Year,Country of origin,Country of origin (ISO),Country of asylum,Country of asylum (ISO),Recognized decisions,Complementary protection,Rejected decisions,Otherwise closed,Total decisions
2000,Afghanistan,AFG,Australia,AUS,38,0,25,0,63
2000,Albania,ALB,Australia,AUS,5,0,23,0,28
2000,Algeria,DZA,Australia,AUS,5,0,15,0,20
2000,Egypt,EGY,Australia,AUS,20,0,49,5,74
2000,Armenia,ARM,Australia,AUS,0,0,5,0,5
2000,Bangladesh,BGD,Australia,AUS,5,0,215,23,243
2000,Bulgaria,BGR,Australia,AUS,0,0,10,5,15
2000,Cambodia,KHM,Australia,AUS,0,0,80,5,85
2000,China,CHN,Australia,AUS,18,0,514,53,585
2000,Chile,CHL,Australia,AUS,0,0,11,5,16
2000,Dem. Rep. of the Congo,COD,Australia,AUS,0,0,5,0,5
2000,Colombia,COL,Australia,AUS,17,0,77,10,104
2000,Ecuador,ECU,Australia,AUS,0,0,10,0,10
2000,Ethiopia,ETH,Australia,AUS,5,0,5,0,10
2000,Fiji,FJI,Australia,AUS,0,0,99,17,116
2000,Palestinian,PSE,Australia,AUS,5,0,0,0,5
2000,United Kingdom of Great Britain and Northern Ireland,GBR,Australia,AUS,0,0,5,0,5
2000,Georgia,GEO,Australia,AUS,0,0,26,0,26
2000,Ghana,GHA,Australia,AUS,0,0,5,0,5
2000,"China, Hong Kong SAR",HKG,Australia,AUS,0,0,14,0,14
2000,Croatia,HRV,Australia,AUS,0,0,5,0,5
2000,India,IND,Australia,AUS,5,0,346,86,437
2000,Indonesia,IDN,Australia,AUS,0,0,1056,95,1151
2000,Iran (Islamic Rep. of),IRN,Australia,AUS,30,0,89,5,124
2000,Iraq,IRQ,Australia,AUS,125,0,51,0,176
2000,Israel,ISR,Australia,AUS,0,0,5,0,5
2000,Jordan,JOR,Australia,AUS,0,0,19,5,24
2000,Kenya,KEN,Australia,AUS,0,0,5,0,5
2000,Rep. of Korea,KOR,Australia,AUS,0,0,191,17,208
2000,Kuwait,KWT,Australia,AUS,0,0,5,0,5
2000,Lebanon,LBN,Australia,AUS,5,0,30,10,45
2000,Sri Lanka,LKA,Australia,AUS,87,0,334,34,455
2000,Lithuania,LTU,Australia,AUS,0,0,5,0,5
2000,Latvia,LVA,Australia,AUS,0,0,10,0,10
2000,North Macedonia,MKD,Australia,AUS,0,0,13,10,23
2000,Rep. of Moldova,MDA,Australia,AUS,0,0,5,0,5
2000,Malaysia,MYS,Australia,AUS,0,0,229,5,234
2000,Morocco,MAR,Australia,AUS,0,0,5,0,5
2000,Myanmar,MMR,Australia,AUS,77,0,101,10,188
2000,Nepal,NPL,Australia,AUS,0,0,50,12,62
2000,Nigeria,NGA,Australia,AUS,0,0,5,0,5
2000,Pakistan,PAK,Australia,AUS,5,0,67,15,87
2000,Peru,PER,Australia,AUS,0,0,14,5,19
2000,Philippines,PHL,Australia,AUS,0,0,660,52,712
2000,Papua New Guinea,PNG,Australia,AUS,0,0,5,0,5
2000,Romania,ROU,Australia,AUS,0,0,10,0,10
2000,South Africa,ZAF,Australia,AUS,0,0,5,0,5
2000,Russian Federation,RUS,Australia,AUS,16,0,27,0,43
2000,Serbia and Kosovo: S/RES/1244 (1999),SRB,Australia,AUS,5,0,26,5,36
2000,Singapore,SGP,Australia,AUS,0,0,5,0,5
2000,Sierra Leone,SLE,Australia,AUS,0,0,5,0,5
2000,Somalia,SOM,Australia,AUS,5,0,12,0,17
2000,Viet Nam,VNM,Australia,AUS,5,0,79,11,95
2000,Sudan,SDN,Australia,AUS,5,0,0,0,5
2000,Syrian Arab Rep.,SYR,Australia,AUS,10,0,10,0,20
2000,United Rep. of Tanzania,TZA,Australia,AUS,0,0,5,0,5
2000,Thailand,THA,Australia,AUS,0,0,110,10,120
2000,Tonga,TON,Australia,AUS,0,0,20,0,20
2000,Turkey,TUR,Australia,AUS,17,0,57,5,79
2000,Uganda,UGA,Australia,AUS,0,0,5,0,5
2000,Ukraine,UKR,Australia,AUS,10,0,50,5,65
2000,United States of America,USA,Australia,AUS,0,0,5,0,5
2000,Uzbekistan,UZB,Australia,AUS,0,0,5,0,5
2000,Samoa,WSM,Australia,AUS,0,0,5,0,5
2000,Yemen,YEM,Australia,AUS,0,0,5,0,5
2000,Afghanistan,AFG,Czechia,CZE,10,0,5,55,70
2000,Algeria,DZA,Czechia,CZE,0,0,28,5,33
2000,Armenia,ARM,Czechia,CZE,15,0,21,5,41
2000,Bangladesh,BGD,Czechia,CZE,0,0,10,5,15
2000,Belarus,BLR,Czechia,CZE,0,0,5,5,10
2000,Bosnia and Herzegovina,BIH,Czechia,CZE,0,0,5,0,5
2000,Bulgaria,BGR,Czechia,CZE,5,0,75,10,90
2000,Congo,COG,Czechia,CZE,0,0,5,10,15
2000,Georgia,GEO,Czechia,CZE,0,0,5,5,10
2000,India,IND,Czechia,CZE,0,0,5,17,22
2000,Iran (Islamic Rep. of),IRN,Czechia,CZE,0,0,5,0,5
2000,Iraq,IRQ,Czechia,CZE,0,0,0,5,5
2000,Kazakhstan,KAZ,Czechia,CZE,0,0,10,5,15
2000,Kyrgyzstan,KGZ,Czechia,CZE,0,0,5,0,5
2000,Sri Lanka,LKA,Czechia,CZE,0,0,11,46,57
2000,Lithuania,LTU,Czechia,CZE,0,0,5,0,5
2000,Rep. of Moldova,MDA,Czechia,CZE,0,0,34,17,51
2000,Mongolia,MNG,Czechia,CZE,0,0,5,0,5
2000,Morocco,MAR,Czechia,CZE,0,0,5,0,5
2000,Nigeria,NGA,Czechia,CZE,0,0,10,0,10
2000,Pakistan,PAK,Czechia,CZE,0,0,13,5,18
2000,Romania,ROU,Czechia,CZE,0,0,71,10,81
2000,Russian Federation,RUS,Czechia,CZE,0,0,44,15,59
2000,Serbia and Kosovo: S/RES/1244 (1999),SRB,Czechia,CZE,5,0,43,15,63
2000,Sierra Leone,SLE,Czechia,CZE,0,0,0,5,5
2000,Viet Nam,VNM,Czechia,CZE,0,0,24,5,29
2000,Slovakia,SVK,Czechia,CZE,0,0,280,179,459
2000,Ukraine,UKR,Czechia,CZE,5,0,39,19,63
2000,Stateless,XXA,Czechia,CZE,0,0,5,5,10
2000,Unknown ,,Czechia,CZE,0,0,5,0,5
2000,Unknown ,,United Kingdom of Great Britain and Northern Ireland,GBR,3340,0,15580,475,19395
2001,Afghanistan,AFG,Australia,AUS,247,0,93,5,345
2001,Albania,ALB,Australia,AUS,5,0,15,0,20
2001,Algeria,DZA,Australia,AUS,5,0,11,0,16
2001,Egypt,EGY,Australia,AUS,11,0,28,5,44
2001,Bangladesh,BGD,Australia,AUS,5,0,76,11,92
2001,Belarus,BLR,Australia,AUS,5,0,5,0,10
2001,Brazil,BRA,Australia,AUS,0,0,5,0,5
2001,Bosnia and Herzegovina,BIH,Australia,AUS,5,0,0,0,5
2001,Bulgaria,BGR,Australia,AUS,0,0,19,10,29
2001,Cambodia,KHM,Australia,AUS,0,0,30,0,30
2001,China,CHN,Australia,AUS,37,0,786,71,894
2001,Chile,CHL,Australia,AUS,0,0,10,5,15
2001,Dem. Rep. of the Congo,COD,Australia,AUS,5,0,0,0,5
2001,Colombia,COL,Australia,AUS,12,0,63,11,86
2001,Ecuador,ECU,Australia,AUS,0,0,10,5,15
2001,Ethiopia,ETH,Australia,AUS,5,0,5,0,10
2001,Fiji,FJI,Australia,AUS,0,0,346,38,384
2001,Palestinian,PSE,Australia,AUS,5,0,41,0,46
2001,Georgia,GEO,Australia,AUS,0,0,14,0,14
2001,Ghana,GHA,Australia,AUS,0,0,5,0,5
2001,"China, Hong Kong SAR",HKG,Australia,AUS,0,0,10,0,10
2001,Hungary,HUN,Australia,AUS,0,0,5,0,5
2001,India,IND,Australia,AUS,5,0,432,57,494
2001,Indonesia,IDN,Australia,AUS,10,0,872,59,941
2001,Iran (Islamic Rep. of),IRN,Australia,AUS,87,0,278,17,382
2001,Iraq,IRQ,Australia,AUS,102,0,18,5,125
2001,Israel,ISR,Australia,AUS,0,0,5,0,5
2001,Jordan,JOR,Australia,AUS,0,0,13,5,18
2001,Kenya,KEN,Australia,AUS,0,0,5,0,5
2001,Rep. of Korea,KOR,Australia,AUS,0,0,79,5,84
2001,Kuwait,KWT,Australia,AUS,5,0,0,0,5
2001,Lao People's Dem. Rep.,LAO,Australia,AUS,0,0,5,0,5
2001,Lebanon,LBN,Australia,AUS,5,0,45,16,66
2001,Sri Lanka,LKA,Australia,AUS,50,0,182,17,249
2001,Latvia,LVA,Australia,AUS,0,0,5,0,5
2001,North Macedonia,MKD,Australia,AUS,0,0,5,5,10
2001,Rep. of Moldova,MDA,Australia,AUS,0,0,14,5,19
2001,Malaysia,MYS,Australia,AUS,0,0,162,10,172
2001,Morocco,MAR,Australia,AUS,0,0,5,0,5
2001,Myanmar,MMR,Australia,AUS,34,0,32,0,66
2001,Nepal,NPL,Australia,AUS,0,0,52,12,64
2001,Nigeria,NGA,Australia,AUS,0,0,32,5,37
2001,Pakistan,PAK,Australia,AUS,5,0,67,12,84
2001,Peru,PER,Australia,AUS,0,0,22,5,27
2001,Philippines,PHL,Australia,AUS,0,0,193,17,210
2001,Poland,POL,Australia,AUS,0,0,5,0,5
2001,Romania,ROU,Australia,AUS,0,0,10,0,10
2001,South Africa,ZAF,Australia,AUS,0,0,5,0,5
2001,Russian Federation,RUS,Australia,AUS,12,0,31,10,53
2001,Rwanda,RWA,Australia,AUS,0,0,5,0,5
2001,El Salvador,SLV,Australia,AUS,0,0,5,0,5
2001,Serbia and Kosovo: S/RES/1244 (1999),SRB,Australia,AUS,5,0,31,5,41
2001,Singapore,SGP,Australia,AUS,0,0,5,0,5
2001,Sierra Leone,SLE,Australia,AUS,0,0,5,0,5
2001,Somalia,SOM,Australia,AUS,5,0,5,0,10
2001,Viet Nam,VNM,Australia,AUS,0,0,121,15,136
2001,Sudan,SDN,Australia,AUS,5,0,5,0,10
2001,Syrian Arab Rep.,SYR,Australia,AUS,13,0,58,5,76
2001,Thailand,THA,Australia,AUS,0,0,151,10,161
2001,Tonga,TON,Australia,AUS,0,0,5,0,5
2001,Tunisia,TUN,Australia,AUS,5,0,0,0,5
2001,Turkey,TUR,Australia,AUS,5,0,27,12,44
2001,Uganda,UGA,Australia,AUS,0,0,5,0,5
2001,Ukraine,UKR,Australia,AUS,5,0,43,10,58
2001,Afghanistan,AFG,Czechia,CZE,0,0,29,41,70
2001,Algeria,DZA,Czechia,CZE,0,0,5,5,10
2001,Angola,AGO,Czechia,CZE,0,0,0,5,5
2001,Armenia,ARM,Czechia,CZE,0,0,43,10,53
2001,Azerbaijan,AZE,Czechia,CZE,0,0,0,5,5
2001,Belarus,BLR,Czechia,CZE,0,0,5,14,19
2001,Bulgaria,BGR,Czechia,CZE,0,0,51,21,72
2001,Georgia,GEO,Czechia,CZE,0,0,5,10,15
2001,Ghana,GHA,Czechia,CZE,0,0,5,0,5
2001,India,IND,Czechia,CZE,0,0,0,10,10
2001,Iran (Islamic Rep. of),IRN,Czechia,CZE,0,0,5,0,5
2001,Iraq,IRQ,Czechia,CZE,0,0,0,5,5
2001,Kazakhstan,KAZ,Czechia,CZE,5,0,5,0,10
2001,Sri Lanka,LKA,Czechia,CZE,0,0,5,5,10
2001,North Macedonia,MKD,Czechia,CZE,0,0,12,0,12
2001,Rep. of Moldova,MDA,Czechia,CZE,0,0,59,44,103
2001,Mongolia,MNG,Czechia,CZE,0,0,15,5,20
2001,Nigeria,NGA,Czechia,CZE,0,0,5,5,10
2001,Pakistan,PAK,Czechia,CZE,0,0,5,0,5
2001,Romania,ROU,Czechia,CZE,0,0,85,74,159
2001,Russian Federation,RUS,Czechia,CZE,0,0,46,54,100
2001,Serbia and Kosovo: S/RES/1244 (1999),SRB,Czechia,CZE,0,0,16,5,21
2001,Viet Nam,VNM,Czechia,CZE,0,0,119,55,174
2001,Slovakia,SVK,Czechia,CZE,0,0,119,125,244
2001,Ukraine,UKR,Czechia,CZE,0,0,329,177,506
2001,Uzbekistan,UZB,Czechia,CZE,0,0,0,5,5
2001,Unknown ,,Czechia,CZE,0,0,23,10,33
2001,Unknown ,,United Kingdom of Great Britain and Northern Ireland,GBR,8155,0,34440,825,43420
2002,Afghanistan,AFG,Australia,AUS,48,0,101,0,149
2002,Albania,ALB,Australia,AUS,0,0,27,5,32
2002,Algeria,DZA,Australia,AUS,5,0,10,0,15
2002,Angola,AGO,Australia,AUS,0,0,5,0,5
2002,Egypt,EGY,Australia,AUS,14,0,31,0,45
2002,Argentina,ARG,Australia,AUS,0,0,12,5,17
2002,Azerbaijan,AZE,Australia,AUS,0,0,5,0,5
2002,Bangladesh,BGD,Australia,AUS,5,0,229,14,248
2002,Belarus,BLR,Australia,AUS,0,0,10,0,10
2002,Bolivia (Plurinational State of),BOL,Australia,AUS,0,0,5,0,5
2002,Brazil,BRA,Australia,AUS,0,0,14,5,19
2002,Bulgaria,BGR,Australia,AUS,0,0,20,0,20
2002,Cambodia,KHM,Australia,AUS,0,0,17,0,17
2002,China,CHN,Australia,AUS,30,0,684,55,769
2002,Chile,CHL,Australia,AUS,0,0,23,5,28
2002,Dem. Rep. of the Congo,COD,Australia,AUS,0,0,10,0,10
2002,Colombia,COL,Australia,AUS,18,0,71,5,94
2002,Cyprus,CYP,Australia,AUS,0,0,5,0,5
2002,Czechia,CZE,Australia,AUS,0,0,5,0,5
2002,Ecuador,ECU,Australia,AUS,0,0,14,0,14
2002,Ethiopia,ETH,Australia,AUS,0,0,10,0,10
2002,Fiji,FJI,Australia,AUS,0,0,340,48,388
2002,France,FRA,Australia,AUS,0,0,5,0,5
2002,Palestinian,PSE,Australia,AUS,10,0,10,0,20
2002,Georgia,GEO,Australia,AUS,0,0,15,0,15
2002,Ghana,GHA,Australia,AUS,0,0,30,0,30
2002,Croatia,HRV,Australia,AUS,0,0,10,0,10
2002,India,IND,Australia,AUS,5,0,710,54,769
2002,Indonesia,IDN,Australia,AUS,13,0,583,38,634
2002,Iran (Islamic Rep. of),IRN,Australia,AUS,38,0,99,0,137
2002,Iraq,IRQ,Australia,AUS,60,0,10,0,70
2002,Israel,ISR,Australia,AUS,0,0,5,5,10
2002,Italy,ITA,Australia,AUS,0,0,5,0,5
2002,Jordan,JOR,Australia,AUS,5,0,15,0,20
2002,Kenya,KEN,Australia,AUS,0,0,11,0,11
2002,Kyrgyzstan,KGZ,Australia,AUS,11,0,0,0,11
2002,Rep. of Korea,KOR,Australia,AUS,0,0,118,5,123
2002,Lao People's Dem. Rep.,LAO,Australia,AUS,0,0,5,0,5
2002,Lebanon,LBN,Australia,AUS,12,0,94,13,119
2002,Sri Lanka,LKA,Australia,AUS,32,0,222,37,291
2002,Lithuania,LTU,Australia,AUS,0,0,5,0,5
2002,Latvia,LVA,Australia,AUS,0,0,21,0,21
2002,Mauritania,MRT,Australia,AUS,5,0,0,0,5
2002,North Macedonia,MKD,Australia,AUS,0,0,98,13,111
2002,Rep. of Moldova,MDA,Australia,AUS,0,0,19,0,19
2002,Malaysia,MYS,Australia,AUS,5,0,145,11,161
2002,Mongolia,MNG,Australia,AUS,0,0,45,5,50
2002,Mauritius,MUS,Australia,AUS,0,0,5,0,5
2002,Myanmar,MMR,Australia,AUS,22,0,51,5,78
2002,Nepal,NPL,Australia,AUS,12,0,177,12,201
2002,Nigeria,NGA,Australia,AUS,0,0,65,10,75
2002,Pakistan,PAK,Australia,AUS,10,0,104,14,128
2002,Peru,PER,Australia,AUS,5,0,40,5,50
2002,Philippines,PHL,Australia,AUS,0,0,106,10,116
2002,Poland,POL,Australia,AUS,0,0,5,5,10
2002,Portugal,PRT,Australia,AUS,0,0,5,0,5
2002,Romania,ROU,Australia,AUS,0,0,16,0,16
2002,South Africa,ZAF,Australia,AUS,0,0,25,0,25
2002,Russian Federation,RUS,Australia,AUS,17,0,56,5,78
2002,Serbia and Kosovo: S/RES/1244 (1999),SRB,Australia,AUS,5,0,51,10,66
2002,Senegal,SEN,Australia,AUS,0,0,5,0,5
2002,Sierra Leone,SLE,Australia,AUS,0,0,12,0,12
2002,Somalia,SOM,Australia,AUS,10,0,0,0,10
2002,Spain,ESP,Australia,AUS,0,0,5,0,5
2002,Viet Nam,VNM,Australia,AUS,0,0,146,19,165
2002,Sudan,SDN,Australia,AUS,5,0,5,0,10
2002,Syrian Arab Rep.,SYR,Australia,AUS,5,0,31,5,41
2002,United Rep. of Tanzania,TZA,Australia,AUS,0,0,5,0,5
2002,Thailand,THA,Australia,AUS,0,0,148,16,164
2002,Timor-Leste,TLS,Australia,AUS,0,0,38,5,43
2002,Tonga,TON,Australia,AUS,0,0,20,5,25
2002,Turkey,TUR,Australia,AUS,19,0,45,10,74
2002,Uganda,UGA,Australia,AUS,0,0,5,0,5
2002,Ukraine,UKR,Australia,AUS,12,0,130,14,156
2002,Uruguay,URY,Australia,AUS,0,0,10,0,10
2002,Uzbekistan,UZB,Australia,AUS,0,0,10,5,15
2002,Samoa,WSM,Australia,AUS,0,0,5,0,5
2002,Zambia,ZMB,Australia,AUS,0,0,5,0,5
2002,Zimbabwe,ZWE,Australia,AUS,5,0,10,0,15
2002,Afghanistan,AFG,Czechia,CZE,0,0,16,5,21
2002,Algeria,DZA,Czechia,CZE,0,0,10,10,20
2002,Armenia,ARM,Czechia,CZE,0,0,15,10,25
2002,Belarus,BLR,Czechia,CZE,0,0,29,29,58
2002,Bulgaria,BGR,Czechia,CZE,0,0,45,25,70
2002,China,CHN,Czechia,CZE,0,0,0,5,5
2002,Georgia,GEO,Czechia,CZE,0,0,32,34,66
2002,India,IND,Czechia,CZE,0,0,0,10,10
2002,Iraq,IRQ,Czechia,CZE,0,0,0,5,5
2002,Kazakhstan,KAZ,Czechia,CZE,0,0,12,10,22
2002,Sri Lanka,LKA,Czechia,CZE,0,0,0,5,5
2002,North Macedonia,MKD,Czechia,CZE,0,0,5,10,15
2002,Rep. of Moldova,MDA,Czechia,CZE,0,0,145,108,253
2002,Mongolia,MNG,Czechia,CZE,0,0,22,5,27
2002,Romania,ROU,Czechia,CZE,0,0,83,76,159
2002,Russian Federation,RUS,Czechia,CZE,0,0,84,40,124
2002,Serbia and Kosovo: S/RES/1244 (1999),SRB,Czechia,CZE,0,0,17,10,27
2002,Viet Nam,VNM,Czechia,CZE,0,0,214,94,308
2002,Slovakia,SVK,Czechia,CZE,0,0,60,28,88
2002,Turkey,TUR,Czechia,CZE,0,0,0,5,5
2002,Ukraine,UKR,Czechia,CZE,0,0,572,441,1013
2002,Stateless,XXA,Czechia,CZE,0,0,5,0,5
2002,Unknown ,,Czechia,CZE,0,0,0,19,19
2002,Afghanistan,AFG,United Kingdom of Great Britain and Northern Ireland,GBR,230,0,1235,580,2045
2002,Albania,ALB,United Kingdom of Great Britain and Northern Ireland,GBR,165,0,955,80,1200
2002,Algeria,DZA,United Kingdom of Great Britain and Northern Ireland,GBR,200,0,1190,75,1465
2002,Angola,AGO,United Kingdom of Great Britain and Northern Ireland,GBR,120,0,365,80,565
2002,Burundi,BDI,United Kingdom of Great Britain and Northern Ireland,GBR,90,0,230,35,355
2002,Bangladesh,BGD,United Kingdom of Great Britain and Northern Ireland,GBR,55,0,505,25,585
2002,China,CHN,United Kingdom of Great Britain and Northern Ireland,GBR,165,0,2395,35,2595
2002,Cameroon,CMR,United Kingdom of Great Britain and Northern Ireland,GBR,150,0,315,15,480
2002,Congo,COG,United Kingdom of Great Britain and Northern Ireland,GBR,180,0,405,30,615
2002,Dem. Rep. of the Congo,COD,United Kingdom of Great Britain and Northern Ireland,GBR,520,0,1035,95,1650
2002,Colombia,COL,United Kingdom of Great Britain and Northern Ireland,GBR,160,0,465,35,660
2002,Czechia,CZE,United Kingdom of Great Britain and Northern Ireland,GBR,50,0,825,85,960
2002,Ecuador,ECU,United Kingdom of Great Britain and Northern Ireland,GBR,45,0,305,15,365
2002,Eritrea,ERI,United Kingdom of Great Britain and Northern Ireland,GBR,275,0,390,40,705
2002,Ethiopia,ETH,United Kingdom of Great Britain and Northern Ireland,GBR,230,0,340,50,620
2002,Gambia,GMB,United Kingdom of Great Britain and Northern Ireland,GBR,10,0,35,0,45
2002,Ghana,GHA,United Kingdom of Great Britain and Northern Ireland,GBR,10,0,175,15,200
2002,Cote d'Ivoire,CIV,United Kingdom of Great Britain and Northern Ireland,GBR,65,0,245,15,325
2002,India,IND,United Kingdom of Great Britain and Northern Ireland,GBR,45,0,1580,70,1695
2002,Iran (Islamic Rep. of),IRN,United Kingdom of Great Britain and Northern Ireland,GBR,1430,0,2210,125,3765
2002,Iraq,IRQ,United Kingdom of Great Britain and Northern Ireland,GBR,1130,0,2970,470,4570
2002,Jamaica,JAM,United Kingdom of Great Britain and Northern Ireland,GBR,40,0,320,40,400
2002,Kenya,KEN,United Kingdom of Great Britain and Northern Ireland,GBR,95,0,430,30,555
2002,Sri Lanka,LKA,United Kingdom of Great Britain and Northern Ireland,GBR,1455,0,4880,100,6435
2002,North Macedonia,MKD,United Kingdom of Great Britain and Northern Ireland,GBR,55,0,390,40,485
2002,Rep. of Moldova,MDA,United Kingdom of Great Britain and Northern Ireland,GBR,25,0,245,20,290
2002,Nigeria,NGA,United Kingdom of Great Britain and Northern Ireland,GBR,60,0,790,55,905
2002,Pakistan,PAK,United Kingdom of Great Britain and Northern Ireland,GBR,395,0,2150,150,2695
2002,Poland,POL,United Kingdom of Great Britain and Northern Ireland,GBR,35,0,800,60,895
2002,Romania,ROU,United Kingdom of Great Britain and Northern Ireland,GBR,35,0,670,55,760
2002,Russian Federation,RUS,United Kingdom of Great Britain and Northern Ireland,GBR,345,0,1360,105,1810
2002,Rwanda,RWA,United Kingdom of Great Britain and Northern Ireland,GBR,60,0,185,30,275
2002,Serbia and Kosovo: S/RES/1244 (1999),SRB,United Kingdom of Great Britain and Northern Ireland,GBR,995,0,4580,355,5930
2002,Sierra Leone,SLE,United Kingdom of Great Britain and Northern Ireland,GBR,120,0,870,40,1030
2002,Somalia,SOM,United Kingdom of Great Britain and Northern Ireland,GBR,1065,0,1570,380,3015
2002,Viet Nam,VNM,United Kingdom of Great Britain and Northern Ireland,GBR,50,0,250,5,305
2002,Sudan,SDN,United Kingdom of Great Britain and Northern Ireland,GBR,225,0,240,20,485
2002,United Rep. of Tanzania,TZA,United Kingdom of Great Britain and Northern Ireland,GBR,10,0,50,5,65
2002,Turkey,TUR,United Kingdom of Great Britain and Northern Ireland,GBR,1320,0,4070,130,5520
2002,Uganda,UGA,United Kingdom of Great Britain and Northern Ireland,GBR,155,0,570,25,750
2002,Ukraine,UKR,United Kingdom of Great Britain and Northern Ireland,GBR,65,0,420,30,515
2002,Zimbabwe,ZWE,United Kingdom of Great Britain and Northern Ireland,GBR,925,0,1370,110,2405
2002,Unknown ,,United Kingdom of Great Britain and Northern Ireland,GBR,745,0,2475,180,3400
2003,Afghanistan,AFG,Australia,AUS,22,0,13,0,35
2003,Albania,ALB,Australia,AUS,0,0,25,0,25
2003,Algeria,DZA,Australia,AUS,0,0,5,0,5
2003,Angola,AGO,Australia,AUS,0,0,5,0,5
2003,Egypt,EGY,Australia,AUS,5,0,33,0,38
2003,Argentina,ARG,Australia,AUS,0,0,18,5,23
2003,Armenia,ARM,Australia,AUS,0,0,5,0,5
2003,Azerbaijan,AZE,Australia,AUS,0,0,5,0,5
2003,Bangladesh,BGD,Australia,AUS,16,0,342,10,368
2003,Belarus,BLR,Australia,AUS,5,0,5,0,10
2003,Brazil,BRA,Australia,AUS,0,0,36,0,36
2003,Bosnia and Herzegovina,BIH,Australia,AUS,0,0,5,0,5
2003,Bulgaria,BGR,Australia,AUS,0,0,5,0,5
2003,Cambodia,KHM,Australia,AUS,0,0,15,0,15
2003,China,CHN,Australia,AUS,34,0,1069,88,1191
2003,Chile,CHL,Australia,AUS,0,0,14,5,19
2003,Cameroon,CMR,Australia,AUS,0,0,5,0,5
2003,Dem. Rep. of the Congo,COD,Australia,AUS,5,0,5,0,10
2003,Colombia,COL,Australia,AUS,12,0,21,5,38
2003,Cyprus,CYP,Australia,AUS,0,0,18,0,18
2003,Ecuador,ECU,Australia,AUS,0,0,11,0,11
2003,Eritrea,ERI,Australia,AUS,5,0,5,0,10
2003,Ethiopia,ETH,Australia,AUS,5,0,10,0,15
2003,Fiji,FJI,Australia,AUS,0,0,224,23,247
2003,Palestinian,PSE,Australia,AUS,5,0,5,0,10
2003,United Kingdom of Great Britain and Northern Ireland,GBR,Australia,AUS,0,0,5,0,5
2003,Georgia,GEO,Australia,AUS,0,0,5,0,5
2003,Ghana,GHA,Australia,AUS,0,0,25,0,25
2003,"China, Hong Kong SAR",HKG,Australia,AUS,0,0,5,0,5
2003,Croatia,HRV,Australia,AUS,0,0,5,5,10
2003,Hungary,HUN,Australia,AUS,0,0,5,5,10
2003,India,IND,Australia,AUS,0,0,606,45,651
2003,Indonesia,IDN,Australia,AUS,13,0,438,27,478
2003,Iran (Islamic Rep. of),IRN,Australia,AUS,28,0,44,0,72
2003,Iraq,IRQ,Australia,AUS,5,0,10,5,20
2003,Israel,ISR,Australia,AUS,5,0,15,13,33
2003,Jordan,JOR,Australia,AUS,0,0,11,0,11
2003,Kazakhstan,KAZ,Australia,AUS,5,0,0,0,5
2003,Kenya,KEN,Australia,AUS,0,0,10,0,10
2003,Kyrgyzstan,KGZ,Australia,AUS,5,0,5,0,10
2003,Rep. of Korea,KOR,Australia,AUS,0,0,211,17,228
2003,Lao People's Dem. Rep.,LAO,Australia,AUS,0,0,10,0,10
2003,Lebanon,LBN,Australia,AUS,17,0,165,11,193
2003,Sri Lanka,LKA,Australia,AUS,10,0,241,22,273
2003,Lithuania,LTU,Australia,AUS,0,0,22,0,22
2003,Latvia,LVA,Australia,AUS,0,0,5,0,5
2003,North Macedonia,MKD,Australia,AUS,0,0,24,5,29
2003,Rep. of Moldova,MDA,Australia,AUS,0,0,16,0,16
2003,Malaysia,MYS,Australia,AUS,0,0,145,12,157
2003,Mongolia,MNG,Australia,AUS,0,0,72,10,82
2003,Myanmar,MMR,Australia,AUS,28,0,31,0,59
2003,Nepal,NPL,Australia,AUS,10,0,59,0,69
2003,Nigeria,NGA,Australia,AUS,5,0,44,5,54
2003,Pakistan,PAK,Australia,AUS,12,0,142,10,164
2003,Peru,PER,Australia,AUS,0,0,53,0,53
2003,Philippines,PHL,Australia,AUS,0,0,29,5,34
2003,Poland,POL,Australia,AUS,0,0,26,0,26
2003,Portugal,PRT,Australia,AUS,0,0,0,5,5
2003,Romania,ROU,Australia,AUS,0,0,10,0,10
2003,South Africa,ZAF,Australia,AUS,0,0,18,0,18
2003,Russian Federation,RUS,Australia,AUS,19,0,78,5,102
2003,El Salvador,SLV,Australia,AUS,0,0,5,0,5
2003,Serbia and Kosovo: S/RES/1244 (1999),SRB,Australia,AUS,0,0,17,0,17
2003,Senegal,SEN,Australia,AUS,0,0,5,0,5
2003,Sierra Leone,SLE,Australia,AUS,0,0,5,0,5
2003,Somalia,SOM,Australia,AUS,5,0,0,0,5
2003,Viet Nam,VNM,Australia,AUS,5,0,89,11,105
2003,Syrian Arab Rep.,SYR,Australia,AUS,5,0,5,0,10
2003,United Rep. of Tanzania,TZA,Australia,AUS,0,0,5,0,5
2003,Thailand,THA,Australia,AUS,0,0,241,27,268
2003,Timor-Leste,TLS,Australia,AUS,0,0,583,41,624
2003,Tonga,TON,Australia,AUS,0,0,54,5,59
2003,Tunisia,TUN,Australia,AUS,5,0,0,0,5
2003,Turkey,TUR,Australia,AUS,11,0,32,5,48
2003,Ukraine,UKR,Australia,AUS,10,0,114,10,134
2003,Uruguay,URY,Australia,AUS,0,0,22,10,32
2003,Uzbekistan,UZB,Australia,AUS,5,0,5,0,10
2003,Samoa,WSM,Australia,AUS,0,0,5,0,5
2003,Zimbabwe,ZWE,Australia,AUS,14,0,5,5,24
2003,Afghanistan,AFG,United Kingdom of Great Britain and Northern Ireland,GBR,695,0,4415,440,5550
2003,Albania,ALB,United Kingdom of Great Britain and Northern Ireland,GBR,120,0,885,90,1095
2003,Algeria,DZA,United Kingdom of Great Britain and Northern Ireland,GBR,200,0,1255,110,1565
2003,Angola,AGO,United Kingdom of Great Britain and Northern Ireland,GBR,160,0,690,80,930
2003,Burundi,BDI,United Kingdom of Great Britain and Northern Ireland,GBR,160,0,500,50,710
2003,Bangladesh,BGD,United Kingdom of Great Britain and Northern Ireland,GBR,50,0,575,45,670
2003,China,CHN,United Kingdom of Great Britain and Northern Ireland,GBR,160,0,2550,60,2770
2003,Cameroon,CMR,United Kingdom of Great Britain and Northern Ireland,GBR,170,0,540,25,735
2003,Congo,COG,United Kingdom of Great Britain and Northern Ireland,GBR,150,0,445,30,625
2003,Dem. Rep. of the Congo,COD,United Kingdom of Great Britain and Northern Ireland,GBR,720,0,1915,110,2745
2003,Colombia,COL,United Kingdom of Great Britain and Northern Ireland,GBR,160,0,475,30,665
2003,Czechia,CZE,United Kingdom of Great Britain and Northern Ireland,GBR,30,0,595,60,685
2003,Ecuador,ECU,United Kingdom of Great Britain and Northern Ireland,GBR,50,0,375,20,445
2003,Eritrea,ERI,United Kingdom of Great Britain and Northern Ireland,GBR,500,0,960,60,1520
2003,Ethiopia,ETH,United Kingdom of Great Britain and Northern Ireland,GBR,325,0,680,55,1060
2003,Gambia,GMB,United Kingdom of Great Britain and Northern Ireland,GBR,5,0,100,5,110
2003,Ghana,GHA,United Kingdom of Great Britain and Northern Ireland,GBR,20,0,285,35,340
2003,Cote d'Ivoire,CIV,United Kingdom of Great Britain and Northern Ireland,GBR,120,0,450,35,605
2003,India,IND,United Kingdom of Great Britain and Northern Ireland,GBR,55,0,1635,75,1765
2003,Iran (Islamic Rep. of),IRN,United Kingdom of Great Britain and Northern Ireland,GBR,1440,0,3255,175,4870
2003,Iraq,IRQ,United Kingdom of Great Britain and Northern Ireland,GBR,490,0,4435,475,5400
2003,Jamaica,JAM,United Kingdom of Great Britain and Northern Ireland,GBR,70,0,875,90,1035
2003,Kenya,KEN,United Kingdom of Great Britain and Northern Ireland,GBR,105,0,480,35,620
2003,Liberia,LBR,United Kingdom of Great Britain and Northern Ireland,GBR,110,0,345,20,475
2003,Sri Lanka,LKA,United Kingdom of Great Britain and Northern Ireland,GBR,715,0,4730,160,5605
2003,North Macedonia,MKD,United Kingdom of Great Britain and Northern Ireland,GBR,25,0,180,15,220
2003,Rep. of Moldova,MDA,United Kingdom of Great Britain and Northern Ireland,GBR,25,0,335,15,375
2003,Nigeria,NGA,United Kingdom of Great Britain and Northern Ireland,GBR,75,0,915,55,1045
2003,Pakistan,PAK,United Kingdom of Great Britain and Northern Ireland,GBR,535,0,2240,155,2930
2003,Poland,POL,United Kingdom of Great Britain and Northern Ireland,GBR,30,0,545,45,620
2003,Romania,ROU,United Kingdom of Great Britain and Northern Ireland,GBR,25,0,645,35,705
2003,Russian Federation,RUS,United Kingdom of Great Britain and Northern Ireland,GBR,325,0,1530,130,1985
2003,Rwanda,RWA,United Kingdom of Great Britain and Northern Ireland,GBR,130,0,465,40,635
2003,Serbia and Kosovo: S/RES/1244 (1999),SRB,United Kingdom of Great Britain and Northern Ireland,GBR,1010,0,5825,435,7270
2003,Sierra Leone,SLE,United Kingdom of Great Britain and Northern Ireland,GBR,155,0,930,90,1175
2003,Somalia,SOM,United Kingdom of Great Britain and Northern Ireland,GBR,2015,0,2960,390,5365
2003,Viet Nam,VNM,United Kingdom of Great Britain and Northern Ireland,GBR,75,0,760,30,865
2003,Sudan,SDN,United Kingdom of Great Britain and Northern Ireland,GBR,310,0,470,40,820
2003,United Rep. of Tanzania,TZA,United Kingdom of Great Britain and Northern Ireland,GBR,20,0,60,5,85
2003,Turkey,TUR,United Kingdom of Great Britain and Northern Ireland,GBR,1665,0,3880,185,5730
2003,Uganda,UGA,United Kingdom of Great Britain and Northern Ireland,GBR,205,0,680,40,925
2003,Ukraine,UKR,United Kingdom of Great Britain and Northern Ireland,GBR,70,0,415,30,515
2003,Zimbabwe,ZWE,United Kingdom of Great Britain and Northern Ireland,GBR,1140,0,2745,205,4090
2003,Unknown ,,United Kingdom of Great Britain and Northern Ireland,GBR,945,0,2620,200,3765
2004,Afghanistan,AFG,Australia,AUS,728,0,62,5,795
2004,Albania,ALB,Australia,AUS,5,0,39,0,44
2004,Egypt,EGY,Australia,AUS,15,0,46,0,61
2004,Bangladesh,BGD,Australia,AUS,24,0,103,10,137
2004,Brazil,BRA,Australia,AUS,0,0,18,0,18
2004,China,CHN,Australia,AUS,77,0,841,44,962
2004,Fiji,FJI,Australia,AUS,5,0,76,10,91
2004,Ghana,GHA,Australia,AUS,5,0,15,0,20
2004,"China, Hong Kong SAR",HKG,Australia,AUS,0,0,14,0,14
2004,India,IND,Australia,AUS,5,0,423,25,453
2004,Indonesia,IDN,Australia,AUS,5,0,147,14,166
2004,Iran (Islamic Rep. of),IRN,Australia,AUS,45,0,19,0,64
2004,Iraq,IRQ,Australia,AUS,5,0,11,0,16
2004,Israel,ISR,Australia,AUS,5,0,20,5,30
2004,Jordan,JOR,Australia,AUS,5,0,12,0,17
2004,Kenya,KEN,Australia,AUS,0,0,18,0,18
2004,Rep. of Korea,KOR,Australia,AUS,0,0,53,5,58
2004,Lebanon,LBN,Australia,AUS,11,0,48,5,64
2004,Sri Lanka,LKA,Australia,AUS,15,0,109,5,129
2004,Lithuania,LTU,Australia,AUS,0,0,12,0,12
2004,North Macedonia,MKD,Australia,AUS,0,0,12,5,17
2004,Malaysia,MYS,Australia,AUS,0,0,134,13,147
2004,Mongolia,MNG,Australia,AUS,0,0,22,0,22
2004,Myanmar,MMR,Australia,AUS,14,0,12,0,26
2004,Nepal,NPL,Australia,AUS,5,0,48,0,53
2004,Nigeria,NGA,Australia,AUS,10,0,37,5,52
2004,Pakistan,PAK,Australia,AUS,11,0,42,5,58
2004,Philippines,PHL,Australia,AUS,0,0,50,5,55
2004,Poland,POL,Australia,AUS,0,0,15,0,15
2004,Romania,ROU,Australia,AUS,0,0,13,0,13
2004,Russian Federation,RUS,Australia,AUS,5,0,16,0,21
2004,Serbia and Kosovo: S/RES/1244 (1999),SRB,Australia,AUS,0,0,16,0,16
2004,Viet Nam,VNM,Australia,AUS,5,0,60,5,70
2004,Syrian Arab Rep.,SYR,Australia,AUS,10,0,16,0,26
2004,Thailand,THA,Australia,AUS,0,0,59,15,74
2004,Tonga,TON,Australia,AUS,0,0,30,0,30
2004,Turkey,TUR,Australia,AUS,16,0,39,5,60
2004,Unknown ,,Australia,AUS,87,0,217,33,337
2004,Afghanistan,AFG,United Kingdom of Great Britain and Northern Ireland,GBR,325,0,2595,150,3070
2004,Albania,ALB,United Kingdom of Great Britain and Northern Ireland,GBR,55,0,300,35,390
2004,Algeria,DZA,United Kingdom of Great Britain and Northern Ireland,GBR,60,0,760,70,890
2004,Angola,AGO,United Kingdom of Great Britain and Northern Ireland,GBR,125,0,645,30,800
2004,Burundi,BDI,United Kingdom of Great Britain and Northern Ireland,GBR,85,0,395,40,520
2004,Bangladesh,BGD,United Kingdom of Great Britain and Northern Ireland,GBR,10,0,185,20,215
2004,China,CHN,United Kingdom of Great Britain and Northern Ireland,GBR,135,0,2120,50,2305
2004,Cameroon,CMR,United Kingdom of Great Britain and Northern Ireland,GBR,115,0,405,25,545
2004,Congo,COG,United Kingdom of Great Britain and Northern Ireland,GBR,70,0,345,30,445
2004,Dem. Rep. of the Congo,COD,United Kingdom of Great Britain and Northern Ireland,GBR,400,0,1585,55,2040
2004,Colombia,COL,United Kingdom of Great Britain and Northern Ireland,GBR,45,0,230,35,310
2004,Czechia,CZE,United Kingdom of Great Britain and Northern Ireland,GBR,5,0,60,10,75
2004,Ecuador,ECU,United Kingdom of Great Britain and Northern Ireland,GBR,5,0,110,5,120
2004,Eritrea,ERI,United Kingdom of Great Britain and Northern Ireland,GBR,405,0,605,35,1045
2004,Ethiopia,ETH,United Kingdom of Great Britain and Northern Ireland,GBR,220,0,585,25,830
2004,Gambia,GMB,United Kingdom of Great Britain and Northern Ireland,GBR,5,0,110,5,120
2004,Ghana,GHA,United Kingdom of Great Britain and Northern Ireland,GBR,5,0,290,25,320
2004,Cote d'Ivoire,CIV,United Kingdom of Great Britain and Northern Ireland,GBR,65,0,275,15,355
2004,India,IND,United Kingdom of Great Britain and Northern Ireland,GBR,20,0,1040,35,1095
2004,Iran (Islamic Rep. of),IRN,United Kingdom of Great Britain and Northern Ireland,GBR,985,0,3305,140,4430
2004,Iraq,IRQ,United Kingdom of Great Britain and Northern Ireland,GBR,280,0,6250,135,6665
2004,Jamaica,JAM,United Kingdom of Great Britain and Northern Ireland,GBR,50,0,425,35,510
2004,Kenya,KEN,United Kingdom of Great Britain and Northern Ireland,GBR,25,0,270,20,315
2004,Liberia,LBR,United Kingdom of Great Britain and Northern Ireland,GBR,40,0,555,25,620
2004,Sri Lanka,LKA,United Kingdom of Great Britain and Northern Ireland,GBR,105,0,1400,55,1560
2004,North Macedonia,MKD,United Kingdom of Great Britain and Northern Ireland,GBR,5,0,55,0,60
2004,Rep. of Moldova,MDA,United Kingdom of Great Britain and Northern Ireland,GBR,5,0,75,5,85
2004,Nigeria,NGA,United Kingdom of Great Britain and Northern Ireland,GBR,40,0,905,50,995
2004,Pakistan,PAK,United Kingdom of Great Britain and Northern Ireland,GBR,410,0,2040,80,2530
2004,Poland,POL,United Kingdom of Great Britain and Northern Ireland,GBR,5,0,85,20,110
2004,Romania,ROU,United Kingdom of Great Britain and Northern Ireland,GBR,10,0,170,10,190
2004,Russian Federation,RUS,United Kingdom of Great Britain and Northern Ireland,GBR,235,0,790,75,1100
2004,Rwanda,RWA,United Kingdom of Great Britain and Northern Ireland,GBR,60,0,295,20,375
2004,Serbia and Kosovo: S/RES/1244 (1999),SRB,United Kingdom of Great Britain and Northern Ireland,GBR,375,0,1620,175,2170
2004,Sierra Leone,SLE,United Kingdom of Great Britain and Northern Ireland,GBR,65,0,475,40,580
2004,Somalia,SOM,United Kingdom of Great Britain and Northern Ireland,GBR,1835,0,2240,235,4310
2004,Viet Nam,VNM,United Kingdom of Great Britain and Northern Ireland,GBR,45,0,540,30,615
2004,Sudan,SDN,United Kingdom of Great Britain and Northern Ireland,GBR,445,0,645,45,1135
2004,United Rep. of Tanzania,TZA,United Kingdom of Great Britain and Northern Ireland,GBR,5,0,40,5,50
2004,Turkey,TUR,United Kingdom of Great Britain and Northern Ireland,GBR,840,0,2680,110,3630
2004,Uganda,UGA,United Kingdom of Great Britain and Northern Ireland,GBR,125,0,490,35,650
2004,Ukraine,UKR,United Kingdom of Great Britain and Northern Ireland,GBR,35,0,135,10,180
2004,Zimbabwe,ZWE,United Kingdom of Great Britain and Northern Ireland,GBR,595,0,2655,95,3345
2004,Unknown ,,United Kingdom of Great Britain and Northern Ireland,GBR,2070,0,3335,200,5605
2005,Afghanistan,AFG,Australia,AUS,239,0,24,5,268
2005,Albania,ALB,Australia,AUS,5,0,17,0,22
2005,Algeria,DZA,Australia,AUS,0,0,5,0,5
2005,Egypt,EGY,Australia,AUS,14,0,21,0,35
2005,Bangladesh,BGD,Australia,AUS,21,0,139,11,171
2005,Brazil,BRA,Australia,AUS,0,0,10,0,10
2005,Bulgaria,BGR,Australia,AUS,0,0,5,0,5
2005,Cambodia,KHM,Australia,AUS,0,0,5,0,5
2005,China,CHN,Australia,AUS,103,0,740,63,906
2005,Dem. Rep. of the Congo,COD,Australia,AUS,5,0,0,0,5
2005,Colombia,COL,Australia,AUS,0,0,10,0,10
2005,Eritrea,ERI,Australia,AUS,5,0,0,0,5
2005,Ethiopia,ETH,Australia,AUS,10,0,0,0,10
2005,Fiji,FJI,Australia,AUS,0,0,40,5,45
2005,Palestinian,PSE,Australia,AUS,5,0,0,0,5
2005,Ghana,GHA,Australia,AUS,0,0,5,0,5
2005,"China, Hong Kong SAR",HKG,Australia,AUS,0,0,5,0,5
2005,Croatia,HRV,Australia,AUS,0,0,5,0,5
2005,India,IND,Australia,AUS,10,0,167,11,188
2005,Indonesia,IDN,Australia,AUS,10,0,70,5,85
2005,Iran (Islamic Rep. of),IRN,Australia,AUS,25,0,14,5,44
2005,Iraq,IRQ,Australia,AUS,556,0,16,5,577
2005,Israel,ISR,Australia,AUS,0,0,10,0,10
2005,Jordan,JOR,Australia,AUS,0,0,11,0,11
2005,Kenya,KEN,Australia,AUS,0,0,14,0,14
2005,Rep. of Korea,KOR,Australia,AUS,0,0,32,5,37
2005,Dem. People's Rep. of Korea,PRK,Australia,AUS,5,0,5,0,10
2005,Lebanon,LBN,Australia,AUS,13,0,42,5,60
2005,Sri Lanka,LKA,Australia,AUS,31,0,76,10,117
2005,North Macedonia,MKD,Australia,AUS,0,0,5,0,5
2005,Rep. of Moldova,MDA,Australia,AUS,0,0,5,0,5
2005,Malaysia,MYS,Australia,AUS,0,0,98,5,103
2005,Mongolia,MNG,Australia,AUS,5,0,28,5,38
2005,Myanmar,MMR,Australia,AUS,11,0,5,5,21
2005,Nepal,NPL,Australia,AUS,15,0,44,0,59
2005,Nigeria,NGA,Australia,AUS,5,0,12,0,17
2005,Pakistan,PAK,Australia,AUS,5,0,56,5,66
2005,Peru,PER,Australia,AUS,0,0,5,0,5
2005,Philippines,PHL,Australia,AUS,0,0,54,10,64
2005,Romania,ROU,Australia,AUS,0,0,10,0,10
2005,Russian Federation,RUS,Australia,AUS,14,0,12,0,26
2005,Serbia and Kosovo: S/RES/1244 (1999),SRB,Australia,AUS,0,0,20,0,20
2005,Somalia,SOM,Australia,AUS,5,0,0,0,5
2005,Viet Nam,VNM,Australia,AUS,19,0,18,0,37
2005,Sudan,SDN,Australia,AUS,5,0,5,0,10
2005,Syrian Arab Rep.,SYR,Australia,AUS,5,0,5,0,10
2005,Thailand,THA,Australia,AUS,0,0,17,5,22
2005,Tonga,TON,Australia,AUS,0,0,5,0,5
2005,Turkey,TUR,Australia,AUS,10,0,19,5,34
2005,Uganda,UGA,Australia,AUS,0,0,5,0,5
2005,Ukraine,UKR,Australia,AUS,5,0,11,0,16
2005,Uzbekistan,UZB,Australia,AUS,5,0,5,0,10
2005,Samoa,WSM,Australia,AUS,0,0,5,0,5
2005,Zimbabwe,ZWE,Australia,AUS,13,0,5,0,18
2005,Afghanistan,AFG,United Kingdom of Great Britain and Northern Ireland,GBR,205,0,1555,85,1845
2005,Albania,ALB,United Kingdom of Great Britain and Northern Ireland,GBR,20,0,175,25,220
2005,Algeria,DZA,United Kingdom of Great Britain and Northern Ireland,GBR,35,0,365,30,430
2005,Angola,AGO,United Kingdom of Great Britain and Northern Ireland,GBR,50,0,325,25,400
2005,Burundi,BDI,United Kingdom of Great Britain and Northern Ireland,GBR,45,0,205,20,270
2005,Bangladesh,BGD,United Kingdom of Great Britain and Northern Ireland,GBR,10,0,190,20,220
2005,China,CHN,United Kingdom of Great Britain and Northern Ireland,GBR,80,0,1120,60,1260
2005,Cameroon,CMR,United Kingdom of Great Britain and Northern Ireland,GBR,85,0,260,15,360
2005,Congo,COG,United Kingdom of Great Britain and Northern Ireland,GBR,25,0,165,15,205
2005,Dem. Rep. of the Congo,COD,United Kingdom of Great Britain and Northern Ireland,GBR,305,0,1360,75,1740
2005,Colombia,COL,United Kingdom of Great Britain and Northern Ireland,GBR,35,0,130,25,190
2005,Czechia,CZE,United Kingdom of Great Britain and Northern Ireland,GBR,0,0,10,0,10
2005,Ecuador,ECU,United Kingdom of Great Britain and Northern Ireland,GBR,5,0,30,10,45
2005,Eritrea,ERI,United Kingdom of Great Britain and Northern Ireland,GBR,475,0,625,55,1155
2005,Ethiopia,ETH,United Kingdom of Great Britain and Northern Ireland,GBR,170,0,475,30,675
2005,Gambia,GMB,United Kingdom of Great Britain and Northern Ireland,GBR,5,0,85,5,95
2005,Ghana,GHA,United Kingdom of Great Britain and Northern Ireland,GBR,0,0,160,5,165
2005,Cote d'Ivoire,CIV,United Kingdom of Great Britain and Northern Ireland,GBR,35,0,245,5,285
2005,India,IND,United Kingdom of Great Britain and Northern Ireland,GBR,10,0,185,25,220
2005,Iran (Islamic Rep. of),IRN,United Kingdom of Great Britain and Northern Ireland,GBR,705,0,3630,175,4510
2005,Iraq,IRQ,United Kingdom of Great Britain and Northern Ireland,GBR,160,0,2585,100,2845
2005,Jamaica,JAM,United Kingdom of Great Britain and Northern Ireland,GBR,40,0,290,30,360
2005,Kenya,KEN,United Kingdom of Great Britain and Northern Ireland,GBR,20,0,125,20,165
2005,Liberia,LBR,United Kingdom of Great Britain and Northern Ireland,GBR,25,0,255,15,295
2005,Libya,LBY,United Kingdom of Great Britain and Northern Ireland,GBR,40,0,140,10,190
2005,Sri Lanka,LKA,United Kingdom of Great Britain and Northern Ireland,GBR,80,0,475,55,610
2005,North Macedonia,MKD,United Kingdom of Great Britain and Northern Ireland,GBR,0,0,25,0,25
2005,Rep. of Moldova,MDA,United Kingdom of Great Britain and Northern Ireland,GBR,0,0,35,0,35
2005,Nigeria,NGA,United Kingdom of Great Britain and Northern Ireland,GBR,30,0,675,40,745
2005,Pakistan,PAK,United Kingdom of Great Britain and Northern Ireland,GBR,215,0,1385,100,1700
2005,Poland,POL,United Kingdom of Great Britain and Northern Ireland,GBR,0,0,5,0,5
2005,Romania,ROU,United Kingdom of Great Britain and Northern Ireland,GBR,10,0,60,15,85
2005,Russian Federation,RUS,United Kingdom of Great Britain and Northern Ireland,GBR,70,0,110,15,195
2005,Rwanda,RWA,United Kingdom of Great Britain and Northern Ireland,GBR,20,0,120,15,155
2005,Serbia and Kosovo: S/RES/1244 (1999),SRB,United Kingdom of Great Britain and Northern Ireland,GBR,140,0,675,150,965
2005,Sierra Leone,SLE,United Kingdom of Great Britain and Northern Ireland,GBR,30,0,210,20,260
2005,Somalia,SOM,United Kingdom of Great Britain and Northern Ireland,GBR,790,0,1045,165,2000
2005,Viet Nam,VNM,United Kingdom of Great Britain and Northern Ireland,GBR,20,0,270,15,305
2005,Sudan,SDN,United Kingdom of Great Britain and Northern Ireland,GBR,370,0,865,25,1260
2005,Syrian Arab Rep.,SYR,United Kingdom of Great Britain and Northern Ireland,GBR,120,0,255,15,390
2005,United Rep. of Tanzania,TZA,United Kingdom of Great Britain and Northern Ireland,GBR,5,0,15,0,20
2005,Turkey,TUR,United Kingdom of Great Britain and Northern Ireland,GBR,430,0,1315,120,1865
2005,Uganda,UGA,United Kingdom of Great Britain and Northern Ireland,GBR,55,0,325,15,395
2005,Ukraine,UKR,United Kingdom of Great Britain and Northern Ireland,GBR,15,0,70,10,95
2005,Zimbabwe,ZWE,United Kingdom of Great Britain and Northern Ireland,GBR,460,0,1285,65,1810
2005,Stateless,XXA,United Kingdom of Great Britain and Northern Ireland,GBR,75,0,25,15,115
2005,Unknown ,,United Kingdom of Great Britain and Northern Ireland,GBR,360,0,2220,175,2755
2006,Afghanistan,AFG,Australia,AUS,18,0,5,5,28
2006,Albania,ALB,Australia,AUS,10,0,10,0,20
2006,Algeria,DZA,Australia,AUS,0,0,5,0,5
2006,Egypt,EGY,Australia,AUS,27,0,19,0,46
2006,Bahrain,BHR,Australia,AUS,5,0,5,0,10
2006,Bangladesh,BGD,Australia,AUS,22,0,111,82,215
2006,Belarus,BLR,Australia,AUS,0,0,5,0,5
2006,Brazil,BRA,Australia,AUS,0,0,5,0,5
2006,Bulgaria,BGR,Australia,AUS,0,0,5,0,5
2006,Cambodia,KHM,Australia,AUS,0,0,5,0,5
2006,China,CHN,Australia,AUS,209,0,832,44,1085
2006,Chile,CHL,Australia,AUS,0,0,5,0,5
2006,Cameroon,CMR,Australia,AUS,11,0,0,0,11
2006,Colombia,COL,Australia,AUS,5,0,5,0,10
2006,Ethiopia,ETH,Australia,AUS,10,0,5,0,15
2006,Fiji,FJI,Australia,AUS,5,0,29,5,39
2006,Palestinian,PSE,Australia,AUS,5,0,0,0,5
2006,United Kingdom of Great Britain and Northern Ireland,GBR,Australia,AUS,0,0,5,0,5
2006,Germany,DEU,Australia,AUS,0,0,5,0,5
2006,Ghana,GHA,Australia,AUS,5,0,5,0,10
2006,India,IND,Australia,AUS,16,0,281,32,329
2006,Indonesia,IDN,Australia,AUS,10,0,157,10,177
2006,Iran (Islamic Rep. of),IRN,Australia,AUS,11,0,12,0,23
2006,Iraq,IRQ,Australia,AUS,16,0,0,0,16
2006,Israel,ISR,Australia,AUS,0,0,5,0,5
2006,Jordan,JOR,Australia,AUS,5,0,5,0,10
2006,Kenya,KEN,Australia,AUS,0,0,5,0,5
2006,Kyrgyzstan,KGZ,Australia,AUS,0,0,5,0,5
2006,Rep. of Korea,KOR,Australia,AUS,0,0,42,10,52
2006,Dem. People's Rep. of Korea,PRK,Australia,AUS,5,0,5,0,10
2006,Lebanon,LBN,Australia,AUS,10,0,25,0,35
2006,Sri Lanka,LKA,Australia,AUS,44,0,93,5,142
2006,Latvia,LVA,Australia,AUS,5,0,0,0,5
2006,Malaysia,MYS,Australia,AUS,5,0,105,5,115
2006,Mongolia,MNG,Australia,AUS,10,0,10,0,20
2006,Morocco,MAR,Australia,AUS,0,0,5,0,5
2006,Myanmar,MMR,Australia,AUS,18,0,10,0,28
2006,Nepal,NPL,Australia,AUS,15,0,49,0,64
2006,Nigeria,NGA,Australia,AUS,12,0,21,0,33
2006,Pakistan,PAK,Australia,AUS,15,0,68,5,88
2006,Philippines,PHL,Australia,AUS,0,0,31,5,36
2006,Papua New Guinea,PNG,Australia,AUS,5,0,5,5,15
2006,South Africa,ZAF,Australia,AUS,0,0,5,0,5
2006,Russian Federation,RUS,Australia,AUS,5,0,10,0,15
2006,Serbia and Kosovo: S/RES/1244 (1999),SRB,Australia,AUS,0,0,5,0,5
2006,Viet Nam,VNM,Australia,AUS,5,0,20,0,25
2006,Sudan,SDN,Australia,AUS,0,0,5,0,5
2006,Syrian Arab Rep.,SYR,Australia,AUS,0,0,10,0,10
2006,United Rep. of Tanzania,TZA,Australia,AUS,0,0,5,0,5
2006,Thailand,THA,Australia,AUS,5,0,40,5,50
2006,Tonga,TON,Australia,AUS,0,0,10,5,15
2006,Turkey,TUR,Australia,AUS,5,0,25,5,35
2006,Uganda,UGA,Australia,AUS,5,0,0,0,5
2006,Ukraine,UKR,Australia,AUS,0,0,5,0,5
2006,United States of America,USA,Australia,AUS,0,0,5,0,5
2006,Uzbekistan,UZB,Australia,AUS,5,0,5,0,10
2006,Zimbabwe,ZWE,Australia,AUS,10,0,5,0,15
2006,Afghanistan,AFG,Azerbaijan,AZE,0,0,20,0,20
2006,Iran (Islamic Rep. of),IRN,Azerbaijan,AZE,0,0,14,0,14
2006,Pakistan,PAK,Azerbaijan,AZE,0,0,5,0,5
2006,Afghanistan,AFG,United Kingdom of Great Britain and Northern Ireland,GBR,135,0,1055,60,1250
2006,Albania,ALB,United Kingdom of Great Britain and Northern Ireland,GBR,15,0,70,5,90
2006,Algeria,DZA,United Kingdom of Great Britain and Northern Ireland,GBR,10,0,135,10,155
2006,Angola,AGO,United Kingdom of Great Britain and Northern Ireland,GBR,15,0,65,5,85
2006,Burundi,BDI,United Kingdom of Great Britain and Northern Ireland,GBR,10,0,55,5,70
2006,Bangladesh,BGD,United Kingdom of Great Britain and Northern Ireland,GBR,5,0,180,20,205
2006,China,CHN,United Kingdom of Great Britain and Northern Ireland,GBR,50,0,625,25,700
2006,Cameroon,CMR,United Kingdom of Great Britain and Northern Ireland,GBR,45,0,160,10,215
2006,Congo,COG,United Kingdom of Great Britain and Northern Ireland,GBR,10,0,55,5,70
2006,Dem. Rep. of the Congo,COD,United Kingdom of Great Britain and Northern Ireland,GBR,160,0,465,35,660
2006,Colombia,COL,United Kingdom of Great Britain and Northern Ireland,GBR,5,0,40,5,50
2006,Ecuador,ECU,United Kingdom of Great Britain and Northern Ireland,GBR,5,0,15,0,20
2006,Eritrea,ERI,United Kingdom of Great Britain and Northern Ireland,GBR,380,0,430,50,860
2006,Ethiopia,ETH,United Kingdom of Great Britain and Northern Ireland,GBR,70,0,165,10,245
2006,Gambia,GMB,United Kingdom of Great Britain and Northern Ireland,GBR,5,0,75,0,80
2006,Ghana,GHA,United Kingdom of Great Britain and Northern Ireland,GBR,0,0,40,5,45
2006,Cote d'Ivoire,CIV,United Kingdom of Great Britain and Northern Ireland,GBR,25,0,110,5,140
2006,India,IND,United Kingdom of Great Britain and Northern Ireland,GBR,15,0,70,10,95
2006,Iran (Islamic Rep. of),IRN,United Kingdom of Great Britain and Northern Ireland,GBR,385,0,1690,60,2135
2006,Iraq,IRQ,United Kingdom of Great Britain and Northern Ireland,GBR,105,0,610,40,755
2006,Jamaica,JAM,United Kingdom of Great Britain and Northern Ireland,GBR,15,0,110,5,130
2006,Kenya,KEN,United Kingdom of Great Britain and Northern Ireland,GBR,10,0,75,10,95
2006,Liberia,LBR,United Kingdom of Great Britain and Northern Ireland,GBR,5,0,55,0,60
2006,Libya,LBY,United Kingdom of Great Britain and Northern Ireland,GBR,15,0,75,5,95
2006,Sri Lanka,LKA,United Kingdom of Great Britain and Northern Ireland,GBR,85,0,295,10,390
2006,North Macedonia,MKD,United Kingdom of Great Britain and Northern Ireland,GBR,0,0,5,0,5
2006,Rep. of Moldova,MDA,United Kingdom of Great Britain and Northern Ireland,GBR,5,0,15,0,20
2006,Nigeria,NGA,United Kingdom of Great Britain and Northern Ireland,GBR,15,0,380,25,420
2006,Pakistan,PAK,United Kingdom of Great Britain and Northern Ireland,GBR,120,0,620,45,785
2006,Romania,ROU,United Kingdom of Great Britain and Northern Ireland,GBR,0,0,30,10,40
2006,Russian Federation,RUS,United Kingdom of Great Britain and Northern Ireland,GBR,75,0,190,25,290
2006,Rwanda,RWA,United Kingdom of Great Britain and Northern Ireland,GBR,10,0,30,0,40
2006,Serbia and Kosovo: S/RES/1244 (1999),SRB,United Kingdom of Great Britain and Northern Ireland,GBR,55,0,180,20,255
2006,Sierra Leone,SLE,United Kingdom of Great Britain and Northern Ireland,GBR,10,0,80,5,95
2006,Somalia,SOM,United Kingdom of Great Britain and Northern Ireland,GBR,460,0,470,55,985
2006,Viet Nam,VNM,United Kingdom of Great Britain and Northern Ireland,GBR,5,0,35,5,45
2006,Sudan,SDN,United Kingdom of Great Britain and Northern Ireland,GBR,130,0,385,20,535
2006,Syrian Arab Rep.,SYR,United Kingdom of Great Britain and Northern Ireland,GBR,35,0,120,5,160
2006,United Rep. of Tanzania,TZA,United Kingdom of Great Britain and Northern Ireland,GBR,0,0,20,0,20
2006,Turkey,TUR,United Kingdom of Great Britain and Northern Ireland,GBR,150,0,435,30,615
2006,Uganda,UGA,United Kingdom of Great Britain and Northern Ireland,GBR,15,0,130,5,150
2006,Ukraine,UKR,United Kingdom of Great Britain and Northern Ireland,GBR,5,0,35,5,45
2006,Zimbabwe,ZWE,United Kingdom of Great Britain and Northern Ireland,GBR,735,0,960,55,1750
2006,Unknown ,,United Kingdom of Great Britain and Northern Ireland,GBR,205,0,865,75,1145
2007,Afghanistan,AFG,Australia,AUS,5,0,0,0,5
2007,Albania,ALB,Australia,AUS,0,0,5,0,5
2007,Egypt,EGY,Australia,AUS,10,0,10,0,20
2007,Bangladesh,BGD,Australia,AUS,19,0,55,96,170
2007,Brazil,BRA,Australia,AUS,0,0,5,0,5
2007,Cambodia,KHM,Australia,AUS,0,0,5,0,5
2007,China,CHN,Australia,AUS,213,0,673,34,920
2007,Chile,CHL,Australia,AUS,0,0,5,0,5
2007,Cameroon,CMR,Australia,AUS,5,0,0,0,5
2007,Colombia,COL,Australia,AUS,5,0,5,0,10
2007,Ethiopia,ETH,Australia,AUS,5,0,5,0,10
2007,Fiji,FJI,Australia,AUS,5,0,35,5,45
2007,United Kingdom of Great Britain and Northern Ireland,GBR,Australia,AUS,0,0,5,0,5
2007,Ghana,GHA,Australia,AUS,0,0,10,0,10
2007,India,IND,Australia,AUS,16,0,271,38,325
2007,Indonesia,IDN,Australia,AUS,5,0,124,5,134
2007,Iran (Islamic Rep. of),IRN,Australia,AUS,14,0,5,0,19
2007,Iraq,IRQ,Australia,AUS,5,0,0,0,5
2007,Israel,ISR,Australia,AUS,5,0,10,0,15
2007,Jordan,JOR,Australia,AUS,0,0,5,0,5
2007,Kenya,KEN,Australia,AUS,0,0,5,0,5
2007,Kyrgyzstan,KGZ,Australia,AUS,5,0,0,0,5
2007,Rep. of Korea,KOR,Australia,AUS,0,0,39,0,39
2007,Dem. People's Rep. of Korea,PRK,Australia,AUS,0,0,5,0,5
2007,Lebanon,LBN,Australia,AUS,10,0,51,5,66
2007,Sri Lanka,LKA,Australia,AUS,42,0,38,0,80
2007,Lithuania,LTU,Australia,AUS,0,0,5,0,5
2007,North Macedonia,MKD,Australia,AUS,0,0,5,0,5
2007,Malaysia,MYS,Australia,AUS,0,0,68,12,80
2007,Mongolia,MNG,Australia,AUS,5,0,10,0,15
2007,Morocco,MAR,Australia,AUS,5,0,5,0,10
2007,Myanmar,MMR,Australia,AUS,10,0,10,0,20
2007,Nepal,NPL,Australia,AUS,15,0,43,5,63
2007,Nigeria,NGA,Australia,AUS,5,0,15,0,20
2007,Pakistan,PAK,Australia,AUS,14,0,36,5,55
2007,Philippines,PHL,Australia,AUS,0,0,35,5,40
2007,Papua New Guinea,PNG,Australia,AUS,0,0,5,0,5
2007,South Africa,ZAF,Australia,AUS,0,0,5,0,5
2007,Russian Federation,RUS,Australia,AUS,5,0,5,5,15
2007,Singapore,SGP,Australia,AUS,0,0,5,0,5
2007,Viet Nam,VNM,Australia,AUS,5,0,22,0,27
2007,Syrian Arab Rep.,SYR,Australia,AUS,0,0,10,0,10
2007,Thailand,THA,Australia,AUS,0,0,30,0,30
2007,Timor-Leste,TLS,Australia,AUS,5,0,10,0,15
2007,Tonga,TON,Australia,AUS,0,0,10,0,10
2007,Turkey,TUR,Australia,AUS,11,0,15,0,26
2007,Uganda,UGA,Australia,AUS,5,0,0,0,5
2007,Ukraine,UKR,Australia,AUS,0,0,10,0,10
2007,Zimbabwe,ZWE,Australia,AUS,10,0,10,0,20
2007,Afghanistan,AFG,Azerbaijan,AZE,0,0,10,0,10
2007,Iran (Islamic Rep. of),IRN,Azerbaijan,AZE,0,0,10,0,10
2007,Afghanistan,AFG,United Kingdom of Great Britain and Northern Ireland,GBR,205,0,1100,90,1395
2007,Albania,ALB,United Kingdom of Great Britain and Northern Ireland,GBR,30,0,50,0,80
2007,Algeria,DZA,United Kingdom of Great Britain and Northern Ireland,GBR,15,0,110,5,130
2007,Angola,AGO,United Kingdom of Great Britain and Northern Ireland,GBR,30,0,90,10,130
2007,Burundi,BDI,United Kingdom of Great Britain and Northern Ireland,GBR,20,0,45,5,70
2007,Bangladesh,BGD,United Kingdom of Great Britain and Northern Ireland,GBR,15,0,205,10,230
2007,China,CHN,United Kingdom of Great Britain and Northern Ireland,GBR,75,0,465,15,555
2007,Cameroon,CMR,United Kingdom of Great Britain and Northern Ireland,GBR,55,0,155,10,220
2007,Congo,COG,United Kingdom of Great Britain and Northern Ireland,GBR,20,0,55,10,85
2007,Dem. Rep. of the Congo,COD,United Kingdom of Great Britain and Northern Ireland,GBR,120,0,315,20,455
2007,Colombia,COL,United Kingdom of Great Britain and Northern Ireland,GBR,5,0,35,0,40
2007,Ecuador,ECU,United Kingdom of Great Britain and Northern Ireland,GBR,0,0,10,0,10
2007,Eritrea,ERI,United Kingdom of Great Britain and Northern Ireland,GBR,300,0,345,55,700
2007,Ethiopia,ETH,United Kingdom of Great Britain and Northern Ireland,GBR,45,0,95,10,150
2007,Gambia,GMB,United Kingdom of Great Britain and Northern Ireland,GBR,15,0,60,0,75
2007,Ghana,GHA,United Kingdom of Great Britain and Northern Ireland,GBR,5,0,55,0,60
2007,Cote d'Ivoire,CIV,United Kingdom of Great Britain and Northern Ireland,GBR,35,0,95,0,130
2007,India,IND,United Kingdom of Great Britain and Northern Ireland,GBR,10,0,45,15,70
2007,Iran (Islamic Rep. of),IRN,United Kingdom of Great Britain and Northern Ireland,GBR,325,0,1480,75,1880
2007,Iraq,IRQ,United Kingdom of Great Britain and Northern Ireland,GBR,245,0,855,65,1165
2007,Jamaica,JAM,United Kingdom of Great Britain and Northern Ireland,GBR,20,0,85,5,110
2007,Kenya,KEN,United Kingdom of Great Britain and Northern Ireland,GBR,20,0,100,5,125
2007,Liberia,LBR,United Kingdom of Great Britain and Northern Ireland,GBR,10,0,45,5,60
2007,Libya,LBY,United Kingdom of Great Britain and Northern Ireland,GBR,5,0,45,5,55
2007,Sri Lanka,LKA,United Kingdom of Great Britain and Northern Ireland,GBR,245,0,590,25,860
2007,Rep. of Moldova,MDA,United Kingdom of Great Britain and Northern Ireland,GBR,5,0,5,0,10
2007,Nigeria,NGA,United Kingdom of Great Britain and Northern Ireland,GBR,45,0,285,20,350
2007,Pakistan,PAK,United Kingdom of Great Britain and Northern Ireland,GBR,90,0,695,55,840
2007,Romania,ROU,United Kingdom of Great Britain and Northern Ireland,GBR,0,0,0,5,5
2007,Russian Federation,RUS,United Kingdom of Great Britain and Northern Ireland,GBR,25,0,60,5,90
2007,Rwanda,RWA,United Kingdom of Great Britain and Northern Ireland,GBR,10,0,40,5,55
2007,Serbia and Kosovo: S/RES/1244 (1999),SRB,United Kingdom of Great Britain and Northern Ireland,GBR,5,0,25,0,30
2007,Sierra Leone,SLE,United Kingdom of Great Britain and Northern Ireland,GBR,30,0,95,5,130
2007,Somalia,SOM,United Kingdom of Great Britain and Northern Ireland,GBR,445,0,375,60,880
2007,Viet Nam,VNM,United Kingdom of Great Britain and Northern Ireland,GBR,0,0,30,0,30
2007,Sudan,SDN,United Kingdom of Great Britain and Northern Ireland,GBR,125,0,210,25,360
2007,Syrian Arab Rep.,SYR,United Kingdom of Great Britain and Northern Ireland,GBR,35,0,85,5,125
2007,United Rep. of Tanzania,TZA,United Kingdom of Great Britain and Northern Ireland,GBR,0,0,15,0,15
2007,Turkey,TUR,United Kingdom of Great Britain and Northern Ireland,GBR,105,0,270,20,395
2007,Uganda,UGA,United Kingdom of Great Britain and Northern Ireland,GBR,30,0,115,15,160
2007,Ukraine,UKR,United Kingdom of Great Britain and Northern Ireland,GBR,10,0,15,0,25
2007,Zimbabwe,ZWE,United Kingdom of Great Britain and Northern Ireland,GBR,285,0,910,45,1240
2007,Unknown ,,United Kingdom of Great Britain and Northern Ireland,GBR,270,0,970,75,1315
2007,Unknown ,,Luxembourg,LUX,19,5,273,14,311
2008,Albania,ALB,Australia,AUS,5,0,5,0,10
2008,Egypt,EGY,Australia,AUS,10,0,18,0,28
2008,Bahrain,BHR,Australia,AUS,0,0,5,0,5
2008,Bangladesh,BGD,Australia,AUS,11,0,59,87,157
2008,China,CHN,Australia,AUS,203,0,676,47,926
2008,Chile,CHL,Australia,AUS,0,0,5,0,5
2008,Cameroon,CMR,Australia,AUS,5,0,0,0,5
2008,Colombia,COL,Australia,AUS,0,0,5,0,5
2008,Czechia,CZE,Australia,AUS,0,0,5,0,5
2008,Ethiopia,ETH,Australia,AUS,5,0,11,0,16
2008,Fiji,FJI,Australia,AUS,5,0,28,5,38
2008,Palestinian,PSE,Australia,AUS,5,0,0,0,5
2008,United Kingdom of Great Britain and Northern Ireland,GBR,Australia,AUS,0,0,5,0,5
2008,Georgia,GEO,Australia,AUS,0,0,5,0,5
2008,Ghana,GHA,Australia,AUS,5,0,10,0,15
2008,India,IND,Australia,AUS,12,0,148,41,201
2008,Indonesia,IDN,Australia,AUS,10,0,134,17,161
2008,Iran (Islamic Rep. of),IRN,Australia,AUS,10,0,11,0,21
2008,Iraq,IRQ,Australia,AUS,5,0,0,0,5
2008,Israel,ISR,Australia,AUS,0,0,5,0,5
2008,Jordan,JOR,Australia,AUS,5,0,0,0,5
2008,Kenya,KEN,Australia,AUS,0,0,5,0,5
2008,Rep. of Korea,KOR,Australia,AUS,0,0,26,13,39
2008,Lebanon,LBN,Australia,AUS,21,0,39,5,65
2008,Sri Lanka,LKA,Australia,AUS,15,0,40,0,55
2008,North Macedonia,MKD,Australia,AUS,0,0,5,0,5
2008,Malaysia,MYS,Australia,AUS,10,0,140,10,160
2008,Mongolia,MNG,Australia,AUS,0,0,5,0,5
2008,Myanmar,MMR,Australia,AUS,5,0,5,0,10
2008,Nepal,NPL,Australia,AUS,17,0,18,5,40
2008,Nigeria,NGA,Australia,AUS,5,0,11,0,16
2008,Pakistan,PAK,Australia,AUS,15,0,35,10,60
2008,Philippines,PHL,Australia,AUS,5,0,15,0,20
2008,Papua New Guinea,PNG,Australia,AUS,0,0,5,0,5
2008,South Africa,ZAF,Australia,AUS,0,0,5,0,5
2008,Russian Federation,RUS,Australia,AUS,5,0,0,0,5
2008,Serbia and Kosovo: S/RES/1244 (1999),SRB,Australia,AUS,0,0,5,0,5
2008,Viet Nam,VNM,Australia,AUS,5,0,27,5,37
2008,Sudan,SDN,Australia,AUS,0,0,5,0,5
2008,Syrian Arab Rep.,SYR,Australia,AUS,5,0,0,0,5
2008,United Rep. of Tanzania,TZA,Australia,AUS,0,0,5,0,5
2008,Thailand,THA,Australia,AUS,0,0,10,0,10
2008,Tonga,TON,Australia,AUS,0,0,5,0,5
2008,Turkey,TUR,Australia,AUS,10,0,10,0,20
2008,Uganda,UGA,Australia,AUS,0,0,5,0,5
2008,Ukraine,UKR,Australia,AUS,0,0,5,0,5
2008,United States of America,USA,Australia,AUS,0,0,5,0,5
2008,Uzbekistan,UZB,Australia,AUS,0,0,5,0,5
2008,Samoa,WSM,Australia,AUS,0,0,5,0,5
2008,Zimbabwe,ZWE,Australia,AUS,22,0,10,0,32
2008,Afghanistan,AFG,Azerbaijan,AZE,0,0,14,0,14
2008,Afghanistan,AFG,United Kingdom of Great Britain and Northern Ireland,GBR,165,0,635,65,865
2008,Albania,ALB,United Kingdom of Great Britain and Northern Ireland,GBR,15,0,30,10,55
2008,Algeria,DZA,United Kingdom of Great Britain and Northern Ireland,GBR,10,0,75,10,95
2008,Angola,AGO,United Kingdom of Great Britain and Northern Ireland,GBR,10,0,35,10,55
2008,Burundi,BDI,United Kingdom of Great Britain and Northern Ireland,GBR,5,0,10,5,20
2008,Bangladesh,BGD,United Kingdom of Great Britain and Northern Ireland,GBR,25,0,145,10,180
2008,China,CHN,United Kingdom of Great Britain and Northern Ireland,GBR,45,0,310,10,365
2008,Cameroon,CMR,United Kingdom of Great Britain and Northern Ireland,GBR,25,0,55,10,90
2008,Congo,COG,United Kingdom of Great Britain and Northern Ireland,GBR,20,0,50,5,75
2008,Dem. Rep. of the Congo,COD,United Kingdom of Great Britain and Northern Ireland,GBR,35,0,95,15,145
2008,Colombia,COL,United Kingdom of Great Britain and Northern Ireland,GBR,5,0,5,0,10
2008,Ecuador,ECU,United Kingdom of Great Britain and Northern Ireland,GBR,5,0,5,0,10
2008,Eritrea,ERI,United Kingdom of Great Britain and Northern Ireland,GBR,160,0,160,35,355
2008,Ethiopia,ETH,United Kingdom of Great Britain and Northern Ireland,GBR,15,0,35,5,55
2008,Gambia,GMB,United Kingdom of Great Britain and Northern Ireland,GBR,10,0,35,0,45
2008,Ghana,GHA,United Kingdom of Great Britain and Northern Ireland,GBR,0,0,35,0,35
2008,Cote d'Ivoire,CIV,United Kingdom of Great Britain and Northern Ireland,GBR,10,0,35,0,45
2008,India,IND,United Kingdom of Great Britain and Northern Ireland,GBR,5,0,25,10,40
2008,Iran (Islamic Rep. of),IRN,United Kingdom of Great Britain and Northern Ireland,GBR,240,0,880,35,1155
2008,Iraq,IRQ,United Kingdom of Great Britain and Northern Ireland,GBR,165,0,735,40,940
2008,Jamaica,JAM,United Kingdom of Great Britain and Northern Ireland,GBR,10,0,45,5,60
2008,Kenya,KEN,United Kingdom of Great Britain and Northern Ireland,GBR,10,0,55,5,70
2008,Liberia,LBR,United Kingdom of Great Britain and Northern Ireland,GBR,0,0,10,0,10
2008,Libya,LBY,United Kingdom of Great Britain and Northern Ireland,GBR,5,0,15,0,20
2008,Sri Lanka,LKA,United Kingdom of Great Britain and Northern Ireland,GBR,225,0,450,20,695
2008,North Macedonia,MKD,United Kingdom of Great Britain and Northern Ireland,GBR,0,0,5,0,5
2008,Rep. of Moldova,MDA,United Kingdom of Great Britain and Northern Ireland,GBR,0,0,5,0,5
2008,Nigeria,NGA,United Kingdom of Great Britain and Northern Ireland,GBR,35,0,240,15,290
2008,Pakistan,PAK,United Kingdom of Great Britain and Northern Ireland,GBR,80,0,600,50,730
2008,Russian Federation,RUS,United Kingdom of Great Britain and Northern Ireland,GBR,5,0,20,5,30
2008,Rwanda,RWA,United Kingdom of Great Britain and Northern Ireland,GBR,5,0,15,0,20
2008,Sierra Leone,SLE,United Kingdom of Great Britain and Northern Ireland,GBR,5,0,30,5,40
2008,Somalia,SOM,United Kingdom of Great Britain and Northern Ireland,GBR,215,0,265,55,535
2008,Viet Nam,VNM,United Kingdom of Great Britain and Northern Ireland,GBR,5,0,15,0,20
2008,Sudan,SDN,United Kingdom of Great Britain and Northern Ireland,GBR,40,0,80,5,125
2008,Syrian Arab Rep.,SYR,United Kingdom of Great Britain and Northern Ireland,GBR,30,0,55,5,90
2008,United Rep. of Tanzania,TZA,United Kingdom of Great Britain and Northern Ireland,GBR,0,0,15,0,15
2008,Turkey,TUR,United Kingdom of Great Britain and Northern Ireland,GBR,50,0,100,5,155
2008,Uganda,UGA,United Kingdom of Great Britain and Northern Ireland,GBR,20,0,70,5,95
2008,Ukraine,UKR,United Kingdom of Great Britain and Northern Ireland,GBR,0,0,5,0,5
2008,Zimbabwe,ZWE,United Kingdom of Great Britain and Northern Ireland,GBR,585,0,1480,135,2200
2008,Unknown ,,United Kingdom of Great Britain and Northern Ireland,GBR,180,0,605,65,850
2008,Unknown ,,Luxembourg,LUX,20,0,183,17,220
2009,Albania,ALB,Australia,AUS,5,0,5,0,10
2009,Egypt,EGY,Australia,AUS,14,0,16,5,35
2009,Bangladesh,BGD,Australia,AUS,10,0,55,22,87
2009,Cambodia,KHM,Australia,AUS,0,0,5,0,5
2009,China,CHN,Australia,AUS,220,0,667,32,919
2009,Cameroon,CMR,Australia,AUS,5,0,5,0,10
2009,Colombia,COL,Australia,AUS,0,0,5,0,5
2009,Ethiopia,ETH,Australia,AUS,14,0,5,0,19
2009,Fiji,FJI,Australia,AUS,11,0,53,11,75
2009,Ghana,GHA,Australia,AUS,5,0,16,0,21
2009,India,IND,Australia,AUS,10,0,224,14,248
2009,Indonesia,IDN,Australia,AUS,10,0,95,14,119
2009,Iran (Islamic Rep. of),IRN,Australia,AUS,15,0,5,0,20
2009,Iraq,IRQ,Australia,AUS,5,0,5,0,10
2009,Israel,ISR,Australia,AUS,0,0,10,0,10
2009,Jordan,JOR,Australia,AUS,10,0,5,0,15
2009,Kenya,KEN,Australia,AUS,11,0,14,0,25
2009,Rep. of Korea,KOR,Australia,AUS,0,0,44,5,49
2009,Lebanon,LBN,Australia,AUS,24,0,51,0,75
2009,Sri Lanka,LKA,Australia,AUS,26,0,41,5,72
2009,North Macedonia,MKD,Australia,AUS,0,0,5,0,5
2009,Malaysia,MYS,Australia,AUS,10,0,136,14,160
2009,Mongolia,MNG,Australia,AUS,5,0,0,0,5
2009,Myanmar,MMR,Australia,AUS,11,0,5,0,16
2009,Nepal,NPL,Australia,AUS,5,0,19,0,24
2009,Nigeria,NGA,Australia,AUS,5,0,15,0,20
2009,New Zealand,NZL,Australia,AUS,0,0,5,0,5
2009,Pakistan,PAK,Australia,AUS,14,0,40,0,54
2009,Philippines,PHL,Australia,AUS,0,0,14,0,14
2009,Papua New Guinea,PNG,Australia,AUS,0,0,5,0,5
2009,South Africa,ZAF,Australia,AUS,0,0,5,0,5
2009,Russian Federation,RUS,Australia,AUS,0,0,5,0,5
2009,Rwanda,RWA,Australia,AUS,5,0,0,0,5
2009,Somalia,SOM,Australia,AUS,5,0,0,0,5
2009,Viet Nam,VNM,Australia,AUS,0,0,20,0,20
2009,Syrian Arab Rep.,SYR,Australia,AUS,5,0,0,0,5
2009,Togo,TGO,Australia,AUS,5,0,5,0,10
2009,Tonga,TON,Australia,AUS,0,0,10,0,10
2009,Turkey,TUR,Australia,AUS,10,0,5,0,15
2009,Uganda,UGA,Australia,AUS,5,0,5,0,10
2009,United States of America,USA,Australia,AUS,0,0,5,0,5
2009,Zimbabwe,ZWE,Australia,AUS,27,0,17,5,49
2009,Stateless,XXA,Australia,AUS,0,0,5,0,5
2009,Unknown ,,Australia,AUS,0,0,16,0,16
2009,Afghanistan,AFG,Azerbaijan,AZE,0,0,53,0,53
2009,Iran (Islamic Rep. of),IRN,Azerbaijan,AZE,0,0,11,0,11
2009,Pakistan,PAK,Azerbaijan,AZE,0,0,34,0,34
2009,Afghanistan,AFG,United Kingdom of Great Britain and Northern Ireland,GBR,330,0,1145,100,1575
2009,Albania,ALB,United Kingdom of Great Britain and Northern Ireland,GBR,15,0,45,5,65
2009,Algeria,DZA,United Kingdom of Great Britain and Northern Ireland,GBR,5,0,70,5,80
2009,Angola,AGO,United Kingdom of Great Britain and Northern Ireland,GBR,10,0,30,0,40
2009,Burundi,BDI,United Kingdom of Great Britain and Northern Ireland,GBR,0,0,10,0,10
2009,Bangladesh,BGD,United Kingdom of Great Britain and Northern Ireland,GBR,15,0,190,15,220
2009,China,CHN,United Kingdom of Great Britain and Northern Ireland,GBR,65,0,395,5,465
2009,Cameroon,CMR,United Kingdom of Great Britain and Northern Ireland,GBR,25,0,40,0,65
2009,Congo,COG,United Kingdom of Great Britain and Northern Ireland,GBR,20,0,60,5,85
2009,Dem. Rep. of the Congo,COD,United Kingdom of Great Britain and Northern Ireland,GBR,30,0,110,15,155
2009,Colombia,COL,United Kingdom of Great Britain and Northern Ireland,GBR,5,0,5,0,10
2009,Eritrea,ERI,United Kingdom of Great Britain and Northern Ireland,GBR,185,0,260,25,470
2009,Ethiopia,ETH,United Kingdom of Great Britain and Northern Ireland,GBR,15,0,40,0,55
2009,Gambia,GMB,United Kingdom of Great Britain and Northern Ireland,GBR,20,0,75,5,100
2009,Ghana,GHA,United Kingdom of Great Britain and Northern Ireland,GBR,10,0,30,0,40
2009,Cote d'Ivoire,CIV,United Kingdom of Great Britain and Northern Ireland,GBR,5,0,25,0,30
2009,India,IND,United Kingdom of Great Britain and Northern Ireland,GBR,15,0,35,10,60
2009,Iran (Islamic Rep. of),IRN,United Kingdom of Great Britain and Northern Ireland,GBR,390,0,1135,45,1570
2009,Iraq,IRQ,United Kingdom of Great Britain and Northern Ireland,GBR,155,0,840,40,1035
2009,Jamaica,JAM,United Kingdom of Great Britain and Northern Ireland,GBR,15,0,55,5,75
2009,Kenya,KEN,United Kingdom of Great Britain and Northern Ireland,GBR,15,0,35,0,50
2009,Liberia,LBR,United Kingdom of Great Britain and Northern Ireland,GBR,0,0,10,0,10
2009,Libya,LBY,United Kingdom of Great Britain and Northern Ireland,GBR,10,0,20,5,35
2009,Sri Lanka,LKA,United Kingdom of Great Britain and Northern Ireland,GBR,320,0,600,45,965
2009,Rep. of Moldova,MDA,United Kingdom of Great Britain and Northern Ireland,GBR,0,0,0,5,5
2009,Nigeria,NGA,United Kingdom of Great Britain and Northern Ireland,GBR,35,0,215,10,260
2009,Pakistan,PAK,United Kingdom of Great Britain and Northern Ireland,GBR,120,0,845,40,1005
2009,Russian Federation,RUS,United Kingdom of Great Britain and Northern Ireland,GBR,10,0,30,0,40
2009,Rwanda,RWA,United Kingdom of Great Britain and Northern Ireland,GBR,5,0,10,5,20
2009,Sierra Leone,SLE,United Kingdom of Great Britain and Northern Ireland,GBR,5,0,35,5,45
2009,Somalia,SOM,United Kingdom of Great Britain and Northern Ireland,GBR,230,0,230,30,490
2009,Viet Nam,VNM,United Kingdom of Great Britain and Northern Ireland,GBR,10,0,15,0,25
2009,Sudan,SDN,United Kingdom of Great Britain and Northern Ireland,GBR,35,0,65,25,125
2009,Syrian Arab Rep.,SYR,United Kingdom of Great Britain and Northern Ireland,GBR,20,0,50,0,70
2009,United Rep. of Tanzania,TZA,United Kingdom of Great Britain and Northern Ireland,GBR,0,0,15,0,15
2009,Turkey,TUR,United Kingdom of Great Britain and Northern Ireland,GBR,40,0,75,5,120
2009,Uganda,UGA,United Kingdom of Great Britain and Northern Ireland,GBR,20,0,90,10,120
2009,Ukraine,UKR,United Kingdom of Great Britain and Northern Ireland,GBR,0,0,15,0,15
2009,Zimbabwe,ZWE,United Kingdom of Great Britain and Northern Ireland,GBR,1690,0,2010,200,3900
2009,Unknown ,,United Kingdom of Great Britain and Northern Ireland,GBR,255,0,735,80,1070
2009,Iran (Islamic Rep. of),IRN,Luxembourg,LUX,5,0,0,0,5
2009,Serbia and Kosovo: S/RES/1244 (1999),SRB,Luxembourg,LUX,10,5,0,0,15
2010,Afghanistan,AFG,Australia,AUS,10,0,5,0,15
2010,Albania,ALB,Australia,AUS,0,0,10,0,10
2010,Egypt,EGY,Australia,AUS,21,0,30,0,51
2010,Bangladesh,BGD,Australia,AUS,10,0,24,5,39
2010,China,CHN,Australia,AUS,172,0,587,45,804
2010,Cameroon,CMR,Australia,AUS,0,0,5,0,5
2010,Colombia,COL,Australia,AUS,5,0,10,0,15
2010,Ethiopia,ETH,Australia,AUS,10,0,5,0,15
2010,Fiji,FJI,Australia,AUS,45,0,237,40,322
2010,Palestinian,PSE,Australia,AUS,5,0,0,0,5
2010,Ghana,GHA,Australia,AUS,0,0,10,0,10
2010,India,IND,Australia,AUS,15,0,148,5,168
2010,Indonesia,IDN,Australia,AUS,5,0,91,10,106
2010,Iran (Islamic Rep. of),IRN,Australia,AUS,26,0,10,0,36
2010,Iraq,IRQ,Australia,AUS,10,0,0,0,10
2010,Israel,ISR,Australia,AUS,0,0,5,0,5
2010,Jordan,JOR,Australia,AUS,0,0,5,0,5
2010,Kenya,KEN,Australia,AUS,0,0,5,0,5
2010,Rep. of Korea,KOR,Australia,AUS,5,0,26,0,31
2010,Dem. People's Rep. of Korea,PRK,Australia,AUS,11,0,0,0,11
2010,Liberia,LBR,Australia,AUS,5,0,0,0,5
2010,Lebanon,LBN,Australia,AUS,25,0,64,0,89
2010,Sri Lanka,LKA,Australia,AUS,29,0,24,5,58
2010,North Macedonia,MKD,Australia,AUS,0,0,5,0,5
2010,Malaysia,MYS,Australia,AUS,5,0,218,10,233
2010,Mongolia,MNG,Australia,AUS,0,0,10,0,10
2010,Myanmar,MMR,Australia,AUS,13,0,5,0,18
2010,Nepal,NPL,Australia,AUS,10,0,26,5,41
2010,Nigeria,NGA,Australia,AUS,5,0,11,0,16
2010,New Zealand,NZL,Australia,AUS,0,0,5,0,5
2010,Pakistan,PAK,Australia,AUS,19,0,29,0,48
2010,Philippines,PHL,Australia,AUS,0,0,45,0,45
2010,Papua New Guinea,PNG,Australia,AUS,0,0,5,0,5
2010,Romania,ROU,Australia,AUS,0,0,5,0,5
2010,South Africa,ZAF,Australia,AUS,5,0,5,0,10
2010,Serbia and Kosovo: S/RES/1244 (1999),SRB,Australia,AUS,0,0,5,0,5
2010,Singapore,SGP,Australia,AUS,0,0,5,0,5
2010,Sierra Leone,SLE,Australia,AUS,0,0,5,0,5
2010,Somalia,SOM,Australia,AUS,5,0,0,0,5
2010,Viet Nam,VNM,Australia,AUS,0,0,15,0,15
2010,United Rep. of Tanzania,TZA,Australia,AUS,5,0,0,0,5
2010,Thailand,THA,Australia,AUS,0,0,5,5,10
2010,Tonga,TON,Australia,AUS,0,0,19,0,19
2010,Turkey,TUR,Australia,AUS,13,0,10,0,23
2010,Ukraine,UKR,Australia,AUS,0,0,5,0,5
2010,Uzbekistan,UZB,Australia,AUS,5,0,5,0,10
2010,Zimbabwe,ZWE,Australia,AUS,36,0,25,0,61
2010,Stateless,XXA,Australia,AUS,0,0,5,0,5
2010,Afghanistan,AFG,Azerbaijan,AZE,0,0,40,0,40
2010,Iran (Islamic Rep. of),IRN,Azerbaijan,AZE,0,0,5,0,5
2010,Iraq,IRQ,Azerbaijan,AZE,0,0,15,0,15
2011,Afghanistan,AFG,Australia,AUS,10,0,5,0,15
2011,Albania,ALB,Australia,AUS,10,0,5,0,15
2011,Egypt,EGY,Australia,AUS,126,0,90,12,228
2011,Bangladesh,BGD,Australia,AUS,19,0,67,5,91
2011,Brazil,BRA,Australia,AUS,0,0,5,0,5
2011,China,CHN,Australia,AUS,209,0,593,40,842
2011,Dem. Rep. of the Congo,COD,Australia,AUS,5,0,0,0,5
2011,Colombia,COL,Australia,AUS,13,0,5,0,18
2011,Ethiopia,ETH,Australia,AUS,5,0,5,0,10
2011,Fiji,FJI,Australia,AUS,44,0,198,20,262
2011,Palestinian,PSE,Australia,AUS,13,0,0,0,13
2011,Ghana,GHA,Australia,AUS,0,0,10,0,10
2011,India,IND,Australia,AUS,17,0,205,26,248
2011,Indonesia,IDN,Australia,AUS,5,0,137,5,147
2011,Iran (Islamic Rep. of),IRN,Australia,AUS,55,0,12,5,72
2011,Iraq,IRQ,Australia,AUS,43,0,0,5,48
2011,Jordan,JOR,Australia,AUS,5,0,10,0,15
2011,Kazakhstan,KAZ,Australia,AUS,5,0,0,0,5
2011,Kenya,KEN,Australia,AUS,5,0,5,0,10
2011,Rep. of Korea,KOR,Australia,AUS,5,0,58,0,63
2011,Dem. People's Rep. of Korea,PRK,Australia,AUS,5,0,0,0,5
2011,Kuwait,KWT,Australia,AUS,5,0,0,0,5
2011,Libya,LBY,Australia,AUS,5,0,0,0,5
2011,Lebanon,LBN,Australia,AUS,42,0,68,5,115
2011,Sri Lanka,LKA,Australia,AUS,38,0,52,10,100
2011,Lithuania,LTU,Australia,AUS,0,0,5,0,5
2011,Malaysia,MYS,Australia,AUS,0,0,108,10,118
2011,Mongolia,MNG,Australia,AUS,0,0,5,0,5
2011,Mauritius,MUS,Australia,AUS,0,0,10,10,20
2011,Myanmar,MMR,Australia,AUS,14,0,5,0,19
2011,Nepal,NPL,Australia,AUS,15,0,73,5,93
2011,Nigeria,NGA,Australia,AUS,5,0,14,0,19
2011,Pakistan,PAK,Australia,AUS,48,0,62,5,115
2011,Peru,PER,Australia,AUS,0,0,5,0,5
2011,Philippines,PHL,Australia,AUS,5,0,38,0,43
2011,Papua New Guinea,PNG,Australia,AUS,0,0,17,0,17
2011,Poland,POL,Australia,AUS,0,0,5,0,5
2011,South Africa,ZAF,Australia,AUS,5,0,10,0,15
2011,Russian Federation,RUS,Australia,AUS,5,0,5,0,10
2011,El Salvador,SLV,Australia,AUS,0,0,5,0,5
2011,Sierra Leone,SLE,Australia,AUS,5,0,0,0,5
2011,Solomon Islands,SLB,Australia,AUS,0,0,5,0,5
2011,Viet Nam,VNM,Australia,AUS,5,0,61,5,71
2011,Sudan,SDN,Australia,AUS,0,0,0,5,5
2011,Syrian Arab Rep.,SYR,Australia,AUS,10,0,5,0,15
2011,Thailand,THA,Australia,AUS,0,0,11,5,16
2011,Timor-Leste,TLS,Australia,AUS,0,0,5,0,5
2011,Tonga,TON,Australia,AUS,0,0,23,0,23
2011,Turkey,TUR,Australia,AUS,27,0,14,0,41
2011,United Arab Emirates,ARE,Australia,AUS,0,0,5,0,5
2011,Uganda,UGA,Australia,AUS,5,0,0,0,5
2011,Ukraine,UKR,Australia,AUS,5,0,5,0,10
2011,United States of America,USA,Australia,AUS,0,0,10,0,10
2011,Zimbabwe,ZWE,Australia,AUS,42,0,25,0,67
2011,Stateless,XXA,Australia,AUS,10,0,5,0,15
2011,Afghanistan,AFG,Azerbaijan,AZE,0,0,5,0,5
2011,Unknown ,,Belgium,BEL,347,52,9840,0,10239
2011,Afghanistan,AFG,United Kingdom of Great Britain and Northern Ireland,GBR,198,0,816,69,1083
2011,Albania,ALB,United Kingdom of Great Britain and Northern Ireland,GBR,27,0,65,5,97
2011,Algeria,DZA,United Kingdom of Great Britain and Northern Ireland,GBR,16,0,100,10,126
2011,Angola,AGO,United Kingdom of Great Britain and Northern Ireland,GBR,10,0,20,5,35
2011,Egypt,EGY,United Kingdom of Great Britain and Northern Ireland,GBR,17,0,42,5,64
2011,Armenia,ARM,United Kingdom of Great Britain and Northern Ireland,GBR,5,0,5,5,15
2011,Azerbaijan,AZE,United Kingdom of Great Britain and Northern Ireland,GBR,0,0,5,0,5
2011,Bahrain,BHR,United Kingdom of Great Britain and Northern Ireland,GBR,10,0,5,5,20
2011,Burundi,BDI,United Kingdom of Great Britain and Northern Ireland,GBR,0,0,5,0,5
2011,Bangladesh,BGD,United Kingdom of Great Britain and Northern Ireland,GBR,23,0,205,12,240
2011,Bhutan,BTN,United Kingdom of Great Britain and Northern Ireland,GBR,0,0,5,0,5
2011,Belarus,BLR,United Kingdom of Great Britain and Northern Ireland,GBR,5,0,5,0,10
2011,Botswana,BWA,United Kingdom of Great Britain and Northern Ireland,GBR,0,0,10,0,10
2011,Brazil,BRA,United Kingdom of Great Britain and Northern Ireland,GBR,0,0,5,0,5
2011,Chad,TCD,United Kingdom of Great Britain and Northern Ireland,GBR,0,0,5,0,5
2011,China,CHN,United Kingdom of Great Britain and Northern Ireland,GBR,91,0,406,40,537
2011,Cameroon,CMR,United Kingdom of Great Britain and Northern Ireland,GBR,15,0,26,5,46
2011,Congo,COG,United Kingdom of Great Britain and Northern Ireland,GBR,0,0,10,0,10
2011,Dem. Rep. of the Congo,COD,United Kingdom of Great Britain and Northern Ireland,GBR,47,0,78,11,136
2011,Colombia,COL,United Kingdom of Great Britain and Northern Ireland,GBR,5,0,10,0,15
2011,Cuba,CUB,United Kingdom of Great Britain and Northern Ireland,GBR,0,0,5,0,5
2011,Ecuador,ECU,United Kingdom of Great Britain and Northern Ireland,GBR,0,0,5,0,5
2011,Eritrea,ERI,United Kingdom of Great Britain and Northern Ireland,GBR,102,0,106,11,219
2011,Ethiopia,ETH,United Kingdom of Great Britain and Northern Ireland,GBR,22,0,40,5,67
2011,Gambia,GMB,United Kingdom of Great Britain and Northern Ireland,GBR,33,0,91,5,129
2011,Palestinian,PSE,United Kingdom of Great Britain and Northern Ireland,GBR,17,0,99,5,121
2011,Georgia,GEO,United Kingdom of Great Britain and Northern Ireland,GBR,5,0,17,0,22
2011,Ghana,GHA,United Kingdom of Great Britain and Northern Ireland,GBR,10,0,45,0,55
2011,Grenada,GRD,United Kingdom of Great Britain and Northern Ireland,GBR,0,0,5,0,5
2011,Guinea,GIN,United Kingdom of Great Britain and Northern Ireland,GBR,5,0,36,0,41
2011,Cote d'Ivoire,CIV,United Kingdom of Great Britain and Northern Ireland,GBR,24,0,72,5,101
2011,India,IND,United Kingdom of Great Britain and Northern Ireland,GBR,16,0,85,10,111
2011,Iran (Islamic Rep. of),IRN,United Kingdom of Great Britain and Northern Ireland,GBR,376,0,800,75,1251
2011,Iraq,IRQ,United Kingdom of Great Britain and Northern Ireland,GBR,66,0,210,27,303
2011,Jamaica,JAM,United Kingdom of Great Britain and Northern Ireland,GBR,22,0,44,5,71
2011,Jordan,JOR,United Kingdom of Great Britain and Northern Ireland,GBR,0,0,5,0,5
2011,Kenya,KEN,United Kingdom of Great Britain and Northern Ireland,GBR,11,0,47,0,58
2011,Kyrgyzstan,KGZ,United Kingdom of Great Britain and Northern Ireland,GBR,0,0,5,0,5
2011,Dem. People's Rep. of Korea,PRK,United Kingdom of Great Britain and Northern Ireland,GBR,10,0,10,5,25
2011,Kuwait,KWT,United Kingdom of Great Britain and Northern Ireland,GBR,13,0,17,0,30
2011,Liberia,LBR,United Kingdom of Great Britain and Northern Ireland,GBR,0,0,5,0,5
2011,Libya,LBY,United Kingdom of Great Britain and Northern Ireland,GBR,92,0,247,45,384
2011,Lebanon,LBN,United Kingdom of Great Britain and Northern Ireland,GBR,5,0,23,5,33
2011,Sri Lanka,LKA,United Kingdom of Great Britain and Northern Ireland,GBR,467,0,751,46,1264
2011,Mexico,MEX,United Kingdom of Great Britain and Northern Ireland,GBR,0,0,5,0,5
2011,Malaysia,MYS,United Kingdom of Great Britain and Northern Ireland,GBR,5,0,16,0,21
2011,Malawi,MWI,United Kingdom of Great Britain and Northern Ireland,GBR,17,0,51,5,73
2011,Mongolia,MNG,United Kingdom of Great Britain and Northern Ireland,GBR,5,0,12,0,17
2011,Morocco,MAR,United Kingdom of Great Britain and Northern Ireland,GBR,5,0,16,0,21
2011,Mauritius,MUS,United Kingdom of Great Britain and Northern Ireland,GBR,5,0,10,0,15
2011,Myanmar,MMR,United Kingdom of Great Britain and Northern Ireland,GBR,64,0,34,5,103
2011,Namibia,NAM,United Kingdom of Great Britain and Northern Ireland,GBR,0,0,10,0,10
2011,Nepal,NPL,United Kingdom of Great Britain and Northern Ireland,GBR,0,0,18,0,18
2011,Niger,NER,United Kingdom of Great Britain and Northern Ireland,GBR,0,0,5,0,5
2011,Nigeria,NGA,United Kingdom of Great Britain and Northern Ireland,GBR,64,0,256,19,339
2011,Pakistan,PAK,United Kingdom of Great Britain and Northern Ireland,GBR,201,0,997,63,1261
2011,Philippines,PHL,United Kingdom of Great Britain and Northern Ireland,GBR,0,0,5,0,5
2011,South Africa,ZAF,United Kingdom of Great Britain and Northern Ireland,GBR,13,0,39,5,57
2011,Russian Federation,RUS,United Kingdom of Great Britain and Northern Ireland,GBR,13,0,18,5,36
2011,Rwanda,RWA,United Kingdom of Great Britain and Northern Ireland,GBR,5,0,5,0,10
2011,Serbia and Kosovo: S/RES/1244 (1999),SRB,United Kingdom of Great Britain and Northern Ireland,GBR,5,0,5,0,10
2011,Senegal,SEN,United Kingdom of Great Britain and Northern Ireland,GBR,0,0,24,0,24
2011,Sierra Leone,SLE,United Kingdom of Great Britain and Northern Ireland,GBR,10,0,35,5,50
2011,Somalia,SOM,United Kingdom of Great Britain and Northern Ireland,GBR,114,0,80,21,215
2011,Viet Nam,VNM,United Kingdom of Great Britain and Northern Ireland,GBR,20,0,39,5,64
2011,Sudan,SDN,United Kingdom of Great Britain and Northern Ireland,GBR,50,0,65,14,129
2011,Eswatini,SWZ,United Kingdom of Great Britain and Northern Ireland,GBR,0,0,5,0,5
2011,Syrian Arab Rep.,SYR,United Kingdom of Great Britain and Northern Ireland,GBR,47,0,64,10,121
2011,United Rep. of Tanzania,TZA,United Kingdom of Great Britain and Northern Ireland,GBR,0,0,20,0,20
2011,Togo,TGO,United Kingdom of Great Britain and Northern Ireland,GBR,5,0,5,0,10
2011,Trinidad and Tobago,TTO,United Kingdom of Great Britain and Northern Ireland,GBR,0,0,5,0,5
2011,Tunisia,TUN,United Kingdom of Great Britain and Northern Ireland,GBR,5,0,16,0,21
2011,Turkey,TUR,United Kingdom of Great Britain and Northern Ireland,GBR,31,0,64,5,100
2011,Uganda,UGA,United Kingdom of Great Britain and Northern Ireland,GBR,37,0,89,11,137
2011,Ukraine,UKR,United Kingdom of Great Britain and Northern Ireland,GBR,0,0,5,0,5
2011,Uzbekistan,UZB,United Kingdom of Great Britain and Northern Ireland,GBR,0,0,5,0,5
2011,Saint Vincent and the Grenadines,VCT,United Kingdom of Great Britain and Northern Ireland,GBR,0,0,5,0,5
2011,Venezuela (Bolivarian Republic of),VEN,United Kingdom of Great Britain and Northern Ireland,GBR,0,0,5,0,5
2011,Western Sahara,ESH,United Kingdom of Great Britain and Northern Ireland,GBR,0,0,5,0,5
2011,Yemen,YEM,United Kingdom of Great Britain and Northern Ireland,GBR,11,0,10,0,21
2011,Zambia,ZMB,United Kingdom of Great Britain and Northern Ireland,GBR,5,0,5,0,10
2011,Zimbabwe,ZWE,United Kingdom of Great Britain and Northern Ireland,GBR,205,0,364,34,603
2011,Stateless,XXA,United Kingdom of Great Britain and Northern Ireland,GBR,49,0,52,5,106
2011,Unknown ,,United Kingdom of Great Britain and Northern Ireland,GBR,0,0,5,0,5
2012,Afghanistan,AFG,Australia,AUS,729,0,108,0,837
2012,Albania,ALB,Australia,AUS,5,0,19,0,24
2012,Algeria,DZA,Australia,AUS,0,0,5,0,5
2012,Egypt,EGY,Australia,AUS,125,0,78,5,208
2012,Bahrain,BHR,Australia,AUS,5,0,5,0,10
2012,Burundi,BDI,Australia,AUS,5,0,0,0,5
2012,Bangladesh,BGD,Australia,AUS,11,0,42,0,53
2012,Brazil,BRA,Australia,AUS,0,0,10,0,10
2012,Cambodia,KHM,Australia,AUS,5,0,14,0,19
2012,China,CHN,Australia,AUS,151,0,631,42,824
2012,Cameroon,CMR,Australia,AUS,0,0,5,0,5
2012,Colombia,COL,Australia,AUS,20,0,11,0,31
2012,Ethiopia,ETH,Australia,AUS,10,0,5,0,15
2012,Fiji,FJI,Australia,AUS,41,0,92,10,143
2012,United Kingdom of Great Britain and Northern Ireland,GBR,Australia,AUS,0,0,5,0,5
2012,Georgia,GEO,Australia,AUS,0,0,5,0,5
2012,Ghana,GHA,Australia,AUS,0,0,12,0,12
2012,India,IND,Australia,AUS,40,0,463,44,547
2012,Indonesia,IDN,Australia,AUS,5,0,99,0,104
2012,Iran (Islamic Rep. of),IRN,Australia,AUS,746,0,443,5,1194
2012,Iraq,IRQ,Australia,AUS,175,0,67,0,242
2012,Israel,ISR,Australia,AUS,5,0,0,0,5
2012,Jordan,JOR,Australia,AUS,5,0,10,5,20
2012,Japan,JPN,Australia,AUS,0,0,5,0,5
2012,Kenya,KEN,Australia,AUS,10,0,11,0,21
2012,Rep. of Korea,KOR,Australia,AUS,0,0,35,10,45
2012,Kuwait,KWT,Australia,AUS,5,0,0,0,5
2012,Libya,LBY,Australia,AUS,18,0,16,0,34
2012,Lebanon,LBN,Australia,AUS,39,0,68,5,112
2012,Sri Lanka,LKA,Australia,AUS,220,0,151,5,376
2012,Lithuania,LTU,Australia,AUS,0,0,5,0,5
2012,North Macedonia,MKD,Australia,AUS,0,0,5,0,5
2012,Malaysia,MYS,Australia,AUS,13,0,100,17,130
2012,Mongolia,MNG,Australia,AUS,5,0,5,0,10
2012,Morocco,MAR,Australia,AUS,5,0,0,0,5
2012,Mauritius,MUS,Australia,AUS,0,0,28,0,28
2012,Myanmar,MMR,Australia,AUS,10,0,5,0,15
2012,Nepal,NPL,Australia,AUS,17,0,186,10,213
2012,Nigeria,NGA,Australia,AUS,12,0,21,5,38
2012,New Zealand,NZL,Australia,AUS,0,0,10,0,10
2012,Pakistan,PAK,Australia,AUS,262,0,128,20,410
2012,Peru,PER,Australia,AUS,0,0,5,0,5
2012,Philippines,PHL,Australia,AUS,5,0,34,5,44
2012,Papua New Guinea,PNG,Australia,AUS,17,0,0,0,17
2012,Romania,ROU,Australia,AUS,0,0,5,5,10
2012,Russian Federation,RUS,Australia,AUS,5,0,5,0,10
2012,El Salvador,SLV,Australia,AUS,0,0,5,0,5
2012,Singapore,SGP,Australia,AUS,0,0,5,0,5
2012,Solomon Islands,SLB,Australia,AUS,0,0,5,0,5
2012,Viet Nam,VNM,Australia,AUS,28,0,95,0,123
2012,Sudan,SDN,Australia,AUS,5,0,0,0,5
2012,Syrian Arab Rep.,SYR,Australia,AUS,11,0,5,0,16
2012,Thailand,THA,Australia,AUS,0,0,5,0,5
2012,Tonga,TON,Australia,AUS,0,0,41,5,46
2012,Turkey,TUR,Australia,AUS,48,0,29,0,77
2012,Uganda,UGA,Australia,AUS,0,0,5,0,5
2012,Ukraine,UKR,Australia,AUS,0,0,5,5,10
2012,Zimbabwe,ZWE,Australia,AUS,45,0,45,5,95
2012,Stateless,XXA,Australia,AUS,238,0,62,0,300
2012,Afghanistan,AFG,United Kingdom of Great Britain and Northern Ireland,GBR,172,0,397,40,609
2012,Albania,ALB,United Kingdom of Great Britain and Northern Ireland,GBR,34,0,112,14,160
2012,Algeria,DZA,United Kingdom of Great Britain and Northern Ireland,GBR,10,0,66,0,76
2012,Angola,AGO,United Kingdom of Great Britain and Northern Ireland,GBR,5,0,10,5,20
2012,Egypt,EGY,United Kingdom of Great Britain and Northern Ireland,GBR,20,0,63,5,88
2012,Armenia,ARM,United Kingdom of Great Britain and Northern Ireland,GBR,0,0,5,0,5
2012,Bahrain,BHR,United Kingdom of Great Britain and Northern Ireland,GBR,0,0,5,0,5
2012,Burundi,BDI,United Kingdom of Great Britain and Northern Ireland,GBR,0,0,5,0,5
2012,Benin,BEN,United Kingdom of Great Britain and Northern Ireland,GBR,0,0,5,0,5
2012,Bangladesh,BGD,United Kingdom of Great Britain and Northern Ireland,GBR,25,0,283,10,318
2012,Belarus,BLR,United Kingdom of Great Britain and Northern Ireland,GBR,5,0,5,0,10
2012,Botswana,BWA,United Kingdom of Great Britain and Northern Ireland,GBR,0,0,10,0,10
2012,Central African Rep.,CAF,United Kingdom of Great Britain and Northern Ireland,GBR,0,0,5,0,5
2012,China,CHN,United Kingdom of Great Britain and Northern Ireland,GBR,47,0,270,12,329
2012,Cameroon,CMR,United Kingdom of Great Britain and Northern Ireland,GBR,11,0,38,5,54
2012,Congo,COG,United Kingdom of Great Britain and Northern Ireland,GBR,5,0,5,0,10
2012,Dem. Rep. of the Congo,COD,United Kingdom of Great Britain and Northern Ireland,GBR,32,0,48,5,85
2012,Colombia,COL,United Kingdom of Great Britain and Northern Ireland,GBR,0,0,5,0,5
2012,Eritrea,ERI,United Kingdom of Great Britain and Northern Ireland,GBR,48,0,51,5,104
2012,Ethiopia,ETH,United Kingdom of Great Britain and Northern Ireland,GBR,13,0,40,5,58
2012,Gambia,GMB,United Kingdom of Great Britain and Northern Ireland,GBR,39,0,100,5,144
2012,Palestinian,PSE,United Kingdom of Great Britain and Northern Ireland,GBR,13,0,57,5,75
2012,Georgia,GEO,United Kingdom of Great Britain and Northern Ireland,GBR,0,0,12,0,12
2012,Ghana,GHA,United Kingdom of Great Britain and Northern Ireland,GBR,13,0,43,5,61
2012,Guinea,GIN,United Kingdom of Great Britain and Northern Ireland,GBR,5,0,30,0,35
2012,Honduras,HND,United Kingdom of Great Britain and Northern Ireland,GBR,0,0,5,0,5
2012,Cote d'Ivoire,CIV,United Kingdom of Great Britain and Northern Ireland,GBR,5,0,26,0,31
2012,India,IND,United Kingdom of Great Britain and Northern Ireland,GBR,17,0,55,0,72
2012,Iran (Islamic Rep. of),IRN,United Kingdom of Great Britain and Northern Ireland,GBR,333,0,579,70,982
2012,Iraq,IRQ,United Kingdom of Great Britain and Northern Ireland,GBR,38,0,126,18,182
2012,Jamaica,JAM,United Kingdom of Great Britain and Northern Ireland,GBR,10,0,22,0,32
2012,Jordan,JOR,United Kingdom of Great Britain and Northern Ireland,GBR,0,0,12,0,12
2012,Kenya,KEN,United Kingdom of Great Britain and Northern Ireland,GBR,5,0,37,5,47
2012,Dem. People's Rep. of Korea,PRK,United Kingdom of Great Britain and Northern Ireland,GBR,5,0,5,0,10
2012,Kuwait,KWT,United Kingdom of Great Britain and Northern Ireland,GBR,10,0,27,0,37
2012,Liberia,LBR,United Kingdom of Great Britain and Northern Ireland,GBR,5,0,5,0,10
2012,Libya,LBY,United Kingdom of Great Britain and Northern Ireland,GBR,28,0,79,10,117
2012,Lebanon,LBN,United Kingdom of Great Britain and Northern Ireland,GBR,5,0,16,0,21
2012,Sri Lanka,LKA,United Kingdom of Great Britain and Northern Ireland,GBR,405,0,543,48,996
2012,Mauritania,MRT,United Kingdom of Great Britain and Northern Ireland,GBR,0,0,5,0,5
2012,Mexico,MEX,United Kingdom of Great Britain and Northern Ireland,GBR,5,0,0,0,5
2012,Mali,MLI,United Kingdom of Great Britain and Northern Ireland,GBR,0,0,5,0,5
2012,Malaysia,MYS,United Kingdom of Great Britain and Northern Ireland,GBR,0,0,15,0,15
2012,Malawi,MWI,United Kingdom of Great Britain and Northern Ireland,GBR,16,0,38,10,64
2012,Mongolia,MNG,United Kingdom of Great Britain and Northern Ireland,GBR,0,0,5,0,5
2012,Morocco,MAR,United Kingdom of Great Britain and Northern Ireland,GBR,5,0,24,0,29
2012,Mauritius,MUS,United Kingdom of Great Britain and Northern Ireland,GBR,5,0,10,0,15
2012,Myanmar,MMR,United Kingdom of Great Britain and Northern Ireland,GBR,16,0,10,5,31
2012,Namibia,NAM,United Kingdom of Great Britain and Northern Ireland,GBR,5,0,5,0,10
2012,Nepal,NPL,United Kingdom of Great Britain and Northern Ireland,GBR,0,0,25,5,30
2012,Nigeria,NGA,United Kingdom of Great Britain and Northern Ireland,GBR,61,0,258,18,337
2012,Pakistan,PAK,United Kingdom of Great Britain and Northern Ireland,GBR,284,0,1175,104,1563
2012,Philippines,PHL,United Kingdom of Great Britain and Northern Ireland,GBR,0,0,5,0,5
2012,South Africa,ZAF,United Kingdom of Great Britain and Northern Ireland,GBR,5,0,10,0,15
2012,Russian Federation,RUS,United Kingdom of Great Britain and Northern Ireland,GBR,12,0,15,5,32
2012,Rwanda,RWA,United Kingdom of Great Britain and Northern Ireland,GBR,0,0,13,0,13
2012,Serbia and Kosovo: S/RES/1244 (1999),SRB,United Kingdom of Great Britain and Northern Ireland,GBR,5,0,5,0,10
2012,Senegal,SEN,United Kingdom of Great Britain and Northern Ireland,GBR,5,0,19,0,24
2012,Sierra Leone,SLE,United Kingdom of Great Britain and Northern Ireland,GBR,5,0,15,0,20
2012,Somalia,SOM,United Kingdom of Great Britain and Northern Ireland,GBR,43,0,56,19,118
2012,Viet Nam,VNM,United Kingdom of Great Britain and Northern Ireland,GBR,16,0,38,10,64
2012,Sudan,SDN,United Kingdom of Great Britain and Northern Ireland,GBR,33,0,31,13,77
2012,Syrian Arab Rep.,SYR,United Kingdom of Great Britain and Northern Ireland,GBR,102,0,60,33,195
2012,United Rep. of Tanzania,TZA,United Kingdom of Great Britain and Northern Ireland,GBR,0,0,10,5,15
2012,Turkmenistan,TKM,United Kingdom of Great Britain and Northern Ireland,GBR,0,0,5,0,5
2012,Togo,TGO,United Kingdom of Great Britain and Northern Ireland,GBR,0,0,5,0,5
2012,Trinidad and Tobago,TTO,United Kingdom of Great Britain and Northern Ireland,GBR,5,0,5,5,15
2012,Tunisia,TUN,United Kingdom of Great Britain and Northern Ireland,GBR,0,0,11,0,11
2012,Turkey,TUR,United Kingdom of Great Britain and Northern Ireland,GBR,27,0,51,10,88
2012,Uganda,UGA,United Kingdom of Great Britain and Northern Ireland,GBR,33,0,73,11,117
2012,Ukraine,UKR,United Kingdom of Great Britain and Northern Ireland,GBR,5,0,5,0,10
2012,Uzbekistan,UZB,United Kingdom of Great Britain and Northern Ireland,GBR,0,0,5,0,5
2012,Yemen,YEM,United Kingdom of Great Britain and Northern Ireland,GBR,11,0,10,0,21
2012,Zambia,ZMB,United Kingdom of Great Britain and Northern Ireland,GBR,0,0,5,0,5
2012,Zimbabwe,ZWE,United Kingdom of Great Britain and Northern Ireland,GBR,61,0,151,34,246
2012,Stateless,XXA,United Kingdom of Great Britain and Northern Ireland,GBR,22,0,32,5,59
2012,Unknown ,,United Kingdom of Great Britain and Northern Ireland,GBR,10,0,0,0,10
2013,Afghanistan,AFG,Australia,AUS,300,0,69,0,369
2013,Albania,ALB,Australia,AUS,5,0,10,0,15
2013,Egypt,EGY,Australia,AUS,45,0,56,5,106
2013,Bangladesh,BGD,Australia,AUS,5,0,68,10,83
2013,Brazil,BRA,Australia,AUS,0,0,5,0,5
2013,Cambodia,KHM,Australia,AUS,0,0,5,0,5
2013,China,CHN,Australia,AUS,69,0,444,48,561
2013,Cameroon,CMR,Australia,AUS,0,0,5,0,5
2013,Colombia,COL,Australia,AUS,5,0,5,0,10
2013,Ethiopia,ETH,Australia,AUS,10,0,5,0,15
2013,Fiji,FJI,Australia,AUS,12,0,98,5,115
2013,Palestinian,PSE,Australia,AUS,0,0,5,0,5
2013,United Kingdom of Great Britain and Northern Ireland,GBR,Australia,AUS,0,0,10,0,10
2013,Georgia,GEO,Australia,AUS,0,0,5,0,5
2013,Ghana,GHA,Australia,AUS,5,0,10,0,15
2013,India,IND,Australia,AUS,29,0,383,35,447
2013,Indonesia,IDN,Australia,AUS,5,0,25,0,30
2013,Ireland,IRL,Australia,AUS,0,0,5,0,5
2013,Iran (Islamic Rep. of),IRN,Australia,AUS,111,0,85,5,201
2013,Iraq,IRQ,Australia,AUS,28,0,24,10,62
2013,Israel,ISR,Australia,AUS,0,0,5,0,5
2013,Jordan,JOR,Australia,AUS,5,0,22,5,32
2013,Kenya,KEN,Australia,AUS,5,0,10,0,15
2013,Rep. of Korea,KOR,Australia,AUS,0,0,22,0,22
2013,Kuwait,KWT,Australia,AUS,0,0,5,0,5
2013,Libya,LBY,Australia,AUS,10,0,5,0,15
2013,Lebanon,LBN,Australia,AUS,39,0,135,5,179
2013,Sri Lanka,LKA,Australia,AUS,174,0,382,10,566
2013,Malaysia,MYS,Australia,AUS,5,0,58,5,68
2013,Mongolia,MNG,Australia,AUS,0,0,5,0,5
2013,Mauritius,MUS,Australia,AUS,0,0,10,0,10
2013,Myanmar,MMR,Australia,AUS,5,0,5,0,10
2013,Nepal,NPL,Australia,AUS,5,0,92,11,108
2013,Nigeria,NGA,Australia,AUS,5,0,18,0,23
2013,New Zealand,NZL,Australia,AUS,0,0,5,0,5
2013,Pakistan,PAK,Australia,AUS,171,0,127,5,303
2013,Peru,PER,Australia,AUS,0,0,5,0,5
2013,Philippines,PHL,Australia,AUS,0,0,25,0,25
2013,Papua New Guinea,PNG,Australia,AUS,5,0,5,0,10
2013,Russian Federation,RUS,Australia,AUS,0,0,5,0,5
2013,Singapore,SGP,Australia,AUS,0,0,5,0,5
2013,Solomon Islands,SLB,Australia,AUS,0,0,5,0,5
2013,Viet Nam,VNM,Australia,AUS,0,0,25,0,25
2013,Sudan,SDN,Australia,AUS,5,0,0,0,5
2013,Syrian Arab Rep.,SYR,Australia,AUS,5,0,0,0,5
2013,Thailand,THA,Australia,AUS,0,0,14,0,14
2013,Tonga,TON,Australia,AUS,0,0,21,0,21
2013,Turkey,TUR,Australia,AUS,14,0,14,0,28
2013,Uganda,UGA,Australia,AUS,5,0,5,0,10
2013,Ukraine,UKR,Australia,AUS,0,0,5,0,5
2013,Uzbekistan,UZB,Australia,AUS,0,0,5,0,5
2013,Zimbabwe,ZWE,Australia,AUS,12,0,31,0,43
2013,Stateless,XXA,Australia,AUS,19,0,10,0,29
2013,Afghanistan,AFG,United Kingdom of Great Britain and Northern Ireland,GBR,176,0,340,40,556
2013,Albania,ALB,United Kingdom of Great Britain and Northern Ireland,GBR,86,0,215,25,326
2013,Algeria,DZA,United Kingdom of Great Britain and Northern Ireland,GBR,14,0,60,5,79
2013,Angola,AGO,United Kingdom of Great Britain and Northern Ireland,GBR,5,0,15,0,20
2013,Egypt,EGY,United Kingdom of Great Britain and Northern Ireland,GBR,21,0,101,5,127
2013,Burundi,BDI,United Kingdom of Great Britain and Northern Ireland,GBR,0,0,5,0,5
2013,Bangladesh,BGD,United Kingdom of Great Britain and Northern Ireland,GBR,21,0,451,34,506
2013,Belarus,BLR,United Kingdom of Great Britain and Northern Ireland,GBR,5,0,0,0,5
2013,Chad,TCD,United Kingdom of Great Britain and Northern Ireland,GBR,0,0,5,0,5
2013,China,CHN,United Kingdom of Great Britain and Northern Ireland,GBR,45,0,283,20,348
2013,Cameroon,CMR,United Kingdom of Great Britain and Northern Ireland,GBR,23,0,40,0,63
2013,Congo,COG,United Kingdom of Great Britain and Northern Ireland,GBR,5,0,10,0,15
2013,Dem. Rep. of the Congo,COD,United Kingdom of Great Britain and Northern Ireland,GBR,24,0,28,11,63
2013,Colombia,COL,United Kingdom of Great Britain and Northern Ireland,GBR,0,0,5,0,5
2013,Eritrea,ERI,United Kingdom of Great Britain and Northern Ireland,GBR,27,0,43,5,75
2013,Ethiopia,ETH,United Kingdom of Great Britain and Northern Ireland,GBR,32,0,30,5,67
2013,Gambia,GMB,United Kingdom of Great Britain and Northern Ireland,GBR,25,0,87,13,125
2013,Palestinian,PSE,United Kingdom of Great Britain and Northern Ireland,GBR,10,0,27,5,42
2013,Georgia,GEO,United Kingdom of Great Britain and Northern Ireland,GBR,5,0,10,0,15
2013,Ghana,GHA,United Kingdom of Great Britain and Northern Ireland,GBR,10,0,55,5,70
2013,Guinea,GIN,United Kingdom of Great Britain and Northern Ireland,GBR,5,0,27,5,37
2013,Cote d'Ivoire,CIV,United Kingdom of Great Britain and Northern Ireland,GBR,13,0,20,5,38
2013,India,IND,United Kingdom of Great Britain and Northern Ireland,GBR,14,0,100,11,125
2013,Iran (Islamic Rep. of),IRN,United Kingdom of Great Britain and Northern Ireland,GBR,289,0,555,47,891
2013,Iraq,IRQ,United Kingdom of Great Britain and Northern Ireland,GBR,40,0,93,12,145
2013,Jamaica,JAM,United Kingdom of Great Britain and Northern Ireland,GBR,5,0,26,0,31
2013,Jordan,JOR,United Kingdom of Great Britain and Northern Ireland,GBR,0,0,14,0,14
2013,Kenya,KEN,United Kingdom of Great Britain and Northern Ireland,GBR,20,0,27,5,52
2013,Dem. People's Rep. of Korea,PRK,United Kingdom of Great Britain and Northern Ireland,GBR,0,0,5,5,10
2013,Kuwait,KWT,United Kingdom of Great Britain and Northern Ireland,GBR,10,0,11,0,21
2013,Liberia,LBR,United Kingdom of Great Britain and Northern Ireland,GBR,5,0,0,0,5
2013,Libya,LBY,United Kingdom of Great Britain and Northern Ireland,GBR,28,0,72,5,105
2013,Lebanon,LBN,United Kingdom of Great Britain and Northern Ireland,GBR,5,0,17,0,22
2013,Sri Lanka,LKA,United Kingdom of Great Britain and Northern Ireland,GBR,417,0,492,50,959
2013,Mexico,MEX,United Kingdom of Great Britain and Northern Ireland,GBR,0,0,5,0,5
2013,Mali,MLI,United Kingdom of Great Britain and Northern Ireland,GBR,0,0,5,0,5
2013,Malaysia,MYS,United Kingdom of Great Britain and Northern Ireland,GBR,0,0,22,0,22
2013,Malawi,MWI,United Kingdom of Great Britain and Northern Ireland,GBR,10,0,52,0,62
2013,Mongolia,MNG,United Kingdom of Great Britain and Northern Ireland,GBR,0,0,5,0,5
2013,Morocco,MAR,United Kingdom of Great Britain and Northern Ireland,GBR,5,0,15,0,20
2013,Mauritius,MUS,United Kingdom of Great Britain and Northern Ireland,GBR,0,0,5,0,5
2013,Myanmar,MMR,United Kingdom of Great Britain and Northern Ireland,GBR,5,0,11,5,21
2013,Nepal,NPL,United Kingdom of Great Britain and Northern Ireland,GBR,5,0,22,5,32
2013,Nigeria,NGA,United Kingdom of Great Britain and Northern Ireland,GBR,59,0,280,22,361
2013,Pakistan,PAK,United Kingdom of Great Britain and Northern Ireland,GBR,270,0,1272,92,1634
2013,Philippines,PHL,United Kingdom of Great Britain and Northern Ireland,GBR,0,0,10,0,10
2013,South Africa,ZAF,United Kingdom of Great Britain and Northern Ireland,GBR,5,0,10,0,15
2013,Russian Federation,RUS,United Kingdom of Great Britain and Northern Ireland,GBR,15,0,10,0,25
2013,Rwanda,RWA,United Kingdom of Great Britain and Northern Ireland,GBR,5,0,5,0,10
2013,Saudi Arabia,SAU,United Kingdom of Great Britain and Northern Ireland,GBR,0,0,5,0,5
2013,Serbia and Kosovo: S/RES/1244 (1999),SRB,United Kingdom of Great Britain and Northern Ireland,GBR,5,0,10,5,20
2013,Senegal,SEN,United Kingdom of Great Britain and Northern Ireland,GBR,5,0,15,0,20
2013,Sierra Leone,SLE,United Kingdom of Great Britain and Northern Ireland,GBR,5,0,21,0,26
2013,Somalia,SOM,United Kingdom of Great Britain and Northern Ireland,GBR,53,0,61,16,130
2013,Viet Nam,VNM,United Kingdom of Great Britain and Northern Ireland,GBR,28,0,78,12,118
2013,Sudan,SDN,United Kingdom of Great Britain and Northern Ireland,GBR,36,0,36,10,82
2013,Syrian Arab Rep.,SYR,United Kingdom of Great Britain and Northern Ireland,GBR,10,0,67,11,88
2013,United Rep. of Tanzania,TZA,United Kingdom of Great Britain and Northern Ireland,GBR,0,0,18,0,18
2013,Thailand,THA,United Kingdom of Great Britain and Northern Ireland,GBR,0,0,5,0,5
2013,Togo,TGO,United Kingdom of Great Britain and Northern Ireland,GBR,5,0,5,0,10
2013,Trinidad and Tobago,TTO,United Kingdom of Great Britain and Northern Ireland,GBR,0,0,10,0,10
2013,Tunisia,TUN,United Kingdom of Great Britain and Northern Ireland,GBR,5,0,5,0,10
2013,Turkey,TUR,United Kingdom of Great Britain and Northern Ireland,GBR,35,0,55,10,100
2013,Uganda,UGA,United Kingdom of Great Britain and Northern Ireland,GBR,28,0,54,5,87
2013,Ukraine,UKR,United Kingdom of Great Britain and Northern Ireland,GBR,0,0,5,0,5
2013,Uzbekistan,UZB,United Kingdom of Great Britain and Northern Ireland,GBR,5,0,5,0,10
2013,Yemen,YEM,United Kingdom of Great Britain and Northern Ireland,GBR,10,0,10,5,25
2013,Zambia,ZMB,United Kingdom of Great Britain and Northern Ireland,GBR,5,0,10,0,15
2013,Zimbabwe,ZWE,United Kingdom of Great Britain and Northern Ireland,GBR,52,0,125,15,192
2013,Stateless,XXA,United Kingdom of Great Britain and Northern Ireland,GBR,5,0,16,5,26
2013,Unknown ,,United Kingdom of Great Britain and Northern Ireland,GBR,5,0,0,0,5
2013,Unknown ,,Luxembourg,LUX,15,5,0,46,66
2014,Afghanistan,AFG,Australia,AUS,35,0,10,0,45
2014,Albania,ALB,Australia,AUS,0,0,5,0,5
2014,Egypt,EGY,Australia,AUS,35,0,102,10,147
2014,Bahrain,BHR,Australia,AUS,5,0,0,0,5
2014,Bangladesh,BGD,Australia,AUS,14,0,96,12,122
2014,Cambodia,KHM,Australia,AUS,0,0,5,0,5
2014,China,CHN,Australia,AUS,71,0,673,41,785
2014,Colombia,COL,Australia,AUS,5,0,5,0,10
2014,Ethiopia,ETH,Australia,AUS,10,0,5,0,15
2014,Fiji,FJI,Australia,AUS,10,0,112,16,138
2014,United Kingdom of Great Britain and Northern Ireland,GBR,Australia,AUS,0,0,5,0,5
2014,Georgia,GEO,Australia,AUS,0,0,10,0,10
2014,Ghana,GHA,Australia,AUS,0,0,10,0,10
2014,Greece,GRC,Australia,AUS,0,0,5,0,5
2014,India,IND,Australia,AUS,29,0,428,38,495
2014,Indonesia,IDN,Australia,AUS,10,0,36,5,51
2014,Ireland,IRL,Australia,AUS,0,0,5,0,5
2014,Iran (Islamic Rep. of),IRN,Australia,AUS,104,0,60,11,175
2014,Iraq,IRQ,Australia,AUS,36,0,5,5,46
2014,Jordan,JOR,Australia,AUS,5,0,32,5,42
2014,Kenya,KEN,Australia,AUS,0,0,14,0,14
2014,Rep. of Korea,KOR,Australia,AUS,0,0,25,5,30
2014,Liberia,LBR,Australia,AUS,0,0,5,0,5
2014,Libya,LBY,Australia,AUS,11,0,12,0,23
2014,Lebanon,LBN,Australia,AUS,27,0,151,13,191
2014,Sri Lanka,LKA,Australia,AUS,57,0,205,14,276
2014,Malaysia,MYS,Australia,AUS,11,0,69,10,90
2014,Mongolia,MNG,Australia,AUS,0,0,11,0,11
2014,Morocco,MAR,Australia,AUS,0,0,5,0,5
2014,Mauritius,MUS,Australia,AUS,0,0,5,0,5
2014,Myanmar,MMR,Australia,AUS,5,0,0,0,5
2014,Nepal,NPL,Australia,AUS,10,0,136,10,156
2014,Nigeria,NGA,Australia,AUS,5,0,34,0,39
2014,Pakistan,PAK,Australia,AUS,123,0,179,10,312
2014,Peru,PER,Australia,AUS,0,0,5,0,5
2014,Philippines,PHL,Australia,AUS,0,0,24,0,24
2014,Papua New Guinea,PNG,Australia,AUS,5,0,5,0,10
2014,South Africa,ZAF,Australia,AUS,0,0,10,0,10
2014,Singapore,SGP,Australia,AUS,0,0,5,0,5
2014,Somalia,SOM,Australia,AUS,5,0,0,0,5
2014,Viet Nam,VNM,Australia,AUS,5,0,32,0,37
2014,Thailand,THA,Australia,AUS,0,0,5,0,5
2014,Tonga,TON,Australia,AUS,0,0,32,5,37
2014,Turkey,TUR,Australia,AUS,19,0,21,0,40
2014,Uganda,UGA,Australia,AUS,5,0,5,0,10
2014,Ukraine,UKR,Australia,AUS,0,0,5,0,5
2014,United States of America,USA,Australia,AUS,0,0,5,0,5
2014,Yemen,YEM,Australia,AUS,0,0,5,0,5
2014,Zimbabwe,ZWE,Australia,AUS,20,0,29,5,54
2014,Stateless,XXA,Australia,AUS,10,0,11,5,26
2014,Afghanistan,AFG,United Kingdom of Great Britain and Northern Ireland,GBR,171,0,287,22,480
2014,Albania,ALB,United Kingdom of Great Britain and Northern Ireland,GBR,105,0,203,21,329
2014,Algeria,DZA,United Kingdom of Great Britain and Northern Ireland,GBR,16,0,46,0,62
2014,Angola,AGO,United Kingdom of Great Britain and Northern Ireland,GBR,0,0,10,0,10
2014,Egypt,EGY,United Kingdom of Great Britain and Northern Ireland,GBR,15,0,54,0,69
2014,Bahrain,BHR,United Kingdom of Great Britain and Northern Ireland,GBR,0,0,5,0,5
2014,Burundi,BDI,United Kingdom of Great Britain and Northern Ireland,GBR,0,0,5,0,5
2014,Bangladesh,BGD,United Kingdom of Great Britain and Northern Ireland,GBR,36,0,259,10,305
2014,Botswana,BWA,United Kingdom of Great Britain and Northern Ireland,GBR,0,0,5,0,5
2014,Brazil,BRA,United Kingdom of Great Britain and Northern Ireland,GBR,0,0,5,0,5
2014,China,CHN,United Kingdom of Great Britain and Northern Ireland,GBR,31,0,256,5,292
2014,Cameroon,CMR,United Kingdom of Great Britain and Northern Ireland,GBR,19,0,41,5,65
2014,Congo,COG,United Kingdom of Great Britain and Northern Ireland,GBR,0,0,5,0,5
2014,Dem. Rep. of the Congo,COD,United Kingdom of Great Britain and Northern Ireland,GBR,33,0,35,5,73
2014,Eritrea,ERI,United Kingdom of Great Britain and Northern Ireland,GBR,49,0,59,5,113
2014,Ethiopia,ETH,United Kingdom of Great Britain and Northern Ireland,GBR,25,0,27,0,52
2014,Gambia,GMB,United Kingdom of Great Britain and Northern Ireland,GBR,17,0,39,5,61
2014,Palestinian,PSE,United Kingdom of Great Britain and Northern Ireland,GBR,5,0,21,0,26
2014,Georgia,GEO,United Kingdom of Great Britain and Northern Ireland,GBR,0,0,5,0,5
2014,Ghana,GHA,United Kingdom of Great Britain and Northern Ireland,GBR,10,0,31,5,46
2014,Guinea,GIN,United Kingdom of Great Britain and Northern Ireland,GBR,10,0,14,0,24
2014,Honduras,HND,United Kingdom of Great Britain and Northern Ireland,GBR,0,0,5,0,5
2014,Cote d'Ivoire,CIV,United Kingdom of Great Britain and Northern Ireland,GBR,10,0,25,0,35
2014,India,IND,United Kingdom of Great Britain and Northern Ireland,GBR,14,0,75,5,94
2014,Iran (Islamic Rep. of),IRN,United Kingdom of Great Britain and Northern Ireland,GBR,203,0,268,35,506
2014,Iraq,IRQ,United Kingdom of Great Britain and Northern Ireland,GBR,33,0,84,5,122
2014,Jamaica,JAM,United Kingdom of Great Britain and Northern Ireland,GBR,10,0,14,5,29
2014,Jordan,JOR,United Kingdom of Great Britain and Northern Ireland,GBR,0,0,5,0,5
2014,Kenya,KEN,United Kingdom of Great Britain and Northern Ireland,GBR,12,0,16,5,33
2014,Dem. People's Rep. of Korea,PRK,United Kingdom of Great Britain and Northern Ireland,GBR,0,0,5,0,5
2014,Kuwait,KWT,United Kingdom of Great Britain and Northern Ireland,GBR,0,0,5,0,5
2014,Libya,LBY,United Kingdom of Great Britain and Northern Ireland,GBR,13,0,37,5,55
2014,Lebanon,LBN,United Kingdom of Great Britain and Northern Ireland,GBR,5,0,10,0,15
2014,Sri Lanka,LKA,United Kingdom of Great Britain and Northern Ireland,GBR,288,0,340,34,662
2014,Mali,MLI,United Kingdom of Great Britain and Northern Ireland,GBR,5,0,5,0,10
2014,Malaysia,MYS,United Kingdom of Great Britain and Northern Ireland,GBR,0,0,10,0,10
2014,Malawi,MWI,United Kingdom of Great Britain and Northern Ireland,GBR,5,0,22,0,27
2014,Mongolia,MNG,United Kingdom of Great Britain and Northern Ireland,GBR,0,0,10,0,10
2014,Morocco,MAR,United Kingdom of Great Britain and Northern Ireland,GBR,0,0,15,0,15
2014,Myanmar,MMR,United Kingdom of Great Britain and Northern Ireland,GBR,10,0,10,0,20
2014,Namibia,NAM,United Kingdom of Great Britain and Northern Ireland,GBR,0,0,10,0,10
2014,Nepal,NPL,United Kingdom of Great Britain and Northern Ireland,GBR,0,0,18,0,18
2014,Nigeria,NGA,United Kingdom of Great Britain and Northern Ireland,GBR,64,0,206,23,293
2014,Pakistan,PAK,United Kingdom of Great Britain and Northern Ireland,GBR,244,0,913,61,1218
2014,Philippines,PHL,United Kingdom of Great Britain and Northern Ireland,GBR,0,0,11,0,11
2014,South Africa,ZAF,United Kingdom of Great Britain and Northern Ireland,GBR,0,0,10,0,10
2014,Russian Federation,RUS,United Kingdom of Great Britain and Northern Ireland,GBR,5,0,14,0,19
2014,Rwanda,RWA,United Kingdom of Great Britain and Northern Ireland,GBR,5,0,5,0,10
2014,Serbia and Kosovo: S/RES/1244 (1999),SRB,United Kingdom of Great Britain and Northern Ireland,GBR,5,0,11,0,16
2014,Senegal,SEN,United Kingdom of Great Britain and Northern Ireland,GBR,0,0,5,0,5
2014,Seychelles,SYC,United Kingdom of Great Britain and Northern Ireland,GBR,0,0,5,0,5
2014,Sierra Leone,SLE,United Kingdom of Great Britain and Northern Ireland,GBR,5,0,12,0,17
2014,Somalia,SOM,United Kingdom of Great Britain and Northern Ireland,GBR,36,0,42,5,83
2014,Viet Nam,VNM,United Kingdom of Great Britain and Northern Ireland,GBR,24,0,49,5,78
2014,Sudan,SDN,United Kingdom of Great Britain and Northern Ireland,GBR,26,0,28,5,59
2014,Eswatini,SWZ,United Kingdom of Great Britain and Northern Ireland,GBR,0,0,5,0,5
2014,Syrian Arab Rep.,SYR,United Kingdom of Great Britain and Northern Ireland,GBR,14,0,54,5,73
2014,United Rep. of Tanzania,TZA,United Kingdom of Great Britain and Northern Ireland,GBR,0,0,10,0,10
2014,Trinidad and Tobago,TTO,United Kingdom of Great Britain and Northern Ireland,GBR,5,0,5,0,10
2014,Tunisia,TUN,United Kingdom of Great Britain and Northern Ireland,GBR,0,0,21,0,21
2014,Turkey,TUR,United Kingdom of Great Britain and Northern Ireland,GBR,33,0,61,10,104
2014,Uganda,UGA,United Kingdom of Great Britain and Northern Ireland,GBR,31,0,46,5,82
2014,Ukraine,UKR,United Kingdom of Great Britain and Northern Ireland,GBR,5,0,10,0,15
2014,United States of America,USA,United Kingdom of Great Britain and Northern Ireland,GBR,0,0,5,0,5
2014,Uzbekistan,UZB,United Kingdom of Great Britain and Northern Ireland,GBR,5,0,0,0,5
2014,Venezuela (Bolivarian Republic of),VEN,United Kingdom of Great Britain and Northern Ireland,GBR,5,0,5,0,10
2014,Yemen,YEM,United Kingdom of Great Britain and Northern Ireland,GBR,5,0,5,0,10
2014,Zambia,ZMB,United Kingdom of Great Britain and Northern Ireland,GBR,5,0,5,0,10
2014,Zimbabwe,ZWE,United Kingdom of Great Britain and Northern Ireland,GBR,17,0,74,5,96
2014,Stateless,XXA,United Kingdom of Great Britain and Northern Ireland,GBR,16,0,16,5,37
2014,Unknown ,,United Kingdom of Great Britain and Northern Ireland,GBR,5,0,0,0,5
2015,Afghanistan,AFG,Australia,AUS,144,0,35,0,179
2015,Albania,ALB,Australia,AUS,0,0,5,0,5
2015,Egypt,EGY,Australia,AUS,38,0,88,5,131
2015,Bangladesh,BGD,Australia,AUS,18,0,83,5,106
2015,Cambodia,KHM,Australia,AUS,0,0,5,0,5
2015,China,CHN,Australia,AUS,55,0,397,54,506
2015,Fiji,FJI,Australia,AUS,5,0,123,16,144
2015,Ghana,GHA,Australia,AUS,0,0,5,0,5
2015,India,IND,Australia,AUS,10,0,227,47,284
2015,Indonesia,IDN,Australia,AUS,5,0,29,5,39
2015,Ireland,IRL,Australia,AUS,0,0,5,5,10
2015,Iran (Islamic Rep. of),IRN,Australia,AUS,99,0,110,16,225
2015,Iraq,IRQ,Australia,AUS,40,0,5,0,45
2015,Jordan,JOR,Australia,AUS,0,0,12,5,17
2015,Kenya,KEN,Australia,AUS,5,0,5,5,15
2015,Rep. of Korea,KOR,Australia,AUS,0,0,14,0,14
2015,Liberia,LBR,Australia,AUS,0,0,5,0,5
2015,Libya,LBY,Australia,AUS,19,0,0,0,19
2015,Lebanon,LBN,Australia,AUS,14,0,73,10,97
2015,Sri Lanka,LKA,Australia,AUS,159,0,780,29,968
2015,Malaysia,MYS,Australia,AUS,5,0,187,47,239
2015,Mongolia,MNG,Australia,AUS,0,0,5,0,5
2015,Mauritius,MUS,Australia,AUS,0,0,5,0,5
2015,Myanmar,MMR,Australia,AUS,0,0,5,0,5
2015,Nepal,NPL,Australia,AUS,5,0,77,12,94
2015,Nigeria,NGA,Australia,AUS,5,0,10,0,15
2015,Pakistan,PAK,Australia,AUS,63,0,117,17,197
2015,Philippines,PHL,Australia,AUS,0,0,10,0,10
2015,Papua New Guinea,PNG,Australia,AUS,5,0,13,0,18
2015,South Africa,ZAF,Australia,AUS,0,0,5,0,5
2015,Viet Nam,VNM,Australia,AUS,10,0,35,5,50
2015,Thailand,THA,Australia,AUS,0,0,0,5,5
2015,Tonga,TON,Australia,AUS,0,0,5,0,5
2015,Turkey,TUR,Australia,AUS,5,0,11,5,21
2015,Ukraine,UKR,Australia,AUS,0,0,5,0,5
2015,Zimbabwe,ZWE,Australia,AUS,5,0,12,5,22
2015,Stateless,XXA,Australia,AUS,10,0,14,0,24
2015,Unknown ,,Australia,AUS,0,0,5,0,5
2015,Afghanistan,AFG,United Kingdom of Great Britain and Northern Ireland,GBR,261,0,252,28,541
2015,Albania,ALB,United Kingdom of Great Britain and Northern Ireland,GBR,138,0,286,20,444
2015,Algeria,DZA,United Kingdom of Great Britain and Northern Ireland,GBR,10,0,38,0,48
2015,Angola,AGO,United Kingdom of Great Britain and Northern Ireland,GBR,5,0,19,0,24
2015,Egypt,EGY,United Kingdom of Great Britain and Northern Ireland,GBR,34,0,88,10,132
2015,Armenia,ARM,United Kingdom of Great Britain and Northern Ireland,GBR,0,0,5,0,5
2015,Azerbaijan,AZE,United Kingdom of Great Britain and Northern Ireland,GBR,0,0,5,0,5
2015,Burundi,BDI,United Kingdom of Great Britain and Northern Ireland,GBR,0,0,5,0,5
2015,Bangladesh,BGD,United Kingdom of Great Britain and Northern Ireland,GBR,49,0,330,20,399
2015,Botswana,BWA,United Kingdom of Great Britain and Northern Ireland,GBR,0,0,5,0,5
2015,China,CHN,United Kingdom of Great Britain and Northern Ireland,GBR,49,0,386,15,450
2015,Cameroon,CMR,United Kingdom of Great Britain and Northern Ireland,GBR,19,0,35,5,59
2015,Congo,COG,United Kingdom of Great Britain and Northern Ireland,GBR,5,0,13,0,18
2015,Dem. Rep. of the Congo,COD,United Kingdom of Great Britain and Northern Ireland,GBR,60,0,79,5,144
2015,Colombia,COL,United Kingdom of Great Britain and Northern Ireland,GBR,0,0,5,0,5
2015,Eritrea,ERI,United Kingdom of Great Britain and Northern Ireland,GBR,452,0,94,16,562
2015,Ethiopia,ETH,United Kingdom of Great Britain and Northern Ireland,GBR,30,0,44,5,79
2015,Gambia,GMB,United Kingdom of Great Britain and Northern Ireland,GBR,25,0,78,5,108
2015,Palestinian,PSE,United Kingdom of Great Britain and Northern Ireland,GBR,19,0,30,5,54
2015,Georgia,GEO,United Kingdom of Great Britain and Northern Ireland,GBR,5,0,13,0,18
2015,Ghana,GHA,United Kingdom of Great Britain and Northern Ireland,GBR,10,0,40,5,55
2015,Guinea,GIN,United Kingdom of Great Britain and Northern Ireland,GBR,10,0,10,0,20
2015,Honduras,HND,United Kingdom of Great Britain and Northern Ireland,GBR,5,0,0,0,5
2015,Cote d'Ivoire,CIV,United Kingdom of Great Britain and Northern Ireland,GBR,10,0,22,5,37
2015,India,IND,United Kingdom of Great Britain and Northern Ireland,GBR,21,0,91,10,122
2015,Indonesia,IDN,United Kingdom of Great Britain and Northern Ireland,GBR,0,0,5,0,5
2015,Iran (Islamic Rep. of),IRN,United Kingdom of Great Britain and Northern Ireland,GBR,338,0,409,49,796
2015,Iraq,IRQ,United Kingdom of Great Britain and Northern Ireland,GBR,100,0,155,17,272
2015,Israel,ISR,United Kingdom of Great Britain and Northern Ireland,GBR,0,0,5,0,5
2015,Jamaica,JAM,United Kingdom of Great Britain and Northern Ireland,GBR,16,0,22,0,38
2015,Jordan,JOR,United Kingdom of Great Britain and Northern Ireland,GBR,0,0,10,0,10
2015,Kazakhstan,KAZ,United Kingdom of Great Britain and Northern Ireland,GBR,5,0,0,0,5
2015,Kenya,KEN,United Kingdom of Great Britain and Northern Ireland,GBR,5,0,26,5,36
2015,Dem. People's Rep. of Korea,PRK,United Kingdom of Great Britain and Northern Ireland,GBR,0,0,5,0,5
2015,Kuwait,KWT,United Kingdom of Great Britain and Northern Ireland,GBR,5,0,10,0,15
2015,Libya,LBY,United Kingdom of Great Britain and Northern Ireland,GBR,80,0,95,12,187
2015,Lebanon,LBN,United Kingdom of Great Britain and Northern Ireland,GBR,5,0,12,5,22
2015,Sri Lanka,LKA,United Kingdom of Great Britain and Northern Ireland,GBR,505,0,572,46,1123
2015,Mali,MLI,United Kingdom of Great Britain and Northern Ireland,GBR,0,0,5,0,5
2015,Malaysia,MYS,United Kingdom of Great Britain and Northern Ireland,GBR,0,0,14,0,14
2015,Malawi,MWI,United Kingdom of Great Britain and Northern Ireland,GBR,5,0,31,5,41
2015,Morocco,MAR,United Kingdom of Great Britain and Northern Ireland,GBR,5,0,20,5,30
2015,Mauritius,MUS,United Kingdom of Great Britain and Northern Ireland,GBR,0,0,5,0,5
2015,Myanmar,MMR,United Kingdom of Great Britain and Northern Ireland,GBR,24,0,32,0,56
2015,Nepal,NPL,United Kingdom of Great Britain and Northern Ireland,GBR,0,0,18,0,18
2015,Nigeria,NGA,United Kingdom of Great Britain and Northern Ireland,GBR,58,0,262,14,334
2015,Pakistan,PAK,United Kingdom of Great Britain and Northern Ireland,GBR,298,0,858,51,1207
2015,Philippines,PHL,United Kingdom of Great Britain and Northern Ireland,GBR,0,0,10,0,10
2015,South Africa,ZAF,United Kingdom of Great Britain and Northern Ireland,GBR,5,0,5,0,10
2015,Russian Federation,RUS,United Kingdom of Great Britain and Northern Ireland,GBR,17,0,13,5,35
2015,Rwanda,RWA,United Kingdom of Great Britain and Northern Ireland,GBR,5,0,5,0,10
2015,El Salvador,SLV,United Kingdom of Great Britain and Northern Ireland,GBR,5,0,5,0,10
2015,Serbia and Kosovo: S/RES/1244 (1999),SRB,United Kingdom of Great Britain and Northern Ireland,GBR,0,0,5,0,5
2015,Senegal,SEN,United Kingdom of Great Britain and Northern Ireland,GBR,5,0,10,0,15
2015,Sierra Leone,SLE,United Kingdom of Great Britain and Northern Ireland,GBR,18,0,18,0,36
2015,Somalia,SOM,United Kingdom of Great Britain and Northern Ireland,GBR,61,0,105,17,183
2015,Viet Nam,VNM,United Kingdom of Great Britain and Northern Ireland,GBR,39,0,77,11,127
2015,Sudan,SDN,United Kingdom of Great Britain and Northern Ireland,GBR,74,0,55,14,143
2015,Syrian Arab Rep.,SYR,United Kingdom of Great Britain and Northern Ireland,GBR,34,0,55,5,94
2015,United Rep. of Tanzania,TZA,United Kingdom of Great Britain and Northern Ireland,GBR,0,0,16,0,16
2015,Thailand,THA,United Kingdom of Great Britain and Northern Ireland,GBR,0,0,5,0,5
2015,Trinidad and Tobago,TTO,United Kingdom of Great Britain and Northern Ireland,GBR,5,0,5,0,10
2015,Tunisia,TUN,United Kingdom of Great Britain and Northern Ireland,GBR,5,0,12,0,17
2015,Turkey,TUR,United Kingdom of Great Britain and Northern Ireland,GBR,56,0,122,10,188
2015,United Arab Emirates,ARE,United Kingdom of Great Britain and Northern Ireland,GBR,5,0,0,0,5
2015,Uganda,UGA,United Kingdom of Great Britain and Northern Ireland,GBR,39,0,39,5,83
2015,Ukraine,UKR,United Kingdom of Great Britain and Northern Ireland,GBR,13,0,20,0,33
2015,Uzbekistan,UZB,United Kingdom of Great Britain and Northern Ireland,GBR,5,0,5,0,10
2015,Venezuela (Bolivarian Republic of),VEN,United Kingdom of Great Britain and Northern Ireland,GBR,0,0,10,0,10
2015,Yemen,YEM,United Kingdom of Great Britain and Northern Ireland,GBR,21,0,18,0,39
2015,Zambia,ZMB,United Kingdom of Great Britain and Northern Ireland,GBR,5,0,5,0,10
2015,Zimbabwe,ZWE,United Kingdom of Great Britain and Northern Ireland,GBR,55,0,189,11,255
2015,Stateless,XXA,United Kingdom of Great Britain and Northern Ireland,GBR,20,0,24,5,49
2015,Unknown ,,United Kingdom of Great Britain and Northern Ireland,GBR,43,0,5,0,48
2016,Afghanistan,AFG,United Kingdom of Great Britain and Northern Ireland,GBR,395,0,388,24,807
2016,Albania,ALB,United Kingdom of Great Britain and Northern Ireland,GBR,241,0,441,31,713
2016,Algeria,DZA,United Kingdom of Great Britain and Northern Ireland,GBR,11,0,35,5,51
2016,Angola,AGO,United Kingdom of Great Britain and Northern Ireland,GBR,5,0,13,0,18
2016,Egypt,EGY,United Kingdom of Great Britain and Northern Ireland,GBR,40,0,110,11,161
2016,Armenia,ARM,United Kingdom of Great Britain and Northern Ireland,GBR,0,0,11,0,11
2016,Azerbaijan,AZE,United Kingdom of Great Britain and Northern Ireland,GBR,5,0,0,0,5
2016,Burundi,BDI,United Kingdom of Great Britain and Northern Ireland,GBR,5,0,0,0,5
2016,Bangladesh,BGD,United Kingdom of Great Britain and Northern Ireland,GBR,110,0,535,21,666
2016,Botswana,BWA,United Kingdom of Great Britain and Northern Ireland,GBR,0,0,5,0,5
2016,Brazil,BRA,United Kingdom of Great Britain and Northern Ireland,GBR,0,0,5,0,5
2016,Chad,TCD,United Kingdom of Great Britain and Northern Ireland,GBR,5,0,10,0,15
2016,China,CHN,United Kingdom of Great Britain and Northern Ireland,GBR,23,0,236,11,270
2016,Cameroon,CMR,United Kingdom of Great Britain and Northern Ireland,GBR,22,0,51,5,78
2016,Congo,COG,United Kingdom of Great Britain and Northern Ireland,GBR,5,0,13,0,18
2016,Dem. Rep. of the Congo,COD,United Kingdom of Great Britain and Northern Ireland,GBR,32,0,71,0,103
2016,Colombia,COL,United Kingdom of Great Britain and Northern Ireland,GBR,5,0,0,0,5
2016,Eritrea,ERI,United Kingdom of Great Britain and Northern Ireland,GBR,1187,0,162,234,1583
2016,Ethiopia,ETH,United Kingdom of Great Britain and Northern Ireland,GBR,119,0,148,5,272
2016,Gambia,GMB,United Kingdom of Great Britain and Northern Ireland,GBR,44,0,97,0,141
2016,Palestinian,PSE,United Kingdom of Great Britain and Northern Ireland,GBR,17,0,38,5,60
2016,Georgia,GEO,United Kingdom of Great Britain and Northern Ireland,GBR,5,0,13,5,23
2016,Ghana,GHA,United Kingdom of Great Britain and Northern Ireland,GBR,16,0,49,0,65
2016,Guinea,GIN,United Kingdom of Great Britain and Northern Ireland,GBR,5,0,10,0,15
2016,Cote d'Ivoire,CIV,United Kingdom of Great Britain and Northern Ireland,GBR,10,0,16,0,26
2016,India,IND,United Kingdom of Great Britain and Northern Ireland,GBR,20,0,80,5,105
2016,Indonesia,IDN,United Kingdom of Great Britain and Northern Ireland,GBR,5,0,0,0,5
2016,Iran (Islamic Rep. of),IRN,United Kingdom of Great Britain and Northern Ireland,GBR,542,0,657,33,1232
2016,Iraq,IRQ,United Kingdom of Great Britain and Northern Ireland,GBR,359,0,618,28,1005
2016,Jamaica,JAM,United Kingdom of Great Britain and Northern Ireland,GBR,10,0,34,5,49
2016,Jordan,JOR,United Kingdom of Great Britain and Northern Ireland,GBR,0,0,5,0,5
2016,Kenya,KEN,United Kingdom of Great Britain and Northern Ireland,GBR,10,0,26,0,36
2016,Kyrgyzstan,KGZ,United Kingdom of Great Britain and Northern Ireland,GBR,0,0,5,0,5
2016,Kuwait,KWT,United Kingdom of Great Britain and Northern Ireland,GBR,5,0,10,0,15
2016,Liberia,LBR,United Kingdom of Great Britain and Northern Ireland,GBR,5,0,0,0,5
2016,Libya,LBY,United Kingdom of Great Britain and Northern Ireland,GBR,136,0,129,10,275
2016,Lebanon,LBN,United Kingdom of Great Britain and Northern Ireland,GBR,5,0,18,0,23
2016,Sri Lanka,LKA,United Kingdom of Great Britain and Northern Ireland,GBR,412,0,442,23,877
2016,Latvia,LVA,United Kingdom of Great Britain and Northern Ireland,GBR,0,0,5,0,5
2016,Mexico,MEX,United Kingdom of Great Britain and Northern Ireland,GBR,0,0,5,0,5
2016,Mali,MLI,United Kingdom of Great Britain and Northern Ireland,GBR,0,0,5,0,5
2016,Malaysia,MYS,United Kingdom of Great Britain and Northern Ireland,GBR,5,0,17,0,22
2016,Malawi,MWI,United Kingdom of Great Britain and Northern Ireland,GBR,10,0,27,0,37
2016,Mongolia,MNG,United Kingdom of Great Britain and Northern Ireland,GBR,5,0,5,0,10
2016,Morocco,MAR,United Kingdom of Great Britain and Northern Ireland,GBR,10,0,20,0,30
2016,Mauritius,MUS,United Kingdom of Great Britain and Northern Ireland,GBR,0,0,5,0,5
2016,Myanmar,MMR,United Kingdom of Great Britain and Northern Ireland,GBR,38,0,80,0,118
2016,Namibia,NAM,United Kingdom of Great Britain and Northern Ireland,GBR,0,0,5,0,5
2016,Nepal,NPL,United Kingdom of Great Britain and Northern Ireland,GBR,5,0,27,0,32
2016,Nigeria,NGA,United Kingdom of Great Britain and Northern Ireland,GBR,97,0,280,17,394
2016,Pakistan,PAK,United Kingdom of Great Britain and Northern Ireland,GBR,310,0,769,30,1109
2016,Philippines,PHL,United Kingdom of Great Britain and Northern Ireland,GBR,5,0,21,0,26
2016,Poland,POL,United Kingdom of Great Britain and Northern Ireland,GBR,0,0,5,0,5
2016,South Africa,ZAF,United Kingdom of Great Britain and Northern Ireland,GBR,5,0,15,0,20
2016,Russian Federation,RUS,United Kingdom of Great Britain and Northern Ireland,GBR,16,0,15,5,36
2016,Rwanda,RWA,United Kingdom of Great Britain and Northern Ireland,GBR,5,0,5,0,10
2016,El Salvador,SLV,United Kingdom of Great Britain and Northern Ireland,GBR,0,0,5,0,5
2016,Serbia and Kosovo: S/RES/1244 (1999),SRB,United Kingdom of Great Britain and Northern Ireland,GBR,10,0,5,0,15
2016,Senegal,SEN,United Kingdom of Great Britain and Northern Ireland,GBR,0,0,10,0,10
2016,Sierra Leone,SLE,United Kingdom of Great Britain and Northern Ireland,GBR,10,0,17,0,27
2016,Somalia,SOM,United Kingdom of Great Britain and Northern Ireland,GBR,67,0,122,10,199
2016,Viet Nam,VNM,United Kingdom of Great Britain and Northern Ireland,GBR,49,0,95,5,149
2016,Sudan,SDN,United Kingdom of Great Britain and Northern Ireland,GBR,159,0,103,10,272
2016,Eswatini,SWZ,United Kingdom of Great Britain and Northern Ireland,GBR,0,0,5,0,5
2016,Syrian Arab Rep.,SYR,United Kingdom of Great Britain and Northern Ireland,GBR,48,0,93,10,151
2016,United Rep. of Tanzania,TZA,United Kingdom of Great Britain and Northern Ireland,GBR,0,0,20,0,20
2016,Togo,TGO,United Kingdom of Great Britain and Northern Ireland,GBR,0,0,5,0,5
2016,Trinidad and Tobago,TTO,United Kingdom of Great Britain and Northern Ireland,GBR,5,0,5,0,10
2016,Tunisia,TUN,United Kingdom of Great Britain and Northern Ireland,GBR,0,0,13,0,13
2016,Turkey,TUR,United Kingdom of Great Britain and Northern Ireland,GBR,57,0,73,11,141
2016,United Arab Emirates,ARE,United Kingdom of Great Britain and Northern Ireland,GBR,5,0,0,0,5
2016,Uganda,UGA,United Kingdom of Great Britain and Northern Ireland,GBR,43,0,51,5,99
2016,Ukraine,UKR,United Kingdom of Great Britain and Northern Ireland,GBR,13,0,34,5,52
2016,Uzbekistan,UZB,United Kingdom of Great Britain and Northern Ireland,GBR,5,0,5,0,10
2016,Venezuela (Bolivarian Republic of),VEN,United Kingdom of Great Britain and Northern Ireland,GBR,0,0,5,0,5
2016,Yemen,YEM,United Kingdom of Great Britain and Northern Ireland,GBR,26,0,12,5,43
2016,Zambia,ZMB,United Kingdom of Great Britain and Northern Ireland,GBR,5,0,5,0,10
2016,Zimbabwe,ZWE,United Kingdom of Great Britain and Northern Ireland,GBR,60,0,135,5,200
2016,Stateless,XXA,United Kingdom of Great Britain and Northern Ireland,GBR,35,0,40,5,80
2016,Unknown ,,United Kingdom of Great Britain and Northern Ireland,GBR,75,0,0,0,75
2017,Afghanistan,AFG,United Kingdom of Great Britain and Northern Ireland,GBR,568,0,491,40,1099
2017,Albania,ALB,United Kingdom of Great Britain and Northern Ireland,GBR,142,0,318,29,489
2017,Algeria,DZA,United Kingdom of Great Britain and Northern Ireland,GBR,21,0,57,0,78
2017,Angola,AGO,United Kingdom of Great Britain and Northern Ireland,GBR,0,0,25,0,25
2017,Egypt,EGY,United Kingdom of Great Britain and Northern Ireland,GBR,53,0,139,5,197
2017,Armenia,ARM,United Kingdom of Great Britain and Northern Ireland,GBR,5,0,5,0,10
2017,Azerbaijan,AZE,United Kingdom of Great Britain and Northern Ireland,GBR,5,0,11,0,16
2017,Burundi,BDI,United Kingdom of Great Britain and Northern Ireland,GBR,5,0,5,0,10
2017,Benin,BEN,United Kingdom of Great Britain and Northern Ireland,GBR,0,0,5,0,5
2017,Bangladesh,BGD,United Kingdom of Great Britain and Northern Ireland,GBR,188,0,865,33,1086
2017,Burkina Faso,BFA,United Kingdom of Great Britain and Northern Ireland,GBR,0,0,5,0,5
2017,Belarus,BLR,United Kingdom of Great Britain and Northern Ireland,GBR,0,0,5,0,5
2017,Bolivia (Plurinational State of),BOL,United Kingdom of Great Britain and Northern Ireland,GBR,0,0,5,0,5
2017,Botswana,BWA,United Kingdom of Great Britain and Northern Ireland,GBR,0,0,5,0,5
2017,Chad,TCD,United Kingdom of Great Britain and Northern Ireland,GBR,0,0,5,0,5
2017,China,CHN,United Kingdom of Great Britain and Northern Ireland,GBR,30,0,270,13,313
2017,Cameroon,CMR,United Kingdom of Great Britain and Northern Ireland,GBR,38,0,72,0,110
2017,Congo,COG,United Kingdom of Great Britain and Northern Ireland,GBR,5,0,10,0,15
2017,Dem. Rep. of the Congo,COD,United Kingdom of Great Britain and Northern Ireland,GBR,51,0,75,5,131
2017,Colombia,COL,United Kingdom of Great Britain and Northern Ireland,GBR,0,0,5,0,5
2017,Eritrea,ERI,United Kingdom of Great Britain and Northern Ireland,GBR,199,0,132,209,540
2017,Ethiopia,ETH,United Kingdom of Great Britain and Northern Ireland,GBR,76,0,96,5,177
2017,Gambia,GMB,United Kingdom of Great Britain and Northern Ireland,GBR,23,0,60,5,88
2017,Palestinian,PSE,United Kingdom of Great Britain and Northern Ireland,GBR,18,0,31,0,49
2017,Georgia,GEO,United Kingdom of Great Britain and Northern Ireland,GBR,5,0,16,0,21
2017,Ghana,GHA,United Kingdom of Great Britain and Northern Ireland,GBR,11,0,93,5,109
2017,Guinea-Bissau,GNB,United Kingdom of Great Britain and Northern Ireland,GBR,0,0,5,0,5
2017,Guinea,GIN,United Kingdom of Great Britain and Northern Ireland,GBR,0,0,14,0,14
2017,Cote d'Ivoire,CIV,United Kingdom of Great Britain and Northern Ireland,GBR,5,0,19,0,24
2017,India,IND,United Kingdom of Great Britain and Northern Ireland,GBR,46,0,145,13,204
2017,Indonesia,IDN,United Kingdom of Great Britain and Northern Ireland,GBR,0,0,5,0,5
2017,Iran (Islamic Rep. of),IRN,United Kingdom of Great Britain and Northern Ireland,GBR,1001,0,1138,33,2172
2017,Iraq,IRQ,United Kingdom of Great Britain and Northern Ireland,GBR,604,0,1065,34,1703
2017,Israel,ISR,United Kingdom of Great Britain and Northern Ireland,GBR,0,0,5,0,5
2017,Jamaica,JAM,United Kingdom of Great Britain and Northern Ireland,GBR,14,0,44,0,58
2017,Jordan,JOR,United Kingdom of Great Britain and Northern Ireland,GBR,5,0,10,0,15
2017,Kazakhstan,KAZ,United Kingdom of Great Britain and Northern Ireland,GBR,0,0,5,0,5
2017,Kenya,KEN,United Kingdom of Great Britain and Northern Ireland,GBR,10,0,32,5,47
2017,Kuwait,KWT,United Kingdom of Great Britain and Northern Ireland,GBR,10,0,11,0,21
2017,Libya,LBY,United Kingdom of Great Britain and Northern Ireland,GBR,126,0,56,23,205
2017,Saint Lucia,LCA,United Kingdom of Great Britain and Northern Ireland,GBR,5,0,5,0,10
2017,Lebanon,LBN,United Kingdom of Great Britain and Northern Ireland,GBR,16,0,24,0,40
2017,Sri Lanka,LKA,United Kingdom of Great Britain and Northern Ireland,GBR,337,0,358,15,710
2017,Maldives,MDV,United Kingdom of Great Britain and Northern Ireland,GBR,0,0,0,5,5
2017,Mexico,MEX,United Kingdom of Great Britain and Northern Ireland,GBR,0,0,5,0,5
2017,Mali,MLI,United Kingdom of Great Britain and Northern Ireland,GBR,0,0,5,0,5
2017,Malaysia,MYS,United Kingdom of Great Britain and Northern Ireland,GBR,5,0,25,0,30
2017,Malawi,MWI,United Kingdom of Great Britain and Northern Ireland,GBR,5,0,25,0,30
2017,Mongolia,MNG,United Kingdom of Great Britain and Northern Ireland,GBR,0,0,5,0,5
2017,Morocco,MAR,United Kingdom of Great Britain and Northern Ireland,GBR,11,0,30,0,41
2017,Mauritius,MUS,United Kingdom of Great Britain and Northern Ireland,GBR,5,0,10,0,15
2017,Myanmar,MMR,United Kingdom of Great Britain and Northern Ireland,GBR,10,0,30,0,40
2017,Namibia,NAM,United Kingdom of Great Britain and Northern Ireland,GBR,5,0,11,0,16
2017,Nepal,NPL,United Kingdom of Great Britain and Northern Ireland,GBR,5,0,46,0,51
2017,Nigeria,NGA,United Kingdom of Great Britain and Northern Ireland,GBR,134,0,388,17,539
2017,Pakistan,PAK,United Kingdom of Great Britain and Northern Ireland,GBR,357,0,1138,35,1530
2017,Philippines,PHL,United Kingdom of Great Britain and Northern Ireland,GBR,5,0,28,0,33
2017,South Africa,ZAF,United Kingdom of Great Britain and Northern Ireland,GBR,5,0,11,0,16
2017,Russian Federation,RUS,United Kingdom of Great Britain and Northern Ireland,GBR,20,0,22,0,42
2017,Rwanda,RWA,United Kingdom of Great Britain and Northern Ireland,GBR,10,0,10,0,20
2017,El Salvador,SLV,United Kingdom of Great Britain and Northern Ireland,GBR,11,0,10,0,21
2017,Saudi Arabia,SAU,United Kingdom of Great Britain and Northern Ireland,GBR,5,0,14,0,19
2017,Serbia and Kosovo: S/RES/1244 (1999),SRB,United Kingdom of Great Britain and Northern Ireland,GBR,5,0,5,0,10
2017,Senegal,SEN,United Kingdom of Great Britain and Northern Ireland,GBR,5,0,15,0,20
2017,Sierra Leone,SLE,United Kingdom of Great Britain and Northern Ireland,GBR,5,0,17,0,22
2017,Somalia,SOM,United Kingdom of Great Britain and Northern Ireland,GBR,97,0,79,0,176
2017,Viet Nam,VNM,United Kingdom of Great Britain and Northern Ireland,GBR,99,0,134,10,243
2017,Sudan,SDN,United Kingdom of Great Britain and Northern Ireland,GBR,103,0,87,10,200
2017,Eswatini,SWZ,United Kingdom of Great Britain and Northern Ireland,GBR,0,0,5,0,5
2017,Syrian Arab Rep.,SYR,United Kingdom of Great Britain and Northern Ireland,GBR,62,0,96,5,163
2017,United Rep. of Tanzania,TZA,United Kingdom of Great Britain and Northern Ireland,GBR,5,0,10,0,15
2017,Thailand,THA,United Kingdom of Great Britain and Northern Ireland,GBR,0,0,5,0,5
2017,Trinidad and Tobago,TTO,United Kingdom of Great Britain and Northern Ireland,GBR,0,0,10,0,10
2017,Tunisia,TUN,United Kingdom of Great Britain and Northern Ireland,GBR,5,0,10,0,15
2017,Turkey,TUR,United Kingdom of Great Britain and Northern Ireland,GBR,95,0,114,5,214
2017,Uganda,UGA,United Kingdom of Great Britain and Northern Ireland,GBR,28,0,62,5,95
2017,Ukraine,UKR,United Kingdom of Great Britain and Northern Ireland,GBR,13,0,42,5,60
2017,Uzbekistan,UZB,United Kingdom of Great Britain and Northern Ireland,GBR,0,0,5,0,5
2017,Yemen,YEM,United Kingdom of Great Britain and Northern Ireland,GBR,23,0,10,0,33
2017,Zambia,ZMB,United Kingdom of Great Britain and Northern Ireland,GBR,0,0,14,0,14
2017,Zimbabwe,ZWE,United Kingdom of Great Britain and Northern Ireland,GBR,64,0,155,5,224
2017,Stateless,XXA,United Kingdom of Great Britain and Northern Ireland,GBR,22,0,57,10,89
2017,Unknown ,,United Kingdom of Great Britain and Northern Ireland,GBR,143,0,5,0,148
2018,Afghanistan,AFG,United Kingdom of Great Britain and Northern Ireland,GBR,408,0,313,32,753
2018,Albania,ALB,United Kingdom of Great Britain and Northern Ireland,GBR,166,0,238,21,425
2018,Algeria,DZA,United Kingdom of Great Britain and Northern Ireland,GBR,17,0,49,0,66
2018,Angola,AGO,United Kingdom of Great Britain and Northern Ireland,GBR,10,0,20,0,30
2018,Egypt,EGY,United Kingdom of Great Britain and Northern Ireland,GBR,72,0,152,10,234
2018,Armenia,ARM,United Kingdom of Great Britain and Northern Ireland,GBR,5,0,14,0,19
2018,Azerbaijan,AZE,United Kingdom of Great Britain and Northern Ireland,GBR,10,0,10,0,20
2018,Bahrain,BHR,United Kingdom of Great Britain and Northern Ireland,GBR,5,0,5,0,10
2018,Burundi,BDI,United Kingdom of Great Britain and Northern Ireland,GBR,5,0,10,0,15
2018,Bangladesh,BGD,United Kingdom of Great Britain and Northern Ireland,GBR,202,0,820,30,1052
2018,Belarus,BLR,United Kingdom of Great Britain and Northern Ireland,GBR,5,0,5,0,10
2018,Botswana,BWA,United Kingdom of Great Britain and Northern Ireland,GBR,0,0,10,0,10
2018,Brazil,BRA,United Kingdom of Great Britain and Northern Ireland,GBR,0,0,5,0,5
2018,China,CHN,United Kingdom of Great Britain and Northern Ireland,GBR,43,0,171,12,226
2018,Cameroon,CMR,United Kingdom of Great Britain and Northern Ireland,GBR,66,0,66,0,132
2018,Congo,COG,United Kingdom of Great Britain and Northern Ireland,GBR,5,0,11,5,21
2018,Dem. Rep. of the Congo,COD,United Kingdom of Great Britain and Northern Ireland,GBR,60,0,62,5,127
2018,Colombia,COL,United Kingdom of Great Britain and Northern Ireland,GBR,0,0,10,0,10
2018,Cuba,CUB,United Kingdom of Great Britain and Northern Ireland,GBR,0,0,5,0,5
2018,Eritrea,ERI,United Kingdom of Great Britain and Northern Ireland,GBR,43,0,39,5,87
2018,Ethiopia,ETH,United Kingdom of Great Britain and Northern Ireland,GBR,69,0,96,5,170
2018,Gambia,GMB,United Kingdom of Great Britain and Northern Ireland,GBR,15,0,35,5,55
2018,Palestinian,PSE,United Kingdom of Great Britain and Northern Ireland,GBR,18,0,37,5,60
2018,Georgia,GEO,United Kingdom of Great Britain and Northern Ireland,GBR,10,0,13,0,23
2018,Ghana,GHA,United Kingdom of Great Britain and Northern Ireland,GBR,14,0,57,0,71
2018,Grenada,GRD,United Kingdom of Great Britain and Northern Ireland,GBR,0,0,5,0,5
2018,Guinea,GIN,United Kingdom of Great Britain and Northern Ireland,GBR,5,0,13,0,18
2018,"China, Hong Kong SAR",HKG,United Kingdom of Great Britain and Northern Ireland,GBR,0,0,5,0,5
2018,Cote d'Ivoire,CIV,United Kingdom of Great Britain and Northern Ireland,GBR,10,0,24,5,39
2018,India,IND,United Kingdom of Great Britain and Northern Ireland,GBR,35,0,102,12,149
2018,Indonesia,IDN,United Kingdom of Great Britain and Northern Ireland,GBR,0,0,5,0,5
2018,Iran (Islamic Rep. of),IRN,United Kingdom of Great Britain and Northern Ireland,GBR,687,0,634,51,1372
2018,Iraq,IRQ,United Kingdom of Great Britain and Northern Ireland,GBR,549,0,814,60,1423
2018,Jamaica,JAM,United Kingdom of Great Britain and Northern Ireland,GBR,14,0,38,5,57
2018,Jordan,JOR,United Kingdom of Great Britain and Northern Ireland,GBR,10,0,12,0,22
2018,Kazakhstan,KAZ,United Kingdom of Great Britain and Northern Ireland,GBR,0,0,5,0,5
2018,Kenya,KEN,United Kingdom of Great Britain and Northern Ireland,GBR,21,0,40,0,61
2018,Kyrgyzstan,KGZ,United Kingdom of Great Britain and Northern Ireland,GBR,0,0,5,0,5
2018,Kuwait,KWT,United Kingdom of Great Britain and Northern Ireland,GBR,10,0,16,0,26
2018,Libya,LBY,United Kingdom of Great Britain and Northern Ireland,GBR,14,0,10,5,29
2018,Saint Lucia,LCA,United Kingdom of Great Britain and Northern Ireland,GBR,0,0,5,0,5
2018,Lebanon,LBN,United Kingdom of Great Britain and Northern Ireland,GBR,10,0,17,0,27
2018,Sri Lanka,LKA,United Kingdom of Great Britain and Northern Ireland,GBR,294,0,243,20,557
2018,Malaysia,MYS,United Kingdom of Great Britain and Northern Ireland,GBR,17,0,28,5,50
2018,Malawi,MWI,United Kingdom of Great Britain and Northern Ireland,GBR,5,0,37,0,42
2018,Mongolia,MNG,United Kingdom of Great Britain and Northern Ireland,GBR,5,0,0,0,5
2018,Morocco,MAR,United Kingdom of Great Britain and Northern Ireland,GBR,13,0,25,0,38
2018,Mozambique,MOZ,United Kingdom of Great Britain and Northern Ireland,GBR,0,0,5,0,5
2018,Mauritius,MUS,United Kingdom of Great Britain and Northern Ireland,GBR,5,0,10,0,15
2018,Myanmar,MMR,United Kingdom of Great Britain and Northern Ireland,GBR,18,0,22,0,40
2018,Namibia,NAM,United Kingdom of Great Britain and Northern Ireland,GBR,5,0,32,5,42
2018,Nepal,NPL,United Kingdom of Great Britain and Northern Ireland,GBR,5,0,41,0,46
2018,Nigeria,NGA,United Kingdom of Great Britain and Northern Ireland,GBR,106,0,318,24,448
2018,Oman,OMN,United Kingdom of Great Britain and Northern Ireland,GBR,5,0,0,0,5
2018,Pakistan,PAK,United Kingdom of Great Britain and Northern Ireland,GBR,361,0,891,42,1294
2018,Philippines,PHL,United Kingdom of Great Britain and Northern Ireland,GBR,5,0,22,5,32
2018,South Africa,ZAF,United Kingdom of Great Britain and Northern Ireland,GBR,5,0,18,0,23
2018,Russian Federation,RUS,United Kingdom of Great Britain and Northern Ireland,GBR,23,0,10,5,38
2018,Rwanda,RWA,United Kingdom of Great Britain and Northern Ireland,GBR,5,0,10,0,15
2018,El Salvador,SLV,United Kingdom of Great Britain and Northern Ireland,GBR,0,0,17,0,17
2018,Saudi Arabia,SAU,United Kingdom of Great Britain and Northern Ireland,GBR,0,0,10,0,10
2018,Serbia and Kosovo: S/RES/1244 (1999),SRB,United Kingdom of Great Britain and Northern Ireland,GBR,0,0,5,0,5
2018,Senegal,SEN,United Kingdom of Great Britain and Northern Ireland,GBR,10,0,5,0,15
2018,Sierra Leone,SLE,United Kingdom of Great Britain and Northern Ireland,GBR,10,0,13,5,28
2018,Somalia,SOM,United Kingdom of Great Britain and Northern Ireland,GBR,44,0,52,5,101
2018,Viet Nam,VNM,United Kingdom of Great Britain and Northern Ireland,GBR,126,0,164,19,309
2018,Sudan,SDN,United Kingdom of Great Britain and Northern Ireland,GBR,295,0,82,38,415
2018,Syrian Arab Rep.,SYR,United Kingdom of Great Britain and Northern Ireland,GBR,27,0,39,5,71
2018,United Rep. of Tanzania,TZA,United Kingdom of Great Britain and Northern Ireland,GBR,5,0,20,0,25
2018,Thailand,THA,United Kingdom of Great Britain and Northern Ireland,GBR,10,0,5,0,15
2018,Togo,TGO,United Kingdom of Great Britain and Northern Ireland,GBR,0,0,5,0,5
2018,Trinidad and Tobago,TTO,United Kingdom of Great Britain and Northern Ireland,GBR,5,0,10,0,15
2018,Tunisia,TUN,United Kingdom of Great Britain and Northern Ireland,GBR,5,0,11,0,16
2018,Turkey,TUR,United Kingdom of Great Britain and Northern Ireland,GBR,104,0,118,10,232
2018,Uganda,UGA,United Kingdom of Great Britain and Northern Ireland,GBR,23,0,28,10,61
2018,Ukraine,UKR,United Kingdom of Great Britain and Northern Ireland,GBR,25,0,36,0,61
2018,Uzbekistan,UZB,United Kingdom of Great Britain and Northern Ireland,GBR,5,0,5,0,10
2018,Venezuela (Bolivarian Republic of),VEN,United Kingdom of Great Britain and Northern Ireland,GBR,5,0,5,0,10
2018,Yemen,YEM,United Kingdom of Great Britain and Northern Ireland,GBR,19,0,14,5,38
2018,Zambia,ZMB,United Kingdom of Great Britain and Northern Ireland,GBR,0,0,5,0,5
2018,Zimbabwe,ZWE,United Kingdom of Great Britain and Northern Ireland,GBR,50,0,89,10,149
2018,Stateless,XXA,United Kingdom of Great Britain and Northern Ireland,GBR,34,0,37,20,91
2018,Unknown ,,United Kingdom of Great Britain and Northern Ireland,GBR,57,0,5,5,67
2018,Afghanistan,AFG,Kazakhstan,KAZ,0,0,64,15,79
2018,Syrian Arab Rep.,SYR,Kazakhstan,KAZ,0,0,17,0,17
2018,Turkey,TUR,Kazakhstan,KAZ,0,0,0,10,10
2019,Afghanistan,AFG,United Kingdom of Great Britain and Northern Ireland,GBR,299,0,248,48,595
2019,Albania,ALB,United Kingdom of Great Britain and Northern Ireland,GBR,295,0,278,35,608
2019,Algeria,DZA,United Kingdom of Great Britain and Northern Ireland,GBR,18,0,42,0,60
2019,Angola,AGO,United Kingdom of Great Britain and Northern Ireland,GBR,5,0,20,0,25
2019,Egypt,EGY,United Kingdom of Great Britain and Northern Ireland,GBR,53,0,95,10,158
2019,Azerbaijan,AZE,United Kingdom of Great Britain and Northern Ireland,GBR,10,0,10,0,20
2019,Barbados,BRB,United Kingdom of Great Britain and Northern Ireland,GBR,0,0,5,0,5
2019,Bangladesh,BGD,United Kingdom of Great Britain and Northern Ireland,GBR,166,0,458,12,636
2019,Burkina Faso,BFA,United Kingdom of Great Britain and Northern Ireland,GBR,0,0,5,0,5
2019,Bolivia (Plurinational State of),BOL,United Kingdom of Great Britain and Northern Ireland,GBR,0,0,5,0,5
2019,Botswana,BWA,United Kingdom of Great Britain and Northern Ireland,GBR,5,0,5,0,10
2019,Brazil,BRA,United Kingdom of Great Britain and Northern Ireland,GBR,5,0,5,0,10
2019,Chad,TCD,United Kingdom of Great Britain and Northern Ireland,GBR,0,0,5,0,5
2019,China,CHN,United Kingdom of Great Britain and Northern Ireland,GBR,52,0,151,26,229
2019,Cameroon,CMR,United Kingdom of Great Britain and Northern Ireland,GBR,50,0,35,5,90
2019,Congo,COG,United Kingdom of Great Britain and Northern Ireland,GBR,0,0,11,0,11
2019,Dem. Rep. of the Congo,COD,United Kingdom of Great Britain and Northern Ireland,GBR,32,0,46,5,83
2019,Colombia,COL,United Kingdom of Great Britain and Northern Ireland,GBR,0,0,5,0,5
2019,Eritrea,ERI,United Kingdom of Great Britain and Northern Ireland,GBR,49,0,30,10,89
2019,Ethiopia,ETH,United Kingdom of Great Britain and Northern Ireland,GBR,104,0,116,5,225
2019,Gambia,GMB,United Kingdom of Great Britain and Northern Ireland,GBR,11,0,16,0,27
2019,Palestinian,PSE,United Kingdom of Great Britain and Northern Ireland,GBR,18,0,27,0,45
2019,Georgia,GEO,United Kingdom of Great Britain and Northern Ireland,GBR,5,0,5,0,10
2019,Ghana,GHA,United Kingdom of Great Britain and Northern Ireland,GBR,14,0,51,5,70
2019,Grenada,GRD,United Kingdom of Great Britain and Northern Ireland,GBR,0,0,5,0,5
2019,Guinea,GIN,United Kingdom of Great Britain and Northern Ireland,GBR,5,0,10,0,15
2019,Honduras,HND,United Kingdom of Great Britain and Northern Ireland,GBR,5,0,5,0,10
2019,Cote d'Ivoire,CIV,United Kingdom of Great Britain and Northern Ireland,GBR,13,0,5,0,18
2019,India,IND,United Kingdom of Great Britain and Northern Ireland,GBR,35,0,129,14,178
2019,Iran (Islamic Rep. of),IRN,United Kingdom of Great Britain and Northern Ireland,GBR,618,0,428,86,1132
2019,Iraq,IRQ,United Kingdom of Great Britain and Northern Ireland,GBR,620,0,960,74,1654
2019,Jamaica,JAM,United Kingdom of Great Britain and Northern Ireland,GBR,18,0,25,5,48
2019,Jordan,JOR,United Kingdom of Great Britain and Northern Ireland,GBR,0,0,14,0,14
2019,Kazakhstan,KAZ,United Kingdom of Great Britain and Northern Ireland,GBR,5,0,0,0,5
2019,Kenya,KEN,United Kingdom of Great Britain and Northern Ireland,GBR,14,0,36,5,55
2019,Kyrgyzstan,KGZ,United Kingdom of Great Britain and Northern Ireland,GBR,0,0,5,0,5
2019,Kuwait,KWT,United Kingdom of Great Britain and Northern Ireland,GBR,5,0,10,5,20
2019,Libya,LBY,United Kingdom of Great Britain and Northern Ireland,GBR,13,0,13,5,31
2019,Saint Lucia,LCA,United Kingdom of Great Britain and Northern Ireland,GBR,0,0,5,0,5
2019,Lebanon,LBN,United Kingdom of Great Britain and Northern Ireland,GBR,5,0,14,0,19
2019,Sri Lanka,LKA,United Kingdom of Great Britain and Northern Ireland,GBR,218,0,150,32,400
2019,Mexico,MEX,United Kingdom of Great Britain and Northern Ireland,GBR,0,0,5,0,5
2019,Malaysia,MYS,United Kingdom of Great Britain and Northern Ireland,GBR,11,0,29,0,40
2019,Malawi,MWI,United Kingdom of Great Britain and Northern Ireland,GBR,10,0,16,5,31
2019,Mongolia,MNG,United Kingdom of Great Britain and Northern Ireland,GBR,0,0,5,0,5
2019,Morocco,MAR,United Kingdom of Great Britain and Northern Ireland,GBR,11,0,23,5,39
2019,Mauritius,MUS,United Kingdom of Great Britain and Northern Ireland,GBR,5,0,5,0,10
2019,Myanmar,MMR,United Kingdom of Great Britain and Northern Ireland,GBR,11,0,5,0,16
2019,Namibia,NAM,United Kingdom of Great Britain and Northern Ireland,GBR,35,0,64,5,104
2019,Nepal,NPL,United Kingdom of Great Britain and Northern Ireland,GBR,10,0,24,5,39
2019,Nigeria,NGA,United Kingdom of Great Britain and Northern Ireland,GBR,124,0,252,27,403
2019,Pakistan,PAK,United Kingdom of Great Britain and Northern Ireland,GBR,207,0,460,44,711
2019,Philippines,PHL,United Kingdom of Great Britain and Northern Ireland,GBR,5,0,18,0,23
2019,South Africa,ZAF,United Kingdom of Great Britain and Northern Ireland,GBR,5,0,15,0,20
2019,Russian Federation,RUS,United Kingdom of Great Britain and Northern Ireland,GBR,22,0,13,5,40
2019,Rwanda,RWA,United Kingdom of Great Britain and Northern Ireland,GBR,5,0,5,0,10
2019,El Salvador,SLV,United Kingdom of Great Britain and Northern Ireland,GBR,50,0,28,10,88
2019,Saudi Arabia,SAU,United Kingdom of Great Britain and Northern Ireland,GBR,0,0,0,5,5
2019,Senegal,SEN,United Kingdom of Great Britain and Northern Ireland,GBR,0,0,5,0,5
2019,Sierra Leone,SLE,United Kingdom of Great Britain and Northern Ireland,GBR,10,0,14,0,24
2019,Somalia,SOM,United Kingdom of Great Britain and Northern Ireland,GBR,33,0,37,5,75
2019,Viet Nam,VNM,United Kingdom of Great Britain and Northern Ireland,GBR,195,0,126,30,351
2019,Saint Kitts and Nevis,KNA,United Kingdom of Great Britain and Northern Ireland,GBR,0,0,5,0,5
2019,Sudan,SDN,United Kingdom of Great Britain and Northern Ireland,GBR,114,0,41,62,217
2019,South Sudan,SSD,United Kingdom of Great Britain and Northern Ireland,GBR,5,0,0,0,5
2019,Syrian Arab Rep.,SYR,United Kingdom of Great Britain and Northern Ireland,GBR,24,0,22,0,46
2019,United Rep. of Tanzania,TZA,United Kingdom of Great Britain and Northern Ireland,GBR,5,0,16,5,26
2019,Thailand,THA,United Kingdom of Great Britain and Northern Ireland,GBR,5,0,5,0,10
2019,Trinidad and Tobago,TTO,United Kingdom of Great Britain and Northern Ireland,GBR,5,0,10,0,15
2019,Tunisia,TUN,United Kingdom of Great Britain and Northern Ireland,GBR,5,0,13,0,18
2019,Turkey,TUR,United Kingdom of Great Britain and Northern Ireland,GBR,101,0,85,5,191
2019,Uganda,UGA,United Kingdom of Great Britain and Northern Ireland,GBR,16,0,15,0,31
2019,Ukraine,UKR,United Kingdom of Great Britain and Northern Ireland,GBR,30,0,34,5,69
2019,Uzbekistan,UZB,United Kingdom of Great Britain and Northern Ireland,GBR,5,0,0,0,5
2019,Venezuela (Bolivarian Republic of),VEN,United Kingdom of Great Britain and Northern Ireland,GBR,5,0,5,0,10
2019,Yemen,YEM,United Kingdom of Great Britain and Northern Ireland,GBR,11,0,5,5,21
2019,Zambia,ZMB,United Kingdom of Great Britain and Northern Ireland,GBR,5,0,5,0,10
2019,Zimbabwe,ZWE,United Kingdom of Great Britain and Northern Ireland,GBR,27,0,40,0,67
2019,Stateless,XXA,United Kingdom of Great Britain and Northern Ireland,GBR,19,0,20,12,51
2019,Unknown ,,United Kingdom of Great Britain and Northern Ireland,GBR,50,0,5,5,60
2020,Afghanistan,AFG,United Kingdom of Great Britain and Northern Ireland,GBR,99,0,101,42,242
2020,Albania,ALB,United Kingdom of Great Britain and Northern Ireland,GBR,128,0,87,40,255
2020,Algeria,DZA,United Kingdom of Great Britain and Northern Ireland,GBR,5,0,12,0,17
2020,Angola,AGO,United Kingdom of Great Britain and Northern Ireland,GBR,0,0,5,0,5
2020,Egypt,EGY,United Kingdom of Great Britain and Northern Ireland,GBR,19,0,29,5,53
2020,Armenia,ARM,United Kingdom of Great Britain and Northern Ireland,GBR,0,0,5,0,5
2020,Azerbaijan,AZE,United Kingdom of Great Britain and Northern Ireland,GBR,0,0,5,0,5
2020,Bangladesh,BGD,United Kingdom of Great Britain and Northern Ireland,GBR,53,0,129,15,197
2020,Bolivia (Plurinational State of),BOL,United Kingdom of Great Britain and Northern Ireland,GBR,5,0,0,5,10
2020,Botswana,BWA,United Kingdom of Great Britain and Northern Ireland,GBR,0,0,5,0,5
2020,Brazil,BRA,United Kingdom of Great Britain and Northern Ireland,GBR,5,0,5,0,10
2020,Chad,TCD,United Kingdom of Great Britain and Northern Ireland,GBR,5,0,5,0,10
2020,China,CHN,United Kingdom of Great Britain and Northern Ireland,GBR,15,0,46,5,66
2020,Cameroon,CMR,United Kingdom of Great Britain and Northern Ireland,GBR,15,0,12,0,27
2020,Congo,COG,United Kingdom of Great Britain and Northern Ireland,GBR,0,0,5,0,5
2020,Dem. Rep. of the Congo,COD,United Kingdom of Great Britain and Northern Ireland,GBR,10,0,14,5,29
2020,Dominica,DMA,United Kingdom of Great Britain and Northern Ireland,GBR,5,0,0,0,5
2020,Eritrea,ERI,United Kingdom of Great Britain and Northern Ireland,GBR,35,0,14,10,59
2020,Ethiopia,ETH,United Kingdom of Great Britain and Northern Ireland,GBR,76,0,63,14,153
2020,Gambia,GMB,United Kingdom of Great Britain and Northern Ireland,GBR,0,0,13,0,13
2020,Palestinian,PSE,United Kingdom of Great Britain and Northern Ireland,GBR,12,0,5,5,22
2020,Georgia,GEO,United Kingdom of Great Britain and Northern Ireland,GBR,5,0,5,0,10
2020,Ghana,GHA,United Kingdom of Great Britain and Northern Ireland,GBR,5,0,24,5,34
2020,Guinea,GIN,United Kingdom of Great Britain and Northern Ireland,GBR,0,0,5,0,5
2020,Honduras,HND,United Kingdom of Great Britain and Northern Ireland,GBR,11,0,0,0,11
2020,Cote d'Ivoire,CIV,United Kingdom of Great Britain and Northern Ireland,GBR,0,0,11,0,11
2020,India,IND,United Kingdom of Great Britain and Northern Ireland,GBR,14,0,70,12,96
2020,Iran (Islamic Rep. of),IRN,United Kingdom of Great Britain and Northern Ireland,GBR,171,0,138,50,359
2020,Iraq,IRQ,United Kingdom of Great Britain and Northern Ireland,GBR,279,0,479,31,789
2020,Jamaica,JAM,United Kingdom of Great Britain and Northern Ireland,GBR,5,0,10,0,15
2020,Jordan,JOR,United Kingdom of Great Britain and Northern Ireland,GBR,5,0,5,0,10
2020,Kenya,KEN,United Kingdom of Great Britain and Northern Ireland,GBR,13,0,5,0,18
2020,Kuwait,KWT,United Kingdom of Great Britain and Northern Ireland,GBR,5,0,0,5,10
2020,Libya,LBY,United Kingdom of Great Britain and Northern Ireland,GBR,5,0,5,0,10
2020,Saint Lucia,LCA,United Kingdom of Great Britain and Northern Ireland,GBR,0,0,5,0,5
2020,Lebanon,LBN,United Kingdom of Great Britain and Northern Ireland,GBR,5,0,5,0,10
2020,Sri Lanka,LKA,United Kingdom of Great Britain and Northern Ireland,GBR,48,0,33,12,93
2020,Mexico,MEX,United Kingdom of Great Britain and Northern Ireland,GBR,0,0,5,0,5
2020,Mali,MLI,United Kingdom of Great Britain and Northern Ireland,GBR,0,0,5,0,5
2020,Malaysia,MYS,United Kingdom of Great Britain and Northern Ireland,GBR,13,0,0,0,13
2020,Malawi,MWI,United Kingdom of Great Britain and Northern Ireland,GBR,5,0,0,0,5
2020,Morocco,MAR,United Kingdom of Great Britain and Northern Ireland,GBR,0,0,5,0,5
2020,Mauritius,MUS,United Kingdom of Great Britain and Northern Ireland,GBR,5,0,0,0,5
2020,Namibia,NAM,United Kingdom of Great Britain and Northern Ireland,GBR,10,0,47,0,57
2020,Nepal,NPL,United Kingdom of Great Britain and Northern Ireland,GBR,0,0,15,0,15
2020,Nicaragua,NIC,United Kingdom of Great Britain and Northern Ireland,GBR,5,0,5,0,10
2020,Nigeria,NGA,United Kingdom of Great Britain and Northern Ireland,GBR,54,0,94,22,170
2020,Oman,OMN,United Kingdom of Great Britain and Northern Ireland,GBR,0,0,0,5,5
2020,Pakistan,PAK,United Kingdom of Great Britain and Northern Ireland,GBR,73,0,133,17,223
2020,Philippines,PHL,United Kingdom of Great Britain and Northern Ireland,GBR,0,0,12,0,12
2020,South Africa,ZAF,United Kingdom of Great Britain and Northern Ireland,GBR,0,0,13,0,13
2020,Russian Federation,RUS,United Kingdom of Great Britain and Northern Ireland,GBR,13,0,5,10,28
2020,Rwanda,RWA,United Kingdom of Great Britain and Northern Ireland,GBR,0,0,5,0,5
2020,El Salvador,SLV,United Kingdom of Great Britain and Northern Ireland,GBR,31,0,19,10,60
2020,Saudi Arabia,SAU,United Kingdom of Great Britain and Northern Ireland,GBR,5,0,0,0,5
2020,Serbia and Kosovo: S/RES/1244 (1999),SRB,United Kingdom of Great Britain and Northern Ireland,GBR,5,0,0,0,5
2020,Senegal,SEN,United Kingdom of Great Britain and Northern Ireland,GBR,0,0,5,0,5
2020,Sierra Leone,SLE,United Kingdom of Great Britain and Northern Ireland,GBR,12,0,0,0,12
2020,Somalia,SOM,United Kingdom of Great Britain and Northern Ireland,GBR,10,0,10,5,25
2020,Viet Nam,VNM,United Kingdom of Great Britain and Northern Ireland,GBR,51,0,40,16,107
2020,Sudan,SDN,United Kingdom of Great Britain and Northern Ireland,GBR,12,0,5,11,28
2020,South Sudan,SSD,United Kingdom of Great Britain and Northern Ireland,GBR,5,0,0,0,5
2020,Syrian Arab Rep.,SYR,United Kingdom of Great Britain and Northern Ireland,GBR,14,0,0,0,14
2020,United Rep. of Tanzania,TZA,United Kingdom of Great Britain and Northern Ireland,GBR,5,0,5,0,10
2020,Thailand,THA,United Kingdom of Great Britain and Northern Ireland,GBR,0,0,0,5,5
2020,Togo,TGO,United Kingdom of Great Britain and Northern Ireland,GBR,0,0,5,0,5
2020,Trinidad and Tobago,TTO,United Kingdom of Great Britain and Northern Ireland,GBR,0,0,5,0,5
2020,Tunisia,TUN,United Kingdom of Great Britain and Northern Ireland,GBR,0,0,5,0,5
2020,Turkey,TUR,United Kingdom of Great Britain and Northern Ireland,GBR,43,0,22,5,70
2020,Uganda,UGA,United Kingdom of Great Britain and Northern Ireland,GBR,5,0,0,0,5
2020,Ukraine,UKR,United Kingdom of Great Britain and Northern Ireland,GBR,10,0,17,0,27
2020,Uzbekistan,UZB,United Kingdom of Great Britain and Northern Ireland,GBR,5,0,0,0,5
2020,Venezuela (Bolivarian Republic of),VEN,United Kingdom of Great Britain and Northern Ireland,GBR,5,0,0,0,5
2020,Yemen,YEM,United Kingdom of Great Britain and Northern Ireland,GBR,13,0,0,0,13
2020,Zimbabwe,ZWE,United Kingdom of Great Britain and Northern Ireland,GBR,13,0,19,5,37
2020,Stateless,XXA,United Kingdom of Great Britain and Northern Ireland,GBR,13,0,5,11,29
2020,Unknown ,,United Kingdom of Great Britain and Northern Ireland,GBR,17,0,5,0,22
2000,Afghanistan,AFG,Belgium,BEL,0,0,15,0,15
2000,Albania,ALB,Belgium,BEL,5,0,5,0,10
2000,Algeria,DZA,Belgium,BEL,0,0,27,0,27
2000,Angola,AGO,Belgium,BEL,5,0,46,0,51
2000,Armenia,ARM,Belgium,BEL,0,0,38,0,38
2000,Azerbaijan,AZE,Belgium,BEL,0,0,5,0,5
2000,Burundi,BDI,Belgium,BEL,26,0,105,0,131
2000,Bangladesh,BGD,Belgium,BEL,0,0,10,0,10
2000,Belarus,BLR,Belgium,BEL,0,0,17,0,17
2000,Bulgaria,BGR,Belgium,BEL,0,0,10,0,10
2000,Cameroon,CMR,Belgium,BEL,0,0,60,5,65
2000,Congo,COG,Belgium,BEL,0,0,19,0,19
2000,Dem. Rep. of the Congo,COD,Belgium,BEL,55,0,322,10,387
2000,Colombia,COL,Belgium,BEL,0,0,17,0,17
2000,Cuba,CUB,Belgium,BEL,5,0,0,0,5
2000,Czechia,CZE,Belgium,BEL,0,0,10,0,10
2000,Ecuador,ECU,Belgium,BEL,0,0,5,0,5
2000,Ethiopia,ETH,Belgium,BEL,5,0,5,0,10
2000,Georgia,GEO,Belgium,BEL,5,0,22,0,27
2000,Guinea,GIN,Belgium,BEL,5,0,175,0,180
2000,India,IND,Belgium,BEL,0,0,20,0,20
2000,Iran (Islamic Rep. of),IRN,Belgium,BEL,0,0,15,0,15
2000,Iraq,IRQ,Belgium,BEL,0,0,39,0,39
2000,Israel,ISR,Belgium,BEL,0,0,5,0,5
2000,Kenya,KEN,Belgium,BEL,0,0,5,0,5
2000,Lebanon,LBN,Belgium,BEL,0,0,5,0,5
2000,Sri Lanka,LKA,Belgium,BEL,0,0,13,0,13
2000,Mauritania,MRT,Belgium,BEL,5,0,42,0,47
2000,Rep. of Moldova,MDA,Belgium,BEL,0,0,5,0,5
2000,Mongolia,MNG,Belgium,BEL,0,0,5,0,5
2000,Nigeria,NGA,Belgium,BEL,0,0,5,0,5
2000,Pakistan,PAK,Belgium,BEL,5,0,36,0,41
2000,Romania,ROU,Belgium,BEL,0,0,16,0,16
2000,Rwanda,RWA,Belgium,BEL,44,0,91,0,135
2000,Serbia and Kosovo: S/RES/1244 (1999),SRB,Belgium,BEL,0,0,215,5,220
2000,Senegal,SEN,Belgium,BEL,0,0,5,0,5
2000,Sierra Leone,SLE,Belgium,BEL,5,0,59,0,64
2000,Somalia,SOM,Belgium,BEL,5,0,42,0,47
2000,Sudan,SDN,Belgium,BEL,0,0,5,0,5
2000,Slovakia,SVK,Belgium,BEL,0,0,39,0,39
2000,Syrian Arab Rep.,SYR,Belgium,BEL,0,0,20,0,20
2000,Togo,TGO,Belgium,BEL,0,0,5,0,5
2000,Turkey,TUR,Belgium,BEL,10,0,64,5,79
2000,Ukraine,UKR,Belgium,BEL,0,0,18,0,18
2000,Afghanistan,AFG,Denmark,DNK,35,56,61,0,152
2000,Albania,ALB,Denmark,DNK,0,0,5,0,5
2000,Algeria,DZA,Denmark,DNK,0,0,10,0,10
2000,Egypt,EGY,Denmark,DNK,0,0,5,0,5
2000,Armenia,ARM,Denmark,DNK,10,5,150,0,165
2000,Azerbaijan,AZE,Denmark,DNK,5,0,13,0,18
2000,Bahrain,BHR,Denmark,DNK,0,0,5,0,5
2000,Bangladesh,BGD,Denmark,DNK,0,0,12,0,12
2000,Belarus,BLR,Denmark,DNK,5,0,0,0,5
2000,Bosnia and Herzegovina,BIH,Denmark,DNK,0,5,165,0,170
2000,China,CHN,Denmark,DNK,0,0,5,0,5
2000,Cameroon,CMR,Denmark,DNK,0,0,12,0,12
2000,Dem. Rep. of the Congo,COD,Denmark,DNK,0,0,5,0,5
2000,Ethiopia,ETH,Denmark,DNK,0,0,5,0,5
2000,Gambia,GMB,Denmark,DNK,0,0,10,0,10
2000,Palestinian,PSE,Denmark,DNK,5,5,59,0,69
2000,Georgia,GEO,Denmark,DNK,0,5,26,0,31
2000,Ghana,GHA,Denmark,DNK,0,0,5,0,5
2000,Croatia,HRV,Denmark,DNK,0,0,10,0,10
2000,India,IND,Denmark,DNK,5,5,10,0,20
2000,Iran (Islamic Rep. of),IRN,Denmark,DNK,35,26,90,0,151
2000,Iraq,IRQ,Denmark,DNK,5,29,43,0,77
2000,Jordan,JOR,Denmark,DNK,0,5,0,0,5
2000,Liberia,LBR,Denmark,DNK,0,0,5,0,5
2000,Lebanon,LBN,Denmark,DNK,0,0,23,0,23
2000,Sri Lanka,LKA,Denmark,DNK,0,5,14,0,19
2000,North Macedonia,MKD,Denmark,DNK,0,0,5,0,5
2000,Rep. of Moldova,MDA,Denmark,DNK,0,10,14,0,24
2000,Mongolia,MNG,Denmark,DNK,0,0,10,0,10
2000,Nepal,NPL,Denmark,DNK,0,0,5,0,5
2000,Nigeria,NGA,Denmark,DNK,0,0,11,0,11
2000,Pakistan,PAK,Denmark,DNK,0,0,42,0,42
2000,Poland,POL,Denmark,DNK,0,0,5,0,5
2000,Romania,ROU,Denmark,DNK,0,0,5,0,5
2000,Russian Federation,RUS,Denmark,DNK,5,5,44,0,54
2000,Saudi Arabia,SAU,Denmark,DNK,0,0,5,0,5
2000,Serbia and Kosovo: S/RES/1244 (1999),SRB,Denmark,DNK,0,75,600,0,675
2000,Somalia,SOM,Denmark,DNK,0,11,13,0,24
2000,Viet Nam,VNM,Denmark,DNK,5,5,0,0,10
2000,Slovakia,SVK,Denmark,DNK,0,0,49,0,49
2000,Syrian Arab Rep.,SYR,Denmark,DNK,5,5,18,0,28
2000,Turkey,TUR,Denmark,DNK,0,0,20,0,20
2000,Ukraine,UKR,Denmark,DNK,5,10,10,0,25
2000,Stateless,XXA,Denmark,DNK,0,0,5,0,5
2000,Albania,ALB,Finland,FIN,0,0,19,0,19
2000,Algeria,DZA,Finland,FIN,0,0,5,0,5
2000,Bangladesh,BGD,Finland,FIN,0,0,5,0,5
2000,Congo,COG,Finland,FIN,0,0,5,0,5
2000,Ethiopia,ETH,Finland,FIN,0,0,5,0,5
2000,Iraq,IRQ,Finland,FIN,5,5,5,0,15
2000,Libya,LBY,Finland,FIN,0,5,0,0,5
2000,Nigeria,NGA,Finland,FIN,0,0,11,0,11
2000,Pakistan,PAK,Finland,FIN,0,0,5,0,5
2000,Poland,POL,Finland,FIN,0,0,74,0,74
2000,Russian Federation,RUS,Finland,FIN,0,0,0,5,5
2000,Serbia and Kosovo: S/RES/1244 (1999),SRB,Finland,FIN,0,0,5,0,5
2000,Somalia,SOM,Finland,FIN,0,22,0,0,22
2000,Syrian Arab Rep.,SYR,Finland,FIN,0,0,5,0,5
2000,Turkey,TUR,Finland,FIN,0,0,5,0,5
2000,Albania,ALB,France,FRA,44,0,124,0,168
2000,Algeria,DZA,France,FRA,49,0,705,0,754
2000,Angola,AGO,France,FRA,32,0,90,0,122
2000,Armenia,ARM,France,FRA,52,0,124,0,176
2000,Bangladesh,BGD,France,FRA,131,0,541,0,672
2000,China,CHN,France,FRA,24,0,4883,0,4907
2000,Congo,COG,France,FRA,23,0,111,0,134
2000,Dem. Rep. of the Congo,COD,France,FRA,69,0,319,0,388
2000,Georgia,GEO,France,FRA,66,0,80,0,146
2000,Guinea,GIN,France,FRA,13,0,88,0,101
2000,Haiti,HTI,France,FRA,33,0,685,0,718
2000,India,IND,France,FRA,37,0,527,0,564
2000,Sri Lanka,LKA,France,FRA,286,0,546,0,832
2000,Mauritania,MRT,France,FRA,71,0,237,0,308
2000,Rep. of Moldova,MDA,France,FRA,22,0,623,0,645
2000,Mali,MLI,France,FRA,5,0,2215,0,2220
2000,Pakistan,PAK,France,FRA,19,0,686,0,705
2000,Romania,ROU,France,FRA,5,0,134,0,139
2000,Russian Federation,RUS,France,FRA,87,0,233,0,320
2000,Serbia and Kosovo: S/RES/1244 (1999),SRB,France,FRA,146,0,556,0,702
2000,Turkey,TUR,France,FRA,245,0,1331,0,1576
2000,Ukraine,UKR,France,FRA,50,0,237,0,287
2000,Unknown ,,France,FRA,335,0,1165,0,1500
2000,Albania,ALB,Iceland,ISL,0,5,0,0,5
2000,Ukraine,UKR,Iceland,ISL,0,0,5,0,5
2000,Unknown ,,Ireland,IRL,395,0,2457,690,3542
2000,Afghanistan,AFG,Netherlands,NLD,482,254,2791,637,4164
2000,Albania,ALB,Netherlands,NLD,0,10,52,14,76
2000,Algeria,DZA,Netherlands,NLD,5,11,169,93,278
2000,Angola,AGO,Netherlands,NLD,5,37,156,146,344
2000,Egypt,EGY,Netherlands,NLD,0,0,5,0,5
2000,Armenia,ARM,Netherlands,NLD,10,71,234,138,453
2000,Azerbaijan,AZE,Netherlands,NLD,19,57,352,164,592
2000,Burundi,BDI,Netherlands,NLD,11,11,28,17,67
2000,Bangladesh,BGD,Netherlands,NLD,0,0,14,5,19
2000,Bhutan,BTN,Netherlands,NLD,0,0,5,0,5
2000,Belarus,BLR,Netherlands,NLD,0,0,0,10,10
2000,Bosnia and Herzegovina,BIH,Netherlands,NLD,5,135,827,904,1871
2000,Bulgaria,BGR,Netherlands,NLD,0,0,5,5,10
2000,Chad,TCD,Netherlands,NLD,0,0,13,5,18
2000,China,CHN,Netherlands,NLD,0,55,127,138,320
2000,Cameroon,CMR,Netherlands,NLD,0,5,17,5,27
2000,Congo,COG,Netherlands,NLD,5,10,87,70,172
2000,Dem. Rep. of the Congo,COD,Netherlands,NLD,10,52,126,87,275
2000,Czechia,CZE,Netherlands,NLD,0,0,28,33,61
2000,Ecuador,ECU,Netherlands,NLD,0,0,5,0,5
2000,Eritrea,ERI,Netherlands,NLD,0,5,46,10,61
2000,Ethiopia,ETH,Netherlands,NLD,0,10,55,27,92
2000,Gambia,GMB,Netherlands,NLD,0,0,5,0,5
2000,Palestinian,PSE,Netherlands,NLD,0,0,5,0,5
2000,Georgia,GEO,Netherlands,NLD,0,23,88,32,143
2000,Germany,DEU,Netherlands,NLD,0,0,5,0,5
2000,Guinea-Bissau,GNB,Netherlands,NLD,0,0,5,0,5
2000,Guinea,GIN,Netherlands,NLD,0,13,69,45,127
2000,Croatia,HRV,Netherlands,NLD,0,10,34,23,67
2000,Cote d'Ivoire,CIV,Netherlands,NLD,0,0,5,5,10
2000,India,IND,Netherlands,NLD,0,0,5,5,10
2000,Indonesia,IDN,Netherlands,NLD,0,0,5,5,10
2000,Iran (Islamic Rep. of),IRN,Netherlands,NLD,39,192,556,376,1163
2000,Iraq,IRQ,Netherlands,NLD,132,214,3146,814,4306
2000,Jordan,JOR,Netherlands,NLD,0,0,11,0,11
2000,Kazakhstan,KAZ,Netherlands,NLD,0,5,17,5,27
2000,Kenya,KEN,Netherlands,NLD,0,0,5,5,10
2000,Kyrgyzstan,KGZ,Netherlands,NLD,0,0,5,0,5
2000,Liberia,LBR,Netherlands,NLD,5,15,84,31,135
2000,Libya,LBY,Netherlands,NLD,0,0,15,5,20
2000,Lebanon,LBN,Netherlands,NLD,5,0,11,11,27
2000,Sri Lanka,LKA,Netherlands,NLD,20,56,255,111,442
2000,Mauritania,MRT,Netherlands,NLD,0,5,23,0,28
2000,North Macedonia,MKD,Netherlands,NLD,0,5,31,11,47
2000,Rep. of Moldova,MDA,Netherlands,NLD,0,0,0,5,5
2000,Mongolia,MNG,Netherlands,NLD,0,0,24,18,42
2000,Morocco,MAR,Netherlands,NLD,0,0,5,5,10
2000,Myanmar,MMR,Netherlands,NLD,0,10,5,5,20
2000,Netherlands,NLD,Netherlands,NLD,0,5,5,48,58
2000,Niger,NER,Netherlands,NLD,0,0,5,5,10
2000,Nicaragua,NIC,Netherlands,NLD,0,0,0,5,5
2000,Nigeria,NGA,Netherlands,NLD,0,10,48,21,79
2000,Pakistan,PAK,Netherlands,NLD,5,10,23,19,57
2000,Poland,POL,Netherlands,NLD,0,0,5,0,5
2000,Romania,ROU,Netherlands,NLD,0,0,14,5,19
2000,Russian Federation,RUS,Netherlands,NLD,5,28,129,102,264
2000,Rwanda,RWA,Netherlands,NLD,29,11,49,27,116
2000,Serbia and Kosovo: S/RES/1244 (1999),SRB,Netherlands,NLD,19,56,1153,738,1966
2000,Sierra Leone,SLE,Netherlands,NLD,0,33,105,113,251
2000,Somalia,SOM,Netherlands,NLD,12,308,849,378,1547
2000,Viet Nam,VNM,Netherlands,NLD,0,0,20,5,25
2000,Sudan,SDN,Netherlands,NLD,34,57,540,227,858
2000,Slovakia,SVK,Netherlands,NLD,0,0,103,129,232
2000,Syrian Arab Rep.,SYR,Netherlands,NLD,29,27,293,94,443
2000,United Rep. of Tanzania,TZA,Netherlands,NLD,0,0,5,0,5
2000,Tajikistan,TJK,Netherlands,NLD,0,5,5,5,15
2000,Togo,TGO,Netherlands,NLD,0,0,30,31,61
2000,Tunisia,TUN,Netherlands,NLD,0,0,5,5,10
2000,Turkey,TUR,Netherlands,NLD,10,38,779,321,1148
2000,Uganda,UGA,Netherlands,NLD,0,0,5,0,5
2000,Ukraine,UKR,Netherlands,NLD,0,21,73,32,126
2000,Uzbekistan,UZB,Netherlands,NLD,0,0,10,5,15
2000,Yemen,YEM,Netherlands,NLD,0,5,11,18,34
2000,Zimbabwe,ZWE,Netherlands,NLD,0,0,5,0,5
2000,Stateless,XXA,Netherlands,NLD,10,43,164,61,278
2000,Unknown ,,Netherlands,NLD,5,15,42,18,80
2000,Afghanistan,AFG,Norway,NOR,0,0,57,0,57
2000,Albania,ALB,Norway,NOR,0,5,45,0,50
2000,Algeria,DZA,Norway,NOR,0,0,32,0,32
2000,Egypt,EGY,Norway,NOR,0,0,5,0,5
2000,Armenia,ARM,Norway,NOR,0,12,86,0,98
2000,Azerbaijan,AZE,Norway,NOR,0,5,28,0,33
2000,Bangladesh,BGD,Norway,NOR,0,0,21,0,21
2000,Belarus,BLR,Norway,NOR,0,5,29,0,34
2000,Bosnia and Herzegovina,BIH,Norway,NOR,0,18,132,0,150
2000,Bulgaria,BGR,Norway,NOR,0,5,5,0,10
2000,Chile,CHL,Norway,NOR,0,0,5,0,5
2000,Cameroon,CMR,Norway,NOR,0,0,46,0,46
2000,Congo,COG,Norway,NOR,0,0,5,0,5
2000,Colombia,COL,Norway,NOR,5,53,50,0,108
2000,Cuba,CUB,Norway,NOR,0,0,5,0,5
2000,Eritrea,ERI,Norway,NOR,0,5,14,0,19
2000,Estonia,EST,Norway,NOR,0,0,5,0,5
2000,Ethiopia,ETH,Norway,NOR,0,12,89,0,101
2000,Palestinian,PSE,Norway,NOR,0,10,142,0,152
2000,Georgia,GEO,Norway,NOR,0,0,32,0,32
2000,Ghana,GHA,Norway,NOR,0,0,5,0,5
2000,Croatia,HRV,Norway,NOR,0,83,252,0,335
2000,India,IND,Norway,NOR,0,0,5,0,5
2000,Iran (Islamic Rep. of),IRN,Norway,NOR,0,42,387,0,429
2000,Iraq,IRQ,Norway,NOR,0,0,629,0,629
2000,Israel,ISR,Norway,NOR,0,0,18,0,18
2000,Jordan,JOR,Norway,NOR,0,0,11,0,11
2000,Kazakhstan,KAZ,Norway,NOR,0,5,0,0,5
2000,Kenya,KEN,Norway,NOR,0,0,5,0,5
2000,Lebanon,LBN,Norway,NOR,0,5,72,0,77
2000,Sri Lanka,LKA,Norway,NOR,0,16,227,0,243
2000,Lithuania,LTU,Norway,NOR,0,0,32,0,32
2000,Latvia,LVA,Norway,NOR,0,0,13,0,13
2000,North Macedonia,MKD,Norway,NOR,0,0,17,0,17
2000,Rep. of Moldova,MDA,Norway,NOR,0,0,30,0,30
2000,Morocco,MAR,Norway,NOR,0,0,10,0,10
2000,Nicaragua,NIC,Norway,NOR,0,0,5,0,5
2000,Nigeria,NGA,Norway,NOR,0,0,10,0,10
2000,Pakistan,PAK,Norway,NOR,0,10,241,0,251
2000,Poland,POL,Norway,NOR,0,0,19,0,19
2000,Romania,ROU,Norway,NOR,0,0,123,0,123
2000,Russian Federation,RUS,Norway,NOR,0,5,154,0,159
2000,Rwanda,RWA,Norway,NOR,0,0,5,0,5
2000,Serbia and Kosovo: S/RES/1244 (1999),SRB,Norway,NOR,0,11,613,0,624
2000,Sierra Leone,SLE,Norway,NOR,0,0,5,0,5
2000,Somalia,SOM,Norway,NOR,0,23,111,0,134
2000,Sudan,SDN,Norway,NOR,0,5,39,0,44
2000,Slovakia,SVK,Norway,NOR,0,0,101,0,101
2000,Slovenia,SVN,Norway,NOR,0,0,5,0,5
2000,Syrian Arab Rep.,SYR,Norway,NOR,0,5,155,0,160
2000,Turkey,TUR,Norway,NOR,0,10,254,0,264
2000,Uganda,UGA,Norway,NOR,0,0,5,0,5
2000,Ukraine,UKR,Norway,NOR,0,0,15,0,15
2000,Unknown ,,Norway,NOR,0,5,11,0,16
2000,Unknown ,,New Zealand,NZL,60,0,591,0,651
2000,Armenia,ARM,Poland,POL,0,0,59,0,59
2000,Georgia,GEO,Poland,POL,5,0,0,0,5
2000,India,IND,Poland,POL,0,0,5,0,5
2000,Sri Lanka,LKA,Poland,POL,0,0,5,0,5
2000,North Macedonia,MKD,Poland,POL,0,0,5,0,5
2000,Pakistan,PAK,Poland,POL,0,0,5,0,5
2000,Romania,ROU,Poland,POL,0,0,5,0,5
2000,Russian Federation,RUS,Poland,POL,0,0,5,0,5
2000,Serbia and Kosovo: S/RES/1244 (1999),SRB,Poland,POL,5,0,0,0,5
2000,Somalia,SOM,Poland,POL,5,0,0,0,5
2000,Turkey,TUR,Poland,POL,5,0,0,0,5
2000,Stateless,XXA,Poland,POL,0,0,5,0,5
2000,Afghanistan,AFG,Sweden,SWE,0,44,124,0,168
2000,Albania,ALB,Sweden,SWE,5,30,27,0,62
2000,Algeria,DZA,Sweden,SWE,0,12,36,0,48
2000,Egypt,EGY,Sweden,SWE,0,5,12,0,17
2000,Armenia,ARM,Sweden,SWE,5,57,80,0,142
2000,Azerbaijan,AZE,Sweden,SWE,0,5,12,0,17
2000,Bangladesh,BGD,Sweden,SWE,0,31,42,0,73
2000,Belarus,BLR,Sweden,SWE,10,5,28,5,48
2000,Bolivia (Plurinational State of),BOL,Sweden,SWE,0,15,39,10,64
2000,Bosnia and Herzegovina,BIH,Sweden,SWE,25,549,168,10,752
2000,Bulgaria,BGR,Sweden,SWE,0,0,5,0,5
2000,China,CHN,Sweden,SWE,5,5,16,5,31
2000,Chile,CHL,Sweden,SWE,0,0,16,0,16
2000,Congo,COG,Sweden,SWE,0,5,5,0,10
2000,Dem. Rep. of the Congo,COD,Sweden,SWE,0,14,34,0,48
2000,Colombia,COL,Sweden,SWE,10,39,21,10,80
2000,Cuba,CUB,Sweden,SWE,0,5,10,0,15
2000,Djibouti,DJI,Sweden,SWE,0,0,5,0,5
2000,Ecuador,ECU,Sweden,SWE,0,0,59,5,64
2000,Eritrea,ERI,Sweden,SWE,0,5,5,0,10
2000,Estonia,EST,Sweden,SWE,0,0,10,0,10
2000,Ethiopia,ETH,Sweden,SWE,0,10,15,0,25
2000,Gambia,GMB,Sweden,SWE,0,0,5,0,5
2000,Georgia,GEO,Sweden,SWE,0,5,14,5,24
2000,Ghana,GHA,Sweden,SWE,0,0,5,0,5
2000,Guinea-Bissau,GNB,Sweden,SWE,0,0,5,0,5
2000,Guatemala,GTM,Sweden,SWE,0,0,5,0,5
2000,Honduras,HND,Sweden,SWE,0,0,5,5,10
2000,Croatia,HRV,Sweden,SWE,0,26,46,0,72
2000,India,IND,Sweden,SWE,0,10,12,0,22
2000,Iran (Islamic Rep. of),IRN,Sweden,SWE,5,109,232,36,382
2000,Iraq,IRQ,Sweden,SWE,5,74,215,0,294
2000,Israel,ISR,Sweden,SWE,0,0,5,0,5
2000,Jordan,JOR,Sweden,SWE,0,5,10,5,20
2000,Kazakhstan,KAZ,Sweden,SWE,0,23,38,5,66
2000,Kenya,KEN,Sweden,SWE,0,5,10,0,15
2000,Liberia,LBR,Sweden,SWE,0,0,5,0,5
2000,Libya,LBY,Sweden,SWE,5,0,0,0,5
2000,Lebanon,LBN,Sweden,SWE,0,5,32,5,42
2000,Sri Lanka,LKA,Sweden,SWE,0,0,10,0,10
2000,Latvia,LVA,Sweden,SWE,0,0,14,0,14
2000,North Macedonia,MKD,Sweden,SWE,0,35,21,0,56
2000,Rep. of Moldova,MDA,Sweden,SWE,0,0,10,0,10
2000,Morocco,MAR,Sweden,SWE,0,5,0,0,5
2000,Nicaragua,NIC,Sweden,SWE,0,0,5,0,5
2000,Nigeria,NGA,Sweden,SWE,0,0,22,0,22
2000,Pakistan,PAK,Sweden,SWE,0,13,167,5,185
2000,Peru,PER,Sweden,SWE,5,32,18,0,55
2000,Poland,POL,Sweden,SWE,0,5,5,0,10
2000,Romania,ROU,Sweden,SWE,0,0,27,0,27
2000,Russian Federation,RUS,Sweden,SWE,33,41,176,35,285
2000,El Salvador,SLV,Sweden,SWE,0,5,10,0,15
2000,Serbia and Kosovo: S/RES/1244 (1999),SRB,Sweden,SWE,0,407,743,16,1166
2000,Sierra Leone,SLE,Sweden,SWE,0,0,5,0,5
2000,Somalia,SOM,Sweden,SWE,0,10,11,0,21
2000,Viet Nam,VNM,Sweden,SWE,0,15,5,0,20
2000,Sudan,SDN,Sweden,SWE,5,5,5,0,15
2000,Slovakia,SVK,Sweden,SWE,5,5,5,0,15
2000,Slovenia,SVN,Sweden,SWE,0,0,5,0,5
2000,Syrian Arab Rep.,SYR,Sweden,SWE,0,62,95,5,162
2000,United Rep. of Tanzania,TZA,Sweden,SWE,0,5,10,0,15
2000,Thailand,THA,Sweden,SWE,0,0,5,0,5
2000,Tajikistan,TJK,Sweden,SWE,0,0,11,0,11
2000,Turkmenistan,TKM,Sweden,SWE,0,5,5,0,10
2000,Tunisia,TUN,Sweden,SWE,0,0,5,0,5
2000,Turkey,TUR,Sweden,SWE,0,59,110,0,169
2000,Uganda,UGA,Sweden,SWE,0,0,5,0,5
2000,Ukraine,UKR,Sweden,SWE,0,23,38,0,61
2000,Uzbekistan,UZB,Sweden,SWE,0,13,19,0,32
2000,Venezuela (Bolivarian Republic of),VEN,Sweden,SWE,0,0,5,0,5
2000,Stateless,XXA,Sweden,SWE,0,49,78,5,132
2000,Unknown ,,Sweden,SWE,5,15,30,5,55
2000,Unknown ,,Switzerland,CHE,622,0,5479,7026,13127
2001,Afghanistan,AFG,Belgium,BEL,5,0,10,0,15
2001,Albania,ALB,Belgium,BEL,5,0,15,0,20
2001,Algeria,DZA,Belgium,BEL,0,0,10,5,15
2001,Angola,AGO,Belgium,BEL,5,0,21,0,26
2001,Armenia,ARM,Belgium,BEL,0,0,43,5,48
2001,Azerbaijan,AZE,Belgium,BEL,0,0,12,0,12
2001,Burundi,BDI,Belgium,BEL,22,0,111,5,138
2001,Bangladesh,BGD,Belgium,BEL,0,0,5,0,5
2001,Bhutan,BTN,Belgium,BEL,0,0,53,0,53
2001,Belarus,BLR,Belgium,BEL,0,0,24,5,29
2001,Bosnia and Herzegovina,BIH,Belgium,BEL,0,0,5,0,5
2001,Bulgaria,BGR,Belgium,BEL,0,0,10,5,15
2001,Cameroon,CMR,Belgium,BEL,5,0,88,11,104
2001,Congo,COG,Belgium,BEL,0,0,14,5,19
2001,Dem. Rep. of the Congo,COD,Belgium,BEL,72,0,202,32,306
2001,Colombia,COL,Belgium,BEL,0,0,5,0,5
2001,Djibouti,DJI,Belgium,BEL,5,0,5,0,10
2001,Ethiopia,ETH,Belgium,BEL,0,0,5,0,5
2001,Georgia,GEO,Belgium,BEL,0,0,22,0,22
2001,Guinea,GIN,Belgium,BEL,0,0,73,0,73
2001,Cote d'Ivoire,CIV,Belgium,BEL,0,0,5,0,5
2001,India,IND,Belgium,BEL,0,0,5,0,5
2001,Iran (Islamic Rep. of),IRN,Belgium,BEL,5,0,37,5,47
2001,Iraq,IRQ,Belgium,BEL,0,0,19,0,19
2001,Kazakhstan,KAZ,Belgium,BEL,0,0,54,5,59
2001,Kyrgyzstan,KGZ,Belgium,BEL,0,0,5,0,5
2001,Lebanon,LBN,Belgium,BEL,0,0,0,5,5
2001,Mauritania,MRT,Belgium,BEL,0,0,43,0,43
2001,Niger,NER,Belgium,BEL,0,0,10,0,10
2001,Nigeria,NGA,Belgium,BEL,0,0,5,0,5
2001,Pakistan,PAK,Belgium,BEL,0,0,12,0,12
2001,Romania,ROU,Belgium,BEL,0,0,10,5,15
2001,Russian Federation,RUS,Belgium,BEL,0,0,19,0,19
2001,Rwanda,RWA,Belgium,BEL,96,0,129,12,237
2001,Serbia and Kosovo: S/RES/1244 (1999),SRB,Belgium,BEL,10,0,320,62,392
2001,Senegal,SEN,Belgium,BEL,0,0,5,0,5
2001,Sierra Leone,SLE,Belgium,BEL,0,0,38,5,43
2001,Somalia,SOM,Belgium,BEL,5,0,45,10,60
2001,Sudan,SDN,Belgium,BEL,5,0,0,0,5
2001,Slovakia,SVK,Belgium,BEL,0,0,20,0,20
2001,Syrian Arab Rep.,SYR,Belgium,BEL,0,0,12,5,17
2001,Togo,TGO,Belgium,BEL,0,0,5,0,5
2001,Turkey,TUR,Belgium,BEL,5,0,35,0,40
2001,Ukraine,UKR,Belgium,BEL,0,0,5,0,5
2001,Uzbekistan,UZB,Belgium,BEL,0,0,5,0,5
2001,Afghanistan,AFG,Denmark,DNK,5,17,23,0,45
2001,Albania,ALB,Denmark,DNK,0,5,20,0,25
2001,Algeria,DZA,Denmark,DNK,0,0,5,0,5
2001,Egypt,EGY,Denmark,DNK,0,0,5,0,5
2001,Armenia,ARM,Denmark,DNK,5,5,179,0,189
2001,Azerbaijan,AZE,Denmark,DNK,13,5,34,0,52
2001,Bangladesh,BGD,Denmark,DNK,0,0,5,0,5
2001,Belarus,BLR,Denmark,DNK,5,0,18,0,23
2001,Bosnia and Herzegovina,BIH,Denmark,DNK,0,56,312,0,368
2001,China,CHN,Denmark,DNK,5,0,20,0,25
2001,Cameroon,CMR,Denmark,DNK,0,0,5,0,5
2001,Colombia,COL,Denmark,DNK,5,0,0,0,5
2001,Cuba,CUB,Denmark,DNK,0,0,5,0,5
2001,Czechia,CZE,Denmark,DNK,0,0,12,0,12
2001,Ecuador,ECU,Denmark,DNK,0,0,5,0,5
2001,Ethiopia,ETH,Denmark,DNK,0,0,5,0,5
2001,Gambia,GMB,Denmark,DNK,0,0,13,0,13
2001,Palestinian,PSE,Denmark,DNK,14,5,81,0,100
2001,Georgia,GEO,Denmark,DNK,0,5,63,0,68
2001,Croatia,HRV,Denmark,DNK,0,0,5,0,5
2001,India,IND,Denmark,DNK,0,0,19,0,19
2001,Iran (Islamic Rep. of),IRN,Denmark,DNK,16,39,126,0,181
2001,Iraq,IRQ,Denmark,DNK,5,30,122,0,157
2001,Jordan,JOR,Denmark,DNK,0,0,5,0,5
2001,Kazakhstan,KAZ,Denmark,DNK,0,0,16,0,16
2001,Kyrgyzstan,KGZ,Denmark,DNK,0,0,18,0,18
2001,Lebanon,LBN,Denmark,DNK,0,5,20,0,25
2001,Sri Lanka,LKA,Denmark,DNK,0,5,21,0,26
2001,North Macedonia,MKD,Denmark,DNK,0,0,11,0,11
2001,Rep. of Moldova,MDA,Denmark,DNK,5,0,34,0,39
2001,Mongolia,MNG,Denmark,DNK,0,0,27,0,27
2001,Morocco,MAR,Denmark,DNK,0,0,5,0,5
2001,Nepal,NPL,Denmark,DNK,0,0,5,0,5
2001,Pakistan,PAK,Denmark,DNK,0,0,41,0,41
2001,Romania,ROU,Denmark,DNK,0,0,5,0,5
2001,Russian Federation,RUS,Denmark,DNK,22,30,69,0,121
2001,Serbia and Kosovo: S/RES/1244 (1999),SRB,Denmark,DNK,39,149,570,0,758
2001,Sierra Leone,SLE,Denmark,DNK,0,5,5,0,10
2001,Somalia,SOM,Denmark,DNK,0,5,5,0,10
2001,Viet Nam,VNM,Denmark,DNK,0,0,5,0,5
2001,Slovakia,SVK,Denmark,DNK,0,0,24,0,24
2001,Syrian Arab Rep.,SYR,Denmark,DNK,10,0,18,0,28
2001,Tajikistan,TJK,Denmark,DNK,0,0,5,0,5
2001,Turkmenistan,TKM,Denmark,DNK,0,0,5,0,5
2001,Turkey,TUR,Denmark,DNK,0,0,17,0,17
2001,Ukraine,UKR,Denmark,DNK,5,0,31,0,36
2001,Albania,ALB,France,FRA,40,0,100,0,140
2001,Algeria,DZA,France,FRA,118,0,1168,0,1286
2001,Angola,AGO,France,FRA,48,0,174,0,222
2001,Armenia,ARM,France,FRA,67,0,156,0,223
2001,Bangladesh,BGD,France,FRA,130,0,608,0,738
2001,China,CHN,France,FRA,11,0,3906,0,3917
2001,Congo,COG,France,FRA,103,0,275,0,378
2001,Dem. Rep. of the Congo,COD,France,FRA,147,0,1003,0,1150
2001,Georgia,GEO,France,FRA,60,0,117,0,177
2001,Guinea,GIN,France,FRA,18,0,181,0,199
2001,Haiti,HTI,France,FRA,116,0,1780,0,1896
2001,India,IND,France,FRA,29,0,390,0,419
2001,Iraq,IRQ,France,FRA,65,0,66,0,131
2001,Sri Lanka,LKA,France,FRA,305,0,737,0,1042
2001,Mauritania,MRT,France,FRA,115,0,457,0,572
2001,Rep. of Moldova,MDA,France,FRA,23,0,615,0,638
2001,Mali,MLI,France,FRA,11,0,2557,0,2568
2001,Nigeria,NGA,France,FRA,10,0,96,0,106
2001,Pakistan,PAK,France,FRA,20,0,525,0,545
2001,Russian Federation,RUS,France,FRA,108,0,285,0,393
2001,Serbia and Kosovo: S/RES/1244 (1999),SRB,France,FRA,153,0,797,0,950
2001,Senegal,SEN,France,FRA,15,0,251,0,266
2001,Turkey,TUR,France,FRA,288,0,1871,0,2159
2001,Ukraine,UKR,France,FRA,56,0,446,0,502
2001,Unknown ,,France,FRA,324,0,1149,0,1473
2001,Serbia and Kosovo: S/RES/1244 (1999),SRB,Iceland,ISL,0,0,0,5,5
2001,Albania,ALB,Ireland,IRL,5,0,0,0,5
2001,Algeria,DZA,Ireland,IRL,31,0,0,0,31
2001,Angola,AGO,Ireland,IRL,42,0,0,0,42
2001,Armenia,ARM,Ireland,IRL,5,0,0,0,5
2001,Belarus,BLR,Ireland,IRL,5,0,0,0,5
2001,Bulgaria,BGR,Ireland,IRL,13,0,0,0,13
2001,Central African Rep.,CAF,Ireland,IRL,5,0,0,0,5
2001,Cameroon,CMR,Ireland,IRL,5,0,0,0,5
2001,Congo,COG,Ireland,IRL,5,0,0,0,5
2001,Dem. Rep. of the Congo,COD,Ireland,IRL,46,0,0,0,46
2001,Czechia,CZE,Ireland,IRL,15,0,0,0,15
2001,Croatia,HRV,Ireland,IRL,5,0,0,0,5
2001,Iraq,IRQ,Ireland,IRL,22,0,0,0,22
2001,Libya,LBY,Ireland,IRL,32,0,0,0,32
2001,Rep. of Moldova,MDA,Ireland,IRL,14,0,0,0,14
2001,Nigeria,NGA,Ireland,IRL,44,0,0,0,44
2001,Pakistan,PAK,Ireland,IRL,5,0,0,0,5
2001,Poland,POL,Ireland,IRL,5,0,0,0,5
2001,Romania,ROU,Ireland,IRL,45,0,0,0,45
2001,Russian Federation,RUS,Ireland,IRL,17,0,0,0,17
2001,Rwanda,RWA,Ireland,IRL,5,0,0,0,5
2001,Serbia and Kosovo: S/RES/1244 (1999),SRB,Ireland,IRL,36,0,0,0,36
2001,Sierra Leone,SLE,Ireland,IRL,10,0,0,0,10
2001,Somalia,SOM,Ireland,IRL,20,0,0,0,20
2001,Sudan,SDN,Ireland,IRL,5,0,0,0,5
2001,Tajikistan,TJK,Ireland,IRL,5,0,0,0,5
2001,Togo,TGO,Ireland,IRL,5,0,0,0,5
2001,Ukraine,UKR,Ireland,IRL,12,0,0,0,12
2001,Unknown ,,Ireland,IRL,0,0,2008,986,2994
2001,Afghanistan,AFG,Japan,JPN,0,0,12,5,17
2001,China,CHN,Japan,JPN,0,0,5,0,5
2001,Ethiopia,ETH,Japan,JPN,0,0,5,0,5
2001,Iran (Islamic Rep. of),IRN,Japan,JPN,0,0,5,0,5
2001,Sri Lanka,LKA,Japan,JPN,0,0,5,0,5
2001,Myanmar,MMR,Japan,JPN,0,0,10,0,10
2001,Pakistan,PAK,Japan,JPN,0,0,18,0,18
2001,Sudan,SDN,Japan,JPN,0,0,5,0,5
2001,Turkey,TUR,Japan,JPN,0,0,21,10,31
2001,Unknown ,,Japan,JPN,0,0,5,10,15
2001,Afghanistan,AFG,Netherlands,NLD,95,215,27,5295,5632
2001,Albania,ALB,Netherlands,NLD,5,10,0,67,82
2001,Algeria,DZA,Netherlands,NLD,0,13,0,235,248
2001,Angola,AGO,Netherlands,NLD,5,71,5,620,701
2001,Egypt,EGY,Netherlands,NLD,0,0,0,10,10
2001,Armenia,ARM,Netherlands,NLD,14,42,13,497,566
2001,Azerbaijan,AZE,Netherlands,NLD,11,37,10,808,866
2001,Bahrain,BHR,Netherlands,NLD,0,0,0,5,5
2001,Burundi,BDI,Netherlands,NLD,5,18,0,238,261
2001,Benin,BEN,Netherlands,NLD,0,0,0,5,5
2001,Bangladesh,BGD,Netherlands,NLD,0,0,0,21,21
2001,Burkina Faso,BFA,Netherlands,NLD,0,0,0,11,11
2001,Belarus,BLR,Netherlands,NLD,5,0,0,24,29
2001,Bosnia and Herzegovina,BIH,Netherlands,NLD,10,127,21,1073,1231
2001,Bulgaria,BGR,Netherlands,NLD,0,0,0,5,5
2001,Central African Rep.,CAF,Netherlands,NLD,0,0,0,5,5
2001,Chad,TCD,Netherlands,NLD,0,0,0,24,24
2001,China,CHN,Netherlands,NLD,0,37,0,310,347
2001,Cameroon,CMR,Netherlands,NLD,0,5,0,57,62
2001,Congo,COG,Netherlands,NLD,0,16,0,268,284
2001,Dem. Rep. of the Congo,COD,Netherlands,NLD,12,28,0,292,332
2001,Colombia,COL,Netherlands,NLD,0,5,0,5,10
2001,Cuba,CUB,Netherlands,NLD,0,0,0,10,10
2001,Czechia,CZE,Netherlands,NLD,0,11,0,43,54
2001,Ecuador,ECU,Netherlands,NLD,0,0,0,12,12
2001,Eritrea,ERI,Netherlands,NLD,0,10,0,99,109
2001,Ethiopia,ETH,Netherlands,NLD,0,17,0,136,153
2001,Georgia,GEO,Netherlands,NLD,5,10,0,108,123
2001,Germany,DEU,Netherlands,NLD,0,0,0,5,5
2001,Ghana,GHA,Netherlands,NLD,0,0,0,5,5
2001,Guinea-Bissau,GNB,Netherlands,NLD,0,0,0,10,10
2001,Guinea,GIN,Netherlands,NLD,5,36,5,291,337
2001,Croatia,HRV,Netherlands,NLD,5,5,0,46,56
2001,Hungary,HUN,Netherlands,NLD,0,0,0,25,25
2001,Cote d'Ivoire,CIV,Netherlands,NLD,0,5,0,21,26
2001,India,IND,Netherlands,NLD,0,0,0,5,5
2001,Indonesia,IDN,Netherlands,NLD,0,5,0,19,24
2001,Iran (Islamic Rep. of),IRN,Netherlands,NLD,28,98,23,1333,1482
2001,Iraq,IRQ,Netherlands,NLD,222,571,64,6034,6891
2001,Jordan,JOR,Netherlands,NLD,0,0,0,5,5
2001,Kazakhstan,KAZ,Netherlands,NLD,5,10,0,66,81
2001,Kenya,KEN,Netherlands,NLD,0,0,0,10,10
2001,Kyrgyzstan,KGZ,Netherlands,NLD,0,0,0,31,31
2001,Dem. People's Rep. of Korea,PRK,Netherlands,NLD,0,0,0,5,5
2001,Kuwait,KWT,Netherlands,NLD,0,0,0,5,5
2001,Liberia,LBR,Netherlands,NLD,5,11,0,88,104
2001,Libya,LBY,Netherlands,NLD,0,0,0,48,48
2001,Lebanon,LBN,Netherlands,NLD,0,5,0,43,48
2001,Sri Lanka,LKA,Netherlands,NLD,10,47,0,341,398
2001,Lithuania,LTU,Netherlands,NLD,0,0,0,5,5
2001,Mauritania,MRT,Netherlands,NLD,0,5,0,41,46
2001,North Macedonia,MKD,Netherlands,NLD,0,0,0,22,22
2001,Rep. of Moldova,MDA,Netherlands,NLD,0,0,0,5,5
2001,Mongolia,MNG,Netherlands,NLD,0,5,0,72,77
2001,Morocco,MAR,Netherlands,NLD,0,0,0,5,5
2001,Myanmar,MMR,Netherlands,NLD,0,5,0,10,15
2001,Netherlands,NLD,Netherlands,NLD,5,10,0,120,135
2001,Niger,NER,Netherlands,NLD,0,0,0,20,20
2001,Nigeria,NGA,Netherlands,NLD,0,5,0,69,74
2001,Pakistan,PAK,Netherlands,NLD,5,17,0,63,85
2001,Peru,PER,Netherlands,NLD,0,0,0,5,5
2001,Poland,POL,Netherlands,NLD,0,0,0,12,12
2001,Romania,ROU,Netherlands,NLD,0,0,0,16,16
2001,Russian Federation,RUS,Netherlands,NLD,5,49,0,357,411
2001,Rwanda,RWA,Netherlands,NLD,5,20,0,205,230
2001,Serbia and Kosovo: S/RES/1244 (1999),SRB,Netherlands,NLD,50,216,83,4052,4401
2001,Senegal,SEN,Netherlands,NLD,0,0,0,5,5
2001,Sierra Leone,SLE,Netherlands,NLD,5,398,5,590,998
2001,Somalia,SOM,Netherlands,NLD,30,172,21,1660,1883
2001,Viet Nam,VNM,Netherlands,NLD,0,5,0,25,30
2001,Sudan,SDN,Netherlands,NLD,49,92,5,1042,1188
2001,Suriname,SUR,Netherlands,NLD,0,0,0,5,5
2001,Slovakia,SVK,Netherlands,NLD,0,0,0,278,278
2001,Syrian Arab Rep.,SYR,Netherlands,NLD,14,67,0,543,624
2001,United Rep. of Tanzania,TZA,Netherlands,NLD,0,0,0,5,5
2001,Tajikistan,TJK,Netherlands,NLD,0,0,0,16,16
2001,Togo,TGO,Netherlands,NLD,0,5,0,88,93
2001,Tunisia,TUN,Netherlands,NLD,0,0,0,10,10
2001,Turkey,TUR,Netherlands,NLD,16,64,13,1165,1258
2001,Uganda,UGA,Netherlands,NLD,0,5,0,25,30
2001,Ukraine,UKR,Netherlands,NLD,0,12,5,129,146
2001,United States of America,USA,Netherlands,NLD,0,0,0,5,5
2001,Uzbekistan,UZB,Netherlands,NLD,10,0,0,29,39
2001,Yemen,YEM,Netherlands,NLD,0,5,0,26,31
2001,Stateless,XXA,Netherlands,NLD,0,39,0,306,345
2001,Unknown ,,Netherlands,NLD,0,17,5,132,154
2001,Unknown ,,New Zealand,NZL,35,0,528,0,563
2001,Algeria,DZA,Poland,POL,0,0,5,0,5
2001,Armenia,ARM,Poland,POL,0,0,727,5,732
2001,Azerbaijan,AZE,Poland,POL,0,0,34,5,39
2001,Bangladesh,BGD,Poland,POL,0,0,10,0,10
2001,Belarus,BLR,Poland,POL,5,0,38,0,43
2001,Bulgaria,BGR,Poland,POL,0,0,199,5,204
2001,China,CHN,Poland,POL,0,0,5,0,5
2001,Georgia,GEO,Poland,POL,0,0,39,0,39
2001,India,IND,Poland,POL,0,0,12,0,12
2001,Iraq,IRQ,Poland,POL,0,0,5,0,5
2001,Jordan,JOR,Poland,POL,0,0,5,0,5
2001,Kyrgyzstan,KGZ,Poland,POL,0,0,5,0,5
2001,Sri Lanka,LKA,Poland,POL,0,0,5,0,5
2001,Latvia,LVA,Poland,POL,0,0,5,0,5
2001,Rep. of Moldova,MDA,Poland,POL,0,0,85,0,85
2001,Mongolia,MNG,Poland,POL,0,0,150,0,150
2001,Pakistan,PAK,Poland,POL,0,0,5,0,5
2001,Romania,ROU,Poland,POL,0,0,237,0,237
2001,Russian Federation,RUS,Poland,POL,0,0,112,10,122
2001,Serbia and Kosovo: S/RES/1244 (1999),SRB,Poland,POL,0,0,5,0,5
2001,Somalia,SOM,Poland,POL,0,0,0,5,5
2001,Viet Nam,VNM,Poland,POL,0,0,96,0,96
2001,Syrian Arab Rep.,SYR,Poland,POL,0,0,5,0,5
2001,Ukraine,UKR,Poland,POL,0,0,73,0,73
2001,Uzbekistan,UZB,Poland,POL,0,0,0,5,5
2001,Stateless,XXA,Poland,POL,0,0,10,0,10
2001,Unknown ,,South Africa,ZAF,0,0,3116,0,3116
2001,Afghanistan,AFG,Sweden,SWE,0,12,514,5,531
2001,Albania,ALB,Sweden,SWE,0,5,40,0,45
2001,Algeria,DZA,Sweden,SWE,0,11,16,0,27
2001,Egypt,EGY,Sweden,SWE,0,0,10,0,10
2001,Armenia,ARM,Sweden,SWE,0,37,49,13,99
2001,Azerbaijan,AZE,Sweden,SWE,0,5,10,0,15
2001,Burundi,BDI,Sweden,SWE,0,0,5,0,5
2001,Bangladesh,BGD,Sweden,SWE,0,23,31,5,59
2001,Belarus,BLR,Sweden,SWE,0,5,66,5,76
2001,Bolivia (Plurinational State of),BOL,Sweden,SWE,0,5,5,5,15
2001,Brazil,BRA,Sweden,SWE,0,0,5,0,5
2001,Bosnia and Herzegovina,BIH,Sweden,SWE,0,233,1054,115,1402
2001,Bulgaria,BGR,Sweden,SWE,0,0,42,5,47
2001,China,CHN,Sweden,SWE,5,5,18,0,28
2001,Chile,CHL,Sweden,SWE,0,11,26,5,42
2001,Cameroon,CMR,Sweden,SWE,0,0,5,0,5
2001,Dem. Rep. of the Congo,COD,Sweden,SWE,0,0,28,0,28
2001,Colombia,COL,Sweden,SWE,27,40,30,0,97
2001,Ecuador,ECU,Sweden,SWE,0,0,68,5,73
2001,Eritrea,ERI,Sweden,SWE,0,10,41,5,56
2001,Estonia,EST,Sweden,SWE,0,0,5,0,5
2001,Ethiopia,ETH,Sweden,SWE,0,10,41,0,51
2001,Gambia,GMB,Sweden,SWE,0,0,10,0,10
2001,Georgia,GEO,Sweden,SWE,0,5,17,10,32
2001,Ghana,GHA,Sweden,SWE,0,0,10,0,10
2001,Guatemala,GTM,Sweden,SWE,0,5,0,0,5
2001,Guinea,GIN,Sweden,SWE,0,0,5,0,5
2001,Croatia,HRV,Sweden,SWE,0,10,53,0,63
2001,Hungary,HUN,Sweden,SWE,0,0,5,0,5
2001,India,IND,Sweden,SWE,0,5,26,0,31
2001,Iran (Islamic Rep. of),IRN,Sweden,SWE,38,179,373,24,614
2001,Iraq,IRQ,Sweden,SWE,0,68,160,21,249
2001,Israel,ISR,Sweden,SWE,0,0,10,0,10
2001,Jordan,JOR,Sweden,SWE,0,14,25,10,49
2001,Kazakhstan,KAZ,Sweden,SWE,0,51,68,0,119
2001,Kenya,KEN,Sweden,SWE,0,0,17,0,17
2001,Kyrgyzstan,KGZ,Sweden,SWE,0,0,5,0,5
2001,Rep. of Korea,KOR,Sweden,SWE,0,5,5,0,10
2001,Liberia,LBR,Sweden,SWE,0,0,5,0,5
2001,Libya,LBY,Sweden,SWE,0,0,5,0,5
2001,Lebanon,LBN,Sweden,SWE,15,42,53,5,115
2001,Sri Lanka,LKA,Sweden,SWE,5,0,40,5,50
2001,Lithuania,LTU,Sweden,SWE,0,0,16,0,16
2001,Latvia,LVA,Sweden,SWE,0,0,10,0,10
2001,North Macedonia,MKD,Sweden,SWE,0,5,19,0,24
2001,Rep. of Moldova,MDA,Sweden,SWE,0,0,10,0,10
2001,Mongolia,MNG,Sweden,SWE,0,0,17,0,17
2001,Nigeria,NGA,Sweden,SWE,0,5,17,0,22
2001,Pakistan,PAK,Sweden,SWE,0,26,42,5,73
2001,Paraguay,PRY,Sweden,SWE,0,0,5,0,5
2001,Peru,PER,Sweden,SWE,0,22,21,22,65
2001,Poland,POL,Sweden,SWE,0,5,5,0,10
2001,Romania,ROU,Sweden,SWE,0,0,21,0,21
2001,Russian Federation,RUS,Sweden,SWE,15,59,176,31,281
2001,Rwanda,RWA,Sweden,SWE,0,5,10,0,15
2001,El Salvador,SLV,Sweden,SWE,0,0,5,0,5
2001,Serbia and Kosovo: S/RES/1244 (1999),SRB,Sweden,SWE,0,993,1581,48,2622
2001,Senegal,SEN,Sweden,SWE,0,0,5,0,5
2001,Sierra Leone,SLE,Sweden,SWE,0,0,10,0,10
2001,Somalia,SOM,Sweden,SWE,0,11,13,0,24
2001,Viet Nam,VNM,Sweden,SWE,0,10,5,0,15
2001,Slovakia,SVK,Sweden,SWE,0,0,59,5,64
2001,Syrian Arab Rep.,SYR,Sweden,SWE,15,100,153,12,280
2001,United Rep. of Tanzania,TZA,Sweden,SWE,0,0,10,0,10
2001,Tajikistan,TJK,Sweden,SWE,0,5,14,0,19
2001,Tunisia,TUN,Sweden,SWE,0,0,5,0,5
2001,Turkey,TUR,Sweden,SWE,5,70,98,0,173
2001,Ukraine,UKR,Sweden,SWE,0,15,39,5,59
2001,Uzbekistan,UZB,Sweden,SWE,0,5,5,5,15
2001,Yemen,YEM,Sweden,SWE,0,0,10,0,10
2001,Stateless,XXA,Sweden,SWE,11,54,194,10,269
2001,Unknown ,,Sweden,SWE,0,11,21,0,32
2001,Unknown ,,Switzerland,CHE,1178,0,5079,6339,12596
2002,Afghanistan,AFG,Belgium,BEL,0,0,5,0,5
2002,Albania,ALB,Belgium,BEL,0,0,50,5,55
2002,Algeria,DZA,Belgium,BEL,5,0,236,36,277
2002,Angola,AGO,Belgium,BEL,0,0,35,5,40
2002,Armenia,ARM,Belgium,BEL,0,0,31,5,36
2002,Azerbaijan,AZE,Belgium,BEL,0,0,5,0,5
2002,Burundi,BDI,Belgium,BEL,5,0,37,10,52
2002,Bangladesh,BGD,Belgium,BEL,0,0,5,0,5
2002,Bhutan,BTN,Belgium,BEL,0,0,5,0,5
2002,Belarus,BLR,Belgium,BEL,0,0,24,5,29
2002,Bosnia and Herzegovina,BIH,Belgium,BEL,0,0,19,0,19
2002,Cameroon,CMR,Belgium,BEL,5,0,36,0,41
2002,Dem. Rep. of the Congo,COD,Belgium,BEL,18,0,147,38,203
2002,Colombia,COL,Belgium,BEL,0,0,0,5,5
2002,Czechia,CZE,Belgium,BEL,0,0,10,0,10
2002,Djibouti,DJI,Belgium,BEL,5,0,5,0,10
2002,Ethiopia,ETH,Belgium,BEL,0,0,5,0,5
2002,Georgia,GEO,Belgium,BEL,10,0,47,5,62
2002,Guinea,GIN,Belgium,BEL,5,0,150,16,171
2002,Croatia,HRV,Belgium,BEL,0,0,5,0,5
2002,Cote d'Ivoire,CIV,Belgium,BEL,0,0,0,5,5
2002,India,IND,Belgium,BEL,0,0,5,0,5
2002,Iran (Islamic Rep. of),IRN,Belgium,BEL,0,0,68,11,79
2002,Iraq,IRQ,Belgium,BEL,0,0,26,0,26
2002,Kazakhstan,KAZ,Belgium,BEL,0,0,24,5,29
2002,Kyrgyzstan,KGZ,Belgium,BEL,0,0,5,0,5
2002,Liberia,LBR,Belgium,BEL,0,0,5,0,5
2002,Mauritania,MRT,Belgium,BEL,0,0,24,0,24
2002,North Macedonia,MKD,Belgium,BEL,0,0,15,0,15
2002,Rep. of Moldova,MDA,Belgium,BEL,0,0,5,0,5
2002,Nepal,NPL,Belgium,BEL,0,0,104,5,109
2002,Niger,NER,Belgium,BEL,0,0,15,5,20
2002,Nigeria,NGA,Belgium,BEL,0,0,10,5,15
2002,Pakistan,PAK,Belgium,BEL,0,0,24,5,29
2002,Romania,ROU,Belgium,BEL,0,0,10,0,10
2002,Russian Federation,RUS,Belgium,BEL,10,0,56,5,71
2002,Rwanda,RWA,Belgium,BEL,54,0,51,10,115
2002,Serbia and Kosovo: S/RES/1244 (1999),SRB,Belgium,BEL,10,0,199,51,260
2002,Sierra Leone,SLE,Belgium,BEL,0,0,33,5,38
2002,Somalia,SOM,Belgium,BEL,0,0,20,0,20
2002,Slovakia,SVK,Belgium,BEL,0,0,17,0,17
2002,Togo,TGO,Belgium,BEL,0,0,5,0,5
2002,Turkey,TUR,Belgium,BEL,10,0,34,14,58
2002,Ukraine,UKR,Belgium,BEL,0,0,17,5,22
2002,Uzbekistan,UZB,Belgium,BEL,5,0,20,0,25
2002,Afghanistan,AFG,Denmark,DNK,22,12,98,0,132
2002,Albania,ALB,Denmark,DNK,0,0,31,0,31
2002,Algeria,DZA,Denmark,DNK,0,0,5,0,5
2002,Armenia,ARM,Denmark,DNK,0,0,52,0,52
2002,Azerbaijan,AZE,Denmark,DNK,12,5,83,0,100
2002,Bangladesh,BGD,Denmark,DNK,0,0,14,0,14
2002,Belarus,BLR,Denmark,DNK,0,0,5,0,5
2002,Bosnia and Herzegovina,BIH,Denmark,DNK,5,72,651,0,728
2002,China,CHN,Denmark,DNK,5,0,34,0,39
2002,Cameroon,CMR,Denmark,DNK,0,0,10,0,10
2002,Dem. Rep. of the Congo,COD,Denmark,DNK,0,0,23,0,23
2002,Eritrea,ERI,Denmark,DNK,0,0,5,0,5
2002,Ethiopia,ETH,Denmark,DNK,0,0,16,0,16
2002,Gambia,GMB,Denmark,DNK,0,0,16,0,16
2002,Palestinian,PSE,Denmark,DNK,5,0,99,0,104
2002,Georgia,GEO,Denmark,DNK,0,0,19,0,19
2002,Guatemala,GTM,Denmark,DNK,0,0,5,0,5
2002,Croatia,HRV,Denmark,DNK,0,0,5,0,5
2002,India,IND,Denmark,DNK,0,0,36,0,36
2002,Iran (Islamic Rep. of),IRN,Denmark,DNK,21,33,165,0,219
2002,Iraq,IRQ,Denmark,DNK,24,113,534,0,671
2002,Jordan,JOR,Denmark,DNK,0,0,5,0,5
2002,Kazakhstan,KAZ,Denmark,DNK,0,0,23,0,23
2002,Kyrgyzstan,KGZ,Denmark,DNK,0,0,5,0,5
2002,Libya,LBY,Denmark,DNK,0,0,5,0,5
2002,Lebanon,LBN,Denmark,DNK,0,0,29,0,29
2002,Sri Lanka,LKA,Denmark,DNK,0,0,21,0,21
2002,North Macedonia,MKD,Denmark,DNK,0,0,36,0,36
2002,Rep. of Moldova,MDA,Denmark,DNK,0,0,5,0,5
2002,Mongolia,MNG,Denmark,DNK,0,0,5,0,5
2002,Nepal,NPL,Denmark,DNK,0,0,10,0,10
2002,Nigeria,NGA,Denmark,DNK,0,0,11,0,11
2002,Pakistan,PAK,Denmark,DNK,0,0,39,0,39
2002,Peru,PER,Denmark,DNK,0,0,5,0,5
2002,Russian Federation,RUS,Denmark,DNK,5,12,25,0,42
2002,Rwanda,RWA,Denmark,DNK,0,0,5,0,5
2002,Serbia and Kosovo: S/RES/1244 (1999),SRB,Denmark,DNK,0,31,417,0,448
2002,Sierra Leone,SLE,Denmark,DNK,0,0,10,0,10
2002,Somalia,SOM,Denmark,DNK,5,5,16,0,26
2002,Viet Nam,VNM,Denmark,DNK,0,0,5,0,5
2002,Syrian Arab Rep.,SYR,Denmark,DNK,20,0,15,0,35
2002,Tajikistan,TJK,Denmark,DNK,0,0,5,0,5
2002,Tunisia,TUN,Denmark,DNK,0,0,5,0,5
2002,Turkey,TUR,Denmark,DNK,0,0,37,0,37
2002,Ukraine,UKR,Denmark,DNK,0,0,15,0,15
2002,Uzbekistan,UZB,Denmark,DNK,0,5,0,0,5
2002,Stateless,XXA,Denmark,DNK,0,0,5,0,5
2002,Albania,ALB,France,FRA,79,0,139,0,218
2002,Algeria,DZA,France,FRA,118,0,1169,0,1287
2002,Angola,AGO,France,FRA,36,0,207,0,243
2002,Armenia,ARM,France,FRA,62,0,188,0,250
2002,Bangladesh,BGD,France,FRA,83,0,647,0,730
2002,China,CHN,France,FRA,10,0,2130,0,2140
2002,Congo,COG,France,FRA,87,0,358,0,445
2002,Dem. Rep. of the Congo,COD,France,FRA,189,0,1480,0,1669
2002,Georgia,GEO,France,FRA,61,0,282,0,343
2002,Guinea,GIN,France,FRA,35,0,343,0,378
2002,Haiti,HTI,France,FRA,134,0,1503,0,1637
2002,Cote d'Ivoire,CIV,France,FRA,5,0,176,0,181
2002,India,IND,France,FRA,20,0,330,0,350
2002,Iran (Islamic Rep. of),IRN,France,FRA,37,0,96,0,133
2002,Iraq,IRQ,France,FRA,44,0,62,0,106
2002,Sri Lanka,LKA,France,FRA,333,0,1024,0,1357
2002,Mauritania,MRT,France,FRA,113,0,653,0,766
2002,Rep. of Moldova,MDA,France,FRA,15,0,404,0,419
2002,Mali,MLI,France,FRA,5,0,1677,0,1682
2002,Nigeria,NGA,France,FRA,5,0,117,0,122
2002,Pakistan,PAK,France,FRA,5,0,283,0,288
2002,Russian Federation,RUS,France,FRA,130,0,264,0,394
2002,Serbia and Kosovo: S/RES/1244 (1999),SRB,France,FRA,113,0,775,0,888
2002,Senegal,SEN,France,FRA,18,0,373,0,391
2002,Turkey,TUR,France,FRA,262,0,2201,0,2463
2002,Ukraine,UKR,France,FRA,40,0,255,0,295
2002,Unknown ,,France,FRA,212,0,4525,0,4737
2002,Albania,ALB,Iceland,ISL,0,5,0,0,5
2002,Iran (Islamic Rep. of),IRN,Iceland,ISL,0,5,0,0,5
2002,Afghanistan,AFG,Ireland,IRL,5,0,5,0,10
2002,Albania,ALB,Ireland,IRL,18,0,33,10,61
2002,Algeria,DZA,Ireland,IRL,55,0,151,5,211
2002,Angola,AGO,Ireland,IRL,80,0,69,0,149
2002,Egypt,EGY,Ireland,IRL,11,0,10,0,21
2002,Armenia,ARM,Ireland,IRL,10,0,5,0,15
2002,Azerbaijan,AZE,Ireland,IRL,5,0,5,5,15
2002,Burundi,BDI,Ireland,IRL,0,0,10,0,10
2002,Belarus,BLR,Ireland,IRL,19,0,19,0,38
2002,Bosnia and Herzegovina,BIH,Ireland,IRL,5,0,5,0,10
2002,Bulgaria,BGR,Ireland,IRL,16,0,55,5,76
2002,Cambodia,KHM,Ireland,IRL,13,0,45,5,63
2002,China,CHN,Ireland,IRL,0,0,5,0,5
2002,Congo,COG,Ireland,IRL,0,0,12,0,12
2002,Dem. Rep. of the Congo,COD,Ireland,IRL,67,0,114,10,191
2002,Czechia,CZE,Ireland,IRL,41,0,127,19,187
2002,Estonia,EST,Ireland,IRL,0,0,21,10,31
2002,Ethiopia,ETH,Ireland,IRL,0,0,5,0,5
2002,Georgia,GEO,Ireland,IRL,15,0,39,0,54
2002,Ghana,GHA,Ireland,IRL,5,0,48,10,63
2002,Guinea-Bissau,GNB,Ireland,IRL,0,0,12,0,12
2002,Guinea,GIN,Ireland,IRL,0,0,5,0,5
2002,Croatia,HRV,Ireland,IRL,50,0,99,10,159
2002,Cote d'Ivoire,CIV,Ireland,IRL,5,0,25,5,35
2002,Iran (Islamic Rep. of),IRN,Ireland,IRL,5,0,10,0,15
2002,Iraq,IRQ,Ireland,IRL,24,0,20,0,44
2002,Israel,ISR,Ireland,IRL,0,0,5,5,10
2002,Kazakhstan,KAZ,Ireland,IRL,10,0,22,5,37
2002,Kenya,KEN,Ireland,IRL,10,0,13,5,28
2002,Liberia,LBR,Ireland,IRL,0,0,11,0,11
2002,Libya,LBY,Ireland,IRL,11,0,12,5,28
2002,Lebanon,LBN,Ireland,IRL,0,0,5,0,5
2002,Lithuania,LTU,Ireland,IRL,5,0,52,13,70
2002,Latvia,LVA,Ireland,IRL,5,0,33,5,43
2002,North Macedonia,MKD,Ireland,IRL,0,0,12,0,12
2002,Rep. of Moldova,MDA,Ireland,IRL,56,0,177,28,261
2002,Malawi,MWI,Ireland,IRL,0,0,5,0,5
2002,Niger,NER,Ireland,IRL,5,0,0,0,5
2002,Nigeria,NGA,Ireland,IRL,131,0,1099,228,1458
2002,Pakistan,PAK,Ireland,IRL,12,0,42,5,59
2002,Poland,POL,Ireland,IRL,30,0,102,42,174
2002,Romania,ROU,Ireland,IRL,109,0,579,138,826
2002,South Africa,ZAF,Ireland,IRL,12,0,95,12,119
2002,Russian Federation,RUS,Ireland,IRL,65,0,139,14,218
2002,Rwanda,RWA,Ireland,IRL,5,0,11,0,16
2002,Serbia and Kosovo: S/RES/1244 (1999),SRB,Ireland,IRL,39,0,126,10,175
2002,Sierra Leone,SLE,Ireland,IRL,21,0,96,15,132
2002,Somalia,SOM,Ireland,IRL,19,0,18,0,37
2002,Sudan,SDN,Ireland,IRL,5,0,11,5,21
2002,Slovakia,SVK,Ireland,IRL,10,0,15,0,25
2002,Tajikistan,TJK,Ireland,IRL,0,0,5,0,5
2002,Togo,TGO,Ireland,IRL,5,0,5,0,10
2002,Turkey,TUR,Ireland,IRL,5,0,10,0,15
2002,Uganda,UGA,Ireland,IRL,11,0,5,0,16
2002,Ukraine,UKR,Ireland,IRL,34,0,78,21,133
2002,Uzbekistan,UZB,Ireland,IRL,5,0,16,5,26
2002,Zimbabwe,ZWE,Ireland,IRL,15,0,26,0,41
2002,Stateless,XXA,Ireland,IRL,5,0,13,0,18
2002,Afghanistan,AFG,Japan,JPN,0,0,35,5,40
2002,Bangladesh,BGD,Japan,JPN,0,0,5,0,5
2002,China,CHN,Japan,JPN,0,0,5,0,5
2002,Iran (Islamic Rep. of),IRN,Japan,JPN,0,0,13,0,13
2002,Myanmar,MMR,Japan,JPN,0,0,20,5,25
2002,Pakistan,PAK,Japan,JPN,0,0,37,5,42
2002,Viet Nam,VNM,Japan,JPN,0,0,5,0,5
2002,Sudan,SDN,Japan,JPN,0,0,5,0,5
2002,Turkey,TUR,Japan,JPN,0,0,93,10,103
2002,Unknown ,,Japan,JPN,0,0,10,5,15
2002,Afghanistan,AFG,Netherlands,NLD,17,110,454,697,1278
2002,Albania,ALB,Netherlands,NLD,0,5,22,15,42
2002,Algeria,DZA,Netherlands,NLD,0,25,141,33,199
2002,Angola,AGO,Netherlands,NLD,5,225,1743,202,2175
2002,Egypt,EGY,Netherlands,NLD,0,0,10,0,10
2002,Armenia,ARM,Netherlands,NLD,5,120,945,97,1167
2002,Azerbaijan,AZE,Netherlands,NLD,20,319,2042,167,2548
2002,Burundi,BDI,Netherlands,NLD,5,15,48,42,110
2002,Benin,BEN,Netherlands,NLD,0,0,10,0,10
2002,Bangladesh,BGD,Netherlands,NLD,0,5,19,5,29
2002,Bhutan,BTN,Netherlands,NLD,0,0,0,5,5
2002,Burkina Faso,BFA,Netherlands,NLD,0,0,16,0,16
2002,Belarus,BLR,Netherlands,NLD,0,0,34,0,34
2002,Bosnia and Herzegovina,BIH,Netherlands,NLD,10,85,433,114,642
2002,Bulgaria,BGR,Netherlands,NLD,0,0,10,0,10
2002,Central African Rep.,CAF,Netherlands,NLD,0,0,5,0,5
2002,Chad,TCD,Netherlands,NLD,0,0,32,0,32
2002,China,CHN,Netherlands,NLD,0,72,716,88,876
2002,Cameroon,CMR,Netherlands,NLD,0,10,97,16,123
2002,Congo,COG,Netherlands,NLD,10,66,448,66,590
2002,Dem. Rep. of the Congo,COD,Netherlands,NLD,5,56,363,62,486
2002,Comoros,COM,Netherlands,NLD,0,0,5,0,5
2002,Colombia,COL,Netherlands,NLD,0,0,5,5,10
2002,Cuba,CUB,Netherlands,NLD,0,0,5,0,5
2002,Czechia,CZE,Netherlands,NLD,0,0,16,10,26
2002,Eritrea,ERI,Netherlands,NLD,0,31,207,24,262
2002,Ethiopia,ETH,Netherlands,NLD,5,15,168,23,211
2002,Gambia,GMB,Netherlands,NLD,0,0,5,0,5
2002,Georgia,GEO,Netherlands,NLD,5,17,190,25,237
2002,Ghana,GHA,Netherlands,NLD,0,0,5,0,5
2002,Guinea-Bissau,GNB,Netherlands,NLD,0,0,15,0,15
2002,Guinea,GIN,Netherlands,NLD,0,42,422,75,539
2002,Croatia,HRV,Netherlands,NLD,0,5,87,11,103
2002,Cote d'Ivoire,CIV,Netherlands,NLD,0,0,25,5,30
2002,India,IND,Netherlands,NLD,0,5,12,0,17
2002,Indonesia,IDN,Netherlands,NLD,0,5,18,5,28
2002,Iran (Islamic Rep. of),IRN,Netherlands,NLD,32,255,1348,157,1792
2002,Iraq,IRQ,Netherlands,NLD,175,1185,4740,646,6746
2002,Israel,ISR,Netherlands,NLD,0,0,5,0,5
2002,Jordan,JOR,Netherlands,NLD,0,0,5,0,5
2002,Kazakhstan,KAZ,Netherlands,NLD,0,10,119,12,141
2002,Kenya,KEN,Netherlands,NLD,0,5,10,0,15
2002,Kyrgyzstan,KGZ,Netherlands,NLD,0,5,41,5,51
2002,Dem. People's Rep. of Korea,PRK,Netherlands,NLD,0,0,5,0,5
2002,Liberia,LBR,Netherlands,NLD,5,24,106,30,165
2002,Libya,LBY,Netherlands,NLD,0,11,31,13,55
2002,Lebanon,LBN,Netherlands,NLD,0,5,48,0,53
2002,Sri Lanka,LKA,Netherlands,NLD,10,87,387,57,541
2002,Lithuania,LTU,Netherlands,NLD,0,0,5,0,5
2002,Latvia,LVA,Netherlands,NLD,0,0,10,0,10
2002,Mauritania,MRT,Netherlands,NLD,0,10,49,10,69
2002,North Macedonia,MKD,Netherlands,NLD,0,0,28,5,33
2002,Rep. of Moldova,MDA,Netherlands,NLD,0,0,11,0,11
2002,Mali,MLI,Netherlands,NLD,0,0,5,0,5
2002,Mongolia,MNG,Netherlands,NLD,0,5,140,10,155
2002,Morocco,MAR,Netherlands,NLD,0,0,10,0,10
2002,Myanmar,MMR,Netherlands,NLD,0,0,5,0,5
2002,Netherlands,NLD,Netherlands,NLD,20,57,30,92,199
2002,Niger,NER,Netherlands,NLD,0,0,42,10,52
2002,Nigeria,NGA,Netherlands,NLD,0,15,102,10,127
2002,Pakistan,PAK,Netherlands,NLD,0,20,49,5,74
2002,Peru,PER,Netherlands,NLD,0,0,0,5,5
2002,Romania,ROU,Netherlands,NLD,0,10,16,0,26
2002,Russian Federation,RUS,Netherlands,NLD,5,96,743,80,924
2002,Rwanda,RWA,Netherlands,NLD,25,47,341,91,504
2002,Serbia and Kosovo: S/RES/1244 (1999),SRB,Netherlands,NLD,51,144,1726,191,2112
2002,Senegal,SEN,Netherlands,NLD,0,0,10,0,10
2002,Sierra Leone,SLE,Netherlands,NLD,10,245,393,189,837
2002,Somalia,SOM,Netherlands,NLD,64,293,1970,312,2639
2002,Viet Nam,VNM,Netherlands,NLD,5,0,27,0,32
2002,Sudan,SDN,Netherlands,NLD,46,203,1272,282,1803
2002,Slovakia,SVK,Netherlands,NLD,0,10,123,64,197
2002,Syrian Arab Rep.,SYR,Netherlands,NLD,16,144,577,90,827
2002,Tajikistan,TJK,Netherlands,NLD,0,0,21,5,26
2002,Togo,TGO,Netherlands,NLD,5,13,154,27,199
2002,Tunisia,TUN,Netherlands,NLD,0,0,11,0,11
2002,Turkey,TUR,Netherlands,NLD,10,50,822,145,1027
2002,Uganda,UGA,Netherlands,NLD,0,0,14,0,14
2002,Ukraine,UKR,Netherlands,NLD,0,24,132,24,180
2002,Uzbekistan,UZB,Netherlands,NLD,0,5,72,10,87
2002,Yemen,YEM,Netherlands,NLD,0,0,40,5,45
2002,Zimbabwe,ZWE,Netherlands,NLD,0,0,5,0,5
2002,Stateless,XXA,Netherlands,NLD,20,117,506,69,712
2002,Unknown ,,Netherlands,NLD,27,91,312,89,519
2002,Unknown ,,New Zealand,NZL,68,0,529,0,597
2002,Afghanistan,AFG,Poland,POL,0,0,146,5,151
2002,Algeria,DZA,Poland,POL,0,0,10,0,10
2002,Egypt,EGY,Poland,POL,0,0,5,0,5
2002,Armenia,ARM,Poland,POL,0,0,390,0,390
2002,Azerbaijan,AZE,Poland,POL,0,0,77,5,82
2002,Belarus,BLR,Poland,POL,5,0,44,0,49
2002,Bulgaria,BGR,Poland,POL,0,0,15,0,15
2002,China,CHN,Poland,POL,0,0,15,0,15
2002,Cameroon,CMR,Poland,POL,0,0,5,0,5
2002,Georgia,GEO,Poland,POL,0,0,48,0,48
2002,India,IND,Poland,POL,0,0,72,0,72
2002,Iran (Islamic Rep. of),IRN,Poland,POL,0,0,5,0,5
2002,Iraq,IRQ,Poland,POL,0,0,5,0,5
2002,Kazakhstan,KAZ,Poland,POL,0,0,13,0,13
2002,Sri Lanka,LKA,Poland,POL,0,0,11,0,11
2002,Lithuania,LTU,Poland,POL,0,0,5,0,5
2002,Latvia,LVA,Poland,POL,0,0,5,0,5
2002,North Macedonia,MKD,Poland,POL,0,0,5,0,5
2002,Rep. of Moldova,MDA,Poland,POL,0,0,42,0,42
2002,Mongolia,MNG,Poland,POL,0,0,109,0,109
2002,Morocco,MAR,Poland,POL,0,0,5,0,5
2002,Nigeria,NGA,Poland,POL,0,0,10,0,10
2002,Pakistan,PAK,Poland,POL,0,0,14,0,14
2002,Romania,ROU,Poland,POL,0,0,36,0,36
2002,Russian Federation,RUS,Poland,POL,19,0,536,61,616
2002,Somalia,SOM,Poland,POL,0,0,5,0,5
2002,Viet Nam,VNM,Poland,POL,0,0,48,0,48
2002,Sudan,SDN,Poland,POL,0,0,5,0,5
2002,Syrian Arab Rep.,SYR,Poland,POL,0,0,10,0,10
2002,Tajikistan,TJK,Poland,POL,0,0,5,0,5
2002,Turkey,TUR,Poland,POL,0,0,10,0,10
2002,Ukraine,UKR,Poland,POL,0,0,93,0,93
2002,Uzbekistan,UZB,Poland,POL,0,0,13,0,13
2002,Stateless,XXA,Poland,POL,0,0,10,0,10
2002,Afghanistan,AFG,Sweden,SWE,0,5,312,5,322
2002,Albania,ALB,Sweden,SWE,0,11,75,5,91
2002,Algeria,DZA,Sweden,SWE,0,10,31,5,46
2002,Egypt,EGY,Sweden,SWE,0,5,31,5,41
2002,Argentina,ARG,Sweden,SWE,0,0,5,0,5
2002,Armenia,ARM,Sweden,SWE,0,38,105,11,154
2002,Azerbaijan,AZE,Sweden,SWE,0,5,50,0,55
2002,Burundi,BDI,Sweden,SWE,0,5,0,0,5
2002,Bangladesh,BGD,Sweden,SWE,0,24,75,5,104
2002,Belarus,BLR,Sweden,SWE,11,10,105,10,136
2002,Bolivia (Plurinational State of),BOL,Sweden,SWE,0,12,28,10,50
2002,Bosnia and Herzegovina,BIH,Sweden,SWE,5,524,3253,181,3963
2002,Bulgaria,BGR,Sweden,SWE,0,5,178,24,207
2002,China,CHN,Sweden,SWE,0,0,25,0,25
2002,Chile,CHL,Sweden,SWE,0,0,11,0,11
2002,Cameroon,CMR,Sweden,SWE,0,0,5,0,5
2002,Congo,COG,Sweden,SWE,0,0,5,0,5
2002,Dem. Rep. of the Congo,COD,Sweden,SWE,0,0,30,0,30
2002,Colombia,COL,Sweden,SWE,10,25,39,10,84
2002,Cuba,CUB,Sweden,SWE,0,0,10,0,10
2002,Czechia,CZE,Sweden,SWE,0,0,31,10,41
2002,Ecuador,ECU,Sweden,SWE,0,5,72,11,88
2002,Eritrea,ERI,Sweden,SWE,5,5,78,0,88
2002,Estonia,EST,Sweden,SWE,0,5,5,0,10
2002,Ethiopia,ETH,Sweden,SWE,0,11,66,0,77
2002,Gambia,GMB,Sweden,SWE,0,0,12,0,12
2002,Georgia,GEO,Sweden,SWE,0,5,36,10,51
2002,Ghana,GHA,Sweden,SWE,0,0,5,0,5
2002,Guinea-Bissau,GNB,Sweden,SWE,0,0,5,0,5
2002,Guinea,GIN,Sweden,SWE,0,0,19,0,19
2002,Honduras,HND,Sweden,SWE,0,0,5,5,10
2002,Croatia,HRV,Sweden,SWE,0,5,198,29,232
2002,Hungary,HUN,Sweden,SWE,0,0,5,0,5
2002,India,IND,Sweden,SWE,0,0,42,5,47
2002,Iran (Islamic Rep. of),IRN,Sweden,SWE,79,161,354,28,622
2002,Iraq,IRQ,Sweden,SWE,0,42,434,20,496
2002,Israel,ISR,Sweden,SWE,0,5,24,0,29
2002,Jordan,JOR,Sweden,SWE,0,10,28,0,38
2002,Kazakhstan,KAZ,Sweden,SWE,0,32,32,5,69
2002,Kenya,KEN,Sweden,SWE,0,5,12,0,17
2002,Liberia,LBR,Sweden,SWE,0,0,5,0,5
2002,Libya,LBY,Sweden,SWE,10,0,15,0,25
2002,Lebanon,LBN,Sweden,SWE,5,38,53,5,101
2002,Sri Lanka,LKA,Sweden,SWE,0,0,21,0,21
2002,Lithuania,LTU,Sweden,SWE,0,0,19,5,24
2002,Latvia,LVA,Sweden,SWE,0,0,5,0,5
2002,North Macedonia,MKD,Sweden,SWE,0,5,192,10,207
2002,Rep. of Moldova,MDA,Sweden,SWE,0,5,19,5,29
2002,Mongolia,MNG,Sweden,SWE,0,0,103,11,114
2002,Morocco,MAR,Sweden,SWE,0,0,10,0,10
2002,Nigeria,NGA,Sweden,SWE,0,0,18,0,18
2002,Pakistan,PAK,Sweden,SWE,5,34,120,0,159
2002,Peru,PER,Sweden,SWE,0,5,43,10,58
2002,Philippines,PHL,Sweden,SWE,0,0,5,0,5
2002,Poland,POL,Sweden,SWE,0,0,17,0,17
2002,Romania,ROU,Sweden,SWE,0,5,34,0,39
2002,Russian Federation,RUS,Sweden,SWE,5,60,250,24,339
2002,El Salvador,SLV,Sweden,SWE,0,0,335,29,364
2002,Serbia and Kosovo: S/RES/1244 (1999),SRB,Sweden,SWE,29,703,1878,74,2684
2002,Sierra Leone,SLE,Sweden,SWE,0,0,17,0,17
2002,Somalia,SOM,Sweden,SWE,0,5,16,0,21
2002,Viet Nam,VNM,Sweden,SWE,0,5,0,0,5
2002,Sudan,SDN,Sweden,SWE,0,0,10,0,10
2002,Slovakia,SVK,Sweden,SWE,0,0,108,5,113
2002,Syrian Arab Rep.,SYR,Sweden,SWE,33,100,187,25,345
2002,United Rep. of Tanzania,TZA,Sweden,SWE,0,5,0,0,5
2002,Thailand,THA,Sweden,SWE,0,5,0,0,5
2002,Tajikistan,TJK,Sweden,SWE,0,10,5,0,15
2002,Tunisia,TUN,Sweden,SWE,0,5,11,5,21
2002,Turkey,TUR,Sweden,SWE,5,36,120,10,171
2002,Uganda,UGA,Sweden,SWE,0,0,10,0,10
2002,Ukraine,UKR,Sweden,SWE,0,5,157,19,181
2002,United States of America,USA,Sweden,SWE,0,0,5,0,5
2002,Uzbekistan,UZB,Sweden,SWE,0,10,123,10,143
2002,Venezuela (Bolivarian Republic of),VEN,Sweden,SWE,0,0,5,0,5
2002,Zambia,ZMB,Sweden,SWE,0,0,5,0,5
2002,Stateless,XXA,Sweden,SWE,10,92,180,11,293
2002,Unknown ,,Sweden,SWE,0,0,25,0,25
2002,Unknown ,,Switzerland,CHE,1258,0,5118,6418,12794
2003,Afghanistan,AFG,Belgium,BEL,10,0,184,24,218
2003,Albania,ALB,Belgium,BEL,5,0,50,5,60
2003,Algeria,DZA,Belgium,BEL,17,0,193,48,258
2003,Angola,AGO,Belgium,BEL,0,0,14,0,14
2003,Armenia,ARM,Belgium,BEL,0,0,19,5,24
2003,Azerbaijan,AZE,Belgium,BEL,0,0,5,5,10
2003,Burundi,BDI,Belgium,BEL,13,0,10,5,28
2003,Bhutan,BTN,Belgium,BEL,0,0,5,0,5
2003,Belarus,BLR,Belgium,BEL,0,0,21,5,26
2003,Bosnia and Herzegovina,BIH,Belgium,BEL,0,0,5,0,5
2003,Bulgaria,BGR,Belgium,BEL,0,0,10,5,15
2003,Cameroon,CMR,Belgium,BEL,0,0,5,0,5
2003,Dem. Rep. of the Congo,COD,Belgium,BEL,23,0,206,47,276
2003,Colombia,COL,Belgium,BEL,0,0,13,5,18
2003,Djibouti,DJI,Belgium,BEL,0,0,0,5,5
2003,Ecuador,ECU,Belgium,BEL,0,0,5,0,5
2003,Georgia,GEO,Belgium,BEL,0,0,41,16,57
2003,Guinea,GIN,Belgium,BEL,5,0,157,21,183
2003,India,IND,Belgium,BEL,0,0,5,0,5
2003,Iran (Islamic Rep. of),IRN,Belgium,BEL,5,0,159,21,185
2003,Iraq,IRQ,Belgium,BEL,0,0,5,0,5
2003,Kazakhstan,KAZ,Belgium,BEL,0,0,38,5,43
2003,Kyrgyzstan,KGZ,Belgium,BEL,0,0,5,0,5
2003,Liberia,LBR,Belgium,BEL,5,0,0,0,5
2003,Lebanon,LBN,Belgium,BEL,0,0,5,0,5
2003,Sri Lanka,LKA,Belgium,BEL,0,0,5,0,5
2003,Mauritania,MRT,Belgium,BEL,0,0,5,0,5
2003,North Macedonia,MKD,Belgium,BEL,0,0,18,0,18
2003,Rep. of Moldova,MDA,Belgium,BEL,0,0,5,0,5
2003,Nepal,NPL,Belgium,BEL,0,0,92,10,102
2003,Niger,NER,Belgium,BEL,0,0,5,0,5
2003,Romania,ROU,Belgium,BEL,0,0,5,5,10
2003,Russian Federation,RUS,Belgium,BEL,13,0,64,17,94
2003,Rwanda,RWA,Belgium,BEL,39,0,25,10,74
2003,Serbia and Kosovo: S/RES/1244 (1999),SRB,Belgium,BEL,25,0,129,29,183
2003,Sierra Leone,SLE,Belgium,BEL,0,0,13,0,13
2003,Somalia,SOM,Belgium,BEL,0,0,5,0,5
2003,Sudan,SDN,Belgium,BEL,0,0,18,0,18
2003,Syrian Arab Rep.,SYR,Belgium,BEL,0,0,21,5,26
2003,Togo,TGO,Belgium,BEL,0,0,21,5,26
2003,Turkey,TUR,Belgium,BEL,10,0,37,16,63
2003,Ukraine,UKR,Belgium,BEL,0,0,21,5,26
2003,Uzbekistan,UZB,Belgium,BEL,0,0,12,0,12
2003,Chad,TCD,Benin,BEN,5,0,5,0,10
2003,Congo,COG,Benin,BEN,0,0,16,0,16
2003,Dem. Rep. of the Congo,COD,Benin,BEN,0,0,34,0,34
2003,Equatorial Guinea,GNQ,Benin,BEN,0,0,5,0,5
2003,Cote d'Ivoire,CIV,Benin,BEN,5,0,19,0,24
2003,Nigeria,NGA,Benin,BEN,0,0,0,38,38
2003,Rwanda,RWA,Benin,BEN,0,0,5,0,5
2003,Sudan,SDN,Benin,BEN,0,0,20,0,20
2003,Togo,TGO,Benin,BEN,0,0,63,0,63
2003,Afghanistan,AFG,Czechia,CZE,16,0,5,0,21
2003,Algeria,DZA,Czechia,CZE,0,0,12,0,12
2003,Armenia,ARM,Czechia,CZE,0,0,94,11,105
2003,Belarus,BLR,Czechia,CZE,0,0,24,0,24
2003,Bulgaria,BGR,Czechia,CZE,0,0,11,0,11
2003,China,CHN,Czechia,CZE,0,0,0,5,5
2003,Georgia,GEO,Czechia,CZE,0,0,45,0,45
2003,Guinea,GIN,Czechia,CZE,0,0,0,5,5
2003,Iran (Islamic Rep. of),IRN,Czechia,CZE,0,0,0,5,5
2003,Kazakhstan,KAZ,Czechia,CZE,5,0,19,5,29
2003,Kyrgyzstan,KGZ,Czechia,CZE,0,0,10,0,10
2003,Sri Lanka,LKA,Czechia,CZE,0,0,5,0,5
2003,North Macedonia,MKD,Czechia,CZE,0,0,19,0,19
2003,Rep. of Moldova,MDA,Czechia,CZE,0,0,188,52,240
2003,Mongolia,MNG,Czechia,CZE,0,0,48,5,53
2003,Nigeria,NGA,Czechia,CZE,0,0,0,5,5
2003,Pakistan,PAK,Czechia,CZE,0,0,5,0,5
2003,Romania,ROU,Czechia,CZE,0,0,54,13,67
2003,Russian Federation,RUS,Czechia,CZE,0,0,36,11,47
2003,Serbia and Kosovo: S/RES/1244 (1999),SRB,Czechia,CZE,0,0,21,0,21
2003,Viet Nam,VNM,Czechia,CZE,0,0,106,5,111
2003,Ukraine,UKR,Czechia,CZE,0,0,576,111,687
2003,Uzbekistan,UZB,Czechia,CZE,0,0,5,0,5
2003,Stateless,XXA,Czechia,CZE,0,0,5,5,10
2003,Unknown ,,Czechia,CZE,0,0,13,0,13
2003,Afghanistan,AFG,Denmark,DNK,118,93,980,0,1191
2003,Albania,ALB,Denmark,DNK,0,0,21,0,21
2003,Algeria,DZA,Denmark,DNK,0,0,10,0,10
2003,Egypt,EGY,Denmark,DNK,0,0,5,0,5
2003,Armenia,ARM,Denmark,DNK,5,0,5,0,10
2003,Azerbaijan,AZE,Denmark,DNK,5,0,17,0,22
2003,Burundi,BDI,Denmark,DNK,0,0,13,0,13
2003,Bangladesh,BGD,Denmark,DNK,0,0,5,0,5
2003,Bosnia and Herzegovina,BIH,Denmark,DNK,0,21,130,0,151
2003,Bulgaria,BGR,Denmark,DNK,0,0,5,0,5
2003,China,CHN,Denmark,DNK,5,5,20,0,30
2003,Cameroon,CMR,Denmark,DNK,0,0,5,0,5
2003,Dem. Rep. of the Congo,COD,Denmark,DNK,0,5,10,0,15
2003,Colombia,COL,Denmark,DNK,0,0,5,0,5
2003,Ethiopia,ETH,Denmark,DNK,0,0,5,0,5
2003,Gambia,GMB,Denmark,DNK,0,0,5,0,5
2003,Palestinian,PSE,Denmark,DNK,13,13,97,0,123
2003,Georgia,GEO,Denmark,DNK,0,0,12,0,12
2003,Croatia,HRV,Denmark,DNK,0,0,10,0,10
2003,India,IND,Denmark,DNK,0,0,25,0,25
2003,Iran (Islamic Rep. of),IRN,Denmark,DNK,38,30,148,0,216
2003,Iraq,IRQ,Denmark,DNK,5,72,226,0,303
2003,Jordan,JOR,Denmark,DNK,0,5,25,0,30
2003,Kenya,KEN,Denmark,DNK,0,0,10,0,10
2003,Libya,LBY,Denmark,DNK,0,5,14,0,19
2003,Lebanon,LBN,Denmark,DNK,0,10,36,0,46
2003,Sri Lanka,LKA,Denmark,DNK,0,0,11,0,11
2003,North Macedonia,MKD,Denmark,DNK,0,0,31,0,31
2003,Rep. of Moldova,MDA,Denmark,DNK,0,0,5,0,5
2003,Mongolia,MNG,Denmark,DNK,0,5,0,0,5
2003,Nigeria,NGA,Denmark,DNK,0,0,5,0,5
2003,Pakistan,PAK,Denmark,DNK,0,0,14,0,14
2003,Russian Federation,RUS,Denmark,DNK,10,12,30,0,52
2003,Rwanda,RWA,Denmark,DNK,0,0,19,0,19
2003,Serbia and Kosovo: S/RES/1244 (1999),SRB,Denmark,DNK,0,34,392,0,426
2003,Seychelles,SYC,Denmark,DNK,0,0,5,0,5
2003,Sierra Leone,SLE,Denmark,DNK,0,0,5,0,5
2003,Somalia,SOM,Denmark,DNK,0,10,85,0,95
2003,Viet Nam,VNM,Denmark,DNK,0,0,5,0,5
2003,Sudan,SDN,Denmark,DNK,5,0,10,0,15
2003,Slovakia,SVK,Denmark,DNK,0,0,5,0,5
2003,Syrian Arab Rep.,SYR,Denmark,DNK,5,5,31,0,41
2003,Tunisia,TUN,Denmark,DNK,0,0,5,0,5
2003,Turkey,TUR,Denmark,DNK,0,0,23,0,23
2003,Ukraine,UKR,Denmark,DNK,0,0,5,0,5
2003,Uzbekistan,UZB,Denmark,DNK,0,0,10,0,10
2003,Yemen,YEM,Denmark,DNK,0,0,5,0,5
2003,Stateless,XXA,Denmark,DNK,0,0,10,0,10
2003,Albania,ALB,France,FRA,119,0,196,0,315
2003,Algeria,DZA,France,FRA,114,0,1131,0,1245
2003,Angola,AGO,France,FRA,76,0,531,0,607
2003,Armenia,ARM,France,FRA,92,0,375,0,467
2003,Azerbaijan,AZE,France,FRA,96,0,59,0,155
2003,Bangladesh,BGD,France,FRA,60,0,345,0,405
2003,Belarus,BLR,France,FRA,30,0,57,0,87
2003,Bosnia and Herzegovina,BIH,France,FRA,26,0,90,0,116
2003,Central African Rep.,CAF,France,FRA,15,0,57,0,72
2003,China,CHN,France,FRA,5,0,2152,0,2157
2003,Cameroon,CMR,France,FRA,12,0,117,0,129
2003,Congo,COG,France,FRA,139,0,742,0,881
2003,Dem. Rep. of the Congo,COD,France,FRA,305,0,2465,0,2770
2003,Georgia,GEO,France,FRA,61,0,277,0,338
2003,Guinea,GIN,France,FRA,54,0,535,0,589
2003,Haiti,HTI,France,FRA,121,0,961,0,1082
2003,India,IND,France,FRA,24,0,199,0,223
2003,Iran (Islamic Rep. of),IRN,France,FRA,34,0,56,0,90
2003,Sri Lanka,LKA,France,FRA,344,0,1180,0,1524
2003,Mauritania,MRT,France,FRA,278,0,1682,0,1960
2003,North Macedonia,MKD,France,FRA,31,0,166,0,197
2003,Rep. of Moldova,MDA,France,FRA,37,0,420,0,457
2003,Mali,MLI,France,FRA,5,0,1219,0,1224
2003,Nigeria,NGA,France,FRA,15,0,201,0,216
2003,Pakistan,PAK,France,FRA,15,0,175,0,190
2003,Russian Federation,RUS,France,FRA,255,0,390,0,645
2003,Serbia and Kosovo: S/RES/1244 (1999),SRB,France,FRA,188,0,627,0,815
2003,Senegal,SEN,France,FRA,14,0,266,0,280
2003,Sierra Leone,SLE,France,FRA,24,0,245,0,269
2003,Turkey,TUR,France,FRA,397,0,3065,0,3462
2003,Ukraine,UKR,France,FRA,74,0,260,0,334
2003,Unknown ,,France,FRA,318,0,5884,0,6202
2003,Afghanistan,AFG,Ireland,IRL,0,0,5,0,5
2003,Albania,ALB,Ireland,IRL,16,0,56,5,77
2003,Algeria,DZA,Ireland,IRL,23,0,73,0,96
2003,Angola,AGO,Ireland,IRL,28,0,60,0,88
2003,Egypt,EGY,Ireland,IRL,0,0,10,0,10
2003,Armenia,ARM,Ireland,IRL,0,0,5,0,5
2003,Azerbaijan,AZE,Ireland,IRL,0,0,5,0,5
2003,Burundi,BDI,Ireland,IRL,5,0,10,0,15
2003,Belarus,BLR,Ireland,IRL,5,0,10,0,15
2003,Bosnia and Herzegovina,BIH,Ireland,IRL,0,0,5,0,5
2003,Bulgaria,BGR,Ireland,IRL,5,0,19,5,29
2003,China,CHN,Ireland,IRL,0,0,10,0,10
2003,Cameroon,CMR,Ireland,IRL,28,0,58,0,86
2003,Congo,COG,Ireland,IRL,5,0,5,0,10
2003,Dem. Rep. of the Congo,COD,Ireland,IRL,59,0,86,0,145
2003,Cuba,CUB,Ireland,IRL,0,0,5,0,5
2003,Czechia,CZE,Ireland,IRL,22,0,126,13,161
2003,Estonia,EST,Ireland,IRL,10,0,35,0,45
2003,Ethiopia,ETH,Ireland,IRL,5,0,0,0,5
2003,Gambia,GMB,Ireland,IRL,0,0,5,0,5
2003,Palestinian,PSE,Ireland,IRL,5,0,18,0,23
2003,Georgia,GEO,Ireland,IRL,20,0,51,0,71
2003,Ghana,GHA,Ireland,IRL,11,0,103,0,114
2003,Croatia,HRV,Ireland,IRL,45,0,132,5,182
2003,Hungary,HUN,Ireland,IRL,0,0,0,12,12
2003,Cote d'Ivoire,CIV,Ireland,IRL,5,0,28,0,33
2003,India,IND,Ireland,IRL,0,0,5,10,15
2003,Iran (Islamic Rep. of),IRN,Ireland,IRL,5,0,5,0,10
2003,Iraq,IRQ,Ireland,IRL,5,0,10,0,15
2003,Israel,ISR,Ireland,IRL,0,0,45,0,45
2003,Jamaica,JAM,Ireland,IRL,5,0,5,0,10
2003,Kazakhstan,KAZ,Ireland,IRL,29,0,36,0,65
2003,Kenya,KEN,Ireland,IRL,19,0,36,0,55
2003,Kyrgyzstan,KGZ,Ireland,IRL,0,0,5,0,5
2003,Liberia,LBR,Ireland,IRL,5,0,10,0,15
2003,Libya,LBY,Ireland,IRL,5,0,5,0,10
2003,Lebanon,LBN,Ireland,IRL,5,0,5,0,10
2003,Lesotho,LSO,Ireland,IRL,0,0,5,0,5
2003,Sri Lanka,LKA,Ireland,IRL,5,0,0,0,5
2003,Lithuania,LTU,Ireland,IRL,10,0,80,5,95
2003,Latvia,LVA,Ireland,IRL,10,0,23,0,33
2003,North Macedonia,MKD,Ireland,IRL,5,0,10,0,15
2003,Rep. of Moldova,MDA,Ireland,IRL,52,0,161,5,218
2003,Mongolia,MNG,Ireland,IRL,0,0,5,0,5
2003,Morocco,MAR,Ireland,IRL,0,0,5,0,5
2003,Nigeria,NGA,Ireland,IRL,106,0,1303,41,1450
2003,Pakistan,PAK,Ireland,IRL,10,0,29,0,39
2003,Philippines,PHL,Ireland,IRL,0,0,5,0,5
2003,Poland,POL,Ireland,IRL,10,0,119,24,153
2003,Romania,ROU,Ireland,IRL,46,0,524,22,592
2003,South Africa,ZAF,Ireland,IRL,10,0,105,5,120
2003,Russian Federation,RUS,Ireland,IRL,24,0,73,5,102
2003,Rwanda,RWA,Ireland,IRL,5,0,5,0,10
2003,Serbia and Kosovo: S/RES/1244 (1999),SRB,Ireland,IRL,24,0,72,5,101
2003,Sierra Leone,SLE,Ireland,IRL,5,0,86,5,96
2003,Somalia,SOM,Ireland,IRL,19,0,14,0,33
2003,Sudan,SDN,Ireland,IRL,10,0,11,0,21
2003,Slovakia,SVK,Ireland,IRL,5,0,10,0,15
2003,Togo,TGO,Ireland,IRL,10,0,23,0,33
2003,Turkey,TUR,Ireland,IRL,5,0,5,0,10
2003,Uganda,UGA,Ireland,IRL,0,0,10,0,10
2003,Ukraine,UKR,Ireland,IRL,37,0,90,5,132
2003,Uzbekistan,UZB,Ireland,IRL,10,0,10,0,20
2003,Zimbabwe,ZWE,Ireland,IRL,49,0,92,0,141
2003,Stateless,XXA,Ireland,IRL,5,0,10,0,15
2003,Afghanistan,AFG,Japan,JPN,0,0,20,5,25
2003,Bangladesh,BGD,Japan,JPN,0,0,5,0,5
2003,China,CHN,Japan,JPN,0,0,16,0,16
2003,Cameroon,CMR,Japan,JPN,0,0,5,0,5
2003,Gambia,GMB,Japan,JPN,0,0,5,0,5
2003,India,IND,Japan,JPN,0,0,10,0,10
2003,Indonesia,IDN,Japan,JPN,0,0,5,0,5
2003,Iran (Islamic Rep. of),IRN,Japan,JPN,0,0,18,0,18
2003,Myanmar,MMR,Japan,JPN,5,5,21,0,31
2003,Nigeria,NGA,Japan,JPN,0,0,5,0,5
2003,Pakistan,PAK,Japan,JPN,0,5,10,0,15
2003,Turkey,TUR,Japan,JPN,0,0,49,0,49
2003,Unknown ,,Japan,JPN,0,0,5,0,5
2003,Unknown ,,Malta,MLT,0,0,46,0,46
2003,Afghanistan,AFG,Netherlands,NLD,134,67,537,242,980
2003,Albania,ALB,Netherlands,NLD,0,0,12,5,17
2003,Algeria,DZA,Netherlands,NLD,0,0,48,12,60
2003,Angola,AGO,Netherlands,NLD,20,23,550,158,751
2003,Armenia,ARM,Netherlands,NLD,23,15,144,39,221
2003,Azerbaijan,AZE,Netherlands,NLD,56,43,360,128,587
2003,Burundi,BDI,Netherlands,NLD,5,5,17,10,37
2003,Benin,BEN,Netherlands,NLD,0,0,10,0,10
2003,Bangladesh,BGD,Netherlands,NLD,0,0,5,5,10
2003,Belarus,BLR,Netherlands,NLD,0,0,10,0,10
2003,Bosnia and Herzegovina,BIH,Netherlands,NLD,13,12,93,66,184
2003,Bulgaria,BGR,Netherlands,NLD,0,0,5,0,5
2003,Chad,TCD,Netherlands,NLD,0,0,15,0,15
2003,China,CHN,Netherlands,NLD,5,11,226,78,320
2003,Cameroon,CMR,Netherlands,NLD,0,5,38,10,53
2003,Congo,COG,Netherlands,NLD,0,10,85,29,124
2003,Dem. Rep. of the Congo,COD,Netherlands,NLD,13,17,146,50,226
2003,Colombia,COL,Netherlands,NLD,0,5,5,0,10
2003,Eritrea,ERI,Netherlands,NLD,0,0,55,21,76
2003,Ethiopia,ETH,Netherlands,NLD,5,5,66,20,96
2003,Palestinian,PSE,Netherlands,NLD,0,0,5,0,5
2003,Georgia,GEO,Netherlands,NLD,0,0,59,10,69
2003,Ghana,GHA,Netherlands,NLD,0,0,5,0,5
2003,Guinea-Bissau,GNB,Netherlands,NLD,0,0,5,0,5
2003,Guinea,GIN,Netherlands,NLD,10,27,215,61,313
2003,Cote d'Ivoire,CIV,Netherlands,NLD,0,0,22,5,27
2003,India,IND,Netherlands,NLD,0,0,5,5,10
2003,Indonesia,IDN,Netherlands,NLD,0,0,0,5,5
2003,Iran (Islamic Rep. of),IRN,Netherlands,NLD,41,29,295,85,450
2003,Iraq,IRQ,Netherlands,NLD,87,1830,496,692,3105
2003,Jordan,JOR,Netherlands,NLD,0,0,0,5,5
2003,Kazakhstan,KAZ,Netherlands,NLD,0,0,35,5,40
2003,Kyrgyzstan,KGZ,Netherlands,NLD,0,0,13,5,18
2003,Kuwait,KWT,Netherlands,NLD,0,0,0,5,5
2003,Liberia,LBR,Netherlands,NLD,5,5,34,42,86
2003,Libya,LBY,Netherlands,NLD,5,0,19,5,29
2003,Lebanon,LBN,Netherlands,NLD,0,0,5,5,10
2003,Sri Lanka,LKA,Netherlands,NLD,11,10,74,19,114
2003,Mauritania,MRT,Netherlands,NLD,0,5,20,10,35
2003,North Macedonia,MKD,Netherlands,NLD,0,0,5,5,10
2003,Mongolia,MNG,Netherlands,NLD,0,0,66,15,81
2003,Morocco,MAR,Netherlands,NLD,0,0,5,0,5
2003,Myanmar,MMR,Netherlands,NLD,0,0,5,0,5
2003,Nepal,NPL,Netherlands,NLD,0,0,5,0,5
2003,Netherlands,NLD,Netherlands,NLD,0,0,5,14,19
2003,Niger,NER,Netherlands,NLD,0,0,31,15,46
2003,Nigeria,NGA,Netherlands,NLD,0,0,41,12,53
2003,Pakistan,PAK,Netherlands,NLD,5,0,34,5,44
2003,Poland,POL,Netherlands,NLD,0,0,5,0,5
2003,Russian Federation,RUS,Netherlands,NLD,20,31,173,50,274
2003,Rwanda,RWA,Netherlands,NLD,19,14,117,40,190
2003,Serbia and Kosovo: S/RES/1244 (1999),SRB,Netherlands,NLD,47,31,256,134,468
2003,Senegal,SEN,Netherlands,NLD,0,0,5,0,5
2003,Sierra Leone,SLE,Netherlands,NLD,5,5,271,102,383
2003,Somalia,SOM,Netherlands,NLD,68,44,399,130,641
2003,Viet Nam,VNM,Netherlands,NLD,0,0,35,5,40
2003,Sudan,SDN,Netherlands,NLD,37,32,327,134,530
2003,Slovakia,SVK,Netherlands,NLD,0,0,22,26,48
2003,Syrian Arab Rep.,SYR,Netherlands,NLD,34,33,180,93,340
2003,Tajikistan,TJK,Netherlands,NLD,0,0,5,0,5
2003,Togo,TGO,Netherlands,NLD,0,5,81,20,106
2003,Turkey,TUR,Netherlands,NLD,5,5,129,61,200
2003,Uganda,UGA,Netherlands,NLD,0,0,11,5,16
2003,Ukraine,UKR,Netherlands,NLD,0,5,34,17,56
2003,Uzbekistan,UZB,Netherlands,NLD,0,0,21,5,26
2003,Yemen,YEM,Netherlands,NLD,0,0,13,10,23
2003,Stateless,XXA,Netherlands,NLD,10,13,130,37,190
2003,Unknown ,,Netherlands,NLD,45,99,218,122,484
2003,Afghanistan,AFG,New Zealand,NZL,0,0,5,0,5
2003,Albania,ALB,New Zealand,NZL,0,0,5,0,5
2003,Algeria,DZA,New Zealand,NZL,5,0,5,0,10
2003,Egypt,EGY,New Zealand,NZL,0,0,5,0,5
2003,Bangladesh,BGD,New Zealand,NZL,0,0,15,0,15
2003,Bulgaria,BGR,New Zealand,NZL,0,0,5,0,5
2003,China,CHN,New Zealand,NZL,0,0,21,0,21
2003,Chile,CHL,New Zealand,NZL,0,0,5,0,5
2003,Congo,COG,New Zealand,NZL,0,0,5,0,5
2003,Colombia,COL,New Zealand,NZL,5,0,0,0,5
2003,Czechia,CZE,New Zealand,NZL,5,0,24,0,29
2003,Ecuador,ECU,New Zealand,NZL,0,0,5,0,5
2003,Fiji,FJI,New Zealand,NZL,0,0,15,0,15
2003,Hungary,HUN,New Zealand,NZL,0,0,5,0,5
2003,India,IND,New Zealand,NZL,0,0,56,0,56
2003,Indonesia,IDN,New Zealand,NZL,0,0,5,0,5
2003,Iran (Islamic Rep. of),IRN,New Zealand,NZL,20,0,42,0,62
2003,Iraq,IRQ,New Zealand,NZL,0,0,5,0,5
2003,Kuwait,KWT,New Zealand,NZL,0,0,5,0,5
2003,Sri Lanka,LKA,New Zealand,NZL,0,0,41,0,41
2003,Malaysia,MYS,New Zealand,NZL,0,0,15,0,15
2003,Nepal,NPL,New Zealand,NZL,0,0,10,0,10
2003,Nigeria,NGA,New Zealand,NZL,0,0,12,0,12
2003,Pakistan,PAK,New Zealand,NZL,5,0,16,0,21
2003,South Africa,ZAF,New Zealand,NZL,0,0,5,0,5
2003,Somalia,SOM,New Zealand,NZL,5,0,0,0,5
2003,Viet Nam,VNM,New Zealand,NZL,0,0,5,0,5
2003,Thailand,THA,New Zealand,NZL,0,0,127,0,127
2003,Turkey,TUR,New Zealand,NZL,0,0,5,0,5
2003,Zimbabwe,ZWE,New Zealand,NZL,12,0,10,0,22
2003,Afghanistan,AFG,Poland,POL,0,0,57,0,57
2003,Egypt,EGY,Poland,POL,0,0,5,0,5
2003,Armenia,ARM,Poland,POL,0,0,100,0,100
2003,Azerbaijan,AZE,Poland,POL,0,0,10,0,10
2003,Belarus,BLR,Poland,POL,0,0,12,0,12
2003,Bulgaria,BGR,Poland,POL,0,0,5,0,5
2003,China,CHN,Poland,POL,0,0,5,0,5
2003,Czechia,CZE,Poland,POL,0,0,5,0,5
2003,Georgia,GEO,Poland,POL,0,0,5,0,5
2003,India,IND,Poland,POL,0,0,105,0,105
2003,Iraq,IRQ,Poland,POL,0,0,17,0,17
2003,Jordan,JOR,Poland,POL,0,0,5,0,5
2003,Kyrgyzstan,KGZ,Poland,POL,0,0,5,0,5
2003,Sri Lanka,LKA,Poland,POL,0,0,18,0,18
2003,Mongolia,MNG,Poland,POL,0,0,22,0,22
2003,Nigeria,NGA,Poland,POL,0,0,10,0,10
2003,Pakistan,PAK,Poland,POL,0,0,16,0,16
2003,Romania,ROU,Poland,POL,0,0,11,0,11
2003,Russian Federation,RUS,Poland,POL,24,0,379,36,439
2003,Viet Nam,VNM,Poland,POL,0,0,10,0,10
2003,Sudan,SDN,Poland,POL,0,0,10,0,10
2003,Syrian Arab Rep.,SYR,Poland,POL,0,0,5,0,5
2003,Turkey,TUR,Poland,POL,0,0,5,0,5
2003,Ukraine,UKR,Poland,POL,0,0,23,0,23
2003,Stateless,XXA,Poland,POL,0,0,5,0,5
2003,Afghanistan,AFG,Sweden,SWE,0,5,62,5,72
2003,Albania,ALB,Sweden,SWE,0,10,166,5,181
2003,Algeria,DZA,Sweden,SWE,0,5,127,5,137
2003,Angola,AGO,Sweden,SWE,0,0,5,0,5
2003,Egypt,EGY,Sweden,SWE,0,5,80,0,85
2003,Argentina,ARG,Sweden,SWE,0,0,5,0,5
2003,Armenia,ARM,Sweden,SWE,0,25,102,0,127
2003,Azerbaijan,AZE,Sweden,SWE,0,13,122,12,147
2003,Bangladesh,BGD,Sweden,SWE,0,33,108,0,141
2003,Belarus,BLR,Sweden,SWE,5,12,170,26,213
2003,Bolivia (Plurinational State of),BOL,Sweden,SWE,0,0,139,16,155
2003,Brazil,BRA,Sweden,SWE,0,0,5,0,5
2003,Bosnia and Herzegovina,BIH,Sweden,SWE,10,607,2407,42,3066
2003,Bulgaria,BGR,Sweden,SWE,5,5,161,5,176
2003,China,CHN,Sweden,SWE,5,0,35,0,40
2003,Chile,CHL,Sweden,SWE,0,5,70,0,75
2003,Cameroon,CMR,Sweden,SWE,0,0,10,0,10
2003,Congo,COG,Sweden,SWE,0,0,5,0,5
2003,Dem. Rep. of the Congo,COD,Sweden,SWE,0,0,36,0,36
2003,Colombia,COL,Sweden,SWE,0,5,12,0,17
2003,Cuba,CUB,Sweden,SWE,0,5,11,0,16
2003,Czechia,CZE,Sweden,SWE,0,0,10,0,10
2003,Ecuador,ECU,Sweden,SWE,0,21,147,13,181
2003,Eritrea,ERI,Sweden,SWE,0,5,118,0,123
2003,Estonia,EST,Sweden,SWE,0,0,5,0,5
2003,Ethiopia,ETH,Sweden,SWE,0,0,66,0,66
2003,Gambia,GMB,Sweden,SWE,0,0,5,0,5
2003,Georgia,GEO,Sweden,SWE,0,18,93,10,121
2003,Germany,DEU,Sweden,SWE,0,0,0,5,5
2003,Ghana,GHA,Sweden,SWE,0,0,5,0,5
2003,Guinea,GIN,Sweden,SWE,0,0,28,0,28
2003,Honduras,HND,Sweden,SWE,0,5,5,0,10
2003,Croatia,HRV,Sweden,SWE,0,18,206,5,229
2003,Hungary,HUN,Sweden,SWE,0,0,10,0,10
2003,Cote d'Ivoire,CIV,Sweden,SWE,0,0,10,0,10
2003,India,IND,Sweden,SWE,0,0,28,0,28
2003,Iran (Islamic Rep. of),IRN,Sweden,SWE,54,69,389,35,547
2003,Iraq,IRQ,Sweden,SWE,5,71,477,34,587
2003,Israel,ISR,Sweden,SWE,0,0,21,0,21
2003,Jordan,JOR,Sweden,SWE,0,5,29,5,39
2003,Kazakhstan,KAZ,Sweden,SWE,10,31,72,5,118
2003,Kiribati,KIR,Sweden,SWE,0,5,59,5,69
2003,Liberia,LBR,Sweden,SWE,0,0,5,0,5
2003,Libya,LBY,Sweden,SWE,0,0,125,15,140
2003,Lebanon,LBN,Sweden,SWE,10,21,0,16,47
2003,Sri Lanka,LKA,Sweden,SWE,0,0,16,0,16
2003,Lithuania,LTU,Sweden,SWE,0,5,10,0,15
2003,Latvia,LVA,Sweden,SWE,0,5,0,5,10
2003,North Macedonia,MKD,Sweden,SWE,0,13,377,18,408
2003,Rep. of Moldova,MDA,Sweden,SWE,0,0,44,0,44
2003,Malaysia,MYS,Sweden,SWE,0,0,5,0,5
2003,Mongolia,MNG,Sweden,SWE,0,0,175,5,180
2003,Morocco,MAR,Sweden,SWE,0,5,16,0,21
2003,Myanmar,MMR,Sweden,SWE,0,5,0,0,5
2003,Nigeria,NGA,Sweden,SWE,0,0,87,0,87
2003,Pakistan,PAK,Sweden,SWE,5,18,50,0,73
2003,Paraguay,PRY,Sweden,SWE,0,0,5,0,5
2003,Peru,PER,Sweden,SWE,0,0,70,0,70
2003,Poland,POL,Sweden,SWE,0,0,5,0,5
2003,Romania,ROU,Sweden,SWE,0,0,67,0,67
2003,Russian Federation,RUS,Sweden,SWE,13,43,504,34,594
2003,El Salvador,SLV,Sweden,SWE,5,5,74,5,89
2003,Serbia and Kosovo: S/RES/1244 (1999),SRB,Sweden,SWE,37,345,3212,37,3631
2003,Sierra Leone,SLE,Sweden,SWE,0,0,16,0,16
2003,Somalia,SOM,Sweden,SWE,0,5,41,0,46
2003,Viet Nam,VNM,Sweden,SWE,0,0,13,0,13
2003,Sudan,SDN,Sweden,SWE,0,5,11,0,16
2003,Slovakia,SVK,Sweden,SWE,0,0,83,5,88
2003,Sweden,SWE,Sweden,SWE,0,5,0,0,5
2003,Syrian Arab Rep.,SYR,Sweden,SWE,26,72,456,12,566
2003,United Rep. of Tanzania,TZA,Sweden,SWE,0,0,10,0,10
2003,Tajikistan,TJK,Sweden,SWE,0,0,10,0,10
2003,Turkmenistan,TKM,Sweden,SWE,0,0,5,0,5
2003,Togo,TGO,Sweden,SWE,0,0,5,0,5
2003,Tunisia,TUN,Sweden,SWE,0,0,32,0,32
2003,Turkey,TUR,Sweden,SWE,5,37,392,15,449
2003,Uganda,UGA,Sweden,SWE,0,0,13,0,13
2003,Ukraine,UKR,Sweden,SWE,0,12,269,13,294
2003,United States of America,USA,Sweden,SWE,0,0,5,0,5
2003,Uzbekistan,UZB,Sweden,SWE,5,36,220,14,275
2003,Venezuela (Bolivarian Republic of),VEN,Sweden,SWE,0,5,5,0,10
2003,Yemen,YEM,Sweden,SWE,0,5,13,0,18
2003,Stateless,XXA,Sweden,SWE,0,121,174,10,305
2003,Unknown ,,Sweden,SWE,0,10,36,0,46
2003,Unknown ,,Switzerland,CHE,1003,0,6132,8699,15834
2004,Afghanistan,AFG,Azerbaijan,AZE,0,0,40,0,40
2004,Afghanistan,AFG,Belgium,BEL,14,0,283,34,331
2004,Albania,ALB,Belgium,BEL,0,0,54,0,54
2004,Algeria,DZA,Belgium,BEL,5,0,63,26,94
2004,Angola,AGO,Belgium,BEL,0,0,10,0,10
2004,Armenia,ARM,Belgium,BEL,0,0,11,10,21
2004,Azerbaijan,AZE,Belgium,BEL,0,0,5,0,5
2004,Burundi,BDI,Belgium,BEL,5,0,10,5,20
2004,Bangladesh,BGD,Belgium,BEL,0,0,20,0,20
2004,Bhutan,BTN,Belgium,BEL,0,0,5,0,5
2004,Belarus,BLR,Belgium,BEL,0,0,12,5,17
2004,Bosnia and Herzegovina,BIH,Belgium,BEL,0,0,13,0,13
2004,Bulgaria,BGR,Belgium,BEL,5,0,5,0,10
2004,China,CHN,Belgium,BEL,0,0,0,5,5
2004,Cameroon,CMR,Belgium,BEL,0,0,38,10,48
2004,Dem. Rep. of the Congo,COD,Belgium,BEL,5,0,337,69,411
2004,Colombia,COL,Belgium,BEL,5,0,27,5,37
2004,Ecuador,ECU,Belgium,BEL,0,0,5,0,5
2004,Palestinian,PSE,Belgium,BEL,0,0,0,5,5
2004,Georgia,GEO,Belgium,BEL,0,0,34,14,48
2004,Guinea,GIN,Belgium,BEL,0,0,19,5,24
2004,Iran (Islamic Rep. of),IRN,Belgium,BEL,5,0,75,14,94
2004,Iraq,IRQ,Belgium,BEL,0,0,0,5,5
2004,Kazakhstan,KAZ,Belgium,BEL,0,0,5,0,5
2004,Kyrgyzstan,KGZ,Belgium,BEL,0,0,5,0,5
2004,Lebanon,LBN,Belgium,BEL,0,0,10,5,15
2004,Sri Lanka,LKA,Belgium,BEL,0,0,5,0,5
2004,Mauritania,MRT,Belgium,BEL,0,0,10,5,15
2004,North Macedonia,MKD,Belgium,BEL,0,0,11,5,16
2004,Rep. of Moldova,MDA,Belgium,BEL,0,0,5,5,10
2004,Mongolia,MNG,Belgium,BEL,0,0,10,0,10
2004,Myanmar,MMR,Belgium,BEL,0,0,5,0,5
2004,Nepal,NPL,Belgium,BEL,0,0,39,5,44
2004,Pakistan,PAK,Belgium,BEL,0,0,22,10,32
2004,Romania,ROU,Belgium,BEL,0,0,10,0,10
2004,Russian Federation,RUS,Belgium,BEL,14,0,78,24,116
2004,Rwanda,RWA,Belgium,BEL,14,0,16,10,40
2004,El Salvador,SLV,Belgium,BEL,0,0,5,0,5
2004,Serbia and Kosovo: S/RES/1244 (1999),SRB,Belgium,BEL,0,0,86,19,105
2004,Sierra Leone,SLE,Belgium,BEL,0,0,0,5,5
2004,Sudan,SDN,Belgium,BEL,0,0,17,0,17
2004,Slovakia,SVK,Belgium,BEL,0,0,5,0,5
2004,Syrian Arab Rep.,SYR,Belgium,BEL,0,0,65,5,70
2004,Togo,TGO,Belgium,BEL,0,0,75,14,89
2004,Turkey,TUR,Belgium,BEL,12,0,123,34,169
2004,Ukraine,UKR,Belgium,BEL,0,0,21,0,21
2004,Uzbekistan,UZB,Belgium,BEL,0,0,5,0,5
2004,Chad,TCD,Benin,BEN,0,0,14,0,14
2004,Congo,COG,Benin,BEN,0,0,10,0,10
2004,Dem. Rep. of the Congo,COD,Benin,BEN,0,0,23,0,23
2004,Cote d'Ivoire,CIV,Benin,BEN,0,0,10,0,10
2004,Nigeria,NGA,Benin,BEN,0,0,20,0,20
2004,Rwanda,RWA,Benin,BEN,5,0,0,0,5
2004,Togo,TGO,Benin,BEN,5,0,31,0,36
2004,Bangladesh,BGD,Cyprus,CYP,0,0,11,0,11
2004,Palestinian,PSE,Cyprus,CYP,0,0,5,10,15
2004,Iran (Islamic Rep. of),IRN,Cyprus,CYP,0,0,69,23,92
2004,Lebanon,LBN,Cyprus,CYP,0,0,0,5,5
2004,Rep. of Moldova,MDA,Cyprus,CYP,0,0,5,0,5
2004,Nigeria,NGA,Cyprus,CYP,0,0,5,0,5
2004,Pakistan,PAK,Cyprus,CYP,0,0,13,5,18
2004,Russian Federation,RUS,Cyprus,CYP,0,0,45,11,56
2004,Turkey,TUR,Cyprus,CYP,0,0,52,5,57
2004,Ukraine,UKR,Cyprus,CYP,0,0,19,5,24
2004,Algeria,DZA,Czechia,CZE,0,0,0,5,5
2004,Armenia,ARM,Czechia,CZE,0,0,5,0,5
2004,Georgia,GEO,Czechia,CZE,0,0,0,5,5
2004,North Macedonia,MKD,Czechia,CZE,0,0,0,5,5
2004,Rep. of Moldova,MDA,Czechia,CZE,0,0,0,31,31
2004,Russian Federation,RUS,Czechia,CZE,0,0,0,5,5
2004,Serbia and Kosovo: S/RES/1244 (1999),SRB,Czechia,CZE,0,0,5,12,17
2004,Ukraine,UKR,Czechia,CZE,0,0,5,12,17
2004,Afghanistan,AFG,Denmark,DNK,45,15,210,0,270
2004,Albania,ALB,Denmark,DNK,0,0,10,0,10
2004,Algeria,DZA,Denmark,DNK,0,0,5,0,5
2004,Armenia,ARM,Denmark,DNK,0,0,10,0,10
2004,Azerbaijan,AZE,Denmark,DNK,0,5,5,0,10
2004,Burundi,BDI,Denmark,DNK,0,0,14,0,14
2004,Bangladesh,BGD,Denmark,DNK,0,0,12,0,12
2004,Belarus,BLR,Denmark,DNK,0,0,5,0,5
2004,Brazil,BRA,Denmark,DNK,0,0,5,0,5
2004,Bosnia and Herzegovina,BIH,Denmark,DNK,0,0,28,0,28
2004,Bulgaria,BGR,Denmark,DNK,0,0,5,0,5
2004,China,CHN,Denmark,DNK,5,0,5,0,10
2004,Dem. Rep. of the Congo,COD,Denmark,DNK,0,0,5,0,5
2004,Palestinian,PSE,Denmark,DNK,47,0,58,0,105
2004,Georgia,GEO,Denmark,DNK,5,0,0,0,5
2004,Guinea,GIN,Denmark,DNK,0,0,5,0,5
2004,Hungary,HUN,Denmark,DNK,0,0,5,0,5
2004,Cote d'Ivoire,CIV,Denmark,DNK,0,0,5,0,5
2004,India,IND,Denmark,DNK,0,0,15,0,15
2004,Iran (Islamic Rep. of),IRN,Denmark,DNK,21,19,51,0,91
2004,Iraq,IRQ,Denmark,DNK,0,37,789,0,826
2004,Jordan,JOR,Denmark,DNK,0,0,5,0,5
2004,Liberia,LBR,Denmark,DNK,0,0,5,0,5
2004,Libya,LBY,Denmark,DNK,0,0,5,0,5
2004,Lebanon,LBN,Denmark,DNK,5,10,5,0,20
2004,Sri Lanka,LKA,Denmark,DNK,0,0,5,0,5
2004,Lithuania,LTU,Denmark,DNK,0,0,5,0,5
2004,North Macedonia,MKD,Denmark,DNK,0,0,25,0,25
2004,Myanmar,MMR,Denmark,DNK,5,0,0,0,5
2004,Nigeria,NGA,Denmark,DNK,0,0,13,0,13
2004,Pakistan,PAK,Denmark,DNK,0,0,27,0,27
2004,Romania,ROU,Denmark,DNK,0,0,5,0,5
2004,Russian Federation,RUS,Denmark,DNK,18,5,31,0,54
2004,Rwanda,RWA,Denmark,DNK,0,0,5,0,5
2004,Serbia and Kosovo: S/RES/1244 (1999),SRB,Denmark,DNK,0,14,134,0,148
2004,Somalia,SOM,Denmark,DNK,5,5,88,0,98
2004,Sudan,SDN,Denmark,DNK,0,0,5,0,5
2004,Syrian Arab Rep.,SYR,Denmark,DNK,11,5,20,0,36
2004,Turkey,TUR,Denmark,DNK,0,0,10,0,10
2004,Uganda,UGA,Denmark,DNK,0,0,5,0,5
2004,Ukraine,UKR,Denmark,DNK,0,0,5,0,5
2004,Stateless,XXA,Denmark,DNK,5,0,5,0,10
2004,Albania,ALB,France,FRA,112,0,176,29,317
2004,Algeria,DZA,France,FRA,74,0,720,241,1035
2004,Angola,AGO,France,FRA,214,0,1328,133,1675
2004,Armenia,ARM,France,FRA,199,0,481,52,732
2004,Azerbaijan,AZE,France,FRA,161,0,122,15,298
2004,Bangladesh,BGD,France,FRA,82,0,355,22,459
2004,Bosnia and Herzegovina,BIH,France,FRA,51,0,178,25,254
2004,Central African Rep.,CAF,France,FRA,28,0,201,85,314
2004,Chad,TCD,France,FRA,70,0,169,21,260
2004,China,CHN,France,FRA,11,0,2537,132,2680
2004,Cameroon,CMR,France,FRA,38,0,277,127,442
2004,Congo,COG,France,FRA,238,0,1253,430,1921
2004,Dem. Rep. of the Congo,COD,France,FRA,610,0,4642,611,5863
2004,Georgia,GEO,France,FRA,313,0,918,85,1316
2004,Guinea,GIN,France,FRA,91,0,505,80,676
2004,Haiti,HTI,France,FRA,60,0,507,139,706
2004,Cote d'Ivoire,CIV,France,FRA,112,0,431,144,687
2004,India,IND,France,FRA,17,0,330,44,391
2004,Sri Lanka,LKA,France,FRA,396,0,1131,106,1633
2004,Mauritania,MRT,France,FRA,480,0,2396,316,3192
2004,Rep. of Moldova,MDA,France,FRA,60,0,798,178,1036
2004,Mali,MLI,France,FRA,5,0,507,140,652
2004,Nigeria,NGA,France,FRA,29,0,564,207,800
2004,Pakistan,PAK,France,FRA,19,0,268,80,367
2004,Russian Federation,RUS,France,FRA,267,0,489,75,831
2004,Serbia and Kosovo: S/RES/1244 (1999),SRB,France,FRA,144,0,599,117,860
2004,Senegal,SEN,France,FRA,16,0,157,43,216
2004,Sierra Leone,SLE,France,FRA,21,0,305,98,424
2004,Togo,TGO,France,FRA,37,0,115,51,203
2004,Turkey,TUR,France,FRA,566,0,5075,756,6397
2004,Ukraine,UKR,France,FRA,55,0,315,60,430
2004,Afghanistan,AFG,Hungary,HUN,0,0,10,0,10
2004,Algeria,DZA,Hungary,HUN,0,0,19,0,19
2004,Angola,AGO,Hungary,HUN,0,0,5,0,5
2004,Armenia,ARM,Hungary,HUN,0,0,10,0,10
2004,Bangladesh,BGD,Hungary,HUN,0,0,10,0,10
2004,China,CHN,Hungary,HUN,0,0,64,0,64
2004,Palestinian,PSE,Hungary,HUN,0,0,5,0,5
2004,India,IND,Hungary,HUN,0,0,5,0,5
2004,Iran (Islamic Rep. of),IRN,Hungary,HUN,0,0,11,5,16
2004,Iraq,IRQ,Hungary,HUN,0,0,15,0,15
2004,Liberia,LBR,Hungary,HUN,0,0,10,0,10
2004,Rep. of Moldova,MDA,Hungary,HUN,0,0,5,0,5
2004,Mongolia,MNG,Hungary,HUN,0,0,5,0,5
2004,Nigeria,NGA,Hungary,HUN,0,0,29,0,29
2004,Pakistan,PAK,Hungary,HUN,0,0,5,0,5
2004,Romania,ROU,Hungary,HUN,0,0,13,0,13
2004,Russian Federation,RUS,Hungary,HUN,0,0,5,0,5
2004,Serbia and Kosovo: S/RES/1244 (1999),SRB,Hungary,HUN,0,0,17,0,17
2004,Senegal,SEN,Hungary,HUN,0,0,5,0,5
2004,Sierra Leone,SLE,Hungary,HUN,0,0,5,0,5
2004,Viet Nam,VNM,Hungary,HUN,0,0,25,0,25
2004,Sudan,SDN,Hungary,HUN,0,0,5,0,5
2004,Slovakia,SVK,Hungary,HUN,0,0,5,0,5
2004,Syrian Arab Rep.,SYR,Hungary,HUN,0,0,5,0,5
2004,Turkey,TUR,Hungary,HUN,0,0,5,0,5
2004,Ukraine,UKR,Hungary,HUN,0,0,5,0,5
2004,Afghanistan,AFG,Ireland,IRL,5,0,11,0,16
2004,Albania,ALB,Ireland,IRL,37,0,85,5,127
2004,Algeria,DZA,Ireland,IRL,10,0,64,0,74
2004,Angola,AGO,Ireland,IRL,14,0,87,5,106
2004,Egypt,EGY,Ireland,IRL,0,0,10,0,10
2004,Armenia,ARM,Ireland,IRL,0,0,13,0,13
2004,Azerbaijan,AZE,Ireland,IRL,5,0,5,0,10
2004,Burundi,BDI,Ireland,IRL,0,0,20,0,20
2004,Benin,BEN,Ireland,IRL,0,0,5,0,5
2004,Bangladesh,BGD,Ireland,IRL,0,0,5,0,5
2004,Belarus,BLR,Ireland,IRL,5,0,15,0,20
2004,Brazil,BRA,Ireland,IRL,0,0,5,0,5
2004,Bosnia and Herzegovina,BIH,Ireland,IRL,0,0,10,0,10
2004,Bulgaria,BGR,Ireland,IRL,0,0,12,0,12
2004,China,CHN,Ireland,IRL,5,0,40,0,45
2004,Cameroon,CMR,Ireland,IRL,18,0,73,5,96
2004,Congo,COG,Ireland,IRL,0,0,11,0,11
2004,Dem. Rep. of the Congo,COD,Ireland,IRL,52,0,179,5,236
2004,Czechia,CZE,Ireland,IRL,18,0,105,10,133
2004,Eritrea,ERI,Ireland,IRL,11,0,5,0,16
2004,Estonia,EST,Ireland,IRL,0,0,19,5,24
2004,Ethiopia,ETH,Ireland,IRL,0,0,5,0,5
2004,Gambia,GMB,Ireland,IRL,0,0,5,0,5
2004,Palestinian,PSE,Ireland,IRL,15,0,5,0,20
2004,Georgia,GEO,Ireland,IRL,16,0,81,5,102
2004,Ghana,GHA,Ireland,IRL,13,0,159,5,177
2004,Guinea,GIN,Ireland,IRL,5,0,10,0,15
2004,Croatia,HRV,Ireland,IRL,62,0,104,0,166
2004,Cote d'Ivoire,CIV,Ireland,IRL,11,0,48,0,59
2004,India,IND,Ireland,IRL,0,0,5,0,5
2004,Iran (Islamic Rep. of),IRN,Ireland,IRL,5,0,12,0,17
2004,Iraq,IRQ,Ireland,IRL,20,0,43,0,63
2004,Israel,ISR,Ireland,IRL,5,0,35,5,45
2004,Jamaica,JAM,Ireland,IRL,0,0,10,0,10
2004,Kazakhstan,KAZ,Ireland,IRL,10,0,24,0,34
2004,Kenya,KEN,Ireland,IRL,12,0,42,0,54
2004,Kyrgyzstan,KGZ,Ireland,IRL,0,0,5,0,5
2004,Liberia,LBR,Ireland,IRL,5,0,75,5,85
2004,Libya,LBY,Ireland,IRL,0,0,5,0,5
2004,Lebanon,LBN,Ireland,IRL,0,0,5,0,5
2004,Lithuania,LTU,Ireland,IRL,5,0,45,5,55
2004,Latvia,LVA,Ireland,IRL,0,0,10,0,10
2004,North Macedonia,MKD,Ireland,IRL,5,0,5,0,10
2004,Rep. of Moldova,MDA,Ireland,IRL,34,0,189,0,223
2004,Malawi,MWI,Ireland,IRL,0,0,5,0,5
2004,Mongolia,MNG,Ireland,IRL,0,0,5,0,5
2004,Morocco,MAR,Ireland,IRL,0,0,5,0,5
2004,Nigeria,NGA,Ireland,IRL,94,0,2669,105,2868
2004,Pakistan,PAK,Ireland,IRL,14,0,28,5,47
2004,Poland,POL,Ireland,IRL,0,0,86,10,96
2004,Romania,ROU,Ireland,IRL,45,0,453,19,517
2004,South Africa,ZAF,Ireland,IRL,10,0,73,5,88
2004,Russian Federation,RUS,Ireland,IRL,23,0,75,5,103
2004,Rwanda,RWA,Ireland,IRL,0,0,18,0,18
2004,Serbia and Kosovo: S/RES/1244 (1999),SRB,Ireland,IRL,38,0,59,5,102
2004,Sierra Leone,SLE,Ireland,IRL,5,0,45,0,50
2004,Somalia,SOM,Ireland,IRL,10,0,50,0,60
2004,Sudan,SDN,Ireland,IRL,10,0,47,0,57
2004,Slovakia,SVK,Ireland,IRL,0,0,13,0,13
2004,Syrian Arab Rep.,SYR,Ireland,IRL,0,0,5,0,5
2004,Togo,TGO,Ireland,IRL,10,0,43,0,53
2004,Turkey,TUR,Ireland,IRL,5,0,5,0,10
2004,Uganda,UGA,Ireland,IRL,0,0,12,0,12
2004,Ukraine,UKR,Ireland,IRL,34,0,84,5,123
2004,United States of America,USA,Ireland,IRL,0,0,5,0,5
2004,Uzbekistan,UZB,Ireland,IRL,0,0,5,0,5
2004,Zimbabwe,ZWE,Ireland,IRL,23,0,59,5,87
2004,Stateless,XXA,Ireland,IRL,0,0,17,0,17
2004,Myanmar,MMR,Japan,JPN,5,0,30,0,35
2004,Turkey,TUR,Japan,JPN,0,0,47,0,47
2004,Unknown ,,Japan,JPN,0,0,78,23,101
2004,Afghanistan,AFG,Netherlands,NLD,37,20,54,67,178
2004,Albania,ALB,Netherlands,NLD,0,0,10,5,15
2004,Algeria,DZA,Netherlands,NLD,0,0,5,11,16
2004,Angola,AGO,Netherlands,NLD,5,13,130,78,226
2004,Armenia,ARM,Netherlands,NLD,0,5,59,29,93
2004,Azerbaijan,AZE,Netherlands,NLD,15,19,230,117,381
2004,Burundi,BDI,Netherlands,NLD,0,0,10,0,10
2004,Benin,BEN,Netherlands,NLD,0,0,5,5,10
2004,Burkina Faso,BFA,Netherlands,NLD,0,0,0,5,5
2004,Belarus,BLR,Netherlands,NLD,0,0,5,0,5
2004,Bosnia and Herzegovina,BIH,Netherlands,NLD,0,10,16,17,43
2004,China,CHN,Netherlands,NLD,0,0,76,41,117
2004,Cameroon,CMR,Netherlands,NLD,0,0,14,10,24
2004,Congo,COG,Netherlands,NLD,0,5,12,5,22
2004,Dem. Rep. of the Congo,COD,Netherlands,NLD,14,10,53,28,105
2004,Eritrea,ERI,Netherlands,NLD,0,5,17,5,27
2004,Ethiopia,ETH,Netherlands,NLD,5,0,15,5,25
2004,Georgia,GEO,Netherlands,NLD,0,10,22,13,45
2004,Ghana,GHA,Netherlands,NLD,0,0,5,0,5
2004,Guinea,GIN,Netherlands,NLD,5,11,65,25,106
2004,Croatia,HRV,Netherlands,NLD,0,0,10,5,15
2004,Cote d'Ivoire,CIV,Netherlands,NLD,0,0,5,0,5
2004,Indonesia,IDN,Netherlands,NLD,0,0,5,5,10
2004,Iran (Islamic Rep. of),IRN,Netherlands,NLD,27,33,100,65,225
2004,Iraq,IRQ,Netherlands,NLD,27,244,235,337,843
2004,Kenya,KEN,Netherlands,NLD,0,0,5,5,10
2004,Kyrgyzstan,KGZ,Netherlands,NLD,0,0,5,5,10
2004,Liberia,LBR,Netherlands,NLD,0,5,25,14,44
2004,Libya,LBY,Netherlands,NLD,0,0,5,0,5
2004,Lebanon,LBN,Netherlands,NLD,0,0,5,0,5
2004,Sri Lanka,LKA,Netherlands,NLD,0,5,16,5,26
2004,Mauritania,MRT,Netherlands,NLD,0,0,5,5,10
2004,Mongolia,MNG,Netherlands,NLD,0,0,12,5,17
2004,Netherlands,NLD,Netherlands,NLD,0,0,0,13,13
2004,Niger,NER,Netherlands,NLD,0,0,5,0,5
2004,Nigeria,NGA,Netherlands,NLD,5,5,13,11,34
2004,Pakistan,PAK,Netherlands,NLD,0,0,10,5,15
2004,Russian Federation,RUS,Netherlands,NLD,0,12,57,23,92
2004,Rwanda,RWA,Netherlands,NLD,5,10,16,18,49
2004,Serbia and Kosovo: S/RES/1244 (1999),SRB,Netherlands,NLD,19,26,115,80,240
2004,Sierra Leone,SLE,Netherlands,NLD,10,10,103,41,164
2004,Somalia,SOM,Netherlands,NLD,51,27,92,71,241
2004,Viet Nam,VNM,Netherlands,NLD,0,0,5,0,5
2004,Sudan,SDN,Netherlands,NLD,5,17,133,62,217
2004,Syrian Arab Rep.,SYR,Netherlands,NLD,37,28,55,33,153
2004,Tajikistan,TJK,Netherlands,NLD,0,5,0,0,5
2004,Togo,TGO,Netherlands,NLD,0,0,26,10,36
2004,Tunisia,TUN,Netherlands,NLD,0,0,0,5,5
2004,Turkey,TUR,Netherlands,NLD,0,5,61,40,106
2004,Ukraine,UKR,Netherlands,NLD,0,5,10,5,20
2004,Uzbekistan,UZB,Netherlands,NLD,0,0,13,0,13
2004,Yemen,YEM,Netherlands,NLD,0,0,10,0,10
2004,Stateless,XXA,Netherlands,NLD,0,11,56,34,101
2004,Unknown ,,Netherlands,NLD,32,59,228,143,462
2004,Afghanistan,AFG,Norway,NOR,0,5,97,0,102
2004,Albania,ALB,Norway,NOR,0,10,157,0,167
2004,Algeria,DZA,Norway,NOR,0,0,124,0,124
2004,Angola,AGO,Norway,NOR,0,0,10,0,10
2004,Egypt,EGY,Norway,NOR,0,0,5,0,5
2004,Armenia,ARM,Norway,NOR,0,10,65,0,75
2004,Azerbaijan,AZE,Norway,NOR,0,5,88,0,93
2004,Benin,BEN,Norway,NOR,0,0,5,0,5
2004,Bangladesh,BGD,Norway,NOR,0,5,47,0,52
2004,Belarus,BLR,Norway,NOR,0,5,154,0,159
2004,Bosnia and Herzegovina,BIH,Norway,NOR,0,22,171,0,193
2004,Bulgaria,BGR,Norway,NOR,0,0,34,0,34
2004,China,CHN,Norway,NOR,0,0,27,0,27
2004,Chile,CHL,Norway,NOR,0,0,5,0,5
2004,Cameroon,CMR,Norway,NOR,0,0,71,0,71
2004,Dem. Rep. of the Congo,COD,Norway,NOR,0,0,14,0,14
2004,Czechia,CZE,Norway,NOR,0,0,17,0,17
2004,Eritrea,ERI,Norway,NOR,0,27,35,0,62
2004,Estonia,EST,Norway,NOR,0,0,5,0,5
2004,Ethiopia,ETH,Norway,NOR,0,20,350,0,370
2004,Georgia,GEO,Norway,NOR,0,0,82,0,82
2004,Guatemala,GTM,Norway,NOR,0,0,5,0,5
2004,Guinea,GIN,Norway,NOR,0,0,24,0,24
2004,Croatia,HRV,Norway,NOR,0,5,20,0,25
2004,Hungary,HUN,Norway,NOR,0,0,5,0,5
2004,India,IND,Norway,NOR,0,0,37,0,37
2004,Iran (Islamic Rep. of),IRN,Norway,NOR,0,20,359,0,379
2004,Iraq,IRQ,Norway,NOR,0,68,668,0,736
2004,Israel,ISR,Norway,NOR,0,0,44,0,44
2004,Jordan,JOR,Norway,NOR,0,5,11,0,16
2004,Kazakhstan,KAZ,Norway,NOR,0,5,78,0,83
2004,Kenya,KEN,Norway,NOR,0,5,0,0,5
2004,Kyrgyzstan,KGZ,Norway,NOR,0,5,88,0,93
2004,Libya,LBY,Norway,NOR,0,0,154,0,154
2004,Lebanon,LBN,Norway,NOR,0,5,24,0,29
2004,Sri Lanka,LKA,Norway,NOR,0,12,59,0,71
2004,Lithuania,LTU,Norway,NOR,0,0,5,0,5
2004,Latvia,LVA,Norway,NOR,0,0,5,0,5
2004,North Macedonia,MKD,Norway,NOR,0,0,156,0,156
2004,Rep. of Moldova,MDA,Norway,NOR,0,0,38,0,38
2004,Mali,MLI,Norway,NOR,0,0,5,0,5
2004,Mongolia,MNG,Norway,NOR,0,0,38,0,38
2004,Morocco,MAR,Norway,NOR,0,0,10,0,10
2004,Nepal,NPL,Norway,NOR,0,0,60,0,60
2004,Niger,NER,Norway,NOR,0,0,76,0,76
2004,Nigeria,NGA,Norway,NOR,0,0,157,0,157
2004,Pakistan,PAK,Norway,NOR,5,0,146,0,151
2004,Romania,ROU,Norway,NOR,0,0,32,0,32
2004,Russian Federation,RUS,Norway,NOR,5,32,448,0,485
2004,Rwanda,RWA,Norway,NOR,0,0,5,0,5
2004,Serbia and Kosovo: S/RES/1244 (1999),SRB,Norway,NOR,40,273,1328,0,1641
2004,Sierra Leone,SLE,Norway,NOR,0,0,5,0,5
2004,Somalia,SOM,Norway,NOR,0,10,211,0,221
2004,Viet Nam,VNM,Norway,NOR,0,0,50,0,50
2004,Sudan,SDN,Norway,NOR,0,0,37,0,37
2004,Slovakia,SVK,Norway,NOR,0,0,10,0,10
2004,Syrian Arab Rep.,SYR,Norway,NOR,0,23,55,0,78
2004,Tajikistan,TJK,Norway,NOR,0,0,23,0,23
2004,Turkmenistan,TKM,Norway,NOR,0,0,5,0,5
2004,Togo,TGO,Norway,NOR,0,0,12,0,12
2004,Turkey,TUR,Norway,NOR,0,21,195,0,216
2004,Uganda,UGA,Norway,NOR,0,0,5,0,5
2004,Ukraine,UKR,Norway,NOR,0,0,44,0,44
2004,Uzbekistan,UZB,Norway,NOR,0,5,118,0,123
2004,Yemen,YEM,Norway,NOR,0,0,5,0,5
2004,Stateless,XXA,Norway,NOR,0,10,298,0,308
2004,Afghanistan,AFG,New Zealand,NZL,0,0,5,0,5
2004,Albania,ALB,New Zealand,NZL,0,0,5,0,5
2004,Algeria,DZA,New Zealand,NZL,0,0,5,0,5
2004,Egypt,EGY,New Zealand,NZL,0,0,5,0,5
2004,Bangladesh,BGD,New Zealand,NZL,0,0,21,5,26
2004,Brazil,BRA,New Zealand,NZL,0,0,5,0,5
2004,Bulgaria,BGR,New Zealand,NZL,0,0,0,5,5
2004,China,CHN,New Zealand,NZL,5,0,31,5,41
2004,Chile,CHL,New Zealand,NZL,0,0,24,0,24
2004,Dem. Rep. of the Congo,COD,New Zealand,NZL,5,0,0,0,5
2004,Colombia,COL,New Zealand,NZL,5,0,0,0,5
2004,Czechia,CZE,New Zealand,NZL,16,0,17,10,43
2004,Eritrea,ERI,New Zealand,NZL,0,0,5,0,5
2004,Ethiopia,ETH,New Zealand,NZL,0,0,5,0,5
2004,Fiji,FJI,New Zealand,NZL,0,0,10,5,15
2004,Hungary,HUN,New Zealand,NZL,0,0,21,0,21
2004,India,IND,New Zealand,NZL,0,0,55,5,60
2004,Iran (Islamic Rep. of),IRN,New Zealand,NZL,42,0,30,0,72
2004,Iraq,IRQ,New Zealand,NZL,10,0,22,0,32
2004,Israel,ISR,New Zealand,NZL,0,0,5,0,5
2004,Sri Lanka,LKA,New Zealand,NZL,5,0,30,5,40
2004,Malaysia,MYS,New Zealand,NZL,0,0,19,5,24
2004,Nigeria,NGA,New Zealand,NZL,0,0,5,0,5
2004,Pakistan,PAK,New Zealand,NZL,0,0,11,5,16
2004,Peru,PER,New Zealand,NZL,0,0,5,0,5
2004,Russian Federation,RUS,New Zealand,NZL,0,0,10,0,10
2004,Solomon Islands,SLB,New Zealand,NZL,0,0,5,0,5
2004,Viet Nam,VNM,New Zealand,NZL,0,0,10,0,10
2004,Thailand,THA,New Zealand,NZL,0,0,59,0,59
2004,Turkey,TUR,New Zealand,NZL,5,0,5,0,10
2004,Zimbabwe,ZWE,New Zealand,NZL,10,0,10,5,25
2004,Afghanistan,AFG,Poland,POL,0,0,18,0,18
2004,Armenia,ARM,Poland,POL,0,0,15,0,15
2004,Belarus,BLR,Poland,POL,0,0,10,0,10
2004,Bulgaria,BGR,Poland,POL,0,0,5,0,5
2004,China,CHN,Poland,POL,0,0,15,0,15
2004,Palestinian,PSE,Poland,POL,0,0,5,0,5
2004,Georgia,GEO,Poland,POL,0,0,5,0,5
2004,Cote d'Ivoire,CIV,Poland,POL,0,0,5,0,5
2004,India,IND,Poland,POL,0,0,28,5,33
2004,Iran (Islamic Rep. of),IRN,Poland,POL,0,0,5,0,5
2004,Iraq,IRQ,Poland,POL,0,0,15,0,15
2004,Rep. of Moldova,MDA,Poland,POL,0,0,5,0,5
2004,Mongolia,MNG,Poland,POL,0,0,5,0,5
2004,Pakistan,PAK,Poland,POL,0,0,48,5,53
2004,Russian Federation,RUS,Poland,POL,10,0,402,62,474
2004,Serbia and Kosovo: S/RES/1244 (1999),SRB,Poland,POL,0,0,5,0,5
2004,Somalia,SOM,Poland,POL,0,0,5,0,5
2004,Viet Nam,VNM,Poland,POL,0,0,5,0,5
2004,Turkey,TUR,Poland,POL,0,0,10,0,10
2004,Ukraine,UKR,Poland,POL,0,0,18,5,23
2004,Uzbekistan,UZB,Poland,POL,0,0,5,0,5
2004,Afghanistan,AFG,Sweden,SWE,5,21,165,10,201
2004,Albania,ALB,Sweden,SWE,0,16,142,10,168
2004,Algeria,DZA,Sweden,SWE,0,0,160,10,170
2004,Angola,AGO,Sweden,SWE,0,0,14,0,14
2004,Egypt,EGY,Sweden,SWE,0,10,41,5,56
2004,Argentina,ARG,Sweden,SWE,0,0,5,0,5
2004,Armenia,ARM,Sweden,SWE,0,27,236,17,280
2004,Azerbaijan,AZE,Sweden,SWE,0,52,581,54,687
2004,Burundi,BDI,Sweden,SWE,0,0,15,0,15
2004,Benin,BEN,Sweden,SWE,0,0,5,0,5
2004,Bangladesh,BGD,Sweden,SWE,0,25,92,5,122
2004,Belarus,BLR,Sweden,SWE,0,13,501,67,581
2004,Bolivia (Plurinational State of),BOL,Sweden,SWE,0,5,256,38,299
2004,Brazil,BRA,Sweden,SWE,0,0,5,0,5
2004,Bosnia and Herzegovina,BIH,Sweden,SWE,0,206,703,19,928
2004,Bulgaria,BGR,Sweden,SWE,0,0,193,5,198
2004,Chad,TCD,Sweden,SWE,0,0,5,0,5
2004,China,CHN,Sweden,SWE,5,5,30,0,40
2004,Chile,CHL,Sweden,SWE,0,0,21,5,26
2004,Cameroon,CMR,Sweden,SWE,0,5,16,0,21
2004,Congo,COG,Sweden,SWE,0,0,5,0,5
2004,Dem. Rep. of the Congo,COD,Sweden,SWE,0,5,68,0,73
2004,Colombia,COL,Sweden,SWE,0,10,35,10,55
2004,Cuba,CUB,Sweden,SWE,5,5,10,0,20
2004,Ecuador,ECU,Sweden,SWE,0,10,118,10,138
2004,Eritrea,ERI,Sweden,SWE,5,30,245,16,296
2004,Ethiopia,ETH,Sweden,SWE,0,5,101,0,106
2004,Gabon,GAB,Sweden,SWE,0,0,5,0,5
2004,Gambia,GMB,Sweden,SWE,0,0,5,0,5
2004,Georgia,GEO,Sweden,SWE,0,16,373,30,419
2004,Ghana,GHA,Sweden,SWE,0,0,12,0,12
2004,Guinea,GIN,Sweden,SWE,0,5,14,0,19
2004,Honduras,HND,Sweden,SWE,5,0,10,0,15
2004,Croatia,HRV,Sweden,SWE,0,5,66,0,71
2004,Cote d'Ivoire,CIV,Sweden,SWE,0,0,22,5,27
2004,India,IND,Sweden,SWE,5,0,48,5,58
2004,Iran (Islamic Rep. of),IRN,Sweden,SWE,50,96,577,49,772
2004,Iraq,IRQ,Sweden,SWE,5,94,1171,160,1430
2004,Israel,ISR,Sweden,SWE,0,0,19,5,24
2004,Jordan,JOR,Sweden,SWE,0,11,76,14,101
2004,Kazakhstan,KAZ,Sweden,SWE,5,13,130,15,163
2004,Kenya,KEN,Sweden,SWE,0,0,10,0,10
2004,Kyrgyzstan,KGZ,Sweden,SWE,0,0,209,10,219
2004,Kiribati,KIR,Sweden,SWE,0,16,0,0,16
2004,Liberia,LBR,Sweden,SWE,0,0,20,0,20
2004,Libya,LBY,Sweden,SWE,0,5,164,24,193
2004,Lebanon,LBN,Sweden,SWE,0,16,276,20,312
2004,Sri Lanka,LKA,Sweden,SWE,0,0,16,0,16
2004,Lithuania,LTU,Sweden,SWE,0,0,5,5,10
2004,Latvia,LVA,Sweden,SWE,0,0,12,5,17
2004,Mauritania,MRT,Sweden,SWE,0,0,5,0,5
2004,North Macedonia,MKD,Sweden,SWE,0,20,300,5,325
2004,Rep. of Moldova,MDA,Sweden,SWE,0,0,48,5,53
2004,Mali,MLI,Sweden,SWE,0,0,5,0,5
2004,Malaysia,MYS,Sweden,SWE,0,5,5,0,10
2004,Mongolia,MNG,Sweden,SWE,0,10,169,5,184
2004,Morocco,MAR,Sweden,SWE,0,0,22,5,27
2004,Myanmar,MMR,Sweden,SWE,0,5,5,0,10
2004,Nepal,NPL,Sweden,SWE,0,0,5,0,5
2004,Niger,NER,Sweden,SWE,0,0,10,0,10
2004,Nigeria,NGA,Sweden,SWE,0,5,316,15,336
2004,Pakistan,PAK,Sweden,SWE,0,10,21,0,31
2004,Paraguay,PRY,Sweden,SWE,0,0,0,5,5
2004,Peru,PER,Sweden,SWE,0,10,86,10,106
2004,Philippines,PHL,Sweden,SWE,0,5,5,0,10
2004,Poland,POL,Sweden,SWE,0,0,5,5,10
2004,Romania,ROU,Sweden,SWE,0,0,96,0,96
2004,Russian Federation,RUS,Sweden,SWE,0,73,850,98,1021
2004,Rwanda,RWA,Sweden,SWE,0,0,15,0,15
2004,El Salvador,SLV,Sweden,SWE,0,0,14,0,14
2004,Saudi Arabia,SAU,Sweden,SWE,0,0,10,0,10
2004,Serbia and Kosovo: S/RES/1244 (1999),SRB,Sweden,SWE,38,310,2611,178,3137
2004,Senegal,SEN,Sweden,SWE,0,0,5,0,5
2004,Sierra Leone,SLE,Sweden,SWE,0,5,36,0,41
2004,Somalia,SOM,Sweden,SWE,14,32,453,36,535
2004,Viet Nam,VNM,Sweden,SWE,0,0,67,5,72
2004,Sudan,SDN,Sweden,SWE,0,0,30,5,35
2004,Slovakia,SVK,Sweden,SWE,0,0,25,0,25
2004,Sweden,SWE,Sweden,SWE,0,10,0,0,10
2004,Syrian Arab Rep.,SYR,Sweden,SWE,32,56,479,26,593
2004,United Rep. of Tanzania,TZA,Sweden,SWE,0,0,5,0,5
2004,Tajikistan,TJK,Sweden,SWE,5,0,44,0,49
2004,Turkmenistan,TKM,Sweden,SWE,0,0,12,0,12
2004,Togo,TGO,Sweden,SWE,0,0,5,0,5
2004,Tunisia,TUN,Sweden,SWE,0,0,38,13,51
2004,Turkey,TUR,Sweden,SWE,0,46,624,29,699
2004,Uganda,UGA,Sweden,SWE,0,0,28,0,28
2004,Ukraine,UKR,Sweden,SWE,0,16,285,20,321
2004,United States of America,USA,Sweden,SWE,0,0,5,0,5
2004,Uzbekistan,UZB,Sweden,SWE,0,32,368,5,405
2004,Venezuela (Bolivarian Republic of),VEN,Sweden,SWE,0,0,11,0,11
2004,Yemen,YEM,Sweden,SWE,0,0,45,0,45
2004,Stateless,XXA,Sweden,SWE,0,80,404,47,531
2004,Unknown ,,Sweden,SWE,0,5,102,11,118
2004,Unknown ,,Switzerland,CHE,1150,0,6624,7321,15095
2004,Cote d'Ivoire,CIV,Togo,TGO,5,0,0,0,5
2004,Nigeria,NGA,Togo,TGO,5,0,0,0,5
2004,Rwanda,RWA,Togo,TGO,5,0,0,0,5
2004,Afghanistan,AFG,Ukraine,UKR,0,0,12,37,49
2004,Angola,AGO,Ukraine,UKR,0,0,5,21,26
2004,Armenia,ARM,Ukraine,UKR,0,0,5,5,10
2004,Bangladesh,BGD,Ukraine,UKR,0,0,96,19,115
2004,China,CHN,Ukraine,UKR,0,0,13,0,13
2004,Congo,COG,Ukraine,UKR,0,0,0,5,5
2004,Ethiopia,ETH,Ukraine,UKR,0,0,5,10,15
2004,Palestinian,PSE,Ukraine,UKR,0,0,0,5,5
2004,Georgia,GEO,Ukraine,UKR,0,0,0,5,5
2004,India,IND,Ukraine,UKR,0,0,31,5,36
2004,Iran (Islamic Rep. of),IRN,Ukraine,UKR,0,0,5,13,18
2004,Iraq,IRQ,Ukraine,UKR,0,0,5,10,15
2004,Lebanon,LBN,Ukraine,UKR,0,0,5,0,5
2004,Sri Lanka,LKA,Ukraine,UKR,0,0,5,10,15
2004,Nigeria,NGA,Ukraine,UKR,0,0,10,11,21
2004,Pakistan,PAK,Ukraine,UKR,0,0,13,5,18
2004,Russian Federation,RUS,Ukraine,UKR,0,0,5,19,24
2004,Somalia,SOM,Ukraine,UKR,0,0,17,10,27
2004,Syrian Arab Rep.,SYR,Ukraine,UKR,0,0,0,5,5
2004,Uganda,UGA,Ukraine,UKR,0,0,0,5,5
2005,Afghanistan,AFG,Azerbaijan,AZE,0,0,163,0,163
2005,Iran (Islamic Rep. of),IRN,Azerbaijan,AZE,0,0,10,0,10
2005,Iraq,IRQ,Azerbaijan,AZE,0,0,12,0,12
2005,Pakistan,PAK,Azerbaijan,AZE,0,0,19,0,19
2005,Tajikistan,TJK,Azerbaijan,AZE,0,0,5,0,5
2005,Afghanistan,AFG,Belgium,BEL,0,0,33,20,53
2005,Albania,ALB,Belgium,BEL,0,0,24,34,58
2005,Algeria,DZA,Belgium,BEL,0,0,17,17,34
2005,Angola,AGO,Belgium,BEL,0,0,13,10,23
2005,Armenia,ARM,Belgium,BEL,0,0,0,21,21
2005,Azerbaijan,AZE,Belgium,BEL,0,0,5,13,18
2005,Burundi,BDI,Belgium,BEL,0,0,0,10,10
2005,Bangladesh,BGD,Belgium,BEL,0,0,15,5,20
2005,Bhutan,BTN,Belgium,BEL,0,0,5,0,5
2005,Belarus,BLR,Belgium,BEL,0,0,10,10,20
2005,Bosnia and Herzegovina,BIH,Belgium,BEL,0,0,11,5,16
2005,Bulgaria,BGR,Belgium,BEL,0,0,0,26,26
2005,China,CHN,Belgium,BEL,5,0,151,11,167
2005,Cameroon,CMR,Belgium,BEL,0,0,33,32,65
2005,Dem. Rep. of the Congo,COD,Belgium,BEL,21,0,248,87,356
2005,Colombia,COL,Belgium,BEL,0,0,22,10,32
2005,Cuba,CUB,Belgium,BEL,0,0,5,0,5
2005,Georgia,GEO,Belgium,BEL,0,0,32,62,94
2005,Guinea,GIN,Belgium,BEL,0,0,5,10,15
2005,India,IND,Belgium,BEL,0,0,10,0,10
2005,Iran (Islamic Rep. of),IRN,Belgium,BEL,10,0,364,41,415
2005,Iraq,IRQ,Belgium,BEL,0,0,5,10,15
2005,Israel,ISR,Belgium,BEL,0,0,5,0,5
2005,Kazakhstan,KAZ,Belgium,BEL,0,0,5,51,56
2005,Kyrgyzstan,KGZ,Belgium,BEL,0,0,5,20,25
2005,Lebanon,LBN,Belgium,BEL,0,0,5,5,10
2005,Sri Lanka,LKA,Belgium,BEL,0,0,35,5,40
2005,Mauritania,MRT,Belgium,BEL,0,0,21,5,26
2005,North Macedonia,MKD,Belgium,BEL,0,0,5,0,5
2005,Rep. of Moldova,MDA,Belgium,BEL,0,0,0,16,16
2005,Myanmar,MMR,Belgium,BEL,0,0,5,0,5
2005,Nepal,NPL,Belgium,BEL,0,0,45,37,82
2005,Pakistan,PAK,Belgium,BEL,10,0,109,19,138
2005,Romania,ROU,Belgium,BEL,0,0,0,5,5
2005,Russian Federation,RUS,Belgium,BEL,579,0,95,171,845
2005,Rwanda,RWA,Belgium,BEL,10,0,15,5,30
2005,Serbia and Kosovo: S/RES/1244 (1999),SRB,Belgium,BEL,10,0,44,62,116
2005,Sierra Leone,SLE,Belgium,BEL,0,0,5,5,10
2005,Somalia,SOM,Belgium,BEL,5,0,5,0,10
2005,Sudan,SDN,Belgium,BEL,0,0,15,0,15
2005,Syrian Arab Rep.,SYR,Belgium,BEL,0,0,41,16,57
2005,Togo,TGO,Belgium,BEL,0,0,24,14,38
2005,Turkey,TUR,Belgium,BEL,12,0,91,74,177
2005,Ukraine,UKR,Belgium,BEL,0,0,5,13,18
2005,Uzbekistan,UZB,Belgium,BEL,0,0,0,22,22
2005,Unknown ,,Belgium,BEL,0,0,0,5,5
2005,Togo,TGO,Benin,BEN,0,0,5,0,5
2005,Cuba,CUB,Colombia,COL,0,0,5,0,5
2005,Peru,PER,Colombia,COL,0,0,5,0,5
2005,Venezuela (Bolivarian Republic of),VEN,Colombia,COL,0,0,5,0,5
2005,Bangladesh,BGD,Cyprus,CYP,0,0,790,36,826
2005,Burkina Faso,BFA,Cyprus,CYP,0,0,0,5,5
2005,Belarus,BLR,Cyprus,CYP,0,0,5,0,5
2005,China,CHN,Cyprus,CYP,0,0,5,0,5
2005,Dem. Rep. of the Congo,COD,Cyprus,CYP,0,0,5,0,5
2005,Palestinian,PSE,Cyprus,CYP,0,0,14,0,14
2005,Georgia,GEO,Cyprus,CYP,0,0,17,5,22
2005,Cote d'Ivoire,CIV,Cyprus,CYP,0,0,0,5,5
2005,India,IND,Cyprus,CYP,0,0,5,5,10
2005,Iran (Islamic Rep. of),IRN,Cyprus,CYP,0,5,143,5,153
2005,Lebanon,LBN,Cyprus,CYP,0,0,5,0,5
2005,Sri Lanka,LKA,Cyprus,CYP,0,0,0,5,5
2005,Rep. of Moldova,MDA,Cyprus,CYP,0,0,5,0,5
2005,Pakistan,PAK,Cyprus,CYP,0,0,101,22,123
2005,Russian Federation,RUS,Cyprus,CYP,0,0,28,5,33
2005,Syrian Arab Rep.,SYR,Cyprus,CYP,0,0,5,0,5
2005,Turkey,TUR,Cyprus,CYP,0,10,71,11,92
2005,Ukraine,UKR,Cyprus,CYP,0,0,22,5,27
2005,Afghanistan,AFG,Denmark,DNK,19,15,120,0,154
2005,Albania,ALB,Denmark,DNK,0,0,10,0,10
2005,Algeria,DZA,Denmark,DNK,0,0,5,0,5
2005,Azerbaijan,AZE,Denmark,DNK,5,0,5,0,10
2005,Burundi,BDI,Denmark,DNK,0,0,10,0,10
2005,Bangladesh,BGD,Denmark,DNK,0,0,5,0,5
2005,Bosnia and Herzegovina,BIH,Denmark,DNK,0,0,5,0,5
2005,China,CHN,Denmark,DNK,5,0,10,0,15
2005,Dem. Rep. of the Congo,COD,Denmark,DNK,0,0,5,0,5
2005,Eritrea,ERI,Denmark,DNK,0,0,5,0,5
2005,Palestinian,PSE,Denmark,DNK,12,0,41,0,53
2005,Guinea,GIN,Denmark,DNK,0,0,5,0,5
2005,India,IND,Denmark,DNK,0,0,12,0,12
2005,Iran (Islamic Rep. of),IRN,Denmark,DNK,19,19,36,0,74
2005,Iraq,IRQ,Denmark,DNK,0,16,221,0,237
2005,Kyrgyzstan,KGZ,Denmark,DNK,0,0,5,0,5
2005,Lebanon,LBN,Denmark,DNK,0,0,5,0,5
2005,Sri Lanka,LKA,Denmark,DNK,0,0,10,0,10
2005,Rep. of Moldova,MDA,Denmark,DNK,0,0,5,0,5
2005,Morocco,MAR,Denmark,DNK,0,0,5,0,5
2005,Nigeria,NGA,Denmark,DNK,0,0,20,0,20
2005,Pakistan,PAK,Denmark,DNK,0,0,5,0,5
2005,Russian Federation,RUS,Denmark,DNK,5,5,25,0,35
2005,Serbia and Kosovo: S/RES/1244 (1999),SRB,Denmark,DNK,0,0,99,0,99
2005,Sierra Leone,SLE,Denmark,DNK,0,0,5,0,5
2005,Somalia,SOM,Denmark,DNK,0,5,48,0,53
2005,Sudan,SDN,Denmark,DNK,0,0,5,0,5
2005,Syrian Arab Rep.,SYR,Denmark,DNK,5,0,14,0,19
2005,Togo,TGO,Denmark,DNK,0,0,5,0,5
2005,Turkey,TUR,Denmark,DNK,0,0,10,0,10
2005,Albania,ALB,France,FRA,207,0,272,47,526
2005,Algeria,DZA,France,FRA,214,0,1625,371,2210
2005,Angola,AGO,France,FRA,317,0,1213,137,1667
2005,Armenia,ARM,France,FRA,536,0,932,128,1596
2005,Azerbaijan,AZE,France,FRA,359,0,323,49,731
2005,Bangladesh,BGD,France,FRA,342,0,921,123,1386
2005,Bosnia and Herzegovina,BIH,France,FRA,80,0,398,103,581
2005,Central African Rep.,CAF,France,FRA,41,0,213,44,298
2005,Chad,TCD,France,FRA,97,0,164,29,290
2005,China,CHN,France,FRA,33,0,4764,1619,6416
2005,Congo,COG,France,FRA,404,0,1708,322,2434
2005,Dem. Rep. of the Congo,COD,France,FRA,826,0,4765,474,6065
2005,Georgia,GEO,France,FRA,558,0,1520,218,2296
2005,Guinea,GIN,France,FRA,228,0,903,160,1291
2005,Haiti,HTI,France,FRA,209,0,1613,723,2545
2005,India,IND,France,FRA,34,0,826,193,1053
2005,Sri Lanka,LKA,France,FRA,899,0,2512,200,3611
2005,Madagascar,MDG,France,FRA,37,0,222,31,290
2005,Mauritania,MRT,France,FRA,375,0,1535,309,2219
2005,North Macedonia,MKD,France,FRA,50,0,199,35,284
2005,Rep. of Moldova,MDA,France,FRA,85,0,1165,1046,2296
2005,Mali,MLI,France,FRA,16,0,614,303,933
2005,Mongolia,MNG,France,FRA,86,0,490,97,673
2005,Nigeria,NGA,France,FRA,130,0,1170,456,1756
2005,Pakistan,PAK,France,FRA,46,0,715,226,987
2005,Russian Federation,RUS,France,FRA,736,0,1015,130,1881
2005,Serbia and Kosovo: S/RES/1244 (1999),SRB,France,FRA,542,0,1213,373,2128
2005,Sierra Leone,SLE,France,FRA,23,0,285,83,391
2005,Turkey,TUR,France,FRA,789,0,4419,1368,6576
2005,Ukraine,UKR,France,FRA,76,0,473,188,737
2005,Afghanistan,AFG,Hungary,HUN,0,0,5,5,10
2005,Algeria,DZA,Hungary,HUN,0,0,20,5,25
2005,Angola,AGO,Hungary,HUN,0,0,5,0,5
2005,Armenia,ARM,Hungary,HUN,0,0,5,0,5
2005,Bangladesh,BGD,Hungary,HUN,0,0,5,0,5
2005,China,CHN,Hungary,HUN,0,0,26,10,36
2005,Cameroon,CMR,Hungary,HUN,0,0,5,0,5
2005,Congo,COG,Hungary,HUN,0,0,5,0,5
2005,Gambia,GMB,Hungary,HUN,0,0,5,0,5
2005,Georgia,GEO,Hungary,HUN,0,0,12,10,22
2005,Cote d'Ivoire,CIV,Hungary,HUN,0,0,0,5,5
2005,India,IND,Hungary,HUN,0,0,5,5,10
2005,Iraq,IRQ,Hungary,HUN,0,0,10,0,10
2005,Jordan,JOR,Hungary,HUN,0,0,5,5,10
2005,Nigeria,NGA,Hungary,HUN,0,0,27,10,37
2005,Pakistan,PAK,Hungary,HUN,0,0,0,5,5
2005,Romania,ROU,Hungary,HUN,0,0,5,5,10
2005,Russian Federation,RUS,Hungary,HUN,0,0,10,5,15
2005,Serbia and Kosovo: S/RES/1244 (1999),SRB,Hungary,HUN,0,5,22,12,39
2005,Senegal,SEN,Hungary,HUN,0,0,5,0,5
2005,Somalia,SOM,Hungary,HUN,0,0,5,0,5
2005,Viet Nam,VNM,Hungary,HUN,0,0,118,19,137
2005,Slovakia,SVK,Hungary,HUN,0,0,10,0,10
2005,Syrian Arab Rep.,SYR,Hungary,HUN,0,0,5,0,5
2005,Turkey,TUR,Hungary,HUN,0,0,14,5,19
2005,Ukraine,UKR,Hungary,HUN,0,0,10,5,15
2005,Afghanistan,AFG,Iceland,ISL,0,0,5,0,5
2005,Algeria,DZA,Iceland,ISL,0,0,5,0,5
2005,Kazakhstan,KAZ,Iceland,ISL,0,0,5,0,5
2005,Unknown ,,Ireland,IRL,101,0,299,107,507
2005,China,CHN,Japan,JPN,0,0,5,0,5
2005,Myanmar,MMR,Japan,JPN,14,38,77,5,134
2005,Turkey,TUR,Japan,JPN,0,0,34,5,39
2005,Unknown ,,Japan,JPN,0,36,44,5,85
2005,Bhutan,BTN,Nepal,NPL,0,88,10,0,98
2005,Afghanistan,AFG,Netherlands,NLD,0,42,34,186,262
2005,Albania,ALB,Netherlands,NLD,0,0,0,5,5
2005,Algeria,DZA,Netherlands,NLD,0,0,0,12,12
2005,Angola,AGO,Netherlands,NLD,0,19,33,260,312
2005,Egypt,EGY,Netherlands,NLD,0,0,0,5,5
2005,Armenia,ARM,Netherlands,NLD,0,50,44,135,229
2005,Azerbaijan,AZE,Netherlands,NLD,0,114,85,405,604
2005,Burundi,BDI,Netherlands,NLD,0,0,5,10,15
2005,Benin,BEN,Netherlands,NLD,0,0,0,5,5
2005,Bangladesh,BGD,Netherlands,NLD,0,0,0,5,5
2005,Burkina Faso,BFA,Netherlands,NLD,0,0,0,10,10
2005,Belarus,BLR,Netherlands,NLD,0,0,0,5,5
2005,Bosnia and Herzegovina,BIH,Netherlands,NLD,0,15,5,58,78
2005,China,CHN,Netherlands,NLD,0,5,21,146,172
2005,Cameroon,CMR,Netherlands,NLD,0,5,0,16,21
2005,Congo,COG,Netherlands,NLD,0,5,5,20,30
2005,Dem. Rep. of the Congo,COD,Netherlands,NLD,0,25,13,100,138
2005,Eritrea,ERI,Netherlands,NLD,0,5,5,24,34
2005,Ethiopia,ETH,Netherlands,NLD,0,5,5,35,45
2005,Georgia,GEO,Netherlands,NLD,0,5,5,35,45
2005,Guinea,GIN,Netherlands,NLD,0,11,26,121,158
2005,Croatia,HRV,Netherlands,NLD,0,0,0,5,5
2005,Cote d'Ivoire,CIV,Netherlands,NLD,0,0,0,11,11
2005,Iran (Islamic Rep. of),IRN,Netherlands,NLD,0,52,23,140,215
2005,Iraq,IRQ,Netherlands,NLD,0,342,82,773,1197
2005,Kazakhstan,KAZ,Netherlands,NLD,0,10,5,21,36
2005,Kyrgyzstan,KGZ,Netherlands,NLD,0,5,5,16,26
2005,Liberia,LBR,Netherlands,NLD,0,0,5,27,32
2005,Libya,LBY,Netherlands,NLD,0,0,0,5,5
2005,Sri Lanka,LKA,Netherlands,NLD,0,5,0,27,32
2005,Mauritania,MRT,Netherlands,NLD,0,0,0,16,16
2005,Rep. of Moldova,MDA,Netherlands,NLD,0,0,0,5,5
2005,Mongolia,MNG,Netherlands,NLD,0,0,5,16,21
2005,Myanmar,MMR,Netherlands,NLD,0,0,0,10,10
2005,Niger,NER,Netherlands,NLD,0,0,0,5,5
2005,Nigeria,NGA,Netherlands,NLD,0,0,5,23,28
2005,Pakistan,PAK,Netherlands,NLD,0,0,5,18,23
2005,Russian Federation,RUS,Netherlands,NLD,0,38,44,145,227
2005,Rwanda,RWA,Netherlands,NLD,0,16,5,85,106
2005,Serbia and Kosovo: S/RES/1244 (1999),SRB,Netherlands,NLD,0,37,54,165,256
2005,Sierra Leone,SLE,Netherlands,NLD,0,10,18,134,162
2005,Somalia,SOM,Netherlands,NLD,0,83,39,232,354
2005,Viet Nam,VNM,Netherlands,NLD,0,0,0,5,5
2005,Sudan,SDN,Netherlands,NLD,0,40,49,171,260
2005,Slovakia,SVK,Netherlands,NLD,0,0,11,10,21
2005,Syrian Arab Rep.,SYR,Netherlands,NLD,0,32,24,100,156
2005,Tajikistan,TJK,Netherlands,NLD,0,0,5,0,5
2005,Togo,TGO,Netherlands,NLD,0,0,5,36,41
2005,Tunisia,TUN,Netherlands,NLD,0,0,0,10,10
2005,Turkey,TUR,Netherlands,NLD,0,12,16,67,95
2005,Uganda,UGA,Netherlands,NLD,0,0,0,5,5
2005,Ukraine,UKR,Netherlands,NLD,0,5,5,12,22
2005,Uzbekistan,UZB,Netherlands,NLD,0,5,0,10,15
2005,Yemen,YEM,Netherlands,NLD,0,0,0,5,5
2005,Stateless,XXA,Netherlands,NLD,0,18,59,107,184
2005,Unknown ,,Netherlands,NLD,0,103,68,316,487
2005,Dem. Rep. of the Congo,COD,Niger,NER,0,0,5,0,5
2005,Afghanistan,AFG,Norway,NOR,0,16,390,0,406
2005,Albania,ALB,Norway,NOR,5,5,126,0,136
2005,Algeria,DZA,Norway,NOR,0,0,122,0,122
2005,Angola,AGO,Norway,NOR,0,0,23,0,23
2005,Egypt,EGY,Norway,NOR,0,0,5,0,5
2005,Armenia,ARM,Norway,NOR,0,0,17,0,17
2005,Azerbaijan,AZE,Norway,NOR,0,15,58,0,73
2005,Burundi,BDI,Norway,NOR,0,0,10,0,10
2005,Benin,BEN,Norway,NOR,0,0,5,0,5
2005,Bangladesh,BGD,Norway,NOR,0,0,19,0,19
2005,Belarus,BLR,Norway,NOR,0,0,34,0,34
2005,Bosnia and Herzegovina,BIH,Norway,NOR,0,5,164,0,169
2005,Bulgaria,BGR,Norway,NOR,0,0,10,0,10
2005,China,CHN,Norway,NOR,0,0,22,0,22
2005,Cameroon,CMR,Norway,NOR,0,5,57,0,62
2005,Dem. Rep. of the Congo,COD,Norway,NOR,0,10,10,0,20
2005,Colombia,COL,Norway,NOR,0,0,5,0,5
2005,Cabo Verde,CPV,Norway,NOR,0,0,5,0,5
2005,Czechia,CZE,Norway,NOR,0,0,10,0,10
2005,Eritrea,ERI,Norway,NOR,5,167,45,0,217
2005,Ethiopia,ETH,Norway,NOR,10,33,167,0,210
2005,Georgia,GEO,Norway,NOR,0,0,24,0,24
2005,Ghana,GHA,Norway,NOR,0,0,10,0,10
2005,Guinea,GIN,Norway,NOR,0,5,30,0,35
2005,Croatia,HRV,Norway,NOR,0,5,26,0,31
2005,Hungary,HUN,Norway,NOR,0,0,10,0,10
2005,Cote d'Ivoire,CIV,Norway,NOR,0,0,10,0,10
2005,India,IND,Norway,NOR,0,5,5,0,10
2005,Iran (Islamic Rep. of),IRN,Norway,NOR,0,5,394,0,399
2005,Iraq,IRQ,Norway,NOR,0,5,644,0,649
2005,Israel,ISR,Norway,NOR,0,0,30,0,30
2005,Jordan,JOR,Norway,NOR,0,0,10,0,10
2005,Kazakhstan,KAZ,Norway,NOR,0,5,18,0,23
2005,Kyrgyzstan,KGZ,Norway,NOR,0,0,34,0,34
2005,Kuwait,KWT,Norway,NOR,0,0,5,0,5
2005,Liberia,LBR,Norway,NOR,0,5,46,0,51
2005,Libya,LBY,Norway,NOR,0,0,156,0,156
2005,Lebanon,LBN,Norway,NOR,0,0,36,0,36
2005,Sri Lanka,LKA,Norway,NOR,0,10,79,0,89
2005,Lithuania,LTU,Norway,NOR,0,0,5,0,5
2005,Latvia,LVA,Norway,NOR,0,0,5,0,5
2005,Mauritania,MRT,Norway,NOR,0,0,10,0,10
2005,North Macedonia,MKD,Norway,NOR,0,0,74,0,74
2005,Rep. of Moldova,MDA,Norway,NOR,0,0,10,0,10
2005,Mongolia,MNG,Norway,NOR,0,0,26,0,26
2005,Morocco,MAR,Norway,NOR,0,0,15,0,15
2005,Nepal,NPL,Norway,NOR,0,0,30,0,30
2005,Niger,NER,Norway,NOR,0,0,14,0,14
2005,Nigeria,NGA,Norway,NOR,0,5,187,0,192
2005,Pakistan,PAK,Norway,NOR,0,10,125,0,135
2005,Poland,POL,Norway,NOR,0,0,5,0,5
2005,Romania,ROU,Norway,NOR,0,0,13,0,13
2005,Russian Federation,RUS,Norway,NOR,5,50,350,0,405
2005,Rwanda,RWA,Norway,NOR,0,0,23,0,23
2005,Serbia and Kosovo: S/RES/1244 (1999),SRB,Norway,NOR,28,94,889,0,1011
2005,Senegal,SEN,Norway,NOR,0,0,5,0,5
2005,Sierra Leone,SLE,Norway,NOR,0,5,56,0,61
2005,Somalia,SOM,Norway,NOR,10,27,234,0,271
2005,Viet Nam,VNM,Norway,NOR,0,0,10,0,10
2005,Sudan,SDN,Norway,NOR,0,0,30,0,30
2005,Suriname,SUR,Norway,NOR,0,0,5,0,5
2005,Syrian Arab Rep.,SYR,Norway,NOR,0,5,71,0,76
2005,Tajikistan,TJK,Norway,NOR,0,0,10,0,10
2005,Togo,TGO,Norway,NOR,0,0,5,0,5
2005,Tunisia,TUN,Norway,NOR,0,0,5,0,5
2005,Turkey,TUR,Norway,NOR,0,0,88,0,88
2005,Uganda,UGA,Norway,NOR,0,0,5,0,5
2005,Ukraine,UKR,Norway,NOR,0,14,25,0,39
2005,Uzbekistan,UZB,Norway,NOR,0,0,58,0,58
2005,Western Sahara,ESH,Norway,NOR,0,0,11,0,11
2005,Yemen,YEM,Norway,NOR,0,0,12,0,12
2005,Unknown ,,Norway,NOR,0,5,182,0,187
2005,Albania,ALB,New Zealand,NZL,0,0,5,0,5
2005,Algeria,DZA,New Zealand,NZL,5,0,0,0,5
2005,Bangladesh,BGD,New Zealand,NZL,0,0,30,5,35
2005,Brazil,BRA,New Zealand,NZL,0,0,5,0,5
2005,China,CHN,New Zealand,NZL,10,0,13,0,23
2005,Chile,CHL,New Zealand,NZL,0,0,23,5,28
2005,Congo,COG,New Zealand,NZL,5,0,5,0,10
2005,Czechia,CZE,New Zealand,NZL,18,0,18,5,41
2005,Hungary,HUN,New Zealand,NZL,0,0,5,0,5
2005,India,IND,New Zealand,NZL,0,0,81,10,91
2005,Iran (Islamic Rep. of),IRN,New Zealand,NZL,19,0,27,5,51
2005,Iraq,IRQ,New Zealand,NZL,10,0,10,0,20
2005,Israel,ISR,New Zealand,NZL,0,0,5,0,5
2005,Jordan,JOR,New Zealand,NZL,5,0,13,0,18
2005,Kyrgyzstan,KGZ,New Zealand,NZL,5,0,0,0,5
2005,Lebanon,LBN,New Zealand,NZL,5,0,0,0,5
2005,Sri Lanka,LKA,New Zealand,NZL,5,0,32,5,42
2005,Malaysia,MYS,New Zealand,NZL,0,0,5,0,5
2005,Myanmar,MMR,New Zealand,NZL,0,0,5,0,5
2005,Nepal,NPL,New Zealand,NZL,0,0,5,0,5
2005,Nigeria,NGA,New Zealand,NZL,0,0,10,0,10
2005,Pakistan,PAK,New Zealand,NZL,5,0,11,0,16
2005,Peru,PER,New Zealand,NZL,0,0,5,0,5
2005,South Africa,ZAF,New Zealand,NZL,0,0,11,0,11
2005,Russian Federation,RUS,New Zealand,NZL,0,0,5,0,5
2005,Saudi Arabia,SAU,New Zealand,NZL,0,0,0,5,5
2005,Serbia and Kosovo: S/RES/1244 (1999),SRB,New Zealand,NZL,5,0,5,0,10
2005,Somalia,SOM,New Zealand,NZL,5,0,0,0,5
2005,Viet Nam,VNM,New Zealand,NZL,0,0,5,0,5
2005,Sudan,SDN,New Zealand,NZL,0,0,10,0,10
2005,Syrian Arab Rep.,SYR,New Zealand,NZL,5,0,5,0,10
2005,Turkey,TUR,New Zealand,NZL,0,0,5,0,5
2005,Zimbabwe,ZWE,New Zealand,NZL,10,0,5,0,15
2005,Armenia,ARM,Poland,POL,0,0,5,0,5
2005,Belarus,BLR,Poland,POL,0,0,11,0,11
2005,Bulgaria,BGR,Poland,POL,0,0,10,0,10
2005,Georgia,GEO,Poland,POL,0,0,12,0,12
2005,India,IND,Poland,POL,0,0,5,0,5
2005,Kazakhstan,KAZ,Poland,POL,0,0,10,0,10
2005,Rep. of Moldova,MDA,Poland,POL,0,0,5,0,5
2005,Pakistan,PAK,Poland,POL,0,0,5,0,5
2005,Russian Federation,RUS,Poland,POL,23,23,253,155,454
2005,Turkmenistan,TKM,Poland,POL,0,0,5,0,5
2005,Ukraine,UKR,Poland,POL,0,0,33,10,43
2005,Uzbekistan,UZB,Poland,POL,0,0,5,0,5
2005,Afghanistan,AFG,Sweden,SWE,5,77,758,51,891
2005,Albania,ALB,Sweden,SWE,0,21,294,5,320
2005,Algeria,DZA,Sweden,SWE,0,5,193,14,212
2005,Angola,AGO,Sweden,SWE,0,0,150,5,155
2005,Egypt,EGY,Sweden,SWE,0,5,77,10,92
2005,Armenia,ARM,Sweden,SWE,0,31,636,30,697
2005,Azerbaijan,AZE,Sweden,SWE,0,93,2265,61,2419
2005,Bahrain,BHR,Sweden,SWE,0,0,0,5,5
2005,Burundi,BDI,Sweden,SWE,0,0,31,0,31
2005,Benin,BEN,Sweden,SWE,0,0,10,0,10
2005,Bangladesh,BGD,Sweden,SWE,0,38,188,5,231
2005,Burkina Faso,BFA,Sweden,SWE,0,0,10,0,10
2005,Belarus,BLR,Sweden,SWE,0,10,631,29,670
2005,Bolivia (Plurinational State of),BOL,Sweden,SWE,0,0,251,34,285
2005,Bosnia and Herzegovina,BIH,Sweden,SWE,0,82,832,10,924
2005,Bulgaria,BGR,Sweden,SWE,0,0,254,19,273
2005,Cambodia,KHM,Sweden,SWE,0,0,5,0,5
2005,Chad,TCD,Sweden,SWE,0,0,5,0,5
2005,China,CHN,Sweden,SWE,10,5,134,5,154
2005,Chile,CHL,Sweden,SWE,0,5,28,0,33
2005,Cameroon,CMR,Sweden,SWE,0,0,53,0,53
2005,Congo,COG,Sweden,SWE,0,5,10,0,15
2005,Dem. Rep. of the Congo,COD,Sweden,SWE,0,5,131,0,136
2005,Colombia,COL,Sweden,SWE,5,5,48,5,63
2005,Cuba,CUB,Sweden,SWE,0,5,23,0,28
2005,Czechia,CZE,Sweden,SWE,0,0,5,0,5
2005,Ecuador,ECU,Sweden,SWE,0,0,67,5,72
2005,Eritrea,ERI,Sweden,SWE,5,218,262,10,495
2005,Estonia,EST,Sweden,SWE,0,5,5,0,10
2005,Ethiopia,ETH,Sweden,SWE,0,14,220,5,239
2005,Gambia,GMB,Sweden,SWE,0,0,13,5,18
2005,Georgia,GEO,Sweden,SWE,0,19,265,12,296
2005,Ghana,GHA,Sweden,SWE,0,0,20,0,20
2005,Guatemala,GTM,Sweden,SWE,0,0,5,0,5
2005,Guinea,GIN,Sweden,SWE,0,5,47,0,52
2005,Honduras,HND,Sweden,SWE,0,0,10,0,10
2005,Croatia,HRV,Sweden,SWE,10,5,126,16,157
2005,Hungary,HUN,Sweden,SWE,0,0,5,0,5
2005,Cote d'Ivoire,CIV,Sweden,SWE,0,5,54,0,59
2005,India,IND,Sweden,SWE,0,10,102,5,117
2005,Iran (Islamic Rep. of),IRN,Sweden,SWE,15,44,1145,48,1252
2005,Iraq,IRQ,Sweden,SWE,0,440,4581,110,5131
2005,Israel,ISR,Sweden,SWE,0,0,17,5,22
2005,Jordan,JOR,Sweden,SWE,0,16,233,42,291
2005,Kazakhstan,KAZ,Sweden,SWE,0,13,196,5,214
2005,Kenya,KEN,Sweden,SWE,0,0,20,0,20
2005,Kyrgyzstan,KGZ,Sweden,SWE,0,43,238,10,291
2005,Kuwait,KWT,Sweden,SWE,0,0,5,0,5
2005,Lao People's Dem. Rep.,LAO,Sweden,SWE,0,0,5,0,5
2005,Liberia,LBR,Sweden,SWE,0,0,17,0,17
2005,Libya,LBY,Sweden,SWE,5,51,395,23,474
2005,Lebanon,LBN,Sweden,SWE,5,27,589,30,651
2005,Sri Lanka,LKA,Sweden,SWE,0,0,42,5,47
2005,Lithuania,LTU,Sweden,SWE,0,5,0,0,5
2005,Latvia,LVA,Sweden,SWE,0,0,10,0,10
2005,Mauritania,MRT,Sweden,SWE,0,0,10,0,10
2005,North Macedonia,MKD,Sweden,SWE,0,28,275,5,308
2005,Rep. of Moldova,MDA,Sweden,SWE,0,0,35,5,40
2005,Mongolia,MNG,Sweden,SWE,0,0,172,5,177
2005,Morocco,MAR,Sweden,SWE,0,5,30,0,35
2005,Myanmar,MMR,Sweden,SWE,0,0,10,0,10
2005,Nepal,NPL,Sweden,SWE,5,0,17,0,22
2005,Niger,NER,Sweden,SWE,0,0,11,0,11
2005,Nicaragua,NIC,Sweden,SWE,0,0,5,0,5
2005,Nigeria,NGA,Sweden,SWE,0,5,358,18,381
2005,Pakistan,PAK,Sweden,SWE,0,5,120,5,130
2005,Peru,PER,Sweden,SWE,0,10,48,5,63
2005,Philippines,PHL,Sweden,SWE,0,15,20,0,35
2005,Romania,ROU,Sweden,SWE,0,0,41,5,46
2005,Russian Federation,RUS,Sweden,SWE,0,62,1140,46,1248
2005,Rwanda,RWA,Sweden,SWE,0,5,17,0,22
2005,El Salvador,SLV,Sweden,SWE,0,5,15,0,20
2005,Saudi Arabia,SAU,Sweden,SWE,0,0,5,0,5
2005,Serbia and Kosovo: S/RES/1244 (1999),SRB,Sweden,SWE,178,314,3915,130,4537
2005,Sierra Leone,SLE,Sweden,SWE,0,0,74,0,74
2005,Somalia,SOM,Sweden,SWE,115,161,1213,73,1562
2005,Viet Nam,VNM,Sweden,SWE,0,5,82,0,87
2005,Sudan,SDN,Sweden,SWE,0,0,72,0,72
2005,Syrian Arab Rep.,SYR,Sweden,SWE,15,77,934,17,1043
2005,United Rep. of Tanzania,TZA,Sweden,SWE,0,0,14,0,14
2005,Thailand,THA,Sweden,SWE,0,0,32,0,32
2005,Tajikistan,TJK,Sweden,SWE,0,0,60,0,60
2005,Turkmenistan,TKM,Sweden,SWE,11,5,42,0,58
2005,Togo,TGO,Sweden,SWE,0,0,25,0,25
2005,Tunisia,TUN,Sweden,SWE,0,10,72,5,87
2005,Turkey,TUR,Sweden,SWE,0,36,677,26,739
2005,Uganda,UGA,Sweden,SWE,0,0,34,0,34
2005,Ukraine,UKR,Sweden,SWE,0,17,239,21,277
2005,United States of America,USA,Sweden,SWE,0,0,18,0,18
2005,Uzbekistan,UZB,Sweden,SWE,5,453,423,23,904
2005,Yemen,YEM,Sweden,SWE,0,0,58,0,58
2005,Zimbabwe,ZWE,Sweden,SWE,10,0,5,0,15
2005,Stateless,XXA,Sweden,SWE,34,57,1600,231,1922
2005,Unknown ,,Sweden,SWE,5,13,292,18,328
2005,Unknown ,,Switzerland,CHE,1432,0,4783,5107,11322
2006,Afghanistan,AFG,Belgium,BEL,21,0,24,5,50
2006,Albania,ALB,Belgium,BEL,0,0,17,37,54
2006,Algeria,DZA,Belgium,BEL,5,0,29,79,113
2006,Angola,AGO,Belgium,BEL,0,0,42,51,93
2006,Armenia,ARM,Belgium,BEL,0,0,40,41,81
2006,Azerbaijan,AZE,Belgium,BEL,0,0,21,13,34
2006,Burundi,BDI,Belgium,BEL,5,0,0,41,46
2006,Benin,BEN,Belgium,BEL,0,0,0,5,5
2006,Bangladesh,BGD,Belgium,BEL,0,0,13,5,18
2006,Bhutan,BTN,Belgium,BEL,0,0,5,5,10
2006,Belarus,BLR,Belgium,BEL,5,0,21,37,63
2006,Bosnia and Herzegovina,BIH,Belgium,BEL,5,0,5,34,44
2006,Bulgaria,BGR,Belgium,BEL,5,0,5,14,24
2006,Chad,TCD,Belgium,BEL,0,0,0,5,5
2006,China,CHN,Belgium,BEL,19,0,135,10,164
2006,Cameroon,CMR,Belgium,BEL,5,0,97,98,200
2006,Congo,COG,Belgium,BEL,0,0,0,5,5
2006,Dem. Rep. of the Congo,COD,Belgium,BEL,31,0,478,300,809
2006,Colombia,COL,Belgium,BEL,0,0,5,5,10
2006,Djibouti,DJI,Belgium,BEL,5,0,12,14,31
2006,Ethiopia,ETH,Belgium,BEL,0,0,5,0,5
2006,Palestinian,PSE,Belgium,BEL,0,0,5,23,28
2006,Georgia,GEO,Belgium,BEL,0,0,14,69,83
2006,Guinea,GIN,Belgium,BEL,0,0,5,63,68
2006,Cote d'Ivoire,CIV,Belgium,BEL,24,5,5,22,56
2006,Iran (Islamic Rep. of),IRN,Belgium,BEL,28,0,214,137,379
2006,Iraq,IRQ,Belgium,BEL,0,0,10,66,76
2006,Israel,ISR,Belgium,BEL,0,0,10,10,20
2006,Jordan,JOR,Belgium,BEL,0,0,0,5,5
2006,Kazakhstan,KAZ,Belgium,BEL,0,0,5,38,43
2006,Kenya,KEN,Belgium,BEL,0,0,0,5,5
2006,Kyrgyzstan,KGZ,Belgium,BEL,0,0,5,21,26
2006,Liberia,LBR,Belgium,BEL,0,0,12,5,17
2006,Libya,LBY,Belgium,BEL,0,0,0,5,5
2006,Lebanon,LBN,Belgium,BEL,0,0,13,64,77
2006,Sri Lanka,LKA,Belgium,BEL,0,0,12,10,22
2006,Mauritania,MRT,Belgium,BEL,5,0,57,39,101
2006,North Macedonia,MKD,Belgium,BEL,0,0,5,17,22
2006,Rep. of Moldova,MDA,Belgium,BEL,5,0,5,14,24
2006,Myanmar,MMR,Belgium,BEL,0,0,5,0,5
2006,Nepal,NPL,Belgium,BEL,0,0,186,36,222
2006,Niger,NER,Belgium,BEL,0,0,0,32,32
2006,Nigeria,NGA,Belgium,BEL,0,0,5,5,10
2006,Pakistan,PAK,Belgium,BEL,5,0,41,15,61
2006,Romania,ROU,Belgium,BEL,0,0,5,5,10
2006,Russian Federation,RUS,Belgium,BEL,186,0,159,241,586
2006,Rwanda,RWA,Belgium,BEL,11,0,17,57,85
2006,Serbia and Kosovo: S/RES/1244 (1999),SRB,Belgium,BEL,32,0,69,66,167
2006,Sierra Leone,SLE,Belgium,BEL,0,0,12,13,25
2006,Somalia,SOM,Belgium,BEL,5,0,10,5,20
2006,Sudan,SDN,Belgium,BEL,5,0,19,11,35
2006,Syrian Arab Rep.,SYR,Belgium,BEL,5,0,67,100,172
2006,Togo,TGO,Belgium,BEL,5,0,27,71,103
2006,Turkey,TUR,Belgium,BEL,36,0,67,95,198
2006,Ukraine,UKR,Belgium,BEL,0,0,5,29,34
2006,Uzbekistan,UZB,Belgium,BEL,0,0,10,33,43
2006,Venezuela (Bolivarian Republic of),VEN,Belgium,BEL,0,0,0,5,5
2006,Yemen,YEM,Belgium,BEL,0,0,5,0,5
2006,Central African Rep.,CAF,Benin,BEN,0,0,0,13,13
2006,Dem. Rep. of the Congo,COD,Benin,BEN,0,0,5,0,5
2006,Nigeria,NGA,Benin,BEN,0,0,17,0,17
2006,Togo,TGO,Benin,BEN,0,0,5,0,5
2006,Central African Rep.,CAF,Burkina Faso,BFA,0,0,0,12,12
2006,Chad,TCD,Burkina Faso,BFA,0,0,0,17,17
2006,Cameroon,CMR,Burkina Faso,BFA,0,0,0,15,15
2006,Congo,COG,Burkina Faso,BFA,0,0,0,58,58
2006,Dem. Rep. of the Congo,COD,Burkina Faso,BFA,0,0,0,10,10
2006,Ghana,GHA,Burkina Faso,BFA,0,0,0,5,5
2006,Nigeria,NGA,Burkina Faso,BFA,0,0,0,12,12
2006,Rwanda,RWA,Burkina Faso,BFA,0,0,0,13,13
2006,Togo,TGO,Burkina Faso,BFA,0,0,0,50,50
2006,Cuba,CUB,Colombia,COL,0,0,13,0,13
2006,Guinea-Bissau,GNB,Colombia,COL,0,0,5,0,5
2006,Egypt,EGY,Cyprus,CYP,5,0,0,0,5
2006,Bangladesh,BGD,Cyprus,CYP,0,0,1104,48,1152
2006,China,CHN,Cyprus,CYP,0,0,5,5,10
2006,Palestinian,PSE,Cyprus,CYP,0,0,28,0,28
2006,Georgia,GEO,Cyprus,CYP,0,0,78,31,109
2006,India,IND,Cyprus,CYP,0,0,18,10,28
2006,Iran (Islamic Rep. of),IRN,Cyprus,CYP,5,16,220,22,263
2006,Lebanon,LBN,Cyprus,CYP,0,0,5,5,10
2006,Sri Lanka,LKA,Cyprus,CYP,0,0,21,22,43
2006,Rep. of Moldova,MDA,Cyprus,CYP,0,0,5,0,5
2006,Nigeria,NGA,Cyprus,CYP,0,0,5,0,5
2006,Pakistan,PAK,Cyprus,CYP,0,0,157,28,185
2006,Russian Federation,RUS,Cyprus,CYP,0,0,53,11,64
2006,Serbia and Kosovo: S/RES/1244 (1999),SRB,Cyprus,CYP,0,0,5,0,5
2006,Syrian Arab Rep.,SYR,Cyprus,CYP,0,0,52,10,62
2006,Turkey,TUR,Cyprus,CYP,0,0,50,17,67
2006,Ukraine,UKR,Cyprus,CYP,0,0,31,15,46
2006,Afghanistan,AFG,Czechia,CZE,5,0,5,5,15
2006,Algeria,DZA,Czechia,CZE,0,0,21,33,54
2006,Angola,AGO,Czechia,CZE,5,0,0,5,10
2006,Egypt,EGY,Czechia,CZE,0,0,96,54,150
2006,Armenia,ARM,Czechia,CZE,10,0,52,0,62
2006,Belarus,BLR,Czechia,CZE,10,0,60,35,105
2006,Bulgaria,BGR,Czechia,CZE,0,0,15,10,25
2006,China,CHN,Czechia,CZE,5,0,67,69,141
2006,Georgia,GEO,Czechia,CZE,5,0,18,21,44
2006,Ghana,GHA,Czechia,CZE,0,0,5,0,5
2006,Cote d'Ivoire,CIV,Czechia,CZE,5,0,5,0,10
2006,India,IND,Czechia,CZE,0,0,10,42,52
2006,Iraq,IRQ,Czechia,CZE,0,0,5,0,5
2006,Kazakhstan,KAZ,Czechia,CZE,5,0,14,5,24
2006,Kyrgyzstan,KGZ,Czechia,CZE,5,0,30,10,45
2006,Sri Lanka,LKA,Czechia,CZE,0,0,5,5,10
2006,North Macedonia,MKD,Czechia,CZE,0,0,5,10,15
2006,Rep. of Moldova,MDA,Czechia,CZE,5,0,49,12,66
2006,Mongolia,MNG,Czechia,CZE,0,0,57,51,108
2006,Nigeria,NGA,Czechia,CZE,0,0,24,19,43
2006,Pakistan,PAK,Czechia,CZE,0,0,5,13,18
2006,Romania,ROU,Czechia,CZE,0,0,15,0,15
2006,Russian Federation,RUS,Czechia,CZE,12,0,100,72,184
2006,Senegal,SEN,Czechia,CZE,0,0,0,5,5
2006,Viet Nam,VNM,Czechia,CZE,5,0,113,67,185
2006,Slovakia,SVK,Czechia,CZE,0,0,110,109,219
2006,Turkey,TUR,Czechia,CZE,0,0,5,13,18
2006,Ukraine,UKR,Czechia,CZE,13,0,559,199,771
2006,Uzbekistan,UZB,Czechia,CZE,0,0,10,0,10
2006,Stateless,XXA,Czechia,CZE,5,0,5,18,28
2006,Unknown ,,Czechia,CZE,10,0,55,10,75
2006,Afghanistan,AFG,Denmark,DNK,28,11,55,0,94
2006,Algeria,DZA,Denmark,DNK,0,0,5,0,5
2006,Azerbaijan,AZE,Denmark,DNK,0,0,5,0,5
2006,Bangladesh,BGD,Denmark,DNK,0,0,5,0,5
2006,Burkina Faso,BFA,Denmark,DNK,0,0,5,0,5
2006,Bosnia and Herzegovina,BIH,Denmark,DNK,0,0,10,0,10
2006,China,CHN,Denmark,DNK,0,0,14,0,14
2006,Cameroon,CMR,Denmark,DNK,0,0,5,0,5
2006,Dem. Rep. of the Congo,COD,Denmark,DNK,0,0,5,0,5
2006,Ethiopia,ETH,Denmark,DNK,0,0,5,0,5
2006,Palestinian,PSE,Denmark,DNK,35,0,25,0,60
2006,Georgia,GEO,Denmark,DNK,0,0,5,0,5
2006,India,IND,Denmark,DNK,0,0,5,0,5
2006,Iran (Islamic Rep. of),IRN,Denmark,DNK,10,10,20,0,40
2006,Iraq,IRQ,Denmark,DNK,5,5,85,0,95
2006,Libya,LBY,Denmark,DNK,0,5,5,0,10
2006,Sri Lanka,LKA,Denmark,DNK,0,0,12,0,12
2006,Nepal,NPL,Denmark,DNK,0,0,5,0,5
2006,Nigeria,NGA,Denmark,DNK,0,0,12,0,12
2006,Russian Federation,RUS,Denmark,DNK,0,0,10,0,10
2006,Serbia and Kosovo: S/RES/1244 (1999),SRB,Denmark,DNK,0,0,102,0,102
2006,Somalia,SOM,Denmark,DNK,0,5,37,0,42
2006,Sudan,SDN,Denmark,DNK,0,0,5,0,5
2006,Syrian Arab Rep.,SYR,Denmark,DNK,10,0,0,0,10
2006,Turkey,TUR,Denmark,DNK,0,0,5,0,5
2006,Algeria,DZA,France,FRA,73,25,1076,0,1174
2006,Angola,AGO,France,FRA,85,5,532,0,622
2006,Armenia,ARM,France,FRA,181,21,633,0,835
2006,Bangladesh,BGD,France,FRA,128,5,559,0,692
2006,Bosnia and Herzegovina,BIH,France,FRA,242,5,818,0,1065
2006,China,CHN,France,FRA,16,0,1889,0,1905
2006,Congo,COG,France,FRA,77,5,650,0,732
2006,Dem. Rep. of the Congo,COD,France,FRA,256,15,1805,0,2076
2006,Georgia,GEO,France,FRA,130,20,720,0,870
2006,Guinea,GIN,France,FRA,150,11,578,0,739
2006,Haiti,HTI,France,FRA,159,39,2464,0,2662
2006,Cote d'Ivoire,CIV,France,FRA,101,5,532,0,638
2006,India,IND,France,FRA,0,0,89,0,89
2006,Sri Lanka,LKA,France,FRA,343,5,1160,0,1508
2006,Mauritania,MRT,France,FRA,161,0,1009,0,1170
2006,Rep. of Moldova,MDA,France,FRA,23,12,613,0,648
2006,Nigeria,NGA,France,FRA,53,115,543,0,711
2006,Pakistan,PAK,France,FRA,30,10,457,0,497
2006,Russian Federation,RUS,France,FRA,336,32,756,0,1124
2006,Serbia and Kosovo: S/RES/1244 (1999),SRB,France,FRA,358,11,993,0,1362
2006,Turkey,TUR,France,FRA,293,5,2558,0,2856
2006,Unknown ,,France,FRA,886,26,4142,0,5054
2006,Afghanistan,AFG,Ireland,IRL,15,0,64,5,84
2006,Albania,ALB,Ireland,IRL,11,0,21,0,32
2006,Algeria,DZA,Ireland,IRL,0,0,25,0,25
2006,Angola,AGO,Ireland,IRL,0,0,28,5,33
2006,Egypt,EGY,Ireland,IRL,5,0,0,0,5
2006,Azerbaijan,AZE,Ireland,IRL,0,0,5,0,5
2006,Burundi,BDI,Ireland,IRL,0,0,13,0,13
2006,Bangladesh,BGD,Ireland,IRL,5,0,11,0,16
2006,Belarus,BLR,Ireland,IRL,0,0,5,0,5
2006,China,CHN,Ireland,IRL,0,0,11,0,11
2006,Cameroon,CMR,Ireland,IRL,5,0,45,0,50
2006,Congo,COG,Ireland,IRL,0,0,10,0,10
2006,Dem. Rep. of the Congo,COD,Ireland,IRL,0,0,123,0,123
2006,Eritrea,ERI,Ireland,IRL,0,0,14,0,14
2006,Ethiopia,ETH,Ireland,IRL,5,0,10,0,15
2006,Palestinian,PSE,Ireland,IRL,5,0,17,0,22
2006,Georgia,GEO,Ireland,IRL,24,0,62,0,86
2006,Ghana,GHA,Ireland,IRL,0,0,37,0,37
2006,Guinea,GIN,Ireland,IRL,0,0,10,0,10
2006,Guyana,GUY,Ireland,IRL,0,0,0,5,5
2006,Croatia,HRV,Ireland,IRL,5,0,20,5,30
2006,Cote d'Ivoire,CIV,Ireland,IRL,0,0,13,0,13
2006,India,IND,Ireland,IRL,5,0,5,0,10
2006,Iran (Islamic Rep. of),IRN,Ireland,IRL,11,0,53,5,69
2006,Iraq,IRQ,Ireland,IRL,16,0,15,0,31
2006,Israel,ISR,Ireland,IRL,0,0,5,0,5
2006,Kazakhstan,KAZ,Ireland,IRL,5,0,0,0,5
2006,Kenya,KEN,Ireland,IRL,5,0,36,0,41
2006,Kyrgyzstan,KGZ,Ireland,IRL,5,0,0,0,5
2006,Kuwait,KWT,Ireland,IRL,5,0,10,5,20
2006,Liberia,LBR,Ireland,IRL,0,0,17,0,17
2006,Lebanon,LBN,Ireland,IRL,0,0,11,0,11
2006,North Macedonia,MKD,Ireland,IRL,0,0,5,0,5
2006,Rep. of Moldova,MDA,Ireland,IRL,5,0,23,0,28
2006,Malawi,MWI,Ireland,IRL,0,0,5,0,5
2006,Morocco,MAR,Ireland,IRL,0,0,5,0,5
2006,Myanmar,MMR,Ireland,IRL,0,0,5,0,5
2006,Nepal,NPL,Ireland,IRL,0,0,5,0,5
2006,Nigeria,NGA,Ireland,IRL,22,0,436,25,483
2006,Pakistan,PAK,Ireland,IRL,11,0,27,5,43
2006,Romania,ROU,Ireland,IRL,5,0,72,5,82
2006,South Africa,ZAF,Ireland,IRL,0,0,16,0,16
2006,Russian Federation,RUS,Ireland,IRL,0,0,15,5,20
2006,Rwanda,RWA,Ireland,IRL,5,0,5,0,10
2006,Serbia and Kosovo: S/RES/1244 (1999),SRB,Ireland,IRL,10,0,5,0,15
2006,Sierra Leone,SLE,Ireland,IRL,0,0,10,0,10
2006,Somalia,SOM,Ireland,IRL,39,0,128,5,172
2006,Viet Nam,VNM,Ireland,IRL,0,0,5,0,5
2006,Sudan,SDN,Ireland,IRL,5,0,40,5,50
2006,Syrian Arab Rep.,SYR,Ireland,IRL,0,0,10,0,10
2006,Togo,TGO,Ireland,IRL,0,0,21,0,21
2006,Uganda,UGA,Ireland,IRL,0,0,10,0,10
2006,Ukraine,UKR,Ireland,IRL,0,0,17,5,22
2006,Uzbekistan,UZB,Ireland,IRL,0,0,5,0,5
2006,Zimbabwe,ZWE,Ireland,IRL,5,0,21,0,26
2006,Stateless,XXA,Ireland,IRL,0,0,5,0,5
2006,Unknown ,,Japan,JPN,12,26,101,33,172
2006,Unknown ,,Luxembourg,LUX,0,0,305,5,310
2006,Bhutan,BTN,Nepal,NPL,0,5,0,0,5
2006,Afghanistan,AFG,Netherlands,NLD,0,129,159,145,433
2006,Albania,ALB,Netherlands,NLD,0,0,0,5,5
2006,Algeria,DZA,Netherlands,NLD,0,0,5,5,10
2006,Angola,AGO,Netherlands,NLD,0,62,49,67,178
2006,Armenia,ARM,Netherlands,NLD,0,75,35,50,160
2006,Azerbaijan,AZE,Netherlands,NLD,0,229,60,213,502
2006,Burundi,BDI,Netherlands,NLD,0,25,22,21,68
2006,Bangladesh,BGD,Netherlands,NLD,0,0,0,5,5
2006,Belarus,BLR,Netherlands,NLD,0,5,5,5,15
2006,Bosnia and Herzegovina,BIH,Netherlands,NLD,0,30,24,13,67
2006,Bulgaria,BGR,Netherlands,NLD,0,0,5,0,5
2006,China,CHN,Netherlands,NLD,0,46,24,36,106
2006,Cameroon,CMR,Netherlands,NLD,0,5,5,5,15
2006,Congo,COG,Netherlands,NLD,0,20,16,20,56
2006,Dem. Rep. of the Congo,COD,Netherlands,NLD,0,25,26,30,81
2006,Colombia,COL,Netherlands,NLD,0,10,10,10,30
2006,Czechia,CZE,Netherlands,NLD,0,0,5,0,5
2006,Eritrea,ERI,Netherlands,NLD,0,67,12,31,110
2006,Ethiopia,ETH,Netherlands,NLD,0,17,10,24,51
2006,Georgia,GEO,Netherlands,NLD,0,11,12,12,35
2006,Guinea,GIN,Netherlands,NLD,0,29,27,21,77
2006,Croatia,HRV,Netherlands,NLD,0,11,5,20,36
2006,Cote d'Ivoire,CIV,Netherlands,NLD,0,66,12,5,83
2006,Iran (Islamic Rep. of),IRN,Netherlands,NLD,0,116,33,79,228
2006,Iraq,IRQ,Netherlands,NLD,0,183,131,236,550
2006,Kazakhstan,KAZ,Netherlands,NLD,0,20,12,21,53
2006,Kenya,KEN,Netherlands,NLD,0,0,0,5,5
2006,Kyrgyzstan,KGZ,Netherlands,NLD,0,10,0,0,10
2006,Liberia,LBR,Netherlands,NLD,0,31,27,23,81
2006,Libya,LBY,Netherlands,NLD,0,5,0,10,15
2006,Lebanon,LBN,Netherlands,NLD,0,5,0,0,5
2006,Sri Lanka,LKA,Netherlands,NLD,0,18,5,13,36
2006,Mauritania,MRT,Netherlands,NLD,0,0,0,5,5
2006,North Macedonia,MKD,Netherlands,NLD,0,0,5,5,10
2006,Rep. of Moldova,MDA,Netherlands,NLD,0,0,5,0,5
2006,Mongolia,MNG,Netherlands,NLD,0,5,5,12,22
2006,Morocco,MAR,Netherlands,NLD,0,5,0,0,5
2006,Myanmar,MMR,Netherlands,NLD,0,0,5,0,5
2006,Nepal,NPL,Netherlands,NLD,0,12,20,5,37
2006,Niger,NER,Netherlands,NLD,0,0,5,5,10
2006,Nigeria,NGA,Netherlands,NLD,0,22,12,17,51
2006,Pakistan,PAK,Netherlands,NLD,0,10,5,5,20
2006,Russian Federation,RUS,Netherlands,NLD,0,95,35,66,196
2006,Rwanda,RWA,Netherlands,NLD,0,20,5,22,47
2006,Serbia and Kosovo: S/RES/1244 (1999),SRB,Netherlands,NLD,0,64,35,76,175
2006,Sierra Leone,SLE,Netherlands,NLD,0,39,40,55,134
2006,Somalia,SOM,Netherlands,NLD,0,125,26,76,227
2006,Viet Nam,VNM,Netherlands,NLD,0,0,5,0,5
2006,Sudan,SDN,Netherlands,NLD,0,48,32,75,155
2006,Slovakia,SVK,Netherlands,NLD,0,5,5,0,10
2006,Syrian Arab Rep.,SYR,Netherlands,NLD,0,64,22,42,128
2006,Tajikistan,TJK,Netherlands,NLD,0,12,5,5,22
2006,Togo,TGO,Netherlands,NLD,0,12,5,5,22
2006,Turkey,TUR,Netherlands,NLD,0,42,13,49,104
2006,Uganda,UGA,Netherlands,NLD,0,5,5,5,15
2006,Ukraine,UKR,Netherlands,NLD,0,5,10,10,25
2006,Uzbekistan,UZB,Netherlands,NLD,0,5,5,10,20
2006,Yemen,YEM,Netherlands,NLD,0,0,5,0,5
2006,Stateless,XXA,Netherlands,NLD,0,69,27,62,158
2006,Unknown ,,Netherlands,NLD,0,106,93,111,310
2006,Chad,TCD,Niger,NER,0,0,0,5,5
2006,Congo,COG,Niger,NER,0,0,0,5,5
2006,Afghanistan,AFG,Norway,NOR,10,33,655,5,703
2006,Albania,ALB,Norway,NOR,0,0,50,0,50
2006,Algeria,DZA,Norway,NOR,0,0,40,0,40
2006,Angola,AGO,Norway,NOR,0,0,52,0,52
2006,Armenia,ARM,Norway,NOR,0,10,15,0,25
2006,Azerbaijan,AZE,Norway,NOR,0,5,58,0,63
2006,Burundi,BDI,Norway,NOR,0,5,68,0,73
2006,Benin,BEN,Norway,NOR,0,0,5,0,5
2006,Bangladesh,BGD,Norway,NOR,0,0,16,0,16
2006,Bhutan,BTN,Norway,NOR,0,0,10,0,10
2006,Belarus,BLR,Norway,NOR,0,0,13,0,13
2006,Bosnia and Herzegovina,BIH,Norway,NOR,0,0,62,0,62
2006,Bulgaria,BGR,Norway,NOR,0,0,13,0,13
2006,China,CHN,Norway,NOR,0,0,27,5,32
2006,Cameroon,CMR,Norway,NOR,5,10,87,0,102
2006,Congo,COG,Norway,NOR,0,5,14,0,19
2006,Dem. Rep. of the Congo,COD,Norway,NOR,0,5,77,0,82
2006,Cuba,CUB,Norway,NOR,0,0,5,0,5
2006,Eritrea,ERI,Norway,NOR,0,54,37,0,91
2006,Ethiopia,ETH,Norway,NOR,5,25,125,0,155
2006,Gambia,GMB,Norway,NOR,0,0,5,0,5
2006,Georgia,GEO,Norway,NOR,0,10,21,0,31
2006,Guinea,GIN,Norway,NOR,5,0,50,0,55
2006,Croatia,HRV,Norway,NOR,0,0,13,0,13
2006,Hungary,HUN,Norway,NOR,0,0,5,0,5
2006,Cote d'Ivoire,CIV,Norway,NOR,0,5,11,0,16
2006,India,IND,Norway,NOR,0,0,23,0,23
2006,Iran (Islamic Rep. of),IRN,Norway,NOR,0,11,551,10,572
2006,Iraq,IRQ,Norway,NOR,0,5,774,5,784
2006,Israel,ISR,Norway,NOR,0,0,16,0,16
2006,Jordan,JOR,Norway,NOR,0,0,5,0,5
2006,Kazakhstan,KAZ,Norway,NOR,0,5,13,0,18
2006,Kyrgyzstan,KGZ,Norway,NOR,0,0,14,0,14
2006,Liberia,LBR,Norway,NOR,0,0,46,0,46
2006,Libya,LBY,Norway,NOR,0,0,40,0,40
2006,Lebanon,LBN,Norway,NOR,0,0,28,0,28
2006,Sri Lanka,LKA,Norway,NOR,0,5,73,0,78
2006,Mauritania,MRT,Norway,NOR,0,0,5,0,5
2006,North Macedonia,MKD,Norway,NOR,0,5,16,0,21
2006,Rep. of Moldova,MDA,Norway,NOR,0,0,10,0,10
2006,Mongolia,MNG,Norway,NOR,0,0,5,0,5
2006,Morocco,MAR,Norway,NOR,0,5,12,0,17
2006,Mozambique,MOZ,Norway,NOR,0,0,5,0,5
2006,Nepal,NPL,Norway,NOR,0,0,108,0,108
2006,Niger,NER,Norway,NOR,0,0,14,0,14
2006,Nigeria,NGA,Norway,NOR,0,10,112,0,122
2006,Pakistan,PAK,Norway,NOR,0,12,92,0,104
2006,Romania,ROU,Norway,NOR,0,0,5,0,5
2006,Russian Federation,RUS,Norway,NOR,0,27,236,5,268
2006,Rwanda,RWA,Norway,NOR,0,0,52,0,52
2006,Serbia and Kosovo: S/RES/1244 (1999),SRB,Norway,NOR,20,65,473,0,558
2006,Sierra Leone,SLE,Norway,NOR,0,0,28,0,28
2006,Somalia,SOM,Norway,NOR,5,113,284,10,412
2006,Viet Nam,VNM,Norway,NOR,0,0,5,0,5
2006,Sudan,SDN,Norway,NOR,5,5,64,0,74
2006,Syrian Arab Rep.,SYR,Norway,NOR,0,5,67,0,72
2006,United Rep. of Tanzania,TZA,Norway,NOR,0,0,5,0,5
2006,Togo,TGO,Norway,NOR,0,0,19,0,19
2006,Tunisia,TUN,Norway,NOR,0,0,5,0,5
2006,Turkey,TUR,Norway,NOR,0,0,60,0,60
2006,Uganda,UGA,Norway,NOR,0,0,10,0,10
2006,Ukraine,UKR,Norway,NOR,0,0,10,0,10
2006,Uzbekistan,UZB,Norway,NOR,0,11,25,0,36
2006,Western Sahara,ESH,Norway,NOR,0,0,10,0,10
2006,Yemen,YEM,Norway,NOR,0,0,5,0,5
2006,Unknown ,,Norway,NOR,0,5,175,0,180
2006,Afghanistan,AFG,New Zealand,NZL,0,0,5,0,5
2006,Bangladesh,BGD,New Zealand,NZL,0,0,28,5,33
2006,Bulgaria,BGR,New Zealand,NZL,5,0,0,0,5
2006,China,CHN,New Zealand,NZL,0,0,5,0,5
2006,Chile,CHL,New Zealand,NZL,0,0,5,0,5
2006,Congo,COG,New Zealand,NZL,0,0,0,12,12
2006,Czechia,CZE,New Zealand,NZL,10,0,10,0,20
2006,Ethiopia,ETH,New Zealand,NZL,0,0,5,13,18
2006,Hungary,HUN,New Zealand,NZL,0,0,5,0,5
2006,India,IND,New Zealand,NZL,0,0,21,0,21
2006,Iran (Islamic Rep. of),IRN,New Zealand,NZL,20,0,50,0,70
2006,Iraq,IRQ,New Zealand,NZL,10,0,5,0,15
2006,Jordan,JOR,New Zealand,NZL,0,0,5,0,5
2006,Sri Lanka,LKA,New Zealand,NZL,0,0,22,0,22
2006,Malaysia,MYS,New Zealand,NZL,0,0,5,0,5
2006,Myanmar,MMR,New Zealand,NZL,0,0,0,5,5
2006,Nepal,NPL,New Zealand,NZL,5,0,12,0,17
2006,Nigeria,NGA,New Zealand,NZL,0,0,5,0,5
2006,Pakistan,PAK,New Zealand,NZL,0,0,5,0,5
2006,El Salvador,SLV,New Zealand,NZL,0,0,5,0,5
2006,Somalia,SOM,New Zealand,NZL,0,0,5,0,5
2006,Viet Nam,VNM,New Zealand,NZL,0,0,5,0,5
2006,Syrian Arab Rep.,SYR,New Zealand,NZL,0,0,10,0,10
2006,Zimbabwe,ZWE,New Zealand,NZL,5,0,5,0,10
2006,Armenia,ARM,Poland,POL,0,0,5,0,5
2006,Belarus,BLR,Poland,POL,5,0,5,0,10
2006,Guinea,GIN,Poland,POL,0,0,5,0,5
2006,Kazakhstan,KAZ,Poland,POL,0,0,10,0,10
2006,Kyrgyzstan,KGZ,Poland,POL,0,0,5,0,5
2006,Nepal,NPL,Poland,POL,0,0,5,0,5
2006,Nigeria,NGA,Poland,POL,0,0,5,0,5
2006,Russian Federation,RUS,Poland,POL,54,61,224,46,385
2006,Syrian Arab Rep.,SYR,Poland,POL,5,0,0,0,5
2006,Ukraine,UKR,Poland,POL,0,0,5,5,10
2006,Unknown ,,Switzerland,CHE,1421,0,3562,4340,9323
2006,Afghanistan,AFG,Ukraine,UKR,0,0,18,14,32
2006,Angola,AGO,Ukraine,UKR,0,0,0,5,5
2006,Bangladesh,BGD,Ukraine,UKR,0,0,58,0,58
2006,Belarus,BLR,Ukraine,UKR,0,0,5,0,5
2006,Chad,TCD,Ukraine,UKR,0,0,0,5,5
2006,China,CHN,Ukraine,UKR,0,0,5,0,5
2006,Ethiopia,ETH,Ukraine,UKR,0,0,10,5,15
2006,Palestinian,PSE,Ukraine,UKR,0,0,70,0,70
2006,Georgia,GEO,Ukraine,UKR,0,0,5,0,5
2006,Ghana,GHA,Ukraine,UKR,0,0,0,5,5
2006,India,IND,Ukraine,UKR,0,0,185,0,185
2006,Iran (Islamic Rep. of),IRN,Ukraine,UKR,0,0,0,14,14
2006,Iraq,IRQ,Ukraine,UKR,0,0,41,27,68
2006,Sri Lanka,LKA,Ukraine,UKR,0,0,0,5,5
2006,Nigeria,NGA,Ukraine,UKR,0,0,10,5,15
2006,Pakistan,PAK,Ukraine,UKR,0,0,71,0,71
2006,Russian Federation,RUS,Ukraine,UKR,5,0,14,17,36
2006,Somalia,SOM,Ukraine,UKR,0,0,0,10,10
2006,Sudan,SDN,Ukraine,UKR,0,0,5,0,5
2006,Uzbekistan,UZB,Ukraine,UKR,0,0,18,24,42
2007,Central African Rep.,CAF,Benin,BEN,0,0,5,0,5
2007,Congo,COG,Benin,BEN,0,0,10,5,15
2007,Dem. Rep. of the Congo,COD,Benin,BEN,0,0,49,64,113
2007,Cote d'Ivoire,CIV,Benin,BEN,0,0,0,13,13
2007,Nigeria,NGA,Benin,BEN,0,0,21,15,36
2007,Togo,TGO,Benin,BEN,0,0,32,13,45
2007,Chad,TCD,Burkina Faso,BFA,0,0,5,0,5
2007,Congo,COG,Burkina Faso,BFA,0,0,5,0,5
2007,Togo,TGO,Burkina Faso,BFA,0,0,5,0,5
2007,Afghanistan,AFG,Cyprus,CYP,0,0,13,5,18
2007,Egypt,EGY,Cyprus,CYP,0,0,10,5,15
2007,Armenia,ARM,Cyprus,CYP,0,5,5,5,15
2007,Bangladesh,BGD,Cyprus,CYP,0,0,329,46,375
2007,Belarus,BLR,Cyprus,CYP,0,0,5,5,10
2007,China,CHN,Cyprus,CYP,0,0,66,10,76
2007,Cameroon,CMR,Cyprus,CYP,0,0,5,0,5
2007,Palestinian,PSE,Cyprus,CYP,0,0,32,5,37
2007,Georgia,GEO,Cyprus,CYP,0,11,302,74,387
2007,India,IND,Cyprus,CYP,0,0,89,25,114
2007,Iran (Islamic Rep. of),IRN,Cyprus,CYP,0,0,140,26,166
2007,Iraq,IRQ,Cyprus,CYP,0,0,5,5,10
2007,Kazakhstan,KAZ,Cyprus,CYP,0,0,5,0,5
2007,Lebanon,LBN,Cyprus,CYP,0,0,5,0,5
2007,Sri Lanka,LKA,Cyprus,CYP,0,0,154,36,190
2007,Rep. of Moldova,MDA,Cyprus,CYP,0,5,20,5,30
2007,Nigeria,NGA,Cyprus,CYP,0,0,5,0,5
2007,Pakistan,PAK,Cyprus,CYP,0,0,259,46,305
2007,Philippines,PHL,Cyprus,CYP,0,0,12,0,12
2007,Russian Federation,RUS,Cyprus,CYP,0,5,82,12,99
2007,Syrian Arab Rep.,SYR,Cyprus,CYP,0,14,168,42,224
2007,Turkey,TUR,Cyprus,CYP,0,0,77,10,87
2007,Ukraine,UKR,Cyprus,CYP,0,0,91,33,124
2007,Uzbekistan,UZB,Cyprus,CYP,0,0,5,0,5
2007,Algeria,DZA,Czechia,CZE,5,0,11,17,33
2007,Egypt,EGY,Czechia,CZE,0,0,0,112,112
2007,Armenia,ARM,Czechia,CZE,5,0,23,5,33
2007,Bangladesh,BGD,Czechia,CZE,0,0,5,0,5
2007,Belarus,BLR,Czechia,CZE,5,0,23,5,33
2007,Bulgaria,BGR,Czechia,CZE,0,0,5,5,10
2007,China,CHN,Czechia,CZE,0,0,37,32,69
2007,Cameroon,CMR,Czechia,CZE,0,0,5,10,15
2007,Congo,COG,Czechia,CZE,0,0,5,0,5
2007,Dem. Rep. of the Congo,COD,Czechia,CZE,5,0,10,0,15
2007,Georgia,GEO,Czechia,CZE,0,0,28,10,38
2007,Ghana,GHA,Czechia,CZE,0,0,0,5,5
2007,Guinea,GIN,Czechia,CZE,0,0,5,0,5
2007,Cote d'Ivoire,CIV,Czechia,CZE,0,0,5,5,10
2007,India,IND,Czechia,CZE,0,0,10,10,20
2007,Kazakhstan,KAZ,Czechia,CZE,11,0,28,0,39
2007,Kyrgyzstan,KGZ,Czechia,CZE,10,0,0,35,45
2007,Sri Lanka,LKA,Czechia,CZE,0,0,0,5,5
2007,North Macedonia,MKD,Czechia,CZE,0,0,5,0,5
2007,Rep. of Moldova,MDA,Czechia,CZE,0,0,20,5,25
2007,Mongolia,MNG,Czechia,CZE,0,0,47,21,68
2007,Morocco,MAR,Czechia,CZE,0,0,5,0,5
2007,Nigeria,NGA,Czechia,CZE,0,0,26,46,72
2007,Pakistan,PAK,Czechia,CZE,0,0,5,10,15
2007,Russian Federation,RUS,Czechia,CZE,10,0,63,23,96
2007,Serbia and Kosovo: S/RES/1244 (1999),SRB,Czechia,CZE,0,0,5,5,10
2007,Senegal,SEN,Czechia,CZE,0,0,5,0,5
2007,Sierra Leone,SLE,Czechia,CZE,0,0,5,0,5
2007,Viet Nam,VNM,Czechia,CZE,0,0,78,28,106
2007,Slovakia,SVK,Czechia,CZE,0,0,5,0,5
2007,Syrian Arab Rep.,SYR,Czechia,CZE,5,0,5,0,10
2007,Thailand,THA,Czechia,CZE,0,0,5,0,5
2007,Turkey,TUR,Czechia,CZE,0,0,5,19,24
2007,Ukraine,UKR,Czechia,CZE,5,0,336,117,458
2007,Uzbekistan,UZB,Czechia,CZE,0,0,5,0,5
2007,Stateless,XXA,Czechia,CZE,5,0,12,26,43
2007,Unknown ,,Czechia,CZE,10,0,18,0,28
2007,Afghanistan,AFG,Denmark,DNK,5,5,20,0,30
2007,Armenia,ARM,Denmark,DNK,0,0,11,0,11
2007,Azerbaijan,AZE,Denmark,DNK,5,0,0,0,5
2007,China,CHN,Denmark,DNK,0,0,5,0,5
2007,Ethiopia,ETH,Denmark,DNK,0,0,5,0,5
2007,Palestinian,PSE,Denmark,DNK,0,0,12,0,12
2007,India,IND,Denmark,DNK,0,0,5,0,5
2007,Iran (Islamic Rep. of),IRN,Denmark,DNK,5,5,17,0,27
2007,Iraq,IRQ,Denmark,DNK,0,17,45,0,62
2007,Lebanon,LBN,Denmark,DNK,0,0,10,0,10
2007,Sri Lanka,LKA,Denmark,DNK,0,0,19,0,19
2007,Nigeria,NGA,Denmark,DNK,0,0,10,0,10
2007,Pakistan,PAK,Denmark,DNK,0,0,5,0,5
2007,Russian Federation,RUS,Denmark,DNK,5,0,5,0,10
2007,Serbia and Kosovo: S/RES/1244 (1999),SRB,Denmark,DNK,0,0,14,0,14
2007,Somalia,SOM,Denmark,DNK,0,0,10,0,10
2007,Syrian Arab Rep.,SYR,Denmark,DNK,0,0,5,0,5
2007,Turkey,TUR,Denmark,DNK,0,0,5,0,5
2007,Albania,ALB,France,FRA,27,30,144,18,219
2007,Algeria,DZA,France,FRA,83,48,664,346,1141
2007,Angola,AGO,France,FRA,115,5,400,55,575
2007,Armenia,ARM,France,FRA,192,42,683,131,1048
2007,Azerbaijan,AZE,France,FRA,171,0,191,38,400
2007,Bangladesh,BGD,France,FRA,197,5,545,154,901
2007,Bosnia and Herzegovina,BIH,France,FRA,176,5,352,62,595
2007,China,CHN,France,FRA,12,0,355,1034,1401
2007,Cameroon,CMR,France,FRA,38,11,168,36,253
2007,Congo,COG,France,FRA,100,5,505,155,765
2007,Dem. Rep. of the Congo,COD,France,FRA,285,28,1364,304,1981
2007,Georgia,GEO,France,FRA,92,22,321,52,487
2007,Guinea,GIN,France,FRA,210,24,470,104,808
2007,Haiti,HTI,France,FRA,175,68,1552,591,2386
2007,Cote d'Ivoire,CIV,France,FRA,82,5,460,144,691
2007,Sri Lanka,LKA,France,FRA,561,32,975,304,1872
2007,Madagascar,MDG,France,FRA,19,5,114,32,170
2007,Mauritania,MRT,France,FRA,102,0,569,158,829
2007,Rep. of Moldova,MDA,France,FRA,27,5,212,117,361
2007,Nigeria,NGA,France,FRA,35,11,360,96,502
2007,Pakistan,PAK,France,FRA,27,5,233,97,362
2007,Russian Federation,RUS,France,FRA,457,49,644,134,1284
2007,Serbia and Kosovo: S/RES/1244 (1999),SRB,France,FRA,539,47,1013,492,2091
2007,Togo,TGO,France,FRA,44,0,120,24,188
2007,Turkey,TUR,France,FRA,468,12,1798,662,2940
2007,Unknown ,,France,FRA,619,98,1738,537,2992
2007,Afghanistan,AFG,Greece,GRC,5,0,0,0,5
2007,Bangladesh,BGD,Greece,GRC,0,5,0,0,5
2007,Cameroon,CMR,Greece,GRC,5,0,0,0,5
2007,Iran (Islamic Rep. of),IRN,Greece,GRC,11,5,0,0,16
2007,Iraq,IRQ,Greece,GRC,107,5,0,0,112
2007,Nigeria,NGA,Greece,GRC,5,0,0,0,5
2007,Unknown ,,Greece,GRC,0,0,5544,749,6293
2007,Albania,ALB,Croatia,HRV,0,0,5,0,5
2007,Bosnia and Herzegovina,BIH,Croatia,HRV,0,0,5,0,5
2007,North Macedonia,MKD,Croatia,HRV,0,0,5,0,5
2007,Serbia and Kosovo: S/RES/1244 (1999),SRB,Croatia,HRV,0,0,10,5,15
2007,Afghanistan,AFG,Ireland,IRL,11,0,43,5,59
2007,Albania,ALB,Ireland,IRL,0,0,17,0,17
2007,Algeria,DZA,Ireland,IRL,0,0,21,0,21
2007,Angola,AGO,Ireland,IRL,5,0,14,5,24
2007,Burundi,BDI,Ireland,IRL,0,0,10,0,10
2007,Bhutan,BTN,Ireland,IRL,0,0,5,0,5
2007,Belarus,BLR,Ireland,IRL,0,0,10,0,10
2007,Brazil,BRA,Ireland,IRL,0,0,5,0,5
2007,China,CHN,Ireland,IRL,0,0,12,5,17
2007,Cameroon,CMR,Ireland,IRL,0,0,32,0,32
2007,Congo,COG,Ireland,IRL,0,0,10,0,10
2007,Dem. Rep. of the Congo,COD,Ireland,IRL,10,0,64,0,74
2007,Eritrea,ERI,Ireland,IRL,5,0,5,0,10
2007,Ethiopia,ETH,Ireland,IRL,0,0,12,0,12
2007,Palestinian,PSE,Ireland,IRL,5,0,10,0,15
2007,Georgia,GEO,Ireland,IRL,5,0,81,13,99
2007,Ghana,GHA,Ireland,IRL,0,0,40,0,40
2007,Guinea,GIN,Ireland,IRL,0,0,10,0,10
2007,Croatia,HRV,Ireland,IRL,5,0,14,0,19
2007,Cote d'Ivoire,CIV,Ireland,IRL,0,0,5,0,5
2007,India,IND,Ireland,IRL,0,0,5,0,5
2007,Iran (Islamic Rep. of),IRN,Ireland,IRL,16,0,40,5,61
2007,Iraq,IRQ,Ireland,IRL,18,0,27,0,45
2007,Israel,ISR,Ireland,IRL,0,0,26,5,31
2007,Kazakhstan,KAZ,Ireland,IRL,0,0,5,0,5
2007,Kenya,KEN,Ireland,IRL,0,0,15,0,15
2007,Kuwait,KWT,Ireland,IRL,0,0,5,0,5
2007,Liberia,LBR,Ireland,IRL,0,0,20,5,25
2007,Libya,LBY,Ireland,IRL,0,0,5,0,5
2007,North Macedonia,MKD,Ireland,IRL,0,0,5,0,5
2007,Rep. of Moldova,MDA,Ireland,IRL,5,0,32,0,37
2007,Malaysia,MYS,Ireland,IRL,0,0,5,0,5
2007,Morocco,MAR,Ireland,IRL,0,0,5,0,5
2007,Nigeria,NGA,Ireland,IRL,25,0,522,45,592
2007,Pakistan,PAK,Ireland,IRL,11,0,49,0,60
2007,Romania,ROU,Ireland,IRL,0,0,40,0,40
2007,South Africa,ZAF,Ireland,IRL,0,0,34,5,39
2007,Russian Federation,RUS,Ireland,IRL,10,0,16,5,31
2007,Rwanda,RWA,Ireland,IRL,5,0,5,0,10
2007,Serbia and Kosovo: S/RES/1244 (1999),SRB,Ireland,IRL,5,0,5,0,10
2007,Sierra Leone,SLE,Ireland,IRL,0,0,10,0,10
2007,Somalia,SOM,Ireland,IRL,14,0,79,5,98
2007,Sudan,SDN,Ireland,IRL,13,0,76,5,94
2007,Togo,TGO,Ireland,IRL,5,0,13,0,18
2007,Turkey,TUR,Ireland,IRL,0,0,5,0,5
2007,Uganda,UGA,Ireland,IRL,0,0,10,10,20
2007,Ukraine,UKR,Ireland,IRL,5,0,5,0,10
2007,Zimbabwe,ZWE,Ireland,IRL,10,0,26,5,41
2007,Myanmar,MMR,Japan,JPN,5,20,150,0,175
2007,Turkey,TUR,Japan,JPN,0,5,12,0,17
2007,Unknown ,,Japan,JPN,0,5,21,34,60
2007,Algeria,DZA,Malta,MLT,0,0,5,0,5
2007,Burkina Faso,BFA,Malta,MLT,0,0,5,0,5
2007,Chad,TCD,Malta,MLT,0,0,5,0,5
2007,Dem. Rep. of the Congo,COD,Malta,MLT,0,0,10,0,10
2007,Eritrea,ERI,Malta,MLT,0,0,18,0,18
2007,Ethiopia,ETH,Malta,MLT,0,0,34,0,34
2007,Palestinian,PSE,Malta,MLT,0,0,5,0,5
2007,Cote d'Ivoire,CIV,Malta,MLT,0,0,59,0,59
2007,Iraq,IRQ,Malta,MLT,0,0,5,0,5
2007,Liberia,LBR,Malta,MLT,0,0,5,0,5
2007,Mali,MLI,Malta,MLT,0,0,27,0,27
2007,Niger,NER,Malta,MLT,0,0,39,0,39
2007,Serbia and Kosovo: S/RES/1244 (1999),SRB,Malta,MLT,0,0,5,0,5
2007,Senegal,SEN,Malta,MLT,0,0,5,0,5
2007,Somalia,SOM,Malta,MLT,0,0,5,0,5
2007,Sudan,SDN,Malta,MLT,0,0,24,0,24
2007,Togo,TGO,Malta,MLT,0,0,18,0,18
2007,Turkey,TUR,Malta,MLT,0,0,5,0,5
2007,Bhutan,BTN,Nepal,NPL,0,0,0,336,336
2007,Afghanistan,AFG,Netherlands,NLD,13,58,168,101,340
2007,Angola,AGO,Netherlands,NLD,0,10,29,28,67
2007,Armenia,ARM,Netherlands,NLD,5,20,11,25,61
2007,Azerbaijan,AZE,Netherlands,NLD,10,28,36,28,102
2007,Burundi,BDI,Netherlands,NLD,5,10,30,10,55
2007,Belarus,BLR,Netherlands,NLD,0,5,0,0,5
2007,Bosnia and Herzegovina,BIH,Netherlands,NLD,0,21,10,36,67
2007,China,CHN,Netherlands,NLD,5,10,10,10,35
2007,Cameroon,CMR,Netherlands,NLD,5,0,0,0,5
2007,Congo,COG,Netherlands,NLD,0,10,12,5,27
2007,Dem. Rep. of the Congo,COD,Netherlands,NLD,5,5,10,11,31
2007,Colombia,COL,Netherlands,NLD,5,5,10,13,33
2007,Eritrea,ERI,Netherlands,NLD,0,19,0,5,24
2007,Ethiopia,ETH,Netherlands,NLD,0,5,5,5,15
2007,Georgia,GEO,Netherlands,NLD,5,5,5,5,20
2007,Guinea,GIN,Netherlands,NLD,5,10,5,21,41
2007,Croatia,HRV,Netherlands,NLD,0,0,0,5,5
2007,Cote d'Ivoire,CIV,Netherlands,NLD,0,5,0,5,10
2007,India,IND,Netherlands,NLD,0,0,0,5,5
2007,Indonesia,IDN,Netherlands,NLD,0,0,0,5,5
2007,Iran (Islamic Rep. of),IRN,Netherlands,NLD,17,51,19,57,144
2007,Iraq,IRQ,Netherlands,NLD,28,465,59,127,679
2007,Kazakhstan,KAZ,Netherlands,NLD,0,0,0,5,5
2007,Kenya,KEN,Netherlands,NLD,0,0,5,0,5
2007,Kyrgyzstan,KGZ,Netherlands,NLD,5,0,5,0,10
2007,Dem. People's Rep. of Korea,PRK,Netherlands,NLD,0,5,0,0,5
2007,Liberia,LBR,Netherlands,NLD,0,10,15,5,30
2007,Libya,LBY,Netherlands,NLD,0,18,0,0,18
2007,Lebanon,LBN,Netherlands,NLD,0,5,5,0,10
2007,Sri Lanka,LKA,Netherlands,NLD,5,5,5,5,20
2007,Rep. of Moldova,MDA,Netherlands,NLD,0,0,5,0,5
2007,Mongolia,MNG,Netherlands,NLD,0,0,0,5,5
2007,Morocco,MAR,Netherlands,NLD,0,0,5,0,5
2007,Nepal,NPL,Netherlands,NLD,15,5,10,0,30
2007,Nigeria,NGA,Netherlands,NLD,5,5,10,5,25
2007,Pakistan,PAK,Netherlands,NLD,0,5,13,5,23
2007,Russian Federation,RUS,Netherlands,NLD,10,15,16,25,66
2007,Rwanda,RWA,Netherlands,NLD,0,10,5,14,29
2007,Saudi Arabia,SAU,Netherlands,NLD,0,0,5,0,5
2007,Serbia and Kosovo: S/RES/1244 (1999),SRB,Netherlands,NLD,0,23,13,40,76
2007,Sierra Leone,SLE,Netherlands,NLD,0,14,15,36,65
2007,Somalia,SOM,Netherlands,NLD,0,49,16,24,89
2007,Sudan,SDN,Netherlands,NLD,5,10,17,15,47
2007,Slovakia,SVK,Netherlands,NLD,0,0,0,5,5
2007,Syrian Arab Rep.,SYR,Netherlands,NLD,5,0,13,11,29
2007,Togo,TGO,Netherlands,NLD,0,0,0,10,10
2007,Turkey,TUR,Netherlands,NLD,11,16,17,16,60
2007,Ukraine,UKR,Netherlands,NLD,5,5,5,0,15
2007,Uzbekistan,UZB,Netherlands,NLD,0,5,0,5,10
2007,Stateless,XXA,Netherlands,NLD,12,31,11,14,68
2007,Unknown ,,Netherlands,NLD,14,69,41,50,174
2007,Afghanistan,AFG,Norway,NOR,5,231,498,53,787
2007,Albania,ALB,Norway,NOR,0,0,36,0,36
2007,Algeria,DZA,Norway,NOR,0,10,40,10,60
2007,Angola,AGO,Norway,NOR,0,5,20,5,30
2007,Egypt,EGY,Norway,NOR,0,0,5,5,10
2007,Armenia,ARM,Norway,NOR,0,10,16,5,31
2007,Azerbaijan,AZE,Norway,NOR,0,5,71,12,88
2007,Burundi,BDI,Norway,NOR,0,10,32,22,64
2007,Bangladesh,BGD,Norway,NOR,0,0,5,0,5
2007,Bhutan,BTN,Norway,NOR,0,0,10,0,10
2007,Belarus,BLR,Norway,NOR,0,16,12,5,33
2007,Bosnia and Herzegovina,BIH,Norway,NOR,0,10,29,10,49
2007,Bulgaria,BGR,Norway,NOR,0,0,10,0,10
2007,China,CHN,Norway,NOR,0,5,11,0,16
2007,Chile,CHL,Norway,NOR,0,0,5,0,5
2007,Cameroon,CMR,Norway,NOR,0,0,15,0,15
2007,Congo,COG,Norway,NOR,0,0,5,0,5
2007,Dem. Rep. of the Congo,COD,Norway,NOR,0,0,38,5,43
2007,Czechia,CZE,Norway,NOR,0,0,5,0,5
2007,Eritrea,ERI,Norway,NOR,0,19,28,74,121
2007,Ethiopia,ETH,Norway,NOR,5,87,242,29,363
2007,Gambia,GMB,Norway,NOR,0,0,5,0,5
2007,Georgia,GEO,Norway,NOR,0,5,13,0,18
2007,Ghana,GHA,Norway,NOR,0,0,0,5,5
2007,Guinea,GIN,Norway,NOR,0,5,5,0,10
2007,Croatia,HRV,Norway,NOR,0,0,10,0,10
2007,Cote d'Ivoire,CIV,Norway,NOR,0,0,5,5,10
2007,India,IND,Norway,NOR,0,5,18,0,23
2007,Iran (Islamic Rep. of),IRN,Norway,NOR,0,104,311,32,447
2007,Iraq,IRQ,Norway,NOR,0,185,443,198,826
2007,Israel,ISR,Norway,NOR,0,5,10,0,15
2007,Jordan,JOR,Norway,NOR,0,0,5,0,5
2007,Kazakhstan,KAZ,Norway,NOR,0,5,13,0,18
2007,Kenya,KEN,Norway,NOR,0,5,12,0,17
2007,Kyrgyzstan,KGZ,Norway,NOR,0,5,30,5,40
2007,Liberia,LBR,Norway,NOR,0,0,16,0,16
2007,Libya,LBY,Norway,NOR,0,0,36,5,41
2007,Lebanon,LBN,Norway,NOR,0,5,15,10,30
2007,Sri Lanka,LKA,Norway,NOR,0,13,28,33,74
2007,Mauritania,MRT,Norway,NOR,0,0,5,0,5
2007,North Macedonia,MKD,Norway,NOR,0,0,32,5,37
2007,Rep. of Moldova,MDA,Norway,NOR,0,0,24,0,24
2007,Morocco,MAR,Norway,NOR,0,5,10,5,20
2007,Myanmar,MMR,Norway,NOR,0,5,0,5,10
2007,Nepal,NPL,Norway,NOR,0,0,75,5,80
2007,Netherlands,NLD,Norway,NOR,0,0,5,0,5
2007,Niger,NER,Norway,NOR,0,0,12,0,12
2007,Nigeria,NGA,Norway,NOR,0,5,41,11,57
2007,Pakistan,PAK,Norway,NOR,5,5,22,5,37
2007,Romania,ROU,Norway,NOR,0,0,5,0,5
2007,Russian Federation,RUS,Norway,NOR,5,155,188,115,463
2007,Rwanda,RWA,Norway,NOR,0,20,39,5,64
2007,Serbia and Kosovo: S/RES/1244 (1999),SRB,Norway,NOR,19,129,336,55,539
2007,Senegal,SEN,Norway,NOR,0,0,5,0,5
2007,Sierra Leone,SLE,Norway,NOR,0,0,27,5,32
2007,Somalia,SOM,Norway,NOR,5,278,200,46,529
2007,Viet Nam,VNM,Norway,NOR,0,5,11,0,16
2007,Sudan,SDN,Norway,NOR,0,0,35,5,40
2007,Slovakia,SVK,Norway,NOR,0,0,16,0,16
2007,Syrian Arab Rep.,SYR,Norway,NOR,0,24,28,17,69
2007,United Rep. of Tanzania,TZA,Norway,NOR,0,0,0,5,5
2007,Tajikistan,TJK,Norway,NOR,0,5,0,0,5
2007,Togo,TGO,Norway,NOR,0,5,5,0,10
2007,Tunisia,TUN,Norway,NOR,0,0,5,0,5
2007,Turkey,TUR,Norway,NOR,0,22,58,18,98
2007,Uganda,UGA,Norway,NOR,0,0,12,0,12
2007,Ukraine,UKR,Norway,NOR,0,0,5,5,10
2007,Uzbekistan,UZB,Norway,NOR,0,12,26,5,43
2007,Venezuela (Bolivarian Republic of),VEN,Norway,NOR,0,0,5,0,5
2007,Western Sahara,ESH,Norway,NOR,0,0,5,5,10
2007,Zambia,ZMB,Norway,NOR,0,0,10,0,10
2007,Stateless,XXA,Norway,NOR,0,77,122,63,262
2007,Bangladesh,BGD,New Zealand,NZL,0,0,10,0,10
2007,Chad,TCD,New Zealand,NZL,0,0,5,0,5
2007,China,CHN,New Zealand,NZL,5,0,5,0,10
2007,Czechia,CZE,New Zealand,NZL,0,0,5,0,5
2007,Fiji,FJI,New Zealand,NZL,0,0,10,0,10
2007,Hungary,HUN,New Zealand,NZL,0,0,5,10,15
2007,India,IND,New Zealand,NZL,0,0,5,5,10
2007,Iran (Islamic Rep. of),IRN,New Zealand,NZL,10,0,23,5,38
2007,Iraq,IRQ,New Zealand,NZL,5,0,0,0,5
2007,Israel,ISR,New Zealand,NZL,0,0,5,0,5
2007,Kyrgyzstan,KGZ,New Zealand,NZL,5,0,0,0,5
2007,Sri Lanka,LKA,New Zealand,NZL,5,0,20,0,25
2007,Pakistan,PAK,New Zealand,NZL,5,0,5,0,10
2007,Slovakia,SVK,New Zealand,NZL,5,0,5,0,10
2007,Zimbabwe,ZWE,New Zealand,NZL,0,0,5,0,5
2007,Algeria,DZA,Poland,POL,0,0,5,0,5
2007,Armenia,ARM,Poland,POL,0,0,5,0,5
2007,Belarus,BLR,Poland,POL,0,0,21,0,21
2007,Cameroon,CMR,Poland,POL,0,0,5,0,5
2007,Dem. Rep. of the Congo,COD,Poland,POL,0,0,5,0,5
2007,Palestinian,PSE,Poland,POL,0,0,5,0,5
2007,Georgia,GEO,Poland,POL,0,0,5,5,10
2007,India,IND,Poland,POL,0,0,5,0,5
2007,Kyrgyzstan,KGZ,Poland,POL,0,0,5,5,10
2007,Mongolia,MNG,Poland,POL,0,0,5,0,5
2007,Nigeria,NGA,Poland,POL,0,0,5,0,5
2007,Pakistan,PAK,Poland,POL,0,0,0,5,5
2007,Russian Federation,RUS,Poland,POL,61,40,399,130,630
2007,Sierra Leone,SLE,Poland,POL,0,0,5,0,5
2007,Turkey,TUR,Poland,POL,0,0,5,0,5
2007,Uganda,UGA,Poland,POL,0,0,5,0,5
2007,Ukraine,UKR,Poland,POL,0,0,22,0,22
2007,Stateless,XXA,Poland,POL,0,0,5,0,5
2007,Afghanistan,AFG,Sweden,SWE,15,42,110,10,177
2007,Albania,ALB,Sweden,SWE,5,10,17,5,37
2007,Algeria,DZA,Sweden,SWE,0,0,44,10,54
2007,Angola,AGO,Sweden,SWE,0,5,11,0,16
2007,Egypt,EGY,Sweden,SWE,0,0,24,10,34
2007,Argentina,ARG,Sweden,SWE,0,0,5,0,5
2007,Armenia,ARM,Sweden,SWE,0,10,82,14,106
2007,Azerbaijan,AZE,Sweden,SWE,11,15,64,15,105
2007,Burundi,BDI,Sweden,SWE,5,5,38,5,53
2007,Benin,BEN,Sweden,SWE,0,0,5,0,5
2007,Bangladesh,BGD,Sweden,SWE,0,5,36,5,46
2007,Belarus,BLR,Sweden,SWE,0,5,97,21,123
2007,Bolivia (Plurinational State of),BOL,Sweden,SWE,0,5,470,63,538
2007,Bosnia and Herzegovina,BIH,Sweden,SWE,0,14,53,15,82
2007,Bulgaria,BGR,Sweden,SWE,0,0,36,18,54
2007,China,CHN,Sweden,SWE,10,0,25,0,35
2007,Chile,CHL,Sweden,SWE,0,0,13,0,13
2007,Cameroon,CMR,Sweden,SWE,0,0,12,0,12
2007,Congo,COG,Sweden,SWE,0,5,10,0,15
2007,Dem. Rep. of the Congo,COD,Sweden,SWE,5,5,71,5,86
2007,Colombia,COL,Sweden,SWE,0,0,11,0,11
2007,Cuba,CUB,Sweden,SWE,0,0,5,0,5
2007,Ecuador,ECU,Sweden,SWE,0,0,5,5,10
2007,Eritrea,ERI,Sweden,SWE,21,27,146,14,208
2007,Ethiopia,ETH,Sweden,SWE,0,5,50,5,60
2007,Georgia,GEO,Sweden,SWE,0,10,37,5,52
2007,Ghana,GHA,Sweden,SWE,0,0,5,0,5
2007,Guinea,GIN,Sweden,SWE,5,0,13,5,23
2007,Honduras,HND,Sweden,SWE,0,5,5,0,10
2007,Croatia,HRV,Sweden,SWE,0,0,10,0,10
2007,Hungary,HUN,Sweden,SWE,0,0,5,5,10
2007,Cote d'Ivoire,CIV,Sweden,SWE,0,5,11,5,21
2007,India,IND,Sweden,SWE,0,0,25,0,25
2007,Iran (Islamic Rep. of),IRN,Sweden,SWE,25,24,123,23,195
2007,Iraq,IRQ,Sweden,SWE,10,75,667,116,868
2007,Israel,ISR,Sweden,SWE,0,0,0,5,5
2007,Jordan,JOR,Sweden,SWE,0,0,27,0,27
2007,Kazakhstan,KAZ,Sweden,SWE,5,5,22,10,42
2007,Kenya,KEN,Sweden,SWE,0,0,13,5,18
2007,Kyrgyzstan,KGZ,Sweden,SWE,0,5,14,0,19
2007,Liberia,LBR,Sweden,SWE,0,0,14,0,14
2007,Libya,LBY,Sweden,SWE,5,5,113,25,148
2007,Lebanon,LBN,Sweden,SWE,5,25,187,22,239
2007,North Macedonia,MKD,Sweden,SWE,0,0,25,5,30
2007,Rep. of Moldova,MDA,Sweden,SWE,0,0,12,0,12
2007,Mongolia,MNG,Sweden,SWE,0,5,139,27,171
2007,Morocco,MAR,Sweden,SWE,0,0,14,5,19
2007,Montenegro,MNE,Sweden,SWE,0,0,18,0,18
2007,Nepal,NPL,Sweden,SWE,0,0,17,0,17
2007,Nicaragua,NIC,Sweden,SWE,0,0,5,0,5
2007,Nigeria,NGA,Sweden,SWE,0,5,44,5,54
2007,Pakistan,PAK,Sweden,SWE,0,0,29,5,34
2007,Peru,PER,Sweden,SWE,0,0,12,0,12
2007,Romania,ROU,Sweden,SWE,0,5,15,5,25
2007,Russian Federation,RUS,Sweden,SWE,0,18,195,40,253
2007,Rwanda,RWA,Sweden,SWE,0,5,5,0,10
2007,El Salvador,SLV,Sweden,SWE,0,0,12,5,17
2007,Saudi Arabia,SAU,Sweden,SWE,0,0,5,0,5
2007,Serbia and Kosovo: S/RES/1244 (1999),SRB,Sweden,SWE,39,68,539,60,706
2007,Senegal,SEN,Sweden,SWE,0,0,5,0,5
2007,Sierra Leone,SLE,Sweden,SWE,0,5,5,0,10
2007,Somalia,SOM,Sweden,SWE,0,16,45,11,72
2007,Viet Nam,VNM,Sweden,SWE,0,0,21,5,26
2007,Sudan,SDN,Sweden,SWE,5,0,11,0,16
2007,Syrian Arab Rep.,SYR,Sweden,SWE,10,10,133,10,163
2007,United Rep. of Tanzania,TZA,Sweden,SWE,0,0,5,0,5
2007,Thailand,THA,Sweden,SWE,0,5,0,0,5
2007,Tajikistan,TJK,Sweden,SWE,0,0,5,0,5
2007,Turkmenistan,TKM,Sweden,SWE,0,5,0,0,5
2007,Togo,TGO,Sweden,SWE,0,0,5,0,5
2007,Tunisia,TUN,Sweden,SWE,0,0,21,0,21
2007,Turkey,TUR,Sweden,SWE,0,11,92,17,120
2007,Uganda,UGA,Sweden,SWE,0,0,10,0,10
2007,Ukraine,UKR,Sweden,SWE,0,0,27,5,32
2007,United States of America,USA,Sweden,SWE,0,0,0,5,5
2007,Uzbekistan,UZB,Sweden,SWE,0,14,81,23,118
2007,Yemen,YEM,Sweden,SWE,0,0,5,0,5
2007,Stateless,XXA,Sweden,SWE,0,59,210,39,308
2007,Unknown ,,Sweden,SWE,5,0,74,20,99
2007,Dem. Rep. of the Congo,COD,Togo,TGO,0,0,0,5,5
2007,Afghanistan,AFG,Ukraine,UKR,5,0,49,5,59
2007,Angola,AGO,Ukraine,UKR,0,0,0,19,19
2007,Armenia,ARM,Ukraine,UKR,0,0,5,10,15
2007,Azerbaijan,AZE,Ukraine,UKR,0,0,0,5,5
2007,Bangladesh,BGD,Ukraine,UKR,0,0,83,0,83
2007,China,CHN,Ukraine,UKR,0,0,0,10,10
2007,Congo,COG,Ukraine,UKR,0,0,5,0,5
2007,Dem. Rep. of the Congo,COD,Ukraine,UKR,0,0,0,5,5
2007,Eritrea,ERI,Ukraine,UKR,0,0,0,5,5
2007,Ethiopia,ETH,Ukraine,UKR,0,0,10,0,10
2007,Palestinian,PSE,Ukraine,UKR,0,0,13,42,55
2007,Georgia,GEO,Ukraine,UKR,0,0,0,5,5
2007,Cote d'Ivoire,CIV,Ukraine,UKR,0,0,5,0,5
2007,India,IND,Ukraine,UKR,0,0,98,0,98
2007,Iran (Islamic Rep. of),IRN,Ukraine,UKR,0,0,5,10,15
2007,Iraq,IRQ,Ukraine,UKR,0,0,11,12,23
2007,Sri Lanka,LKA,Ukraine,UKR,0,0,5,0,5
2007,Mauritania,MRT,Ukraine,UKR,0,0,0,5,5
2007,Nepal,NPL,Ukraine,UKR,0,0,5,0,5
2007,Nigeria,NGA,Ukraine,UKR,0,0,0,10,10
2007,Pakistan,PAK,Ukraine,UKR,0,0,163,0,163
2007,Russian Federation,RUS,Ukraine,UKR,0,0,5,60,65
2007,Somalia,SOM,Ukraine,UKR,0,0,0,26,26
2007,Viet Nam,VNM,Ukraine,UKR,0,0,5,0,5
2007,Sudan,SDN,Ukraine,UKR,0,0,10,13,23
2007,Syrian Arab Rep.,SYR,Ukraine,UKR,0,0,10,10,20
2007,Uganda,UGA,Ukraine,UKR,0,0,0,5,5
2008,Central African Rep.,CAF,Benin,BEN,0,0,5,0,5
2008,Congo,COG,Benin,BEN,0,0,28,0,28
2008,Dem. Rep. of the Congo,COD,Benin,BEN,5,0,79,0,84
2008,Nigeria,NGA,Benin,BEN,0,0,81,0,81
2008,Rwanda,RWA,Benin,BEN,5,0,0,0,5
2008,Togo,TGO,Benin,BEN,0,0,141,0,141
2008,Cuba,CUB,Colombia,COL,0,0,10,0,10
2008,Afghanistan,AFG,Cyprus,CYP,0,0,48,14,62
2008,Egypt,EGY,Cyprus,CYP,0,0,16,5,21
2008,Armenia,ARM,Cyprus,CYP,0,0,117,12,129
2008,Bangladesh,BGD,Cyprus,CYP,0,0,268,61,329
2008,China,CHN,Cyprus,CYP,0,0,5,5,10
2008,Cameroon,CMR,Cyprus,CYP,0,0,16,11,27
2008,Dem. Rep. of the Congo,COD,Cyprus,CYP,0,0,5,0,5
2008,Palestinian,PSE,Cyprus,CYP,0,0,5,0,5
2008,Georgia,GEO,Cyprus,CYP,0,10,75,35,120
2008,India,IND,Cyprus,CYP,0,0,10,21,31
2008,Iran (Islamic Rep. of),IRN,Cyprus,CYP,10,0,46,14,70
2008,Iraq,IRQ,Cyprus,CYP,0,0,14,0,14
2008,Jordan,JOR,Cyprus,CYP,0,0,0,5,5
2008,Lebanon,LBN,Cyprus,CYP,0,0,5,0,5
2008,Sri Lanka,LKA,Cyprus,CYP,0,0,291,44,335
2008,Rep. of Moldova,MDA,Cyprus,CYP,0,0,24,5,29
2008,Nepal,NPL,Cyprus,CYP,0,0,0,10,10
2008,Nigeria,NGA,Cyprus,CYP,0,0,22,13,35
2008,Pakistan,PAK,Cyprus,CYP,0,0,301,20,321
2008,Philippines,PHL,Cyprus,CYP,0,0,18,5,23
2008,Russian Federation,RUS,Cyprus,CYP,0,0,25,5,30
2008,Serbia and Kosovo: S/RES/1244 (1999),SRB,Cyprus,CYP,0,5,0,5,10
2008,Somalia,SOM,Cyprus,CYP,0,0,0,5,5
2008,Viet Nam,VNM,Cyprus,CYP,0,0,5,0,5
2008,Syrian Arab Rep.,SYR,Cyprus,CYP,0,5,1012,97,1114
2008,Turkey,TUR,Cyprus,CYP,0,0,33,5,38
2008,Ukraine,UKR,Cyprus,CYP,0,5,31,12,48
2008,Uzbekistan,UZB,Cyprus,CYP,0,0,5,5,10
2008,Afghanistan,AFG,Czechia,CZE,0,0,5,5,10
2008,Algeria,DZA,Czechia,CZE,0,0,5,5,10
2008,Egypt,EGY,Czechia,CZE,0,0,0,5,5
2008,Armenia,ARM,Czechia,CZE,0,0,25,0,25
2008,Azerbaijan,AZE,Czechia,CZE,0,0,5,0,5
2008,Bangladesh,BGD,Czechia,CZE,0,0,5,5,10
2008,Belarus,BLR,Czechia,CZE,5,0,42,5,52
2008,China,CHN,Czechia,CZE,0,0,24,10,34
2008,Cameroon,CMR,Czechia,CZE,0,0,5,0,5
2008,Dem. Rep. of the Congo,COD,Czechia,CZE,5,0,5,0,10
2008,Georgia,GEO,Czechia,CZE,5,0,11,0,16
2008,Ghana,GHA,Czechia,CZE,0,0,5,0,5
2008,Guinea,GIN,Czechia,CZE,0,0,5,0,5
2008,Cote d'Ivoire,CIV,Czechia,CZE,0,0,5,0,5
2008,India,IND,Czechia,CZE,0,0,5,5,10
2008,Iraq,IRQ,Czechia,CZE,10,0,0,0,10
2008,Kazakhstan,KAZ,Czechia,CZE,5,0,133,10,148
2008,Kyrgyzstan,KGZ,Czechia,CZE,0,0,27,17,44
2008,Sri Lanka,LKA,Czechia,CZE,0,0,5,12,17
2008,North Macedonia,MKD,Czechia,CZE,0,0,5,5,10
2008,Rep. of Moldova,MDA,Czechia,CZE,0,0,10,5,15
2008,Mongolia,MNG,Czechia,CZE,0,0,94,38,132
2008,Nigeria,NGA,Czechia,CZE,0,0,24,5,29
2008,Pakistan,PAK,Czechia,CZE,0,0,5,5,10
2008,Russian Federation,RUS,Czechia,CZE,5,0,47,15,67
2008,Serbia and Kosovo: S/RES/1244 (1999),SRB,Czechia,CZE,0,0,10,5,15
2008,Sierra Leone,SLE,Czechia,CZE,0,0,5,5,10
2008,Viet Nam,VNM,Czechia,CZE,0,0,52,18,70
2008,Turkey,TUR,Czechia,CZE,5,0,50,152,207
2008,Ukraine,UKR,Czechia,CZE,5,0,187,37,229
2008,Uzbekistan,UZB,Czechia,CZE,0,0,15,0,15
2008,Stateless,XXA,Czechia,CZE,0,0,5,0,5
2008,Unknown ,,Czechia,CZE,5,0,0,0,5
2008,Afghanistan,AFG,Denmark,DNK,0,10,32,0,42
2008,Algeria,DZA,Denmark,DNK,0,0,5,0,5
2008,Armenia,ARM,Denmark,DNK,0,0,5,0,5
2008,Azerbaijan,AZE,Denmark,DNK,0,0,5,0,5
2008,Belarus,BLR,Denmark,DNK,0,0,5,0,5
2008,Bosnia and Herzegovina,BIH,Denmark,DNK,0,0,10,0,10
2008,China,CHN,Denmark,DNK,0,0,11,0,11
2008,Georgia,GEO,Denmark,DNK,0,0,5,0,5
2008,Haiti,HTI,Denmark,DNK,0,0,5,0,5
2008,Iran (Islamic Rep. of),IRN,Denmark,DNK,5,5,13,0,23
2008,Iraq,IRQ,Denmark,DNK,74,21,71,0,166
2008,Kyrgyzstan,KGZ,Denmark,DNK,0,0,5,0,5
2008,Liberia,LBR,Denmark,DNK,0,0,5,0,5
2008,Lebanon,LBN,Denmark,DNK,0,0,5,0,5
2008,Sri Lanka,LKA,Denmark,DNK,0,5,14,0,19
2008,Nigeria,NGA,Denmark,DNK,0,0,11,0,11
2008,Pakistan,PAK,Denmark,DNK,0,0,5,0,5
2008,Russian Federation,RUS,Denmark,DNK,0,0,18,0,18
2008,Serbia and Kosovo: S/RES/1244 (1999),SRB,Denmark,DNK,0,0,18,0,18
2008,Somalia,SOM,Denmark,DNK,0,0,5,0,5
2008,Syrian Arab Rep.,SYR,Denmark,DNK,0,0,5,0,5
2008,Turkey,TUR,Denmark,DNK,0,0,5,0,5
2008,Stateless,XXA,Denmark,DNK,10,0,11,0,21
2008,Unknown ,,France,FRA,5199,1132,14490,4246,25067
2008,Iran (Islamic Rep. of),IRN,Greece,GRC,5,0,0,0,5
2008,Iraq,IRQ,Greece,GRC,331,14,0,0,345
2008,Somalia,SOM,Greece,GRC,0,5,0,0,5
2008,Viet Nam,VNM,Greece,GRC,5,0,0,0,5
2008,Unknown ,,Greece,GRC,0,0,1157,275,1432
2008,Pakistan,PAK,Croatia,HRV,0,5,0,0,5
2008,Serbia and Kosovo: S/RES/1244 (1999),SRB,Croatia,HRV,0,0,14,0,14
2008,Russian Federation,RUS,Iceland,ISL,0,0,5,0,5
2008,Afghanistan,AFG,Ireland,IRL,20,0,41,10,71
2008,Albania,ALB,Ireland,IRL,5,0,23,0,28
2008,Algeria,DZA,Ireland,IRL,5,0,14,5,24
2008,Angola,AGO,Ireland,IRL,5,0,14,0,19
2008,Egypt,EGY,Ireland,IRL,0,0,5,0,5
2008,Armenia,ARM,Ireland,IRL,0,0,10,0,10
2008,Azerbaijan,AZE,Ireland,IRL,5,0,0,0,5
2008,Burundi,BDI,Ireland,IRL,0,0,15,0,15
2008,Benin,BEN,Ireland,IRL,0,0,5,0,5
2008,Bangladesh,BGD,Ireland,IRL,0,0,10,0,10
2008,Bhutan,BTN,Ireland,IRL,0,0,5,0,5
2008,Belarus,BLR,Ireland,IRL,5,0,10,0,15
2008,Botswana,BWA,Ireland,IRL,0,0,5,0,5
2008,Brazil,BRA,Ireland,IRL,0,0,10,0,10
2008,China,CHN,Ireland,IRL,5,0,29,5,39
2008,Cameroon,CMR,Ireland,IRL,5,0,50,5,60
2008,Congo,COG,Ireland,IRL,0,0,13,0,13
2008,Dem. Rep. of the Congo,COD,Ireland,IRL,0,0,117,12,129
2008,Eritrea,ERI,Ireland,IRL,5,0,11,0,16
2008,Ethiopia,ETH,Ireland,IRL,5,0,15,0,20
2008,Gambia,GMB,Ireland,IRL,0,0,5,0,5
2008,Palestinian,PSE,Ireland,IRL,10,0,5,0,15
2008,Georgia,GEO,Ireland,IRL,5,0,80,11,96
2008,Ghana,GHA,Ireland,IRL,5,0,71,5,81
2008,Guinea,GIN,Ireland,IRL,5,0,13,0,18
2008,Guyana,GUY,Ireland,IRL,0,0,0,5,5
2008,Croatia,HRV,Ireland,IRL,10,0,14,0,24
2008,Cote d'Ivoire,CIV,Ireland,IRL,5,0,10,0,15
2008,India,IND,Ireland,IRL,0,0,10,5,15
2008,Iran (Islamic Rep. of),IRN,Ireland,IRL,10,0,16,5,31
2008,Iraq,IRQ,Ireland,IRL,30,0,29,5,64
2008,Israel,ISR,Ireland,IRL,0,0,14,5,19
2008,Jamaica,JAM,Ireland,IRL,0,0,5,0,5
2008,Kenya,KEN,Ireland,IRL,0,0,36,5,41
2008,Kuwait,KWT,Ireland,IRL,0,0,10,0,10
2008,Liberia,LBR,Ireland,IRL,0,0,19,5,24
2008,Sri Lanka,LKA,Ireland,IRL,5,0,0,0,5
2008,Rep. of Moldova,MDA,Ireland,IRL,10,0,66,12,88
2008,Malawi,MWI,Ireland,IRL,0,0,10,0,10
2008,Mongolia,MNG,Ireland,IRL,0,0,5,0,5
2008,Mauritius,MUS,Ireland,IRL,0,0,13,0,13
2008,Nigeria,NGA,Ireland,IRL,57,0,804,57,918
2008,Pakistan,PAK,Ireland,IRL,17,0,50,10,77
2008,Romania,ROU,Ireland,IRL,0,0,12,0,12
2008,South Africa,ZAF,Ireland,IRL,5,0,53,0,58
2008,Russian Federation,RUS,Ireland,IRL,5,0,10,13,28
2008,Rwanda,RWA,Ireland,IRL,0,0,10,0,10
2008,Serbia and Kosovo: S/RES/1244 (1999),SRB,Ireland,IRL,5,0,31,0,36
2008,Sierra Leone,SLE,Ireland,IRL,0,0,15,0,15
2008,Somalia,SOM,Ireland,IRL,15,0,61,10,86
2008,Viet Nam,VNM,Ireland,IRL,0,0,5,0,5
2008,Sudan,SDN,Ireland,IRL,5,0,62,24,91
2008,Syrian Arab Rep.,SYR,Ireland,IRL,0,0,5,0,5
2008,Togo,TGO,Ireland,IRL,5,0,11,0,16
2008,Uganda,UGA,Ireland,IRL,0,0,14,0,14
2008,Ukraine,UKR,Ireland,IRL,5,0,14,5,24
2008,Zimbabwe,ZWE,Ireland,IRL,5,0,32,5,42
2008,Stateless,XXA,Ireland,IRL,0,0,0,5,5
2008,Myanmar,MMR,Japan,JPN,16,16,200,0,232
2008,Turkey,TUR,Japan,JPN,0,0,51,0,51
2008,Unknown ,,Japan,JPN,0,29,49,34,112
2008,Benin,BEN,Malta,MLT,0,0,5,0,5
2008,Burkina Faso,BFA,Malta,MLT,0,0,5,0,5
2008,Eritrea,ERI,Malta,MLT,0,0,12,0,12
2008,Ethiopia,ETH,Malta,MLT,0,0,11,0,11
2008,Gambia,GMB,Malta,MLT,0,0,5,0,5
2008,Ghana,GHA,Malta,MLT,0,0,46,0,46
2008,Guinea-Bissau,GNB,Malta,MLT,0,0,5,0,5
2008,Cote d'Ivoire,CIV,Malta,MLT,0,0,36,0,36
2008,Mali,MLI,Malta,MLT,0,0,15,0,15
2008,Nigeria,NGA,Malta,MLT,0,0,5,0,5
2008,Senegal,SEN,Malta,MLT,0,0,5,0,5
2008,Sierra Leone,SLE,Malta,MLT,0,0,5,0,5
2008,Somalia,SOM,Malta,MLT,0,0,14,0,14
2008,Sudan,SDN,Malta,MLT,0,0,11,0,11
2008,Togo,TGO,Malta,MLT,0,0,5,0,5
2008,Afghanistan,AFG,Norway,NOR,21,162,325,0,508
2008,Albania,ALB,Norway,NOR,0,5,30,0,35
2008,Algeria,DZA,Norway,NOR,0,5,22,0,27
2008,Angola,AGO,Norway,NOR,0,0,23,0,23
2008,Egypt,EGY,Norway,NOR,0,0,17,0,17
2008,Azerbaijan,AZE,Norway,NOR,0,17,36,0,53
2008,Burundi,BDI,Norway,NOR,0,10,19,0,29
2008,Bangladesh,BGD,Norway,NOR,0,0,11,0,11
2008,Bhutan,BTN,Norway,NOR,0,0,28,0,28
2008,Belarus,BLR,Norway,NOR,0,5,18,0,23
2008,Bosnia and Herzegovina,BIH,Norway,NOR,0,5,15,0,20
2008,Bulgaria,BGR,Norway,NOR,0,5,5,0,10
2008,China,CHN,Norway,NOR,0,5,5,0,10
2008,Cameroon,CMR,Norway,NOR,0,0,21,0,21
2008,Dem. Rep. of the Congo,COD,Norway,NOR,0,0,37,0,37
2008,Czechia,CZE,Norway,NOR,0,0,5,0,5
2008,Djibouti,DJI,Norway,NOR,0,0,5,0,5
2008,Eritrea,ERI,Norway,NOR,0,5,42,0,47
2008,Ethiopia,ETH,Norway,NOR,14,45,232,0,291
2008,Georgia,GEO,Norway,NOR,0,0,10,0,10
2008,Ghana,GHA,Norway,NOR,0,0,5,0,5
2008,Guinea,GIN,Norway,NOR,0,0,5,0,5
2008,Croatia,HRV,Norway,NOR,0,0,5,0,5
2008,Hungary,HUN,Norway,NOR,0,0,5,0,5
2008,Iran (Islamic Rep. of),IRN,Norway,NOR,5,21,281,0,307
2008,Iraq,IRQ,Norway,NOR,10,40,958,10,1018
2008,Israel,ISR,Norway,NOR,0,0,5,0,5
2008,Jordan,JOR,Norway,NOR,0,0,14,0,14
2008,Kazakhstan,KAZ,Norway,NOR,0,0,12,0,12
2008,Kyrgyzstan,KGZ,Norway,NOR,0,0,36,0,36
2008,Liberia,LBR,Norway,NOR,0,0,14,0,14
2008,Libya,LBY,Norway,NOR,0,5,28,0,33
2008,Lebanon,LBN,Norway,NOR,0,0,96,0,96
2008,Sri Lanka,LKA,Norway,NOR,0,0,74,0,74
2008,Latvia,LVA,Norway,NOR,0,0,5,0,5
2008,North Macedonia,MKD,Norway,NOR,0,0,18,0,18
2008,Rep. of Moldova,MDA,Norway,NOR,0,0,5,0,5
2008,Mongolia,MNG,Norway,NOR,0,0,12,0,12
2008,Morocco,MAR,Norway,NOR,0,0,12,0,12
2008,Montenegro,MNE,Norway,NOR,0,0,19,0,19
2008,Nepal,NPL,Norway,NOR,0,5,63,0,68
2008,Niger,NER,Norway,NOR,0,0,5,0,5
2008,Nigeria,NGA,Norway,NOR,0,11,31,0,42
2008,Pakistan,PAK,Norway,NOR,0,0,12,0,12
2008,Romania,ROU,Norway,NOR,0,0,10,0,10
2008,Russian Federation,RUS,Norway,NOR,5,99,329,0,433
2008,Rwanda,RWA,Norway,NOR,0,0,23,0,23
2008,Serbia and Kosovo: S/RES/1244 (1999),SRB,Norway,NOR,0,0,292,0,292
2008,Sierra Leone,SLE,Norway,NOR,0,5,5,0,10
2008,Somalia,SOM,Norway,NOR,10,47,122,0,179
2008,Viet Nam,VNM,Norway,NOR,0,0,5,0,5
2008,Sudan,SDN,Norway,NOR,0,0,41,0,41
2008,Syrian Arab Rep.,SYR,Norway,NOR,0,0,33,0,33
2008,Tajikistan,TJK,Norway,NOR,0,5,0,0,5
2008,Turkmenistan,TKM,Norway,NOR,0,0,5,0,5
2008,Turkey,TUR,Norway,NOR,0,10,39,0,49
2008,Ukraine,UKR,Norway,NOR,0,0,10,0,10
2008,Uzbekistan,UZB,Norway,NOR,5,27,28,0,60
2008,Yemen,YEM,Norway,NOR,0,5,5,0,10
2008,Zimbabwe,ZWE,Norway,NOR,0,0,5,0,5
2008,Stateless,XXA,Norway,NOR,0,10,181,0,191
2008,Unknown ,,Norway,NOR,5,41,185,5,236
2008,Afghanistan,AFG,New Zealand,NZL,5,0,0,0,5
2008,Bangladesh,BGD,New Zealand,NZL,5,0,5,0,10
2008,Bolivia (Plurinational State of),BOL,New Zealand,NZL,0,0,5,0,5
2008,China,CHN,New Zealand,NZL,5,0,5,5,15
2008,Czechia,CZE,New Zealand,NZL,0,0,5,0,5
2008,Fiji,FJI,New Zealand,NZL,0,0,10,0,10
2008,United Kingdom of Great Britain and Northern Ireland,GBR,New Zealand,NZL,0,0,0,5,5
2008,India,IND,New Zealand,NZL,0,0,5,0,5
2008,Iran (Islamic Rep. of),IRN,New Zealand,NZL,13,0,12,0,25
2008,Sri Lanka,LKA,New Zealand,NZL,5,0,10,0,15
2008,South Africa,ZAF,New Zealand,NZL,0,0,5,0,5
2008,Somalia,SOM,New Zealand,NZL,0,0,10,0,10
2008,Slovakia,SVK,New Zealand,NZL,0,0,5,0,5
2008,Belarus,BLR,Poland,POL,0,0,10,0,10
2008,Cameroon,CMR,Poland,POL,0,0,5,5,10
2008,Nepal,NPL,Poland,POL,0,0,5,0,5
2008,Russian Federation,RUS,Poland,POL,0,5,103,130,238
2008,Serbia and Kosovo: S/RES/1244 (1999),SRB,Poland,POL,0,0,5,0,5
2008,Turkmenistan,TKM,Poland,POL,5,0,0,0,5
2008,Ukraine,UKR,Poland,POL,0,0,10,5,15
2008,Afghanistan,AFG,Sweden,SWE,19,102,281,22,424
2008,Albania,ALB,Sweden,SWE,0,0,53,10,63
2008,Algeria,DZA,Sweden,SWE,0,0,66,15,81
2008,Angola,AGO,Sweden,SWE,0,0,29,0,29
2008,Egypt,EGY,Sweden,SWE,0,0,108,10,118
2008,Armenia,ARM,Sweden,SWE,0,10,129,17,156
2008,Azerbaijan,AZE,Sweden,SWE,5,5,164,25,199
2008,Burundi,BDI,Sweden,SWE,5,17,146,15,183
2008,Benin,BEN,Sweden,SWE,0,0,5,0,5
2008,Bangladesh,BGD,Sweden,SWE,5,5,69,5,84
2008,Belarus,BLR,Sweden,SWE,0,5,265,35,305
2008,Bolivia (Plurinational State of),BOL,Sweden,SWE,0,0,372,27,399
2008,Brazil,BRA,Sweden,SWE,0,0,5,0,5
2008,Bosnia and Herzegovina,BIH,Sweden,SWE,0,17,103,15,135
2008,Bulgaria,BGR,Sweden,SWE,0,0,19,0,19
2008,China,CHN,Sweden,SWE,0,0,21,5,26
2008,Chile,CHL,Sweden,SWE,0,0,40,11,51
2008,Cameroon,CMR,Sweden,SWE,0,0,29,0,29
2008,Congo,COG,Sweden,SWE,0,0,15,0,15
2008,Dem. Rep. of the Congo,COD,Sweden,SWE,10,0,73,0,83
2008,Colombia,COL,Sweden,SWE,0,0,10,0,10
2008,Cuba,CUB,Sweden,SWE,5,0,13,5,23
2008,Czechia,CZE,Sweden,SWE,0,0,0,5,5
2008,Ecuador,ECU,Sweden,SWE,0,0,16,5,21
2008,Eritrea,ERI,Sweden,SWE,14,47,196,13,270
2008,Ethiopia,ETH,Sweden,SWE,10,10,98,10,128
2008,Gambia,GMB,Sweden,SWE,0,0,11,0,11
2008,Georgia,GEO,Sweden,SWE,0,0,64,5,69
2008,Germany,DEU,Sweden,SWE,0,5,0,0,5
2008,Ghana,GHA,Sweden,SWE,0,0,20,0,20
2008,Guatemala,GTM,Sweden,SWE,0,0,11,0,11
2008,Guinea,GIN,Sweden,SWE,0,0,17,5,22
2008,Honduras,HND,Sweden,SWE,0,0,5,0,5
2008,Croatia,HRV,Sweden,SWE,0,0,15,0,15
2008,Cote d'Ivoire,CIV,Sweden,SWE,5,0,23,5,33
2008,India,IND,Sweden,SWE,0,0,38,0,38
2008,Indonesia,IDN,Sweden,SWE,0,0,10,5,15
2008,Iran (Islamic Rep. of),IRN,Sweden,SWE,37,45,364,32,478
2008,Iraq,IRQ,Sweden,SWE,24,126,1922,481,2553
2008,Israel,ISR,Sweden,SWE,0,0,15,5,20
2008,Jordan,JOR,Sweden,SWE,0,10,46,5,61
2008,Kazakhstan,KAZ,Sweden,SWE,0,5,54,10,69
2008,Kenya,KEN,Sweden,SWE,0,5,29,5,39
2008,Kyrgyzstan,KGZ,Sweden,SWE,0,0,53,5,58
2008,Liberia,LBR,Sweden,SWE,0,0,11,0,11
2008,Libya,LBY,Sweden,SWE,5,5,325,28,363
2008,Lebanon,LBN,Sweden,SWE,0,17,475,50,542
2008,Sri Lanka,LKA,Sweden,SWE,0,0,13,0,13
2008,North Macedonia,MKD,Sweden,SWE,0,0,28,0,28
2008,Rep. of Moldova,MDA,Sweden,SWE,0,0,10,5,15
2008,Mongolia,MNG,Sweden,SWE,0,5,631,24,660
2008,Morocco,MAR,Sweden,SWE,0,0,35,0,35
2008,Montenegro,MNE,Sweden,SWE,0,5,54,5,64
2008,Nepal,NPL,Sweden,SWE,0,0,13,0,13
2008,Nicaragua,NIC,Sweden,SWE,0,0,22,5,27
2008,Nigeria,NGA,Sweden,SWE,0,5,76,5,86
2008,Pakistan,PAK,Sweden,SWE,0,0,35,10,45
2008,Panama,PAN,Sweden,SWE,0,0,5,0,5
2008,Paraguay,PRY,Sweden,SWE,0,0,5,0,5
2008,Peru,PER,Sweden,SWE,0,0,17,5,22
2008,Philippines,PHL,Sweden,SWE,0,0,5,0,5
2008,Romania,ROU,Sweden,SWE,0,0,18,5,23
2008,Russian Federation,RUS,Sweden,SWE,5,10,381,71,467
2008,Rwanda,RWA,Sweden,SWE,0,0,5,0,5
2008,El Salvador,SLV,Sweden,SWE,0,0,48,13,61
2008,Serbia and Kosovo: S/RES/1244 (1999),SRB,Sweden,SWE,15,71,1126,144,1356
2008,Senegal,SEN,Sweden,SWE,0,0,10,0,10
2008,Sierra Leone,SLE,Sweden,SWE,0,0,10,0,10
2008,Somalia,SOM,Sweden,SWE,5,5,109,27,146
2008,Viet Nam,VNM,Sweden,SWE,0,0,46,5,51
2008,Sudan,SDN,Sweden,SWE,0,0,17,5,22
2008,Syrian Arab Rep.,SYR,Sweden,SWE,13,21,309,20,363
2008,United Rep. of Tanzania,TZA,Sweden,SWE,0,0,5,0,5
2008,Thailand,THA,Sweden,SWE,0,0,5,0,5
2008,Tajikistan,TJK,Sweden,SWE,0,0,5,0,5
2008,Turkmenistan,TKM,Sweden,SWE,0,5,5,0,10
2008,Togo,TGO,Sweden,SWE,0,0,10,0,10
2008,Tunisia,TUN,Sweden,SWE,0,0,39,5,44
2008,Turkey,TUR,Sweden,SWE,0,18,233,35,286
2008,Uganda,UGA,Sweden,SWE,0,0,25,0,25
2008,Ukraine,UKR,Sweden,SWE,0,0,48,10,58
2008,United States of America,USA,Sweden,SWE,0,0,5,5,10
2008,Uzbekistan,UZB,Sweden,SWE,5,19,419,38,481
2008,Venezuela (Bolivarian Republic of),VEN,Sweden,SWE,0,0,5,0,5
2008,Yemen,YEM,Sweden,SWE,0,0,43,0,43
2008,Stateless,XXA,Sweden,SWE,5,29,409,64,507
2008,Unknown ,,Sweden,SWE,0,5,192,25,222
2008,Afghanistan,AFG,Ukraine,UKR,0,0,52,19,71
2008,Algeria,DZA,Ukraine,UKR,0,0,5,0,5
2008,Azerbaijan,AZE,Ukraine,UKR,0,0,5,5,10
2008,Bangladesh,BGD,Ukraine,UKR,0,0,68,0,68
2008,Dem. Rep. of the Congo,COD,Ukraine,UKR,0,0,10,0,10
2008,Ethiopia,ETH,Ukraine,UKR,0,0,5,0,5
2008,Palestinian,PSE,Ukraine,UKR,0,0,18,0,18
2008,Georgia,GEO,Ukraine,UKR,0,0,5,0,5
2008,India,IND,Ukraine,UKR,0,0,47,5,52
2008,Iran (Islamic Rep. of),IRN,Ukraine,UKR,0,0,13,5,18
2008,Iraq,IRQ,Ukraine,UKR,0,0,21,13,34
2008,Sri Lanka,LKA,Ukraine,UKR,0,0,5,0,5
2008,Nigeria,NGA,Ukraine,UKR,0,0,5,0,5
2008,Pakistan,PAK,Ukraine,UKR,0,0,221,0,221
2008,Russian Federation,RUS,Ukraine,UKR,0,0,5,5,10
2008,Somalia,SOM,Ukraine,UKR,0,0,12,0,12
2008,Sudan,SDN,Ukraine,UKR,0,0,5,0,5
2008,Syrian Arab Rep.,SYR,Ukraine,UKR,0,0,5,0,5
2008,Uzbekistan,UZB,Ukraine,UKR,0,0,0,5,5
2008,Stateless,XXA,Ukraine,UKR,0,0,5,0,5
2009,Unknown ,,Belgium,BEL,183,120,4919,0,5222
2009,Chad,TCD,Benin,BEN,0,0,14,0,14
2009,Congo,COG,Benin,BEN,0,0,5,0,5
2009,Dem. Rep. of the Congo,COD,Benin,BEN,5,0,62,0,67
2009,Kenya,KEN,Benin,BEN,0,0,5,0,5
2009,Nigeria,NGA,Benin,BEN,0,0,30,0,30
2009,Togo,TGO,Benin,BEN,5,0,69,0,74
2009,Chad,TCD,Burkina Faso,BFA,0,0,0,5,5
2009,Congo,COG,Burkina Faso,BFA,0,0,0,11,11
2009,Dem. Rep. of the Congo,COD,Burkina Faso,BFA,0,0,0,10,10
2009,Togo,TGO,Burkina Faso,BFA,0,0,0,15,15
2009,Afghanistan,AFG,Belarus,BLR,0,0,14,0,14
2009,Azerbaijan,AZE,Belarus,BLR,0,0,5,0,5
2009,Iran (Islamic Rep. of),IRN,Belarus,BLR,0,0,5,0,5
2009,Cuba,CUB,Colombia,COL,0,0,5,0,5
2009,Eritrea,ERI,Colombia,COL,0,0,5,0,5
2009,Ethiopia,ETH,Colombia,COL,0,0,5,0,5
2009,Venezuela (Bolivarian Republic of),VEN,Colombia,COL,0,0,5,0,5
2009,Afghanistan,AFG,Cyprus,CYP,0,0,5,0,5
2009,Egypt,EGY,Cyprus,CYP,0,0,35,16,51
2009,Armenia,ARM,Cyprus,CYP,0,5,0,0,5
2009,Bangladesh,BGD,Cyprus,CYP,0,0,171,42,213
2009,China,CHN,Cyprus,CYP,0,0,0,29,29
2009,Cameroon,CMR,Cyprus,CYP,0,0,17,10,27
2009,Palestinian,PSE,Cyprus,CYP,5,5,13,5,28
2009,Georgia,GEO,Cyprus,CYP,0,0,5,24,29
2009,Ghana,GHA,Cyprus,CYP,0,0,0,5,5
2009,Cote d'Ivoire,CIV,Cyprus,CYP,0,0,0,5,5
2009,India,IND,Cyprus,CYP,0,0,195,65,260
2009,Iran (Islamic Rep. of),IRN,Cyprus,CYP,5,0,38,35,78
2009,Iraq,IRQ,Cyprus,CYP,0,0,35,0,35
2009,Jordan,JOR,Cyprus,CYP,0,0,12,5,17
2009,Kazakhstan,KAZ,Cyprus,CYP,0,0,5,0,5
2009,Lebanon,LBN,Cyprus,CYP,0,0,5,5,10
2009,Sri Lanka,LKA,Cyprus,CYP,0,5,483,62,550
2009,Rep. of Moldova,MDA,Cyprus,CYP,0,0,5,5,10
2009,Mongolia,MNG,Cyprus,CYP,0,0,5,14,19
2009,Morocco,MAR,Cyprus,CYP,0,0,5,0,5
2009,Nepal,NPL,Cyprus,CYP,0,0,163,34,197
2009,Nigeria,NGA,Cyprus,CYP,0,0,180,13,193
2009,Pakistan,PAK,Cyprus,CYP,0,5,161,37,203
2009,Philippines,PHL,Cyprus,CYP,0,0,14,10,24
2009,Russian Federation,RUS,Cyprus,CYP,0,0,18,15,33
2009,Serbia and Kosovo: S/RES/1244 (1999),SRB,Cyprus,CYP,0,0,0,5,5
2009,Viet Nam,VNM,Cyprus,CYP,0,0,5,5,10
2009,Syrian Arab Rep.,SYR,Cyprus,CYP,10,10,345,135,500
2009,Turkey,TUR,Cyprus,CYP,0,0,21,10,31
2009,Ukraine,UKR,Cyprus,CYP,0,0,0,10,10
2009,Uzbekistan,UZB,Cyprus,CYP,0,0,5,10,15
2009,Algeria,DZA,Czechia,CZE,0,0,5,5,10
2009,Armenia,ARM,Czechia,CZE,5,0,10,5,20
2009,Azerbaijan,AZE,Czechia,CZE,0,0,5,0,5
2009,Belarus,BLR,Czechia,CZE,10,0,46,12,68
2009,China,CHN,Czechia,CZE,0,0,5,5,10
2009,Cameroon,CMR,Czechia,CZE,0,0,5,0,5
2009,Dem. Rep. of the Congo,COD,Czechia,CZE,5,0,5,5,15
2009,Georgia,GEO,Czechia,CZE,0,0,18,13,31
2009,Kazakhstan,KAZ,Czechia,CZE,5,0,55,0,60
2009,Kyrgyzstan,KGZ,Czechia,CZE,5,0,14,0,19
2009,Sri Lanka,LKA,Czechia,CZE,0,0,0,5,5
2009,North Macedonia,MKD,Czechia,CZE,0,0,5,0,5
2009,Rep. of Moldova,MDA,Czechia,CZE,0,0,5,0,5
2009,Mongolia,MNG,Czechia,CZE,5,0,60,37,102
2009,Nigeria,NGA,Czechia,CZE,5,0,19,12,36
2009,Philippines,PHL,Czechia,CZE,0,0,0,31,31
2009,Russian Federation,RUS,Czechia,CZE,13,0,29,5,47
2009,Serbia and Kosovo: S/RES/1244 (1999),SRB,Czechia,CZE,5,0,5,5,15
2009,Viet Nam,VNM,Czechia,CZE,0,0,18,16,34
2009,Syrian Arab Rep.,SYR,Czechia,CZE,10,0,5,0,15
2009,Turkey,TUR,Czechia,CZE,5,0,19,28,52
2009,Ukraine,UKR,Czechia,CZE,21,0,84,31,136
2009,Uzbekistan,UZB,Czechia,CZE,5,0,5,0,10
2009,Stateless,XXA,Czechia,CZE,5,0,5,10,20
2009,Afghanistan,AFG,Denmark,DNK,5,16,47,0,68
2009,Azerbaijan,AZE,Denmark,DNK,0,0,5,0,5
2009,Burundi,BDI,Denmark,DNK,0,0,5,0,5
2009,Bosnia and Herzegovina,BIH,Denmark,DNK,0,0,13,0,13
2009,Ghana,GHA,Denmark,DNK,0,0,5,0,5
2009,India,IND,Denmark,DNK,0,0,5,0,5
2009,Iran (Islamic Rep. of),IRN,Denmark,DNK,16,5,18,0,39
2009,Iraq,IRQ,Denmark,DNK,27,31,67,0,125
2009,Lebanon,LBN,Denmark,DNK,0,0,5,0,5
2009,Sri Lanka,LKA,Denmark,DNK,5,5,5,0,15
2009,Morocco,MAR,Denmark,DNK,0,0,5,0,5
2009,Nigeria,NGA,Denmark,DNK,0,5,13,0,18
2009,Pakistan,PAK,Denmark,DNK,0,5,5,0,10
2009,Russian Federation,RUS,Denmark,DNK,0,5,14,0,19
2009,Serbia and Kosovo: S/RES/1244 (1999),SRB,Denmark,DNK,0,0,17,0,17
2009,Somalia,SOM,Denmark,DNK,0,0,13,0,13
2009,Syrian Arab Rep.,SYR,Denmark,DNK,5,0,0,0,5
2009,Tunisia,TUN,Denmark,DNK,0,0,5,0,5
2009,Uganda,UGA,Denmark,DNK,0,0,5,0,5
2009,Zimbabwe,ZWE,Denmark,DNK,0,0,5,0,5
2009,Stateless,XXA,Denmark,DNK,5,0,15,0,20
2009,Unknown ,,France,FRA,4042,1321,11602,3275,20240
2009,Unknown ,,Greece,GRC,25,11,834,0,870
2009,Bosnia and Herzegovina,BIH,Croatia,HRV,0,0,5,0,5
2009,Iran (Islamic Rep. of),IRN,Croatia,HRV,0,0,5,5,10
2009,Nigeria,NGA,Croatia,HRV,0,0,0,5,5
2009,Pakistan,PAK,Croatia,HRV,0,0,0,5,5
2009,Russian Federation,RUS,Croatia,HRV,5,0,0,0,5
2009,Serbia and Kosovo: S/RES/1244 (1999),SRB,Iceland,ISL,0,0,5,5,10
2009,Afghanistan,AFG,Ireland,IRL,24,0,70,10,104
2009,Albania,ALB,Ireland,IRL,0,0,68,14,82
2009,Algeria,DZA,Ireland,IRL,0,0,46,16,62
2009,Angola,AGO,Ireland,IRL,10,0,39,5,54
2009,Egypt,EGY,Ireland,IRL,0,0,12,0,12
2009,Armenia,ARM,Ireland,IRL,0,0,5,0,5
2009,Azerbaijan,AZE,Ireland,IRL,0,0,5,0,5
2009,Bahrain,BHR,Ireland,IRL,0,0,5,0,5
2009,Burundi,BDI,Ireland,IRL,0,0,21,0,21
2009,Benin,BEN,Ireland,IRL,0,0,5,0,5
2009,Bangladesh,BGD,Ireland,IRL,0,0,47,0,47
2009,Bhutan,BTN,Ireland,IRL,0,0,43,5,48
2009,Belarus,BLR,Ireland,IRL,5,0,14,0,19
2009,Brazil,BRA,Ireland,IRL,0,0,5,0,5
2009,China,CHN,Ireland,IRL,0,0,36,5,41
2009,Cameroon,CMR,Ireland,IRL,5,0,63,5,73
2009,Congo,COG,Ireland,IRL,0,0,17,0,17
2009,Dem. Rep. of the Congo,COD,Ireland,IRL,10,0,137,5,152
2009,Eritrea,ERI,Ireland,IRL,5,0,34,5,44
2009,Ethiopia,ETH,Ireland,IRL,5,0,5,0,10
2009,Gambia,GMB,Ireland,IRL,0,0,5,0,5
2009,Palestinian,PSE,Ireland,IRL,5,0,10,10,25
2009,Georgia,GEO,Ireland,IRL,5,0,177,32,214
2009,Ghana,GHA,Ireland,IRL,5,0,86,0,91
2009,Guinea-Bissau,GNB,Ireland,IRL,0,0,5,0,5
2009,Guinea,GIN,Ireland,IRL,0,0,20,0,20
2009,Croatia,HRV,Ireland,IRL,10,0,14,0,24
2009,Cote d'Ivoire,CIV,Ireland,IRL,5,0,24,0,29
2009,India,IND,Ireland,IRL,0,0,17,0,17
2009,Iran (Islamic Rep. of),IRN,Ireland,IRL,22,0,32,23,77
2009,Iraq,IRQ,Ireland,IRL,50,0,57,12,119
2009,Israel,ISR,Ireland,IRL,0,0,15,0,15
2009,Jamaica,JAM,Ireland,IRL,0,0,5,0,5
2009,Jordan,JOR,Ireland,IRL,0,0,5,0,5
2009,Kazakhstan,KAZ,Ireland,IRL,0,0,5,0,5
2009,Kenya,KEN,Ireland,IRL,0,0,35,0,35
2009,Kuwait,KWT,Ireland,IRL,0,0,10,5,15
2009,Liberia,LBR,Ireland,IRL,0,0,36,0,36
2009,Libya,LBY,Ireland,IRL,0,0,5,0,5
2009,Sri Lanka,LKA,Ireland,IRL,5,0,10,0,15
2009,Rep. of Moldova,MDA,Ireland,IRL,5,0,99,5,109
2009,Malaysia,MYS,Ireland,IRL,0,0,10,0,10
2009,Malawi,MWI,Ireland,IRL,0,0,14,0,14
2009,Mongolia,MNG,Ireland,IRL,0,0,5,0,5
2009,Morocco,MAR,Ireland,IRL,5,0,15,0,20
2009,Mauritius,MUS,Ireland,IRL,0,0,18,0,18
2009,Myanmar,MMR,Ireland,IRL,5,0,10,0,15
2009,Nepal,NPL,Ireland,IRL,0,0,14,0,14
2009,Niger,NER,Ireland,IRL,0,0,10,0,10
2009,Nigeria,NGA,Ireland,IRL,25,0,800,64,889
2009,Pakistan,PAK,Ireland,IRL,10,0,230,32,272
2009,Romania,ROU,Ireland,IRL,0,0,5,0,5
2009,South Africa,ZAF,Ireland,IRL,5,0,55,0,60
2009,Russian Federation,RUS,Ireland,IRL,5,0,25,5,35
2009,Rwanda,RWA,Ireland,IRL,0,0,10,0,10
2009,Serbia and Kosovo: S/RES/1244 (1999),SRB,Ireland,IRL,5,0,34,10,49
2009,Sierra Leone,SLE,Ireland,IRL,0,0,23,0,23
2009,Somalia,SOM,Ireland,IRL,10,0,48,5,63
2009,Sudan,SDN,Ireland,IRL,5,0,71,15,91
2009,Eswatini,SWZ,Ireland,IRL,0,0,5,0,5
2009,Syrian Arab Rep.,SYR,Ireland,IRL,0,0,5,5,10
2009,Togo,TGO,Ireland,IRL,0,0,27,5,32
2009,Turkey,TUR,Ireland,IRL,0,0,5,5,10
2009,Uganda,UGA,Ireland,IRL,0,0,35,0,35
2009,Ukraine,UKR,Ireland,IRL,0,0,39,5,44
2009,Uzbekistan,UZB,Ireland,IRL,0,0,5,0,5
2009,Zimbabwe,ZWE,Ireland,IRL,5,0,107,5,117
2009,Stateless,XXA,Ireland,IRL,0,0,0,5,5
2009,Iran (Islamic Rep. of),IRN,Japan,JPN,0,0,13,0,13
2009,Sri Lanka,LKA,Japan,JPN,0,0,18,5,23
2009,Myanmar,MMR,Japan,JPN,5,0,112,10,127
2009,Pakistan,PAK,Japan,JPN,0,0,10,5,15
2009,Turkey,TUR,Japan,JPN,0,0,41,28,69
2009,Unknown ,,Japan,JPN,5,0,38,21,64
2009,Rwanda,RWA,Malawi,MWI,0,0,0,132,132
2009,Burundi,BDI,Mozambique,MOZ,0,0,0,5,5
2009,Dem. Rep. of the Congo,COD,Mozambique,MOZ,0,0,0,21,21
2009,Gambia,GMB,Malta,MLT,0,0,10,0,10
2009,Palestinian,PSE,Malta,MLT,0,0,5,0,5
2009,Ghana,GHA,Malta,MLT,0,0,5,40,45
2009,Guinea,GIN,Malta,MLT,0,0,5,0,5
2009,Cote d'Ivoire,CIV,Malta,MLT,0,0,17,0,17
2009,India,IND,Malta,MLT,0,0,0,10,10
2009,Mali,MLI,Malta,MLT,0,0,20,0,20
2009,Niger,NER,Malta,MLT,0,0,5,0,5
2009,Nigeria,NGA,Malta,MLT,0,0,64,5,69
2009,Somalia,SOM,Malta,MLT,0,0,34,0,34
2009,Sudan,SDN,Malta,MLT,0,0,5,0,5
2009,Unknown ,,Malta,MLT,0,0,0,5,5
2009,Chad,TCD,Niger,NER,0,0,5,0,5
2009,Afghanistan,AFG,Norway,NOR,0,53,318,17,388
2009,Albania,ALB,Norway,NOR,0,0,34,0,34
2009,Algeria,DZA,Norway,NOR,0,0,82,0,82
2009,Angola,AGO,Norway,NOR,0,0,20,0,20
2009,Egypt,EGY,Norway,NOR,0,0,5,0,5
2009,Armenia,ARM,Norway,NOR,0,0,10,0,10
2009,Azerbaijan,AZE,Norway,NOR,0,0,47,0,47
2009,Burundi,BDI,Norway,NOR,0,10,124,0,134
2009,Bangladesh,BGD,Norway,NOR,0,0,13,0,13
2009,Bhutan,BTN,Norway,NOR,0,0,24,0,24
2009,Burkina Faso,BFA,Norway,NOR,0,0,5,0,5
2009,Belarus,BLR,Norway,NOR,0,0,12,0,12
2009,Bosnia and Herzegovina,BIH,Norway,NOR,0,0,10,0,10
2009,Bulgaria,BGR,Norway,NOR,0,0,5,0,5
2009,Chad,TCD,Norway,NOR,0,0,5,0,5
2009,China,CHN,Norway,NOR,0,0,16,0,16
2009,Cameroon,CMR,Norway,NOR,0,0,42,5,47
2009,Congo,COG,Norway,NOR,0,0,12,0,12
2009,Dem. Rep. of the Congo,COD,Norway,NOR,0,10,70,10,90
2009,Cuba,CUB,Norway,NOR,0,5,0,0,5
2009,Ecuador,ECU,Norway,NOR,0,0,5,0,5
2009,Eritrea,ERI,Norway,NOR,0,10,402,23,435
2009,Ethiopia,ETH,Norway,NOR,0,15,331,5,351
2009,Gambia,GMB,Norway,NOR,0,0,23,0,23
2009,Georgia,GEO,Norway,NOR,0,0,14,0,14
2009,Ghana,GHA,Norway,NOR,0,0,46,0,46
2009,Guinea,GIN,Norway,NOR,0,0,39,0,39
2009,Croatia,HRV,Norway,NOR,0,0,5,0,5
2009,Hungary,HUN,Norway,NOR,0,0,5,0,5
2009,Cote d'Ivoire,CIV,Norway,NOR,0,0,12,0,12
2009,India,IND,Norway,NOR,0,0,11,0,11
2009,Iran (Islamic Rep. of),IRN,Norway,NOR,5,40,306,5,356
2009,Iraq,IRQ,Norway,NOR,5,14,1862,32,1913
2009,Jordan,JOR,Norway,NOR,0,0,17,0,17
2009,Kazakhstan,KAZ,Norway,NOR,0,0,5,0,5
2009,Kenya,KEN,Norway,NOR,0,0,10,0,10
2009,Kyrgyzstan,KGZ,Norway,NOR,0,5,15,0,20
2009,Rep. of Korea,KOR,Norway,NOR,0,0,32,0,32
2009,Dem. People's Rep. of Korea,PRK,Norway,NOR,0,0,22,0,22
2009,Liberia,LBR,Norway,NOR,0,0,40,5,45
2009,Libya,LBY,Norway,NOR,0,0,87,0,87
2009,Lebanon,LBN,Norway,NOR,0,0,62,0,62
2009,Sri Lanka,LKA,Norway,NOR,0,20,213,5,238
2009,Mauritania,MRT,Norway,NOR,0,0,23,0,23
2009,North Macedonia,MKD,Norway,NOR,0,0,13,5,18
2009,Rep. of Moldova,MDA,Norway,NOR,0,0,10,0,10
2009,Morocco,MAR,Norway,NOR,0,0,38,0,38
2009,Montenegro,MNE,Norway,NOR,0,0,5,0,5
2009,Myanmar,MMR,Norway,NOR,0,0,10,0,10
2009,Nepal,NPL,Norway,NOR,0,0,100,0,100
2009,Niger,NER,Norway,NOR,0,0,10,0,10
2009,Nigeria,NGA,Norway,NOR,0,0,389,10,399
2009,Pakistan,PAK,Norway,NOR,0,5,48,5,58
2009,Philippines,PHL,Norway,NOR,0,0,5,0,5
2009,Romania,ROU,Norway,NOR,0,0,5,0,5
2009,Russian Federation,RUS,Norway,NOR,21,122,907,25,1075
2009,Rwanda,RWA,Norway,NOR,0,0,23,0,23
2009,Serbia and Kosovo: S/RES/1244 (1999),SRB,Norway,NOR,5,24,771,5,805
2009,Senegal,SEN,Norway,NOR,0,0,14,0,14
2009,Sierra Leone,SLE,Norway,NOR,0,0,21,0,21
2009,Somalia,SOM,Norway,NOR,5,32,657,33,727
2009,Viet Nam,VNM,Norway,NOR,0,0,12,0,12
2009,Sudan,SDN,Norway,NOR,0,0,39,5,44
2009,Syrian Arab Rep.,SYR,Norway,NOR,0,0,64,0,64
2009,Tajikistan,TJK,Norway,NOR,0,0,5,0,5
2009,Turkmenistan,TKM,Norway,NOR,0,0,5,0,5
2009,Togo,TGO,Norway,NOR,0,0,5,0,5
2009,Tunisia,TUN,Norway,NOR,0,0,12,0,12
2009,Turkey,TUR,Norway,NOR,0,0,59,0,59
2009,Uganda,UGA,Norway,NOR,0,0,19,0,19
2009,Ukraine,UKR,Norway,NOR,0,0,21,0,21
2009,Uzbekistan,UZB,Norway,NOR,5,11,38,5,59
2009,Western Sahara,ESH,Norway,NOR,0,0,5,0,5
2009,Yemen,YEM,Norway,NOR,0,0,15,0,15
2009,Zimbabwe,ZWE,Norway,NOR,0,0,23,0,23
2009,Stateless,XXA,Norway,NOR,0,5,262,11,278
2009,Egypt,EGY,New Zealand,NZL,0,0,5,0,5
2009,Bangladesh,BGD,New Zealand,NZL,0,0,5,0,5
2009,China,CHN,New Zealand,NZL,0,0,5,0,5
2009,Czechia,CZE,New Zealand,NZL,0,0,0,5,5
2009,Fiji,FJI,New Zealand,NZL,0,0,5,0,5
2009,Iran (Islamic Rep. of),IRN,New Zealand,NZL,22,0,10,0,32
2009,Israel,ISR,New Zealand,NZL,0,0,5,0,5
2009,Sri Lanka,LKA,New Zealand,NZL,5,0,5,0,10
2009,Malaysia,MYS,New Zealand,NZL,0,0,5,0,5
2009,Nepal,NPL,New Zealand,NZL,0,0,5,0,5
2009,Pakistan,PAK,New Zealand,NZL,0,0,5,0,5
2009,Somalia,SOM,New Zealand,NZL,5,0,0,0,5
2009,Syrian Arab Rep.,SYR,New Zealand,NZL,0,0,0,5,5
2009,Turkey,TUR,New Zealand,NZL,0,0,5,0,5
2009,Armenia,ARM,Poland,POL,0,0,0,5,5
2009,Bangladesh,BGD,Poland,POL,0,0,0,5,5
2009,Belarus,BLR,Poland,POL,0,0,0,5,5
2009,Georgia,GEO,Poland,POL,0,0,0,55,55
2009,Kazakhstan,KAZ,Poland,POL,0,5,0,0,5
2009,Russian Federation,RUS,Poland,POL,0,69,5,303,377
2009,Uzbekistan,UZB,Poland,POL,0,0,0,5,5
2009,Afghanistan,AFG,Sweden,SWE,26,76,334,31,467
2009,Albania,ALB,Sweden,SWE,0,0,82,5,87
2009,Algeria,DZA,Sweden,SWE,0,0,54,5,59
2009,Angola,AGO,Sweden,SWE,0,5,11,0,16
2009,Egypt,EGY,Sweden,SWE,5,0,43,5,53
2009,Argentina,ARG,Sweden,SWE,0,0,5,0,5
2009,Armenia,ARM,Sweden,SWE,5,15,134,35,189
2009,Azerbaijan,AZE,Sweden,SWE,0,10,168,35,213
2009,Burundi,BDI,Sweden,SWE,0,5,84,11,100
2009,Benin,BEN,Sweden,SWE,0,0,5,0,5
2009,Bangladesh,BGD,Sweden,SWE,0,0,67,10,77
2009,Bhutan,BTN,Sweden,SWE,0,0,5,0,5
2009,Belarus,BLR,Sweden,SWE,5,0,140,27,172
2009,Bolivia (Plurinational State of),BOL,Sweden,SWE,0,0,29,5,34
2009,Bosnia and Herzegovina,BIH,Sweden,SWE,0,5,77,5,87
2009,Bulgaria,BGR,Sweden,SWE,0,0,5,0,5
2009,China,CHN,Sweden,SWE,5,0,40,10,55
2009,Chile,CHL,Sweden,SWE,0,0,10,5,15
2009,Cameroon,CMR,Sweden,SWE,0,0,31,5,36
2009,Congo,COG,Sweden,SWE,0,0,5,0,5
2009,Dem. Rep. of the Congo,COD,Sweden,SWE,5,15,37,0,57
2009,Colombia,COL,Sweden,SWE,0,0,5,5,10
2009,Cuba,CUB,Sweden,SWE,0,0,5,0,5
2009,Ecuador,ECU,Sweden,SWE,0,0,5,0,5
2009,Eritrea,ERI,Sweden,SWE,14,55,134,23,226
2009,Ethiopia,ETH,Sweden,SWE,5,5,113,18,141
2009,Gambia,GMB,Sweden,SWE,0,0,13,0,13
2009,Georgia,GEO,Sweden,SWE,0,0,98,19,117
2009,Ghana,GHA,Sweden,SWE,0,0,15,5,20
2009,Guinea,GIN,Sweden,SWE,0,0,19,0,19
2009,Croatia,HRV,Sweden,SWE,0,0,23,10,33
2009,Cote d'Ivoire,CIV,Sweden,SWE,0,0,26,0,26
2009,India,IND,Sweden,SWE,0,0,40,5,45
2009,Indonesia,IDN,Sweden,SWE,0,0,5,0,5
2009,Iran (Islamic Rep. of),IRN,Sweden,SWE,44,43,371,40,498
2009,Iraq,IRQ,Sweden,SWE,90,418,5113,825,6446
2009,Israel,ISR,Sweden,SWE,0,0,17,5,22
2009,Jordan,JOR,Sweden,SWE,0,10,59,27,96
2009,Kazakhstan,KAZ,Sweden,SWE,0,0,157,23,180
2009,Kenya,KEN,Sweden,SWE,0,5,20,10,35
2009,Kyrgyzstan,KGZ,Sweden,SWE,0,0,23,5,28
2009,Libya,LBY,Sweden,SWE,5,5,259,46,315
2009,Lebanon,LBN,Sweden,SWE,5,16,242,35,298
2009,Sri Lanka,LKA,Sweden,SWE,0,0,14,0,14
2009,Latvia,LVA,Sweden,SWE,0,0,5,0,5
2009,North Macedonia,MKD,Sweden,SWE,0,0,25,10,35
2009,Rep. of Moldova,MDA,Sweden,SWE,0,0,10,0,10
2009,Mongolia,MNG,Sweden,SWE,0,5,446,31,482
2009,Morocco,MAR,Sweden,SWE,0,5,35,10,50
2009,Montenegro,MNE,Sweden,SWE,0,0,26,5,31
2009,Nepal,NPL,Sweden,SWE,0,0,48,0,48
2009,Nicaragua,NIC,Sweden,SWE,0,0,26,5,31
2009,Nigeria,NGA,Sweden,SWE,0,5,86,21,112
2009,Pakistan,PAK,Sweden,SWE,0,5,52,5,62
2009,Peru,PER,Sweden,SWE,0,0,14,0,14
2009,Philippines,PHL,Sweden,SWE,0,0,5,0,5
2009,Romania,ROU,Sweden,SWE,0,0,0,5,5
2009,Russian Federation,RUS,Sweden,SWE,5,23,458,79,565
2009,Rwanda,RWA,Sweden,SWE,0,0,5,5,10
2009,El Salvador,SLV,Sweden,SWE,0,5,34,5,44
2009,Serbia and Kosovo: S/RES/1244 (1999),SRB,Sweden,SWE,15,70,1462,115,1662
2009,Senegal,SEN,Sweden,SWE,0,0,15,0,15
2009,Sierra Leone,SLE,Sweden,SWE,0,0,13,0,13
2009,Somalia,SOM,Sweden,SWE,15,411,581,70,1077
2009,Viet Nam,VNM,Sweden,SWE,0,0,26,5,31
2009,Sudan,SDN,Sweden,SWE,0,10,29,5,44
2009,Syrian Arab Rep.,SYR,Sweden,SWE,0,13,363,45,421
2009,United Rep. of Tanzania,TZA,Sweden,SWE,0,5,10,5,20
2009,Thailand,THA,Sweden,SWE,0,0,12,0,12
2009,Turkmenistan,TKM,Sweden,SWE,0,0,5,0,5
2009,Togo,TGO,Sweden,SWE,0,0,11,0,11
2009,Tunisia,TUN,Sweden,SWE,0,0,43,5,48
2009,Turkey,TUR,Sweden,SWE,5,14,175,27,221
2009,Uganda,UGA,Sweden,SWE,0,5,15,0,20
2009,Ukraine,UKR,Sweden,SWE,0,0,28,0,28
2009,Uzbekistan,UZB,Sweden,SWE,5,5,401,39,450
2009,Venezuela (Bolivarian Republic of),VEN,Sweden,SWE,0,0,5,0,5
2009,Yemen,YEM,Sweden,SWE,5,5,53,5,68
2009,Zimbabwe,ZWE,Sweden,SWE,0,0,13,0,13
2009,Stateless,XXA,Sweden,SWE,10,64,427,94,595
2009,Unknown ,,Sweden,SWE,0,27,277,31,335
2009,Afghanistan,AFG,Ukraine,UKR,5,0,72,36,113
2009,Algeria,DZA,Ukraine,UKR,0,0,5,0,5
2009,Azerbaijan,AZE,Ukraine,UKR,0,0,0,5,5
2009,Bangladesh,BGD,Ukraine,UKR,0,0,13,0,13
2009,Belarus,BLR,Ukraine,UKR,0,0,0,5,5
2009,Dem. Rep. of the Congo,COD,Ukraine,UKR,0,0,5,5,10
2009,Ethiopia,ETH,Ukraine,UKR,0,0,5,0,5
2009,Palestinian,PSE,Ukraine,UKR,0,0,13,0,13
2009,Georgia,GEO,Ukraine,UKR,0,0,5,5,10
2009,Guinea,GIN,Ukraine,UKR,0,0,5,0,5
2009,India,IND,Ukraine,UKR,0,0,5,10,15
2009,Iran (Islamic Rep. of),IRN,Ukraine,UKR,0,0,5,0,5
2009,Iraq,IRQ,Ukraine,UKR,5,0,11,5,21
2009,Lebanon,LBN,Ukraine,UKR,0,0,5,5,10
2009,Sri Lanka,LKA,Ukraine,UKR,0,0,5,0,5
2009,Nepal,NPL,Ukraine,UKR,0,0,5,0,5
2009,Nigeria,NGA,Ukraine,UKR,0,0,5,5,10
2009,Pakistan,PAK,Ukraine,UKR,0,0,10,5,15
2009,Russian Federation,RUS,Ukraine,UKR,5,0,5,5,15
2009,Saudi Arabia,SAU,Ukraine,UKR,0,0,0,5,5
2009,Somalia,SOM,Ukraine,UKR,0,0,27,10,37
2009,Sudan,SDN,Ukraine,UKR,0,0,5,5,10
2009,Syrian Arab Rep.,SYR,Ukraine,UKR,0,0,10,10,20
2009,Uzbekistan,UZB,Ukraine,UKR,0,0,0,5,5
2009,Stateless,XXA,Ukraine,UKR,0,0,5,0,5
2010,Georgia,GEO,Armenia,ARM,0,0,10,0,10
2010,Unknown ,,Belgium,BEL,142,54,4508,0,4704
2010,Chad,TCD,Benin,BEN,0,0,18,0,18
2010,Dem. Rep. of the Congo,COD,Benin,BEN,5,0,0,5,10
2010,Nigeria,NGA,Benin,BEN,0,0,15,0,15
2010,Togo,TGO,Benin,BEN,0,0,10,0,10
2010,Afghanistan,AFG,Belarus,BLR,0,0,77,0,77
2010,Pakistan,PAK,Belarus,BLR,0,0,5,0,5
2010,Russian Federation,RUS,Belarus,BLR,0,0,5,0,5
2010,Afghanistan,AFG,Cyprus,CYP,0,0,5,5,10
2010,Egypt,EGY,Cyprus,CYP,0,14,294,40,348
2010,Armenia,ARM,Cyprus,CYP,0,0,0,5,5
2010,Bangladesh,BGD,Cyprus,CYP,0,0,144,26,170
2010,China,CHN,Cyprus,CYP,0,0,165,39,204
2010,Cameroon,CMR,Cyprus,CYP,0,0,45,10,55
2010,Dem. Rep. of the Congo,COD,Cyprus,CYP,0,5,0,0,5
2010,Ethiopia,ETH,Cyprus,CYP,0,0,0,5,5
2010,Palestinian,PSE,Cyprus,CYP,5,0,194,23,222
2010,Georgia,GEO,Cyprus,CYP,0,5,287,69,361
2010,Ghana,GHA,Cyprus,CYP,0,0,5,5,10
2010,India,IND,Cyprus,CYP,0,0,422,100,522
2010,Iran (Islamic Rep. of),IRN,Cyprus,CYP,10,17,135,51,213
2010,Iraq,IRQ,Cyprus,CYP,0,0,56,5,61
2010,Jordan,JOR,Cyprus,CYP,0,0,5,5,10
2010,Lebanon,LBN,Cyprus,CYP,0,0,5,12,17
2010,Sri Lanka,LKA,Cyprus,CYP,5,0,110,22,137
2010,Rep. of Moldova,MDA,Cyprus,CYP,0,0,5,5,10
2010,Mongolia,MNG,Cyprus,CYP,0,0,17,5,22
2010,Morocco,MAR,Cyprus,CYP,0,0,0,5,5
2010,Nepal,NPL,Cyprus,CYP,0,0,5,5,10
2010,Nigeria,NGA,Cyprus,CYP,0,0,104,5,109
2010,Pakistan,PAK,Cyprus,CYP,0,0,139,34,173
2010,Philippines,PHL,Cyprus,CYP,0,0,154,16,170
2010,Russian Federation,RUS,Cyprus,CYP,0,0,5,5,10
2010,Serbia and Kosovo: S/RES/1244 (1999),SRB,Cyprus,CYP,0,5,0,5,10
2010,Viet Nam,VNM,Cyprus,CYP,0,0,133,14,147
2010,Syrian Arab Rep.,SYR,Cyprus,CYP,0,16,203,104,323
2010,Turkey,TUR,Cyprus,CYP,0,5,12,0,17
2010,Ukraine,UKR,Cyprus,CYP,0,0,5,22,27
2010,Uzbekistan,UZB,Cyprus,CYP,0,0,5,5,10
2010,Algeria,DZA,Czechia,CZE,0,0,5,5,10
2010,Armenia,ARM,Czechia,CZE,5,0,5,0,10
2010,Belarus,BLR,Czechia,CZE,10,0,24,11,45
2010,China,CHN,Czechia,CZE,0,0,5,0,5
2010,Dem. Rep. of the Congo,COD,Czechia,CZE,5,0,0,5,10
2010,Georgia,GEO,Czechia,CZE,0,0,10,0,10
2010,Kazakhstan,KAZ,Czechia,CZE,15,0,5,0,20
2010,Kyrgyzstan,KGZ,Czechia,CZE,0,0,13,5,18
2010,Sri Lanka,LKA,Czechia,CZE,0,0,0,5,5
2010,Rep. of Moldova,MDA,Czechia,CZE,0,0,10,0,10
2010,Mongolia,MNG,Czechia,CZE,10,0,57,38,105
2010,Nigeria,NGA,Czechia,CZE,5,0,5,5,15
2010,Russian Federation,RUS,Czechia,CZE,10,0,5,5,20
2010,Serbia and Kosovo: S/RES/1244 (1999),SRB,Czechia,CZE,0,0,10,0,10
2010,Somalia,SOM,Czechia,CZE,5,0,0,0,5
2010,Viet Nam,VNM,Czechia,CZE,5,0,10,11,26
2010,Syrian Arab Rep.,SYR,Czechia,CZE,0,0,15,0,15
2010,Turkey,TUR,Czechia,CZE,17,0,10,10,37
2010,Ukraine,UKR,Czechia,CZE,23,0,69,22,114
2010,Uzbekistan,UZB,Czechia,CZE,5,0,5,0,10
2010,Stateless,XXA,Czechia,CZE,0,0,5,0,5
2010,Afghanistan,AFG,Denmark,DNK,10,80,283,0,373
2010,Armenia,ARM,Denmark,DNK,0,0,20,0,20
2010,Palestinian,PSE,Denmark,DNK,0,5,22,0,27
2010,Iran (Islamic Rep. of),IRN,Denmark,DNK,34,14,52,0,100
2010,Iraq,IRQ,Denmark,DNK,5,10,54,0,69
2010,Sri Lanka,LKA,Denmark,DNK,0,5,47,0,52
2010,Russian Federation,RUS,Denmark,DNK,5,11,21,0,37
2010,Serbia and Kosovo: S/RES/1244 (1999),SRB,Denmark,DNK,0,0,26,0,26
2010,Somalia,SOM,Denmark,DNK,0,5,37,0,42
2010,Syrian Arab Rep.,SYR,Denmark,DNK,32,11,63,0,106
2010,Unknown ,,Denmark,DNK,24,5,138,0,167
2010,Algeria,DZA,France,FRA,13,12,524,0,549
2010,Angola,AGO,France,FRA,44,5,229,0,278
2010,Armenia,ARM,France,FRA,164,50,1554,0,1768
2010,Azerbaijan,AZE,France,FRA,83,5,295,0,383
2010,Bangladesh,BGD,France,FRA,338,5,1289,0,1632
2010,China,CHN,France,FRA,12,0,734,0,746
2010,Congo,COG,France,FRA,69,15,538,0,622
2010,Dem. Rep. of the Congo,COD,France,FRA,325,28,1495,0,1848
2010,Guinea,GIN,France,FRA,175,68,799,0,1042
2010,Haiti,HTI,France,FRA,14,22,786,0,822
2010,Cote d'Ivoire,CIV,France,FRA,28,10,287,0,325
2010,Sri Lanka,LKA,France,FRA,842,160,1750,0,2752
2010,Mauritania,MRT,France,FRA,93,25,711,0,829
2010,Mali,MLI,France,FRA,10,179,173,0,362
2010,Nigeria,NGA,France,FRA,21,25,435,0,481
2010,Pakistan,PAK,France,FRA,38,5,346,0,389
2010,Russian Federation,RUS,France,FRA,754,55,973,0,1782
2010,Serbia and Kosovo: S/RES/1244 (1999),SRB,France,FRA,331,157,1678,0,2166
2010,Turkey,TUR,France,FRA,357,18,1577,0,1952
2010,Unknown ,,France,FRA,536,192,2480,0,3208
2010,Unknown ,,United Kingdom of Great Britain and Northern Ireland,GBR,4835,0,12090,1010,17935
2010,Iran (Islamic Rep. of),IRN,Greece,GRC,32,0,0,0,32
2010,Unknown ,,Greece,GRC,0,0,5,0,5
2010,Afghanistan,AFG,Croatia,HRV,0,0,5,5,10
2010,Bosnia and Herzegovina,BIH,Croatia,HRV,0,0,11,0,11
2010,Georgia,GEO,Croatia,HRV,0,5,0,0,5
2010,Iran (Islamic Rep. of),IRN,Croatia,HRV,0,0,0,5,5
2010,Pakistan,PAK,Croatia,HRV,0,0,0,5,5
2010,Russian Federation,RUS,Croatia,HRV,0,0,5,0,5
2010,Serbia and Kosovo: S/RES/1244 (1999),SRB,Croatia,HRV,0,0,18,0,18
2010,Ukraine,UKR,Croatia,HRV,0,0,5,0,5
2010,Afghanistan,AFG,Ireland,IRL,13,0,35,0,48
2010,Albania,ALB,Ireland,IRL,5,0,44,0,49
2010,Algeria,DZA,Ireland,IRL,0,0,47,5,52
2010,Angola,AGO,Ireland,IRL,5,0,33,0,38
2010,Egypt,EGY,Ireland,IRL,0,0,10,0,10
2010,Armenia,ARM,Ireland,IRL,0,0,12,0,12
2010,Burundi,BDI,Ireland,IRL,0,0,5,0,5
2010,Benin,BEN,Ireland,IRL,0,0,18,0,18
2010,Bangladesh,BGD,Ireland,IRL,0,0,55,0,55
2010,Bhutan,BTN,Ireland,IRL,0,0,15,0,15
2010,Belarus,BLR,Ireland,IRL,0,0,5,0,5
2010,Bolivia (Plurinational State of),BOL,Ireland,IRL,0,0,5,0,5
2010,Chad,TCD,Ireland,IRL,0,0,5,0,5
2010,China,CHN,Ireland,IRL,0,0,31,5,36
2010,Cameroon,CMR,Ireland,IRL,5,0,74,0,79
2010,Congo,COG,Ireland,IRL,0,0,10,0,10
2010,Dem. Rep. of the Congo,COD,Ireland,IRL,5,0,139,0,144
2010,Cabo Verde,CPV,Ireland,IRL,0,0,5,0,5
2010,Eritrea,ERI,Ireland,IRL,5,0,19,0,24
2010,Ethiopia,ETH,Ireland,IRL,0,0,10,0,10
2010,Palestinian,PSE,Ireland,IRL,5,0,13,0,18
2010,Georgia,GEO,Ireland,IRL,5,0,64,5,74
2010,Ghana,GHA,Ireland,IRL,0,0,109,0,109
2010,Guinea,GIN,Ireland,IRL,0,0,22,0,22
2010,Guyana,GUY,Ireland,IRL,0,0,5,0,5
2010,Croatia,HRV,Ireland,IRL,0,0,16,0,16
2010,Cote d'Ivoire,CIV,Ireland,IRL,0,0,10,0,10
2010,India,IND,Ireland,IRL,0,0,13,5,18
2010,Iran (Islamic Rep. of),IRN,Ireland,IRL,10,0,31,0,41
2010,Iraq,IRQ,Ireland,IRL,0,0,77,10,87
2010,Israel,ISR,Ireland,IRL,5,0,5,0,10
2010,Kenya,KEN,Ireland,IRL,0,0,34,0,34
2010,Kuwait,KWT,Ireland,IRL,0,0,10,0,10
2010,Liberia,LBR,Ireland,IRL,0,0,13,0,13
2010,Sri Lanka,LKA,Ireland,IRL,0,0,10,5,15
2010,Rep. of Moldova,MDA,Ireland,IRL,5,0,37,5,47
2010,Malawi,MWI,Ireland,IRL,0,0,20,0,20
2010,Morocco,MAR,Ireland,IRL,0,0,5,0,5
2010,Mauritius,MUS,Ireland,IRL,0,0,18,0,18
2010,Myanmar,MMR,Ireland,IRL,0,0,5,0,5
2010,Nepal,NPL,Ireland,IRL,0,0,12,0,12
2010,Niger,NER,Ireland,IRL,0,0,5,0,5
2010,Nigeria,NGA,Ireland,IRL,14,0,657,82,753
2010,Pakistan,PAK,Ireland,IRL,5,0,216,10,231
2010,South Africa,ZAF,Ireland,IRL,0,0,37,0,37
2010,Russian Federation,RUS,Ireland,IRL,5,0,25,0,30
2010,Rwanda,RWA,Ireland,IRL,0,0,5,0,5
2010,Serbia and Kosovo: S/RES/1244 (1999),SRB,Ireland,IRL,5,0,34,0,39
2010,Senegal,SEN,Ireland,IRL,0,0,5,0,5
2010,Sierra Leone,SLE,Ireland,IRL,0,0,39,0,39
2010,Somalia,SOM,Ireland,IRL,12,0,115,5,132
2010,Sudan,SDN,Ireland,IRL,5,0,78,5,88
2010,Syrian Arab Rep.,SYR,Ireland,IRL,0,0,5,0,5
2010,United Rep. of Tanzania,TZA,Ireland,IRL,0,0,5,0,5
2010,Togo,TGO,Ireland,IRL,0,0,13,0,13
2010,Turkey,TUR,Ireland,IRL,0,0,5,0,5
2010,Uganda,UGA,Ireland,IRL,5,0,43,0,48
2010,Ukraine,UKR,Ireland,IRL,0,0,12,0,12
2010,Zimbabwe,ZWE,Ireland,IRL,5,0,114,5,124
2010,Sri Lanka,LKA,Japan,JPN,0,0,27,17,44
2010,Myanmar,MMR,Japan,JPN,13,31,160,40,244
2010,Pakistan,PAK,Japan,JPN,0,0,14,5,19
2010,Turkey,TUR,Japan,JPN,0,5,44,16,65
2010,Unknown ,,Japan,JPN,0,0,80,35,115
2010,Unknown ,,Luxembourg,LUX,10,0,85,17,112
2010,Rwanda,RWA,Malawi,MWI,0,0,0,80,80
2010,Bangladesh,BGD,Malta,MLT,0,0,14,0,14
2010,Eritrea,ERI,Malta,MLT,0,0,5,0,5
2010,Ethiopia,ETH,Malta,MLT,0,0,0,5,5
2010,India,IND,Malta,MLT,0,0,0,5,5
2010,Nigeria,NGA,Malta,MLT,0,0,10,5,15
2010,Somalia,SOM,Malta,MLT,0,0,5,0,5
2010,Afghanistan,AFG,Norway,NOR,54,15,1275,160,1504
2010,Albania,ALB,Norway,NOR,0,0,20,0,20
2010,Algeria,DZA,Norway,NOR,0,0,109,0,109
2010,Angola,AGO,Norway,NOR,0,0,32,0,32
2010,Egypt,EGY,Norway,NOR,0,0,22,0,22
2010,Armenia,ARM,Norway,NOR,0,0,34,0,34
2010,Azerbaijan,AZE,Norway,NOR,5,0,70,0,75
2010,Burundi,BDI,Norway,NOR,0,0,76,5,81
2010,Benin,BEN,Norway,NOR,0,0,5,0,5
2010,Bangladesh,BGD,Norway,NOR,0,0,5,0,5
2010,Bhutan,BTN,Norway,NOR,0,0,15,0,15
2010,Burkina Faso,BFA,Norway,NOR,0,0,10,0,10
2010,Belarus,BLR,Norway,NOR,0,0,5,5,10
2010,Bosnia and Herzegovina,BIH,Norway,NOR,0,0,5,0,5
2010,China,CHN,Norway,NOR,0,0,10,0,10
2010,Cameroon,CMR,Norway,NOR,0,0,30,0,30
2010,Dem. Rep. of the Congo,COD,Norway,NOR,0,0,61,5,66
2010,Colombia,COL,Norway,NOR,0,0,16,0,16
2010,Czechia,CZE,Norway,NOR,0,0,5,0,5
2010,Ecuador,ECU,Norway,NOR,0,0,5,0,5
2010,Eritrea,ERI,Norway,NOR,22,5,601,69,697
2010,Ethiopia,ETH,Norway,NOR,15,12,385,10,422
2010,Gabon,GAB,Norway,NOR,0,0,5,0,5
2010,Gambia,GMB,Norway,NOR,0,0,57,0,57
2010,Palestinian,PSE,Norway,NOR,0,0,5,0,5
2010,Georgia,GEO,Norway,NOR,0,0,65,0,65
2010,Ghana,GHA,Norway,NOR,0,0,67,0,67
2010,Guinea-Bissau,GNB,Norway,NOR,0,0,10,0,10
2010,Guatemala,GTM,Norway,NOR,5,0,0,0,5
2010,Guinea,GIN,Norway,NOR,0,0,59,0,59
2010,Croatia,HRV,Norway,NOR,0,0,15,0,15
2010,Hungary,HUN,Norway,NOR,0,0,5,0,5
2010,Cote d'Ivoire,CIV,Norway,NOR,0,0,19,0,19
2010,India,IND,Norway,NOR,0,0,62,0,62
2010,Iran (Islamic Rep. of),IRN,Norway,NOR,17,12,567,15,611
2010,Iraq,IRQ,Norway,NOR,28,17,1020,33,1098
2010,Israel,ISR,Norway,NOR,0,0,11,0,11
2010,Jordan,JOR,Norway,NOR,0,0,14,0,14
2010,Kazakhstan,KAZ,Norway,NOR,0,0,20,5,25
2010,Kenya,KEN,Norway,NOR,0,0,35,0,35
2010,Kyrgyzstan,KGZ,Norway,NOR,0,0,30,0,30
2010,Dem. People's Rep. of Korea,PRK,Norway,NOR,0,0,10,0,10
2010,Liberia,LBR,Norway,NOR,0,0,38,0,38
2010,Libya,LBY,Norway,NOR,0,0,60,0,60
2010,Lebanon,LBN,Norway,NOR,0,0,49,0,49
2010,Sri Lanka,LKA,Norway,NOR,0,10,295,0,305
2010,Mauritania,MRT,Norway,NOR,0,0,39,0,39
2010,North Macedonia,MKD,Norway,NOR,0,0,73,0,73
2010,Rep. of Moldova,MDA,Norway,NOR,0,0,10,0,10
2010,Morocco,MAR,Norway,NOR,0,0,43,0,43
2010,Montenegro,MNE,Norway,NOR,5,0,5,0,10
2010,Myanmar,MMR,Norway,NOR,0,0,5,0,5
2010,Nepal,NPL,Norway,NOR,0,0,171,5,176
2010,Niger,NER,Norway,NOR,0,0,24,0,24
2010,Nigeria,NGA,Norway,NOR,0,5,470,21,496
2010,Pakistan,PAK,Norway,NOR,0,0,56,5,61
2010,Philippines,PHL,Norway,NOR,0,5,0,0,5
2010,Romania,ROU,Norway,NOR,0,0,5,0,5
2010,Russian Federation,RUS,Norway,NOR,74,45,942,27,1088
2010,Rwanda,RWA,Norway,NOR,0,0,20,0,20
2010,Serbia and Kosovo: S/RES/1244 (1999),SRB,Norway,NOR,0,15,478,10,503
2010,Senegal,SEN,Norway,NOR,0,0,25,0,25
2010,Sierra Leone,SLE,Norway,NOR,0,0,24,0,24
2010,Somalia,SOM,Norway,NOR,5,5,807,79,896
2010,Viet Nam,VNM,Norway,NOR,0,0,16,0,16
2010,Sudan,SDN,Norway,NOR,0,0,81,5,86
2010,Syrian Arab Rep.,SYR,Norway,NOR,0,5,139,10,154
2010,Tajikistan,TJK,Norway,NOR,0,0,17,0,17
2010,Turkmenistan,TKM,Norway,NOR,0,0,5,0,5
2010,Togo,TGO,Norway,NOR,0,0,10,0,10
2010,Tunisia,TUN,Norway,NOR,0,0,21,0,21
2010,Turkey,TUR,Norway,NOR,0,0,59,5,64
2010,Uganda,UGA,Norway,NOR,0,0,28,0,28
2010,Ukraine,UKR,Norway,NOR,0,0,24,0,24
2010,United States of America,USA,Norway,NOR,0,0,5,0,5
2010,Uzbekistan,UZB,Norway,NOR,0,5,165,5,175
2010,Western Sahara,ESH,Norway,NOR,0,0,5,0,5
2010,Yemen,YEM,Norway,NOR,0,0,79,0,79
2010,Zimbabwe,ZWE,Norway,NOR,0,0,38,0,38
2010,Stateless,XXA,Norway,NOR,0,11,478,25,514
2010,Algeria,DZA,New Zealand,NZL,5,0,0,0,5
2010,Egypt,EGY,New Zealand,NZL,0,0,5,0,5
2010,Bangladesh,BGD,New Zealand,NZL,0,0,5,0,5
2010,China,CHN,New Zealand,NZL,5,0,5,0,10
2010,Congo,COG,New Zealand,NZL,0,0,5,0,5
2010,Czechia,CZE,New Zealand,NZL,5,0,5,5,15
2010,Fiji,FJI,New Zealand,NZL,5,0,15,10,30
2010,India,IND,New Zealand,NZL,0,0,20,0,20
2010,Iran (Islamic Rep. of),IRN,New Zealand,NZL,15,0,10,0,25
2010,Sri Lanka,LKA,New Zealand,NZL,5,0,20,0,25
2010,Pakistan,PAK,New Zealand,NZL,0,0,5,0,5
2010,South Africa,ZAF,New Zealand,NZL,0,0,5,0,5
2010,Slovakia,SVK,New Zealand,NZL,0,0,5,5,10
2010,Armenia,ARM,Poland,POL,0,0,0,5,5
2010,Georgia,GEO,Poland,POL,0,0,5,64,69
2010,Rep. of Moldova,MDA,Poland,POL,0,0,0,5,5
2010,Russian Federation,RUS,Poland,POL,0,31,53,246,330
2010,Afghanistan,AFG,Serbia and Kosovo: S/RES/1244 (1999),SRB,0,0,23,252,275
2010,Algeria,DZA,Serbia and Kosovo: S/RES/1244 (1999),SRB,0,0,0,5,5
2010,Palestinian,PSE,Serbia and Kosovo: S/RES/1244 (1999),SRB,0,0,0,68,68
2010,Iran (Islamic Rep. of),IRN,Serbia and Kosovo: S/RES/1244 (1999),SRB,0,0,0,5,5
2010,Iraq,IRQ,Serbia and Kosovo: S/RES/1244 (1999),SRB,0,0,0,18,18
2010,Morocco,MAR,Serbia and Kosovo: S/RES/1244 (1999),SRB,0,0,0,5,5
2010,Netherlands,NLD,Serbia and Kosovo: S/RES/1244 (1999),SRB,0,0,0,5,5
2010,Pakistan,PAK,Serbia and Kosovo: S/RES/1244 (1999),SRB,0,0,0,19,19
2010,Somalia,SOM,Serbia and Kosovo: S/RES/1244 (1999),SRB,0,0,0,5,5
2010,Unknown ,,Slovakia,SVK,0,0,0,10,10
2010,Afghanistan,AFG,Ukraine,UKR,0,13,19,75,107
2010,Bangladesh,BGD,Ukraine,UKR,0,0,0,5,5
2010,Belarus,BLR,Ukraine,UKR,0,0,0,5,5
2010,Cameroon,CMR,Ukraine,UKR,0,0,0,5,5
2010,Dem. Rep. of the Congo,COD,Ukraine,UKR,0,0,5,10,15
2010,Palestinian,PSE,Ukraine,UKR,0,0,0,14,14
2010,Georgia,GEO,Ukraine,UKR,0,0,5,0,5
2010,Guinea,GIN,Ukraine,UKR,0,0,5,10,15
2010,Cote d'Ivoire,CIV,Ukraine,UKR,0,0,0,5,5
2010,India,IND,Ukraine,UKR,0,5,5,5,15
2010,Iran (Islamic Rep. of),IRN,Ukraine,UKR,0,0,0,14,14
2010,Iraq,IRQ,Ukraine,UKR,0,5,5,5,15
2010,Kyrgyzstan,KGZ,Ukraine,UKR,0,5,0,5,10
2010,Pakistan,PAK,Ukraine,UKR,0,0,0,10,10
2010,Russian Federation,RUS,Ukraine,UKR,0,0,5,0,5
2010,Somalia,SOM,Ukraine,UKR,0,0,5,21,26
2010,Syrian Arab Rep.,SYR,Ukraine,UKR,0,0,5,0,5
2010,Uzbekistan,UZB,Ukraine,UKR,0,14,0,10,24
2011,Dem. Rep. of the Congo,COD,Benin,BEN,0,0,10,0,10
2011,Nigeria,NGA,Benin,BEN,0,0,5,0,5
2011,Togo,TGO,Benin,BEN,0,0,14,0,14
2011,Afghanistan,AFG,Belarus,BLR,0,0,40,0,40
2011,Georgia,GEO,Belarus,BLR,0,0,10,0,10
2011,Russian Federation,RUS,Belarus,BLR,0,0,5,0,5
2011,Myanmar,MMR,Cambodia,KHM,0,0,5,0,5
2011,Cuba,CUB,Colombia,COL,0,0,5,0,5
2011,Peru,PER,Colombia,COL,0,0,5,0,5
2011,Venezuela (Bolivarian Republic of),VEN,Colombia,COL,0,0,5,0,5
2011,Afghanistan,AFG,Cyprus,CYP,0,0,11,5,16
2011,Algeria,DZA,Cyprus,CYP,0,0,5,0,5
2011,Egypt,EGY,Cyprus,CYP,0,5,107,0,112
2011,Armenia,ARM,Cyprus,CYP,0,0,11,5,16
2011,Bangladesh,BGD,Cyprus,CYP,0,0,94,18,112
2011,Burkina Faso,BFA,Cyprus,CYP,0,0,5,0,5
2011,China,CHN,Cyprus,CYP,0,0,52,10,62
2011,Cameroon,CMR,Cyprus,CYP,0,0,132,10,142
2011,Ethiopia,ETH,Cyprus,CYP,0,0,5,5,10
2011,Palestinian,PSE,Cyprus,CYP,5,5,1113,56,1179
2011,Georgia,GEO,Cyprus,CYP,0,0,10,29,39
2011,Ghana,GHA,Cyprus,CYP,0,0,46,5,51
2011,Guinea,GIN,Cyprus,CYP,0,0,28,0,28
2011,Cote d'Ivoire,CIV,Cyprus,CYP,0,0,5,0,5
2011,India,IND,Cyprus,CYP,0,0,184,26,210
2011,Indonesia,IDN,Cyprus,CYP,0,0,5,0,5
2011,Iran (Islamic Rep. of),IRN,Cyprus,CYP,0,0,276,58,334
2011,Iraq,IRQ,Cyprus,CYP,0,10,110,20,140
2011,Jordan,JOR,Cyprus,CYP,0,0,26,13,39
2011,Kazakhstan,KAZ,Cyprus,CYP,0,0,0,5,5
2011,Kenya,KEN,Cyprus,CYP,0,0,11,0,11
2011,Lebanon,LBN,Cyprus,CYP,0,0,20,10,30
2011,Sri Lanka,LKA,Cyprus,CYP,0,5,129,19,153
2011,Rep. of Moldova,MDA,Cyprus,CYP,0,0,0,5,5
2011,Mali,MLI,Cyprus,CYP,0,0,5,0,5
2011,Mongolia,MNG,Cyprus,CYP,0,0,15,14,29
2011,Morocco,MAR,Cyprus,CYP,0,0,14,5,19
2011,Nepal,NPL,Cyprus,CYP,0,0,132,26,158
2011,Nigeria,NGA,Cyprus,CYP,0,0,74,10,84
2011,Pakistan,PAK,Cyprus,CYP,0,0,79,20,99
2011,Philippines,PHL,Cyprus,CYP,0,0,78,5,83
2011,Russian Federation,RUS,Cyprus,CYP,0,0,5,11,16
2011,Serbia and Kosovo: S/RES/1244 (1999),SRB,Cyprus,CYP,0,0,5,0,5
2011,Senegal,SEN,Cyprus,CYP,0,0,5,0,5
2011,Sierra Leone,SLE,Cyprus,CYP,0,0,5,0,5
2011,Viet Nam,VNM,Cyprus,CYP,0,0,224,5,229
2011,Syrian Arab Rep.,SYR,Cyprus,CYP,5,5,78,28,116
2011,Tunisia,TUN,Cyprus,CYP,0,0,5,5,10
2011,Turkey,TUR,Cyprus,CYP,0,0,33,5,38
2011,Ukraine,UKR,Cyprus,CYP,0,0,10,10,20
2011,Uzbekistan,UZB,Cyprus,CYP,0,0,5,5,10
2011,Afghanistan,AFG,Denmark,DNK,5,151,479,10,645
2011,Albania,ALB,Denmark,DNK,0,0,5,0,5
2011,Azerbaijan,AZE,Denmark,DNK,0,0,10,0,10
2011,Bosnia and Herzegovina,BIH,Denmark,DNK,0,0,5,0,5
2011,China,CHN,Denmark,DNK,0,0,5,0,5
2011,Cameroon,CMR,Denmark,DNK,0,0,5,0,5
2011,Congo,COG,Denmark,DNK,5,0,0,0,5
2011,Dem. Rep. of the Congo,COD,Denmark,DNK,0,0,5,0,5
2011,Eritrea,ERI,Denmark,DNK,0,0,5,0,5
2011,Palestinian,PSE,Denmark,DNK,0,0,10,0,10
2011,Guinea-Bissau,GNB,Denmark,DNK,0,0,5,0,5
2011,India,IND,Denmark,DNK,0,0,5,0,5
2011,Iran (Islamic Rep. of),IRN,Denmark,DNK,57,5,66,0,128
2011,Iraq,IRQ,Denmark,DNK,5,5,42,0,52
2011,Israel,ISR,Denmark,DNK,0,0,5,0,5
2011,Jordan,JOR,Denmark,DNK,0,0,5,0,5
2011,Kyrgyzstan,KGZ,Denmark,DNK,0,0,5,0,5
2011,Sri Lanka,LKA,Denmark,DNK,0,0,13,0,13
2011,Morocco,MAR,Denmark,DNK,0,0,5,0,5
2011,Myanmar,MMR,Denmark,DNK,5,0,5,0,10
2011,Nigeria,NGA,Denmark,DNK,0,0,13,0,13
2011,Pakistan,PAK,Denmark,DNK,0,0,5,0,5
2011,Russian Federation,RUS,Denmark,DNK,5,15,32,5,57
2011,Serbia and Kosovo: S/RES/1244 (1999),SRB,Denmark,DNK,0,0,10,0,10
2011,Somalia,SOM,Denmark,DNK,0,0,12,0,12
2011,Sudan,SDN,Denmark,DNK,0,0,5,0,5
2011,Syrian Arab Rep.,SYR,Denmark,DNK,100,5,61,5,171
2011,Turkey,TUR,Denmark,DNK,0,0,10,0,10
2011,Uganda,UGA,Denmark,DNK,0,5,5,0,10
2011,Uzbekistan,UZB,Denmark,DNK,0,0,5,0,5
2011,Stateless,XXA,Denmark,DNK,13,0,11,0,24
2011,Afghanistan,AFG,Greece,GRC,47,53,0,0,100
2011,Palestinian,PSE,Greece,GRC,5,0,0,0,5
2011,Georgia,GEO,Greece,GRC,0,5,0,0,5
2011,Iran (Islamic Rep. of),IRN,Greece,GRC,12,10,0,0,22
2011,Iraq,IRQ,Greece,GRC,75,47,0,0,122
2011,Somalia,SOM,Greece,GRC,10,0,0,0,10
2011,Turkey,TUR,Greece,GRC,5,0,0,0,5
2011,Unknown ,,Greece,GRC,5,5,714,15271,15995
2011,Afghanistan,AFG,Croatia,HRV,5,0,0,5,10
2011,Bosnia and Herzegovina,BIH,Croatia,HRV,0,0,0,5,5
2011,Russian Federation,RUS,Croatia,HRV,0,0,5,0,5
2011,Senegal,SEN,Croatia,HRV,0,0,5,0,5
2011,Russian Federation,RUS,Iceland,ISL,0,0,0,5,5
2011,Spain,ESP,Iceland,ISL,0,0,0,5,5
2011,Afghanistan,AFG,Ireland,IRL,10,0,56,0,66
2011,Albania,ALB,Ireland,IRL,0,0,18,0,18
2011,Algeria,DZA,Ireland,IRL,0,0,25,0,25
2011,Angola,AGO,Ireland,IRL,0,0,15,0,15
2011,Armenia,ARM,Ireland,IRL,5,0,10,0,15
2011,Bangladesh,BGD,Ireland,IRL,0,0,25,0,25
2011,Bhutan,BTN,Ireland,IRL,0,0,5,0,5
2011,Belarus,BLR,Ireland,IRL,5,0,5,0,10
2011,Bolivia (Plurinational State of),BOL,Ireland,IRL,0,0,5,0,5
2011,Brazil,BRA,Ireland,IRL,0,0,5,0,5
2011,China,CHN,Ireland,IRL,0,0,15,0,15
2011,Cameroon,CMR,Ireland,IRL,0,0,38,0,38
2011,Congo,COG,Ireland,IRL,0,0,12,0,12
2011,Dem. Rep. of the Congo,COD,Ireland,IRL,0,0,81,0,81
2011,Eritrea,ERI,Ireland,IRL,0,0,5,0,5
2011,Ethiopia,ETH,Ireland,IRL,0,0,5,0,5
2011,Palestinian,PSE,Ireland,IRL,0,0,5,0,5
2011,Georgia,GEO,Ireland,IRL,5,0,24,0,29
2011,Ghana,GHA,Ireland,IRL,0,0,39,0,39
2011,Guinea,GIN,Ireland,IRL,0,0,5,0,5
2011,Cote d'Ivoire,CIV,Ireland,IRL,5,0,5,0,10
2011,India,IND,Ireland,IRL,0,0,5,0,5
2011,Iran (Islamic Rep. of),IRN,Ireland,IRL,5,0,18,0,23
2011,Iraq,IRQ,Ireland,IRL,0,0,20,0,20
2011,Israel,ISR,Ireland,IRL,0,0,5,0,5
2011,Kenya,KEN,Ireland,IRL,0,0,5,0,5
2011,Liberia,LBR,Ireland,IRL,0,0,5,0,5
2011,Lebanon,LBN,Ireland,IRL,0,0,5,0,5
2011,Sri Lanka,LKA,Ireland,IRL,0,0,5,0,5
2011,Rep. of Moldova,MDA,Ireland,IRL,0,0,17,0,17
2011,Malawi,MWI,Ireland,IRL,0,0,5,0,5
2011,Morocco,MAR,Ireland,IRL,0,0,5,0,5
2011,Mauritius,MUS,Ireland,IRL,0,0,5,0,5
2011,Nepal,NPL,Ireland,IRL,0,0,5,0,5
2011,Niger,NER,Ireland,IRL,0,0,5,0,5
2011,Nigeria,NGA,Ireland,IRL,5,0,264,24,293
2011,Pakistan,PAK,Ireland,IRL,5,0,152,5,162
2011,South Africa,ZAF,Ireland,IRL,0,0,30,0,30
2011,Russian Federation,RUS,Ireland,IRL,5,0,10,0,15
2011,Rwanda,RWA,Ireland,IRL,0,0,5,0,5
2011,Serbia and Kosovo: S/RES/1244 (1999),SRB,Ireland,IRL,0,0,10,0,10
2011,Sierra Leone,SLE,Ireland,IRL,0,0,5,0,5
2011,Somalia,SOM,Ireland,IRL,0,0,38,0,38
2011,Sudan,SDN,Ireland,IRL,0,0,30,0,30
2011,Eswatini,SWZ,Ireland,IRL,0,0,5,0,5
2011,Togo,TGO,Ireland,IRL,0,0,5,0,5
2011,Uganda,UGA,Ireland,IRL,0,0,15,0,15
2011,Yemen,YEM,Ireland,IRL,0,0,5,0,5
2011,Zimbabwe,ZWE,Ireland,IRL,0,0,62,0,62
2011,Sri Lanka,LKA,Japan,JPN,0,0,40,46,86
2011,Myanmar,MMR,Japan,JPN,12,60,377,70,519
2011,Nepal,NPL,Japan,JPN,0,0,20,0,20
2011,Pakistan,PAK,Japan,JPN,0,0,19,23,42
2011,Turkey,TUR,Japan,JPN,0,0,72,27,99
2011,Unknown ,,Japan,JPN,0,5,107,65,177
2011,Unknown ,,Luxembourg,LUX,5,0,160,15,180
2011,India,IND,"China, Macao SAR",MAC,0,0,0,5,5
2011,Syrian Arab Rep.,SYR,"China, Macao SAR",MAC,0,0,0,5,5
2011,Burundi,BDI,Malawi,MWI,0,0,0,28,28
2011,Dem. Rep. of the Congo,COD,Malawi,MWI,0,0,0,14,14
2011,Ethiopia,ETH,Malawi,MWI,0,0,0,5,5
2011,Rwanda,RWA,Malawi,MWI,0,0,0,29,29
2011,Burundi,BDI,Mozambique,MOZ,0,0,0,24,24
2011,Dem. Rep. of the Congo,COD,Mozambique,MOZ,0,0,0,56,56
2011,Rwanda,RWA,Mozambique,MOZ,0,0,0,5,5
2011,Armenia,ARM,Malta,MLT,0,0,5,0,5
2011,Bangladesh,BGD,Malta,MLT,0,0,10,0,10
2011,Burkina Faso,BFA,Malta,MLT,0,0,15,0,15
2011,Chad,TCD,Malta,MLT,0,0,10,0,10
2011,Cameroon,CMR,Malta,MLT,0,0,5,0,5
2011,Dem. Rep. of the Congo,COD,Malta,MLT,0,0,5,0,5
2011,Eritrea,ERI,Malta,MLT,0,0,28,0,28
2011,Ethiopia,ETH,Malta,MLT,0,0,75,0,75
2011,Gambia,GMB,Malta,MLT,0,0,14,0,14
2011,Palestinian,PSE,Malta,MLT,0,0,5,0,5
2011,Ghana,GHA,Malta,MLT,0,0,71,0,71
2011,Guinea,GIN,Malta,MLT,0,0,10,0,10
2011,Cote d'Ivoire,CIV,Malta,MLT,0,0,63,0,63
2011,India,IND,Malta,MLT,0,0,10,0,10
2011,Iraq,IRQ,Malta,MLT,0,0,5,0,5
2011,Liberia,LBR,Malta,MLT,0,0,14,0,14
2011,Mali,MLI,Malta,MLT,0,0,48,0,48
2011,Morocco,MAR,Malta,MLT,0,0,5,0,5
2011,Niger,NER,Malta,MLT,0,0,197,0,197
2011,Nigeria,NGA,Malta,MLT,0,0,18,0,18
2011,Pakistan,PAK,Malta,MLT,0,0,17,0,17
2011,Somalia,SOM,Malta,MLT,0,0,27,0,27
2011,Sudan,SDN,Malta,MLT,0,0,14,0,14
2011,Syrian Arab Rep.,SYR,Malta,MLT,0,0,5,0,5
2011,Togo,TGO,Malta,MLT,0,0,26,0,26
2011,Tunisia,TUN,Malta,MLT,0,0,5,0,5
2011,Unknown ,,Malta,MLT,0,0,14,0,14
2011,Afghanistan,AFG,Norway,NOR,52,116,1410,179,1757
2011,Albania,ALB,Norway,NOR,0,0,26,0,26
2011,Algeria,DZA,Norway,NOR,0,0,78,5,83
2011,Angola,AGO,Norway,NOR,0,5,25,0,30
2011,Egypt,EGY,Norway,NOR,0,5,15,5,25
2011,Armenia,ARM,Norway,NOR,0,0,19,0,19
2011,Azerbaijan,AZE,Norway,NOR,5,0,67,5,77
2011,Burundi,BDI,Norway,NOR,0,11,66,0,77
2011,Bangladesh,BGD,Norway,NOR,0,0,17,0,17
2011,Bhutan,BTN,Norway,NOR,0,0,5,0,5
2011,Burkina Faso,BFA,Norway,NOR,0,0,5,0,5
2011,Belarus,BLR,Norway,NOR,0,0,14,0,14
2011,Bosnia and Herzegovina,BIH,Norway,NOR,0,0,24,5,29
2011,Chad,TCD,Norway,NOR,0,0,5,0,5
2011,China,CHN,Norway,NOR,0,0,12,0,12
2011,Cameroon,CMR,Norway,NOR,0,0,30,0,30
2011,Congo,COG,Norway,NOR,0,0,5,0,5
2011,Dem. Rep. of the Congo,COD,Norway,NOR,0,0,97,5,102
2011,Colombia,COL,Norway,NOR,0,0,5,0,5
2011,Czechia,CZE,Norway,NOR,0,0,5,0,5
2011,Eritrea,ERI,Norway,NOR,80,5,428,89,602
2011,Ethiopia,ETH,Norway,NOR,14,20,399,22,455
2011,Gambia,GMB,Norway,NOR,0,0,51,0,51
2011,Palestinian,PSE,Norway,NOR,0,0,5,0,5
2011,Georgia,GEO,Norway,NOR,0,0,46,0,46
2011,Ghana,GHA,Norway,NOR,0,0,36,0,36
2011,Guinea-Bissau,GNB,Norway,NOR,0,0,10,0,10
2011,Guinea,GIN,Norway,NOR,0,0,61,0,61
2011,Cote d'Ivoire,CIV,Norway,NOR,0,0,22,0,22
2011,India,IND,Norway,NOR,0,0,49,5,54
2011,Iran (Islamic Rep. of),IRN,Norway,NOR,31,23,414,26,494
2011,Iraq,IRQ,Norway,NOR,10,43,753,58,864
2011,Israel,ISR,Norway,NOR,0,0,5,0,5
2011,Jordan,JOR,Norway,NOR,0,0,36,0,36
2011,Kazakhstan,KAZ,Norway,NOR,0,0,22,0,22
2011,Kenya,KEN,Norway,NOR,0,0,10,0,10
2011,Kyrgyzstan,KGZ,Norway,NOR,0,0,27,0,27
2011,Dem. People's Rep. of Korea,PRK,Norway,NOR,0,0,5,0,5
2011,Liberia,LBR,Norway,NOR,0,0,51,0,51
2011,Libya,LBY,Norway,NOR,0,0,14,0,14
2011,Lebanon,LBN,Norway,NOR,0,0,48,5,53
2011,Sri Lanka,LKA,Norway,NOR,0,17,325,16,358
2011,Latvia,LVA,Norway,NOR,0,0,5,0,5
2011,Mauritania,MRT,Norway,NOR,0,0,10,0,10
2011,North Macedonia,MKD,Norway,NOR,0,0,32,0,32
2011,Rep. of Moldova,MDA,Norway,NOR,0,0,5,0,5
2011,Mexico,MEX,Norway,NOR,0,0,14,0,14
2011,Mali,MLI,Norway,NOR,0,0,5,0,5
2011,Mongolia,MNG,Norway,NOR,0,0,5,0,5
2011,Morocco,MAR,Norway,NOR,0,0,65,10,75
2011,Montenegro,MNE,Norway,NOR,0,0,5,0,5
2011,Myanmar,MMR,Norway,NOR,0,0,19,0,19
2011,Nepal,NPL,Norway,NOR,0,0,45,0,45
2011,Niger,NER,Norway,NOR,0,0,16,0,16
2011,Nicaragua,NIC,Norway,NOR,0,0,5,0,5
2011,Nigeria,NGA,Norway,NOR,0,0,297,28,325
2011,Pakistan,PAK,Norway,NOR,0,0,115,5,120
2011,Philippines,PHL,Norway,NOR,0,0,5,0,5
2011,Romania,ROU,Norway,NOR,0,0,5,0,5
2011,South Africa,ZAF,Norway,NOR,0,0,5,0,5
2011,Russian Federation,RUS,Norway,NOR,58,42,582,21,703
2011,Rwanda,RWA,Norway,NOR,0,0,26,0,26
2011,El Salvador,SLV,Norway,NOR,0,0,5,0,5
2011,Serbia and Kosovo: S/RES/1244 (1999),SRB,Norway,NOR,0,5,297,10,312
2011,Senegal,SEN,Norway,NOR,0,0,19,0,19
2011,Sierra Leone,SLE,Norway,NOR,0,0,26,0,26
2011,Somalia,SOM,Norway,NOR,5,77,399,130,611
2011,Viet Nam,VNM,Norway,NOR,0,0,10,0,10
2011,Sudan,SDN,Norway,NOR,0,0,59,12,71
2011,Syrian Arab Rep.,SYR,Norway,NOR,0,0,113,5,118
2011,United Rep. of Tanzania,TZA,Norway,NOR,0,0,5,0,5
2011,Tajikistan,TJK,Norway,NOR,0,0,20,0,20
2011,Togo,TGO,Norway,NOR,0,0,10,0,10
2011,Tunisia,TUN,Norway,NOR,0,0,28,0,28
2011,Turkey,TUR,Norway,NOR,0,5,77,10,92
2011,Uganda,UGA,Norway,NOR,0,5,27,0,32
2011,Ukraine,UKR,Norway,NOR,0,0,10,0,10
2011,Uzbekistan,UZB,Norway,NOR,13,5,103,0,121
2011,Yemen,YEM,Norway,NOR,0,0,38,0,38
2011,Zimbabwe,ZWE,Norway,NOR,0,0,23,0,23
2011,Stateless,XXA,Norway,NOR,5,21,655,26,707
2011,Bangladesh,BGD,New Zealand,NZL,0,0,5,0,5
2011,Brazil,BRA,New Zealand,NZL,0,0,5,0,5
2011,China,CHN,New Zealand,NZL,5,0,0,0,5
2011,Czechia,CZE,New Zealand,NZL,0,0,5,0,5
2011,Fiji,FJI,New Zealand,NZL,5,0,21,0,26
2011,Iran (Islamic Rep. of),IRN,New Zealand,NZL,16,0,5,0,21
2011,Sri Lanka,LKA,New Zealand,NZL,0,0,10,0,10
2011,South Africa,ZAF,New Zealand,NZL,0,0,10,0,10
2011,Saudi Arabia,SAU,New Zealand,NZL,5,0,5,0,10
2011,Syrian Arab Rep.,SYR,New Zealand,NZL,0,0,5,0,5
2011,Armenia,ARM,Poland,POL,0,5,0,5,10
2011,Belarus,BLR,Poland,POL,5,0,0,0,5
2011,Georgia,GEO,Poland,POL,0,0,0,19,19
2011,Rep. of Moldova,MDA,Poland,POL,0,0,0,5,5
2011,Russian Federation,RUS,Poland,POL,0,78,0,161,239
2011,Afghanistan,AFG,Sweden,SWE,48,119,552,101,820
2011,Albania,ALB,Sweden,SWE,0,5,79,5,89
2011,Algeria,DZA,Sweden,SWE,0,0,112,15,127
2011,Angola,AGO,Sweden,SWE,0,0,29,5,34
2011,Egypt,EGY,Sweden,SWE,5,0,140,24,169
2011,Armenia,ARM,Sweden,SWE,10,13,232,31,286
2011,Azerbaijan,AZE,Sweden,SWE,5,14,383,34,436
2011,Burundi,BDI,Sweden,SWE,0,0,27,5,32
2011,Benin,BEN,Sweden,SWE,0,0,11,0,11
2011,Bangladesh,BGD,Sweden,SWE,5,5,80,5,95
2011,Belarus,BLR,Sweden,SWE,0,5,185,40,230
2011,Bolivia (Plurinational State of),BOL,Sweden,SWE,0,0,24,5,29
2011,Bosnia and Herzegovina,BIH,Sweden,SWE,5,0,139,25,169
2011,Bulgaria,BGR,Sweden,SWE,0,0,5,0,5
2011,Chad,TCD,Sweden,SWE,0,0,5,0,5
2011,China,CHN,Sweden,SWE,10,0,42,10,62
2011,Chile,CHL,Sweden,SWE,0,0,5,0,5
2011,Cameroon,CMR,Sweden,SWE,5,0,18,5,28
2011,Congo,COG,Sweden,SWE,0,0,10,0,10
2011,Dem. Rep. of the Congo,COD,Sweden,SWE,0,5,91,12,108
2011,Colombia,COL,Sweden,SWE,0,0,15,0,15
2011,Cuba,CUB,Sweden,SWE,5,0,14,5,24
2011,Djibouti,DJI,Sweden,SWE,0,0,12,0,12
2011,Ecuador,ECU,Sweden,SWE,0,0,5,0,5
2011,Eritrea,ERI,Sweden,SWE,5,26,141,24,196
2011,Ethiopia,ETH,Sweden,SWE,10,5,190,16,221
2011,Gambia,GMB,Sweden,SWE,0,0,29,5,34
2011,Georgia,GEO,Sweden,SWE,0,5,175,11,191
2011,Ghana,GHA,Sweden,SWE,0,0,39,0,39
2011,Guinea,GIN,Sweden,SWE,0,0,32,0,32
2011,Honduras,HND,Sweden,SWE,0,0,5,0,5
2011,Croatia,HRV,Sweden,SWE,0,0,14,5,19
2011,Cote d'Ivoire,CIV,Sweden,SWE,0,0,10,5,15
2011,India,IND,Sweden,SWE,0,0,42,0,42
2011,Iran (Islamic Rep. of),IRN,Sweden,SWE,146,37,782,105,1070
2011,Iraq,IRQ,Sweden,SWE,60,87,1259,202,1608
2011,Israel,ISR,Sweden,SWE,0,0,15,0,15
2011,Italy,ITA,Sweden,SWE,0,0,5,0,5
2011,Jordan,JOR,Sweden,SWE,0,0,103,19,122
2011,Kazakhstan,KAZ,Sweden,SWE,0,5,306,45,356
2011,Kenya,KEN,Sweden,SWE,0,5,82,13,100
2011,Kyrgyzstan,KGZ,Sweden,SWE,5,10,274,68,357
2011,Rep. of Korea,KOR,Sweden,SWE,0,0,0,5,5
2011,Dem. People's Rep. of Korea,PRK,Sweden,SWE,0,0,5,0,5
2011,Kuwait,KWT,Sweden,SWE,0,0,11,0,11
2011,Liberia,LBR,Sweden,SWE,0,0,5,0,5
2011,Libya,LBY,Sweden,SWE,0,26,152,53,231
2011,Lebanon,LBN,Sweden,SWE,0,10,176,19,205
2011,Sri Lanka,LKA,Sweden,SWE,0,5,40,0,45
2011,Mauritania,MRT,Sweden,SWE,0,0,5,0,5
2011,North Macedonia,MKD,Sweden,SWE,0,5,335,29,369
2011,Mongolia,MNG,Sweden,SWE,0,10,550,80,640
2011,Morocco,MAR,Sweden,SWE,0,0,45,0,45
2011,Montenegro,MNE,Sweden,SWE,0,0,35,11,46
2011,Myanmar,MMR,Sweden,SWE,0,0,5,0,5
2011,Nepal,NPL,Sweden,SWE,0,0,19,0,19
2011,Nicaragua,NIC,Sweden,SWE,0,0,24,0,24
2011,Nigeria,NGA,Sweden,SWE,0,0,210,28,238
2011,Pakistan,PAK,Sweden,SWE,5,10,65,11,91
2011,Paraguay,PRY,Sweden,SWE,0,0,5,0,5
2011,Peru,PER,Sweden,SWE,0,0,10,0,10
2011,Romania,ROU,Sweden,SWE,0,0,5,0,5
2011,South Africa,ZAF,Sweden,SWE,0,0,10,0,10
2011,Russian Federation,RUS,Sweden,SWE,10,39,612,105,766
2011,Rwanda,RWA,Sweden,SWE,0,0,5,5,10
2011,El Salvador,SLV,Sweden,SWE,0,0,35,5,40
2011,Serbia and Kosovo: S/RES/1244 (1999),SRB,Sweden,SWE,0,43,2593,357,2993
2011,Senegal,SEN,Sweden,SWE,0,0,15,0,15
2011,Sierra Leone,SLE,Sweden,SWE,0,0,17,5,22
2011,Somalia,SOM,Sweden,SWE,16,159,451,112,738
2011,Viet Nam,VNM,Sweden,SWE,0,0,112,10,122
2011,Sudan,SDN,Sweden,SWE,0,5,38,10,53
2011,Syrian Arab Rep.,SYR,Sweden,SWE,12,16,389,39,456
2011,United Rep. of Tanzania,TZA,Sweden,SWE,0,0,21,10,31
2011,Tajikistan,TJK,Sweden,SWE,0,5,35,5,45
2011,Turkmenistan,TKM,Sweden,SWE,0,0,5,0,5
2011,Togo,TGO,Sweden,SWE,0,0,5,0,5
2011,Tunisia,TUN,Sweden,SWE,0,0,45,11,56
2011,Turkey,TUR,Sweden,SWE,5,5,123,42,175
2011,Uganda,UGA,Sweden,SWE,5,0,45,5,55
2011,Ukraine,UKR,Sweden,SWE,0,5,104,10,119
2011,United States of America,USA,Sweden,SWE,0,0,5,0,5
2011,Uzbekistan,UZB,Sweden,SWE,13,10,265,34,322
2011,Yemen,YEM,Sweden,SWE,5,0,75,5,85
2011,Stateless,XXA,Sweden,SWE,25,59,664,61,809
2011,Unknown ,,Sweden,SWE,0,40,647,50,737
2012,Chad,TCD,Benin,BEN,0,0,0,5,5
2012,Eritrea,ERI,Benin,BEN,13,0,0,0,13
2012,Myanmar,MMR,Cambodia,KHM,0,0,5,0,5
2012,Cuba,CUB,Colombia,COL,0,0,5,0,5
2012,Peru,PER,Colombia,COL,0,0,5,0,5
2012,Afghanistan,AFG,Cyprus,CYP,0,0,95,10,105
2012,Egypt,EGY,Cyprus,CYP,0,5,105,0,110
2012,Armenia,ARM,Cyprus,CYP,0,0,15,0,15
2012,Bangladesh,BGD,Cyprus,CYP,0,0,115,25,140
2012,Bosnia and Herzegovina,BIH,Cyprus,CYP,0,0,20,0,20
2012,China,CHN,Cyprus,CYP,0,0,11,13,24
2012,Cameroon,CMR,Cyprus,CYP,0,0,44,11,55
2012,Dem. Rep. of the Congo,COD,Cyprus,CYP,0,0,5,0,5
2012,Ethiopia,ETH,Cyprus,CYP,0,0,12,0,12
2012,Palestinian,PSE,Cyprus,CYP,5,0,22,0,27
2012,Georgia,GEO,Cyprus,CYP,0,0,19,0,19
2012,Ghana,GHA,Cyprus,CYP,0,0,10,0,10
2012,Guinea,GIN,Cyprus,CYP,0,0,15,5,20
2012,India,IND,Cyprus,CYP,0,0,41,19,60
2012,Indonesia,IDN,Cyprus,CYP,0,0,5,0,5
2012,Iran (Islamic Rep. of),IRN,Cyprus,CYP,0,0,83,33,116
2012,Jordan,JOR,Cyprus,CYP,0,5,24,15,44
2012,Kenya,KEN,Cyprus,CYP,0,0,5,0,5
2012,Kyrgyzstan,KGZ,Cyprus,CYP,0,0,5,0,5
2012,Lebanon,LBN,Cyprus,CYP,0,0,45,0,45
2012,Sri Lanka,LKA,Cyprus,CYP,0,0,91,5,96
2012,Rep. of Moldova,MDA,Cyprus,CYP,0,0,13,5,18
2012,Mali,MLI,Cyprus,CYP,0,0,5,0,5
2012,Mongolia,MNG,Cyprus,CYP,0,0,0,5,5
2012,Morocco,MAR,Cyprus,CYP,0,0,5,5,10
2012,Nepal,NPL,Cyprus,CYP,0,0,42,5,47
2012,Nigeria,NGA,Cyprus,CYP,0,0,20,0,20
2012,Pakistan,PAK,Cyprus,CYP,0,0,100,20,120
2012,Philippines,PHL,Cyprus,CYP,0,0,35,13,48
2012,Russian Federation,RUS,Cyprus,CYP,0,0,37,21,58
2012,Serbia and Kosovo: S/RES/1244 (1999),SRB,Cyprus,CYP,0,0,5,47,52
2012,Senegal,SEN,Cyprus,CYP,0,0,5,0,5
2012,Sierra Leone,SLE,Cyprus,CYP,0,0,5,0,5
2012,Viet Nam,VNM,Cyprus,CYP,0,0,141,5,146
2012,Turkey,TUR,Cyprus,CYP,0,5,86,0,91
2012,Ukraine,UKR,Cyprus,CYP,0,0,30,19,49
2012,Uzbekistan,UZB,Cyprus,CYP,0,0,11,5,16
2012,Afghanistan,AFG,Denmark,DNK,10,114,439,0,563
2012,Armenia,ARM,Denmark,DNK,0,10,10,0,20
2012,Azerbaijan,AZE,Denmark,DNK,0,0,16,0,16
2012,Bangladesh,BGD,Denmark,DNK,0,0,46,0,46
2012,Belarus,BLR,Denmark,DNK,0,0,5,0,5
2012,Bosnia and Herzegovina,BIH,Denmark,DNK,0,0,5,0,5
2012,Cambodia,KHM,Denmark,DNK,0,0,10,0,10
2012,China,CHN,Denmark,DNK,0,0,5,0,5
2012,Dem. Rep. of the Congo,COD,Denmark,DNK,0,0,12,0,12
2012,Eritrea,ERI,Denmark,DNK,0,5,0,0,5
2012,Gambia,GMB,Denmark,DNK,0,0,5,0,5
2012,Palestinian,PSE,Denmark,DNK,5,0,10,0,15
2012,Georgia,GEO,Denmark,DNK,0,0,5,0,5
2012,Ghana,GHA,Denmark,DNK,0,0,10,0,10
2012,Cote d'Ivoire,CIV,Denmark,DNK,0,0,5,0,5
2012,India,IND,Denmark,DNK,0,5,5,0,10
2012,Iran (Islamic Rep. of),IRN,Denmark,DNK,104,14,112,0,230
2012,Iraq,IRQ,Denmark,DNK,0,5,48,0,53
2012,Kenya,KEN,Denmark,DNK,0,0,5,0,5
2012,Kyrgyzstan,KGZ,Denmark,DNK,5,0,0,0,5
2012,Libya,LBY,Denmark,DNK,0,0,5,0,5
2012,Sri Lanka,LKA,Denmark,DNK,0,0,10,0,10
2012,Myanmar,MMR,Denmark,DNK,0,0,10,0,10
2012,Nepal,NPL,Denmark,DNK,0,5,5,0,10
2012,Nigeria,NGA,Denmark,DNK,0,0,32,0,32
2012,Pakistan,PAK,Denmark,DNK,0,0,21,0,21
2012,Russian Federation,RUS,Denmark,DNK,5,5,65,0,75
2012,Serbia and Kosovo: S/RES/1244 (1999),SRB,Denmark,DNK,0,0,10,0,10
2012,Sierra Leone,SLE,Denmark,DNK,0,0,5,0,5
2012,Somalia,SOM,Denmark,DNK,0,5,10,0,15
2012,Sudan,SDN,Denmark,DNK,0,0,5,0,5
2012,Syrian Arab Rep.,SYR,Denmark,DNK,80,11,93,0,184
2012,Turkey,TUR,Denmark,DNK,0,0,5,0,5
2012,Uganda,UGA,Denmark,DNK,0,0,12,0,12
2012,Stateless,XXA,Denmark,DNK,5,0,22,0,27
2012,Unknown ,,Denmark,DNK,0,0,5,0,5
2012,Afghanistan,AFG,France,FRA,58,162,118,0,338
2012,Albania,ALB,France,FRA,18,67,299,0,384
2012,Algeria,DZA,France,FRA,29,13,677,0,719
2012,Angola,AGO,France,FRA,42,5,309,0,356
2012,Egypt,EGY,France,FRA,56,0,61,0,117
2012,Armenia,ARM,France,FRA,71,87,1778,0,1936
2012,Azerbaijan,AZE,France,FRA,57,12,322,0,391
2012,Burundi,BDI,France,FRA,5,0,11,0,16
2012,Benin,BEN,France,FRA,0,0,5,0,5
2012,Bangladesh,BGD,France,FRA,409,32,3699,0,4140
2012,Bhutan,BTN,France,FRA,10,0,10,0,20
2012,Burkina Faso,BFA,France,FRA,5,5,15,0,25
2012,Belarus,BLR,France,FRA,13,0,40,0,53
2012,Bolivia (Plurinational State of),BOL,France,FRA,0,0,5,0,5
2012,Brazil,BRA,France,FRA,0,0,5,0,5
2012,Bosnia and Herzegovina,BIH,France,FRA,11,5,103,0,119
2012,Cambodia,KHM,France,FRA,0,0,11,0,11
2012,Central African Rep.,CAF,France,FRA,5,0,38,0,43
2012,Chad,TCD,France,FRA,39,0,80,0,119
2012,China,CHN,France,FRA,23,13,1936,0,1972
2012,Cameroon,CMR,France,FRA,27,10,130,0,167
2012,Congo,COG,France,FRA,36,14,387,0,437
2012,Dem. Rep. of the Congo,COD,France,FRA,327,58,2201,0,2586
2012,Comoros,COM,France,FRA,14,5,687,0,706
2012,Colombia,COL,France,FRA,14,5,64,0,83
2012,Djibouti,DJI,France,FRA,0,0,5,0,5
2012,Dominican Rep.,DOM,France,FRA,0,5,50,0,55
2012,Equatorial Guinea,GNQ,France,FRA,0,0,5,0,5
2012,Eritrea,ERI,France,FRA,132,5,113,0,250
2012,Ethiopia,ETH,France,FRA,11,5,38,0,54
2012,Gabon,GAB,France,FRA,0,0,5,0,5
2012,Gambia,GMB,France,FRA,0,0,28,0,28
2012,Palestinian,PSE,France,FRA,12,0,21,0,33
2012,Georgia,GEO,France,FRA,79,38,655,0,772
2012,Ghana,GHA,France,FRA,0,0,10,0,10
2012,Guinea-Bissau,GNB,France,FRA,0,5,122,0,127
2012,Guinea,GIN,France,FRA,119,62,912,0,1093
2012,Guyana,GUY,France,FRA,0,5,0,0,5
2012,Haiti,HTI,France,FRA,46,37,956,0,1039
2012,Cote d'Ivoire,CIV,France,FRA,43,28,597,0,668
2012,India,IND,France,FRA,0,0,21,0,21
2012,Indonesia,IDN,France,FRA,0,0,5,0,5
2012,Iran (Islamic Rep. of),IRN,France,FRA,34,0,43,0,77
2012,Iraq,IRQ,France,FRA,27,5,54,0,86
2012,Jordan,JOR,France,FRA,0,0,5,0,5
2012,Kazakhstan,KAZ,France,FRA,15,0,63,0,78
2012,Kenya,KEN,France,FRA,5,5,15,0,25
2012,Kyrgyzstan,KGZ,France,FRA,23,5,30,0,58
2012,Dem. People's Rep. of Korea,PRK,France,FRA,0,0,39,0,39
2012,Lao People's Dem. Rep.,LAO,France,FRA,0,0,17,0,17
2012,Liberia,LBR,France,FRA,0,0,16,0,16
2012,Libya,LBY,France,FRA,0,0,15,0,15
2012,Lebanon,LBN,France,FRA,0,0,10,0,10
2012,Sri Lanka,LKA,France,FRA,611,44,1956,0,2611
2012,Madagascar,MDG,France,FRA,5,0,95,0,100
2012,Mauritania,MRT,France,FRA,115,15,991,0,1121
2012,North Macedonia,MKD,France,FRA,10,12,332,0,354
2012,Rep. of Moldova,MDA,France,FRA,5,0,108,0,113
2012,Mali,MLI,France,FRA,5,69,89,0,163
2012,Mongolia,MNG,France,FRA,5,16,142,0,163
2012,Morocco,MAR,France,FRA,0,0,29,0,29
2012,Montenegro,MNE,France,FRA,5,10,106,0,121
2012,Myanmar,MMR,France,FRA,15,0,48,0,63
2012,Nepal,NPL,France,FRA,5,0,45,0,50
2012,Niger,NER,France,FRA,0,0,10,0,10
2012,Nigeria,NGA,France,FRA,25,37,507,0,569
2012,Pakistan,PAK,France,FRA,53,12,837,0,902
2012,Peru,PER,France,FRA,5,11,75,0,91
2012,Romania,ROU,France,FRA,0,0,5,0,5
2012,Russian Federation,RUS,France,FRA,661,82,1441,0,2184
2012,Rwanda,RWA,France,FRA,46,5,88,0,139
2012,Serbia and Kosovo: S/RES/1244 (1999),SRB,France,FRA,384,180,2429,0,2993
2012,Senegal,SEN,France,FRA,5,10,63,0,78
2012,Sierra Leone,SLE,France,FRA,5,0,95,0,100
2012,Somalia,SOM,France,FRA,17,101,63,0,181
2012,Viet Nam,VNM,France,FRA,5,0,10,0,15
2012,Sudan,SDN,France,FRA,147,38,315,0,500
2012,Suriname,SUR,France,FRA,0,0,20,0,20
2012,Syrian Arab Rep.,SYR,France,FRA,36,5,5,0,46
2012,Thailand,THA,France,FRA,0,0,51,0,51
2012,Tajikistan,TJK,France,FRA,0,0,10,0,10
2012,Turkmenistan,TKM,France,FRA,0,0,5,0,5
2012,Togo,TGO,France,FRA,10,0,98,0,108
2012,Tunisia,TUN,France,FRA,0,0,48,0,48
2012,Turkey,TUR,France,FRA,220,14,1342,0,1576
2012,Uganda,UGA,France,FRA,5,0,5,0,10
2012,Ukraine,UKR,France,FRA,5,0,63,0,68
2012,Uzbekistan,UZB,France,FRA,5,0,11,0,16
2012,Venezuela (Bolivarian Republic of),VEN,France,FRA,0,0,5,0,5
2012,Western Sahara,ESH,France,FRA,5,0,5,0,10
2012,Unknown ,,France,FRA,5,0,0,0,5
2012,Afghanistan,AFG,Greece,GRC,19,97,0,0,116
2012,Albania,ALB,Greece,GRC,0,5,0,0,5
2012,Bangladesh,BGD,Greece,GRC,0,5,0,0,5
2012,China,CHN,Greece,GRC,5,0,0,0,5
2012,Dem. Rep. of the Congo,COD,Greece,GRC,0,5,0,0,5
2012,Georgia,GEO,Greece,GRC,0,15,0,0,15
2012,Ghana,GHA,Greece,GRC,0,5,0,0,5
2012,Iran (Islamic Rep. of),IRN,Greece,GRC,28,54,0,0,82
2012,Iraq,IRQ,Greece,GRC,107,96,0,0,203
2012,Lebanon,LBN,Greece,GRC,0,5,0,0,5
2012,Nigeria,NGA,Greece,GRC,5,11,0,0,16
2012,Pakistan,PAK,Greece,GRC,0,5,0,0,5
2012,Sierra Leone,SLE,Greece,GRC,0,5,0,0,5
2012,Sudan,SDN,Greece,GRC,5,5,0,0,10
2012,Syrian Arab Rep.,SYR,Greece,GRC,0,10,0,0,10
2012,Turkey,TUR,Greece,GRC,10,21,0,0,31
2012,Unknown ,,Greece,GRC,0,0,1117,10135,11252
2012,Albania,ALB,Iceland,ISL,0,0,5,0,5
2012,Algeria,DZA,Iceland,ISL,0,0,5,5,10
2012,Iraq,IRQ,Iceland,ISL,0,0,0,5,5
2012,Nigeria,NGA,Iceland,ISL,0,0,0,11,11
2012,Afghanistan,AFG,Ireland,IRL,0,0,31,0,31
2012,Albania,ALB,Ireland,IRL,0,0,23,0,23
2012,Algeria,DZA,Ireland,IRL,0,0,24,5,29
2012,Angola,AGO,Ireland,IRL,0,0,5,0,5
2012,Egypt,EGY,Ireland,IRL,0,0,5,0,5
2012,Armenia,ARM,Ireland,IRL,0,0,5,0,5
2012,Bangladesh,BGD,Ireland,IRL,0,0,17,0,17
2012,Bolivia (Plurinational State of),BOL,Ireland,IRL,0,0,5,0,5
2012,Brazil,BRA,Ireland,IRL,0,0,10,0,10
2012,China,CHN,Ireland,IRL,0,0,10,0,10
2012,Chile,CHL,Ireland,IRL,0,0,5,0,5
2012,Cameroon,CMR,Ireland,IRL,0,0,19,0,19
2012,Congo,COG,Ireland,IRL,0,0,10,0,10
2012,Dem. Rep. of the Congo,COD,Ireland,IRL,5,0,35,0,40
2012,Ethiopia,ETH,Ireland,IRL,0,0,5,0,5
2012,Palestinian,PSE,Ireland,IRL,5,0,5,0,10
2012,Georgia,GEO,Ireland,IRL,5,0,5,0,10
2012,Ghana,GHA,Ireland,IRL,0,0,10,0,10
2012,Cote d'Ivoire,CIV,Ireland,IRL,0,0,5,0,5
2012,India,IND,Ireland,IRL,0,0,5,0,5
2012,Iran (Islamic Rep. of),IRN,Ireland,IRL,0,0,10,0,10
2012,Iraq,IRQ,Ireland,IRL,0,0,5,0,5
2012,Israel,ISR,Ireland,IRL,0,0,12,0,12
2012,Kenya,KEN,Ireland,IRL,0,0,5,0,5
2012,Rep. of Moldova,MDA,Ireland,IRL,5,0,15,0,20
2012,Malawi,MWI,Ireland,IRL,0,0,18,0,18
2012,Mauritius,MUS,Ireland,IRL,0,0,5,0,5
2012,Nepal,NPL,Ireland,IRL,0,0,5,0,5
2012,Niger,NER,Ireland,IRL,0,0,5,0,5
2012,Nigeria,NGA,Ireland,IRL,0,0,90,15,105
2012,Pakistan,PAK,Ireland,IRL,0,0,52,5,57
2012,South Africa,ZAF,Ireland,IRL,0,0,34,0,34
2012,Russian Federation,RUS,Ireland,IRL,5,0,5,5,15
2012,Rwanda,RWA,Ireland,IRL,5,0,10,0,15
2012,Serbia and Kosovo: S/RES/1244 (1999),SRB,Ireland,IRL,0,0,14,0,14
2012,Somalia,SOM,Ireland,IRL,5,0,10,0,15
2012,Sudan,SDN,Ireland,IRL,5,0,11,0,16
2012,Syrian Arab Rep.,SYR,Ireland,IRL,0,0,5,0,5
2012,Uganda,UGA,Ireland,IRL,0,0,5,0,5
2012,Ukraine,UKR,Ireland,IRL,0,0,10,5,15
2012,Yemen,YEM,Ireland,IRL,0,0,5,0,5
2012,Zimbabwe,ZWE,Ireland,IRL,0,0,30,0,30
2012,India,IND,Japan,JPN,0,0,0,13,13
2012,Sri Lanka,LKA,Japan,JPN,0,0,81,22,103
2012,Myanmar,MMR,Japan,JPN,11,0,350,55,416
2012,Nepal,NPL,Japan,JPN,0,0,71,0,71
2012,Pakistan,PAK,Japan,JPN,0,0,53,21,74
2012,Turkey,TUR,Japan,JPN,0,0,58,13,71
2012,Unknown ,,Japan,JPN,0,52,177,69,298
2012,Unknown ,,Luxembourg,LUX,5,0,0,87,92
2012,Burundi,BDI,Malawi,MWI,0,0,0,150,150
2012,Dem. Rep. of the Congo,COD,Malawi,MWI,0,0,0,92,92
2012,Ethiopia,ETH,Malawi,MWI,0,0,0,5,5
2012,Rwanda,RWA,Malawi,MWI,0,0,0,132,132
2012,Egypt,EGY,Malta,MLT,0,0,5,0,5
2012,Eritrea,ERI,Malta,MLT,0,0,5,0,5
2012,Ethiopia,ETH,Malta,MLT,0,0,12,5,17
2012,Ghana,GHA,Malta,MLT,0,0,5,5,10
2012,Cote d'Ivoire,CIV,Malta,MLT,0,0,5,0,5
2012,Iraq,IRQ,Malta,MLT,0,0,5,0,5
2012,Mali,MLI,Malta,MLT,0,0,15,0,15
2012,Nigeria,NGA,Malta,MLT,0,0,5,5,10
2012,Somalia,SOM,Malta,MLT,0,0,5,0,5
2012,Afghanistan,AFG,Norway,NOR,32,49,1485,37,1603
2012,Albania,ALB,Norway,NOR,0,0,70,0,70
2012,Algeria,DZA,Norway,NOR,0,0,55,5,60
2012,Angola,AGO,Norway,NOR,0,0,26,0,26
2012,Egypt,EGY,Norway,NOR,0,0,22,0,22
2012,Armenia,ARM,Norway,NOR,0,0,13,0,13
2012,Azerbaijan,AZE,Norway,NOR,0,0,15,0,15
2012,Burundi,BDI,Norway,NOR,0,0,33,0,33
2012,Benin,BEN,Norway,NOR,0,0,5,0,5
2012,Bangladesh,BGD,Norway,NOR,0,0,98,5,103
2012,Belarus,BLR,Norway,NOR,0,0,61,0,61
2012,Brazil,BRA,Norway,NOR,0,0,5,0,5
2012,Bosnia and Herzegovina,BIH,Norway,NOR,0,0,21,5,26
2012,Bulgaria,BGR,Norway,NOR,0,0,19,0,19
2012,Chad,TCD,Norway,NOR,0,0,5,0,5
2012,China,CHN,Norway,NOR,0,0,33,0,33
2012,Chile,CHL,Norway,NOR,0,0,5,0,5
2012,Cameroon,CMR,Norway,NOR,0,0,28,0,28
2012,Congo,COG,Norway,NOR,0,0,5,0,5
2012,Dem. Rep. of the Congo,COD,Norway,NOR,5,0,119,0,124
2012,Colombia,COL,Norway,NOR,0,0,10,0,10
2012,Eritrea,ERI,Norway,NOR,87,0,452,51,590
2012,Ethiopia,ETH,Norway,NOR,16,0,529,10,555
2012,Gambia,GMB,Norway,NOR,0,0,40,5,45
2012,Palestinian,PSE,Norway,NOR,0,0,5,0,5
2012,Georgia,GEO,Norway,NOR,0,0,31,0,31
2012,Ghana,GHA,Norway,NOR,0,0,29,0,29
2012,Guinea-Bissau,GNB,Norway,NOR,0,0,5,0,5
2012,Guinea,GIN,Norway,NOR,0,0,33,0,33
2012,Hungary,HUN,Norway,NOR,0,0,20,0,20
2012,Cote d'Ivoire,CIV,Norway,NOR,0,0,46,0,46
2012,India,IND,Norway,NOR,0,0,48,0,48
2012,Iran (Islamic Rep. of),IRN,Norway,NOR,40,0,526,25,591
2012,Iraq,IRQ,Norway,NOR,30,10,471,18,529
2012,Israel,ISR,Norway,NOR,0,0,5,0,5
2012,Jordan,JOR,Norway,NOR,0,0,13,0,13
2012,Kazakhstan,KAZ,Norway,NOR,0,0,10,5,15
2012,Kenya,KEN,Norway,NOR,0,0,14,0,14
2012,Kyrgyzstan,KGZ,Norway,NOR,0,0,48,5,53
2012,Kuwait,KWT,Norway,NOR,0,0,5,0,5
2012,Liberia,LBR,Norway,NOR,0,0,17,0,17
2012,Libya,LBY,Norway,NOR,0,0,71,5,76
2012,Lebanon,LBN,Norway,NOR,0,0,16,0,16
2012,Sri Lanka,LKA,Norway,NOR,5,0,93,0,98
2012,Mauritania,MRT,Norway,NOR,0,0,10,0,10
2012,North Macedonia,MKD,Norway,NOR,0,0,19,5,24
2012,Rep. of Moldova,MDA,Norway,NOR,0,0,5,0,5
2012,Mexico,MEX,Norway,NOR,0,0,10,0,10
2012,Mongolia,MNG,Norway,NOR,0,0,5,0,5
2012,Morocco,MAR,Norway,NOR,0,0,51,0,51
2012,Myanmar,MMR,Norway,NOR,0,0,28,0,28
2012,Nepal,NPL,Norway,NOR,0,0,25,0,25
2012,Niger,NER,Norway,NOR,0,0,19,0,19
2012,Nigeria,NGA,Norway,NOR,10,0,235,17,262
2012,Pakistan,PAK,Norway,NOR,0,0,112,5,117
2012,Russian Federation,RUS,Norway,NOR,28,0,476,67,571
2012,Rwanda,RWA,Norway,NOR,0,0,19,0,19
2012,El Salvador,SLV,Norway,NOR,0,0,5,0,5
2012,Serbia and Kosovo: S/RES/1244 (1999),SRB,Norway,NOR,0,0,212,5,217
2012,Senegal,SEN,Norway,NOR,0,0,15,0,15
2012,Sierra Leone,SLE,Norway,NOR,0,0,18,0,18
2012,Somalia,SOM,Norway,NOR,5,22,533,69,629
2012,Viet Nam,VNM,Norway,NOR,0,0,11,0,11
2012,Sudan,SDN,Norway,NOR,5,0,41,0,46
2012,Syrian Arab Rep.,SYR,Norway,NOR,0,159,37,5,201
2012,Tajikistan,TJK,Norway,NOR,0,0,5,5,10
2012,Tunisia,TUN,Norway,NOR,0,0,32,0,32
2012,Turkey,TUR,Norway,NOR,0,0,32,5,37
2012,Uganda,UGA,Norway,NOR,5,0,32,0,37
2012,Ukraine,UKR,Norway,NOR,0,0,5,0,5
2012,Uzbekistan,UZB,Norway,NOR,10,0,56,21,87
2012,Yemen,YEM,Norway,NOR,0,0,105,0,105
2012,Zimbabwe,ZWE,Norway,NOR,0,0,15,0,15
2012,Stateless,XXA,Norway,NOR,5,48,384,15,452
2012,Egypt,EGY,New Zealand,NZL,5,0,0,0,5
2012,China,CHN,New Zealand,NZL,5,0,5,0,10
2012,Chile,CHL,New Zealand,NZL,0,0,5,0,5
2012,Czechia,CZE,New Zealand,NZL,5,0,0,0,5
2012,Fiji,FJI,New Zealand,NZL,0,0,16,0,16
2012,Germany,DEU,New Zealand,NZL,0,0,5,0,5
2012,Hungary,HUN,New Zealand,NZL,5,0,5,0,10
2012,Iran (Islamic Rep. of),IRN,New Zealand,NZL,14,0,11,0,25
2012,Iraq,IRQ,New Zealand,NZL,5,0,0,0,5
2012,Sri Lanka,LKA,New Zealand,NZL,5,0,0,5,10
2012,Pakistan,PAK,New Zealand,NZL,5,0,5,0,10
2012,South Africa,ZAF,New Zealand,NZL,5,0,0,0,5
2012,Syrian Arab Rep.,SYR,New Zealand,NZL,5,0,0,0,5
2012,Tunisia,TUN,New Zealand,NZL,0,0,5,0,5
2012,Zimbabwe,ZWE,New Zealand,NZL,0,0,5,0,5
2012,Afghanistan,AFG,Poland,POL,0,0,15,0,15
2012,Armenia,ARM,Poland,POL,0,0,31,5,36
2012,Belarus,BLR,Poland,POL,0,0,11,0,11
2012,Cameroon,CMR,Poland,POL,0,0,5,5,10
2012,Dem. Rep. of the Congo,COD,Poland,POL,0,0,5,0,5
2012,Palestinian,PSE,Poland,POL,0,0,0,5,5
2012,Georgia,GEO,Poland,POL,0,0,186,32,218
2012,India,IND,Poland,POL,0,0,5,0,5
2012,Iran (Islamic Rep. of),IRN,Poland,POL,0,0,5,0,5
2012,Kyrgyzstan,KGZ,Poland,POL,0,0,11,0,11
2012,Mongolia,MNG,Poland,POL,0,0,5,0,5
2012,Nigeria,NGA,Poland,POL,0,0,10,0,10
2012,Pakistan,PAK,Poland,POL,0,0,5,0,5
2012,Russian Federation,RUS,Poland,POL,17,42,560,129,748
2012,Viet Nam,VNM,Poland,POL,0,0,5,0,5
2012,Ukraine,UKR,Poland,POL,0,0,13,10,23
2012,Uzbekistan,UZB,Poland,POL,0,0,10,0,10
2012,Angola,AGO,South Africa,ZAF,0,0,5,5,10
2012,Burundi,BDI,South Africa,ZAF,0,0,53,5,58
2012,Bangladesh,BGD,South Africa,ZAF,0,0,142,5,147
2012,China,CHN,South Africa,ZAF,0,0,5,0,5
2012,Cameroon,CMR,South Africa,ZAF,0,0,5,0,5
2012,Congo,COG,South Africa,ZAF,0,0,5,0,5
2012,Dem. Rep. of the Congo,COD,South Africa,ZAF,33,0,120,12,165
2012,Eritrea,ERI,South Africa,ZAF,0,0,5,0,5
2012,Ethiopia,ETH,South Africa,ZAF,0,0,671,5,676
2012,Ghana,GHA,South Africa,ZAF,0,0,0,5,5
2012,India,IND,South Africa,ZAF,0,0,26,0,26
2012,Kenya,KEN,South Africa,ZAF,0,0,5,0,5
2012,Liberia,LBR,South Africa,ZAF,0,0,5,0,5
2012,Malawi,MWI,South Africa,ZAF,0,0,10,0,10
2012,Nigeria,NGA,South Africa,ZAF,0,0,15,0,15
2012,Pakistan,PAK,South Africa,ZAF,0,0,36,0,36
2012,Rwanda,RWA,South Africa,ZAF,0,0,5,0,5
2012,Somalia,SOM,South Africa,ZAF,12,0,5,0,17
2012,United Rep. of Tanzania,TZA,South Africa,ZAF,0,0,5,0,5
2012,Uganda,UGA,South Africa,ZAF,0,0,29,0,29
2012,Zimbabwe,ZWE,South Africa,ZAF,0,0,105,36,141
2012,Afghanistan,AFG,Sweden,SWE,92,118,1473,137,1820
2012,Albania,ALB,Sweden,SWE,0,14,380,38,432
2012,Algeria,DZA,Sweden,SWE,0,0,101,20,121
2012,Angola,AGO,Sweden,SWE,0,0,14,5,19
2012,Egypt,EGY,Sweden,SWE,5,0,135,5,145
2012,Armenia,ARM,Sweden,SWE,0,5,261,25,291
2012,Azerbaijan,AZE,Sweden,SWE,5,5,320,26,356
2012,Burundi,BDI,Sweden,SWE,0,0,16,0,16
2012,Bangladesh,BGD,Sweden,SWE,5,0,133,13,151
2012,Burkina Faso,BFA,Sweden,SWE,0,0,5,0,5
2012,Belarus,BLR,Sweden,SWE,0,0,221,41,262
2012,Bolivia (Plurinational State of),BOL,Sweden,SWE,0,0,21,5,26
2012,Bosnia and Herzegovina,BIH,Sweden,SWE,0,0,529,114,643
2012,Bulgaria,BGR,Sweden,SWE,0,0,5,0,5
2012,Chad,TCD,Sweden,SWE,0,0,5,0,5
2012,China,CHN,Sweden,SWE,23,0,64,10,97
2012,Chile,CHL,Sweden,SWE,0,0,10,0,10
2012,Cameroon,CMR,Sweden,SWE,5,0,22,0,27
2012,Congo,COG,Sweden,SWE,0,0,5,0,5
2012,Dem. Rep. of the Congo,COD,Sweden,SWE,5,5,74,11,95
2012,Colombia,COL,Sweden,SWE,0,0,10,5,15
2012,Cuba,CUB,Sweden,SWE,0,0,22,10,32
2012,Djibouti,DJI,Sweden,SWE,0,0,17,0,17
2012,Eritrea,ERI,Sweden,SWE,5,44,175,29,253
2012,Ethiopia,ETH,Sweden,SWE,17,0,222,18,257
2012,Gambia,GMB,Sweden,SWE,0,0,41,5,46
2012,Georgia,GEO,Sweden,SWE,0,0,132,20,152
2012,Ghana,GHA,Sweden,SWE,0,0,31,5,36
2012,Guinea,GIN,Sweden,SWE,5,0,25,0,30
2012,Honduras,HND,Sweden,SWE,0,0,5,0,5
2012,Croatia,HRV,Sweden,SWE,0,0,10,0,10
2012,Cote d'Ivoire,CIV,Sweden,SWE,0,0,24,0,24
2012,India,IND,Sweden,SWE,0,0,53,0,53
2012,Iran (Islamic Rep. of),IRN,Sweden,SWE,202,23,907,97,1229
2012,Iraq,IRQ,Sweden,SWE,108,21,1009,137,1275
2012,Israel,ISR,Sweden,SWE,0,0,11,0,11
2012,Jordan,JOR,Sweden,SWE,0,0,70,15,85
2012,Kazakhstan,KAZ,Sweden,SWE,0,0,243,41,284
2012,Kenya,KEN,Sweden,SWE,0,0,79,5,84
2012,Kyrgyzstan,KGZ,Sweden,SWE,10,0,331,34,375
2012,Dem. People's Rep. of Korea,PRK,Sweden,SWE,0,0,5,0,5
2012,Kuwait,KWT,Sweden,SWE,0,0,17,0,17
2012,Liberia,LBR,Sweden,SWE,0,0,5,5,10
2012,Libya,LBY,Sweden,SWE,0,0,241,31,272
2012,Lebanon,LBN,Sweden,SWE,5,5,194,25,229
2012,Sri Lanka,LKA,Sweden,SWE,0,0,18,5,23
2012,Mauritania,MRT,Sweden,SWE,0,0,5,0,5
2012,North Macedonia,MKD,Sweden,SWE,0,0,322,30,352
2012,Mexico,MEX,Sweden,SWE,0,0,5,0,5
2012,Mali,MLI,Sweden,SWE,0,0,5,0,5
2012,Mongolia,MNG,Sweden,SWE,5,0,669,57,731
2012,Morocco,MAR,Sweden,SWE,0,0,112,13,125
2012,Montenegro,MNE,Sweden,SWE,0,0,78,15,93
2012,Myanmar,MMR,Sweden,SWE,0,0,5,0,5
2012,Nepal,NPL,Sweden,SWE,0,0,22,0,22
2012,Niger,NER,Sweden,SWE,0,0,5,0,5
2012,Nicaragua,NIC,Sweden,SWE,0,0,11,0,11
2012,Nigeria,NGA,Sweden,SWE,5,0,260,18,283
2012,Pakistan,PAK,Sweden,SWE,15,0,130,18,163
2012,Peru,PER,Sweden,SWE,0,0,5,0,5
2012,Philippines,PHL,Sweden,SWE,0,0,5,5,10
2012,Romania,ROU,Sweden,SWE,0,0,5,0,5
2012,Russian Federation,RUS,Sweden,SWE,28,11,649,105,793
2012,Rwanda,RWA,Sweden,SWE,0,0,10,0,10
2012,El Salvador,SLV,Sweden,SWE,0,0,43,0,43
2012,Saudi Arabia,SAU,Sweden,SWE,0,0,11,0,11
2012,Serbia and Kosovo: S/RES/1244 (1999),SRB,Sweden,SWE,10,0,2250,265,2525
2012,Senegal,SEN,Sweden,SWE,0,0,10,0,10
2012,Sierra Leone,SLE,Sweden,SWE,0,0,22,0,22
2012,Somalia,SOM,Sweden,SWE,10,61,471,76,618
2012,Spain,ESP,Sweden,SWE,0,0,5,0,5
2012,Viet Nam,VNM,Sweden,SWE,0,0,41,5,46
2012,Sudan,SDN,Sweden,SWE,0,0,46,0,46
2012,Syrian Arab Rep.,SYR,Sweden,SWE,28,232,338,153,751
2012,United Rep. of Tanzania,TZA,Sweden,SWE,0,0,31,5,36
2012,Tajikistan,TJK,Sweden,SWE,0,0,25,0,25
2012,Turkmenistan,TKM,Sweden,SWE,0,0,5,0,5
2012,Togo,TGO,Sweden,SWE,0,0,5,0,5
2012,Tunisia,TUN,Sweden,SWE,0,0,69,11,80
2012,Turkey,TUR,Sweden,SWE,0,0,107,19,126
2012,Uganda,UGA,Sweden,SWE,5,0,74,5,84
2012,Ukraine,UKR,Sweden,SWE,0,0,146,19,165
2012,Uzbekistan,UZB,Sweden,SWE,10,5,317,26,358
2012,Yemen,YEM,Sweden,SWE,5,5,90,10,110
2012,Zimbabwe,ZWE,Sweden,SWE,0,0,5,0,5
2012,Stateless,XXA,Sweden,SWE,25,36,543,75,679
2012,Unknown ,,Sweden,SWE,5,13,596,49,663
2012,Afghanistan,AFG,Ukraine,UKR,0,5,54,60,119
2012,Azerbaijan,AZE,Ukraine,UKR,5,0,0,0,5
2012,Cameroon,CMR,Ukraine,UKR,0,0,5,5,10
2012,Congo,COG,Ukraine,UKR,0,0,0,5,5
2012,Dem. Rep. of the Congo,COD,Ukraine,UKR,0,0,12,10,22
2012,Palestinian,PSE,Ukraine,UKR,0,0,5,5,10
2012,Guinea,GIN,Ukraine,UKR,0,0,15,5,20
2012,Cote d'Ivoire,CIV,Ukraine,UKR,0,0,5,0,5
2012,India,IND,Ukraine,UKR,0,0,5,5,10
2012,Iran (Islamic Rep. of),IRN,Ukraine,UKR,0,0,0,5,5
2012,Iraq,IRQ,Ukraine,UKR,0,0,5,5,10
2012,Jordan,JOR,Ukraine,UKR,0,0,0,5,5
2012,Kyrgyzstan,KGZ,Ukraine,UKR,0,0,5,58,63
2012,Sri Lanka,LKA,Ukraine,UKR,0,0,0,5,5
2012,Nigeria,NGA,Ukraine,UKR,0,0,5,0,5
2012,Pakistan,PAK,Ukraine,UKR,0,0,5,5,10
2012,Somalia,SOM,Ukraine,UKR,0,22,5,28,55
2012,Syrian Arab Rep.,SYR,Ukraine,UKR,0,5,19,27,51
2012,Uzbekistan,UZB,Ukraine,UKR,0,0,0,5,5
2012,Stateless,XXA,Ukraine,UKR,0,0,0,5,5
2013,Cuba,CUB,Colombia,COL,0,0,14,0,14
2013,Venezuela (Bolivarian Republic of),VEN,Colombia,COL,0,0,5,0,5
2013,Colombia,COL,Costa Rica,CRI,0,0,108,0,108
2013,Cuba,CUB,Costa Rica,CRI,5,0,24,0,29
2013,Honduras,HND,Costa Rica,CRI,0,0,11,0,11
2013,Nepal,NPL,Costa Rica,CRI,0,0,10,0,10
2013,El Salvador,SLV,Costa Rica,CRI,5,0,17,0,22
2013,Venezuela (Bolivarian Republic of),VEN,Costa Rica,CRI,0,0,5,0,5
2013,Afghanistan,AFG,Cyprus,CYP,0,0,19,0,19
2013,Egypt,EGY,Cyprus,CYP,10,10,46,14,80
2013,Armenia,ARM,Cyprus,CYP,0,0,11,0,11
2013,Bangladesh,BGD,Cyprus,CYP,0,0,100,20,120
2013,Cameroon,CMR,Cyprus,CYP,0,0,10,0,10
2013,Dem. Rep. of the Congo,COD,Cyprus,CYP,0,0,14,0,14
2013,Palestinian,PSE,Cyprus,CYP,0,0,5,442,447
2013,Georgia,GEO,Cyprus,CYP,0,0,5,0,5
2013,Cote d'Ivoire,CIV,Cyprus,CYP,0,0,5,0,5
2013,India,IND,Cyprus,CYP,0,0,13,5,18
2013,Iran (Islamic Rep. of),IRN,Cyprus,CYP,0,10,39,22,71
2013,Iraq,IRQ,Cyprus,CYP,0,0,39,274,313
2013,Jordan,JOR,Cyprus,CYP,0,0,5,5,10
2013,Lebanon,LBN,Cyprus,CYP,0,0,11,5,16
2013,Sri Lanka,LKA,Cyprus,CYP,0,0,43,5,48
2013,Nepal,NPL,Cyprus,CYP,0,0,5,0,5
2013,Nigeria,NGA,Cyprus,CYP,0,0,5,0,5
2013,Pakistan,PAK,Cyprus,CYP,0,0,20,5,25
2013,Philippines,PHL,Cyprus,CYP,0,0,17,0,17
2013,Serbia and Kosovo: S/RES/1244 (1999),SRB,Cyprus,CYP,0,5,10,0,15
2013,Somalia,SOM,Cyprus,CYP,0,0,5,0,5
2013,Viet Nam,VNM,Cyprus,CYP,0,0,66,10,76
2013,Syrian Arab Rep.,SYR,Cyprus,CYP,0,54,5,43,102
2013,Turkey,TUR,Cyprus,CYP,0,5,29,0,34
2013,Ukraine,UKR,Cyprus,CYP,0,0,5,0,5
2013,Afghanistan,AFG,Denmark,DNK,31,100,253,0,384
2013,Albania,ALB,Denmark,DNK,0,0,10,0,10
2013,Algeria,DZA,Denmark,DNK,0,0,10,0,10
2013,Egypt,EGY,Denmark,DNK,0,0,5,0,5
2013,Armenia,ARM,Denmark,DNK,10,17,47,0,74
2013,Azerbaijan,AZE,Denmark,DNK,0,0,10,0,10
2013,Bangladesh,BGD,Denmark,DNK,0,0,47,0,47
2013,Belarus,BLR,Denmark,DNK,0,0,10,0,10
2013,China,CHN,Denmark,DNK,0,0,16,0,16
2013,Chile,CHL,Denmark,DNK,0,0,5,0,5
2013,Cameroon,CMR,Denmark,DNK,0,0,5,0,5
2013,Dem. Rep. of the Congo,COD,Denmark,DNK,5,0,14,0,19
2013,Eritrea,ERI,Denmark,DNK,5,10,0,0,15
2013,Gambia,GMB,Denmark,DNK,0,0,10,0,10
2013,Georgia,GEO,Denmark,DNK,0,0,10,0,10
2013,Ghana,GHA,Denmark,DNK,0,0,11,0,11
2013,Guinea-Bissau,GNB,Denmark,DNK,0,0,5,0,5
2013,Guinea,GIN,Denmark,DNK,0,0,5,0,5
2013,Cote d'Ivoire,CIV,Denmark,DNK,0,0,5,0,5
2013,India,IND,Denmark,DNK,0,0,13,0,13
2013,Iran (Islamic Rep. of),IRN,Denmark,DNK,108,17,55,0,180
2013,Iraq,IRQ,Denmark,DNK,5,0,69,0,74
2013,Kazakhstan,KAZ,Denmark,DNK,0,0,5,0,5
2013,Libya,LBY,Denmark,DNK,0,0,10,0,10
2013,Lebanon,LBN,Denmark,DNK,0,0,5,0,5
2013,Sri Lanka,LKA,Denmark,DNK,5,5,14,0,24
2013,Mali,MLI,Denmark,DNK,0,0,5,0,5
2013,Morocco,MAR,Denmark,DNK,0,0,10,0,10
2013,Myanmar,MMR,Denmark,DNK,0,0,17,0,17
2013,Nigeria,NGA,Denmark,DNK,0,0,47,0,47
2013,Pakistan,PAK,Denmark,DNK,5,0,29,0,34
2013,Russian Federation,RUS,Denmark,DNK,20,42,108,0,170
2013,Serbia and Kosovo: S/RES/1244 (1999),SRB,Denmark,DNK,0,0,5,0,5
2013,Somalia,SOM,Denmark,DNK,0,12,79,0,91
2013,Sudan,SDN,Denmark,DNK,0,5,10,0,15
2013,Slovakia,SVK,Denmark,DNK,0,0,5,0,5
2013,Syrian Arab Rep.,SYR,Denmark,DNK,41,44,37,0,122
2013,Tunisia,TUN,Denmark,DNK,0,0,16,0,16
2013,Turkey,TUR,Denmark,DNK,0,0,11,0,11
2013,Uganda,UGA,Denmark,DNK,5,0,19,0,24
2013,Ukraine,UKR,Denmark,DNK,5,0,5,0,10
2013,Uzbekistan,UZB,Denmark,DNK,0,0,5,0,5
2013,Stateless,XXA,Denmark,DNK,18,28,38,0,84
2013,Unknown ,,Denmark,DNK,0,0,11,0,11
2013,Haiti,HTI,Dominican Rep.,DOM,0,0,27,0,27
2013,Afghanistan,AFG,France,FRA,38,152,79,10,279
2013,Albania,ALB,France,FRA,40,56,266,28,390
2013,Algeria,DZA,France,FRA,34,16,613,73,736
2013,Angola,AGO,France,FRA,65,10,516,18,609
2013,Egypt,EGY,France,FRA,102,5,154,5,266
2013,Armenia,ARM,France,FRA,116,109,2400,105,2730
2013,Azerbaijan,AZE,France,FRA,60,0,338,10,408
2013,Burundi,BDI,France,FRA,5,0,10,5,20
2013,Benin,BEN,France,FRA,0,0,5,0,5
2013,Bangladesh,BGD,France,FRA,451,42,2874,311,3678
2013,Bhutan,BTN,France,FRA,13,0,21,5,39
2013,Burkina Faso,BFA,France,FRA,5,0,15,5,25
2013,Belarus,BLR,France,FRA,11,0,30,0,41
2013,Brazil,BRA,France,FRA,0,0,5,0,5
2013,Bosnia and Herzegovina,BIH,France,FRA,22,10,271,26,329
2013,Cambodia,KHM,France,FRA,0,0,13,0,13
2013,Central African Rep.,CAF,France,FRA,5,5,5,5,20
2013,Chad,TCD,France,FRA,16,0,105,10,131
2013,China,CHN,France,FRA,25,5,1724,175,1929
2013,Cameroon,CMR,France,FRA,21,5,130,5,161
2013,Congo,COG,France,FRA,30,12,436,28,506
2013,Dem. Rep. of the Congo,COD,France,FRA,472,67,3166,124,3829
2013,Comoros,COM,France,FRA,33,11,533,325,902
2013,Colombia,COL,France,FRA,0,5,44,10,59
2013,Cuba,CUB,France,FRA,5,0,0,0,5
2013,Djibouti,DJI,France,FRA,0,0,5,0,5
2013,Dominican Rep.,DOM,France,FRA,0,0,75,13,88
2013,Eritrea,ERI,France,FRA,133,10,192,21,356
2013,Ethiopia,ETH,France,FRA,19,0,39,0,58
2013,Gabon,GAB,France,FRA,0,0,5,0,5
2013,Gambia,GMB,France,FRA,5,0,45,0,50
2013,Palestinian,PSE,France,FRA,11,0,19,0,30
2013,Georgia,GEO,France,FRA,109,44,1370,64,1587
2013,Ghana,GHA,France,FRA,0,0,5,0,5
2013,Guinea-Bissau,GNB,France,FRA,0,0,83,5,88
2013,Guinea,GIN,France,FRA,195,58,1089,43,1385
2013,Haiti,HTI,France,FRA,31,19,1094,249,1393
2013,Croatia,HRV,France,FRA,0,0,5,0,5
2013,Cote d'Ivoire,CIV,France,FRA,63,16,819,42,940
2013,India,IND,France,FRA,5,5,17,0,27
2013,Iran (Islamic Rep. of),IRN,France,FRA,28,5,52,5,90
2013,Iraq,IRQ,France,FRA,5,10,21,5,41
2013,Israel,ISR,France,FRA,0,0,5,0,5
2013,Jamaica,JAM,France,FRA,0,0,5,0,5
2013,Kazakhstan,KAZ,France,FRA,17,5,67,0,89
2013,Kenya,KEN,France,FRA,0,0,10,5,15
2013,Kyrgyzstan,KGZ,France,FRA,15,5,30,5,55
2013,Dem. People's Rep. of Korea,PRK,France,FRA,5,0,19,0,24
2013,Lao People's Dem. Rep.,LAO,France,FRA,0,0,0,5,5
2013,Liberia,LBR,France,FRA,0,0,5,0,5
2013,Libya,LBY,France,FRA,10,0,35,0,45
2013,Lebanon,LBN,France,FRA,0,0,14,0,14
2013,Sri Lanka,LKA,France,FRA,551,26,2022,132,2731
2013,Madagascar,MDG,France,FRA,0,0,86,20,106
2013,Mauritania,MRT,France,FRA,134,10,1139,70,1353
2013,North Macedonia,MKD,France,FRA,0,13,299,29,341
2013,Rep. of Moldova,MDA,France,FRA,0,0,117,5,122
2013,Mali,MLI,France,FRA,17,12,263,23,315
2013,Mongolia,MNG,France,FRA,5,5,197,14,221
2013,Morocco,MAR,France,FRA,10,5,36,5,56
2013,Montenegro,MNE,France,FRA,5,5,121,15,146
2013,Mauritius,MUS,France,FRA,0,0,5,0,5
2013,Myanmar,MMR,France,FRA,35,0,158,5,198
2013,Nepal,NPL,France,FRA,26,0,129,10,165
2013,Nigeria,NGA,France,FRA,19,18,318,30,385
2013,Pakistan,PAK,France,FRA,94,21,1476,68,1659
2013,Peru,PER,France,FRA,0,0,52,0,52
2013,Romania,ROU,France,FRA,0,0,5,0,5
2013,Russian Federation,RUS,France,FRA,537,81,1442,94,2154
2013,Rwanda,RWA,France,FRA,65,0,49,20,134
2013,Serbia and Kosovo: S/RES/1244 (1999),SRB,France,FRA,142,71,1430,139,1782
2013,Senegal,SEN,France,FRA,14,0,61,0,75
2013,Sierra Leone,SLE,France,FRA,0,0,51,5,56
2013,Somalia,SOM,France,FRA,31,117,168,19,335
2013,Viet Nam,VNM,France,FRA,5,0,11,0,16
2013,Sudan,SDN,France,FRA,104,71,399,35,609
2013,Suriname,SUR,France,FRA,0,0,18,0,18
2013,Syrian Arab Rep.,SYR,France,FRA,23,5,13,5,46
2013,Thailand,THA,France,FRA,0,0,14,0,14
2013,Tajikistan,TJK,France,FRA,0,0,5,0,5
2013,Togo,TGO,France,FRA,5,0,49,0,54
2013,Tunisia,TUN,France,FRA,5,0,54,5,64
2013,Turkey,TUR,France,FRA,191,12,1277,76,1556
2013,Uganda,UGA,France,FRA,0,0,5,0,5
2013,Ukraine,UKR,France,FRA,10,0,68,0,78
2013,Uzbekistan,UZB,France,FRA,5,5,18,0,28
2013,Venezuela (Bolivarian Republic of),VEN,France,FRA,0,0,5,0,5
2013,Western Sahara,ESH,France,FRA,13,0,36,0,49
2013,Unknown ,,France,FRA,0,0,5,0,5
2013,Afghanistan,AFG,Greece,GRC,49,142,161,147,499
2013,Albania,ALB,Greece,GRC,0,32,118,76,226
2013,Algeria,DZA,Greece,GRC,10,5,11,5,31
2013,Egypt,EGY,Greece,GRC,14,10,49,21,94
2013,Armenia,ARM,Greece,GRC,0,0,15,0,15
2013,Bangladesh,BGD,Greece,GRC,12,18,475,176,681
2013,Burkina Faso,BFA,Greece,GRC,0,5,0,0,5
2013,China,CHN,Greece,GRC,0,0,70,46,116
2013,Cameroon,CMR,Greece,GRC,0,5,14,0,19
2013,Comoros,COM,Greece,GRC,0,0,5,0,5
2013,Eritrea,ERI,Greece,GRC,5,0,0,0,5
2013,Ethiopia,ETH,Greece,GRC,16,22,5,0,43
2013,Gambia,GMB,Greece,GRC,0,0,27,0,27
2013,Georgia,GEO,Greece,GRC,5,43,276,359,683
2013,Ghana,GHA,Greece,GRC,0,11,68,5,84
2013,Guinea,GIN,Greece,GRC,0,0,19,5,24
2013,Cote d'Ivoire,CIV,Greece,GRC,5,0,20,0,25
2013,India,IND,Greece,GRC,0,0,21,5,26
2013,Indonesia,IDN,Greece,GRC,0,0,5,0,5
2013,Iran (Islamic Rep. of),IRN,Greece,GRC,20,28,0,19,67
2013,Iraq,IRQ,Greece,GRC,82,94,271,307,754
2013,Kenya,KEN,Greece,GRC,5,0,5,0,10
2013,Sri Lanka,LKA,Greece,GRC,0,10,22,0,32
2013,Mauritania,MRT,Greece,GRC,5,0,0,0,5
2013,Rep. of Moldova,MDA,Greece,GRC,0,0,5,0,5
2013,Mali,MLI,Greece,GRC,0,0,5,0,5
2013,Morocco,MAR,Greece,GRC,5,0,24,0,29
2013,Nepal,NPL,Greece,GRC,0,0,5,0,5
2013,Nigeria,NGA,Greece,GRC,11,24,201,48,284
2013,Pakistan,PAK,Greece,GRC,17,33,988,484,1522
2013,Philippines,PHL,Greece,GRC,0,0,5,0,5
2013,Russian Federation,RUS,Greece,GRC,0,0,0,33,33
2013,Senegal,SEN,Greece,GRC,5,5,51,26,87
2013,Sierra Leone,SLE,Greece,GRC,0,0,5,0,5
2013,Somalia,SOM,Greece,GRC,0,22,10,5,37
2013,Viet Nam,VNM,Greece,GRC,0,0,5,0,5
2013,Sudan,SDN,Greece,GRC,17,5,0,5,27
2013,Syrian Arab Rep.,SYR,Greece,GRC,29,41,5,10,85
2013,United Rep. of Tanzania,TZA,Greece,GRC,0,0,5,0,5
2013,Tunisia,TUN,Greece,GRC,0,0,5,10,15
2013,Turkey,TUR,Greece,GRC,5,10,5,5,25
2013,Unknown ,,Greece,GRC,5,5,0,36,46
2013,Croatia,HRV,Iceland,ISL,0,0,0,17,17
2013,North Macedonia,MKD,Iceland,ISL,0,5,0,0,5
2013,Afghanistan,AFG,Ireland,IRL,0,0,32,0,32
2013,Albania,ALB,Ireland,IRL,0,0,20,0,20
2013,Algeria,DZA,Ireland,IRL,0,0,20,0,20
2013,Egypt,EGY,Ireland,IRL,0,0,5,0,5
2013,Bangladesh,BGD,Ireland,IRL,0,0,10,0,10
2013,Belarus,BLR,Ireland,IRL,5,0,0,0,5
2013,Cameroon,CMR,Ireland,IRL,0,0,12,0,12
2013,Congo,COG,Ireland,IRL,0,0,5,0,5
2013,Dem. Rep. of the Congo,COD,Ireland,IRL,5,0,61,0,66
2013,Eritrea,ERI,Ireland,IRL,0,0,5,0,5
2013,Georgia,GEO,Ireland,IRL,0,0,13,0,13
2013,Ghana,GHA,Ireland,IRL,0,0,5,0,5
2013,Guinea,GIN,Ireland,IRL,0,0,5,0,5
2013,Cote d'Ivoire,CIV,Ireland,IRL,0,0,5,0,5
2013,Iran (Islamic Rep. of),IRN,Ireland,IRL,0,0,5,0,5
2013,Iraq,IRQ,Ireland,IRL,0,0,5,0,5
2013,Israel,ISR,Ireland,IRL,0,0,5,0,5
2013,Kuwait,KWT,Ireland,IRL,0,0,5,0,5
2013,Libya,LBY,Ireland,IRL,0,0,5,0,5
2013,Rep. of Moldova,MDA,Ireland,IRL,0,0,5,0,5
2013,Malawi,MWI,Ireland,IRL,0,0,16,0,16
2013,Mauritius,MUS,Ireland,IRL,0,0,10,0,10
2013,Myanmar,MMR,Ireland,IRL,5,0,5,0,10
2013,Nigeria,NGA,Ireland,IRL,5,0,94,5,104
2013,Pakistan,PAK,Ireland,IRL,10,0,64,5,79
2013,South Africa,ZAF,Ireland,IRL,0,0,5,0,5
2013,Rwanda,RWA,Ireland,IRL,0,0,5,0,5
2013,Serbia and Kosovo: S/RES/1244 (1999),SRB,Ireland,IRL,0,0,5,0,5
2013,Sierra Leone,SLE,Ireland,IRL,0,0,5,0,5
2013,Somalia,SOM,Ireland,IRL,0,0,5,0,5
2013,Viet Nam,VNM,Ireland,IRL,0,0,5,0,5
2013,Sudan,SDN,Ireland,IRL,5,0,10,0,15
2013,Syrian Arab Rep.,SYR,Ireland,IRL,0,0,5,0,5
2013,Togo,TGO,Ireland,IRL,0,0,5,0,5
2013,Ukraine,UKR,Ireland,IRL,0,0,5,0,5
2013,Zimbabwe,ZWE,Ireland,IRL,5,0,29,0,34
2013,Stateless,XXA,Ireland,IRL,0,0,5,0,5
2013,Unknown ,,Japan,JPN,5,108,813,211,1137
2013,Burundi,BDI,Malawi,MWI,0,0,0,182,182
2013,Dem. Rep. of the Congo,COD,Malawi,MWI,0,0,0,5,5
2013,Rwanda,RWA,Malawi,MWI,0,0,0,223,223
2013,Dem. Rep. of the Congo,COD,Mozambique,MOZ,5,0,0,0,5
2013,Egypt,EGY,Malta,MLT,0,0,5,0,5
2013,Eritrea,ERI,Malta,MLT,0,0,12,0,12
2013,Ethiopia,ETH,Malta,MLT,0,0,5,0,5
2013,Palestinian,PSE,Malta,MLT,0,0,5,0,5
2013,Ghana,GHA,Malta,MLT,0,0,41,0,41
2013,Guinea,GIN,Malta,MLT,0,0,5,0,5
2013,India,IND,Malta,MLT,0,0,5,0,5
2013,Libya,LBY,Malta,MLT,0,0,5,0,5
2013,Mali,MLI,Malta,MLT,0,0,5,0,5
2013,Morocco,MAR,Malta,MLT,0,0,5,0,5
2013,Niger,NER,Malta,MLT,0,0,5,0,5
2013,Nigeria,NGA,Malta,MLT,0,0,49,0,49
2013,Pakistan,PAK,Malta,MLT,0,0,22,0,22
2013,Senegal,SEN,Malta,MLT,0,0,5,0,5
2013,Somalia,SOM,Malta,MLT,0,0,19,0,19
2013,Togo,TGO,Malta,MLT,0,0,5,0,5
2013,Cote d'Ivoire,CIV,Niger,NER,18,0,10,0,28
2013,Afghanistan,AFG,Norway,NOR,38,110,1091,34,1273
2013,Albania,ALB,Norway,NOR,0,5,116,5,126
2013,Algeria,DZA,Norway,NOR,0,0,82,5,87
2013,Angola,AGO,Norway,NOR,0,0,17,0,17
2013,Egypt,EGY,Norway,NOR,0,0,33,0,33
2013,Armenia,ARM,Norway,NOR,0,0,38,5,43
2013,Azerbaijan,AZE,Norway,NOR,0,0,64,0,64
2013,Burundi,BDI,Norway,NOR,0,14,42,0,56
2013,Benin,BEN,Norway,NOR,0,0,5,0,5
2013,Bangladesh,BGD,Norway,NOR,0,0,198,21,219
2013,Bhutan,BTN,Norway,NOR,0,0,5,0,5
2013,Burkina Faso,BFA,Norway,NOR,0,0,10,0,10
2013,Belarus,BLR,Norway,NOR,0,0,41,5,46
2013,Brazil,BRA,Norway,NOR,0,0,5,0,5
2013,Bosnia and Herzegovina,BIH,Norway,NOR,0,0,30,0,30
2013,Bulgaria,BGR,Norway,NOR,0,0,5,0,5
2013,Chad,TCD,Norway,NOR,0,0,14,0,14
2013,China,CHN,Norway,NOR,0,0,31,0,31
2013,Cameroon,CMR,Norway,NOR,0,0,22,0,22
2013,Congo,COG,Norway,NOR,0,0,5,0,5
2013,Dem. Rep. of the Congo,COD,Norway,NOR,0,21,97,5,123
2013,Djibouti,DJI,Norway,NOR,0,0,10,0,10
2013,Eritrea,ERI,Norway,NOR,64,32,730,63,889
2013,Ethiopia,ETH,Norway,NOR,67,58,487,30,642
2013,Gambia,GMB,Norway,NOR,0,0,57,5,62
2013,Georgia,GEO,Norway,NOR,0,0,85,5,90
2013,Germany,DEU,Norway,NOR,0,0,5,0,5
2013,Ghana,GHA,Norway,NOR,0,0,41,0,41
2013,Guinea-Bissau,GNB,Norway,NOR,0,0,16,0,16
2013,Greece,GRC,Norway,NOR,0,0,5,0,5
2013,Guatemala,GTM,Norway,NOR,0,0,5,0,5
2013,Guinea,GIN,Norway,NOR,0,0,53,0,53
2013,Croatia,HRV,Norway,NOR,0,0,5,0,5
2013,Cote d'Ivoire,CIV,Norway,NOR,0,0,56,0,56
2013,India,IND,Norway,NOR,0,0,37,5,42
2013,Iran (Islamic Rep. of),IRN,Norway,NOR,70,88,833,29,1020
2013,Iraq,IRQ,Norway,NOR,18,35,579,48,680
2013,Israel,ISR,Norway,NOR,0,5,5,0,10
2013,Italy,ITA,Norway,NOR,0,0,5,0,5
2013,Jordan,JOR,Norway,NOR,0,0,35,0,35
2013,Kazakhstan,KAZ,Norway,NOR,0,0,24,0,24
2013,Kenya,KEN,Norway,NOR,0,0,16,0,16
2013,Kyrgyzstan,KGZ,Norway,NOR,0,10,26,10,46
2013,Liberia,LBR,Norway,NOR,0,0,34,0,34
2013,Libya,LBY,Norway,NOR,0,0,82,5,87
2013,Lebanon,LBN,Norway,NOR,0,5,30,0,35
2013,Sri Lanka,LKA,Norway,NOR,0,28,84,0,112
2013,Mauritania,MRT,Norway,NOR,0,0,10,0,10
2013,North Macedonia,MKD,Norway,NOR,0,0,10,5,15
2013,Rep. of Moldova,MDA,Norway,NOR,0,0,5,0,5
2013,Mexico,MEX,Norway,NOR,0,0,5,0,5
2013,Mali,MLI,Norway,NOR,0,0,30,5,35
2013,Malawi,MWI,Norway,NOR,0,0,5,0,5
2013,Mongolia,MNG,Norway,NOR,0,0,5,5,10
2013,Morocco,MAR,Norway,NOR,0,0,127,5,132
2013,Montenegro,MNE,Norway,NOR,0,0,5,0,5
2013,Myanmar,MMR,Norway,NOR,0,0,14,0,14
2013,Nepal,NPL,Norway,NOR,0,0,14,0,14
2013,Niger,NER,Norway,NOR,0,0,17,0,17
2013,Nigeria,NGA,Norway,NOR,5,19,566,10,600
2013,Pakistan,PAK,Norway,NOR,0,5,132,10,147
2013,Peru,PER,Norway,NOR,0,0,5,0,5
2013,Poland,POL,Norway,NOR,0,0,5,0,5
2013,Romania,ROU,Norway,NOR,0,0,5,0,5
2013,Russian Federation,RUS,Norway,NOR,64,69,444,75,652
2013,Rwanda,RWA,Norway,NOR,0,5,22,0,27
2013,El Salvador,SLV,Norway,NOR,0,0,17,0,17
2013,Serbia and Kosovo: S/RES/1244 (1999),SRB,Norway,NOR,0,5,182,26,213
2013,Senegal,SEN,Norway,NOR,0,0,28,0,28
2013,Sierra Leone,SLE,Norway,NOR,0,0,27,0,27
2013,Somalia,SOM,Norway,NOR,0,26,1182,81,1289
2013,Viet Nam,VNM,Norway,NOR,0,0,14,0,14
2013,Sudan,SDN,Norway,NOR,5,0,224,5,234
2013,South Sudan,SSD,Norway,NOR,0,0,5,0,5
2013,Syrian Arab Rep.,SYR,Norway,NOR,0,55,127,5,187
2013,United Rep. of Tanzania,TZA,Norway,NOR,0,0,10,0,10
2013,Thailand,THA,Norway,NOR,0,0,5,0,5
2013,Turkmenistan,TKM,Norway,NOR,0,0,5,0,5
2013,Togo,TGO,Norway,NOR,0,0,5,0,5
2013,Tunisia,TUN,Norway,NOR,0,0,50,5,55
2013,Turkey,TUR,Norway,NOR,0,0,84,5,89
2013,Uganda,UGA,Norway,NOR,0,10,39,5,54
2013,Ukraine,UKR,Norway,NOR,0,0,36,0,36
2013,United States of America,USA,Norway,NOR,0,0,5,0,5
2013,Uzbekistan,UZB,Norway,NOR,0,5,118,45,168
2013,Venezuela (Bolivarian Republic of),VEN,Norway,NOR,0,0,5,0,5
2013,Yemen,YEM,Norway,NOR,0,0,129,0,129
2013,Zimbabwe,ZWE,Norway,NOR,5,0,12,0,17
2013,Stateless,XXA,Norway,NOR,0,26,420,10,456
2013,Unknown ,,New Zealand,NZL,44,0,80,13,137
2013,Afghanistan,AFG,Poland,POL,0,0,12,0,12
2013,Armenia,ARM,Poland,POL,0,0,52,5,57
2013,Bangladesh,BGD,Poland,POL,0,0,5,0,5
2013,Belarus,BLR,Poland,POL,0,0,10,0,10
2013,Georgia,GEO,Poland,POL,0,0,177,24,201
2013,Iran (Islamic Rep. of),IRN,Poland,POL,0,0,5,0,5
2013,Iraq,IRQ,Poland,POL,0,0,5,0,5
2013,Kazakhstan,KAZ,Poland,POL,0,0,12,0,12
2013,Kyrgyzstan,KGZ,Poland,POL,0,5,5,0,10
2013,Nigeria,NGA,Poland,POL,0,0,5,0,5
2013,Pakistan,PAK,Poland,POL,0,0,11,0,11
2013,Russian Federation,RUS,Poland,POL,0,35,562,133,730
2013,Viet Nam,VNM,Poland,POL,0,0,10,0,10
2013,Turkey,TUR,Poland,POL,0,0,5,0,5
2013,Ukraine,UKR,Poland,POL,0,0,10,0,10
2013,Angola,AGO,South Africa,ZAF,0,0,34,0,34
2013,Egypt,EGY,South Africa,ZAF,0,0,5,5,10
2013,Burundi,BDI,South Africa,ZAF,0,0,24,5,29
2013,Bangladesh,BGD,South Africa,ZAF,0,0,122,163,285
2013,Cameroon,CMR,South Africa,ZAF,0,0,5,11,16
2013,Dem. Rep. of the Congo,COD,South Africa,ZAF,40,0,226,106,372
2013,Eritrea,ERI,South Africa,ZAF,0,0,10,5,15
2013,Ethiopia,ETH,South Africa,ZAF,5,0,555,201,761
2013,Ghana,GHA,South Africa,ZAF,0,0,10,5,15
2013,India,IND,South Africa,ZAF,0,0,45,65,110
2013,Iran (Islamic Rep. of),IRN,South Africa,ZAF,0,0,5,0,5
2013,Kenya,KEN,South Africa,ZAF,0,0,10,5,15
2013,Malawi,MWI,South Africa,ZAF,0,0,5,5,10
2013,Nigeria,NGA,South Africa,ZAF,0,0,37,56,93
2013,Pakistan,PAK,South Africa,ZAF,0,0,121,104,225
2013,Rwanda,RWA,South Africa,ZAF,0,0,0,5,5
2013,Senegal,SEN,South Africa,ZAF,0,0,10,0,10
2013,Somalia,SOM,South Africa,ZAF,5,0,42,13,60
2013,United Rep. of Tanzania,TZA,South Africa,ZAF,0,0,5,0,5
2013,Uganda,UGA,South Africa,ZAF,0,0,28,17,45
2013,Zimbabwe,ZWE,South Africa,ZAF,53,0,1302,773,2128
2013,Afghanistan,AFG,Sweden,SWE,89,160,1133,136,1518
2013,Albania,ALB,Sweden,SWE,0,22,761,82,865
2013,Algeria,DZA,Sweden,SWE,0,0,65,10,75
2013,Angola,AGO,Sweden,SWE,0,0,5,0,5
2013,Egypt,EGY,Sweden,SWE,5,0,104,12,121
2013,Armenia,ARM,Sweden,SWE,0,5,191,25,221
2013,Azerbaijan,AZE,Sweden,SWE,0,12,133,27,172
2013,Burundi,BDI,Sweden,SWE,0,0,11,5,16
2013,Bangladesh,BGD,Sweden,SWE,5,5,86,10,106
2013,Burkina Faso,BFA,Sweden,SWE,0,0,5,0,5
2013,Belarus,BLR,Sweden,SWE,0,0,149,27,176
2013,Bolivia (Plurinational State of),BOL,Sweden,SWE,0,5,35,0,40
2013,Bosnia and Herzegovina,BIH,Sweden,SWE,0,14,306,54,374
2013,Chad,TCD,Sweden,SWE,0,0,5,0,5
2013,China,CHN,Sweden,SWE,5,0,16,5,26
2013,Chile,CHL,Sweden,SWE,0,0,10,5,15
2013,Cameroon,CMR,Sweden,SWE,0,0,17,0,17
2013,Congo,COG,Sweden,SWE,0,5,5,0,10
2013,Dem. Rep. of the Congo,COD,Sweden,SWE,5,12,48,5,70
2013,Colombia,COL,Sweden,SWE,0,0,10,0,10
2013,Cuba,CUB,Sweden,SWE,0,0,35,0,35
2013,Djibouti,DJI,Sweden,SWE,0,0,10,5,15
2013,Ecuador,ECU,Sweden,SWE,0,0,11,5,16
2013,Eritrea,ERI,Sweden,SWE,10,36,184,24,254
2013,Ethiopia,ETH,Sweden,SWE,14,0,147,15,176
2013,Gambia,GMB,Sweden,SWE,5,5,48,5,63
2013,Georgia,GEO,Sweden,SWE,0,5,157,23,185
2013,Ghana,GHA,Sweden,SWE,0,0,33,0,33
2013,Guinea-Bissau,GNB,Sweden,SWE,0,0,5,0,5
2013,Greece,GRC,Sweden,SWE,0,0,5,5,10
2013,Guinea,GIN,Sweden,SWE,0,0,28,5,33
2013,Honduras,HND,Sweden,SWE,0,0,5,0,5
2013,Cote d'Ivoire,CIV,Sweden,SWE,0,0,18,0,18
2013,India,IND,Sweden,SWE,0,5,34,0,39
2013,Iran (Islamic Rep. of),IRN,Sweden,SWE,219,17,605,106,947
2013,Iraq,IRQ,Sweden,SWE,56,24,598,93,771
2013,Israel,ISR,Sweden,SWE,0,0,5,0,5
2013,Italy,ITA,Sweden,SWE,0,0,5,0,5
2013,Jordan,JOR,Sweden,SWE,0,5,122,10,137
2013,Japan,JPN,Sweden,SWE,0,0,5,0,5
2013,Kazakhstan,KAZ,Sweden,SWE,0,5,235,34,274
2013,Kenya,KEN,Sweden,SWE,0,0,54,0,54
2013,Kyrgyzstan,KGZ,Sweden,SWE,10,0,221,26,257
2013,Rep. of Korea,KOR,Sweden,SWE,0,0,5,0,5
2013,Kuwait,KWT,Sweden,SWE,5,0,12,0,17
2013,Liberia,LBR,Sweden,SWE,0,0,5,0,5
2013,Libya,LBY,Sweden,SWE,0,0,108,10,118
2013,Lebanon,LBN,Sweden,SWE,5,14,241,20,280
2013,Sri Lanka,LKA,Sweden,SWE,0,0,20,0,20
2013,Latvia,LVA,Sweden,SWE,0,0,5,0,5
2013,Mauritania,MRT,Sweden,SWE,0,0,5,0,5
2013,North Macedonia,MKD,Sweden,SWE,0,0,299,17,316
2013,Rep. of Moldova,MDA,Sweden,SWE,0,0,10,0,10
2013,Mexico,MEX,Sweden,SWE,0,0,11,0,11
2013,Mali,MLI,Sweden,SWE,0,0,10,0,10
2013,Mongolia,MNG,Sweden,SWE,0,0,274,23,297
2013,Morocco,MAR,Sweden,SWE,0,5,144,24,173
2013,Montenegro,MNE,Sweden,SWE,0,0,47,0,47
2013,Nepal,NPL,Sweden,SWE,0,0,5,0,5
2013,Niger,NER,Sweden,SWE,0,0,5,0,5
2013,Nicaragua,NIC,Sweden,SWE,0,0,12,5,17
2013,Nigeria,NGA,Sweden,SWE,5,0,290,16,311
2013,Pakistan,PAK,Sweden,SWE,5,5,173,17,200
2013,Philippines,PHL,Sweden,SWE,0,0,0,5,5
2013,Poland,POL,Sweden,SWE,0,0,0,5,5
2013,Romania,ROU,Sweden,SWE,0,0,11,0,11
2013,Russian Federation,RUS,Sweden,SWE,5,12,394,41,452
2013,Rwanda,RWA,Sweden,SWE,0,0,5,5,10
2013,El Salvador,SLV,Sweden,SWE,0,5,40,0,45
2013,Serbia and Kosovo: S/RES/1244 (1999),SRB,Sweden,SWE,0,46,1488,205,1739
2013,Senegal,SEN,Sweden,SWE,0,0,17,5,22
2013,Sierra Leone,SLE,Sweden,SWE,0,0,10,0,10
2013,Somalia,SOM,Sweden,SWE,23,41,699,84,847
2013,Viet Nam,VNM,Sweden,SWE,0,0,20,5,25
2013,Sudan,SDN,Sweden,SWE,0,5,52,5,62
2013,Syrian Arab Rep.,SYR,Sweden,SWE,71,478,811,1107,2467
2013,United Rep. of Tanzania,TZA,Sweden,SWE,0,0,10,0,10
2013,Thailand,THA,Sweden,SWE,0,0,5,0,5
2013,Tajikistan,TJK,Sweden,SWE,0,0,22,0,22
2013,Turkmenistan,TKM,Sweden,SWE,0,0,5,5,10
2013,Tunisia,TUN,Sweden,SWE,0,0,49,5,54
2013,Turkey,TUR,Sweden,SWE,5,0,82,27,114
2013,Uganda,UGA,Sweden,SWE,10,5,56,5,76
2013,Ukraine,UKR,Sweden,SWE,0,0,78,10,88
2013,United States of America,USA,Sweden,SWE,0,0,5,0,5
2013,Uzbekistan,UZB,Sweden,SWE,10,13,228,17,268
2013,Venezuela (Bolivarian Republic of),VEN,Sweden,SWE,0,0,5,0,5
2013,Yemen,YEM,Sweden,SWE,10,5,154,20,189
2013,Stateless,XXA,Sweden,SWE,48,148,634,295,1125
2013,Unknown ,,Sweden,SWE,5,18,378,46,447
2013,Afghanistan,AFG,Switzerland,CHE,0,59,168,101,328
2013,Albania,ALB,Switzerland,CHE,0,0,41,30,71
2013,Algeria,DZA,Switzerland,CHE,0,0,66,37,103
2013,Angola,AGO,Switzerland,CHE,0,0,14,16,30
2013,Egypt,EGY,Switzerland,CHE,0,0,35,10,45
2013,Armenia,ARM,Switzerland,CHE,0,16,82,34,132
2013,Benin,BEN,Switzerland,CHE,0,0,5,10,15
2013,Bangladesh,BGD,Switzerland,CHE,0,0,24,5,29
2013,Burkina Faso,BFA,Switzerland,CHE,0,0,5,5,10
2013,Belarus,BLR,Switzerland,CHE,0,5,14,10,29
2013,Bosnia and Herzegovina,BIH,Switzerland,CHE,0,26,91,79,196
2013,China,CHN,Switzerland,CHE,0,5,28,13,46
2013,Cameroon,CMR,Switzerland,CHE,0,5,19,14,38
2013,Congo,COG,Switzerland,CHE,0,0,5,0,5
2013,Dem. Rep. of the Congo,COD,Switzerland,CHE,0,5,79,48,132
2013,Colombia,COL,Switzerland,CHE,0,5,28,35,68
2013,Cuba,CUB,Switzerland,CHE,0,0,5,0,5
2013,Eritrea,ERI,Switzerland,CHE,0,63,396,155,614
2013,Ethiopia,ETH,Switzerland,CHE,0,5,73,36,114
2013,France,FRA,Switzerland,CHE,0,0,5,0,5
2013,Gambia,GMB,Switzerland,CHE,0,0,29,11,40
2013,Georgia,GEO,Switzerland,CHE,0,0,65,22,87
2013,Ghana,GHA,Switzerland,CHE,0,0,15,10,25
2013,Guinea-Bissau,GNB,Switzerland,CHE,0,0,22,17,39
2013,Guinea,GIN,Switzerland,CHE,0,5,35,17,57
2013,Haiti,HTI,Switzerland,CHE,0,0,5,0,5
2013,Hungary,HUN,Switzerland,CHE,0,0,0,5,5
2013,Cote d'Ivoire,CIV,Switzerland,CHE,0,0,19,10,29
2013,India,IND,Switzerland,CHE,0,0,0,12,12
2013,Iran (Islamic Rep. of),IRN,Switzerland,CHE,0,18,90,34,142
2013,Iraq,IRQ,Switzerland,CHE,0,10,63,34,107
2013,Italy,ITA,Switzerland,CHE,0,0,5,0,5
2013,Jordan,JOR,Switzerland,CHE,0,0,5,0,5
2013,Kazakhstan,KAZ,Switzerland,CHE,0,0,11,5,16
2013,Kyrgyzstan,KGZ,Switzerland,CHE,0,5,15,0,20
2013,Liberia,LBR,Switzerland,CHE,0,0,5,0,5
2013,Libya,LBY,Switzerland,CHE,0,5,17,16,38
2013,Lebanon,LBN,Switzerland,CHE,0,0,16,0,16
2013,Sri Lanka,LKA,Switzerland,CHE,0,116,425,380,921
2013,Mauritania,MRT,Switzerland,CHE,0,0,5,0,5
2013,North Macedonia,MKD,Switzerland,CHE,0,0,77,86,163
2013,Mali,MLI,Switzerland,CHE,0,0,5,11,16
2013,Mongolia,MNG,Switzerland,CHE,0,0,48,14,62
2013,Morocco,MAR,Switzerland,CHE,0,0,68,26,94
2013,Montenegro,MNE,Switzerland,CHE,0,0,42,5,47
2013,Nepal,NPL,Switzerland,CHE,0,0,15,0,15
2013,Niger,NER,Switzerland,CHE,0,0,5,5,10
2013,Nigeria,NGA,Switzerland,CHE,0,0,190,93,283
2013,Pakistan,PAK,Switzerland,CHE,0,0,51,46,97
2013,Poland,POL,Switzerland,CHE,0,0,5,5,10
2013,South Africa,ZAF,Switzerland,CHE,0,0,5,0,5
2013,Russian Federation,RUS,Switzerland,CHE,0,23,203,35,261
2013,Serbia and Kosovo: S/RES/1244 (1999),SRB,Switzerland,CHE,0,59,570,361,990
2013,Senegal,SEN,Switzerland,CHE,0,0,36,14,50
2013,Somalia,SOM,Switzerland,CHE,0,30,69,58,157
2013,Spain,ESP,Switzerland,CHE,0,0,5,0,5
2013,Sudan,SDN,Switzerland,CHE,0,5,0,0,5
2013,Syrian Arab Rep.,SYR,Switzerland,CHE,0,34,140,86,260
2013,Togo,TGO,Switzerland,CHE,0,5,27,28,60
2013,Tunisia,TUN,Switzerland,CHE,0,5,85,32,122
2013,Turkey,TUR,Switzerland,CHE,0,31,200,110,341
2013,Uganda,UGA,Switzerland,CHE,0,0,5,0,5
2013,Ukraine,UKR,Switzerland,CHE,0,10,11,5,26
2013,Uzbekistan,UZB,Switzerland,CHE,0,0,5,5,10
2013,Yemen,YEM,Switzerland,CHE,0,5,5,5,15
2013,Unknown ,,Switzerland,CHE,0,13,86,56,155
2013,Afghanistan,AFG,Ukraine,UKR,10,0,79,5,94
2013,Bangladesh,BGD,Ukraine,UKR,0,0,5,0,5
2013,Belarus,BLR,Ukraine,UKR,5,0,0,0,5
2013,Cameroon,CMR,Ukraine,UKR,0,0,10,0,10
2013,Congo,COG,Ukraine,UKR,0,0,5,0,5
2013,Dem. Rep. of the Congo,COD,Ukraine,UKR,5,0,5,0,10
2013,Palestinian,PSE,Ukraine,UKR,0,0,5,0,5
2013,Georgia,GEO,Ukraine,UKR,0,0,5,0,5
2013,Guinea,GIN,Ukraine,UKR,0,0,5,0,5
2013,Iran (Islamic Rep. of),IRN,Ukraine,UKR,12,0,14,0,26
2013,Iraq,IRQ,Ukraine,UKR,5,0,0,0,5
2013,Lebanon,LBN,Ukraine,UKR,0,0,5,0,5
2013,Sri Lanka,LKA,Ukraine,UKR,0,0,5,0,5
2013,Pakistan,PAK,Ukraine,UKR,0,0,12,0,12
2013,Russian Federation,RUS,Ukraine,UKR,10,0,10,5,25
2013,Somalia,SOM,Ukraine,UKR,0,0,5,0,5
2013,Sudan,SDN,Ukraine,UKR,0,0,5,0,5
2013,Syrian Arab Rep.,SYR,Ukraine,UKR,61,0,33,5,99
2013,Uzbekistan,UZB,Ukraine,UKR,10,0,12,5,27
2014,Dem. Rep. of the Congo,COD,Burundi,BDI,1540,0,1500,1137,4177
2014,Rwanda,RWA,Burundi,BDI,0,0,5,20,25
2014,Afghanistan,AFG,Canada,CAN,5,0,15,0,20
2014,Albania,ALB,Canada,CAN,0,0,40,0,40
2014,Algeria,DZA,Canada,CAN,0,0,32,0,32
2014,Angola,AGO,Canada,CAN,0,0,5,0,5
2014,Antigua and Barbuda,ATG,Canada,CAN,0,0,5,0,5
2014,Egypt,EGY,Canada,CAN,0,0,19,0,19
2014,Burundi,BDI,Canada,CAN,0,0,5,0,5
2014,Benin,BEN,Canada,CAN,0,0,5,0,5
2014,Bangladesh,BGD,Canada,CAN,0,0,34,0,34
2014,Belarus,BLR,Canada,CAN,5,0,0,0,5
2014,Bosnia and Herzegovina,BIH,Canada,CAN,0,0,5,0,5
2014,Cambodia,KHM,Canada,CAN,0,0,10,5,15
2014,China,CHN,Canada,CAN,14,0,206,5,225
2014,Cameroon,CMR,Canada,CAN,5,0,28,0,33
2014,Congo,COG,Canada,CAN,0,0,24,0,24
2014,Dem. Rep. of the Congo,COD,Canada,CAN,0,0,21,0,21
2014,Colombia,COL,Canada,CAN,0,0,35,5,40
2014,Cuba,CUB,Canada,CAN,5,0,24,0,29
2014,Dominican Rep.,DOM,Canada,CAN,0,0,5,0,5
2014,Eritrea,ERI,Canada,CAN,0,0,12,0,12
2014,Ethiopia,ETH,Canada,CAN,0,0,22,0,22
2014,Georgia,GEO,Canada,CAN,0,0,10,0,10
2014,Ghana,GHA,Canada,CAN,0,0,15,0,15
2014,Guinea-Bissau,GNB,Canada,CAN,0,0,5,0,5
2014,Grenada,GRD,Canada,CAN,0,0,10,0,10
2014,Guatemala,GTM,Canada,CAN,0,0,10,0,10
2014,Guinea,GIN,Canada,CAN,0,0,18,0,18
2014,Guyana,GUY,Canada,CAN,0,0,11,0,11
2014,Haiti,HTI,Canada,CAN,5,0,37,0,42
2014,Honduras,HND,Canada,CAN,0,0,16,0,16
2014,Croatia,HRV,Canada,CAN,0,0,5,0,5
2014,Cote d'Ivoire,CIV,Canada,CAN,0,0,5,0,5
2014,India,IND,Canada,CAN,0,0,90,0,90
2014,Indonesia,IDN,Canada,CAN,0,0,5,0,5
2014,Iran (Islamic Rep. of),IRN,Canada,CAN,0,0,28,0,28
2014,Iraq,IRQ,Canada,CAN,0,0,17,5,22
2014,Italy,ITA,Canada,CAN,0,0,5,0,5
2014,Jamaica,JAM,Canada,CAN,5,0,43,0,48
2014,Jordan,JOR,Canada,CAN,0,0,10,0,10
2014,Kenya,KEN,Canada,CAN,0,0,5,0,5
2014,Dem. People's Rep. of Korea,PRK,Canada,CAN,0,0,5,0,5
2014,Lao People's Dem. Rep.,LAO,Canada,CAN,0,0,5,0,5
2014,Libya,LBY,Canada,CAN,0,0,5,0,5
2014,Saint Lucia,LCA,Canada,CAN,0,0,18,0,18
2014,Lebanon,LBN,Canada,CAN,0,0,42,5,47
2014,Sri Lanka,LKA,Canada,CAN,0,0,16,0,16
2014,Mauritania,MRT,Canada,CAN,0,0,5,0,5
2014,Mexico,MEX,Canada,CAN,0,0,11,0,11
2014,Mali,MLI,Canada,CAN,0,0,5,0,5
2014,Morocco,MAR,Canada,CAN,0,0,5,0,5
2014,Namibia,NAM,Canada,CAN,0,0,5,0,5
2014,Nigeria,NGA,Canada,CAN,5,0,170,5,180
2014,Pakistan,PAK,Canada,CAN,10,0,56,5,71
2014,Peru,PER,Canada,CAN,0,0,5,0,5
2014,Philippines,PHL,Canada,CAN,0,0,10,0,10
2014,Portugal,PRT,Canada,CAN,0,0,5,0,5
2014,Romania,ROU,Canada,CAN,0,0,5,0,5
2014,South Africa,ZAF,Canada,CAN,0,0,5,0,5
2014,Russian Federation,RUS,Canada,CAN,0,0,5,0,5
2014,Rwanda,RWA,Canada,CAN,0,0,5,0,5
2014,El Salvador,SLV,Canada,CAN,0,0,14,0,14
2014,Serbia and Kosovo: S/RES/1244 (1999),SRB,Canada,CAN,0,0,21,0,21
2014,Senegal,SEN,Canada,CAN,0,0,10,0,10
2014,Somalia,SOM,Canada,CAN,0,0,34,0,34
2014,Viet Nam,VNM,Canada,CAN,0,0,5,0,5
2014,Saint Kitts and Nevis,KNA,Canada,CAN,0,0,5,0,5
2014,Sudan,SDN,Canada,CAN,0,0,5,0,5
2014,Syrian Arab Rep.,SYR,Canada,CAN,0,0,10,5,15
2014,United Rep. of Tanzania,TZA,Canada,CAN,0,0,5,0,5
2014,Trinidad and Tobago,TTO,Canada,CAN,0,0,5,5,10
2014,Tunisia,TUN,Canada,CAN,0,0,10,0,10
2014,Turkey,TUR,Canada,CAN,0,0,21,0,21
2014,Ukraine,UKR,Canada,CAN,0,0,16,0,16
2014,United States of America,USA,Canada,CAN,0,0,5,0,5
2014,Saint Vincent and the Grenadines,VCT,Canada,CAN,0,0,24,0,24
2014,Yemen,YEM,Canada,CAN,0,0,5,0,5
2014,Zimbabwe,ZWE,Canada,CAN,0,0,5,0,5
2014,Cuba,CUB,Colombia,COL,0,0,14,0,14
2014,Colombia,COL,Costa Rica,CRI,5,0,99,22,126
2014,Cuba,CUB,Costa Rica,CRI,0,0,13,0,13
2014,Guatemala,GTM,Costa Rica,CRI,0,0,0,5,5
2014,Honduras,HND,Costa Rica,CRI,0,0,5,0,5
2014,El Salvador,SLV,Costa Rica,CRI,12,0,0,0,12
2014,Venezuela (Bolivarian Republic of),VEN,Costa Rica,CRI,0,0,0,5,5
2014,Afghanistan,AFG,Cyprus,CYP,0,0,0,5,5
2014,Algeria,DZA,Cyprus,CYP,0,0,0,5,5
2014,Egypt,EGY,Cyprus,CYP,0,0,42,0,42
2014,Bangladesh,BGD,Cyprus,CYP,0,0,21,10,31
2014,Dem. Rep. of the Congo,COD,Cyprus,CYP,0,0,5,0,5
2014,Palestinian,PSE,Cyprus,CYP,0,5,0,12,17
2014,India,IND,Cyprus,CYP,0,0,12,0,12
2014,Iran (Islamic Rep. of),IRN,Cyprus,CYP,5,5,11,0,21
2014,Iraq,IRQ,Cyprus,CYP,0,5,12,37,54
2014,Kazakhstan,KAZ,Cyprus,CYP,0,0,5,0,5
2014,Lebanon,LBN,Cyprus,CYP,0,0,5,0,5
2014,Sri Lanka,LKA,Cyprus,CYP,0,0,19,0,19
2014,Nigeria,NGA,Cyprus,CYP,0,0,5,0,5
2014,Pakistan,PAK,Cyprus,CYP,0,0,5,5,10
2014,Philippines,PHL,Cyprus,CYP,0,0,12,5,17
2014,Serbia and Kosovo: S/RES/1244 (1999),SRB,Cyprus,CYP,0,0,10,0,10
2014,Somalia,SOM,Cyprus,CYP,5,0,0,0,5
2014,Viet Nam,VNM,Cyprus,CYP,0,0,32,5,37
2014,Syrian Arab Rep.,SYR,Cyprus,CYP,0,196,0,0,196
2014,Turkey,TUR,Cyprus,CYP,0,0,5,0,5
2014,Afghanistan,AFG,Denmark,DNK,16,37,133,0,186
2014,Albania,ALB,Denmark,DNK,0,0,21,0,21
2014,Algeria,DZA,Denmark,DNK,0,0,11,0,11
2014,Egypt,EGY,Denmark,DNK,0,0,12,0,12
2014,Armenia,ARM,Denmark,DNK,0,10,48,0,58
2014,Azerbaijan,AZE,Denmark,DNK,0,0,5,0,5
2014,Bangladesh,BGD,Denmark,DNK,5,0,76,0,81
2014,Belarus,BLR,Denmark,DNK,0,0,5,0,5
2014,Bulgaria,BGR,Denmark,DNK,0,0,5,0,5
2014,Chad,TCD,Denmark,DNK,0,0,17,0,17
2014,China,CHN,Denmark,DNK,0,0,11,0,11
2014,Cameroon,CMR,Denmark,DNK,0,0,5,0,5
2014,Dem. Rep. of the Congo,COD,Denmark,DNK,10,5,10,0,25
2014,Eritrea,ERI,Denmark,DNK,5,0,5,0,10
2014,Ethiopia,ETH,Denmark,DNK,0,0,23,0,23
2014,Gambia,GMB,Denmark,DNK,0,0,5,0,5
2014,Georgia,GEO,Denmark,DNK,0,0,17,0,17
2014,Ghana,GHA,Denmark,DNK,0,0,17,0,17
2014,Guinea-Bissau,GNB,Denmark,DNK,0,0,5,0,5
2014,Guinea,GIN,Denmark,DNK,0,0,15,0,15
2014,Cote d'Ivoire,CIV,Denmark,DNK,0,0,5,0,5
2014,India,IND,Denmark,DNK,0,0,15,0,15
2014,Iran (Islamic Rep. of),IRN,Denmark,DNK,69,5,66,0,140
2014,Iraq,IRQ,Denmark,DNK,0,5,49,0,54
2014,Jordan,JOR,Denmark,DNK,0,0,11,0,11
2014,Kazakhstan,KAZ,Denmark,DNK,0,0,5,0,5
2014,Kenya,KEN,Denmark,DNK,0,0,10,0,10
2014,Kyrgyzstan,KGZ,Denmark,DNK,0,0,5,0,5
2014,Libya,LBY,Denmark,DNK,0,0,5,0,5
2014,Lebanon,LBN,Denmark,DNK,0,5,5,0,10
2014,Sri Lanka,LKA,Denmark,DNK,0,0,12,0,12
2014,Mali,MLI,Denmark,DNK,0,0,5,0,5
2014,Morocco,MAR,Denmark,DNK,0,0,11,0,11
2014,Myanmar,MMR,Denmark,DNK,0,0,24,0,24
2014,Nigeria,NGA,Denmark,DNK,0,0,47,0,47
2014,Pakistan,PAK,Denmark,DNK,5,0,37,0,42
2014,Russian Federation,RUS,Denmark,DNK,13,13,234,0,260
2014,Serbia and Kosovo: S/RES/1244 (1999),SRB,Denmark,DNK,0,0,5,0,5
2014,Somalia,SOM,Denmark,DNK,5,5,372,0,382
2014,Sudan,SDN,Denmark,DNK,5,0,10,0,15
2014,Syrian Arab Rep.,SYR,Denmark,DNK,5,10,38,0,53
2014,Tajikistan,TJK,Denmark,DNK,0,0,5,0,5
2014,Tunisia,TUN,Denmark,DNK,0,0,10,0,10
2014,Uganda,UGA,Denmark,DNK,5,0,10,0,15
2014,Ukraine,UKR,Denmark,DNK,0,0,17,0,17
2014,Uzbekistan,UZB,Denmark,DNK,0,0,23,0,23
2014,Stateless,XXA,Denmark,DNK,0,15,37,0,52
2014,Unknown ,,Denmark,DNK,0,0,10,0,10
2014,Afghanistan,AFG,France,FRA,52,175,66,5,298
2014,Albania,ALB,France,FRA,52,273,2206,723,3254
2014,Algeria,DZA,France,FRA,20,17,720,344,1101
2014,Angola,AGO,France,FRA,37,18,347,36,438
2014,Egypt,EGY,France,FRA,117,0,127,12,256
2014,Armenia,ARM,France,FRA,95,81,1606,289,2071
2014,Azerbaijan,AZE,France,FRA,58,0,386,61,505
2014,Burundi,BDI,France,FRA,5,0,16,5,26
2014,Benin,BEN,France,FRA,0,0,10,0,10
2014,Bangladesh,BGD,France,FRA,374,28,3417,1308,5127
2014,Bhutan,BTN,France,FRA,5,0,16,5,26
2014,Burkina Faso,BFA,France,FRA,5,5,16,0,26
2014,Belarus,BLR,France,FRA,30,0,35,5,70
2014,Bosnia and Herzegovina,BIH,France,FRA,23,5,385,255,668
2014,Cambodia,KHM,France,FRA,0,0,12,5,17
2014,Central African Rep.,CAF,France,FRA,10,45,11,10,76
2014,Chad,TCD,France,FRA,41,5,229,20,295
2014,China,CHN,France,FRA,5,10,1875,2005,3895
2014,Cameroon,CMR,France,FRA,30,5,95,19,149
2014,Congo,COG,France,FRA,32,10,320,49,411
2014,Dem. Rep. of the Congo,COD,France,FRA,302,37,2097,275,2711
2014,Comoros,COM,France,FRA,0,0,32,162,194
2014,Colombia,COL,France,FRA,5,5,20,5,35
2014,Djibouti,DJI,France,FRA,5,0,5,5,15
2014,Dominican Rep.,DOM,France,FRA,0,0,74,62,136
2014,Equatorial Guinea,GNQ,France,FRA,0,0,5,0,5
2014,Eritrea,ERI,France,FRA,118,0,160,12,290
2014,Ethiopia,ETH,France,FRA,11,0,42,5,58
2014,Gambia,GMB,France,FRA,5,0,28,5,38
2014,Palestinian,PSE,France,FRA,5,0,10,0,15
2014,Georgia,GEO,France,FRA,72,40,1170,200,1482
2014,Ghana,GHA,France,FRA,0,0,12,0,12
2014,Guinea-Bissau,GNB,France,FRA,5,0,50,15,70
2014,Guinea,GIN,France,FRA,232,43,937,105,1317
2014,Haiti,HTI,France,FRA,22,32,1061,506,1621
2014,Croatia,HRV,France,FRA,0,0,0,5,5
2014,Cote d'Ivoire,CIV,France,FRA,77,22,536,73,708
2014,India,IND,France,FRA,5,0,10,5,20
2014,Iran (Islamic Rep. of),IRN,France,FRA,35,5,46,10,96
2014,Iraq,IRQ,France,FRA,5,10,14,5,34
2014,Jordan,JOR,France,FRA,0,0,5,0,5
2014,Kazakhstan,KAZ,France,FRA,10,5,74,14,103
2014,Kenya,KEN,France,FRA,5,5,15,0,25
2014,Kyrgyzstan,KGZ,France,FRA,22,0,22,5,49
2014,Dem. People's Rep. of Korea,PRK,France,FRA,0,0,23,0,23
2014,Liberia,LBR,France,FRA,0,0,10,5,15
2014,Libya,LBY,France,FRA,11,5,28,0,44
2014,Lebanon,LBN,France,FRA,5,0,10,5,20
2014,Sri Lanka,LKA,France,FRA,590,25,1421,526,2562
2014,Madagascar,MDG,France,FRA,0,0,27,5,32
2014,Mauritania,MRT,France,FRA,111,11,826,204,1152
2014,North Macedonia,MKD,France,FRA,5,5,126,59,195
2014,Rep. of Moldova,MDA,France,FRA,0,0,22,5,27
2014,Mali,MLI,France,FRA,68,10,786,96,960
2014,Mongolia,MNG,France,FRA,0,5,107,46,158
2014,Morocco,MAR,France,FRA,5,0,27,5,37
2014,Montenegro,MNE,France,FRA,0,0,144,78,222
2014,Mauritius,MUS,France,FRA,0,0,5,0,5
2014,Myanmar,MMR,France,FRA,39,0,305,47,391
2014,Nepal,NPL,France,FRA,13,0,59,23,95
2014,Niger,NER,France,FRA,0,0,16,5,21
2014,Nigeria,NGA,France,FRA,56,34,802,70,962
2014,Pakistan,PAK,France,FRA,44,22,1441,634,2141
2014,Peru,PER,France,FRA,0,5,28,13,46
2014,Philippines,PHL,France,FRA,0,0,5,0,5
2014,Romania,ROU,France,FRA,0,0,5,0,5
2014,South Africa,ZAF,France,FRA,0,0,5,0,5
2014,Russian Federation,RUS,France,FRA,603,93,1632,303,2631
2014,Rwanda,RWA,France,FRA,59,5,56,17,137
2014,Serbia and Kosovo: S/RES/1244 (1999),SRB,France,FRA,260,171,2754,1052,4237
2014,Senegal,SEN,France,FRA,20,0,118,14,152
2014,Sierra Leone,SLE,France,FRA,5,5,76,5,91
2014,Somalia,SOM,France,FRA,35,152,185,23,395
2014,Viet Nam,VNM,France,FRA,0,0,12,5,17
2014,Sudan,SDN,France,FRA,124,115,446,42,727
2014,Suriname,SUR,France,FRA,0,0,5,15,20
2014,Syrian Arab Rep.,SYR,France,FRA,55,10,54,10,129
2014,Thailand,THA,France,FRA,0,0,5,0,5
2014,Tajikistan,TJK,France,FRA,0,0,5,0,5
2014,Togo,TGO,France,FRA,14,0,69,5,88
2014,Tunisia,TUN,France,FRA,5,0,37,5,47
2014,Turkey,TUR,France,FRA,150,10,1125,193,1478
2014,Uganda,UGA,France,FRA,5,0,5,0,10
2014,Ukraine,UKR,France,FRA,5,5,59,0,69
2014,Uzbekistan,UZB,France,FRA,5,0,15,10,30
2014,Venezuela (Bolivarian Republic of),VEN,France,FRA,0,0,5,0,5
2014,Western Sahara,ESH,France,FRA,10,0,24,5,39
2014,Unknown ,,France,FRA,5,0,10,25,40
2014,Afghanistan,AFG,Greece,GRC,145,175,340,1010,1670
2014,Albania,ALB,Greece,GRC,11,66,553,205,835
2014,Algeria,DZA,Greece,GRC,5,5,63,88,161
2014,Egypt,EGY,Greece,GRC,38,14,202,149,403
2014,Armenia,ARM,Greece,GRC,0,5,22,22,49
2014,Benin,BEN,Greece,GRC,0,0,0,5,5
2014,Bangladesh,BGD,Greece,GRC,38,63,572,1223,1896
2014,Burkina Faso,BFA,Greece,GRC,0,5,17,68,90
2014,China,CHN,Greece,GRC,5,15,84,142,246
2014,Cameroon,CMR,Greece,GRC,5,0,23,35,63
2014,Congo,COG,Greece,GRC,5,11,21,35,72
2014,Dem. Rep. of the Congo,COD,Greece,GRC,34,5,30,13,82
2014,Comoros,COM,Greece,GRC,0,0,5,12,17
2014,Cuba,CUB,Greece,GRC,0,0,5,0,5
2014,Dominican Rep.,DOM,Greece,GRC,0,0,52,21,73
2014,Eritrea,ERI,Greece,GRC,15,0,11,48,74
2014,Ethiopia,ETH,Greece,GRC,25,14,26,114,179
2014,Gambia,GMB,Greece,GRC,5,5,22,18,50
2014,Palestinian,PSE,Greece,GRC,10,5,14,89,118
2014,Georgia,GEO,Greece,GRC,0,166,415,965,1546
2014,Ghana,GHA,Greece,GRC,5,17,75,179,276
2014,Guinea,GIN,Greece,GRC,10,10,43,63,126
2014,Cote d'Ivoire,CIV,Greece,GRC,11,5,51,66,133
2014,India,IND,Greece,GRC,0,14,177,69,260
2014,Indonesia,IDN,Greece,GRC,0,5,69,22,96
2014,Iran (Islamic Rep. of),IRN,Greece,GRC,26,15,60,168,269
2014,Iraq,IRQ,Greece,GRC,76,65,338,1212,1691
2014,Kenya,KEN,Greece,GRC,10,0,15,32,57
2014,Liberia,LBR,Greece,GRC,0,0,10,5,15
2014,Libya,LBY,Greece,GRC,0,0,0,5,5
2014,Lebanon,LBN,Greece,GRC,0,0,5,0,5
2014,Sri Lanka,LKA,Greece,GRC,0,5,19,75,99
2014,Mauritania,MRT,Greece,GRC,5,10,23,47,85
2014,Rep. of Moldova,MDA,Greece,GRC,0,10,40,39,89
2014,Mali,MLI,Greece,GRC,0,0,14,17,31
2014,Morocco,MAR,Greece,GRC,10,5,50,80,145
2014,Myanmar,MMR,Greece,GRC,0,0,0,10,10
2014,Nepal,NPL,Greece,GRC,0,0,5,5,10
2014,Niger,NER,Greece,GRC,0,0,0,5,5
2014,Nigeria,NGA,Greece,GRC,28,30,192,496,746
2014,Pakistan,PAK,Greece,GRC,67,222,1628,3950,5867
2014,Philippines,PHL,Greece,GRC,0,0,10,32,42
2014,Russian Federation,RUS,Greece,GRC,0,0,11,39,50
2014,Rwanda,RWA,Greece,GRC,0,5,10,11,26
2014,El Salvador,SLV,Greece,GRC,5,0,0,0,5
2014,Serbia and Kosovo: S/RES/1244 (1999),SRB,Greece,GRC,0,17,0,0,17
2014,Senegal,SEN,Greece,GRC,10,21,128,290,449
2014,Sierra Leone,SLE,Greece,GRC,5,10,28,21,64
2014,Somalia,SOM,Greece,GRC,23,10,43,125,201
2014,Viet Nam,VNM,Greece,GRC,0,0,0,5,5
2014,Sudan,SDN,Greece,GRC,49,10,38,97,194
2014,Syrian Arab Rep.,SYR,Greece,GRC,98,25,44,571,738
2014,United Rep. of Tanzania,TZA,Greece,GRC,0,0,12,11,23
2014,Togo,TGO,Greece,GRC,0,0,5,5,10
2014,Tunisia,TUN,Greece,GRC,0,0,18,12,30
2014,Turkey,TUR,Greece,GRC,17,0,28,55,100
2014,Uganda,UGA,Greece,GRC,0,0,0,5,5
2014,Ukraine,UKR,Greece,GRC,0,0,27,14,41
2014,Stateless,XXA,Greece,GRC,0,0,5,0,5
2014,Unknown ,,Greece,GRC,0,0,5,29,34
2014,Afghanistan,AFG,Ireland,IRL,5,0,5,0,10
2014,Albania,ALB,Ireland,IRL,0,0,10,0,10
2014,Algeria,DZA,Ireland,IRL,0,0,5,0,5
2014,Armenia,ARM,Ireland,IRL,0,0,5,0,5
2014,Azerbaijan,AZE,Ireland,IRL,0,0,5,0,5
2014,Belarus,BLR,Ireland,IRL,5,0,0,0,5
2014,Cameroon,CMR,Ireland,IRL,0,0,0,5,5
2014,Dem. Rep. of the Congo,COD,Ireland,IRL,5,0,0,0,5
2014,Georgia,GEO,Ireland,IRL,0,0,0,5,5
2014,Guinea,GIN,Ireland,IRL,5,0,0,0,5
2014,Cote d'Ivoire,CIV,Ireland,IRL,0,0,5,0,5
2014,Iran (Islamic Rep. of),IRN,Ireland,IRL,10,0,0,0,10
2014,Iraq,IRQ,Ireland,IRL,10,0,0,0,10
2014,Kenya,KEN,Ireland,IRL,0,0,0,5,5
2014,Malaysia,MYS,Ireland,IRL,0,0,0,10,10
2014,Malawi,MWI,Ireland,IRL,5,0,0,0,5
2014,Nigeria,NGA,Ireland,IRL,10,0,34,21,65
2014,Pakistan,PAK,Ireland,IRL,5,0,12,5,22
2014,South Africa,ZAF,Ireland,IRL,0,0,5,11,16
2014,Russian Federation,RUS,Ireland,IRL,0,0,0,5,5
2014,Somalia,SOM,Ireland,IRL,5,0,0,0,5
2014,Sudan,SDN,Ireland,IRL,5,0,0,0,5
2014,Ukraine,UKR,Ireland,IRL,0,0,0,5,5
2014,Zimbabwe,ZWE,Ireland,IRL,5,0,14,0,19
2014,Bangladesh,BGD,Japan,JPN,0,0,74,21,95
2014,Cameroon,CMR,Japan,JPN,0,5,35,0,40
2014,India,IND,Japan,JPN,0,0,66,14,80
2014,Iran (Islamic Rep. of),IRN,Japan,JPN,0,0,0,10,10
2014,Sri Lanka,LKA,Japan,JPN,0,5,128,18,151
2014,Myanmar,MMR,Japan,JPN,0,24,212,66,302
2014,Nepal,NPL,Japan,JPN,0,0,187,34,221
2014,Nigeria,NGA,Japan,JPN,0,5,36,0,41
2014,Pakistan,PAK,Japan,JPN,0,5,119,47,171
2014,Turkey,TUR,Japan,JPN,0,0,125,68,193
2014,Unknown ,,Japan,JPN,5,17,128,68,218
2014,Afghanistan,AFG,Luxembourg,LUX,0,0,5,0,5
2014,Albania,ALB,Luxembourg,LUX,0,0,109,0,109
2014,Algeria,DZA,Luxembourg,LUX,0,0,5,0,5
2014,Benin,BEN,Luxembourg,LUX,0,0,5,0,5
2014,Belarus,BLR,Luxembourg,LUX,0,0,5,0,5
2014,Bosnia and Herzegovina,BIH,Luxembourg,LUX,0,0,105,5,110
2014,Dem. Rep. of the Congo,COD,Luxembourg,LUX,0,0,5,0,5
2014,Cote d'Ivoire,CIV,Luxembourg,LUX,0,0,5,0,5
2014,Iran (Islamic Rep. of),IRN,Luxembourg,LUX,5,0,0,5,10
2014,Iraq,IRQ,Luxembourg,LUX,11,5,0,0,16
2014,Kazakhstan,KAZ,Luxembourg,LUX,0,0,0,5,5
2014,North Macedonia,MKD,Luxembourg,LUX,0,0,25,0,25
2014,Montenegro,MNE,Luxembourg,LUX,0,0,109,10,119
2014,Nigeria,NGA,Luxembourg,LUX,0,0,12,0,12
2014,Serbia and Kosovo: S/RES/1244 (1999),SRB,Luxembourg,LUX,15,5,177,12,209
2014,Syrian Arab Rep.,SYR,Luxembourg,LUX,0,0,0,5,5
2014,Tunisia,TUN,Luxembourg,LUX,0,0,10,0,10
2014,Turkey,TUR,Luxembourg,LUX,0,5,10,0,15
2014,Burundi,BDI,Malawi,MWI,16,0,0,19,35
2014,Dem. Rep. of the Congo,COD,Malawi,MWI,28,0,0,0,28
2014,Rwanda,RWA,Malawi,MWI,16,0,0,70,86
2014,Burundi,BDI,Mozambique,MOZ,0,0,0,114,114
2014,Congo,COG,Mozambique,MOZ,0,0,0,5,5
2014,Dem. Rep. of the Congo,COD,Mozambique,MOZ,0,0,0,490,490
2014,Rwanda,RWA,Mozambique,MOZ,0,0,0,19,19
2014,Egypt,EGY,Malta,MLT,0,5,0,0,5
2014,Ethiopia,ETH,Malta,MLT,0,0,0,5,5
2014,Gambia,GMB,Malta,MLT,0,0,31,5,36
2014,Palestinian,PSE,Malta,MLT,0,0,5,0,5
2014,Ghana,GHA,Malta,MLT,0,0,0,5,5
2014,Libya,LBY,Malta,MLT,10,5,0,0,15
2014,Mali,MLI,Malta,MLT,0,0,5,0,5
2014,Nigeria,NGA,Malta,MLT,0,0,13,12,25
2014,Senegal,SEN,Malta,MLT,0,0,0,34,34
2014,Somalia,SOM,Malta,MLT,0,0,11,0,11
2014,Syrian Arab Rep.,SYR,Malta,MLT,0,0,10,0,10
2014,Tunisia,TUN,Malta,MLT,0,0,5,0,5
2014,Rwanda,RWA,Niger,NER,0,0,5,0,5
2014,Afghanistan,AFG,Norway,NOR,43,27,699,34,803
2014,Albania,ALB,Norway,NOR,0,0,205,5,210
2014,Algeria,DZA,Norway,NOR,0,0,88,0,88
2014,Angola,AGO,Norway,NOR,0,0,28,0,28
2014,Egypt,EGY,Norway,NOR,0,0,30,0,30
2014,Armenia,ARM,Norway,NOR,0,0,17,5,22
2014,Azerbaijan,AZE,Norway,NOR,0,0,39,5,44
2014,Burundi,BDI,Norway,NOR,0,0,29,0,29
2014,Bangladesh,BGD,Norway,NOR,0,0,74,18,92
2014,Brazil,BRA,Norway,NOR,0,0,5,0,5
2014,Bosnia and Herzegovina,BIH,Norway,NOR,0,0,35,0,35
2014,Chad,TCD,Norway,NOR,0,0,12,0,12
2014,China,CHN,Norway,NOR,0,0,24,0,24
2014,Cameroon,CMR,Norway,NOR,0,0,20,0,20
2014,Congo,COG,Norway,NOR,0,0,5,0,5
2014,Dem. Rep. of the Congo,COD,Norway,NOR,0,5,42,0,47
2014,Colombia,COL,Norway,NOR,0,0,5,0,5
2014,Cuba,CUB,Norway,NOR,0,0,10,0,10
2014,Djibouti,DJI,Norway,NOR,0,0,5,0,5
2014,Eritrea,ERI,Norway,NOR,28,0,785,10,823
2014,Ethiopia,ETH,Norway,NOR,38,0,527,14,579
2014,France,FRA,Norway,NOR,0,0,5,0,5
2014,Gambia,GMB,Norway,NOR,0,0,22,0,22
2014,Georgia,GEO,Norway,NOR,0,0,27,0,27
2014,Germany,DEU,Norway,NOR,0,0,5,0,5
2014,Ghana,GHA,Norway,NOR,0,0,31,0,31
2014,Guinea-Bissau,GNB,Norway,NOR,0,0,5,0,5
2014,Guinea,GIN,Norway,NOR,0,0,34,0,34
2014,Cote d'Ivoire,CIV,Norway,NOR,0,0,32,0,32
2014,India,IND,Norway,NOR,0,0,25,0,25
2014,Iran (Islamic Rep. of),IRN,Norway,NOR,66,0,549,11,626
2014,Iraq,IRQ,Norway,NOR,10,10,220,10,250
2014,Jordan,JOR,Norway,NOR,0,0,18,0,18
2014,Kazakhstan,KAZ,Norway,NOR,5,0,19,5,29
2014,Kenya,KEN,Norway,NOR,0,0,12,0,12
2014,Kyrgyzstan,KGZ,Norway,NOR,0,0,61,5,66
2014,Liberia,LBR,Norway,NOR,0,0,18,0,18
2014,Libya,LBY,Norway,NOR,0,0,46,5,51
2014,Lebanon,LBN,Norway,NOR,0,0,24,0,24
2014,Sri Lanka,LKA,Norway,NOR,0,0,43,0,43
2014,Lithuania,LTU,Norway,NOR,0,0,5,0,5
2014,Latvia,LVA,Norway,NOR,0,0,5,0,5
2014,Mauritania,MRT,Norway,NOR,0,0,5,0,5
2014,North Macedonia,MKD,Norway,NOR,0,0,28,0,28
2014,Mali,MLI,Norway,NOR,0,0,26,0,26
2014,Mongolia,MNG,Norway,NOR,0,0,5,0,5
2014,Morocco,MAR,Norway,NOR,0,0,83,0,83
2014,Montenegro,MNE,Norway,NOR,0,0,10,0,10
2014,Myanmar,MMR,Norway,NOR,0,0,19,0,19
2014,Nepal,NPL,Norway,NOR,0,0,12,0,12
2014,Niger,NER,Norway,NOR,0,0,18,0,18
2014,Nigeria,NGA,Norway,NOR,5,0,437,13,455
2014,Pakistan,PAK,Norway,NOR,0,0,165,13,178
2014,Philippines,PHL,Norway,NOR,0,0,5,0,5
2014,Romania,ROU,Norway,NOR,0,0,10,0,10
2014,South Africa,ZAF,Norway,NOR,0,0,5,0,5
2014,Russian Federation,RUS,Norway,NOR,20,5,445,27,497
2014,Rwanda,RWA,Norway,NOR,0,0,18,0,18
2014,El Salvador,SLV,Norway,NOR,0,0,10,0,10
2014,Serbia and Kosovo: S/RES/1244 (1999),SRB,Norway,NOR,0,0,223,5,228
2014,Senegal,SEN,Norway,NOR,0,0,10,0,10
2014,Sierra Leone,SLE,Norway,NOR,0,0,13,0,13
2014,Somalia,SOM,Norway,NOR,5,0,775,23,803
2014,Spain,ESP,Norway,NOR,0,0,5,0,5
2014,Viet Nam,VNM,Norway,NOR,0,0,16,0,16
2014,Sudan,SDN,Norway,NOR,0,0,294,5,299
2014,South Sudan,SSD,Norway,NOR,0,0,12,0,12
2014,Syrian Arab Rep.,SYR,Norway,NOR,0,50,158,22,230
2014,United Rep. of Tanzania,TZA,Norway,NOR,0,0,5,0,5
2014,Tajikistan,TJK,Norway,NOR,0,0,30,0,30
2014,Togo,TGO,Norway,NOR,0,0,5,0,5
2014,Tunisia,TUN,Norway,NOR,0,0,56,0,56
2014,Turkey,TUR,Norway,NOR,0,0,38,5,43
2014,Uganda,UGA,Norway,NOR,5,0,38,0,43
2014,Ukraine,UKR,Norway,NOR,0,0,63,5,68
2014,Uzbekistan,UZB,Norway,NOR,0,0,171,33,204
2014,Yemen,YEM,Norway,NOR,5,0,70,0,75
2014,Zimbabwe,ZWE,Norway,NOR,0,0,5,0,5
2014,Stateless,XXA,Norway,NOR,0,5,267,5,277
2014,Iran (Islamic Rep. of),IRN,Nauru,NRU,10,0,5,0,15
2014,Pakistan,PAK,Nauru,NRU,0,0,5,0,5
2014,Unknown ,,New Zealand,NZL,76,0,92,28,196
2014,Afghanistan,AFG,Poland,POL,0,0,10,5,15
2014,Algeria,DZA,Poland,POL,0,0,5,0,5
2014,Armenia,ARM,Poland,POL,0,0,20,0,20
2014,Bangladesh,BGD,Poland,POL,0,0,5,0,5
2014,Belarus,BLR,Poland,POL,0,0,10,0,10
2014,Georgia,GEO,Poland,POL,0,0,111,5,116
2014,India,IND,Poland,POL,0,0,5,0,5
2014,Kazakhstan,KAZ,Poland,POL,0,0,12,5,17
2014,Kyrgyzstan,KGZ,Poland,POL,0,0,5,0,5
2014,Nepal,NPL,Poland,POL,0,0,5,0,5
2014,Pakistan,PAK,Poland,POL,0,0,10,0,10
2014,Russian Federation,RUS,Poland,POL,5,11,918,71,1005
2014,Viet Nam,VNM,Poland,POL,0,0,11,0,11
2014,Syrian Arab Rep.,SYR,Poland,POL,0,0,5,0,5
2014,Ukraine,UKR,Poland,POL,0,0,156,13,169
2014,Uzbekistan,UZB,Poland,POL,0,0,5,0,5
2014,Stateless,XXA,Poland,POL,0,0,5,0,5
2014,Algeria,DZA,South Africa,ZAF,0,0,10,0,10
2014,Egypt,EGY,South Africa,ZAF,0,0,115,17,132
2014,Burundi,BDI,South Africa,ZAF,0,0,130,52,182
2014,Benin,BEN,South Africa,ZAF,0,0,15,5,20
2014,Bangladesh,BGD,South Africa,ZAF,0,0,481,75,556
2014,Burkina Faso,BFA,South Africa,ZAF,0,0,5,0,5
2014,Botswana,BWA,South Africa,ZAF,0,0,5,0,5
2014,China,CHN,South Africa,ZAF,0,0,918,91,1009
2014,Cameroon,CMR,South Africa,ZAF,0,0,333,75,408
2014,Congo,COG,South Africa,ZAF,0,0,16,12,28
2014,Dem. Rep. of the Congo,COD,South Africa,ZAF,42,0,833,312,1187
2014,Eritrea,ERI,South Africa,ZAF,0,0,10,5,15
2014,Ethiopia,ETH,South Africa,ZAF,5,0,573,76,654
2014,Gambia,GMB,South Africa,ZAF,0,0,5,0,5
2014,Palestinian,PSE,South Africa,ZAF,5,0,5,5,15
2014,Ghana,GHA,South Africa,ZAF,0,0,751,89,840
2014,Cote d'Ivoire,CIV,South Africa,ZAF,0,0,5,5,10
2014,India,IND,South Africa,ZAF,0,0,311,68,379
2014,Kenya,KEN,South Africa,ZAF,0,0,192,51,243
2014,Liberia,LBR,South Africa,ZAF,0,0,5,5,10
2014,Lesotho,LSO,South Africa,ZAF,0,0,1044,39,1083
2014,Mali,MLI,South Africa,ZAF,0,0,5,0,5
2014,Malawi,MWI,South Africa,ZAF,0,0,1842,230,2072
2014,Mozambique,MOZ,South Africa,ZAF,0,0,719,59,778
2014,Nepal,NPL,South Africa,ZAF,0,0,5,0,5
2014,Nigeria,NGA,South Africa,ZAF,0,0,2058,216,2274
2014,Pakistan,PAK,South Africa,ZAF,0,0,412,69,481
2014,Russian Federation,RUS,South Africa,ZAF,0,0,42,5,47
2014,Rwanda,RWA,South Africa,ZAF,0,0,17,0,17
2014,Senegal,SEN,South Africa,ZAF,0,0,92,12,104
2014,Somalia,SOM,South Africa,ZAF,15,0,75,15,105
2014,Eswatini,SWZ,South Africa,ZAF,0,0,42,10,52
2014,United Rep. of Tanzania,TZA,South Africa,ZAF,0,0,306,73,379
2014,Thailand,THA,South Africa,ZAF,0,0,18,5,23
2014,Togo,TGO,South Africa,ZAF,0,0,5,5,10
2014,Uganda,UGA,South Africa,ZAF,0,0,355,64,419
2014,Western Sahara,ESH,South Africa,ZAF,0,0,14,5,19
2014,Zambia,ZMB,South Africa,ZAF,0,0,126,10,136
2014,Zimbabwe,ZWE,South Africa,ZAF,0,0,12652,1236,13888
2014,Afghanistan,AFG,Sweden,SWE,86,135,837,36,1094
2014,Albania,ALB,Sweden,SWE,11,23,869,36,939
2014,Algeria,DZA,Sweden,SWE,0,0,91,5,96
2014,Angola,AGO,Sweden,SWE,0,0,17,0,17
2014,Egypt,EGY,Sweden,SWE,0,0,176,20,196
2014,Armenia,ARM,Sweden,SWE,5,19,271,5,300
2014,Azerbaijan,AZE,Sweden,SWE,5,13,170,10,198
2014,Burundi,BDI,Sweden,SWE,0,0,16,0,16
2014,Bangladesh,BGD,Sweden,SWE,0,5,79,11,95
2014,Burkina Faso,BFA,Sweden,SWE,0,0,5,0,5
2014,Belarus,BLR,Sweden,SWE,5,0,123,19,147
2014,Bolivia (Plurinational State of),BOL,Sweden,SWE,0,5,33,0,38
2014,Bosnia and Herzegovina,BIH,Sweden,SWE,0,0,253,40,293
2014,Bulgaria,BGR,Sweden,SWE,0,0,0,11,11
2014,Chad,TCD,Sweden,SWE,0,0,5,0,5
2014,China,CHN,Sweden,SWE,0,5,27,0,32
2014,Chile,CHL,Sweden,SWE,0,5,5,0,10
2014,Cameroon,CMR,Sweden,SWE,0,5,27,0,32
2014,Congo,COG,Sweden,SWE,0,0,12,0,12
2014,Dem. Rep. of the Congo,COD,Sweden,SWE,0,5,46,0,51
2014,Colombia,COL,Sweden,SWE,0,0,10,0,10
2014,Cuba,CUB,Sweden,SWE,0,5,35,5,45
2014,Djibouti,DJI,Sweden,SWE,0,0,30,0,30
2014,Equatorial Guinea,GNQ,Sweden,SWE,0,0,5,0,5
2014,Eritrea,ERI,Sweden,SWE,5,5,201,10,221
2014,Ethiopia,ETH,Sweden,SWE,15,5,209,10,239
2014,Gambia,GMB,Sweden,SWE,0,0,86,5,91
2014,Georgia,GEO,Sweden,SWE,0,5,273,18,296
2014,Ghana,GHA,Sweden,SWE,0,0,30,0,30
2014,Guinea-Bissau,GNB,Sweden,SWE,0,0,10,0,10
2014,Greece,GRC,Sweden,SWE,0,5,0,0,5
2014,Guatemala,GTM,Sweden,SWE,0,0,10,0,10
2014,Guinea,GIN,Sweden,SWE,0,0,30,0,30
2014,Honduras,HND,Sweden,SWE,0,0,5,0,5
2014,Croatia,HRV,Sweden,SWE,0,0,5,0,5
2014,Hungary,HUN,Sweden,SWE,0,0,5,0,5
2014,Cote d'Ivoire,CIV,Sweden,SWE,0,0,14,0,14
2014,India,IND,Sweden,SWE,0,0,27,0,27
2014,Iran (Islamic Rep. of),IRN,Sweden,SWE,121,96,474,12,703
2014,Iraq,IRQ,Sweden,SWE,36,44,617,32,729
2014,Israel,ISR,Sweden,SWE,0,0,12,0,12
2014,Jordan,JOR,Sweden,SWE,0,5,90,10,105
2014,Kazakhstan,KAZ,Sweden,SWE,5,15,173,13,206
2014,Kenya,KEN,Sweden,SWE,0,0,26,0,26
2014,Kyrgyzstan,KGZ,Sweden,SWE,0,5,180,5,190
2014,Dem. People's Rep. of Korea,PRK,Sweden,SWE,0,0,5,0,5
2014,Kuwait,KWT,Sweden,SWE,0,0,11,0,11
2014,Liberia,LBR,Sweden,SWE,0,0,17,0,17
2014,Libya,LBY,Sweden,SWE,0,0,137,5,142
2014,Lebanon,LBN,Sweden,SWE,0,18,265,12,295
2014,Sri Lanka,LKA,Sweden,SWE,0,0,27,0,27
2014,Latvia,LVA,Sweden,SWE,0,0,5,0,5
2014,Mauritania,MRT,Sweden,SWE,0,0,5,0,5
2014,North Macedonia,MKD,Sweden,SWE,0,0,229,10,239
2014,Rep. of Moldova,MDA,Sweden,SWE,0,0,5,5,10
2014,Mexico,MEX,Sweden,SWE,0,0,5,0,5
2014,Mali,MLI,Sweden,SWE,0,0,22,0,22
2014,Malaysia,MYS,Sweden,SWE,0,0,5,0,5
2014,Mongolia,MNG,Sweden,SWE,0,5,296,15,316
2014,Morocco,MAR,Sweden,SWE,0,10,246,10,266
2014,Mozambique,MOZ,Sweden,SWE,0,0,5,0,5
2014,Montenegro,MNE,Sweden,SWE,0,0,38,5,43
2014,Nepal,NPL,Sweden,SWE,0,0,5,0,5
2014,Niger,NER,Sweden,SWE,0,0,5,0,5
2014,Nicaragua,NIC,Sweden,SWE,0,0,10,0,10
2014,Nigeria,NGA,Sweden,SWE,11,15,268,10,304
2014,Pakistan,PAK,Sweden,SWE,5,10,185,10,210
2014,Peru,PER,Sweden,SWE,0,5,5,0,10
2014,Philippines,PHL,Sweden,SWE,0,0,5,0,5
2014,Poland,POL,Sweden,SWE,0,0,5,0,5
2014,Romania,ROU,Sweden,SWE,0,0,5,0,5
2014,South Africa,ZAF,Sweden,SWE,0,0,5,0,5
2014,Russian Federation,RUS,Sweden,SWE,19,11,474,23,527
2014,Rwanda,RWA,Sweden,SWE,0,0,11,0,11
2014,El Salvador,SLV,Sweden,SWE,0,0,22,0,22
2014,Serbia and Kosovo: S/RES/1244 (1999),SRB,Sweden,SWE,0,46,1341,114,1501
2014,Senegal,SEN,Sweden,SWE,0,0,18,0,18
2014,Sierra Leone,SLE,Sweden,SWE,0,0,19,0,19
2014,Somalia,SOM,Sweden,SWE,20,31,961,21,1033
2014,Viet Nam,VNM,Sweden,SWE,0,0,17,0,17
2014,Sudan,SDN,Sweden,SWE,5,0,70,5,80
2014,Slovakia,SVK,Sweden,SWE,0,0,5,0,5
2014,Eswatini,SWZ,Sweden,SWE,0,0,5,0,5
2014,Syrian Arab Rep.,SYR,Sweden,SWE,5,5,671,161,842
2014,United Rep. of Tanzania,TZA,Sweden,SWE,0,0,20,0,20
2014,Thailand,THA,Sweden,SWE,0,0,5,0,5
2014,Tajikistan,TJK,Sweden,SWE,0,0,35,5,40
2014,Togo,TGO,Sweden,SWE,0,0,10,0,10
2014,Tunisia,TUN,Sweden,SWE,0,0,48,10,58
2014,Turkey,TUR,Sweden,SWE,0,5,108,5,118
2014,Uganda,UGA,Sweden,SWE,5,0,55,0,60
2014,Ukraine,UKR,Sweden,SWE,0,0,109,16,125
2014,United States of America,USA,Sweden,SWE,0,0,12,0,12
2014,Uzbekistan,UZB,Sweden,SWE,5,10,196,16,227
2014,Venezuela (Bolivarian Republic of),VEN,Sweden,SWE,0,0,10,0,10
2014,Yemen,YEM,Sweden,SWE,0,5,87,0,92
2014,Zimbabwe,ZWE,Sweden,SWE,0,0,5,0,5
2014,Stateless,XXA,Sweden,SWE,14,32,769,45,860
2014,Unknown ,,Sweden,SWE,0,17,358,5,380
2015,Dem. Rep. of the Congo,COD,Burundi,BDI,379,0,267,91,737
2015,Comoros,COM,Burundi,BDI,0,0,5,0,5
2015,Rwanda,RWA,Burundi,BDI,5,0,0,5,10
2015,Somalia,SOM,Burundi,BDI,0,0,5,0,5
2015,Afghanistan,AFG,Canada,CAN,10,0,16,0,26
2015,Albania,ALB,Canada,CAN,16,0,38,0,54
2015,Algeria,DZA,Canada,CAN,5,0,22,0,27
2015,Angola,AGO,Canada,CAN,0,0,5,0,5
2015,Egypt,EGY,Canada,CAN,10,0,10,0,20
2015,Argentina,ARG,Canada,CAN,0,0,5,0,5
2015,Armenia,ARM,Canada,CAN,0,0,5,0,5
2015,Barbados,BRB,Canada,CAN,0,0,5,0,5
2015,Burundi,BDI,Canada,CAN,5,0,5,5,15
2015,Benin,BEN,Canada,CAN,0,0,5,0,5
2015,Bangladesh,BGD,Canada,CAN,14,0,39,5,58
2015,Bahamas,BHS,Canada,CAN,0,0,5,0,5
2015,Burkina Faso,BFA,Canada,CAN,0,0,5,0,5
2015,Bolivia (Plurinational State of),BOL,Canada,CAN,0,0,5,0,5
2015,Brazil,BRA,Canada,CAN,5,0,5,0,10
2015,Bosnia and Herzegovina,BIH,Canada,CAN,0,0,5,0,5
2015,Cambodia,KHM,Canada,CAN,0,0,5,0,5
2015,Chad,TCD,Canada,CAN,5,0,13,0,18
2015,China,CHN,Canada,CAN,93,0,299,5,397
2015,Cameroon,CMR,Canada,CAN,15,0,41,0,56
2015,Congo,COG,Canada,CAN,5,0,5,0,10
2015,Dem. Rep. of the Congo,COD,Canada,CAN,19,0,62,0,81
2015,Colombia,COL,Canada,CAN,19,0,79,5,103
2015,Cuba,CUB,Canada,CAN,10,0,23,0,33
2015,Djibouti,DJI,Canada,CAN,5,0,0,0,5
2015,Dominican Rep.,DOM,Canada,CAN,0,0,5,0,5
2015,Ecuador,ECU,Canada,CAN,0,0,5,0,5
2015,Eritrea,ERI,Canada,CAN,5,0,16,0,21
2015,Ethiopia,ETH,Canada,CAN,29,0,28,0,57
2015,Gambia,GMB,Canada,CAN,0,0,5,0,5
2015,Palestinian,PSE,Canada,CAN,5,0,13,0,18
2015,Georgia,GEO,Canada,CAN,5,0,20,0,25
2015,Ghana,GHA,Canada,CAN,5,0,31,0,36
2015,Greece,GRC,Canada,CAN,5,0,0,0,5
2015,Grenada,GRD,Canada,CAN,0,0,5,0,5
2015,Guatemala,GTM,Canada,CAN,0,0,13,0,13
2015,Guinea,GIN,Canada,CAN,5,0,17,0,22
2015,Haiti,HTI,Canada,CAN,36,0,80,5,121
2015,Honduras,HND,Canada,CAN,0,0,23,0,23
2015,Croatia,HRV,Canada,CAN,0,0,16,0,16
2015,Hungary,HUN,Canada,CAN,0,0,28,10,38
2015,Cote d'Ivoire,CIV,Canada,CAN,5,0,5,0,10
2015,India,IND,Canada,CAN,11,0,101,0,112
2015,Iran (Islamic Rep. of),IRN,Canada,CAN,18,0,16,0,34
2015,Iraq,IRQ,Canada,CAN,0,0,12,0,12
2015,Italy,ITA,Canada,CAN,0,0,5,0,5
2015,Jamaica,JAM,Canada,CAN,5,0,31,0,36
2015,Jordan,JOR,Canada,CAN,0,0,13,0,13
2015,Kenya,KEN,Canada,CAN,10,0,10,0,20
2015,Kyrgyzstan,KGZ,Canada,CAN,0,0,5,0,5
2015,Libya,LBY,Canada,CAN,12,0,11,5,28
2015,Saint Lucia,LCA,Canada,CAN,5,0,10,0,15
2015,Lebanon,LBN,Canada,CAN,0,0,45,0,45
2015,Sri Lanka,LKA,Canada,CAN,5,0,38,0,43
2015,Madagascar,MDG,Canada,CAN,0,0,5,0,5
2015,Mauritania,MRT,Canada,CAN,0,0,5,0,5
2015,Mexico,MEX,Canada,CAN,0,0,5,5,10
2015,Mali,MLI,Canada,CAN,5,0,14,0,19
2015,Mongolia,MNG,Canada,CAN,5,0,11,0,16
2015,Morocco,MAR,Canada,CAN,5,0,10,0,15
2015,Myanmar,MMR,Canada,CAN,5,0,0,0,5
2015,Nepal,NPL,Canada,CAN,5,0,5,0,10
2015,Nicaragua,NIC,Canada,CAN,0,0,5,0,5
2015,Nigeria,NGA,Canada,CAN,61,0,164,0,225
2015,Pakistan,PAK,Canada,CAN,22,0,90,5,117
2015,Peru,PER,Canada,CAN,0,0,5,0,5
2015,Philippines,PHL,Canada,CAN,0,0,10,0,10
2015,South Africa,ZAF,Canada,CAN,5,0,5,0,10
2015,Russian Federation,RUS,Canada,CAN,5,0,5,5,15
2015,Rwanda,RWA,Canada,CAN,0,0,11,0,11
2015,El Salvador,SLV,Canada,CAN,5,0,22,0,27
2015,Saudi Arabia,SAU,Canada,CAN,5,0,0,0,5
2015,Serbia and Kosovo: S/RES/1244 (1999),SRB,Canada,CAN,10,0,21,0,31
2015,Senegal,SEN,Canada,CAN,0,0,13,0,13
2015,Somalia,SOM,Canada,CAN,35,0,46,0,81
2015,Viet Nam,VNM,Canada,CAN,0,0,5,0,5
2015,Saint Kitts and Nevis,KNA,Canada,CAN,5,0,0,0,5
2015,Sudan,SDN,Canada,CAN,0,0,10,5,15
2015,Slovakia,SVK,Canada,CAN,0,0,5,0,5
2015,Syrian Arab Rep.,SYR,Canada,CAN,0,0,10,0,10
2015,Togo,TGO,Canada,CAN,0,0,5,0,5
2015,Trinidad and Tobago,TTO,Canada,CAN,5,0,5,0,10
2015,Tunisia,TUN,Canada,CAN,5,0,13,0,18
2015,Turkey,TUR,Canada,CAN,13,0,30,0,43
2015,Uganda,UGA,Canada,CAN,10,0,5,0,15
2015,Ukraine,UKR,Canada,CAN,38,0,52,5,95
2015,Uruguay,URY,Canada,CAN,0,0,5,0,5
2015,United States of America,USA,Canada,CAN,0,0,5,0,5
2015,Uzbekistan,UZB,Canada,CAN,0,0,5,0,5
2015,Saint Vincent and the Grenadines,VCT,Canada,CAN,5,0,11,0,16
2015,Venezuela (Bolivarian Republic of),VEN,Canada,CAN,11,0,21,0,32
2015,Yemen,YEM,Canada,CAN,0,0,5,0,5
2015,Zimbabwe,ZWE,Canada,CAN,5,0,5,0,10
2015,Stateless,XXA,Canada,CAN,5,0,5,0,10
2015,Unknown ,,Canada,CAN,0,0,12,0,12
2015,Cuba,CUB,Colombia,COL,0,0,11,0,11
2015,Venezuela (Bolivarian Republic of),VEN,Colombia,COL,5,0,12,0,17
2015,Colombia,COL,Costa Rica,CRI,5,0,37,81,123
2015,Cuba,CUB,Costa Rica,CRI,0,0,5,5,10
2015,Honduras,HND,Costa Rica,CRI,0,0,0,5,5
2015,El Salvador,SLV,Costa Rica,CRI,5,0,0,5,10
2015,Afghanistan,AFG,Cyprus,CYP,0,0,5,0,5
2015,Algeria,DZA,Cyprus,CYP,5,0,0,0,5
2015,Egypt,EGY,Cyprus,CYP,0,0,20,21,41
2015,Bangladesh,BGD,Cyprus,CYP,0,0,33,0,33
2015,Cameroon,CMR,Cyprus,CYP,0,0,10,0,10
2015,Dem. Rep. of the Congo,COD,Cyprus,CYP,0,0,5,0,5
2015,Palestinian,PSE,Cyprus,CYP,0,5,0,0,5
2015,India,IND,Cyprus,CYP,0,0,27,5,32
2015,Iran (Islamic Rep. of),IRN,Cyprus,CYP,19,0,12,0,31
2015,Iraq,IRQ,Cyprus,CYP,0,41,0,18,59
2015,Jordan,JOR,Cyprus,CYP,0,10,5,0,15
2015,Lebanon,LBN,Cyprus,CYP,5,0,5,0,10
2015,Sri Lanka,LKA,Cyprus,CYP,0,0,43,10,53
2015,Nigeria,NGA,Cyprus,CYP,0,0,10,0,10
2015,Pakistan,PAK,Cyprus,CYP,0,0,24,10,34
2015,Philippines,PHL,Cyprus,CYP,0,0,32,5,37
2015,Viet Nam,VNM,Cyprus,CYP,0,0,68,14,82
2015,Syrian Arab Rep.,SYR,Cyprus,CYP,14,202,5,23,244
2015,Turkey,TUR,Cyprus,CYP,0,0,0,10,10
2015,Afghanistan,AFG,Denmark,DNK,32,17,90,0,139
2015,Albania,ALB,Denmark,DNK,0,0,5,0,5
2015,Egypt,EGY,Denmark,DNK,0,0,10,0,10
2015,Armenia,ARM,Denmark,DNK,5,0,43,0,48
2015,Azerbaijan,AZE,Denmark,DNK,5,0,16,0,21
2015,Burundi,BDI,Denmark,DNK,0,0,5,0,5
2015,Bangladesh,BGD,Denmark,DNK,0,0,10,0,10
2015,Belarus,BLR,Denmark,DNK,5,0,10,0,15
2015,Chad,TCD,Denmark,DNK,0,0,5,0,5
2015,China,CHN,Denmark,DNK,0,0,5,0,5
2015,Dem. Rep. of the Congo,COD,Denmark,DNK,5,0,10,0,15
2015,Eritrea,ERI,Denmark,DNK,13,0,34,0,47
2015,Ethiopia,ETH,Denmark,DNK,5,0,33,0,38
2015,Georgia,GEO,Denmark,DNK,0,0,11,0,11
2015,Ghana,GHA,Denmark,DNK,0,0,5,0,5
2015,India,IND,Denmark,DNK,0,0,5,0,5
2015,Iran (Islamic Rep. of),IRN,Denmark,DNK,57,5,41,0,103
2015,Iraq,IRQ,Denmark,DNK,5,0,34,0,39
2015,Jordan,JOR,Denmark,DNK,0,0,10,0,10
2015,Kenya,KEN,Denmark,DNK,0,0,10,0,10
2015,Rep. of Korea,KOR,Denmark,DNK,0,0,5,0,5
2015,Libya,LBY,Denmark,DNK,0,0,13,0,13
2015,Lebanon,LBN,Denmark,DNK,0,0,15,0,15
2015,Sri Lanka,LKA,Denmark,DNK,0,0,5,0,5
2015,Morocco,MAR,Denmark,DNK,0,0,10,0,10
2015,Myanmar,MMR,Denmark,DNK,0,0,28,0,28
2015,Nepal,NPL,Denmark,DNK,0,0,19,0,19
2015,Pakistan,PAK,Denmark,DNK,0,0,12,0,12
2015,Russian Federation,RUS,Denmark,DNK,14,21,160,0,195
2015,Serbia and Kosovo: S/RES/1244 (1999),SRB,Denmark,DNK,0,0,11,0,11
2015,Somalia,SOM,Denmark,DNK,0,16,123,0,139
2015,Sudan,SDN,Denmark,DNK,0,0,12,0,12
2015,Syrian Arab Rep.,SYR,Denmark,DNK,42,5,102,0,149
2015,Tunisia,TUN,Denmark,DNK,0,0,5,0,5
2015,Uganda,UGA,Denmark,DNK,10,0,0,0,10
2015,Ukraine,UKR,Denmark,DNK,0,0,32,0,32
2015,Uzbekistan,UZB,Denmark,DNK,0,0,5,0,5
2015,Stateless,XXA,Denmark,DNK,5,0,79,0,84
2015,Unknown ,,Denmark,DNK,0,0,5,0,5
2015,Afghanistan,AFG,France,FRA,22,48,43,5,118
2015,Albania,ALB,France,FRA,62,295,2030,757,3144
2015,Algeria,DZA,France,FRA,25,21,662,471,1179
2015,Angola,AGO,France,FRA,36,13,266,17,332
2015,Egypt,EGY,France,FRA,69,0,113,5,187
2015,Armenia,ARM,France,FRA,21,63,1076,217,1377
2015,Azerbaijan,AZE,France,FRA,106,13,412,43,574
2015,Burundi,BDI,France,FRA,0,0,5,0,5
2015,Benin,BEN,France,FRA,0,0,10,0,10
2015,Bangladesh,BGD,France,FRA,355,42,2605,712,3714
2015,Bhutan,BTN,France,FRA,5,0,22,10,37
2015,Burkina Faso,BFA,France,FRA,5,0,17,0,22
2015,Belarus,BLR,France,FRA,10,0,21,5,36
2015,Botswana,BWA,France,FRA,0,0,5,0,5
2015,Bosnia and Herzegovina,BIH,France,FRA,16,5,177,104,302
2015,Cambodia,KHM,France,FRA,0,0,37,5,42
2015,Central African Rep.,CAF,France,FRA,0,0,16,5,21
2015,Chad,TCD,France,FRA,19,5,99,5,128
2015,China,CHN,France,FRA,5,0,1518,1534,3057
2015,Cameroon,CMR,France,FRA,21,5,92,13,131
2015,Congo,COG,France,FRA,32,10,369,35,446
2015,Dem. Rep. of the Congo,COD,France,FRA,448,60,3087,263,3858
2015,Comoros,COM,France,FRA,5,0,145,53,203
2015,Colombia,COL,France,FRA,0,5,31,5,41
2015,Djibouti,DJI,France,FRA,5,0,5,0,10
2015,Dominican Rep.,DOM,France,FRA,0,0,129,114,243
2015,Eritrea,ERI,France,FRA,112,5,184,25,326
2015,Ethiopia,ETH,France,FRA,10,0,26,10,46
2015,Gabon,GAB,France,FRA,0,0,10,0,10
2015,Gambia,GMB,France,FRA,5,0,29,5,39
2015,Palestinian,PSE,France,FRA,5,0,10,0,15
2015,Georgia,GEO,France,FRA,73,49,1339,198,1659
2015,Ghana,GHA,France,FRA,0,0,11,0,11
2015,Guinea-Bissau,GNB,France,FRA,0,0,97,20,117
2015,Guinea,GIN,France,FRA,276,66,1254,110,1706
2015,Haiti,HTI,France,FRA,10,13,767,600,1390
2015,Honduras,HND,France,FRA,0,0,5,0,5
2015,Cote d'Ivoire,CIV,France,FRA,70,17,488,55,630
2015,India,IND,France,FRA,0,0,28,0,28
2015,Iran (Islamic Rep. of),IRN,France,FRA,15,5,33,10,63
2015,Iraq,IRQ,France,FRA,10,11,11,5,37
2015,Kazakhstan,KAZ,France,FRA,23,5,63,10,101
2015,Kenya,KEN,France,FRA,0,0,10,0,10
2015,Kyrgyzstan,KGZ,France,FRA,10,0,13,5,28
2015,Dem. People's Rep. of Korea,PRK,France,FRA,0,0,10,0,10
2015,Lao People's Dem. Rep.,LAO,France,FRA,0,0,0,5,5
2015,Liberia,LBR,France,FRA,0,0,5,0,5
2015,Libya,LBY,France,FRA,13,29,28,10,80
2015,Saint Lucia,LCA,France,FRA,0,0,0,5,5
2015,Lebanon,LBN,France,FRA,5,5,22,0,32
2015,Sri Lanka,LKA,France,FRA,386,13,1113,457,1969
2015,Madagascar,MDG,France,FRA,0,5,39,0,44
2015,Mauritania,MRT,France,FRA,72,5,467,133,677
2015,North Macedonia,MKD,France,FRA,0,0,111,53,164
2015,Rep. of Moldova,MDA,France,FRA,0,0,12,10,22
2015,Mali,MLI,France,FRA,29,16,785,81,911
2015,Mongolia,MNG,France,FRA,0,5,103,46,154
2015,Morocco,MAR,France,FRA,5,0,34,5,44
2015,Montenegro,MNE,France,FRA,0,5,68,42,115
2015,Myanmar,MMR,France,FRA,21,0,134,36,191
2015,Nepal,NPL,France,FRA,5,5,37,13,60
2015,Niger,NER,France,FRA,0,0,11,0,11
2015,Nigeria,NGA,France,FRA,96,42,773,73,984
2015,Pakistan,PAK,France,FRA,42,23,1418,818,2301
2015,Peru,PER,France,FRA,0,0,24,5,29
2015,Philippines,PHL,France,FRA,0,0,5,0,5
2015,South Africa,ZAF,France,FRA,0,0,5,0,5
2015,Russian Federation,RUS,France,FRA,465,86,1729,262,2542
2015,Rwanda,RWA,France,FRA,22,0,41,11,74
2015,Serbia and Kosovo: S/RES/1244 (1999),SRB,France,FRA,256,149,2274,943,3622
2015,Senegal,SEN,France,FRA,19,5,69,5,98
2015,Sierra Leone,SLE,France,FRA,10,5,58,5,78
2015,Somalia,SOM,France,FRA,19,108,125,19,271
2015,Viet Nam,VNM,France,FRA,0,0,19,0,19
2015,Sudan,SDN,France,FRA,153,231,530,51,965
2015,Suriname,SUR,France,FRA,0,0,5,5,10
2015,Syrian Arab Rep.,SYR,France,FRA,90,5,104,10,209
2015,Togo,TGO,France,FRA,10,0,96,5,111
2015,Tunisia,TUN,France,FRA,5,0,34,5,44
2015,Turkey,TUR,France,FRA,155,11,1182,145,1493
2015,Ukraine,UKR,France,FRA,33,21,226,22,302
2015,United States of America,USA,France,FRA,0,0,0,5,5
2015,Uzbekistan,UZB,France,FRA,0,0,10,5,15
2015,Venezuela (Bolivarian Republic of),VEN,France,FRA,0,0,5,0,5
2015,Western Sahara,ESH,France,FRA,23,0,96,10,129
2015,Yemen,YEM,France,FRA,0,5,0,0,5
2015,Unknown ,,France,FRA,0,0,0,10,10
2015,Afghanistan,AFG,Greece,GRC,52,80,72,5,209
2015,Albania,ALB,Greece,GRC,5,0,261,10,276
2015,Algeria,DZA,Greece,GRC,0,0,55,5,60
2015,Egypt,EGY,Greece,GRC,20,5,132,5,162
2015,Armenia,ARM,Greece,GRC,0,0,19,0,19
2015,Bangladesh,BGD,Greece,GRC,13,0,289,5,307
2015,Burkina Faso,BFA,Greece,GRC,0,0,5,0,5
2015,China,CHN,Greece,GRC,0,0,35,0,35
2015,Cameroon,CMR,Greece,GRC,22,0,46,0,68
2015,Congo,COG,Greece,GRC,0,0,5,0,5
2015,Dem. Rep. of the Congo,COD,Greece,GRC,21,5,17,5,48
2015,Comoros,COM,Greece,GRC,0,0,5,0,5
2015,Dominican Rep.,DOM,Greece,GRC,0,0,5,5,10
2015,Eritrea,ERI,Greece,GRC,13,0,15,0,28
2015,Ethiopia,ETH,Greece,GRC,13,0,12,0,25
2015,Gambia,GMB,Greece,GRC,0,0,5,0,5
2015,Palestinian,PSE,Greece,GRC,0,0,5,0,5
2015,Georgia,GEO,Greece,GRC,0,0,156,10,166
2015,Ghana,GHA,Greece,GRC,0,0,16,0,16
2015,Guinea,GIN,Greece,GRC,0,5,5,0,10
2015,Cote d'Ivoire,CIV,Greece,GRC,5,0,18,0,23
2015,India,IND,Greece,GRC,0,0,27,0,27
2015,Iran (Islamic Rep. of),IRN,Greece,GRC,21,0,46,0,67
2015,Iraq,IRQ,Greece,GRC,0,0,17,0,17
2015,Kenya,KEN,Greece,GRC,5,0,5,0,10
2015,Sri Lanka,LKA,Greece,GRC,0,0,12,0,12
2015,Mauritania,MRT,Greece,GRC,5,0,10,0,15
2015,Mali,MLI,Greece,GRC,5,0,5,0,10
2015,Morocco,MAR,Greece,GRC,5,0,41,5,51
2015,Nepal,NPL,Greece,GRC,0,0,5,0,5
2015,Nigeria,NGA,Greece,GRC,27,0,157,5,189
2015,Pakistan,PAK,Greece,GRC,43,5,764,13,825
2015,Philippines,PHL,Greece,GRC,0,0,5,0,5
2015,Russian Federation,RUS,Greece,GRC,0,0,14,0,14
2015,Senegal,SEN,Greece,GRC,0,0,43,0,43
2015,Sierra Leone,SLE,Greece,GRC,0,0,5,0,5
2015,Somalia,SOM,Greece,GRC,5,0,10,0,15
2015,Sudan,SDN,Greece,GRC,23,5,32,5,65
2015,United Rep. of Tanzania,TZA,Greece,GRC,0,0,5,0,5
2015,Tunisia,TUN,Greece,GRC,0,0,22,0,22
2015,Turkey,TUR,Greece,GRC,0,0,5,0,5
2015,Uganda,UGA,Greece,GRC,0,0,5,0,5
2015,Ukraine,UKR,Greece,GRC,5,28,28,10,71
2015,Venezuela (Bolivarian Republic of),VEN,Greece,GRC,0,0,5,0,5
2015,Stateless,XXA,Greece,GRC,0,0,5,0,5
2015,Unknown ,,Greece,GRC,1021,350,3344,1777,6492
2015,Afghanistan,AFG,Ireland,IRL,12,0,5,0,17
2015,Albania,ALB,Ireland,IRL,5,0,19,10,34
2015,Algeria,DZA,Ireland,IRL,0,0,16,5,21
2015,Benin,BEN,Ireland,IRL,0,0,5,0,5
2015,Bangladesh,BGD,Ireland,IRL,0,0,5,5,10
2015,Brazil,BRA,Ireland,IRL,0,0,5,0,5
2015,China,CHN,Ireland,IRL,0,0,5,0,5
2015,Cameroon,CMR,Ireland,IRL,5,0,5,5,15
2015,Dem. Rep. of the Congo,COD,Ireland,IRL,34,0,14,12,60
2015,Palestinian,PSE,Ireland,IRL,5,0,0,0,5
2015,Georgia,GEO,Ireland,IRL,0,0,10,0,10
2015,Ghana,GHA,Ireland,IRL,0,0,5,0,5
2015,Cote d'Ivoire,CIV,Ireland,IRL,0,0,5,0,5
2015,Iran (Islamic Rep. of),IRN,Ireland,IRL,5,0,0,0,5
2015,Iraq,IRQ,Ireland,IRL,0,0,0,5,5
2015,Kenya,KEN,Ireland,IRL,5,0,0,0,5
2015,Lebanon,LBN,Ireland,IRL,0,0,5,0,5
2015,Malawi,MWI,Ireland,IRL,0,0,20,0,20
2015,Mauritius,MUS,Ireland,IRL,0,0,5,0,5
2015,Myanmar,MMR,Ireland,IRL,5,0,0,0,5
2015,Niger,NER,Ireland,IRL,0,0,5,0,5
2015,Nigeria,NGA,Ireland,IRL,13,0,78,86,177
2015,Pakistan,PAK,Ireland,IRL,26,0,21,26,73
2015,South Africa,ZAF,Ireland,IRL,5,0,13,10,28
2015,Russian Federation,RUS,Ireland,IRL,0,0,5,0,5
2015,Rwanda,RWA,Ireland,IRL,0,0,5,0,5
2015,Serbia and Kosovo: S/RES/1244 (1999),SRB,Ireland,IRL,0,0,5,0,5
2015,Somalia,SOM,Ireland,IRL,5,0,0,0,5
2015,Sudan,SDN,Ireland,IRL,13,0,5,0,18
2015,Uganda,UGA,Ireland,IRL,5,0,5,0,10
2015,Ukraine,UKR,Ireland,IRL,5,0,5,0,10
2015,Yemen,YEM,Ireland,IRL,5,0,0,0,5
2015,Zimbabwe,ZWE,Ireland,IRL,12,0,27,10,49
2015,Sri Lanka,LKA,Japan,JPN,5,0,0,0,5
2015,Unknown ,,Japan,JPN,5,55,1708,504,2272
2015,Afghanistan,AFG,Kazakhstan,KAZ,0,0,0,14,14
2015,Syrian Arab Rep.,SYR,Kazakhstan,KAZ,0,0,0,10,10
2015,Ukraine,UKR,Kazakhstan,KAZ,0,0,0,12,12
2015,Uzbekistan,UZB,Kazakhstan,KAZ,0,0,0,5,5
2015,Albania,ALB,Luxembourg,LUX,0,0,52,5,57
2015,Algeria,DZA,Luxembourg,LUX,0,0,5,0,5
2015,Azerbaijan,AZE,Luxembourg,LUX,0,0,5,0,5
2015,Benin,BEN,Luxembourg,LUX,0,0,5,0,5
2015,Bosnia and Herzegovina,BIH,Luxembourg,LUX,0,0,93,5,98
2015,Cameroon,CMR,Luxembourg,LUX,0,0,0,5,5
2015,Dem. Rep. of the Congo,COD,Luxembourg,LUX,5,0,5,0,10
2015,Ethiopia,ETH,Luxembourg,LUX,5,0,0,0,5
2015,Guinea,GIN,Luxembourg,LUX,0,0,5,0,5
2015,Libya,LBY,Luxembourg,LUX,0,0,5,0,5
2015,North Macedonia,MKD,Luxembourg,LUX,0,0,20,0,20
2015,Morocco,MAR,Luxembourg,LUX,0,0,5,0,5
2015,Montenegro,MNE,Luxembourg,LUX,0,0,75,10,85
2015,Niger,NER,Luxembourg,LUX,0,0,10,0,10
2015,Russian Federation,RUS,Luxembourg,LUX,0,0,5,0,5
2015,Serbia and Kosovo: S/RES/1244 (1999),SRB,Luxembourg,LUX,10,0,121,24,155
2015,Somalia,SOM,Luxembourg,LUX,0,0,5,0,5
2015,Syrian Arab Rep.,SYR,Luxembourg,LUX,0,0,0,10,10
2015,Tunisia,TUN,Luxembourg,LUX,0,0,12,0,12
2015,Turkey,TUR,Luxembourg,LUX,0,0,18,0,18
2015,Burundi,BDI,Malawi,MWI,0,0,0,15,15
2015,Rwanda,RWA,Malawi,MWI,0,0,427,0,427
2015,Eritrea,ERI,Malta,MLT,0,0,10,0,10
2015,Ethiopia,ETH,Malta,MLT,0,0,11,0,11
2015,Gambia,GMB,Malta,MLT,0,0,5,0,5
2015,Guinea,GIN,Malta,MLT,0,0,10,0,10
2015,Cote d'Ivoire,CIV,Malta,MLT,0,0,12,0,12
2015,Libya,LBY,Malta,MLT,5,0,10,0,15
2015,Mali,MLI,Malta,MLT,0,0,14,0,14
2015,Nigeria,NGA,Malta,MLT,0,0,18,0,18
2015,Senegal,SEN,Malta,MLT,0,0,25,0,25
2015,Somalia,SOM,Malta,MLT,0,0,5,0,5
2015,Syrian Arab Rep.,SYR,Malta,MLT,5,0,5,0,10
2015,Afghanistan,AFG,Norway,NOR,40,17,559,19,635
2015,Albania,ALB,Norway,NOR,0,0,213,10,223
2015,Algeria,DZA,Norway,NOR,0,0,68,0,68
2015,Angola,AGO,Norway,NOR,0,0,10,5,15
2015,Egypt,EGY,Norway,NOR,0,0,41,0,41
2015,Armenia,ARM,Norway,NOR,0,0,13,0,13
2015,Azerbaijan,AZE,Norway,NOR,0,0,18,5,23
2015,Burundi,BDI,Norway,NOR,0,0,12,0,12
2015,Bangladesh,BGD,Norway,NOR,0,0,60,11,71
2015,Belarus,BLR,Norway,NOR,0,0,12,0,12
2015,Bosnia and Herzegovina,BIH,Norway,NOR,0,0,23,0,23
2015,Chad,TCD,Norway,NOR,0,0,5,0,5
2015,China,CHN,Norway,NOR,0,0,12,0,12
2015,Cameroon,CMR,Norway,NOR,0,0,5,0,5
2015,Dem. Rep. of the Congo,COD,Norway,NOR,0,5,19,0,24
2015,Cuba,CUB,Norway,NOR,0,0,5,0,5
2015,Djibouti,DJI,Norway,NOR,0,0,10,0,10
2015,Eritrea,ERI,Norway,NOR,11,0,591,21,623
2015,Ethiopia,ETH,Norway,NOR,10,0,304,10,324
2015,France,FRA,Norway,NOR,0,0,5,0,5
2015,Gambia,GMB,Norway,NOR,0,0,16,0,16
2015,Georgia,GEO,Norway,NOR,0,0,24,0,24
2015,Ghana,GHA,Norway,NOR,0,0,22,5,27
2015,Guinea,GIN,Norway,NOR,0,0,28,0,28
2015,Hungary,HUN,Norway,NOR,0,0,5,0,5
2015,Cote d'Ivoire,CIV,Norway,NOR,0,0,14,0,14
2015,India,IND,Norway,NOR,0,0,10,0,10
2015,Iran (Islamic Rep. of),IRN,Norway,NOR,29,0,250,11,290
2015,Iraq,IRQ,Norway,NOR,18,10,424,27,479
2015,Israel,ISR,Norway,NOR,0,0,5,0,5
2015,Jordan,JOR,Norway,NOR,0,0,34,0,34
2015,Kazakhstan,KAZ,Norway,NOR,0,0,15,0,15
2015,Kenya,KEN,Norway,NOR,0,0,5,0,5
2015,Kyrgyzstan,KGZ,Norway,NOR,0,0,5,0,5
2015,Liberia,LBR,Norway,NOR,0,0,12,0,12
2015,Libya,LBY,Norway,NOR,0,0,38,0,38
2015,Lebanon,LBN,Norway,NOR,0,0,33,0,33
2015,Sri Lanka,LKA,Norway,NOR,0,0,33,0,33
2015,Mauritania,MRT,Norway,NOR,0,0,5,0,5
2015,North Macedonia,MKD,Norway,NOR,0,0,32,0,32
2015,Mali,MLI,Norway,NOR,0,0,10,0,10
2015,Mongolia,MNG,Norway,NOR,0,0,5,0,5
2015,Morocco,MAR,Norway,NOR,0,0,95,0,95
2015,Montenegro,MNE,Norway,NOR,0,0,14,0,14
2015,Myanmar,MMR,Norway,NOR,0,0,10,0,10
2015,Nepal,NPL,Norway,NOR,5,0,11,0,16
2015,Niger,NER,Norway,NOR,0,0,10,0,10
2015,Nigeria,NGA,Norway,NOR,5,0,223,13,241
2015,Pakistan,PAK,Norway,NOR,0,0,176,10,186
2015,Philippines,PHL,Norway,NOR,0,0,5,0,5
2015,Poland,POL,Norway,NOR,0,0,5,0,5
2015,Romania,ROU,Norway,NOR,0,0,10,0,10
2015,Russian Federation,RUS,Norway,NOR,5,0,149,12,166
2015,Rwanda,RWA,Norway,NOR,0,0,11,0,11
2015,El Salvador,SLV,Norway,NOR,0,0,10,5,15
2015,Serbia and Kosovo: S/RES/1244 (1999),SRB,Norway,NOR,0,0,174,18,192
2015,Senegal,SEN,Norway,NOR,0,0,11,0,11
2015,Sierra Leone,SLE,Norway,NOR,0,0,14,0,14
2015,Somalia,SOM,Norway,NOR,0,0,710,5,715
2015,Spain,ESP,Norway,NOR,0,0,5,0,5
2015,Viet Nam,VNM,Norway,NOR,0,0,13,0,13
2015,Sudan,SDN,Norway,NOR,5,0,141,10,156
2015,South Sudan,SSD,Norway,NOR,0,0,10,0,10
2015,Syrian Arab Rep.,SYR,Norway,NOR,5,15,235,10,265
2015,United Rep. of Tanzania,TZA,Norway,NOR,0,0,5,0,5
2015,Tajikistan,TJK,Norway,NOR,0,0,17,0,17
2015,Tunisia,TUN,Norway,NOR,0,0,41,0,41
2015,Turkey,TUR,Norway,NOR,0,0,41,10,51
2015,Uganda,UGA,Norway,NOR,5,0,35,0,40
2015,Ukraine,UKR,Norway,NOR,0,0,74,5,79
2015,Uzbekistan,UZB,Norway,NOR,39,0,30,10,79
2015,Venezuela (Bolivarian Republic of),VEN,Norway,NOR,0,0,5,0,5
2015,Yemen,YEM,Norway,NOR,0,47,20,0,67
2015,Stateless,XXA,Norway,NOR,14,10,211,10,245
2015,Unknown ,,Norway,NOR,0,0,10,0,10
2015,Unknown ,,New Zealand,NZL,65,0,102,10,177
2015,Algeria,DZA,South Africa,ZAF,0,0,0,11,11
2015,Egypt,EGY,South Africa,ZAF,0,0,38,41,79
2015,Burundi,BDI,South Africa,ZAF,5,0,90,88,183
2015,Benin,BEN,South Africa,ZAF,0,0,10,5,15
2015,Bangladesh,BGD,South Africa,ZAF,0,0,345,398,743
2015,China,CHN,South Africa,ZAF,0,0,250,89,339
2015,Cameroon,CMR,South Africa,ZAF,0,0,215,62,277
2015,Congo,COG,South Africa,ZAF,0,0,12,36,48
2015,Dem. Rep. of the Congo,COD,South Africa,ZAF,82,0,606,586,1274
2015,Eritrea,ERI,South Africa,ZAF,0,0,0,12,12
2015,Ethiopia,ETH,South Africa,ZAF,10,0,501,841,1352
2015,Fiji,FJI,South Africa,ZAF,0,0,5,0,5
2015,Ghana,GHA,South Africa,ZAF,0,0,750,114,864
2015,Guinea,GIN,South Africa,ZAF,0,0,5,5,10
2015,Hungary,HUN,South Africa,ZAF,0,0,11,5,16
2015,Cote d'Ivoire,CIV,South Africa,ZAF,0,0,10,12,22
2015,India,IND,South Africa,ZAF,0,0,120,352,472
2015,Kenya,KEN,South Africa,ZAF,0,0,49,31,80
2015,Liberia,LBR,South Africa,ZAF,0,0,5,0,5
2015,Lesotho,LSO,South Africa,ZAF,0,0,341,5,346
2015,Mali,MLI,South Africa,ZAF,0,0,5,5,10
2015,Malawi,MWI,South Africa,ZAF,0,0,1151,197,1348
2015,Mozambique,MOZ,South Africa,ZAF,0,0,339,91,430
2015,Nepal,NPL,South Africa,ZAF,0,0,18,12,30
2015,Niger,NER,South Africa,ZAF,0,0,18,0,18
2015,Nigeria,NGA,South Africa,ZAF,0,0,2895,385,3280
2015,Pakistan,PAK,South Africa,ZAF,0,0,381,453,834
2015,Russian Federation,RUS,South Africa,ZAF,0,0,0,5,5
2015,Rwanda,RWA,South Africa,ZAF,5,0,13,16,34
2015,Senegal,SEN,South Africa,ZAF,0,0,63,30,93
2015,Sierra Leone,SLE,South Africa,ZAF,0,0,5,0,5
2015,Somalia,SOM,South Africa,ZAF,11,0,94,115,220
2015,Eswatini,SWZ,South Africa,ZAF,0,0,16,5,21
2015,United Rep. of Tanzania,TZA,South Africa,ZAF,0,0,230,81,311
2015,Thailand,THA,South Africa,ZAF,0,0,10,0,10
2015,Tunisia,TUN,South Africa,ZAF,0,0,11,0,11
2015,Uganda,UGA,South Africa,ZAF,0,0,242,130,372
2015,Zambia,ZMB,South Africa,ZAF,0,0,61,11,72
2015,Zimbabwe,ZWE,South Africa,ZAF,0,0,9322,594,9916
2015,Afghanistan,AFG,Sweden,SWE,40,47,552,45,684
2015,Albania,ALB,Sweden,SWE,5,5,1232,83,1325
2015,Algeria,DZA,Sweden,SWE,0,0,82,13,95
2015,Angola,AGO,Sweden,SWE,0,0,5,0,5
2015,Egypt,EGY,Sweden,SWE,0,5,121,24,150
2015,Armenia,ARM,Sweden,SWE,0,16,136,30,182
2015,Azerbaijan,AZE,Sweden,SWE,5,10,85,15,115
2015,Burundi,BDI,Sweden,SWE,0,0,5,0,5
2015,Bangladesh,BGD,Sweden,SWE,5,5,92,12,114
2015,Burkina Faso,BFA,Sweden,SWE,0,0,5,0,5
2015,Belarus,BLR,Sweden,SWE,0,0,50,11,61
2015,Bolivia (Plurinational State of),BOL,Sweden,SWE,0,0,22,0,22
2015,Bosnia and Herzegovina,BIH,Sweden,SWE,0,0,208,43,251
2015,Bulgaria,BGR,Sweden,SWE,0,0,5,0,5
2015,Canada,CAN,Sweden,SWE,0,0,5,0,5
2015,Chad,TCD,Sweden,SWE,0,0,5,0,5
2015,China,CHN,Sweden,SWE,0,0,11,5,16
2015,Chile,CHL,Sweden,SWE,0,0,13,0,13
2015,Cameroon,CMR,Sweden,SWE,0,0,18,5,23
2015,Congo,COG,Sweden,SWE,0,0,10,0,10
2015,Dem. Rep. of the Congo,COD,Sweden,SWE,0,0,30,5,35
2015,Colombia,COL,Sweden,SWE,0,0,5,5,10
2015,Cuba,CUB,Sweden,SWE,0,0,18,5,23
2015,Djibouti,DJI,Sweden,SWE,0,0,18,0,18
2015,Ecuador,ECU,Sweden,SWE,0,0,5,0,5
2015,Eritrea,ERI,Sweden,SWE,0,0,172,24,196
2015,Ethiopia,ETH,Sweden,SWE,5,5,177,15,202
2015,Gambia,GMB,Sweden,SWE,0,0,67,0,67
2015,Palestinian,PSE,Sweden,SWE,5,5,80,17,107
2015,Georgia,GEO,Sweden,SWE,0,0,227,26,253
2015,Ghana,GHA,Sweden,SWE,0,0,18,0,18
2015,Guinea-Bissau,GNB,Sweden,SWE,0,0,5,0,5
2015,Guatemala,GTM,Sweden,SWE,0,0,5,0,5
2015,Guinea,GIN,Sweden,SWE,0,0,16,0,16
2015,Honduras,HND,Sweden,SWE,0,0,5,0,5
2015,Croatia,HRV,Sweden,SWE,0,0,10,0,10
2015,Cote d'Ivoire,CIV,Sweden,SWE,0,0,13,0,13
2015,India,IND,Sweden,SWE,0,0,13,0,13
2015,Iran (Islamic Rep. of),IRN,Sweden,SWE,32,10,169,18,229
2015,Iraq,IRQ,Sweden,SWE,42,31,549,59,681
2015,Israel,ISR,Sweden,SWE,0,0,5,0,5
2015,Jordan,JOR,Sweden,SWE,0,0,63,12,75
2015,Kazakhstan,KAZ,Sweden,SWE,0,10,97,5,112
2015,Kenya,KEN,Sweden,SWE,0,0,10,0,10
2015,Kyrgyzstan,KGZ,Sweden,SWE,0,0,53,5,58
2015,Kuwait,KWT,Sweden,SWE,0,0,5,0,5
2015,Liberia,LBR,Sweden,SWE,0,0,5,0,5
2015,Libya,LBY,Sweden,SWE,0,5,72,13,90
2015,Lebanon,LBN,Sweden,SWE,0,18,230,20,268
2015,Sri Lanka,LKA,Sweden,SWE,0,0,11,0,11
2015,Madagascar,MDG,Sweden,SWE,0,0,5,0,5
2015,Mauritania,MRT,Sweden,SWE,0,0,5,0,5
2015,North Macedonia,MKD,Sweden,SWE,0,5,202,23,230
2015,Rep. of Moldova,MDA,Sweden,SWE,0,0,10,5,15
2015,Mexico,MEX,Sweden,SWE,0,0,10,0,10
2015,Mali,MLI,Sweden,SWE,0,0,10,0,10
2015,Mongolia,MNG,Sweden,SWE,0,10,237,5,252
2015,Morocco,MAR,Sweden,SWE,0,0,206,25,231
2015,Montenegro,MNE,Sweden,SWE,0,0,64,5,69
2015,Nepal,NPL,Sweden,SWE,0,0,5,0,5
2015,Nicaragua,NIC,Sweden,SWE,0,0,5,0,5
2015,Nigeria,NGA,Sweden,SWE,0,0,157,17,174
2015,Pakistan,PAK,Sweden,SWE,0,0,114,13,127
2015,Peru,PER,Sweden,SWE,0,0,5,0,5
2015,Philippines,PHL,Sweden,SWE,0,0,10,0,10
2015,Poland,POL,Sweden,SWE,0,0,0,5,5
2015,Romania,ROU,Sweden,SWE,0,0,18,5,23
2015,South Africa,ZAF,Sweden,SWE,0,0,5,0,5
2015,Russian Federation,RUS,Sweden,SWE,13,12,244,16,285
2015,Rwanda,RWA,Sweden,SWE,0,0,5,0,5
2015,El Salvador,SLV,Sweden,SWE,0,10,31,0,41
2015,Serbia and Kosovo: S/RES/1244 (1999),SRB,Sweden,SWE,0,39,1535,154,1728
2015,Senegal,SEN,Sweden,SWE,0,0,20,0,20
2015,Sierra Leone,SLE,Sweden,SWE,0,0,11,0,11
2015,Somalia,SOM,Sweden,SWE,28,25,857,67,977
2015,Viet Nam,VNM,Sweden,SWE,0,0,19,0,19
2015,Sudan,SDN,Sweden,SWE,0,5,82,10,97
2015,Syrian Arab Rep.,SYR,Sweden,SWE,0,10,607,78,695
2015,United Rep. of Tanzania,TZA,Sweden,SWE,0,0,16,0,16
2015,Tajikistan,TJK,Sweden,SWE,0,0,11,0,11
2015,Togo,TGO,Sweden,SWE,0,0,5,0,5
2015,Tunisia,TUN,Sweden,SWE,0,0,53,0,53
2015,Turkey,TUR,Sweden,SWE,0,10,80,12,102
2015,United Arab Emirates,ARE,Sweden,SWE,0,0,5,0,5
2015,Uganda,UGA,Sweden,SWE,5,0,48,0,53
2015,Ukraine,UKR,Sweden,SWE,5,5,359,37,406
2015,United States of America,USA,Sweden,SWE,0,0,5,5,10
2015,Uzbekistan,UZB,Sweden,SWE,0,0,46,36,82
2015,Venezuela (Bolivarian Republic of),VEN,Sweden,SWE,0,0,16,5,21
2015,Yemen,YEM,Sweden,SWE,0,5,32,21,58
2015,Zambia,ZMB,Sweden,SWE,0,0,5,0,5
2015,Stateless,XXA,Sweden,SWE,10,36,406,86,538
2015,Unknown ,,Sweden,SWE,0,5,182,25,212
2016,Afghanistan,AFG,Australia,AUS,42,0,20,0,62
2016,Albania,ALB,Australia,AUS,0,0,5,0,5
2016,Egypt,EGY,Australia,AUS,20,0,55,10,85
2016,Bangladesh,BGD,Australia,AUS,24,0,208,10,242
2016,Brazil,BRA,Australia,AUS,0,0,5,0,5
2016,Cambodia,KHM,Australia,AUS,0,0,5,0,5
2016,China,CHN,Australia,AUS,44,0,3535,51,3630
2016,Cameroon,CMR,Australia,AUS,0,0,5,0,5
2016,Colombia,COL,Australia,AUS,5,0,5,0,10
2016,Ethiopia,ETH,Australia,AUS,5,0,5,0,10
2016,Fiji,FJI,Australia,AUS,10,0,117,16,143
2016,Georgia,GEO,Australia,AUS,0,0,5,0,5
2016,Germany,DEU,Australia,AUS,0,0,5,0,5
2016,Ghana,GHA,Australia,AUS,0,0,5,0,5
2016,India,IND,Australia,AUS,16,0,244,62,322
2016,Indonesia,IDN,Australia,AUS,5,0,28,0,33
2016,Ireland,IRL,Australia,AUS,0,0,5,0,5
2016,Iran (Islamic Rep. of),IRN,Australia,AUS,91,0,74,10,175
2016,Iraq,IRQ,Australia,AUS,13,0,14,5,32
2016,Jordan,JOR,Australia,AUS,10,0,15,0,25
2016,Kenya,KEN,Australia,AUS,5,0,10,0,15
2016,Rep. of Korea,KOR,Australia,AUS,0,0,15,5,20
2016,Libya,LBY,Australia,AUS,5,0,0,0,5
2016,Lebanon,LBN,Australia,AUS,16,0,73,16,105
2016,Sri Lanka,LKA,Australia,AUS,79,0,243,5,327
2016,Malaysia,MYS,Australia,AUS,22,0,904,275,1201
2016,Mongolia,MNG,Australia,AUS,0,0,11,0,11
2016,Myanmar,MMR,Australia,AUS,5,0,5,0,10
2016,Nepal,NPL,Australia,AUS,5,0,121,13,139
2016,Nigeria,NGA,Australia,AUS,5,0,18,0,23
2016,New Zealand,NZL,Australia,AUS,0,0,5,0,5
2016,Pakistan,PAK,Australia,AUS,84,0,221,38,343
2016,Peru,PER,Australia,AUS,0,0,5,0,5
2016,Philippines,PHL,Australia,AUS,0,0,14,0,14
2016,Papua New Guinea,PNG,Australia,AUS,11,0,17,0,28
2016,South Africa,ZAF,Australia,AUS,0,0,5,0,5
2016,Russian Federation,RUS,Australia,AUS,0,0,5,0,5
2016,Rwanda,RWA,Australia,AUS,5,0,0,0,5
2016,Saudi Arabia,SAU,Australia,AUS,0,0,5,0,5
2016,Solomon Islands,SLB,Australia,AUS,5,0,0,0,5
2016,Viet Nam,VNM,Australia,AUS,11,0,91,5,107
2016,United Rep. of Tanzania,TZA,Australia,AUS,0,0,0,5,5
2016,Thailand,THA,Australia,AUS,0,0,5,5,10
2016,Tonga,TON,Australia,AUS,0,0,20,0,20
2016,Turkey,TUR,Australia,AUS,11,0,11,5,27
2016,Ukraine,UKR,Australia,AUS,0,0,5,0,5
2016,Zambia,ZMB,Australia,AUS,0,0,5,0,5
2016,Zimbabwe,ZWE,Australia,AUS,10,0,15,0,25
2016,Stateless,XXA,Australia,AUS,17,0,14,0,31
2016,Unknown ,,Australia,AUS,0,0,5,0,5
2016,Afghanistan,AFG,Azerbaijan,AZE,12,0,0,0,12
2016,Dem. Rep. of the Congo,COD,Burundi,BDI,127,0,175,180,482
2016,Rwanda,RWA,Burundi,BDI,11,0,14,18,43
2016,Eritrea,ERI,Cambodia,KHM,0,0,0,5,5
2016,Venezuela (Bolivarian Republic of),VEN,Colombia,COL,0,0,5,0,5
2016,Colombia,COL,Costa Rica,CRI,25,0,345,136,506
2016,Cuba,CUB,Costa Rica,CRI,0,0,32,10,42
2016,Ecuador,ECU,Costa Rica,CRI,0,0,5,0,5
2016,Guatemala,GTM,Costa Rica,CRI,0,0,10,5,15
2016,Honduras,HND,Costa Rica,CRI,10,0,10,10,30
2016,Niger,NER,Costa Rica,CRI,0,0,5,0,5
2016,Nicaragua,NIC,Costa Rica,CRI,0,0,12,0,12
2016,Russian Federation,RUS,Costa Rica,CRI,0,0,5,0,5
2016,El Salvador,SLV,Costa Rica,CRI,30,0,52,17,99
2016,Venezuela (Bolivarian Republic of),VEN,Costa Rica,CRI,5,0,20,5,30
2016,Unknown ,,Costa Rica,CRI,0,0,0,740,740
2016,Egypt,EGY,Cyprus,CYP,0,0,10,13,23
2016,Bangladesh,BGD,Cyprus,CYP,0,0,12,5,17
2016,Palestinian,PSE,Cyprus,CYP,0,43,0,0,43
2016,India,IND,Cyprus,CYP,0,0,12,10,22
2016,Iraq,IRQ,Cyprus,CYP,0,15,5,147,167
2016,Lebanon,LBN,Cyprus,CYP,0,0,0,5,5
2016,Sri Lanka,LKA,Cyprus,CYP,0,0,10,5,15
2016,Nigeria,NGA,Cyprus,CYP,0,0,5,0,5
2016,Pakistan,PAK,Cyprus,CYP,0,0,10,24,34
2016,Philippines,PHL,Cyprus,CYP,0,0,5,0,5
2016,Sierra Leone,SLE,Cyprus,CYP,0,0,5,0,5
2016,Viet Nam,VNM,Cyprus,CYP,0,0,29,12,41
2016,Syrian Arab Rep.,SYR,Cyprus,CYP,12,5,5,10,32
2016,Afghanistan,AFG,Denmark,DNK,25,39,197,0,261
2016,Albania,ALB,Denmark,DNK,0,0,5,0,5
2016,Algeria,DZA,Denmark,DNK,0,0,5,0,5
2016,Egypt,EGY,Denmark,DNK,0,0,12,0,12
2016,Armenia,ARM,Denmark,DNK,0,5,67,0,72
2016,Azerbaijan,AZE,Denmark,DNK,0,0,11,0,11
2016,Burundi,BDI,Denmark,DNK,0,0,5,0,5
2016,Bangladesh,BGD,Denmark,DNK,0,0,14,0,14
2016,Belarus,BLR,Denmark,DNK,0,0,5,0,5
2016,China,CHN,Denmark,DNK,0,0,16,0,16
2016,Dem. Rep. of the Congo,COD,Denmark,DNK,0,0,5,0,5
2016,Eritrea,ERI,Denmark,DNK,5,0,23,0,28
2016,Ethiopia,ETH,Denmark,DNK,5,0,55,0,60
2016,Georgia,GEO,Denmark,DNK,0,0,11,0,11
2016,Ghana,GHA,Denmark,DNK,0,0,5,0,5
2016,Guinea,GIN,Denmark,DNK,0,0,5,0,5
2016,Haiti,HTI,Denmark,DNK,0,0,5,0,5
2016,India,IND,Denmark,DNK,0,0,5,0,5
2016,Iran (Islamic Rep. of),IRN,Denmark,DNK,76,5,110,0,191
2016,Iraq,IRQ,Denmark,DNK,0,10,74,0,84
2016,Kenya,KEN,Denmark,DNK,0,0,5,0,5
2016,Libya,LBY,Denmark,DNK,0,0,10,0,10
2016,Lebanon,LBN,Denmark,DNK,5,0,20,0,25
2016,Sri Lanka,LKA,Denmark,DNK,5,0,10,0,15
2016,North Macedonia,MKD,Denmark,DNK,0,0,10,0,10
2016,Morocco,MAR,Denmark,DNK,0,0,10,0,10
2016,Myanmar,MMR,Denmark,DNK,0,0,16,0,16
2016,Nepal,NPL,Denmark,DNK,0,0,5,0,5
2016,Nigeria,NGA,Denmark,DNK,0,0,24,0,24
2016,Pakistan,PAK,Denmark,DNK,0,0,15,0,15
2016,Russian Federation,RUS,Denmark,DNK,32,0,64,0,96
2016,El Salvador,SLV,Denmark,DNK,0,5,0,0,5
2016,Serbia and Kosovo: S/RES/1244 (1999),SRB,Denmark,DNK,0,0,5,0,5
2016,Somalia,SOM,Denmark,DNK,5,10,107,0,122
2016,Sudan,SDN,Denmark,DNK,5,0,36,0,41
2016,Syrian Arab Rep.,SYR,Denmark,DNK,13,0,18,0,31
2016,Tunisia,TUN,Denmark,DNK,0,0,5,0,5
2016,Turkey,TUR,Denmark,DNK,0,0,5,0,5
2016,Uganda,UGA,Denmark,DNK,0,0,14,0,14
2016,Ukraine,UKR,Denmark,DNK,10,0,33,0,43
2016,Uzbekistan,UZB,Denmark,DNK,0,0,5,0,5
2016,Stateless,XXA,Denmark,DNK,5,5,87,0,97
2016,Ukraine,UKR,Fiji,FJI,0,0,0,5,5
2016,Afghanistan,AFG,France,FRA,48,88,77,5,218
2016,Albania,ALB,France,FRA,58,146,1317,211,1732
2016,Algeria,DZA,France,FRA,31,25,428,667,1151
2016,Angola,AGO,France,FRA,41,18,273,5,337
2016,Egypt,EGY,France,FRA,47,0,92,0,139
2016,Armenia,ARM,France,FRA,45,44,732,63,884
2016,Azerbaijan,AZE,France,FRA,87,15,351,12,465
2016,Benin,BEN,France,FRA,0,0,5,0,5
2016,Bangladesh,BGD,France,FRA,450,74,1714,37,2275
2016,Bhutan,BTN,France,FRA,5,0,21,0,26
2016,Burkina Faso,BFA,France,FRA,0,5,30,0,35
2016,Belarus,BLR,France,FRA,5,0,17,0,22
2016,Brazil,BRA,France,FRA,0,0,5,0,5
2016,Bosnia and Herzegovina,BIH,France,FRA,12,5,93,32,142
2016,Cambodia,KHM,France,FRA,0,0,13,0,13
2016,Central African Rep.,CAF,France,FRA,5,5,38,10,58
2016,Chad,TCD,France,FRA,54,5,172,5,236
2016,China,CHN,France,FRA,22,5,204,1280,1511
2016,Cameroon,CMR,France,FRA,26,10,112,5,153
2016,Congo,COG,France,FRA,38,18,456,22,534
2016,Dem. Rep. of the Congo,COD,France,FRA,508,92,2769,64,3433
2016,Comoros,COM,France,FRA,0,0,61,58,119
2016,Colombia,COL,France,FRA,0,5,27,5,37
2016,Cuba,CUB,France,FRA,0,0,19,0,19
2016,Djibouti,DJI,France,FRA,10,5,5,5,25
2016,Dominican Rep.,DOM,France,FRA,0,5,58,127,190
2016,Eritrea,ERI,France,FRA,136,0,282,16,434
2016,Ethiopia,ETH,France,FRA,22,0,71,0,93
2016,Gabon,GAB,France,FRA,0,0,12,0,12
2016,Gambia,GMB,France,FRA,10,0,94,5,109
2016,Palestinian,PSE,France,FRA,10,0,19,0,29
2016,Georgia,GEO,France,FRA,51,36,800,34,921
2016,Germany,DEU,France,FRA,0,0,5,0,5
2016,Ghana,GHA,France,FRA,0,0,22,0,22
2016,Guinea-Bissau,GNB,France,FRA,0,5,97,12,114
2016,Guinea,GIN,France,FRA,315,86,1183,33,1617
2016,Haiti,HTI,France,FRA,13,32,1258,1642,2945
2016,Cote d'Ivoire,CIV,France,FRA,68,34,578,30,710
2016,India,IND,France,FRA,0,5,60,5,70
2016,Iran (Islamic Rep. of),IRN,France,FRA,15,5,10,0,30
2016,Iraq,IRQ,France,FRA,5,10,27,5,47
2016,Jamaica,JAM,France,FRA,0,0,5,0,5
2016,Kazakhstan,KAZ,France,FRA,16,5,51,0,72
2016,Kenya,KEN,France,FRA,5,0,5,0,10
2016,Kyrgyzstan,KGZ,France,FRA,5,0,25,0,30
2016,Dem. People's Rep. of Korea,PRK,France,FRA,5,0,5,0,10
2016,Liberia,LBR,France,FRA,5,0,5,0,10
2016,Libya,LBY,France,FRA,11,22,37,0,70
2016,Saint Lucia,LCA,France,FRA,0,0,0,5,5
2016,Lebanon,LBN,France,FRA,5,0,12,0,17
2016,Sri Lanka,LKA,France,FRA,317,27,896,47,1287
2016,Madagascar,MDG,France,FRA,0,5,75,5,85
2016,Mauritania,MRT,France,FRA,112,5,452,78,647
2016,North Macedonia,MKD,France,FRA,10,0,113,16,139
2016,Rep. of Moldova,MDA,France,FRA,0,0,14,0,14
2016,Mexico,MEX,France,FRA,0,0,5,0,5
2016,Mali,MLI,France,FRA,47,10,488,302,847
2016,Mongolia,MNG,France,FRA,0,5,64,12,81
2016,Morocco,MAR,France,FRA,29,0,95,5,129
2016,Montenegro,MNE,France,FRA,0,0,50,18,68
2016,Myanmar,MMR,France,FRA,10,0,11,0,21
2016,Nepal,NPL,France,FRA,5,0,64,0,69
2016,Niger,NER,France,FRA,0,0,11,0,11
2016,Nigeria,NGA,France,FRA,139,47,918,25,1129
2016,Pakistan,PAK,France,FRA,68,33,907,732,1740
2016,Peru,PER,France,FRA,0,0,28,5,33
2016,Romania,ROU,France,FRA,5,0,0,0,5
2016,South Africa,ZAF,France,FRA,0,0,5,0,5
2016,Russian Federation,RUS,France,FRA,433,114,1435,76,2058
2016,Rwanda,RWA,France,FRA,22,0,34,0,56
2016,El Salvador,SLV,France,FRA,0,10,0,0,10
2016,Serbia and Kosovo: S/RES/1244 (1999),SRB,France,FRA,176,177,1817,371,2541
2016,Senegal,SEN,France,FRA,39,5,167,17,228
2016,Sierra Leone,SLE,France,FRA,10,0,35,5,50
2016,Somalia,SOM,France,FRA,60,241,249,19,569
2016,Viet Nam,VNM,France,FRA,0,0,14,0,14
2016,Sudan,SDN,France,FRA,299,403,1127,48,1877
2016,Suriname,SUR,France,FRA,0,0,22,11,33
2016,Syrian Arab Rep.,SYR,France,FRA,138,11,168,13,330
2016,United Rep. of Tanzania,TZA,France,FRA,0,0,5,0,5
2016,Tajikistan,TJK,France,FRA,5,0,5,0,10
2016,Togo,TGO,France,FRA,11,5,96,5,117
2016,Tunisia,TUN,France,FRA,5,5,75,5,90
2016,Turkey,TUR,France,FRA,79,13,488,19,599
2016,Uganda,UGA,France,FRA,5,0,0,0,5
2016,Ukraine,UKR,France,FRA,89,13,642,44,788
2016,United States of America,USA,France,FRA,0,0,5,0,5
2016,Uzbekistan,UZB,France,FRA,0,0,11,0,11
2016,Venezuela (Bolivarian Republic of),VEN,France,FRA,0,0,5,5,10
2016,Western Sahara,ESH,France,FRA,19,0,87,10,116
2016,Unknown ,,France,FRA,0,0,5,29,34
2016,Afghanistan,AFG,Greece,GRC,5,15,23,0,43
2016,Albania,ALB,Greece,GRC,0,0,236,40,276
2016,Algeria,DZA,Greece,GRC,0,0,167,18,185
2016,Egypt,EGY,Greece,GRC,0,0,96,12,108
2016,Armenia,ARM,Greece,GRC,0,0,5,0,5
2016,Bangladesh,BGD,Greece,GRC,0,0,142,14,156
2016,Burkina Faso,BFA,Greece,GRC,0,0,5,0,5
2016,China,CHN,Greece,GRC,0,0,15,5,20
2016,Cameroon,CMR,Greece,GRC,5,0,13,5,23
2016,Dominican Rep.,DOM,Greece,GRC,0,0,5,0,5
2016,Ethiopia,ETH,Greece,GRC,11,0,0,0,11
2016,Gambia,GMB,Greece,GRC,0,0,5,0,5
2016,Georgia,GEO,Greece,GRC,0,0,124,16,140
2016,Ghana,GHA,Greece,GRC,0,0,11,0,11
2016,Guinea,GIN,Greece,GRC,0,0,10,0,10
2016,Cote d'Ivoire,CIV,Greece,GRC,5,0,10,0,15
2016,India,IND,Greece,GRC,0,0,20,5,25
2016,Iran (Islamic Rep. of),IRN,Greece,GRC,0,0,5,5,10
2016,Iraq,IRQ,Greece,GRC,0,0,10,5,15
2016,Lebanon,LBN,Greece,GRC,0,0,5,0,5
2016,Rep. of Moldova,MDA,Greece,GRC,0,0,5,5,10
2016,Mali,MLI,Greece,GRC,0,5,5,0,10
2016,Morocco,MAR,Greece,GRC,0,0,64,14,78
2016,Nepal,NPL,Greece,GRC,0,0,5,0,5
2016,Nigeria,NGA,Greece,GRC,0,0,63,10,73
2016,Pakistan,PAK,Greece,GRC,14,0,768,42,824
2016,Philippines,PHL,Greece,GRC,0,0,5,0,5
2016,Russian Federation,RUS,Greece,GRC,0,0,5,0,5
2016,Senegal,SEN,Greece,GRC,0,0,15,5,20
2016,Sierra Leone,SLE,Greece,GRC,0,0,5,0,5
2016,Sudan,SDN,Greece,GRC,0,0,0,5,5
2016,Syrian Arab Rep.,SYR,Greece,GRC,199,0,0,5,204
2016,Tunisia,TUN,Greece,GRC,0,0,5,5,10
2016,Uganda,UGA,Greece,GRC,5,0,5,0,10
2016,Ukraine,UKR,Greece,GRC,0,5,30,10,45
2016,Stateless,XXA,Greece,GRC,0,0,5,0,5
2016,Unknown ,,Greece,GRC,522,5032,4838,3797,14189
2016,Afghanistan,AFG,Ireland,IRL,18,0,0,5,23
2016,Albania,ALB,Ireland,IRL,0,0,27,10,37
2016,Algeria,DZA,Ireland,IRL,0,0,28,10,38
2016,Bangladesh,BGD,Ireland,IRL,10,0,11,10,31
2016,Cameroon,CMR,Ireland,IRL,0,0,13,0,13
2016,Dem. Rep. of the Congo,COD,Ireland,IRL,24,0,13,0,37
2016,Ethiopia,ETH,Ireland,IRL,5,0,0,0,5
2016,Georgia,GEO,Ireland,IRL,5,0,0,0,5
2016,Ghana,GHA,Ireland,IRL,0,0,5,5,10
2016,"China, Hong Kong SAR",HKG,Ireland,IRL,5,0,0,0,5
2016,India,IND,Ireland,IRL,0,0,5,5,10
2016,Iran (Islamic Rep. of),IRN,Ireland,IRL,5,0,0,5,10
2016,Israel,ISR,Ireland,IRL,0,0,5,0,5
2016,Kenya,KEN,Ireland,IRL,0,0,5,0,5
2016,Malawi,MWI,Ireland,IRL,5,0,24,5,34
2016,Mauritius,MUS,Ireland,IRL,0,0,5,5,10
2016,Nigeria,NGA,Ireland,IRL,12,0,82,59,153
2016,Pakistan,PAK,Ireland,IRL,19,0,41,29,89
2016,South Africa,ZAF,Ireland,IRL,13,0,26,5,44
2016,Rwanda,RWA,Ireland,IRL,5,0,5,0,10
2016,Serbia and Kosovo: S/RES/1244 (1999),SRB,Ireland,IRL,5,0,5,0,10
2016,Sierra Leone,SLE,Ireland,IRL,0,0,5,0,5
2016,Somalia,SOM,Ireland,IRL,0,0,0,5,5
2016,Sudan,SDN,Ireland,IRL,5,0,0,0,5
2016,Eswatini,SWZ,Ireland,IRL,5,0,0,0,5
2016,Ukraine,UKR,Ireland,IRL,5,0,13,5,23
2016,Venezuela (Bolivarian Republic of),VEN,Ireland,IRL,5,0,11,0,16
2016,Zimbabwe,ZWE,Ireland,IRL,23,0,29,5,57
2016,Bangladesh,BGD,Japan,JPN,0,0,68,0,68
2016,Ghana,GHA,Japan,JPN,0,0,77,0,77
2016,Indonesia,IDN,Japan,JPN,0,0,290,0,290
2016,Myanmar,MMR,Japan,JPN,0,0,195,0,195
2016,Nepal,NPL,Japan,JPN,0,0,277,0,277
2016,Pakistan,PAK,Japan,JPN,0,0,84,0,84
2016,Philippines,PHL,Japan,JPN,0,0,124,0,124
2016,Viet Nam,VNM,Japan,JPN,0,0,175,0,175
2016,Turkey,TUR,Japan,JPN,0,0,373,0,373
2016,Unknown ,,Japan,JPN,0,29,449,822,1300
2016,Afghanistan,AFG,Kazakhstan,KAZ,0,0,0,5,5
2016,Afghanistan,AFG,Luxembourg,LUX,0,0,5,0,5
2016,Albania,ALB,Luxembourg,LUX,0,0,66,11,77
2016,Algeria,DZA,Luxembourg,LUX,0,0,5,5,10
2016,Azerbaijan,AZE,Luxembourg,LUX,0,0,10,0,10
2016,Belarus,BLR,Luxembourg,LUX,0,0,5,0,5
2016,Bosnia and Herzegovina,BIH,Luxembourg,LUX,0,0,32,5,37
2016,Cameroon,CMR,Luxembourg,LUX,0,0,0,5,5
2016,Eritrea,ERI,Luxembourg,LUX,0,0,0,5,5
2016,Palestinian,PSE,Luxembourg,LUX,0,0,0,10,10
2016,Georgia,GEO,Luxembourg,LUX,0,0,5,0,5
2016,Guinea,GIN,Luxembourg,LUX,0,0,5,0,5
2016,Iraq,IRQ,Luxembourg,LUX,0,0,0,19,19
2016,North Macedonia,MKD,Luxembourg,LUX,0,0,5,0,5
2016,Montenegro,MNE,Luxembourg,LUX,0,0,18,5,23
2016,Nigeria,NGA,Luxembourg,LUX,0,0,10,5,15
2016,Serbia and Kosovo: S/RES/1244 (1999),SRB,Luxembourg,LUX,0,0,124,27,151
2016,Somalia,SOM,Luxembourg,LUX,0,0,5,0,5
2016,Syrian Arab Rep.,SYR,Luxembourg,LUX,0,0,0,5,5
2016,Togo,TGO,Luxembourg,LUX,0,0,5,0,5
2016,Tunisia,TUN,Luxembourg,LUX,0,0,5,0,5
2016,Ukraine,UKR,Luxembourg,LUX,0,0,5,0,5
2016,Burundi,BDI,Malawi,MWI,0,0,38,99,137
2016,Dem. Rep. of the Congo,COD,Malawi,MWI,0,0,0,93,93
2016,Rwanda,RWA,Malawi,MWI,0,0,57,107,164
2016,Zambia,ZMB,Malawi,MWI,0,0,0,5,5
2016,Algeria,DZA,Malta,MLT,0,0,5,0,5
2016,Egypt,EGY,Malta,MLT,0,0,10,5,15
2016,Bangladesh,BGD,Malta,MLT,0,0,0,5,5
2016,Comoros,COM,Malta,MLT,0,0,5,0,5
2016,Eritrea,ERI,Malta,MLT,0,5,10,27,42
2016,Ethiopia,ETH,Malta,MLT,0,5,0,20,25
2016,Gambia,GMB,Malta,MLT,0,5,5,15,25
2016,Palestinian,PSE,Malta,MLT,0,0,0,5,5
2016,Guinea,GIN,Malta,MLT,0,0,5,0,5
2016,Cote d'Ivoire,CIV,Malta,MLT,0,0,5,0,5
2016,Libya,LBY,Malta,MLT,5,0,5,10,20
2016,North Macedonia,MKD,Malta,MLT,0,0,5,0,5
2016,Mali,MLI,Malta,MLT,0,0,25,14,39
2016,Nepal,NPL,Malta,MLT,0,0,5,5,10
2016,Nigeria,NGA,Malta,MLT,5,5,11,5,26
2016,Somalia,SOM,Malta,MLT,5,5,20,15,45
2016,Sudan,SDN,Malta,MLT,0,5,0,5,10
2016,Syrian Arab Rep.,SYR,Malta,MLT,0,0,5,5,10
2016,Tunisia,TUN,Malta,MLT,0,0,5,0,5
2016,United States of America,USA,Malta,MLT,0,0,0,5,5
2016,Venezuela (Bolivarian Republic of),VEN,Malta,MLT,0,0,5,0,5
2016,Central African Rep.,CAF,Niger,NER,5,0,0,0,5
2016,Afghanistan,AFG,Norway,NOR,23,0,2252,143,2418
2016,Albania,ALB,Norway,NOR,0,0,92,0,92
2016,Algeria,DZA,Norway,NOR,0,0,42,0,42
2016,Angola,AGO,Norway,NOR,0,0,5,0,5
2016,Egypt,EGY,Norway,NOR,0,0,103,5,108
2016,Armenia,ARM,Norway,NOR,0,0,14,0,14
2016,Azerbaijan,AZE,Norway,NOR,0,0,26,0,26
2016,Burundi,BDI,Norway,NOR,0,0,10,0,10
2016,Bangladesh,BGD,Norway,NOR,0,0,40,0,40
2016,Belarus,BLR,Norway,NOR,0,0,5,0,5
2016,Bosnia and Herzegovina,BIH,Norway,NOR,0,0,10,0,10
2016,China,CHN,Norway,NOR,0,0,17,0,17
2016,Cameroon,CMR,Norway,NOR,0,0,5,0,5
2016,Congo,COG,Norway,NOR,0,0,5,0,5
2016,Dem. Rep. of the Congo,COD,Norway,NOR,0,0,12,0,12
2016,Eritrea,ERI,Norway,NOR,10,0,324,5,339
2016,Ethiopia,ETH,Norway,NOR,5,0,237,5,247
2016,Gambia,GMB,Norway,NOR,0,0,27,0,27
2016,Ghana,GHA,Norway,NOR,0,0,11,0,11
2016,Greece,GRC,Norway,NOR,0,0,5,0,5
2016,Guinea,GIN,Norway,NOR,0,0,12,0,12
2016,Cote d'Ivoire,CIV,Norway,NOR,0,0,10,0,10
2016,India,IND,Norway,NOR,0,0,18,0,18
2016,Iran (Islamic Rep. of),IRN,Norway,NOR,18,0,340,21,379
2016,Iraq,IRQ,Norway,NOR,13,5,658,78,754
2016,Jordan,JOR,Norway,NOR,0,0,26,0,26
2016,Kazakhstan,KAZ,Norway,NOR,0,0,12,0,12
2016,Kyrgyzstan,KGZ,Norway,NOR,0,0,12,5,17
2016,Liberia,LBR,Norway,NOR,0,0,5,0,5
2016,Libya,LBY,Norway,NOR,0,0,10,0,10
2016,Lebanon,LBN,Norway,NOR,0,0,57,0,57
2016,Sri Lanka,LKA,Norway,NOR,0,0,29,0,29
2016,Mauritania,MRT,Norway,NOR,0,0,5,0,5
2016,North Macedonia,MKD,Norway,NOR,0,0,10,0,10
2016,Mali,MLI,Norway,NOR,0,0,5,0,5
2016,Morocco,MAR,Norway,NOR,0,0,49,0,49
2016,Myanmar,MMR,Norway,NOR,0,0,5,0,5
2016,Nepal,NPL,Norway,NOR,0,0,10,0,10
2016,Nigeria,NGA,Norway,NOR,0,0,67,5,72
2016,Pakistan,PAK,Norway,NOR,0,0,103,5,108
2016,Russian Federation,RUS,Norway,NOR,0,0,53,5,58
2016,Rwanda,RWA,Norway,NOR,0,0,5,0,5
2016,El Salvador,SLV,Norway,NOR,0,0,5,0,5
2016,Serbia and Kosovo: S/RES/1244 (1999),SRB,Norway,NOR,0,0,53,0,53
2016,Senegal,SEN,Norway,NOR,0,0,12,0,12
2016,Sierra Leone,SLE,Norway,NOR,0,0,5,0,5
2016,Somalia,SOM,Norway,NOR,0,0,229,19,248
2016,Viet Nam,VNM,Norway,NOR,0,34,5,0,39
2016,Sudan,SDN,Norway,NOR,0,0,102,5,107
2016,Syrian Arab Rep.,SYR,Norway,NOR,0,5,321,179,505
2016,Tajikistan,TJK,Norway,NOR,0,0,15,0,15
2016,Tunisia,TUN,Norway,NOR,0,0,15,0,15
2016,Turkey,TUR,Norway,NOR,0,0,33,5,38
2016,Uganda,UGA,Norway,NOR,0,0,12,5,17
2016,Ukraine,UKR,Norway,NOR,0,0,28,5,33
2016,Uzbekistan,UZB,Norway,NOR,18,0,48,5,71
2016,Venezuela (Bolivarian Republic of),VEN,Norway,NOR,0,0,5,0,5
2016,Yemen,YEM,Norway,NOR,0,0,0,11,11
2016,Stateless,XXA,Norway,NOR,36,5,189,31,261
2016,Unknown ,,Norway,NOR,0,0,10,0,10
2016,Unknown ,,New Zealand,NZL,55,0,103,30,188
2016,Bangladesh,BGD,Papua New Guinea,PNG,0,0,5,0,5
2016,India,IND,Papua New Guinea,PNG,0,0,5,0,5
2016,Iran (Islamic Rep. of),IRN,Papua New Guinea,PNG,34,0,5,0,39
2016,Iraq,IRQ,Papua New Guinea,PNG,5,0,0,0,5
2016,Afghanistan,AFG,Poland,POL,0,0,5,0,5
2016,Armenia,ARM,Poland,POL,0,0,10,0,10
2016,Belarus,BLR,Poland,POL,0,0,5,0,5
2016,Georgia,GEO,Poland,POL,0,0,21,10,31
2016,India,IND,Poland,POL,0,0,5,0,5
2016,Iran (Islamic Rep. of),IRN,Poland,POL,0,0,5,5,10
2016,Kyrgyzstan,KGZ,Poland,POL,0,0,15,0,15
2016,Nigeria,NGA,Poland,POL,0,0,5,0,5
2016,Pakistan,PAK,Poland,POL,0,0,10,5,15
2016,Russian Federation,RUS,Poland,POL,0,5,256,39,300
2016,Viet Nam,VNM,Poland,POL,0,0,24,5,29
2016,Turkey,TUR,Poland,POL,0,0,5,0,5
2016,Ukraine,UKR,Poland,POL,5,5,453,131,594
2016,Uzbekistan,UZB,Poland,POL,0,0,5,0,5
2016,Stateless,XXA,Poland,POL,0,0,5,0,5
2016,Afghanistan,AFG,South Africa,ZAF,0,0,0,5,5
2016,Algeria,DZA,South Africa,ZAF,0,0,0,199,199
2016,Angola,AGO,South Africa,ZAF,0,0,0,44,44
2016,Egypt,EGY,South Africa,ZAF,0,0,0,210,210
2016,Burundi,BDI,South Africa,ZAF,5,0,0,956,961
2016,Benin,BEN,South Africa,ZAF,0,0,0,47,47
2016,Bangladesh,BGD,South Africa,ZAF,0,0,129,7830,7959
2016,Burkina Faso,BFA,South Africa,ZAF,0,0,0,50,50
2016,Botswana,BWA,South Africa,ZAF,0,0,0,10,10
2016,Bulgaria,BGR,South Africa,ZAF,0,0,0,5,5
2016,China,CHN,South Africa,ZAF,0,0,0,655,655
2016,Cameroon,CMR,South Africa,ZAF,0,0,5,642,647
2016,Congo,COG,South Africa,ZAF,0,0,0,337,337
2016,Dem. Rep. of the Congo,COD,South Africa,ZAF,45,0,142,8429,8616
2016,Comoros,COM,South Africa,ZAF,0,0,0,11,11
2016,Czechia,CZE,South Africa,ZAF,0,0,0,5,5
2016,Eritrea,ERI,South Africa,ZAF,0,0,0,306,306
2016,Ethiopia,ETH,South Africa,ZAF,5,0,304,12166,12475
2016,Gabon,GAB,South Africa,ZAF,0,0,0,13,13
2016,Gambia,GMB,South Africa,ZAF,0,0,0,17,17
2016,Palestinian,PSE,South Africa,ZAF,0,0,0,5,5
2016,Ghana,GHA,South Africa,ZAF,0,0,10,1682,1692
2016,Guinea-Bissau,GNB,South Africa,ZAF,0,0,0,5,5
2016,Guinea,GIN,South Africa,ZAF,0,0,0,31,31
2016,Cote d'Ivoire,CIV,South Africa,ZAF,0,0,0,104,104
2016,India,IND,South Africa,ZAF,0,0,67,3863,3930
2016,Iran (Islamic Rep. of),IRN,South Africa,ZAF,0,0,0,5,5
2016,Iraq,IRQ,South Africa,ZAF,0,0,0,5,5
2016,Jamaica,JAM,South Africa,ZAF,0,0,0,5,5
2016,Kenya,KEN,South Africa,ZAF,0,0,10,447,457
2016,Liberia,LBR,South Africa,ZAF,0,0,0,24,24
2016,Libya,LBY,South Africa,ZAF,0,0,0,5,5
2016,Lesotho,LSO,South Africa,ZAF,0,0,0,399,399
2016,Sri Lanka,LKA,South Africa,ZAF,0,0,0,10,10
2016,Madagascar,MDG,South Africa,ZAF,0,0,0,5,5
2016,Mali,MLI,South Africa,ZAF,0,0,0,53,53
2016,Malawi,MWI,South Africa,ZAF,0,0,0,1953,1953
2016,Morocco,MAR,South Africa,ZAF,0,0,0,10,10
2016,Mozambique,MOZ,South Africa,ZAF,0,0,0,746,746
2016,Mauritius,MUS,South Africa,ZAF,0,0,0,5,5
2016,Myanmar,MMR,South Africa,ZAF,0,0,0,5,5
2016,Nepal,NPL,South Africa,ZAF,0,0,0,61,61
2016,Niger,NER,South Africa,ZAF,0,0,0,59,59
2016,Nigeria,NGA,South Africa,ZAF,0,0,37,7410,7447
2016,Pakistan,PAK,South Africa,ZAF,0,0,94,5337,5431
2016,Rwanda,RWA,South Africa,ZAF,0,0,0,199,199
2016,Senegal,SEN,South Africa,ZAF,0,0,5,472,477
2016,Sierra Leone,SLE,South Africa,ZAF,0,0,0,10,10
2016,Somalia,SOM,South Africa,ZAF,5,0,0,1081,1086
2016,Sudan,SDN,South Africa,ZAF,0,0,0,33,33
2016,Eswatini,SWZ,South Africa,ZAF,0,0,0,26,26
2016,Syrian Arab Rep.,SYR,South Africa,ZAF,0,0,0,5,5
2016,United Rep. of Tanzania,TZA,South Africa,ZAF,0,0,5,507,512
2016,Thailand,THA,South Africa,ZAF,0,0,0,21,21
2016,Togo,TGO,South Africa,ZAF,0,0,0,19,19
2016,Uganda,UGA,South Africa,ZAF,0,0,26,1528,1554
2016,Zambia,ZMB,South Africa,ZAF,0,0,0,136,136
2016,Zimbabwe,ZWE,South Africa,ZAF,0,0,14,14726,14740
2016,Unknown ,,South Africa,ZAF,0,0,0,543233,543233
2016,Afghanistan,AFG,Sweden,SWE,42,95,1525,551,2213
2016,Albania,ALB,Sweden,SWE,5,17,799,78,899
2016,Algeria,DZA,Sweden,SWE,0,0,72,10,82
2016,Angola,AGO,Sweden,SWE,0,0,10,0,10
2016,Egypt,EGY,Sweden,SWE,5,5,123,42,175
2016,Armenia,ARM,Sweden,SWE,0,24,192,18,234
2016,Azerbaijan,AZE,Sweden,SWE,10,19,157,17,203
2016,Burundi,BDI,Sweden,SWE,0,5,14,0,19
2016,Benin,BEN,Sweden,SWE,0,5,0,0,5
2016,Bangladesh,BGD,Sweden,SWE,0,0,83,16,99
2016,Belarus,BLR,Sweden,SWE,0,0,75,11,86
2016,Bolivia (Plurinational State of),BOL,Sweden,SWE,0,5,11,5,21
2016,Brazil,BRA,Sweden,SWE,0,0,10,0,10
2016,Bosnia and Herzegovina,BIH,Sweden,SWE,0,0,138,28,166
2016,Bulgaria,BGR,Sweden,SWE,0,0,5,0,5
2016,Canada,CAN,Sweden,SWE,0,0,5,0,5
2016,China,CHN,Sweden,SWE,5,5,21,10,41
2016,Chile,CHL,Sweden,SWE,0,0,5,5,10
2016,Cameroon,CMR,Sweden,SWE,0,0,22,0,22
2016,Congo,COG,Sweden,SWE,0,0,10,0,10
2016,Dem. Rep. of the Congo,COD,Sweden,SWE,0,0,16,5,21
2016,Colombia,COL,Sweden,SWE,0,0,11,5,16
2016,Cuba,CUB,Sweden,SWE,0,0,36,5,41
2016,Djibouti,DJI,Sweden,SWE,0,0,15,5,20
2016,Ecuador,ECU,Sweden,SWE,0,0,5,0,5
2016,Eritrea,ERI,Sweden,SWE,5,10,198,46,259
2016,Ethiopia,ETH,Sweden,SWE,14,5,266,15,300
2016,Gambia,GMB,Sweden,SWE,0,0,65,5,70
2016,Palestinian,PSE,Sweden,SWE,12,24,168,41,245
2016,Georgia,GEO,Sweden,SWE,0,14,414,30,458
2016,Ghana,GHA,Sweden,SWE,0,0,24,5,29
2016,Guinea-Bissau,GNB,Sweden,SWE,0,0,5,0,5
2016,Guinea,GIN,Sweden,SWE,0,0,15,0,15
2016,Honduras,HND,Sweden,SWE,0,0,5,0,5
2016,Cote d'Ivoire,CIV,Sweden,SWE,0,0,14,0,14
2016,India,IND,Sweden,SWE,0,0,38,5,43
2016,Indonesia,IDN,Sweden,SWE,0,5,5,0,10
2016,Iran (Islamic Rep. of),IRN,Sweden,SWE,29,10,299,59,397
2016,Iraq,IRQ,Sweden,SWE,24,72,954,301,1351
2016,Israel,ISR,Sweden,SWE,0,0,10,0,10
2016,Jordan,JOR,Sweden,SWE,0,5,99,12,116
2016,Kazakhstan,KAZ,Sweden,SWE,0,18,117,13,148
2016,Kenya,KEN,Sweden,SWE,0,0,17,5,22
2016,Kyrgyzstan,KGZ,Sweden,SWE,0,0,68,14,82
2016,Kuwait,KWT,Sweden,SWE,0,0,5,0,5
2016,Liberia,LBR,Sweden,SWE,0,0,5,0,5
2016,Libya,LBY,Sweden,SWE,10,0,93,5,108
2016,Lebanon,LBN,Sweden,SWE,0,11,164,19,194
2016,Sri Lanka,LKA,Sweden,SWE,0,0,10,5,15
2016,North Macedonia,MKD,Sweden,SWE,0,0,112,10,122
2016,Rep. of Moldova,MDA,Sweden,SWE,0,0,12,5,17
2016,Mexico,MEX,Sweden,SWE,0,0,5,0,5
2016,Mali,MLI,Sweden,SWE,0,0,5,0,5
2016,Mongolia,MNG,Sweden,SWE,0,10,669,85,764
2016,Morocco,MAR,Sweden,SWE,0,0,188,22,210
2016,Montenegro,MNE,Sweden,SWE,0,0,24,0,24
2016,Nepal,NPL,Sweden,SWE,0,0,12,5,17
2016,Nicaragua,NIC,Sweden,SWE,0,0,5,5,10
2016,Nigeria,NGA,Sweden,SWE,5,5,189,29,228
2016,Pakistan,PAK,Sweden,SWE,10,0,143,25,178
2016,Peru,PER,Sweden,SWE,0,0,5,0,5
2016,Philippines,PHL,Sweden,SWE,0,0,5,0,5
2016,Romania,ROU,Sweden,SWE,0,0,10,0,10
2016,Russian Federation,RUS,Sweden,SWE,5,19,199,31,254
2016,Rwanda,RWA,Sweden,SWE,0,0,10,0,10
2016,El Salvador,SLV,Sweden,SWE,0,0,91,5,96
2016,Serbia and Kosovo: S/RES/1244 (1999),SRB,Sweden,SWE,0,10,624,58,692
2016,Senegal,SEN,Sweden,SWE,0,0,17,0,17
2016,Sierra Leone,SLE,Sweden,SWE,0,0,14,0,14
2016,Somalia,SOM,Sweden,SWE,33,21,788,92,934
2016,Spain,ESP,Sweden,SWE,0,0,5,0,5
2016,Viet Nam,VNM,Sweden,SWE,0,0,10,0,10
2016,Saint Kitts and Nevis,KNA,Sweden,SWE,0,0,5,0,5
2016,Sudan,SDN,Sweden,SWE,5,0,90,10,105
2016,Slovakia,SVK,Sweden,SWE,0,0,5,0,5
2016,Syrian Arab Rep.,SYR,Sweden,SWE,0,19,996,893,1908
2016,United Rep. of Tanzania,TZA,Sweden,SWE,0,0,15,0,15
2016,Thailand,THA,Sweden,SWE,0,0,10,0,10
2016,Tajikistan,TJK,Sweden,SWE,0,5,41,0,46
2016,Tunisia,TUN,Sweden,SWE,0,0,55,10,65
2016,Turkey,TUR,Sweden,SWE,0,0,89,11,100
2016,Uganda,UGA,Sweden,SWE,0,0,35,5,40
2016,Ukraine,UKR,Sweden,SWE,10,11,806,108,935
2016,United States of America,USA,Sweden,SWE,0,0,5,5,10
2016,Uzbekistan,UZB,Sweden,SWE,20,0,128,25,173
2016,Venezuela (Bolivarian Republic of),VEN,Sweden,SWE,0,0,22,5,27
2016,Yemen,YEM,Sweden,SWE,0,25,17,5,47
2016,Zimbabwe,ZWE,Sweden,SWE,0,0,5,5,10
2016,Stateless,XXA,Sweden,SWE,5,28,336,154,523
2016,Unknown ,,Sweden,SWE,0,18,150,22,190
2017,Armenia,ARM,Argentina,ARG,0,0,5,0,5
2017,Bangladesh,BGD,Argentina,ARG,0,0,13,21,34
2017,China,CHN,Argentina,ARG,0,0,5,0,5
2017,Colombia,COL,Argentina,ARG,0,0,16,12,28
2017,Cuba,CUB,Argentina,ARG,0,0,81,15,96
2017,Dominican Rep.,DOM,Argentina,ARG,0,0,31,21,52
2017,Ghana,GHA,Argentina,ARG,0,0,5,5,10
2017,Haiti,HTI,Argentina,ARG,0,0,79,11,90
2017,India,IND,Argentina,ARG,0,0,14,10,24
2017,Nigeria,NGA,Argentina,ARG,0,0,20,13,33
2017,Peru,PER,Argentina,ARG,0,0,0,42,42
2017,Romania,ROU,Argentina,ARG,0,0,0,80,80
2017,South Africa,ZAF,Argentina,ARG,0,0,5,0,5
2017,Senegal,SEN,Argentina,ARG,0,0,841,0,841
2017,Stateless,XXA,Argentina,ARG,0,0,5,0,5
2017,Afghanistan,AFG,Australia,AUS,48,0,153,0,201
2017,Albania,ALB,Australia,AUS,0,0,10,0,10
2017,Algeria,DZA,Australia,AUS,0,0,5,0,5
2017,Egypt,EGY,Australia,AUS,21,0,45,5,71
2017,Bangladesh,BGD,Australia,AUS,18,0,108,14,140
2017,Brazil,BRA,Australia,AUS,0,0,5,0,5
2017,Cambodia,KHM,Australia,AUS,0,0,5,0,5
2017,China,CHN,Australia,AUS,28,0,222,114,364
2017,Cameroon,CMR,Australia,AUS,5,0,0,0,5
2017,Ethiopia,ETH,Australia,AUS,21,0,0,0,21
2017,Fiji,FJI,Australia,AUS,5,0,42,20,67
2017,United Kingdom of Great Britain and Northern Ireland,GBR,Australia,AUS,0,0,5,0,5
2017,Ghana,GHA,Australia,AUS,0,0,12,5,17
2017,India,IND,Australia,AUS,12,0,138,59,209
2017,Indonesia,IDN,Australia,AUS,0,0,54,16,70
2017,Ireland,IRL,Australia,AUS,0,0,5,0,5
2017,Iran (Islamic Rep. of),IRN,Australia,AUS,132,0,268,10,410
2017,Iraq,IRQ,Australia,AUS,65,0,180,5,250
2017,Israel,ISR,Australia,AUS,0,0,5,0,5
2017,Italy,ITA,Australia,AUS,0,0,5,0,5
2017,Jordan,JOR,Australia,AUS,0,0,12,5,17
2017,Kenya,KEN,Australia,AUS,0,0,5,0,5
2017,Rep. of Korea,KOR,Australia,AUS,0,0,11,0,11
2017,Kuwait,KWT,Australia,AUS,0,0,5,0,5
2017,Libya,LBY,Australia,AUS,5,0,0,0,5
2017,Lebanon,LBN,Australia,AUS,10,0,60,13,83
2017,Sri Lanka,LKA,Australia,AUS,94,0,1018,14,1126
2017,Malaysia,MYS,Australia,AUS,60,0,2365,1222,3647
2017,Mongolia,MNG,Australia,AUS,0,0,5,0,5
2017,Myanmar,MMR,Australia,AUS,5,0,5,0,10
2017,Nepal,NPL,Australia,AUS,0,0,65,10,75
2017,Nigeria,NGA,Australia,AUS,5,0,11,10,26
2017,Pakistan,PAK,Australia,AUS,60,0,137,29,226
2017,Philippines,PHL,Australia,AUS,5,0,10,0,15
2017,Papua New Guinea,PNG,Australia,AUS,5,0,26,5,36
2017,South Africa,ZAF,Australia,AUS,0,0,5,5,10
2017,Saudi Arabia,SAU,Australia,AUS,0,0,5,0,5
2017,Solomon Islands,SLB,Australia,AUS,0,0,5,0,5
2017,Viet Nam,VNM,Australia,AUS,15,0,179,30,224
2017,Sudan,SDN,Australia,AUS,0,0,10,0,10
2017,Thailand,THA,Australia,AUS,0,0,16,11,27
2017,Tonga,TON,Australia,AUS,0,0,11,0,11
2017,Turkey,TUR,Australia,AUS,5,0,13,0,18
2017,Ukraine,UKR,Australia,AUS,0,0,10,0,10
2017,United States of America,USA,Australia,AUS,0,0,0,5,5
2017,Zimbabwe,ZWE,Australia,AUS,10,0,10,5,25
2017,Stateless,XXA,Australia,AUS,10,0,15,0,25
2017,Unknown ,,Australia,AUS,0,0,50,22,72
2017,Dem. Rep. of the Congo,COD,Burundi,BDI,105,0,159,37,301
2017,Rwanda,RWA,Burundi,BDI,0,0,15,10,25
2017,Viet Nam,VNM,Cambodia,KHM,0,0,0,5,5
2017,Afghanistan,AFG,Canada,CAN,5,0,22,0,27
2017,Albania,ALB,Canada,CAN,5,0,28,10,43
2017,Algeria,DZA,Canada,CAN,0,0,10,0,10
2017,Angola,AGO,Canada,CAN,0,0,5,0,5
2017,Antigua and Barbuda,ATG,Canada,CAN,5,0,13,0,18
2017,Egypt,EGY,Canada,CAN,5,0,16,0,21
2017,Azerbaijan,AZE,Canada,CAN,0,0,10,0,10
2017,Barbados,BRB,Canada,CAN,0,0,5,0,5
2017,Burundi,BDI,Canada,CAN,0,0,5,0,5
2017,Belgium,BEL,Canada,CAN,5,0,0,0,5
2017,Bangladesh,BGD,Canada,CAN,0,0,27,0,27
2017,Bahamas,BHS,Canada,CAN,11,0,17,0,28
2017,Burkina Faso,BFA,Canada,CAN,0,0,5,0,5
2017,Botswana,BWA,Canada,CAN,0,0,5,0,5
2017,Brazil,BRA,Canada,CAN,0,0,10,0,10
2017,Chad,TCD,Canada,CAN,0,0,10,0,10
2017,China,CHN,Canada,CAN,5,0,239,5,249
2017,Chile,CHL,Canada,CAN,0,0,21,0,21
2017,Cameroon,CMR,Canada,CAN,5,0,10,0,15
2017,Congo,COG,Canada,CAN,0,0,5,0,5
2017,Dem. Rep. of the Congo,COD,Canada,CAN,5,0,37,0,42
2017,Colombia,COL,Canada,CAN,0,0,74,5,79
2017,Costa Rica,CRI,Canada,CAN,0,0,10,0,10
2017,Cuba,CUB,Canada,CAN,0,0,5,0,5
2017,Czechia,CZE,Canada,CAN,0,0,10,0,10
2017,Djibouti,DJI,Canada,CAN,0,0,20,0,20
2017,Ecuador,ECU,Canada,CAN,0,0,5,0,5
2017,Eritrea,ERI,Canada,CAN,12,0,27,0,39
2017,Ethiopia,ETH,Canada,CAN,10,0,48,5,63
2017,France,FRA,Canada,CAN,0,0,5,0,5
2017,Gabon,GAB,Canada,CAN,0,0,5,0,5
2017,Gambia,GMB,Canada,CAN,0,0,5,0,5
2017,Palestinian,PSE,Canada,CAN,0,0,15,0,15
2017,Georgia,GEO,Canada,CAN,0,0,11,0,11
2017,Ghana,GHA,Canada,CAN,0,0,25,0,25
2017,Grenada,GRD,Canada,CAN,0,0,5,0,5
2017,Guatemala,GTM,Canada,CAN,0,0,10,0,10
2017,Guinea,GIN,Canada,CAN,0,0,5,0,5
2017,Guyana,GUY,Canada,CAN,0,0,10,0,10
2017,Haiti,HTI,Canada,CAN,0,0,113,0,113
2017,Honduras,HND,Canada,CAN,5,0,10,0,15
2017,Croatia,HRV,Canada,CAN,0,0,10,0,10
2017,Hungary,HUN,Canada,CAN,5,0,81,10,96
2017,India,IND,Canada,CAN,5,0,95,0,100
2017,Iran (Islamic Rep. of),IRN,Canada,CAN,5,0,11,0,16
2017,Iraq,IRQ,Canada,CAN,16,0,35,5,56
2017,Israel,ISR,Canada,CAN,0,0,11,0,11
2017,Italy,ITA,Canada,CAN,0,0,18,0,18
2017,Jamaica,JAM,Canada,CAN,0,0,36,0,36
2017,Jordan,JOR,Canada,CAN,5,0,16,0,21
2017,Kenya,KEN,Canada,CAN,0,0,5,0,5
2017,Libya,LBY,Canada,CAN,17,0,16,0,33
2017,Lebanon,LBN,Canada,CAN,5,0,37,5,47
2017,Sri Lanka,LKA,Canada,CAN,5,0,15,0,20
2017,Mexico,MEX,Canada,CAN,0,0,47,0,47
2017,Mali,MLI,Canada,CAN,5,0,13,0,18
2017,Mongolia,MNG,Canada,CAN,0,0,5,0,5
2017,Morocco,MAR,Canada,CAN,0,0,5,0,5
2017,Mozambique,MOZ,Canada,CAN,0,0,5,0,5
2017,Mauritius,MUS,Canada,CAN,0,0,5,0,5
2017,Nepal,NPL,Canada,CAN,0,0,17,0,17
2017,Niger,NER,Canada,CAN,0,0,5,0,5
2017,Nigeria,NGA,Canada,CAN,22,0,404,10,436
2017,Pakistan,PAK,Canada,CAN,5,0,71,0,76
2017,Peru,PER,Canada,CAN,0,0,5,0,5
2017,Philippines,PHL,Canada,CAN,0,0,5,0,5
2017,Portugal,PRT,Canada,CAN,0,0,5,0,5
2017,Romania,ROU,Canada,CAN,0,0,5,0,5
2017,Rwanda,RWA,Canada,CAN,5,0,5,0,10
2017,El Salvador,SLV,Canada,CAN,10,0,23,0,33
2017,Saudi Arabia,SAU,Canada,CAN,0,0,13,0,13
2017,Serbia and Kosovo: S/RES/1244 (1999),SRB,Canada,CAN,0,0,13,0,13
2017,Senegal,SEN,Canada,CAN,0,0,5,0,5
2017,Somalia,SOM,Canada,CAN,37,0,56,0,93
2017,Sudan,SDN,Canada,CAN,5,0,5,0,10
2017,Slovakia,SVK,Canada,CAN,0,0,16,0,16
2017,Syrian Arab Rep.,SYR,Canada,CAN,0,0,10,0,10
2017,United Rep. of Tanzania,TZA,Canada,CAN,0,0,5,0,5
2017,Thailand,THA,Canada,CAN,0,0,5,0,5
2017,Togo,TGO,Canada,CAN,0,0,5,0,5
2017,Tunisia,TUN,Canada,CAN,0,0,12,0,12
2017,Turkey,TUR,Canada,CAN,31,0,38,5,74
2017,Uganda,UGA,Canada,CAN,5,0,20,0,25
2017,Ukraine,UKR,Canada,CAN,12,0,12,0,24
2017,United States of America,USA,Canada,CAN,0,0,18,5,23
2017,Saint Vincent and the Grenadines,VCT,Canada,CAN,0,0,10,0,10
2017,Venezuela (Bolivarian Republic of),VEN,Canada,CAN,13,0,45,0,58
2017,Yemen,YEM,Canada,CAN,0,0,10,0,10
2017,Zimbabwe,ZWE,Canada,CAN,5,0,20,0,25
2017,Stateless,XXA,Canada,CAN,0,0,10,0,10
2017,Unknown ,,Canada,CAN,0,0,5,0,5
2017,China,CHN,Costa Rica,CRI,0,0,0,5,5
2017,Colombia,COL,Costa Rica,CRI,12,0,326,29,367
2017,Cuba,CUB,Costa Rica,CRI,0,0,44,5,49
2017,Honduras,HND,Costa Rica,CRI,33,0,47,0,80
2017,Iran (Islamic Rep. of),IRN,Costa Rica,CRI,0,0,5,0,5
2017,Mexico,MEX,Costa Rica,CRI,0,0,10,0,10
2017,Nicaragua,NIC,Costa Rica,CRI,0,0,14,0,14
2017,Nigeria,NGA,Costa Rica,CRI,0,0,5,0,5
2017,Panama,PAN,Costa Rica,CRI,0,0,5,0,5
2017,El Salvador,SLV,Costa Rica,CRI,64,0,236,11,311
2017,United States of America,USA,Costa Rica,CRI,0,0,5,0,5
2017,Venezuela (Bolivarian Republic of),VEN,Costa Rica,CRI,5,0,105,5,115
2017,Albania,ALB,Cyprus,CYP,0,0,0,5,5
2017,Egypt,EGY,Cyprus,CYP,0,0,13,5,18
2017,Bangladesh,BGD,Cyprus,CYP,0,0,35,0,35
2017,Palestinian,PSE,Cyprus,CYP,5,10,10,5,30
2017,India,IND,Cyprus,CYP,0,0,76,30,106
2017,Iran (Islamic Rep. of),IRN,Cyprus,CYP,0,0,5,0,5
2017,Iraq,IRQ,Cyprus,CYP,0,5,0,5,10
2017,Jordan,JOR,Cyprus,CYP,5,0,5,0,10
2017,Sri Lanka,LKA,Cyprus,CYP,0,0,31,5,36
2017,Nepal,NPL,Cyprus,CYP,0,0,5,0,5
2017,Pakistan,PAK,Cyprus,CYP,0,0,41,20,61
2017,Philippines,PHL,Cyprus,CYP,0,0,13,5,18
2017,Russian Federation,RUS,Cyprus,CYP,5,0,0,0,5
2017,Senegal,SEN,Cyprus,CYP,0,0,5,0,5
2017,Somalia,SOM,Cyprus,CYP,0,0,0,5,5
2017,Viet Nam,VNM,Cyprus,CYP,0,0,87,12,99
2017,Syrian Arab Rep.,SYR,Cyprus,CYP,5,23,0,0,28
2017,Ukraine,UKR,Cyprus,CYP,0,0,0,5,5
2017,Afghanistan,AFG,Denmark,DNK,39,93,592,0,724
2017,Egypt,EGY,Denmark,DNK,0,0,10,0,10
2017,Armenia,ARM,Denmark,DNK,0,0,20,0,20
2017,Bangladesh,BGD,Denmark,DNK,0,0,5,0,5
2017,China,CHN,Denmark,DNK,0,0,5,0,5
2017,Cameroon,CMR,Denmark,DNK,0,0,5,0,5
2017,Dem. Rep. of the Congo,COD,Denmark,DNK,0,5,0,0,5
2017,Eritrea,ERI,Denmark,DNK,0,0,5,0,5
2017,Ethiopia,ETH,Denmark,DNK,5,0,10,0,15
2017,Georgia,GEO,Denmark,DNK,0,0,5,0,5
2017,Ghana,GHA,Denmark,DNK,0,0,5,0,5
2017,Iran (Islamic Rep. of),IRN,Denmark,DNK,166,10,360,0,536
2017,Iraq,IRQ,Denmark,DNK,10,14,402,0,426
2017,Kuwait,KWT,Denmark,DNK,0,0,5,0,5
2017,Libya,LBY,Denmark,DNK,0,0,5,0,5
2017,Lebanon,LBN,Denmark,DNK,0,0,5,0,5
2017,Sri Lanka,LKA,Denmark,DNK,0,0,5,0,5
2017,North Macedonia,MKD,Denmark,DNK,0,0,10,0,10
2017,Rep. of Moldova,MDA,Denmark,DNK,0,0,13,0,13
2017,Nigeria,NGA,Denmark,DNK,0,0,13,0,13
2017,Pakistan,PAK,Denmark,DNK,0,0,11,0,11
2017,Russian Federation,RUS,Denmark,DNK,0,5,32,0,37
2017,Rwanda,RWA,Denmark,DNK,5,0,0,0,5
2017,Somalia,SOM,Denmark,DNK,0,5,24,0,29
2017,Sudan,SDN,Denmark,DNK,5,0,13,0,18
2017,Syrian Arab Rep.,SYR,Denmark,DNK,5,5,15,0,25
2017,Uganda,UGA,Denmark,DNK,0,0,11,0,11
2017,Ukraine,UKR,Denmark,DNK,0,0,19,0,19
2017,Yemen,YEM,Denmark,DNK,0,0,5,0,5
2017,Stateless,XXA,Denmark,DNK,11,5,52,0,68
2017,Afghanistan,AFG,France,FRA,116,254,202,5,577
2017,Albania,ALB,France,FRA,121,378,3782,45,4326
2017,Algeria,DZA,France,FRA,74,37,299,5,415
2017,Angola,AGO,France,FRA,34,10,257,0,301
2017,Egypt,EGY,France,FRA,55,5,135,5,200
2017,Armenia,ARM,France,FRA,45,59,727,5,836
2017,Azerbaijan,AZE,France,FRA,54,11,172,5,242
2017,Benin,BEN,France,FRA,0,0,5,0,5
2017,Bangladesh,BGD,France,FRA,576,111,2135,10,2832
2017,Bhutan,BTN,France,FRA,0,0,5,0,5
2017,Burkina Faso,BFA,France,FRA,10,5,57,0,72
2017,Belarus,BLR,France,FRA,5,0,15,0,20
2017,Bosnia and Herzegovina,BIH,France,FRA,27,5,156,0,188
2017,Cambodia,KHM,France,FRA,0,0,18,0,18
2017,Central African Rep.,CAF,France,FRA,35,26,113,0,174
2017,Chad,TCD,France,FRA,49,12,196,0,257
2017,China,CHN,France,FRA,16,0,252,0,268
2017,Cameroon,CMR,France,FRA,86,22,212,5,325
2017,Congo,COG,France,FRA,46,14,313,10,383
2017,Dem. Rep. of the Congo,COD,France,FRA,439,100,2156,16,2711
2017,Comoros,COM,France,FRA,0,0,36,0,36
2017,Colombia,COL,France,FRA,5,10,30,0,45
2017,Cuba,CUB,France,FRA,0,0,14,0,14
2017,Djibouti,DJI,France,FRA,13,5,5,0,23
2017,Dominican Rep.,DOM,France,FRA,0,5,57,0,62
2017,Equatorial Guinea,GNQ,France,FRA,0,0,10,0,10
2017,Eritrea,ERI,France,FRA,87,0,181,0,268
2017,Ethiopia,ETH,France,FRA,32,0,70,0,102
2017,Gabon,GAB,France,FRA,5,0,37,0,42
2017,Gambia,GMB,France,FRA,14,5,100,0,119
2017,Palestinian,PSE,France,FRA,18,0,21,0,39
2017,Georgia,GEO,France,FRA,44,22,542,10,618
2017,Ghana,GHA,France,FRA,0,0,22,0,22
2017,Guinea-Bissau,GNB,France,FRA,0,5,46,0,51
2017,Guinea,GIN,France,FRA,335,62,1106,10,1513
2017,Haiti,HTI,France,FRA,16,14,501,19,550
2017,Cote d'Ivoire,CIV,France,FRA,141,42,740,13,936
2017,India,IND,France,FRA,5,5,81,0,91
2017,Iran (Islamic Rep. of),IRN,France,FRA,41,0,35,0,76
2017,Iraq,IRQ,France,FRA,19,42,113,0,174
2017,Israel,ISR,France,FRA,5,0,0,0,5
2017,Jordan,JOR,France,FRA,5,0,5,0,10
2017,Kazakhstan,KAZ,France,FRA,11,5,24,0,40
2017,Kenya,KEN,France,FRA,10,0,34,0,44
2017,Kyrgyzstan,KGZ,France,FRA,17,0,10,0,27
2017,Dem. People's Rep. of Korea,PRK,France,FRA,0,0,10,0,10
2017,Lao People's Dem. Rep.,LAO,France,FRA,0,0,5,0,5
2017,Liberia,LBR,France,FRA,0,0,17,0,17
2017,Libya,LBY,France,FRA,5,31,32,0,68
2017,Lebanon,LBN,France,FRA,0,0,28,0,28
2017,Sri Lanka,LKA,France,FRA,252,30,605,10,897
2017,Madagascar,MDG,France,FRA,5,5,41,0,51
2017,Mauritania,MRT,France,FRA,136,10,481,5,632
2017,North Macedonia,MKD,France,FRA,5,5,120,0,130
2017,Rep. of Moldova,MDA,France,FRA,0,0,5,0,5
2017,Mali,MLI,France,FRA,83,13,573,5,674
2017,Mongolia,MNG,France,FRA,5,5,67,0,77
2017,Morocco,MAR,France,FRA,37,5,119,0,161
2017,Montenegro,MNE,France,FRA,0,0,28,0,28
2017,Mauritius,MUS,France,FRA,0,0,10,0,10
2017,Myanmar,MMR,France,FRA,0,0,12,0,12
2017,Nepal,NPL,France,FRA,0,5,38,0,43
2017,Niger,NER,France,FRA,0,0,18,0,18
2017,Nigeria,NGA,France,FRA,228,86,1262,10,1586
2017,Pakistan,PAK,France,FRA,150,56,686,0,892
2017,Peru,PER,France,FRA,0,0,16,0,16
2017,Philippines,PHL,France,FRA,0,0,5,0,5
2017,South Africa,ZAF,France,FRA,0,0,5,0,5
2017,Russian Federation,RUS,France,FRA,288,91,937,15,1331
2017,Rwanda,RWA,France,FRA,15,0,23,0,38
2017,Serbia and Kosovo: S/RES/1244 (1999),SRB,France,FRA,190,161,1344,12,1707
2017,Senegal,SEN,France,FRA,37,10,252,0,299
2017,Sierra Leone,SLE,France,FRA,18,5,35,0,58
2017,Somalia,SOM,France,FRA,38,169,184,0,391
2017,Viet Nam,VNM,France,FRA,0,0,13,0,13
2017,Sudan,SDN,France,FRA,500,550,1354,15,2419
2017,Suriname,SUR,France,FRA,0,0,5,0,5
2017,Syrian Arab Rep.,SYR,France,FRA,438,26,419,5,888
2017,United Rep. of Tanzania,TZA,France,FRA,0,0,5,0,5
2017,Thailand,THA,France,FRA,0,0,5,0,5
2017,Tajikistan,TJK,France,FRA,0,0,10,0,10
2017,Togo,TGO,France,FRA,23,5,85,5,118
2017,Tunisia,TUN,France,FRA,5,5,73,0,83
2017,Turkey,TUR,France,FRA,198,18,571,5,792
2017,Uganda,UGA,France,FRA,5,0,5,0,10
2017,Ukraine,UKR,France,FRA,70,30,413,5,518
2017,Uzbekistan,UZB,France,FRA,0,0,10,0,10
2017,Venezuela (Bolivarian Republic of),VEN,France,FRA,0,0,25,5,30
2017,Western Sahara,ESH,France,FRA,28,5,207,0,240
2017,Yemen,YEM,France,FRA,0,5,5,0,10
2017,Zimbabwe,ZWE,France,FRA,5,0,5,0,10
2017,Afghanistan,AFG,Greece,GRC,11,13,75,11,110
2017,Albania,ALB,Greece,GRC,0,0,481,45,526
2017,Algeria,DZA,Greece,GRC,0,0,244,59,303
2017,Egypt,EGY,Greece,GRC,0,0,107,16,123
2017,Armenia,ARM,Greece,GRC,0,0,16,5,21
2017,Bangladesh,BGD,Greece,GRC,0,0,376,39,415
2017,Burkina Faso,BFA,Greece,GRC,0,0,5,0,5
2017,Central African Rep.,CAF,Greece,GRC,0,0,63,0,63
2017,China,CHN,Greece,GRC,0,0,12,5,17
2017,Cameroon,CMR,Greece,GRC,5,5,0,13,23
2017,Congo,COG,Greece,GRC,0,0,5,0,5
2017,Dem. Rep. of the Congo,COD,Greece,GRC,5,5,34,0,44
2017,Dominican Rep.,DOM,Greece,GRC,0,0,10,5,15
2017,Eritrea,ERI,Greece,GRC,0,0,5,0,5
2017,Ethiopia,ETH,Greece,GRC,0,0,5,0,5
2017,Gambia,GMB,Greece,GRC,0,0,11,0,11
2017,Palestinian,PSE,Greece,GRC,5,0,0,0,5
2017,Georgia,GEO,Greece,GRC,0,0,183,23,206
2017,Ghana,GHA,Greece,GRC,5,0,29,5,39
2017,Guinea,GIN,Greece,GRC,0,0,15,0,15
2017,Haiti,HTI,Greece,GRC,0,0,10,0,10
2017,Cote d'Ivoire,CIV,Greece,GRC,0,0,11,0,11
2017,India,IND,Greece,GRC,0,0,22,0,22
2017,Iran (Islamic Rep. of),IRN,Greece,GRC,5,5,55,11,76
2017,Iraq,IRQ,Greece,GRC,5,5,38,19,67
2017,Lebanon,LBN,Greece,GRC,0,0,22,0,22
2017,Rep. of Moldova,MDA,Greece,GRC,0,0,10,5,15
2017,Mali,MLI,Greece,GRC,0,5,17,0,22
2017,Morocco,MAR,Greece,GRC,0,0,96,18,114
2017,Nepal,NPL,Greece,GRC,0,0,21,5,26
2017,Niger,NER,Greece,GRC,0,0,10,0,10
2017,Nigeria,NGA,Greece,GRC,5,0,71,19,95
2017,Pakistan,PAK,Greece,GRC,10,0,2062,166,2238
2017,Russian Federation,RUS,Greece,GRC,0,0,5,0,5
2017,Senegal,SEN,Greece,GRC,0,0,22,0,22
2017,Sierra Leone,SLE,Greece,GRC,0,0,10,0,10
2017,Sudan,SDN,Greece,GRC,0,0,5,0,5
2017,Syrian Arab Rep.,SYR,Greece,GRC,5,0,0,172,177
2017,United Rep. of Tanzania,TZA,Greece,GRC,0,0,5,0,5
2017,Tunisia,TUN,Greece,GRC,0,0,11,0,11
2017,Turkey,TUR,Greece,GRC,0,0,10,0,10
2017,Uganda,UGA,Greece,GRC,0,0,5,0,5
2017,Ukraine,UKR,Greece,GRC,0,5,12,5,22
2017,Venezuela (Bolivarian Republic of),VEN,Greece,GRC,0,0,5,0,5
2017,Zimbabwe,ZWE,Greece,GRC,0,0,5,0,5
2017,Unknown ,,Greece,GRC,167,970,2101,2641,5879
2017,Afghanistan,AFG,Iceland,ISL,10,11,0,0,21
2017,Albania,ALB,Iceland,ISL,0,0,59,5,64
2017,Belarus,BLR,Iceland,ISL,0,0,5,0,5
2017,Georgia,GEO,Iceland,ISL,0,0,35,5,40
2017,Ghana,GHA,Iceland,ISL,0,0,50,0,50
2017,Iraq,IRQ,Iceland,ISL,15,0,5,5,25
2017,Israel,ISR,Iceland,ISL,0,0,12,0,12
2017,Kazakhstan,KAZ,Iceland,ISL,0,0,5,0,5
2017,North Macedonia,MKD,Iceland,ISL,0,0,107,11,118
2017,Morocco,MAR,Iceland,ISL,0,0,5,0,5
2017,Nigeria,NGA,Iceland,ISL,5,0,18,0,23
2017,Romania,ROU,Iceland,ISL,0,0,5,0,5
2017,Russian Federation,RUS,Iceland,ISL,0,0,5,0,5
2017,Serbia and Kosovo: S/RES/1244 (1999),SRB,Iceland,ISL,0,0,21,0,21
2017,Syrian Arab Rep.,SYR,Iceland,ISL,5,0,0,0,5
2017,Ukraine,UKR,Iceland,ISL,0,0,10,0,10
2017,Afghanistan,AFG,Ireland,IRL,0,0,5,5,10
2017,Albania,ALB,Ireland,IRL,0,0,26,0,26
2017,Algeria,DZA,Ireland,IRL,0,5,11,5,21
2017,Benin,BEN,Ireland,IRL,0,0,5,0,5
2017,Bangladesh,BGD,Ireland,IRL,0,0,10,0,10
2017,China,CHN,Ireland,IRL,0,0,5,0,5
2017,Cameroon,CMR,Ireland,IRL,0,0,5,0,5
2017,Dem. Rep. of the Congo,COD,Ireland,IRL,0,0,10,5,15
2017,Cote d'Ivoire,CIV,Ireland,IRL,0,0,5,0,5
2017,India,IND,Ireland,IRL,0,0,0,5,5
2017,Kuwait,KWT,Ireland,IRL,0,0,0,5,5
2017,Lesotho,LSO,Ireland,IRL,0,0,5,0,5
2017,Malawi,MWI,Ireland,IRL,5,5,23,5,38
2017,Mauritius,MUS,Ireland,IRL,0,0,5,0,5
2017,Nigeria,NGA,Ireland,IRL,0,5,55,14,74
2017,Pakistan,PAK,Ireland,IRL,0,10,33,17,60
2017,South Africa,ZAF,Ireland,IRL,0,0,13,5,18
2017,Russian Federation,RUS,Ireland,IRL,0,5,0,0,5
2017,Rwanda,RWA,Ireland,IRL,0,5,0,0,5
2017,Viet Nam,VNM,Ireland,IRL,0,0,5,0,5
2017,Togo,TGO,Ireland,IRL,0,0,5,0,5
2017,Ukraine,UKR,Ireland,IRL,0,0,5,0,5
2017,Venezuela (Bolivarian Republic of),VEN,Ireland,IRL,0,0,10,0,10
2017,Zimbabwe,ZWE,Ireland,IRL,10,10,31,0,51
2017,Egypt,EGY,Japan,JPN,0,0,0,5,5
2017,Bangladesh,BGD,Japan,JPN,0,0,47,37,84
2017,Cambodia,KHM,Japan,JPN,0,0,10,22,32
2017,China,CHN,Japan,JPN,0,0,10,5,15
2017,Cameroon,CMR,Japan,JPN,0,0,26,0,26
2017,Dem. Rep. of the Congo,COD,Japan,JPN,0,0,10,0,10
2017,Ethiopia,ETH,Japan,JPN,0,0,13,0,13
2017,Ghana,GHA,Japan,JPN,0,0,50,21,71
2017,India,IND,Japan,JPN,0,0,46,46,92
2017,Indonesia,IDN,Japan,JPN,0,0,797,142,939
2017,Iran (Islamic Rep. of),IRN,Japan,JPN,0,0,17,14,31
2017,Sri Lanka,LKA,Japan,JPN,0,0,128,110,238
2017,Myanmar,MMR,Japan,JPN,0,0,146,76,222
2017,Nepal,NPL,Japan,JPN,0,0,412,270,682
2017,Nigeria,NGA,Japan,JPN,0,0,36,31,67
2017,Pakistan,PAK,Japan,JPN,0,0,91,74,165
2017,Peru,PER,Japan,JPN,0,0,10,0,10
2017,Philippines,PHL,Japan,JPN,0,0,276,90,366
2017,Senegal,SEN,Japan,JPN,0,0,0,5,5
2017,Viet Nam,VNM,Japan,JPN,0,0,606,141,747
2017,Thailand,THA,Japan,JPN,0,0,24,18,42
2017,Tunisia,TUN,Japan,JPN,0,0,0,14,14
2017,Turkey,TUR,Japan,JPN,0,0,259,153,412
2017,Uganda,UGA,Japan,JPN,0,0,12,5,17
2017,Unknown ,,Japan,JPN,0,0,60,29,89
2017,Afghanistan,AFG,Kazakhstan,KAZ,0,0,0,80,80
2017,Ukraine,UKR,Kazakhstan,KAZ,0,0,0,18,18
2017,Albania,ALB,Luxembourg,LUX,0,5,90,0,95
2017,Algeria,DZA,Luxembourg,LUX,0,0,5,0,5
2017,Belarus,BLR,Luxembourg,LUX,0,0,5,0,5
2017,Bosnia and Herzegovina,BIH,Luxembourg,LUX,0,0,35,0,35
2017,Guinea,GIN,Luxembourg,LUX,0,0,5,0,5
2017,Cote d'Ivoire,CIV,Luxembourg,LUX,0,0,5,0,5
2017,Iraq,IRQ,Luxembourg,LUX,0,0,20,0,20
2017,North Macedonia,MKD,Luxembourg,LUX,0,0,15,0,15
2017,Montenegro,MNE,Luxembourg,LUX,0,0,15,0,15
2017,Nigeria,NGA,Luxembourg,LUX,0,0,5,0,5
2017,Serbia and Kosovo: S/RES/1244 (1999),SRB,Luxembourg,LUX,0,0,105,0,105
2017,Senegal,SEN,Luxembourg,LUX,0,0,5,0,5
2017,Dem. Rep. of the Congo,COD,Malawi,MWI,5,0,0,0,5
2017,Egypt,EGY,Malta,MLT,0,0,0,5,5
2017,Armenia,ARM,Malta,MLT,0,0,0,5,5
2017,Eritrea,ERI,Malta,MLT,0,0,0,22,22
2017,Ethiopia,ETH,Malta,MLT,0,0,0,18,18
2017,Gambia,GMB,Malta,MLT,0,0,0,5,5
2017,Iraq,IRQ,Malta,MLT,0,0,5,0,5
2017,Liberia,LBR,Malta,MLT,0,0,0,5,5
2017,Libya,LBY,Malta,MLT,0,0,0,10,10
2017,Mali,MLI,Malta,MLT,0,0,0,5,5
2017,Nigeria,NGA,Malta,MLT,0,0,5,5,10
2017,Pakistan,PAK,Malta,MLT,0,0,0,5,5
2017,Senegal,SEN,Malta,MLT,0,0,0,5,5
2017,Somalia,SOM,Malta,MLT,0,0,0,48,48
2017,Sudan,SDN,Malta,MLT,0,0,0,10,10
2017,Syrian Arab Rep.,SYR,Malta,MLT,0,0,0,74,74
2017,Tunisia,TUN,Malta,MLT,0,0,0,5,5
2017,Central African Rep.,CAF,Niger,NER,0,0,0,10,10
2017,Cote d'Ivoire,CIV,Niger,NER,0,0,0,5,5
2017,Afghanistan,AFG,Norway,NOR,66,13,2061,34,2174
2017,Albania,ALB,Norway,NOR,5,0,43,0,48
2017,Algeria,DZA,Norway,NOR,0,0,17,0,17
2017,Angola,AGO,Norway,NOR,0,0,12,0,12
2017,Egypt,EGY,Norway,NOR,0,0,20,0,20
2017,Armenia,ARM,Norway,NOR,0,0,5,5,10
2017,Azerbaijan,AZE,Norway,NOR,0,0,10,0,10
2017,Burundi,BDI,Norway,NOR,0,0,10,0,10
2017,Bangladesh,BGD,Norway,NOR,0,0,30,0,30
2017,Belarus,BLR,Norway,NOR,0,0,5,0,5
2017,Brazil,BRA,Norway,NOR,0,0,5,0,5
2017,Bosnia and Herzegovina,BIH,Norway,NOR,0,0,5,0,5
2017,China,CHN,Norway,NOR,0,0,17,0,17
2017,Dem. Rep. of the Congo,COD,Norway,NOR,0,0,14,0,14
2017,Colombia,COL,Norway,NOR,0,5,5,5,15
2017,Djibouti,DJI,Norway,NOR,0,0,5,0,5
2017,Eritrea,ERI,Norway,NOR,5,0,251,5,261
2017,Ethiopia,ETH,Norway,NOR,10,0,373,5,388
2017,Gambia,GMB,Norway,NOR,0,0,10,0,10
2017,United Kingdom of Great Britain and Northern Ireland,GBR,Norway,NOR,0,0,5,0,5
2017,Georgia,GEO,Norway,NOR,0,0,13,0,13
2017,Germany,DEU,Norway,NOR,0,0,5,0,5
2017,Ghana,GHA,Norway,NOR,0,0,5,0,5
2017,Guinea,GIN,Norway,NOR,0,0,13,0,13
2017,Cote d'Ivoire,CIV,Norway,NOR,0,0,17,0,17
2017,India,IND,Norway,NOR,0,0,5,0,5
2017,Iran (Islamic Rep. of),IRN,Norway,NOR,26,0,333,18,377
2017,Iraq,IRQ,Norway,NOR,17,51,743,79,890
2017,Jordan,JOR,Norway,NOR,0,0,5,0,5
2017,Kazakhstan,KAZ,Norway,NOR,0,0,5,0,5
2017,Kenya,KEN,Norway,NOR,0,0,5,0,5
2017,Kyrgyzstan,KGZ,Norway,NOR,0,0,5,0,5
2017,Rep. of Korea,KOR,Norway,NOR,0,0,10,0,10
2017,Liberia,LBR,Norway,NOR,0,0,5,0,5
2017,Libya,LBY,Norway,NOR,0,0,19,0,19
2017,Lebanon,LBN,Norway,NOR,0,0,25,0,25
2017,Sri Lanka,LKA,Norway,NOR,0,0,18,0,18
2017,Mexico,MEX,Norway,NOR,0,0,5,0,5
2017,Morocco,MAR,Norway,NOR,0,0,49,0,49
2017,Myanmar,MMR,Norway,NOR,0,0,5,0,5
2017,Nigeria,NGA,Norway,NOR,0,0,54,5,59
2017,Pakistan,PAK,Norway,NOR,0,0,61,0,61
2017,Peru,PER,Norway,NOR,0,0,5,0,5
2017,Philippines,PHL,Norway,NOR,0,0,5,0,5
2017,Romania,ROU,Norway,NOR,0,0,5,0,5
2017,Russian Federation,RUS,Norway,NOR,5,0,74,10,89
2017,Rwanda,RWA,Norway,NOR,0,0,5,0,5
2017,El Salvador,SLV,Norway,NOR,0,0,12,0,12
2017,Saudi Arabia,SAU,Norway,NOR,0,0,5,0,5
2017,Serbia and Kosovo: S/RES/1244 (1999),SRB,Norway,NOR,0,0,22,0,22
2017,Senegal,SEN,Norway,NOR,0,0,5,0,5
2017,Sierra Leone,SLE,Norway,NOR,0,0,5,0,5
2017,Somalia,SOM,Norway,NOR,0,0,322,5,327
2017,Viet Nam,VNM,Norway,NOR,0,0,5,0,5
2017,Sudan,SDN,Norway,NOR,0,0,49,0,49
2017,Slovakia,SVK,Norway,NOR,0,0,10,0,10
2017,Syrian Arab Rep.,SYR,Norway,NOR,0,0,96,26,122
2017,Tajikistan,TJK,Norway,NOR,0,0,5,0,5
2017,Tunisia,TUN,Norway,NOR,0,0,5,0,5
2017,Turkey,TUR,Norway,NOR,0,0,27,5,32
2017,Uganda,UGA,Norway,NOR,0,0,10,0,10
2017,Ukraine,UKR,Norway,NOR,0,0,26,5,31
2017,United States of America,USA,Norway,NOR,0,0,5,0,5
2017,Uzbekistan,UZB,Norway,NOR,5,0,23,0,28
2017,Venezuela (Bolivarian Republic of),VEN,Norway,NOR,0,0,10,0,10
2017,Yemen,YEM,Norway,NOR,0,5,5,0,10
2017,Zambia,ZMB,Norway,NOR,0,0,5,0,5
2017,Zimbabwe,ZWE,Norway,NOR,0,0,5,0,5
2017,Stateless,XXA,Norway,NOR,5,0,110,5,120
2017,Unknown ,,Norway,NOR,0,0,10,0,10
2017,Unknown ,,New Zealand,NZL,55,0,103,30,188
2017,Afghanistan,AFG,Poland,POL,0,0,5,0,5
2017,Algeria,DZA,Poland,POL,0,0,5,0,5
2017,Armenia,ARM,Poland,POL,0,0,39,0,39
2017,Bangladesh,BGD,Poland,POL,0,0,5,0,5
2017,Belarus,BLR,Poland,POL,0,0,10,0,10
2017,Bulgaria,BGR,Poland,POL,0,0,5,0,5
2017,Georgia,GEO,Poland,POL,0,0,73,0,73
2017,India,IND,Poland,POL,0,0,5,0,5
2017,Iran (Islamic Rep. of),IRN,Poland,POL,0,0,5,0,5
2017,Kyrgyzstan,KGZ,Poland,POL,0,5,25,0,30
2017,Rep. of Moldova,MDA,Poland,POL,0,0,5,0,5
2017,Nigeria,NGA,Poland,POL,0,0,5,0,5
2017,Pakistan,PAK,Poland,POL,0,0,5,0,5
2017,Russian Federation,RUS,Poland,POL,0,0,1268,0,1268
2017,Viet Nam,VNM,Poland,POL,0,0,15,0,15
2017,Syrian Arab Rep.,SYR,Poland,POL,0,0,5,0,5
2017,Tajikistan,TJK,Poland,POL,0,0,107,0,107
2017,Ukraine,UKR,Poland,POL,0,22,489,0,511
2017,Uzbekistan,UZB,Poland,POL,0,0,12,0,12
2017,Stateless,XXA,Poland,POL,0,0,5,0,5
2017,Algeria,DZA,South Africa,ZAF,0,0,0,61,61
2017,Egypt,EGY,South Africa,ZAF,0,0,0,155,155
2017,Burundi,BDI,South Africa,ZAF,0,0,0,208,208
2017,Benin,BEN,South Africa,ZAF,0,0,0,25,25
2017,Bangladesh,BGD,South Africa,ZAF,0,0,45,1684,1729
2017,Burkina Faso,BFA,South Africa,ZAF,0,0,0,5,5
2017,Botswana,BWA,South Africa,ZAF,0,0,0,5,5
2017,China,CHN,South Africa,ZAF,0,0,0,88,88
2017,Cameroon,CMR,South Africa,ZAF,0,0,5,424,429
2017,Congo,COG,South Africa,ZAF,0,0,0,146,146
2017,Dem. Rep. of the Congo,COD,South Africa,ZAF,10,0,75,1947,2032
2017,Comoros,COM,South Africa,ZAF,0,0,0,5,5
2017,Eritrea,ERI,South Africa,ZAF,0,0,0,43,43
2017,Estonia,EST,South Africa,ZAF,0,0,0,5,5
2017,Ethiopia,ETH,South Africa,ZAF,5,0,135,2247,2387
2017,Gabon,GAB,South Africa,ZAF,0,0,0,5,5
2017,Gambia,GMB,South Africa,ZAF,0,0,0,10,10
2017,Palestinian,PSE,South Africa,ZAF,0,0,0,39,39
2017,Ghana,GHA,South Africa,ZAF,0,0,0,1906,1906
2017,Guinea-Bissau,GNB,South Africa,ZAF,0,0,0,10,10
2017,Guinea,GIN,South Africa,ZAF,0,0,0,5,5
2017,Cote d'Ivoire,CIV,South Africa,ZAF,0,0,0,21,21
2017,India,IND,South Africa,ZAF,0,0,82,515,597
2017,Kenya,KEN,South Africa,ZAF,0,0,0,132,132
2017,Liberia,LBR,South Africa,ZAF,0,0,0,15,15
2017,Lesotho,LSO,South Africa,ZAF,0,0,0,96,96
2017,Sri Lanka,LKA,South Africa,ZAF,0,0,0,5,5
2017,Mali,MLI,South Africa,ZAF,0,0,0,10,10
2017,Malawi,MWI,South Africa,ZAF,0,0,0,2638,2638
2017,Mozambique,MOZ,South Africa,ZAF,0,0,0,1011,1011
2017,Nepal,NPL,South Africa,ZAF,0,0,0,34,34
2017,Niger,NER,South Africa,ZAF,0,0,0,11,11
2017,Nigeria,NGA,South Africa,ZAF,0,0,5,4311,4316
2017,Pakistan,PAK,South Africa,ZAF,0,0,60,590,650
2017,Rwanda,RWA,South Africa,ZAF,0,0,0,23,23
2017,Senegal,SEN,South Africa,ZAF,0,0,0,180,180
2017,Sierra Leone,SLE,South Africa,ZAF,0,0,0,5,5
2017,Somalia,SOM,South Africa,ZAF,0,0,5,142,147
2017,Sudan,SDN,South Africa,ZAF,0,0,0,5,5
2017,Eswatini,SWZ,South Africa,ZAF,0,0,0,13,13
2017,Switzerland,CHE,South Africa,ZAF,0,0,0,10,10
2017,United Rep. of Tanzania,TZA,South Africa,ZAF,0,0,0,265,265
2017,Thailand,THA,South Africa,ZAF,0,0,0,36,36
2017,Togo,TGO,South Africa,ZAF,0,0,0,5,5
2017,Uganda,UGA,South Africa,ZAF,0,0,0,916,916
2017,Zambia,ZMB,South Africa,ZAF,0,0,0,98,98
2017,Zimbabwe,ZWE,South Africa,ZAF,0,0,33,17963,17996
2017,Stateless,XXA,South Africa,ZAF,0,0,0,41,41
2017,Afghanistan,AFG,Sweden,SWE,290,365,4814,929,6398
2017,Albania,ALB,Sweden,SWE,5,5,367,28,405
2017,Algeria,DZA,Sweden,SWE,0,0,76,10,86
2017,Angola,AGO,Sweden,SWE,0,0,10,0,10
2017,Egypt,EGY,Sweden,SWE,10,5,165,26,206
2017,Argentina,ARG,Sweden,SWE,0,0,5,0,5
2017,Armenia,ARM,Sweden,SWE,0,5,233,21,259
2017,Azerbaijan,AZE,Sweden,SWE,5,0,147,10,162
2017,Burundi,BDI,Sweden,SWE,5,0,15,5,25
2017,Bangladesh,BGD,Sweden,SWE,0,0,105,14,119
2017,Belarus,BLR,Sweden,SWE,0,0,88,10,98
2017,Bolivia (Plurinational State of),BOL,Sweden,SWE,0,0,22,0,22
2017,Brazil,BRA,Sweden,SWE,0,0,10,0,10
2017,Bosnia and Herzegovina,BIH,Sweden,SWE,0,0,95,12,107
2017,Chad,TCD,Sweden,SWE,0,0,5,0,5
2017,China,CHN,Sweden,SWE,5,0,27,5,37
2017,Chile,CHL,Sweden,SWE,0,0,17,0,17
2017,Cameroon,CMR,Sweden,SWE,0,0,26,0,26
2017,Congo,COG,Sweden,SWE,0,0,12,0,12
2017,Dem. Rep. of the Congo,COD,Sweden,SWE,0,0,18,5,23
2017,Colombia,COL,Sweden,SWE,0,0,80,5,85
2017,Cuba,CUB,Sweden,SWE,0,0,21,0,21
2017,Djibouti,DJI,Sweden,SWE,0,0,26,5,31
2017,Ecuador,ECU,Sweden,SWE,0,0,5,0,5
2017,Eritrea,ERI,Sweden,SWE,13,0,128,136,277
2017,Estonia,EST,Sweden,SWE,0,0,5,0,5
2017,Ethiopia,ETH,Sweden,SWE,37,0,291,45,373
2017,Gambia,GMB,Sweden,SWE,0,0,65,5,70
2017,Palestinian,PSE,Sweden,SWE,5,0,183,41,229
2017,Georgia,GEO,Sweden,SWE,0,0,558,76,634
2017,Ghana,GHA,Sweden,SWE,0,0,25,5,30
2017,Guinea,GIN,Sweden,SWE,0,0,13,0,13
2017,Honduras,HND,Sweden,SWE,0,0,12,5,17
2017,Croatia,HRV,Sweden,SWE,0,0,5,0,5
2017,Hungary,HUN,Sweden,SWE,0,0,5,0,5
2017,Cote d'Ivoire,CIV,Sweden,SWE,0,0,13,0,13
2017,India,IND,Sweden,SWE,0,0,39,10,49
2017,Iran (Islamic Rep. of),IRN,Sweden,SWE,77,5,331,75,488
2017,Iraq,IRQ,Sweden,SWE,217,186,2402,539,3344
2017,Israel,ISR,Sweden,SWE,0,0,16,0,16
2017,Jamaica,JAM,Sweden,SWE,0,0,5,0,5
2017,Jordan,JOR,Sweden,SWE,0,5,152,14,171
2017,Japan,JPN,Sweden,SWE,0,0,5,0,5
2017,Kazakhstan,KAZ,Sweden,SWE,0,0,167,14,181
2017,Kenya,KEN,Sweden,SWE,0,0,35,0,35
2017,Kyrgyzstan,KGZ,Sweden,SWE,5,5,102,18,130
2017,Kuwait,KWT,Sweden,SWE,0,0,14,0,14
2017,Libya,LBY,Sweden,SWE,5,0,84,10,99
2017,Lebanon,LBN,Sweden,SWE,0,0,215,32,247
2017,Sri Lanka,LKA,Sweden,SWE,0,0,20,5,25
2017,North Macedonia,MKD,Sweden,SWE,0,0,55,10,65
2017,Rep. of Moldova,MDA,Sweden,SWE,0,0,14,10,24
2017,Mexico,MEX,Sweden,SWE,0,0,5,0,5
2017,Mali,MLI,Sweden,SWE,0,0,5,0,5
2017,Mongolia,MNG,Sweden,SWE,0,0,677,45,722
2017,Morocco,MAR,Sweden,SWE,5,0,205,17,227
2017,Montenegro,MNE,Sweden,SWE,0,0,19,5,24
2017,Nepal,NPL,Sweden,SWE,0,0,25,0,25
2017,Nicaragua,NIC,Sweden,SWE,0,0,39,5,44
2017,Nigeria,NGA,Sweden,SWE,5,0,183,10,198
2017,Pakistan,PAK,Sweden,SWE,15,0,193,18,226
2017,Peru,PER,Sweden,SWE,0,0,17,0,17
2017,Philippines,PHL,Sweden,SWE,0,0,21,0,21
2017,Romania,ROU,Sweden,SWE,0,0,0,5,5
2017,Russian Federation,RUS,Sweden,SWE,10,5,279,19,313
2017,Rwanda,RWA,Sweden,SWE,0,0,5,0,5
2017,El Salvador,SLV,Sweden,SWE,0,0,174,10,184
2017,Serbia and Kosovo: S/RES/1244 (1999),SRB,Sweden,SWE,0,0,378,41,419
2017,Senegal,SEN,Sweden,SWE,0,0,18,0,18
2017,Sierra Leone,SLE,Sweden,SWE,0,0,10,0,10
2017,Somalia,SOM,Sweden,SWE,38,14,749,124,925
2017,Viet Nam,VNM,Sweden,SWE,0,0,21,0,21
2017,Sudan,SDN,Sweden,SWE,19,0,64,14,97
2017,Slovakia,SVK,Sweden,SWE,0,0,5,0,5
2017,Syrian Arab Rep.,SYR,Sweden,SWE,5,17,551,1432,2005
2017,United Rep. of Tanzania,TZA,Sweden,SWE,0,0,34,5,39
2017,Thailand,THA,Sweden,SWE,0,0,10,0,10
2017,Tajikistan,TJK,Sweden,SWE,0,0,19,5,24
2017,Tunisia,TUN,Sweden,SWE,5,0,53,10,68
2017,Turkey,TUR,Sweden,SWE,0,0,144,27,171
2017,United Arab Emirates,ARE,Sweden,SWE,0,0,5,0,5
2017,Uganda,UGA,Sweden,SWE,0,0,14,5,19
2017,Ukraine,UKR,Sweden,SWE,10,5,675,57,747
2017,Uruguay,URY,Sweden,SWE,0,0,5,0,5
2017,United States of America,USA,Sweden,SWE,0,0,5,0,5
2017,Uzbekistan,UZB,Sweden,SWE,5,0,158,20,183
2017,Venezuela (Bolivarian Republic of),VEN,Sweden,SWE,0,0,61,17,78
2017,Yemen,YEM,Sweden,SWE,0,0,12,30,42
2017,Zimbabwe,ZWE,Sweden,SWE,0,0,5,0,5
2017,Stateless,XXA,Sweden,SWE,45,5,353,131,534
2017,Unknown ,,Sweden,SWE,10,5,223,46,284
2017,Afghanistan,AFG,United States of America,USA,5,0,0,5,10
2017,Albania,ALB,United States of America,USA,38,0,0,19,57
2017,Angola,AGO,United States of America,USA,5,0,0,0,5
2017,Egypt,EGY,United States of America,USA,104,0,5,58,167
2017,Armenia,ARM,United States of America,USA,15,0,5,18,38
2017,Azerbaijan,AZE,United States of America,USA,5,0,0,0,5
2017,Burundi,BDI,United States of America,USA,17,0,5,19,41
2017,Bangladesh,BGD,United States of America,USA,69,0,10,71,150
2017,Burkina Faso,BFA,United States of America,USA,57,0,5,28,90
2017,Belarus,BLR,United States of America,USA,21,0,0,5,26
2017,Bolivia (Plurinational State of),BOL,United States of America,USA,0,0,0,5,5
2017,Brazil,BRA,United States of America,USA,5,0,0,61,66
2017,Central African Rep.,CAF,United States of America,USA,5,0,0,0,5
2017,Chad,TCD,United States of America,USA,5,0,0,0,5
2017,China,CHN,United States of America,USA,1855,0,400,1309,3564
2017,Cameroon,CMR,United States of America,USA,39,0,5,21,65
2017,Congo,COG,United States of America,USA,19,0,0,10,29
2017,Dem. Rep. of the Congo,COD,United States of America,USA,12,0,0,0,12
2017,Colombia,COL,United States of America,USA,28,0,10,69,107
2017,Costa Rica,CRI,United States of America,USA,0,0,0,5,5
2017,Djibouti,DJI,United States of America,USA,5,0,0,0,5
2017,Dominican Rep.,DOM,United States of America,USA,0,0,0,10,10
2017,Ecuador,ECU,United States of America,USA,5,0,0,337,342
2017,Eritrea,ERI,United States of America,USA,10,0,0,12,22
2017,Ethiopia,ETH,United States of America,USA,98,0,5,27,130
2017,Gambia,GMB,United States of America,USA,18,0,0,23,41
2017,Palestinian,PSE,United States of America,USA,0,0,0,5,5
2017,United Kingdom of Great Britain and Northern Ireland,GBR,United States of America,USA,0,0,5,0,5
2017,Georgia,GEO,United States of America,USA,5,0,0,0,5
2017,Ghana,GHA,United States of America,USA,0,0,0,5,5
2017,Guatemala,GTM,United States of America,USA,5,0,36,418,459
2017,Guinea,GIN,United States of America,USA,14,0,5,23,42
2017,Guyana,GUY,United States of America,USA,0,0,0,5,5
2017,Haiti,HTI,United States of America,USA,5,0,40,103,148
2017,Honduras,HND,United States of America,USA,12,0,13,108,133
2017,Cote d'Ivoire,CIV,United States of America,USA,14,0,11,21,46
2017,India,IND,United States of America,USA,111,0,25,148,284
2017,Indonesia,IDN,United States of America,USA,10,0,10,31,51
2017,Iran (Islamic Rep. of),IRN,United States of America,USA,44,0,0,38,82
2017,Iraq,IRQ,United States of America,USA,41,0,18,67,126
2017,Jamaica,JAM,United States of America,USA,0,0,0,10,10
2017,Jordan,JOR,United States of America,USA,0,0,0,5,5
2017,Kazakhstan,KAZ,United States of America,USA,27,0,5,19,51
2017,Kenya,KEN,United States of America,USA,14,0,0,20,34
2017,Kyrgyzstan,KGZ,United States of America,USA,33,0,10,23,66
2017,Rep. of Korea,KOR,United States of America,USA,0,0,0,5,5
2017,Liberia,LBR,United States of America,USA,5,0,0,10,15
2017,Libya,LBY,United States of America,USA,5,0,0,11,16
2017,Lebanon,LBN,United States of America,USA,5,0,0,10,15
2017,Sri Lanka,LKA,United States of America,USA,31,0,0,34,65
2017,Mauritania,MRT,United States of America,USA,17,0,5,12,34
2017,Rep. of Moldova,MDA,United States of America,USA,34,0,5,36,75
2017,Mexico,MEX,United States of America,USA,17,0,47,2498,2562
2017,Marshall Islands,MHL,United States of America,USA,5,0,0,0,5
2017,Mali,MLI,United States of America,USA,28,0,0,39,67
2017,Malawi,MWI,United States of America,USA,0,0,0,5,5
2017,Mongolia,MNG,United States of America,USA,10,0,5,37,52
2017,Myanmar,MMR,United States of America,USA,5,0,0,5,10
2017,Nepal,NPL,United States of America,USA,159,0,28,143,330
2017,Nicaragua,NIC,United States of America,USA,0,0,0,10,10
2017,Nigeria,NGA,United States of America,USA,14,0,10,19,43
2017,Niue,NIU,United States of America,USA,0,0,0,5,5
2017,Pakistan,PAK,United States of America,USA,49,0,5,81,135
2017,Peru,PER,United States of America,USA,5,0,0,42,47
2017,Philippines,PHL,United States of America,USA,0,0,0,41,41
2017,Poland,POL,United States of America,USA,0,0,0,12,12
2017,Romania,ROU,United States of America,USA,0,0,0,13,13
2017,Russian Federation,RUS,United States of America,USA,51,0,10,53,114
2017,Rwanda,RWA,United States of America,USA,16,0,0,10,26
2017,El Salvador,SLV,United States of America,USA,17,0,25,278,320
2017,Saudi Arabia,SAU,United States of America,USA,0,0,0,5,5
2017,Serbia and Kosovo: S/RES/1244 (1999),SRB,United States of America,USA,17,0,0,5,22
2017,Senegal,SEN,United States of America,USA,5,0,0,16,21
2017,Sierra Leone,SLE,United States of America,USA,10,0,0,11,21
2017,Somalia,SOM,United States of America,USA,5,0,0,5,10
2017,Viet Nam,VNM,United States of America,USA,0,0,5,0,5
2017,Sudan,SDN,United States of America,USA,11,0,0,10,21
2017,Syrian Arab Rep.,SYR,United States of America,USA,61,0,5,43,109
2017,Tajikistan,TJK,United States of America,USA,10,0,5,0,15
2017,Turkmenistan,TKM,United States of America,USA,5,0,0,0,5
2017,Togo,TGO,United States of America,USA,5,0,0,10,15
2017,Trinidad and Tobago,TTO,United States of America,USA,0,0,0,5,5
2017,Uganda,UGA,United States of America,USA,10,0,0,5,15
2017,Ukraine,UKR,United States of America,USA,35,0,10,53,98
2017,Uzbekistan,UZB,United States of America,USA,23,0,0,22,45
2017,Venezuela (Bolivarian Republic of),VEN,United States of America,USA,27,0,10,35,72
2017,Yemen,YEM,United States of America,USA,0,0,0,5,5
2017,Zimbabwe,ZWE,United States of America,USA,0,0,5,10,15
2017,Unknown ,,United States of America,USA,204,0,97,350,651
2018,Armenia,ARM,Argentina,ARG,0,0,5,0,5
2018,Bangladesh,BGD,Argentina,ARG,0,0,10,0,10
2018,China,CHN,Argentina,ARG,0,0,0,5,5
2018,Cameroon,CMR,Argentina,ARG,0,0,5,0,5
2018,Colombia,COL,Argentina,ARG,0,0,5,0,5
2018,Cuba,CUB,Argentina,ARG,0,0,80,0,80
2018,Dominican Rep.,DOM,Argentina,ARG,0,0,48,5,53
2018,Ghana,GHA,Argentina,ARG,0,0,31,0,31
2018,Haiti,HTI,Argentina,ARG,0,0,125,14,139
2018,India,IND,Argentina,ARG,0,0,29,5,34
2018,Nigeria,NGA,Argentina,ARG,0,0,5,0,5
2018,Russian Federation,RUS,Argentina,ARG,0,0,5,0,5
2018,Senegal,SEN,Argentina,ARG,0,0,295,0,295
2018,Ukraine,UKR,Argentina,ARG,0,0,5,0,5
2018,Iran (Islamic Rep. of),IRN,Armenia,ARM,5,0,10,5,20
2018,Iraq,IRQ,Armenia,ARM,5,0,0,0,5
2018,Afghanistan,AFG,Australia,AUS,35,0,188,5,228
2018,Albania,ALB,Australia,AUS,5,0,5,5,15
2018,Egypt,EGY,Australia,AUS,5,0,17,5,27
2018,Bangladesh,BGD,Australia,AUS,18,0,153,27,198
2018,Brazil,BRA,Australia,AUS,0,0,5,0,5
2018,Cambodia,KHM,Australia,AUS,5,0,0,0,5
2018,China,CHN,Australia,AUS,40,0,424,210,674
2018,Dem. Rep. of the Congo,COD,Australia,AUS,5,0,0,0,5
2018,Colombia,COL,Australia,AUS,5,0,14,0,19
2018,Ethiopia,ETH,Australia,AUS,0,0,5,0,5
2018,Fiji,FJI,Australia,AUS,5,0,117,24,146
2018,Palestinian,PSE,Australia,AUS,0,0,5,0,5
2018,United Kingdom of Great Britain and Northern Ireland,GBR,Australia,AUS,0,0,5,5,10
2018,Germany,DEU,Australia,AUS,0,0,5,0,5
2018,Ghana,GHA,Australia,AUS,0,0,5,5,10
2018,India,IND,Australia,AUS,29,0,173,48,250
2018,Indonesia,IDN,Australia,AUS,10,0,36,38,84
2018,Iran (Islamic Rep. of),IRN,Australia,AUS,150,0,735,48,933
2018,Iraq,IRQ,Australia,AUS,84,0,164,47,295
2018,Israel,ISR,Australia,AUS,0,0,5,0,5
2018,Jordan,JOR,Australia,AUS,0,0,10,0,10
2018,Kenya,KEN,Australia,AUS,0,0,5,0,5
2018,Rep. of Korea,KOR,Australia,AUS,0,0,34,0,34
2018,Dem. People's Rep. of Korea,PRK,Australia,AUS,0,0,5,0,5
2018,Libya,LBY,Australia,AUS,31,0,0,0,31
2018,Lebanon,LBN,Australia,AUS,5,0,126,5,136
2018,Sri Lanka,LKA,Australia,AUS,60,0,1059,24,1143
2018,Malaysia,MYS,Australia,AUS,89,0,1318,1282,2689
2018,Malawi,MWI,Australia,AUS,0,0,5,0,5
2018,Mongolia,MNG,Australia,AUS,0,0,15,5,20
2018,Mauritius,MUS,Australia,AUS,0,0,5,0,5
2018,Myanmar,MMR,Australia,AUS,17,0,23,5,45
2018,Nepal,NPL,Australia,AUS,5,0,38,13,56
2018,Nigeria,NGA,Australia,AUS,5,0,10,5,20
2018,Pakistan,PAK,Australia,AUS,37,0,168,45,250
2018,Philippines,PHL,Australia,AUS,0,0,5,10,15
2018,Papua New Guinea,PNG,Australia,AUS,12,0,16,0,28
2018,South Africa,ZAF,Australia,AUS,0,0,5,10,15
2018,Russian Federation,RUS,Australia,AUS,5,0,5,0,10
2018,Rwanda,RWA,Australia,AUS,0,0,5,0,5
2018,Solomon Islands,SLB,Australia,AUS,0,0,5,0,5
2018,Somalia,SOM,Australia,AUS,10,0,0,0,10
2018,Viet Nam,VNM,Australia,AUS,10,0,219,125,354
2018,Sudan,SDN,Australia,AUS,5,0,10,0,15
2018,Thailand,THA,Australia,AUS,0,0,5,21,26
2018,Turkey,TUR,Australia,AUS,5,0,17,0,22
2018,Ukraine,UKR,Australia,AUS,5,0,5,0,10
2018,United States of America,USA,Australia,AUS,0,0,5,0,5
2018,Zambia,ZMB,Australia,AUS,0,0,5,0,5
2018,Zimbabwe,ZWE,Australia,AUS,11,0,0,0,11
2018,Stateless,XXA,Australia,AUS,28,0,11,5,44
2018,Unknown ,,Australia,AUS,0,0,42,22,64
2018,Dem. Rep. of the Congo,COD,Burundi,BDI,127,0,179,37,343
2018,Rwanda,RWA,Burundi,BDI,0,0,10,10,20
2018,Afghanistan,AFG,Canada,CAN,10,0,22,0,32
2018,Albania,ALB,Canada,CAN,14,0,35,5,54
2018,Algeria,DZA,Canada,CAN,0,0,12,0,12
2018,Angola,AGO,Canada,CAN,0,0,5,0,5
2018,Antigua and Barbuda,ATG,Canada,CAN,0,0,5,0,5
2018,Egypt,EGY,Canada,CAN,10,0,11,0,21
2018,Azerbaijan,AZE,Canada,CAN,10,0,35,5,50
2018,Burundi,BDI,Canada,CAN,14,0,5,0,19
2018,Bangladesh,BGD,Canada,CAN,0,0,34,0,34
2018,Bahamas,BHS,Canada,CAN,0,0,10,0,10
2018,Burkina Faso,BFA,Canada,CAN,0,0,5,0,5
2018,Brazil,BRA,Canada,CAN,5,0,35,0,40
2018,Chad,TCD,Canada,CAN,0,0,24,0,24
2018,China,CHN,Canada,CAN,5,0,243,5,253
2018,Chile,CHL,Canada,CAN,0,0,26,0,26
2018,Cameroon,CMR,Canada,CAN,13,0,51,0,64
2018,Congo,COG,Canada,CAN,5,0,5,0,10
2018,Dem. Rep. of the Congo,COD,Canada,CAN,5,0,64,0,69
2018,Colombia,COL,Canada,CAN,5,0,95,5,105
2018,Costa Rica,CRI,Canada,CAN,0,0,5,0,5
2018,Cuba,CUB,Canada,CAN,0,0,5,0,5
2018,Djibouti,DJI,Canada,CAN,5,0,22,0,27
2018,Dominican Rep.,DOM,Canada,CAN,0,0,5,5,10
2018,Ecuador,ECU,Canada,CAN,0,0,5,0,5
2018,Eritrea,ERI,Canada,CAN,12,0,10,0,22
2018,Ethiopia,ETH,Canada,CAN,5,0,24,0,29
2018,Gambia,GMB,Canada,CAN,0,0,5,0,5
2018,Palestinian,PSE,Canada,CAN,11,0,26,0,37
2018,Georgia,GEO,Canada,CAN,5,0,31,0,36
2018,Ghana,GHA,Canada,CAN,5,0,46,5,56
2018,Guatemala,GTM,Canada,CAN,0,0,15,0,15
2018,Guinea,GIN,Canada,CAN,0,0,11,0,11
2018,Guyana,GUY,Canada,CAN,0,0,16,0,16
2018,Haiti,HTI,Canada,CAN,24,0,534,5,563
2018,Honduras,HND,Canada,CAN,5,0,29,0,34
2018,Croatia,HRV,Canada,CAN,0,0,5,5,10
2018,Hungary,HUN,Canada,CAN,49,0,48,5,102
2018,Cote d'Ivoire,CIV,Canada,CAN,0,0,5,0,5
2018,India,IND,Canada,CAN,16,0,89,5,110
2018,Indonesia,IDN,Canada,CAN,0,0,5,0,5
2018,Iran (Islamic Rep. of),IRN,Canada,CAN,19,0,20,0,39
2018,Iraq,IRQ,Canada,CAN,11,0,61,5,77
2018,Italy,ITA,Canada,CAN,0,0,10,0,10
2018,Jamaica,JAM,Canada,CAN,5,0,23,0,28
2018,Jordan,JOR,Canada,CAN,0,0,13,5,18
2018,Kazakhstan,KAZ,Canada,CAN,0,0,5,0,5
2018,Kenya,KEN,Canada,CAN,5,0,11,0,16
2018,Kyrgyzstan,KGZ,Canada,CAN,0,0,5,0,5
2018,Libya,LBY,Canada,CAN,0,0,5,0,5
2018,Saint Lucia,LCA,Canada,CAN,0,0,5,0,5
2018,Lebanon,LBN,Canada,CAN,11,0,38,0,49
2018,Sri Lanka,LKA,Canada,CAN,0,0,37,0,37
2018,Lithuania,LTU,Canada,CAN,0,0,5,0,5
2018,Latvia,LVA,Canada,CAN,0,0,5,0,5
2018,Mauritania,MRT,Canada,CAN,0,0,5,0,5
2018,Mexico,MEX,Canada,CAN,5,0,85,10,100
2018,Mali,MLI,Canada,CAN,5,0,18,0,23
2018,Montenegro,MNE,Canada,CAN,0,0,5,0,5
2018,Namibia,NAM,Canada,CAN,0,0,5,0,5
2018,Nepal,NPL,Canada,CAN,5,0,16,0,21
2018,Nicaragua,NIC,Canada,CAN,5,0,0,0,5
2018,Nigeria,NGA,Canada,CAN,59,0,632,24,715
2018,Pakistan,PAK,Canada,CAN,5,0,77,11,93
2018,Peru,PER,Canada,CAN,0,0,10,0,10
2018,Philippines,PHL,Canada,CAN,0,0,10,0,10
2018,South Africa,ZAF,Canada,CAN,0,0,15,0,15
2018,Russian Federation,RUS,Canada,CAN,0,0,15,0,15
2018,Rwanda,RWA,Canada,CAN,5,0,14,0,19
2018,El Salvador,SLV,Canada,CAN,0,0,29,5,34
2018,Saudi Arabia,SAU,Canada,CAN,0,0,5,0,5
2018,Serbia and Kosovo: S/RES/1244 (1999),SRB,Canada,CAN,5,0,0,0,5
2018,Senegal,SEN,Canada,CAN,0,0,10,0,10
2018,Sierra Leone,SLE,Canada,CAN,0,0,5,0,5
2018,Somalia,SOM,Canada,CAN,19,0,100,5,124
2018,Spain,ESP,Canada,CAN,0,0,5,0,5
2018,Viet Nam,VNM,Canada,CAN,0,0,5,0,5
2018,Saint Kitts and Nevis,KNA,Canada,CAN,5,0,0,0,5
2018,Sudan,SDN,Canada,CAN,0,0,29,0,29
2018,Slovakia,SVK,Canada,CAN,0,0,5,0,5
2018,Syrian Arab Rep.,SYR,Canada,CAN,5,0,0,0,5
2018,United Rep. of Tanzania,TZA,Canada,CAN,0,0,5,0,5
2018,Togo,TGO,Canada,CAN,0,0,5,0,5
2018,Tunisia,TUN,Canada,CAN,0,0,5,0,5
2018,Turkey,TUR,Canada,CAN,46,0,48,5,99
2018,Uganda,UGA,Canada,CAN,5,0,18,0,23
2018,Ukraine,UKR,Canada,CAN,5,0,15,5,25
2018,United States of America,USA,Canada,CAN,0,0,106,5,111
2018,Uzbekistan,UZB,Canada,CAN,0,0,10,0,10
2018,Saint Vincent and the Grenadines,VCT,Canada,CAN,5,0,10,0,15
2018,Venezuela (Bolivarian Republic of),VEN,Canada,CAN,16,0,41,0,57
2018,Yemen,YEM,Canada,CAN,0,0,5,0,5
2018,Zimbabwe,ZWE,Canada,CAN,0,0,12,0,12
2018,Stateless,XXA,Canada,CAN,0,0,15,0,15
2018,Colombia,COL,Costa Rica,CRI,0,0,275,12,287
2018,Cuba,CUB,Costa Rica,CRI,0,0,13,0,13
2018,France,FRA,Costa Rica,CRI,0,0,5,0,5
2018,Honduras,HND,Costa Rica,CRI,5,0,31,0,36
2018,Nicaragua,NIC,Costa Rica,CRI,0,0,10,0,10
2018,El Salvador,SLV,Costa Rica,CRI,12,0,404,12,428
2018,Viet Nam,VNM,Costa Rica,CRI,0,0,5,0,5
2018,Turkey,TUR,Costa Rica,CRI,0,0,13,0,13
2018,Venezuela (Bolivarian Republic of),VEN,Costa Rica,CRI,0,0,201,0,201
2018,Egypt,EGY,Cyprus,CYP,0,0,5,19,24
2018,Bangladesh,BGD,Cyprus,CYP,0,0,70,21,91
2018,Palestinian,PSE,Cyprus,CYP,0,0,5,0,5
2018,India,IND,Cyprus,CYP,0,0,164,25,189
2018,Iraq,IRQ,Cyprus,CYP,0,5,5,5,15
2018,Sri Lanka,LKA,Cyprus,CYP,0,0,18,5,23
2018,Pakistan,PAK,Cyprus,CYP,0,0,51,19,70
2018,Philippines,PHL,Cyprus,CYP,0,0,13,10,23
2018,Somalia,SOM,Cyprus,CYP,0,0,0,5,5
2018,Viet Nam,VNM,Cyprus,CYP,0,0,115,36,151
2018,Syrian Arab Rep.,SYR,Cyprus,CYP,0,5,5,0,10
2018,Ukraine,UKR,Cyprus,CYP,0,0,0,10,10
2018,Afghanistan,AFG,Denmark,DNK,32,89,380,0,501
2018,Algeria,DZA,Denmark,DNK,0,0,5,0,5
2018,Egypt,EGY,Denmark,DNK,0,0,5,0,5
2018,Armenia,ARM,Denmark,DNK,0,0,16,0,16
2018,Bangladesh,BGD,Denmark,DNK,0,0,10,0,10
2018,China,CHN,Denmark,DNK,5,0,5,0,10
2018,Dem. Rep. of the Congo,COD,Denmark,DNK,0,0,5,0,5
2018,Eritrea,ERI,Denmark,DNK,0,0,5,0,5
2018,Ethiopia,ETH,Denmark,DNK,0,0,12,0,12
2018,Gambia,GMB,Denmark,DNK,0,0,5,0,5
2018,Georgia,GEO,Denmark,DNK,0,0,5,0,5
2018,Iran (Islamic Rep. of),IRN,Denmark,DNK,148,18,460,0,626
2018,Iraq,IRQ,Denmark,DNK,5,11,179,0,195
2018,Libya,LBY,Denmark,DNK,0,0,5,0,5
2018,Lebanon,LBN,Denmark,DNK,0,0,17,0,17
2018,Sri Lanka,LKA,Denmark,DNK,0,0,5,0,5
2018,Morocco,MAR,Denmark,DNK,0,0,5,0,5
2018,Nigeria,NGA,Denmark,DNK,0,0,5,0,5
2018,Pakistan,PAK,Denmark,DNK,0,5,5,0,10
2018,Somalia,SOM,Denmark,DNK,5,5,37,0,47
2018,Syrian Arab Rep.,SYR,Denmark,DNK,0,5,22,0,27
2018,Turkey,TUR,Denmark,DNK,0,0,5,0,5
2018,Uganda,UGA,Denmark,DNK,0,0,10,0,10
2018,Ukraine,UKR,Denmark,DNK,0,0,5,0,5
2018,Stateless,XXA,Denmark,DNK,0,0,244,0,244
2018,Unknown ,,Denmark,DNK,0,0,154,0,154
2018,Afghanistan,AFG,France,FRA,218,353,215,44,830
2018,Albania,ALB,France,FRA,155,398,2762,2718,6033
2018,Algeria,DZA,France,FRA,34,49,239,1296,1618
2018,Angola,AGO,France,FRA,70,29,391,31,521
2018,Egypt,EGY,France,FRA,117,5,150,43,315
2018,Armenia,ARM,France,FRA,43,56,742,596,1437
2018,Azerbaijan,AZE,France,FRA,43,5,135,35,218
2018,Benin,BEN,France,FRA,5,0,22,5,32
2018,Bangladesh,BGD,France,FRA,457,125,1482,771,2835
2018,Bhutan,BTN,France,FRA,10,0,0,0,10
2018,Burkina Faso,BFA,France,FRA,10,5,59,5,79
2018,Belarus,BLR,France,FRA,0,0,5,5,10
2018,Bosnia and Herzegovina,BIH,France,FRA,16,10,130,169,325
2018,Cambodia,KHM,France,FRA,5,0,10,5,20
2018,Central African Rep.,CAF,France,FRA,36,58,137,28,259
2018,Chad,TCD,France,FRA,85,11,148,26,270
2018,China,CHN,France,FRA,43,0,101,1020,1164
2018,Cameroon,CMR,France,FRA,70,15,181,26,292
2018,Congo,COG,France,FRA,111,22,497,59,689
2018,Dem. Rep. of the Congo,COD,France,FRA,426,77,1673,295,2471
2018,Comoros,COM,France,FRA,0,0,61,36,97
2018,Colombia,COL,France,FRA,5,14,29,10,58
2018,Cuba,CUB,France,FRA,0,0,16,5,21
2018,Djibouti,DJI,France,FRA,27,5,13,0,45
2018,Eritrea,ERI,France,FRA,90,0,127,5,222
2018,Ethiopia,ETH,France,FRA,39,5,75,12,131
2018,Gabon,GAB,France,FRA,21,17,98,11,147
2018,Gambia,GMB,France,FRA,11,0,103,15,129
2018,Palestinian,PSE,France,FRA,18,0,14,5,37
2018,Georgia,GEO,France,FRA,31,34,567,619,1251
2018,Guinea-Bissau,GNB,France,FRA,0,5,48,12,65
2018,Guinea,GIN,France,FRA,479,127,1616,148,2370
2018,Haiti,HTI,France,FRA,26,14,486,3657,4183
2018,Cote d'Ivoire,CIV,France,FRA,163,60,1015,135,1373
2018,India,IND,France,FRA,5,5,30,25,65
2018,Iran (Islamic Rep. of),IRN,France,FRA,131,10,59,10,210
2018,Iraq,IRQ,France,FRA,34,45,75,24,178
2018,Kazakhstan,KAZ,France,FRA,13,5,37,19,74
2018,Kenya,KEN,France,FRA,5,5,10,5,25
2018,Kyrgyzstan,KGZ,France,FRA,5,0,5,0,10
2018,Dem. People's Rep. of Korea,PRK,France,FRA,5,0,0,0,5
2018,Liberia,LBR,France,FRA,5,0,17,0,22
2018,Libya,LBY,France,FRA,19,44,45,10,118
2018,Lebanon,LBN,France,FRA,0,0,22,5,27
2018,Sri Lanka,LKA,France,FRA,233,24,510,550,1317
2018,Madagascar,MDG,France,FRA,0,0,52,5,57
2018,Mauritania,MRT,France,FRA,101,5,265,180,551
2018,North Macedonia,MKD,France,FRA,0,0,185,283,468
2018,Mali,MLI,France,FRA,56,11,355,519,941
2018,Mongolia,MNG,France,FRA,10,5,61,30,106
2018,Morocco,MAR,France,FRA,42,13,219,32,306
2018,Montenegro,MNE,France,FRA,0,0,21,58,79
2018,Mauritius,MUS,France,FRA,0,0,5,0,5
2018,Myanmar,MMR,France,FRA,5,0,13,22,40
2018,Nepal,NPL,France,FRA,10,5,53,5,73
2018,Niger,NER,France,FRA,5,0,32,5,42
2018,Nigeria,NGA,France,FRA,239,33,1062,143,1477
2018,Pakistan,PAK,France,FRA,210,41,683,740,1674
2018,Peru,PER,France,FRA,0,5,10,10,25
2018,Russian Federation,RUS,France,FRA,200,48,567,289,1104
2018,Rwanda,RWA,France,FRA,15,0,34,18,67
2018,El Salvador,SLV,France,FRA,0,5,0,5,10
2018,Serbia and Kosovo: S/RES/1244 (1999),SRB,France,FRA,186,155,1117,1119,2577
2018,Senegal,SEN,France,FRA,94,14,458,225,791
2018,Sierra Leone,SLE,France,FRA,24,10,52,5,91
2018,Somalia,SOM,France,FRA,85,235,153,37,510
2018,Viet Nam,VNM,France,FRA,10,0,10,5,25
2018,Sudan,SDN,France,FRA,539,407,682,53,1681
2018,Syrian Arab Rep.,SYR,France,FRA,455,22,274,42,793
2018,Togo,TGO,France,FRA,14,5,70,17,106
2018,Tunisia,TUN,France,FRA,5,0,67,12,84
2018,Turkey,TUR,France,FRA,294,12,476,101,883
2018,Uganda,UGA,France,FRA,5,0,0,0,5
2018,Ukraine,UKR,France,FRA,28,10,191,66,295
2018,Uzbekistan,UZB,France,FRA,0,0,5,5,10
2018,Venezuela (Bolivarian Republic of),VEN,France,FRA,12,10,39,10,71
2018,Western Sahara,ESH,France,FRA,41,5,273,122,441
2018,Yemen,YEM,France,FRA,0,0,5,0,5
2018,Unknown ,,France,FRA,0,0,111,181,292
2018,Afghanistan,AFG,Greece,GRC,21,54,106,52,233
2018,Albania,ALB,Greece,GRC,0,0,1052,36,1088
2018,Algeria,DZA,Greece,GRC,0,0,76,23,99
2018,Egypt,EGY,Greece,GRC,5,0,188,14,207
2018,Armenia,ARM,Greece,GRC,0,0,23,0,23
2018,Bangladesh,BGD,Greece,GRC,0,0,455,16,471
2018,Burkina Faso,BFA,Greece,GRC,0,0,5,0,5
2018,China,CHN,Greece,GRC,0,0,38,5,43
2018,Cameroon,CMR,Greece,GRC,0,0,17,22,39
2018,Congo,COG,Greece,GRC,0,0,5,10,15
2018,Dem. Rep. of the Congo,COD,Greece,GRC,17,10,58,34,119
2018,Dominican Rep.,DOM,Greece,GRC,0,0,5,0,5
2018,Eritrea,ERI,Greece,GRC,5,0,0,5,10
2018,Ethiopia,ETH,Greece,GRC,0,0,22,0,22
2018,Gambia,GMB,Greece,GRC,0,0,11,0,11
2018,Palestinian,PSE,Greece,GRC,0,0,5,5,10
2018,Georgia,GEO,Greece,GRC,0,0,278,5,283
2018,Ghana,GHA,Greece,GRC,0,0,13,0,13
2018,Guinea,GIN,Greece,GRC,0,0,12,0,12
2018,Cote d'Ivoire,CIV,Greece,GRC,0,0,5,0,5
2018,India,IND,Greece,GRC,0,0,29,0,29
2018,Iran (Islamic Rep. of),IRN,Greece,GRC,19,0,49,24,92
2018,Iraq,IRQ,Greece,GRC,24,12,154,52,242
2018,Lebanon,LBN,Greece,GRC,0,0,10,0,10
2018,Rep. of Moldova,MDA,Greece,GRC,0,0,17,0,17
2018,Mali,MLI,Greece,GRC,0,0,15,0,15
2018,Morocco,MAR,Greece,GRC,5,0,49,16,70
2018,Myanmar,MMR,Greece,GRC,0,0,5,0,5
2018,Nepal,NPL,Greece,GRC,0,0,5,0,5
2018,Nigeria,NGA,Greece,GRC,5,5,42,5,57
2018,Pakistan,PAK,Greece,GRC,15,5,2773,258,3051
2018,Russian Federation,RUS,Greece,GRC,0,0,5,0,5
2018,Serbia and Kosovo: S/RES/1244 (1999),SRB,Greece,GRC,0,0,5,0,5
2018,Senegal,SEN,Greece,GRC,0,0,13,0,13
2018,Sierra Leone,SLE,Greece,GRC,0,0,11,0,11
2018,Sudan,SDN,Greece,GRC,0,0,5,5,10
2018,Syrian Arab Rep.,SYR,Greece,GRC,32,5,0,90,127
2018,Tunisia,TUN,Greece,GRC,0,0,10,10,20
2018,Turkey,TUR,Greece,GRC,15,0,5,10,30
2018,Uganda,UGA,Greece,GRC,0,0,5,0,5
2018,Ukraine,UKR,Greece,GRC,0,0,20,0,20
2018,Venezuela (Bolivarian Republic of),VEN,Greece,GRC,0,0,5,0,5
2018,Unknown ,,Greece,GRC,0,0,0,1907,1907
2018,Afghanistan,AFG,Iceland,ISL,0,10,0,18,28
2018,Albania,ALB,Iceland,ISL,0,0,66,10,76
2018,Algeria,DZA,Iceland,ISL,0,0,5,0,5
2018,Egypt,EGY,Iceland,ISL,0,0,5,0,5
2018,Azerbaijan,AZE,Iceland,ISL,0,0,5,5,10
2018,Bangladesh,BGD,Iceland,ISL,0,0,0,5,5
2018,Bosnia and Herzegovina,BIH,Iceland,ISL,0,0,5,5,10
2018,Colombia,COL,Iceland,ISL,0,0,5,0,5
2018,Palestinian,PSE,Iceland,ISL,0,0,0,5,5
2018,Georgia,GEO,Iceland,ISL,0,0,82,5,87
2018,Ghana,GHA,Iceland,ISL,0,0,11,5,16
2018,India,IND,Iceland,ISL,0,0,0,10,10
2018,Iran (Islamic Rep. of),IRN,Iceland,ISL,5,0,0,5,10
2018,Iraq,IRQ,Iceland,ISL,11,0,17,68,96
2018,Libya,LBY,Iceland,ISL,0,0,0,5,5
2018,North Macedonia,MKD,Iceland,ISL,0,0,22,0,22
2018,Mongolia,MNG,Iceland,ISL,0,0,5,0,5
2018,Morocco,MAR,Iceland,ISL,0,0,5,5,10
2018,Nigeria,NGA,Iceland,ISL,0,0,5,0,5
2018,Pakistan,PAK,Iceland,ISL,0,0,10,19,29
2018,Russian Federation,RUS,Iceland,ISL,0,0,5,0,5
2018,Serbia and Kosovo: S/RES/1244 (1999),SRB,Iceland,ISL,0,0,13,5,18
2018,Senegal,SEN,Iceland,ISL,0,0,5,0,5
2018,Somalia,SOM,Iceland,ISL,0,5,5,21,31
2018,Syrian Arab Rep.,SYR,Iceland,ISL,5,0,0,5,10
2018,Ukraine,UKR,Iceland,ISL,0,0,13,0,13
2018,Stateless,XXA,Iceland,ISL,0,0,0,5,5
2018,Afghanistan,AFG,Ireland,IRL,5,0,0,16,21
2018,Albania,ALB,Ireland,IRL,21,5,53,15,94
2018,Algeria,DZA,Ireland,IRL,0,0,34,10,44
2018,Egypt,EGY,Ireland,IRL,0,0,5,0,5
2018,Burundi,BDI,Ireland,IRL,0,0,0,5,5
2018,Bangladesh,BGD,Ireland,IRL,10,0,44,0,54
2018,Brazil,BRA,Ireland,IRL,0,0,5,0,5
2018,China,CHN,Ireland,IRL,0,0,5,5,10
2018,Cameroon,CMR,Ireland,IRL,5,0,0,0,5
2018,Dem. Rep. of the Congo,COD,Ireland,IRL,17,0,13,21,51
2018,Georgia,GEO,Ireland,IRL,10,0,83,25,118
2018,Ghana,GHA,Ireland,IRL,0,0,5,5,10
2018,India,IND,Ireland,IRL,0,0,17,5,22
2018,Iraq,IRQ,Ireland,IRL,5,0,0,0,5
2018,Kuwait,KWT,Ireland,IRL,0,0,5,0,5
2018,Liberia,LBR,Ireland,IRL,0,0,5,0,5
2018,Sri Lanka,LKA,Ireland,IRL,0,0,0,5,5
2018,Malaysia,MYS,Ireland,IRL,0,0,0,5,5
2018,Malawi,MWI,Ireland,IRL,11,0,29,14,54
2018,Mauritius,MUS,Ireland,IRL,0,0,5,10,15
2018,Nepal,NPL,Ireland,IRL,0,0,5,0,5
2018,Nigeria,NGA,Ireland,IRL,21,5,96,16,138
2018,Pakistan,PAK,Ireland,IRL,36,11,152,38,237
2018,South Africa,ZAF,Ireland,IRL,11,5,40,10,66
2018,Russian Federation,RUS,Ireland,IRL,5,0,0,0,5
2018,Serbia and Kosovo: S/RES/1244 (1999),SRB,Ireland,IRL,5,0,0,5,10
2018,Sudan,SDN,Ireland,IRL,5,0,0,0,5
2018,Eswatini,SWZ,Ireland,IRL,0,0,5,0,5
2018,Ukraine,UKR,Ireland,IRL,10,0,0,5,15
2018,Venezuela (Bolivarian Republic of),VEN,Ireland,IRL,0,0,0,5,5
2018,Zimbabwe,ZWE,Ireland,IRL,55,0,39,20,114
2018,Bangladesh,BGD,Japan,JPN,0,0,82,0,82
2018,India,IND,Japan,JPN,0,0,58,0,58
2018,Indonesia,IDN,Japan,JPN,0,0,1057,0,1057
2018,Sri Lanka,LKA,Japan,JPN,0,0,181,0,181
2018,Myanmar,MMR,Japan,JPN,0,0,167,0,167
2018,Nepal,NPL,Japan,JPN,0,0,545,0,545
2018,Pakistan,PAK,Japan,JPN,0,0,75,0,75
2018,Philippines,PHL,Japan,JPN,0,0,1403,0,1403
2018,Viet Nam,VNM,Japan,JPN,0,0,1933,0,1933
2018,Turkey,TUR,Japan,JPN,0,0,241,0,241
2018,Unknown ,,Japan,JPN,5,13,258,2154,2430
2018,Burundi,BDI,Kenya,KEN,0,0,0,38,38
2018,Dem. Rep. of the Congo,COD,Kenya,KEN,0,0,0,100,100
2018,Eritrea,ERI,Kenya,KEN,0,0,0,11,11
2018,Ethiopia,ETH,Kenya,KEN,0,0,0,589,589
2018,Rwanda,RWA,Kenya,KEN,0,0,0,38,38
2018,Somalia,SOM,Kenya,KEN,0,0,0,21,21
2018,Sudan,SDN,Kenya,KEN,0,0,0,15,15
2018,Uganda,UGA,Kenya,KEN,0,0,0,5,5
2018,Albania,ALB,Luxembourg,LUX,5,0,45,0,50
2018,Algeria,DZA,Luxembourg,LUX,0,0,5,0,5
2018,Bosnia and Herzegovina,BIH,Luxembourg,LUX,0,0,5,0,5
2018,Cameroon,CMR,Luxembourg,LUX,0,0,5,0,5
2018,Dem. Rep. of the Congo,COD,Luxembourg,LUX,0,0,5,0,5
2018,Georgia,GEO,Luxembourg,LUX,0,0,5,0,5
2018,Guinea,GIN,Luxembourg,LUX,0,0,5,0,5
2018,Iraq,IRQ,Luxembourg,LUX,0,0,40,0,40
2018,North Macedonia,MKD,Luxembourg,LUX,0,0,10,0,10
2018,Morocco,MAR,Luxembourg,LUX,0,0,10,0,10
2018,Montenegro,MNE,Luxembourg,LUX,0,0,5,0,5
2018,Nigeria,NGA,Luxembourg,LUX,0,0,5,0,5
2018,Burundi,BDI,Malawi,MWI,0,0,0,21,21
2018,Dem. Rep. of the Congo,COD,Malawi,MWI,0,0,0,11,11
2018,Rwanda,RWA,Malawi,MWI,0,0,0,17,17
2018,Algeria,DZA,Malta,MLT,0,0,5,0,5
2018,Egypt,EGY,Malta,MLT,0,0,0,11,11
2018,Comoros,COM,Malta,MLT,0,0,0,5,5
2018,Eritrea,ERI,Malta,MLT,0,0,0,52,52
2018,Ethiopia,ETH,Malta,MLT,0,0,0,20,20
2018,Gambia,GMB,Malta,MLT,0,0,0,5,5
2018,Iraq,IRQ,Malta,MLT,0,0,0,12,12
2018,Libya,LBY,Malta,MLT,0,0,0,16,16
2018,Mali,MLI,Malta,MLT,0,0,0,5,5
2018,Niger,NER,Malta,MLT,0,0,0,5,5
2018,Nigeria,NGA,Malta,MLT,0,0,0,11,11
2018,Pakistan,PAK,Malta,MLT,0,0,0,5,5
2018,Senegal,SEN,Malta,MLT,0,0,0,5,5
2018,Somalia,SOM,Malta,MLT,0,0,0,350,350
2018,Syrian Arab Rep.,SYR,Malta,MLT,0,0,0,126,126
2018,Turkey,TUR,Malta,MLT,0,0,0,5,5
2018,Ukraine,UKR,Malta,MLT,0,5,0,19,24
2018,Afghanistan,AFG,Norway,NOR,34,5,608,11,658
2018,Albania,ALB,Norway,NOR,0,0,28,0,28
2018,Algeria,DZA,Norway,NOR,0,0,5,0,5
2018,Angola,AGO,Norway,NOR,0,0,18,0,18
2018,Egypt,EGY,Norway,NOR,0,0,10,5,15
2018,Armenia,ARM,Norway,NOR,0,0,5,0,5
2018,Azerbaijan,AZE,Norway,NOR,0,0,10,0,10
2018,Burundi,BDI,Norway,NOR,0,0,5,0,5
2018,Bangladesh,BGD,Norway,NOR,0,0,15,0,15
2018,China,CHN,Norway,NOR,0,0,15,0,15
2018,Dem. Rep. of the Congo,COD,Norway,NOR,0,0,13,0,13
2018,Eritrea,ERI,Norway,NOR,10,0,162,5,177
2018,Ethiopia,ETH,Norway,NOR,5,0,250,0,255
2018,Gambia,GMB,Norway,NOR,0,0,5,0,5
2018,Georgia,GEO,Norway,NOR,0,0,13,0,13
2018,Guinea,GIN,Norway,NOR,0,0,5,0,5
2018,Cote d'Ivoire,CIV,Norway,NOR,0,0,5,0,5
2018,India,IND,Norway,NOR,0,0,5,0,5
2018,Iran (Islamic Rep. of),IRN,Norway,NOR,30,0,299,5,334
2018,Iraq,IRQ,Norway,NOR,12,5,312,16,345
2018,Jordan,JOR,Norway,NOR,0,0,5,0,5
2018,Kazakhstan,KAZ,Norway,NOR,0,0,5,0,5
2018,Kyrgyzstan,KGZ,Norway,NOR,0,0,5,0,5
2018,Libya,LBY,Norway,NOR,0,0,10,0,10
2018,Lebanon,LBN,Norway,NOR,0,0,10,0,10
2018,Sri Lanka,LKA,Norway,NOR,0,0,14,0,14
2018,Rep. of Moldova,MDA,Norway,NOR,0,0,5,0,5
2018,Mongolia,MNG,Norway,NOR,0,0,5,0,5
2018,Morocco,MAR,Norway,NOR,0,0,25,0,25
2018,Myanmar,MMR,Norway,NOR,0,0,5,0,5
2018,Nigeria,NGA,Norway,NOR,0,0,36,0,36
2018,Pakistan,PAK,Norway,NOR,0,0,40,5,45
2018,Romania,ROU,Norway,NOR,0,0,5,0,5
2018,Russian Federation,RUS,Norway,NOR,5,0,40,5,50
2018,Saudi Arabia,SAU,Norway,NOR,0,0,5,0,5
2018,Serbia and Kosovo: S/RES/1244 (1999),SRB,Norway,NOR,0,0,23,0,23
2018,Somalia,SOM,Norway,NOR,0,0,110,5,115
2018,Sudan,SDN,Norway,NOR,0,0,18,0,18
2018,Syrian Arab Rep.,SYR,Norway,NOR,5,0,44,14,63
2018,Tajikistan,TJK,Norway,NOR,0,0,5,0,5
2018,Tunisia,TUN,Norway,NOR,0,0,5,0,5
2018,Turkey,TUR,Norway,NOR,0,0,27,0,27
2018,Ukraine,UKR,Norway,NOR,5,0,18,0,23
2018,United States of America,USA,Norway,NOR,0,0,5,0,5
2018,Uzbekistan,UZB,Norway,NOR,0,0,10,0,10
2018,Venezuela (Bolivarian Republic of),VEN,Norway,NOR,5,5,0,0,10
2018,Yemen,YEM,Norway,NOR,0,5,5,0,10
2018,Stateless,XXA,Norway,NOR,0,0,76,5,81
2018,Unknown ,,New Zealand,NZL,91,0,76,10,177
2018,Afghanistan,AFG,Poland,POL,0,0,5,0,5
2018,Algeria,DZA,Poland,POL,0,0,10,0,10
2018,Egypt,EGY,Poland,POL,0,0,5,0,5
2018,Armenia,ARM,Poland,POL,0,0,44,0,44
2018,Azerbaijan,AZE,Poland,POL,0,0,12,5,17
2018,Bangladesh,BGD,Poland,POL,0,0,15,0,15
2018,Belarus,BLR,Poland,POL,0,0,17,0,17
2018,Dem. Rep. of the Congo,COD,Poland,POL,0,0,5,0,5
2018,Ethiopia,ETH,Poland,POL,0,0,5,0,5
2018,Georgia,GEO,Poland,POL,0,0,31,5,36
2018,India,IND,Poland,POL,0,0,5,0,5
2018,Iran (Islamic Rep. of),IRN,Poland,POL,0,0,10,0,10
2018,Iraq,IRQ,Poland,POL,0,0,5,0,5
2018,Kazakhstan,KAZ,Poland,POL,5,5,11,0,21
2018,Kyrgyzstan,KGZ,Poland,POL,10,0,37,0,47
2018,Rep. of Moldova,MDA,Poland,POL,0,0,5,0,5
2018,Nigeria,NGA,Poland,POL,0,0,5,0,5
2018,Pakistan,PAK,Poland,POL,0,0,11,0,11
2018,Russian Federation,RUS,Poland,POL,0,10,1040,46,1096
2018,Viet Nam,VNM,Poland,POL,0,0,5,0,5
2018,Tajikistan,TJK,Poland,POL,0,0,106,5,111
2018,Turkey,TUR,Poland,POL,0,0,10,5,15
2018,Ukraine,UKR,Poland,POL,0,10,277,13,300
2018,Uzbekistan,UZB,Poland,POL,0,5,0,5,10
2018,Stateless,XXA,Poland,POL,0,0,5,0,5
2018,Burundi,BDI,South Africa,ZAF,0,0,0,58,58
2018,Bangladesh,BGD,South Africa,ZAF,0,0,0,1163,1163
2018,China,CHN,South Africa,ZAF,0,0,0,38,38
2018,Cameroon,CMR,South Africa,ZAF,0,0,0,217,217
2018,Congo,COG,South Africa,ZAF,0,0,5,99,104
2018,Dem. Rep. of the Congo,COD,South Africa,ZAF,20,0,34,682,736
2018,Eritrea,ERI,South Africa,ZAF,0,0,0,11,11
2018,Ethiopia,ETH,South Africa,ZAF,0,0,34,1330,1364
2018,Ghana,GHA,South Africa,ZAF,0,0,0,617,617
2018,India,IND,South Africa,ZAF,0,0,5,277,282
2018,Kenya,KEN,South Africa,ZAF,0,0,0,49,49
2018,Malawi,MWI,South Africa,ZAF,0,0,0,634,634
2018,Mozambique,MOZ,South Africa,ZAF,0,0,0,241,241
2018,Niger,NER,South Africa,ZAF,0,0,0,66,66
2018,Nigeria,NGA,South Africa,ZAF,0,0,0,1530,1530
2018,Pakistan,PAK,South Africa,ZAF,0,0,5,529,534
2018,Rwanda,RWA,South Africa,ZAF,0,0,0,5,5
2018,Senegal,SEN,South Africa,ZAF,0,0,0,70,70
2018,Somalia,SOM,South Africa,ZAF,0,0,5,293,298
2018,United Rep. of Tanzania,TZA,South Africa,ZAF,0,0,0,82,82
2018,Uganda,UGA,South Africa,ZAF,0,0,0,324,324
2018,Zimbabwe,ZWE,South Africa,ZAF,0,0,0,5733,5733
2018,Unknown ,,South Africa,ZAF,0,0,0,316,316
2018,Dem. Rep. of the Congo,COD,Uganda,UGA,10,0,0,0,10
2018,Eritrea,ERI,Uganda,UGA,112,0,226,0,338
2018,Ethiopia,ETH,Uganda,UGA,12,0,10,0,22
2018,Rwanda,RWA,Uganda,UGA,0,0,5,0,5
2018,Afghanistan,AFG,United States of America,USA,12,0,0,14,26
2018,Albania,ALB,United States of America,USA,46,0,10,28,84
2018,Angola,AGO,United States of America,USA,22,0,0,0,22
2018,Egypt,EGY,United States of America,USA,120,0,32,87,239
2018,Argentina,ARG,United States of America,USA,0,0,0,10,10
2018,Armenia,ARM,United States of America,USA,18,0,5,25,48
2018,Azerbaijan,AZE,United States of America,USA,10,0,0,5,15
2018,Burundi,BDI,United States of America,USA,18,0,0,11,29
2018,Bangladesh,BGD,United States of America,USA,103,0,46,79,228
2018,Bhutan,BTN,United States of America,USA,0,0,0,12,12
2018,Burkina Faso,BFA,United States of America,USA,64,0,15,53,132
2018,Belarus,BLR,United States of America,USA,31,0,5,0,36
2018,Bolivia (Plurinational State of),BOL,United States of America,USA,0,0,0,15,15
2018,Brazil,BRA,United States of America,USA,0,0,5,98,103
2018,Bulgaria,BGR,United States of America,USA,5,0,0,0,5
2018,Central African Rep.,CAF,United States of America,USA,10,0,0,0,10
2018,Chad,TCD,United States of America,USA,5,0,0,0,5
2018,China,CHN,United States of America,USA,2039,0,670,1343,4052
2018,Cameroon,CMR,United States of America,USA,31,0,5,31,67
2018,Congo,COG,United States of America,USA,16,0,5,26,47
2018,Dem. Rep. of the Congo,COD,United States of America,USA,13,0,5,10,28
2018,Colombia,COL,United States of America,USA,10,0,22,91,123
2018,Costa Rica,CRI,United States of America,USA,0,0,0,5,5
2018,Djibouti,DJI,United States of America,USA,5,0,0,0,5
2018,Dominican Rep.,DOM,United States of America,USA,0,0,0,5,5
2018,Ecuador,ECU,United States of America,USA,0,0,32,741,773
2018,Eritrea,ERI,United States of America,USA,35,0,0,16,51
2018,Ethiopia,ETH,United States of America,USA,97,0,10,45,152
2018,Gambia,GMB,United States of America,USA,19,0,5,35,59
2018,Palestinian,PSE,United States of America,USA,0,0,0,5,5
2018,Georgia,GEO,United States of America,USA,5,0,5,0,10
2018,Ghana,GHA,United States of America,USA,5,0,0,5,10
2018,Guatemala,GTM,United States of America,USA,48,0,71,513,632
2018,Guinea,GIN,United States of America,USA,35,0,12,28,75
2018,Guyana,GUY,United States of America,USA,0,0,0,5,5
2018,Haiti,HTI,United States of America,USA,10,0,43,114,167
2018,Honduras,HND,United States of America,USA,42,0,43,158,243
2018,Cote d'Ivoire,CIV,United States of America,USA,22,0,14,32,68
2018,India,IND,United States of America,USA,236,0,77,224,537
2018,Indonesia,IDN,United States of America,USA,19,0,5,50,74
2018,Iran (Islamic Rep. of),IRN,United States of America,USA,49,0,5,36,90
2018,Iraq,IRQ,United States of America,USA,63,0,5,105,173
2018,Israel,ISR,United States of America,USA,0,0,0,11,11
2018,Jamaica,JAM,United States of America,USA,0,0,0,5,5
2018,Jordan,JOR,United States of America,USA,17,0,0,16,33
2018,Kazakhstan,KAZ,United States of America,USA,25,0,5,18,48
2018,Kenya,KEN,United States of America,USA,19,0,5,21,45
2018,Kyrgyzstan,KGZ,United States of America,USA,49,0,12,43,104
2018,Lao People's Dem. Rep.,LAO,United States of America,USA,0,0,0,5,5
2018,Liberia,LBR,United States of America,USA,11,0,0,22,33
2018,Libya,LBY,United States of America,USA,10,0,0,5,15
2018,Lebanon,LBN,United States of America,USA,15,0,0,10,25
2018,Sri Lanka,LKA,United States of America,USA,32,0,15,23,70
2018,Mauritania,MRT,United States of America,USA,16,0,5,25,46
2018,Rep. of Moldova,MDA,United States of America,USA,46,0,14,13,73
2018,Mexico,MEX,United States of America,USA,25,0,154,2277,2456
2018,Mali,MLI,United States of America,USA,27,0,11,41,79
2018,Malaysia,MYS,United States of America,USA,0,0,5,14,19
2018,Mongolia,MNG,United States of America,USA,23,0,10,15,48
2018,Myanmar,MMR,United States of America,USA,11,0,0,10,21
2018,Nepal,NPL,United States of America,USA,204,0,50,94,348
2018,Niger,NER,United States of America,USA,0,0,0,11,11
2018,Nicaragua,NIC,United States of America,USA,0,0,5,16,21
2018,Nigeria,NGA,United States of America,USA,20,0,15,83,118
2018,Pakistan,PAK,United States of America,USA,108,0,36,88,232
2018,Peru,PER,United States of America,USA,0,0,5,60,65
2018,Philippines,PHL,United States of America,USA,5,0,10,54,69
2018,Poland,POL,United States of America,USA,0,0,0,49,49
2018,Romania,ROU,United States of America,USA,0,0,0,37,37
2018,Russian Federation,RUS,United States of America,USA,72,0,15,98,185
2018,Rwanda,RWA,United States of America,USA,34,0,5,5,44
2018,El Salvador,SLV,United States of America,USA,27,0,50,436,513
2018,Saudi Arabia,SAU,United States of America,USA,5,0,0,31,36
2018,Serbia and Kosovo: S/RES/1244 (1999),SRB,United States of America,USA,33,0,0,5,38
2018,Senegal,SEN,United States of America,USA,5,0,10,27,42
2018,Sierra Leone,SLE,United States of America,USA,10,0,0,10,20
2018,Somalia,SOM,United States of America,USA,0,0,0,5,5
2018,Sudan,SDN,United States of America,USA,20,0,0,13,33
2018,Syrian Arab Rep.,SYR,United States of America,USA,80,0,12,70,162
2018,Tajikistan,TJK,United States of America,USA,11,0,0,5,16
2018,Turkmenistan,TKM,United States of America,USA,5,0,0,5,10
2018,Togo,TGO,United States of America,USA,5,0,0,5,10
2018,Trinidad and Tobago,TTO,United States of America,USA,0,0,0,12,12
2018,Turkey,TUR,United States of America,USA,0,0,0,20,20
2018,United Arab Emirates,ARE,United States of America,USA,5,0,0,0,5
2018,Uganda,UGA,United States of America,USA,15,0,10,18,43
2018,Ukraine,UKR,United States of America,USA,70,0,19,70,159
2018,Uzbekistan,UZB,United States of America,USA,40,0,10,30,80
2018,Venezuela (Bolivarian Republic of),VEN,United States of America,USA,67,0,25,283,375
2018,Yemen,YEM,United States of America,USA,14,0,0,23,37
2018,Zimbabwe,ZWE,United States of America,USA,5,0,5,5,15
2018,Unknown ,,United States of America,USA,193,0,74,1047,1314
2019,Bangladesh,BGD,Argentina,ARG,0,0,0,5,5
2019,Colombia,COL,Argentina,ARG,0,0,11,5,16
2019,Cuba,CUB,Argentina,ARG,0,0,10,0,10
2019,Dominican Rep.,DOM,Argentina,ARG,0,0,11,0,11
2019,Ghana,GHA,Argentina,ARG,0,0,10,0,10
2019,Haiti,HTI,Argentina,ARG,0,0,23,0,23
2019,India,IND,Argentina,ARG,0,0,5,0,5
2019,Russian Federation,RUS,Argentina,ARG,0,0,10,0,10
2019,Senegal,SEN,Argentina,ARG,0,0,203,0,203
2019,Afghanistan,AFG,Australia,AUS,35,0,76,0,111
2019,Albania,ALB,Australia,AUS,0,0,10,0,10
2019,Egypt,EGY,Australia,AUS,11,0,10,5,26
2019,Bangladesh,BGD,Australia,AUS,14,0,196,10,220
2019,Cambodia,KHM,Australia,AUS,10,0,10,0,20
2019,Canada,CAN,Australia,AUS,0,0,5,0,5
2019,China,CHN,Australia,AUS,54,0,771,171,996
2019,Cameroon,CMR,Australia,AUS,5,0,0,0,5
2019,Dem. Rep. of the Congo,COD,Australia,AUS,5,0,0,0,5
2019,Ethiopia,ETH,Australia,AUS,5,0,10,0,15
2019,Fiji,FJI,Australia,AUS,5,0,58,14,77
2019,Gambia,GMB,Australia,AUS,0,0,5,0,5
2019,United Kingdom of Great Britain and Northern Ireland,GBR,Australia,AUS,0,0,5,5,10
2019,Ghana,GHA,Australia,AUS,5,0,5,10,20
2019,Guinea,GIN,Australia,AUS,0,0,5,0,5
2019,Honduras,HND,Australia,AUS,0,0,5,0,5
2019,India,IND,Australia,AUS,37,0,280,38,355
2019,Indonesia,IDN,Australia,AUS,0,0,71,19,90
2019,Ireland,IRL,Australia,AUS,0,0,5,0,5
2019,Iran (Islamic Rep. of),IRN,Australia,AUS,73,0,456,11,540
2019,Iraq,IRQ,Australia,AUS,37,0,113,17,167
2019,Italy,ITA,Australia,AUS,0,0,10,0,10
2019,Jordan,JOR,Australia,AUS,5,0,5,0,10
2019,Kenya,KEN,Australia,AUS,0,0,5,0,5
2019,Rep. of Korea,KOR,Australia,AUS,0,0,31,5,36
2019,Liberia,LBR,Australia,AUS,0,0,5,0,5
2019,Libya,LBY,Australia,AUS,21,0,0,0,21
2019,Lebanon,LBN,Australia,AUS,0,0,101,5,106
2019,Sri Lanka,LKA,Australia,AUS,51,0,592,11,654
2019,Latvia,LVA,Australia,AUS,0,0,5,0,5
2019,Mexico,MEX,Australia,AUS,5,0,0,0,5
2019,Malaysia,MYS,Australia,AUS,30,0,1200,542,1772
2019,Mauritius,MUS,Australia,AUS,0,0,5,0,5
2019,Myanmar,MMR,Australia,AUS,10,0,36,0,46
2019,Nepal,NPL,Australia,AUS,0,0,57,18,75
2019,Netherlands,NLD,Australia,AUS,0,0,5,0,5
2019,Nigeria,NGA,Australia,AUS,11,0,27,5,43
2019,Pakistan,PAK,Australia,AUS,101,0,336,17,454
2019,Peru,PER,Australia,AUS,5,0,5,0,10
2019,Philippines,PHL,Australia,AUS,5,0,0,0,5
2019,Papua New Guinea,PNG,Australia,AUS,11,0,10,5,26
2019,South Africa,ZAF,Australia,AUS,5,0,5,0,10
2019,Russian Federation,RUS,Australia,AUS,0,0,5,0,5
2019,Rwanda,RWA,Australia,AUS,11,0,5,0,16
2019,El Salvador,SLV,Australia,AUS,0,0,5,0,5
2019,Saudi Arabia,SAU,Australia,AUS,10,0,0,0,10
2019,Singapore,SGP,Australia,AUS,0,0,5,0,5
2019,Viet Nam,VNM,Australia,AUS,12,0,188,54,254
2019,Sudan,SDN,Australia,AUS,5,0,10,5,20
2019,Thailand,THA,Australia,AUS,0,0,18,30,48
2019,Tonga,TON,Australia,AUS,0,0,5,0,5
2019,Turkey,TUR,Australia,AUS,24,0,16,0,40
2019,Ukraine,UKR,Australia,AUS,5,0,10,0,15
2019,Venezuela (Bolivarian Republic of),VEN,Australia,AUS,5,0,0,0,5
2019,Samoa,WSM,Australia,AUS,0,0,5,0,5
2019,Zimbabwe,ZWE,Australia,AUS,5,0,10,5,20
2019,Stateless,XXA,Australia,AUS,30,0,20,0,50
2019,Unknown ,,Australia,AUS,5,0,0,0,5
2019,Dem. Rep. of the Congo,COD,Burundi,BDI,197,0,119,0,316
2019,Rwanda,RWA,Burundi,BDI,22,0,10,0,32
2019,Afghanistan,AFG,Canada,CAN,10,0,45,5,60
2019,Albania,ALB,Canada,CAN,14,0,26,0,40
2019,Algeria,DZA,Canada,CAN,13,0,51,0,64
2019,Angola,AGO,Canada,CAN,5,0,53,0,58
2019,Antigua and Barbuda,ATG,Canada,CAN,0,0,5,0,5
2019,Egypt,EGY,Canada,CAN,19,0,35,0,54
2019,Argentina,ARG,Canada,CAN,0,0,10,0,10
2019,Azerbaijan,AZE,Canada,CAN,15,0,38,10,63
2019,Barbados,BRB,Canada,CAN,5,0,0,0,5
2019,Burundi,BDI,Canada,CAN,0,0,5,0,5
2019,Belgium,BEL,Canada,CAN,0,0,5,0,5
2019,Benin,BEN,Canada,CAN,0,0,5,0,5
2019,Bangladesh,BGD,Canada,CAN,42,0,91,0,133
2019,Bahamas,BHS,Canada,CAN,5,0,16,0,21
2019,Burkina Faso,BFA,Canada,CAN,5,0,5,0,10
2019,Botswana,BWA,Canada,CAN,0,0,10,0,10
2019,Brazil,BRA,Canada,CAN,5,0,93,0,98
2019,Cambodia,KHM,Canada,CAN,0,0,15,0,15
2019,Chad,TCD,Canada,CAN,10,0,37,0,47
2019,China,CHN,Canada,CAN,85,0,311,5,401
2019,Chile,CHL,Canada,CAN,13,0,23,0,36
2019,Cameroon,CMR,Canada,CAN,5,0,14,0,19
2019,Congo,COG,Canada,CAN,5,0,5,0,10
2019,Dem. Rep. of the Congo,COD,Canada,CAN,24,0,76,10,110
2019,Colombia,COL,Canada,CAN,49,0,265,5,319
2019,Cuba,CUB,Canada,CAN,0,0,16,0,16
2019,Czechia,CZE,Canada,CAN,0,0,15,0,15
2019,Djibouti,DJI,Canada,CAN,25,0,33,0,58
2019,Dominican Rep.,DOM,Canada,CAN,0,0,5,0,5
2019,Ecuador,ECU,Canada,CAN,0,0,10,0,10
2019,Eritrea,ERI,Canada,CAN,13,0,26,0,39
2019,Ethiopia,ETH,Canada,CAN,37,0,66,5,108
2019,France,FRA,Canada,CAN,0,0,5,0,5
2019,Gambia,GMB,Canada,CAN,0,0,5,0,5
2019,Palestinian,PSE,Canada,CAN,14,0,32,0,46
2019,Georgia,GEO,Canada,CAN,10,0,27,5,42
2019,Germany,DEU,Canada,CAN,0,0,5,0,5
2019,Ghana,GHA,Canada,CAN,17,0,74,0,91
2019,Guinea-Bissau,GNB,Canada,CAN,0,0,5,0,5
2019,Greece,GRC,Canada,CAN,5,0,0,0,5
2019,Guatemala,GTM,Canada,CAN,10,0,22,0,32
2019,Guinea,GIN,Canada,CAN,0,0,15,0,15
2019,Guyana,GUY,Canada,CAN,10,0,20,0,30
2019,Haiti,HTI,Canada,CAN,140,0,1371,18,1529
2019,Honduras,HND,Canada,CAN,10,0,23,0,33
2019,Hungary,HUN,Canada,CAN,57,0,52,5,114
2019,Cote d'Ivoire,CIV,Canada,CAN,0,0,10,0,10
2019,India,IND,Canada,CAN,77,0,383,5,465
2019,Indonesia,IDN,Canada,CAN,0,0,5,0,5
2019,Ireland,IRL,Canada,CAN,0,0,5,0,5
2019,Iran (Islamic Rep. of),IRN,Canada,CAN,57,0,38,5,100
2019,Iraq,IRQ,Canada,CAN,26,0,23,5,54
2019,Israel,ISR,Canada,CAN,5,0,5,0,10
2019,Italy,ITA,Canada,CAN,5,0,18,0,23
2019,Jamaica,JAM,Canada,CAN,5,0,35,0,40
2019,Jordan,JOR,Canada,CAN,15,0,56,0,71
2019,Kenya,KEN,Canada,CAN,5,0,10,0,15
2019,Rep. of Korea,KOR,Canada,CAN,0,0,5,0,5
2019,Dem. People's Rep. of Korea,PRK,Canada,CAN,0,0,35,0,35
2019,Libya,LBY,Canada,CAN,0,0,11,5,16
2019,Saint Lucia,LCA,Canada,CAN,0,0,10,0,10
2019,Lebanon,LBN,Canada,CAN,25,0,58,0,83
2019,Sri Lanka,LKA,Canada,CAN,22,0,41,0,63
2019,Lithuania,LTU,Canada,CAN,0,0,5,0,5
2019,Luxembourg,LUX,Canada,CAN,0,0,5,0,5
2019,Mauritania,MRT,Canada,CAN,10,0,0,0,10
2019,Mexico,MEX,Canada,CAN,97,0,430,16,543
2019,Mali,MLI,Canada,CAN,5,0,14,0,19
2019,Malawi,MWI,Canada,CAN,0,0,5,0,5
2019,Morocco,MAR,Canada,CAN,0,0,11,0,11
2019,Namibia,NAM,Canada,CAN,0,0,15,0,15
2019,Nepal,NPL,Canada,CAN,5,0,17,0,22
2019,Niger,NER,Canada,CAN,5,0,5,0,10
2019,Nigeria,NGA,Canada,CAN,498,0,1936,46,2480
2019,Pakistan,PAK,Canada,CAN,51,0,215,5,271
2019,Panama,PAN,Canada,CAN,0,0,5,0,5
2019,Peru,PER,Canada,CAN,0,0,19,0,19
2019,Philippines,PHL,Canada,CAN,0,0,19,0,19
2019,Poland,POL,Canada,CAN,10,0,5,0,15
2019,Portugal,PRT,Canada,CAN,0,0,10,0,10
2019,Romania,ROU,Canada,CAN,23,0,17,0,40
2019,South Africa,ZAF,Canada,CAN,5,0,37,5,47
2019,Russian Federation,RUS,Canada,CAN,0,0,5,0,5
2019,Rwanda,RWA,Canada,CAN,5,0,26,0,31
2019,El Salvador,SLV,Canada,CAN,18,0,78,0,96
2019,Saudi Arabia,SAU,Canada,CAN,10,0,21,0,31
2019,Serbia and Kosovo: S/RES/1244 (1999),SRB,Canada,CAN,0,0,5,0,5
2019,Senegal,SEN,Canada,CAN,0,0,10,0,10
2019,Somalia,SOM,Canada,CAN,59,0,49,0,108
2019,Spain,ESP,Canada,CAN,0,0,12,0,12
2019,Viet Nam,VNM,Canada,CAN,0,0,13,0,13
2019,Sudan,SDN,Canada,CAN,39,0,30,0,69
2019,Slovakia,SVK,Canada,CAN,10,0,0,5,15
2019,Syrian Arab Rep.,SYR,Canada,CAN,5,0,5,0,10
2019,United Rep. of Tanzania,TZA,Canada,CAN,5,0,5,0,10
2019,Thailand,THA,Canada,CAN,0,0,5,0,5
2019,Togo,TGO,Canada,CAN,0,0,5,0,5
2019,Trinidad and Tobago,TTO,Canada,CAN,0,0,5,0,5
2019,Tunisia,TUN,Canada,CAN,0,0,5,5,10
2019,Turkey,TUR,Canada,CAN,44,0,32,0,76
2019,Uganda,UGA,Canada,CAN,11,0,21,0,32
2019,Ukraine,UKR,Canada,CAN,5,0,18,0,23
2019,United States of America,USA,Canada,CAN,16,0,393,13,422
2019,Saint Vincent and the Grenadines,VCT,Canada,CAN,0,0,15,0,15
2019,Venezuela (Bolivarian Republic of),VEN,Canada,CAN,37,0,82,0,119
2019,Yemen,YEM,Canada,CAN,10,0,5,0,15
2019,Zimbabwe,ZWE,Canada,CAN,0,0,15,0,15
2019,Unknown ,,Canada,CAN,37,0,219,5,261
2019,Angola,AGO,Costa Rica,CRI,0,0,5,0,5
2019,Colombia,COL,Costa Rica,CRI,0,0,109,37,146
2019,Cuba,CUB,Costa Rica,CRI,0,0,10,5,15
2019,Guatemala,GTM,Costa Rica,CRI,0,0,5,0,5
2019,Haiti,HTI,Costa Rica,CRI,0,0,5,0,5
2019,Honduras,HND,Costa Rica,CRI,5,0,10,5,20
2019,India,IND,Costa Rica,CRI,0,0,5,0,5
2019,Nicaragua,NIC,Costa Rica,CRI,0,0,28,0,28
2019,El Salvador,SLV,Costa Rica,CRI,30,0,165,14,209
2019,Venezuela (Bolivarian Republic of),VEN,Costa Rica,CRI,0,0,202,22,224
2019,Egypt,EGY,Cyprus,CYP,0,0,0,19,19
2019,Bangladesh,BGD,Cyprus,CYP,0,0,220,11,231
2019,Cameroon,CMR,Cyprus,CYP,0,0,5,0,5
2019,Dem. Rep. of the Congo,COD,Cyprus,CYP,0,0,0,5,5
2019,Gambia,GMB,Cyprus,CYP,0,0,5,0,5
2019,Palestinian,PSE,Cyprus,CYP,5,0,5,5,15
2019,Georgia,GEO,Cyprus,CYP,0,0,5,0,5
2019,India,IND,Cyprus,CYP,0,0,198,31,229
2019,Iraq,IRQ,Cyprus,CYP,0,0,0,33,33
2019,Sri Lanka,LKA,Cyprus,CYP,0,0,36,14,50
2019,Nepal,NPL,Cyprus,CYP,0,0,5,10,15
2019,Pakistan,PAK,Cyprus,CYP,0,0,50,13,63
2019,Philippines,PHL,Cyprus,CYP,0,0,10,0,10
2019,Viet Nam,VNM,Cyprus,CYP,0,0,201,25,226
2019,Turkey,TUR,Cyprus,CYP,10,0,0,0,10
2019,Ukraine,UKR,Cyprus,CYP,0,0,0,5,5
2019,Afghanistan,AFG,Denmark,DNK,11,57,178,0,246
2019,Algeria,DZA,Denmark,DNK,0,0,5,0,5
2019,Egypt,EGY,Denmark,DNK,0,0,5,0,5
2019,Armenia,ARM,Denmark,DNK,0,5,15,0,20
2019,Azerbaijan,AZE,Denmark,DNK,5,0,5,0,10
2019,Burundi,BDI,Denmark,DNK,0,0,5,0,5
2019,Bangladesh,BGD,Denmark,DNK,0,0,5,0,5
2019,Belarus,BLR,Denmark,DNK,0,0,5,0,5
2019,Cameroon,CMR,Denmark,DNK,0,0,13,0,13
2019,Dem. Rep. of the Congo,COD,Denmark,DNK,0,0,10,0,10
2019,Colombia,COL,Denmark,DNK,0,0,16,0,16
2019,Eritrea,ERI,Denmark,DNK,10,0,5,0,15
2019,Ethiopia,ETH,Denmark,DNK,0,0,16,0,16
2019,Gambia,GMB,Denmark,DNK,0,0,5,0,5
2019,Georgia,GEO,Denmark,DNK,0,0,49,0,49
2019,Ghana,GHA,Denmark,DNK,0,0,5,0,5
2019,Guinea,GIN,Denmark,DNK,0,0,5,0,5
2019,India,IND,Denmark,DNK,0,0,5,0,5
2019,Indonesia,IDN,Denmark,DNK,0,0,10,0,10
2019,Iran (Islamic Rep. of),IRN,Denmark,DNK,72,10,127,0,209
2019,Iraq,IRQ,Denmark,DNK,0,0,137,0,137
2019,Jordan,JOR,Denmark,DNK,0,0,13,0,13
2019,Kenya,KEN,Denmark,DNK,0,0,10,0,10
2019,Lebanon,LBN,Denmark,DNK,0,0,5,0,5
2019,Sri Lanka,LKA,Denmark,DNK,0,0,14,0,14
2019,Morocco,MAR,Denmark,DNK,0,0,17,0,17
2019,Myanmar,MMR,Denmark,DNK,0,0,5,0,5
2019,Nigeria,NGA,Denmark,DNK,0,0,27,0,27
2019,Pakistan,PAK,Denmark,DNK,0,0,5,0,5
2019,Russian Federation,RUS,Denmark,DNK,0,0,40,0,40
2019,El Salvador,SLV,Denmark,DNK,0,0,5,0,5
2019,Sierra Leone,SLE,Denmark,DNK,0,0,5,0,5
2019,Somalia,SOM,Denmark,DNK,0,0,69,0,69
2019,Viet Nam,VNM,Denmark,DNK,0,0,5,0,5
2019,Syrian Arab Rep.,SYR,Denmark,DNK,5,5,12,0,22
2019,Tunisia,TUN,Denmark,DNK,0,0,5,0,5
2019,Turkey,TUR,Denmark,DNK,0,0,18,0,18
2019,Uganda,UGA,Denmark,DNK,0,0,15,0,15
2019,Ukraine,UKR,Denmark,DNK,5,0,21,0,26
2019,Venezuela (Bolivarian Republic of),VEN,Denmark,DNK,0,5,10,0,15
2019,Stateless,XXA,Denmark,DNK,0,0,83,0,83
2019,Unknown ,,Denmark,DNK,0,0,89,0,89
2019,Afghanistan,AFG,France,FRA,521,1208,506,10,2245
2019,Albania,ALB,France,FRA,118,277,1572,18,1985
2019,Algeria,DZA,France,FRA,66,45,249,10,370
2019,Angola,AGO,France,FRA,73,49,481,0,603
2019,Egypt,EGY,France,FRA,128,5,209,0,342
2019,Argentina,ARG,France,FRA,0,0,5,0,5
2019,Armenia,ARM,France,FRA,22,72,713,10,817
2019,Azerbaijan,AZE,France,FRA,88,10,136,0,234
2019,Burundi,BDI,France,FRA,11,0,45,0,56
2019,Benin,BEN,France,FRA,5,5,58,0,68
2019,Bangladesh,BGD,France,FRA,483,174,1704,5,2366
2019,Burkina Faso,BFA,France,FRA,23,10,105,0,138
2019,Belarus,BLR,France,FRA,5,0,29,0,34
2019,Bolivia (Plurinational State of),BOL,France,FRA,0,0,5,0,5
2019,Brazil,BRA,France,FRA,0,0,25,0,25
2019,Bosnia and Herzegovina,BIH,France,FRA,12,5,92,0,109
2019,Cambodia,KHM,France,FRA,5,0,31,0,36
2019,Central African Rep.,CAF,France,FRA,98,106,356,5,565
2019,Chad,TCD,France,FRA,136,39,338,5,518
2019,China,CHN,France,FRA,19,0,51,0,70
2019,Cameroon,CMR,France,FRA,148,49,382,5,584
2019,Congo,COG,France,FRA,105,31,590,15,741
2019,Dem. Rep. of the Congo,COD,France,FRA,443,125,1950,12,2530
2019,Comoros,COM,France,FRA,5,0,142,0,147
2019,Colombia,COL,France,FRA,13,19,55,5,92
2019,Cuba,CUB,France,FRA,5,0,29,0,34
2019,Djibouti,DJI,France,FRA,29,10,19,0,58
2019,Dominican Rep.,DOM,France,FRA,0,0,54,0,54
2019,Equatorial Guinea,GNQ,France,FRA,0,0,14,0,14
2019,Eritrea,ERI,France,FRA,216,5,156,5,382
2019,Ethiopia,ETH,France,FRA,80,5,149,0,234
2019,Gabon,GAB,France,FRA,43,16,186,5,250
2019,Gambia,GMB,France,FRA,20,5,149,0,174
2019,Palestinian,PSE,France,FRA,36,10,25,0,71
2019,Georgia,GEO,France,FRA,83,89,1391,28,1591
2019,Ghana,GHA,France,FRA,0,0,49,0,49
2019,Guinea-Bissau,GNB,France,FRA,10,5,87,0,102
2019,Guinea,GIN,France,FRA,801,153,2312,13,3279
2019,Haiti,HTI,France,FRA,35,19,392,5,451
2019,Honduras,HND,France,FRA,0,5,5,0,10
2019,Cote d'Ivoire,CIV,France,FRA,607,149,2866,18,3640
2019,India,IND,France,FRA,5,0,110,0,115
2019,Iran (Islamic Rep. of),IRN,France,FRA,168,5,105,0,278
2019,Iraq,IRQ,France,FRA,78,49,208,5,340
2019,Kazakhstan,KAZ,France,FRA,17,5,68,0,90
2019,Kenya,KEN,France,FRA,5,0,20,0,25
2019,Kyrgyzstan,KGZ,France,FRA,5,0,10,0,15
2019,Rep. of Korea,KOR,France,FRA,0,0,5,0,5
2019,Dem. People's Rep. of Korea,PRK,France,FRA,5,0,5,0,10
2019,Kuwait,KWT,France,FRA,18,0,5,0,23
2019,Lao People's Dem. Rep.,LAO,France,FRA,0,0,5,0,5
2019,Liberia,LBR,France,FRA,5,0,30,0,35
2019,Libya,LBY,France,FRA,53,110,78,5,246
2019,Lebanon,LBN,France,FRA,5,0,33,0,38
2019,Sri Lanka,LKA,France,FRA,288,29,536,5,858
2019,Madagascar,MDG,France,FRA,0,5,44,0,49
2019,Mauritania,MRT,France,FRA,190,10,393,5,598
2019,North Macedonia,MKD,France,FRA,14,10,181,0,205
2019,Rep. of Moldova,MDA,France,FRA,0,0,22,0,22
2019,Mexico,MEX,France,FRA,0,0,5,0,5
2019,Mali,MLI,France,FRA,145,40,793,5,983
2019,Mongolia,MNG,France,FRA,10,5,84,0,99
2019,Morocco,MAR,France,FRA,58,17,278,0,353
2019,Mozambique,MOZ,France,FRA,0,0,5,0,5
2019,Montenegro,MNE,France,FRA,5,0,21,0,26
2019,Mauritius,MUS,France,FRA,0,0,5,0,5
2019,Myanmar,MMR,France,FRA,13,0,18,0,31
2019,Nepal,NPL,France,FRA,5,10,76,0,91
2019,Niger,NER,France,FRA,12,5,32,0,49
2019,Nicaragua,NIC,France,FRA,0,0,10,0,10
2019,Nigeria,NGA,France,FRA,444,62,1764,5,2275
2019,Pakistan,PAK,France,FRA,170,46,734,0,950
2019,Peru,PER,France,FRA,5,5,26,0,36
2019,South Africa,ZAF,France,FRA,0,0,5,0,5
2019,Russian Federation,RUS,France,FRA,376,81,721,11,1189
2019,Rwanda,RWA,France,FRA,35,5,70,5,115
2019,El Salvador,SLV,France,FRA,0,5,10,0,15
2019,Serbia and Kosovo: S/RES/1244 (1999),SRB,France,FRA,172,123,835,16,1146
2019,Senegal,SEN,France,FRA,177,33,787,5,1002
2019,Sierra Leone,SLE,France,FRA,46,10,97,0,153
2019,Somalia,SOM,France,FRA,133,406,206,10,755
2019,Viet Nam,VNM,France,FRA,10,0,21,0,31
2019,Sudan,SDN,France,FRA,743,635,884,23,2285
2019,Suriname,SUR,France,FRA,0,0,10,0,10
2019,South Sudan,SSD,France,FRA,5,5,5,0,15
2019,Syrian Arab Rep.,SYR,France,FRA,646,90,406,20,1162
2019,United Rep. of Tanzania,TZA,France,FRA,0,0,5,0,5
2019,Tajikistan,TJK,France,FRA,5,0,5,0,10
2019,Togo,TGO,France,FRA,30,5,151,0,186
2019,Tunisia,TUN,France,FRA,14,10,132,0,156
2019,Turkey,TUR,France,FRA,495,5,765,0,1265
2019,Uganda,UGA,France,FRA,13,0,10,0,23
2019,Ukraine,UKR,France,FRA,52,30,201,5,288
2019,United States of America,USA,France,FRA,0,0,5,0,5
2019,Uzbekistan,UZB,France,FRA,0,0,5,0,5
2019,Venezuela (Bolivarian Republic of),VEN,France,FRA,24,10,102,0,136
2019,Western Sahara,ESH,France,FRA,115,25,893,5,1038
2019,Yemen,YEM,France,FRA,18,24,12,0,54
2019,Zimbabwe,ZWE,France,FRA,0,0,5,0,5
2019,Unknown ,,Greece,GRC,2641,277,7739,3575,14232
2019,Afghanistan,AFG,Iceland,ISL,0,14,0,56,70
2019,Albania,ALB,Iceland,ISL,0,0,19,5,24
2019,Algeria,DZA,Iceland,ISL,0,0,0,5,5
2019,Egypt,EGY,Iceland,ISL,0,0,5,5,10
2019,Colombia,COL,Iceland,ISL,0,0,13,0,13
2019,Eritrea,ERI,Iceland,ISL,0,0,0,5,5
2019,Palestinian,PSE,Iceland,ISL,0,5,0,5,10
2019,Georgia,GEO,Iceland,ISL,0,0,11,0,11
2019,Ghana,GHA,Iceland,ISL,0,0,5,5,10
2019,Cote d'Ivoire,CIV,Iceland,ISL,0,0,0,5,5
2019,Iran (Islamic Rep. of),IRN,Iceland,ISL,5,0,0,29,34
2019,Iraq,IRQ,Iceland,ISL,10,10,65,56,141
2019,Libya,LBY,Iceland,ISL,0,5,0,12,17
2019,North Macedonia,MKD,Iceland,ISL,0,0,5,0,5
2019,Rep. of Moldova,MDA,Iceland,ISL,0,0,30,0,30
2019,Morocco,MAR,Iceland,ISL,0,0,5,14,19
2019,Mozambique,MOZ,Iceland,ISL,0,0,0,5,5
2019,Nigeria,NGA,Iceland,ISL,0,0,14,43,57
2019,Pakistan,PAK,Iceland,ISL,0,0,13,13,26
2019,Russian Federation,RUS,Iceland,ISL,0,0,0,5,5
2019,Serbia and Kosovo: S/RES/1244 (1999),SRB,Iceland,ISL,0,0,22,0,22
2019,Somalia,SOM,Iceland,ISL,0,0,5,30,35
2019,Sudan,SDN,Iceland,ISL,0,0,0,5,5
2019,Syrian Arab Rep.,SYR,Iceland,ISL,0,5,0,15,20
2019,Tunisia,TUN,Iceland,ISL,0,0,5,10,15
2019,Ukraine,UKR,Iceland,ISL,0,0,18,0,18
2019,Afghanistan,AFG,Ireland,IRL,12,0,0,5,17
2019,Albania,ALB,Ireland,IRL,53,5,250,35,343
2019,Algeria,DZA,Ireland,IRL,0,0,48,5,53
2019,Angola,AGO,Ireland,IRL,0,0,5,0,5
2019,Egypt,EGY,Ireland,IRL,11,0,5,5,21
2019,Burundi,BDI,Ireland,IRL,5,0,0,0,5
2019,Benin,BEN,Ireland,IRL,0,0,5,0,5
2019,Bangladesh,BGD,Ireland,IRL,21,0,98,5,124
2019,Botswana,BWA,Ireland,IRL,5,0,0,5,10
2019,Brazil,BRA,Ireland,IRL,5,0,24,5,34
2019,China,CHN,Ireland,IRL,0,0,5,0,5
2019,Cameroon,CMR,Ireland,IRL,5,0,10,0,15
2019,Congo,COG,Ireland,IRL,0,0,5,0,5
2019,Dem. Rep. of the Congo,COD,Ireland,IRL,24,5,25,15,69
2019,Georgia,GEO,Ireland,IRL,36,5,130,10,181
2019,Ghana,GHA,Ireland,IRL,0,0,18,0,18
2019,India,IND,Ireland,IRL,5,0,24,5,34
2019,Iraq,IRQ,Ireland,IRL,13,5,5,0,23
2019,Sri Lanka,LKA,Ireland,IRL,0,0,5,0,5
2019,Mexico,MEX,Ireland,IRL,5,0,0,0,5
2019,Malawi,MWI,Ireland,IRL,10,0,35,15,60
2019,Mongolia,MNG,Ireland,IRL,0,0,5,0,5
2019,Morocco,MAR,Ireland,IRL,0,0,5,0,5
2019,Mauritius,MUS,Ireland,IRL,0,0,10,0,10
2019,Nepal,NPL,Ireland,IRL,0,0,5,0,5
2019,Nigeria,NGA,Ireland,IRL,24,5,121,26,176
2019,Pakistan,PAK,Ireland,IRL,60,10,207,41,318
2019,Philippines,PHL,Ireland,IRL,0,0,5,0,5
2019,South Africa,ZAF,Ireland,IRL,33,5,42,5,85
2019,Russian Federation,RUS,Ireland,IRL,0,0,5,0,5
2019,Serbia and Kosovo: S/RES/1244 (1999),SRB,Ireland,IRL,0,0,12,0,12
2019,Sierra Leone,SLE,Ireland,IRL,5,0,5,0,10
2019,Viet Nam,VNM,Ireland,IRL,0,0,5,0,5
2019,Sudan,SDN,Ireland,IRL,10,0,0,0,10
2019,Eswatini,SWZ,Ireland,IRL,0,0,5,0,5
2019,Tunisia,TUN,Ireland,IRL,5,0,5,0,10
2019,Ukraine,UKR,Ireland,IRL,5,0,10,5,20
2019,Zimbabwe,ZWE,Ireland,IRL,65,5,90,25,185
2019,China,CHN,Japan,JPN,0,0,55,0,55
2019,India,IND,Japan,JPN,0,0,80,0,80
2019,Indonesia,IDN,Japan,JPN,0,0,596,0,596
2019,Sri Lanka,LKA,Japan,JPN,0,0,403,0,403
2019,Myanmar,MMR,Japan,JPN,0,0,116,0,116
2019,Nepal,NPL,Japan,JPN,0,0,1606,0,1606
2019,Pakistan,PAK,Japan,JPN,0,0,80,0,80
2019,Philippines,PHL,Japan,JPN,0,0,2076,0,2076
2019,Turkey,TUR,Japan,JPN,0,0,435,0,435
2019,Unknown ,,Japan,JPN,0,0,574,2269,2843
2019,Afghanistan,AFG,Kazakhstan,KAZ,0,0,103,25,128
2019,China,CHN,Kazakhstan,KAZ,0,0,0,5,5
2019,Burundi,BDI,Kenya,KEN,0,0,0,52,52
2019,Dem. Rep. of the Congo,COD,Kenya,KEN,20,0,0,65,85
2019,Eritrea,ERI,Kenya,KEN,0,0,0,12,12
2019,Ethiopia,ETH,Kenya,KEN,20,0,0,441,461
2019,Rwanda,RWA,Kenya,KEN,0,0,0,69,69
2019,Somalia,SOM,Kenya,KEN,0,0,0,16,16
2019,Uganda,UGA,Kenya,KEN,0,0,0,39,39
2019,Burundi,BDI,Malawi,MWI,0,0,0,11,11
2019,Rwanda,RWA,Malawi,MWI,0,0,0,10,10
2019,Egypt,EGY,Malta,MLT,0,0,5,0,5
2019,Bangladesh,BGD,Malta,MLT,0,0,89,5,94
2019,Eritrea,ERI,Malta,MLT,0,0,0,20,20
2019,Ethiopia,ETH,Malta,MLT,0,0,0,5,5
2019,Gambia,GMB,Malta,MLT,0,0,0,25,25
2019,Palestinian,PSE,Malta,MLT,0,0,0,5,5
2019,Guinea,GIN,Malta,MLT,0,0,0,5,5
2019,Cote d'Ivoire,CIV,Malta,MLT,0,0,0,5,5
2019,India,IND,Malta,MLT,0,0,0,5,5
2019,Iraq,IRQ,Malta,MLT,0,0,0,5,5
2019,Libya,LBY,Malta,MLT,5,5,10,21,41
2019,Mali,MLI,Malta,MLT,0,0,0,5,5
2019,Nigeria,NGA,Malta,MLT,0,0,10,12,22
2019,Pakistan,PAK,Malta,MLT,0,0,5,5,10
2019,Senegal,SEN,Malta,MLT,0,0,0,5,5
2019,Somalia,SOM,Malta,MLT,0,0,12,203,215
2019,Sudan,SDN,Malta,MLT,0,0,0,5,5
2019,Syrian Arab Rep.,SYR,Malta,MLT,0,0,0,48,48
2019,Ukraine,UKR,Malta,MLT,0,0,0,5,5
2019,Venezuela (Bolivarian Republic of),VEN,Malta,MLT,0,0,5,10,15
2019,Afghanistan,AFG,Norway,NOR,18,0,156,10,184
2019,Albania,ALB,Norway,NOR,0,0,47,0,47
2019,Algeria,DZA,Norway,NOR,0,0,0,5,5
2019,Angola,AGO,Norway,NOR,0,0,0,10,10
2019,Egypt,EGY,Norway,NOR,0,0,5,5,10
2019,Armenia,ARM,Norway,NOR,0,0,5,0,5
2019,Azerbaijan,AZE,Norway,NOR,0,0,0,5,5
2019,Burundi,BDI,Norway,NOR,0,0,5,0,5
2019,Bangladesh,BGD,Norway,NOR,0,0,15,0,15
2019,China,CHN,Norway,NOR,0,0,10,5,15
2019,Cameroon,CMR,Norway,NOR,0,0,5,0,5
2019,Dem. Rep. of the Congo,COD,Norway,NOR,0,0,5,5,10
2019,Colombia,COL,Norway,NOR,0,0,5,0,5
2019,Eritrea,ERI,Norway,NOR,10,0,75,20,105
2019,Ethiopia,ETH,Norway,NOR,0,0,82,11,93
2019,Georgia,GEO,Norway,NOR,0,0,5,0,5
2019,Ghana,GHA,Norway,NOR,0,0,5,5,10
2019,Guinea,GIN,Norway,NOR,0,0,5,0,5
2019,India,IND,Norway,NOR,0,0,5,0,5
2019,Iran (Islamic Rep. of),IRN,Norway,NOR,28,0,124,20,172
2019,Iraq,IRQ,Norway,NOR,5,12,95,22,134
2019,Jordan,JOR,Norway,NOR,0,0,0,5,5
2019,Kazakhstan,KAZ,Norway,NOR,0,0,5,5,10
2019,Kenya,KEN,Norway,NOR,0,0,0,5,5
2019,Libya,LBY,Norway,NOR,0,5,5,5,15
2019,Lebanon,LBN,Norway,NOR,0,0,5,0,5
2019,Sri Lanka,LKA,Norway,NOR,0,0,5,0,5
2019,North Macedonia,MKD,Norway,NOR,0,0,5,0,5
2019,Mongolia,MNG,Norway,NOR,0,0,5,0,5
2019,Morocco,MAR,Norway,NOR,0,0,5,5,10
2019,Myanmar,MMR,Norway,NOR,0,0,5,0,5
2019,Nigeria,NGA,Norway,NOR,0,0,10,5,15
2019,Pakistan,PAK,Norway,NOR,0,0,5,5,10
2019,Philippines,PHL,Norway,NOR,0,0,5,0,5
2019,Russian Federation,RUS,Norway,NOR,5,0,28,20,53
2019,Rwanda,RWA,Norway,NOR,0,0,5,0,5
2019,Saudi Arabia,SAU,Norway,NOR,0,0,0,5,5
2019,Serbia and Kosovo: S/RES/1244 (1999),SRB,Norway,NOR,0,0,16,0,16
2019,Somalia,SOM,Norway,NOR,0,0,72,12,84
2019,Sudan,SDN,Norway,NOR,0,0,10,5,15
2019,Syrian Arab Rep.,SYR,Norway,NOR,5,0,12,43,60
2019,United Rep. of Tanzania,TZA,Norway,NOR,0,0,5,0,5
2019,Tunisia,TUN,Norway,NOR,0,0,10,0,10
2019,Turkey,TUR,Norway,NOR,0,0,23,12,35
2019,Ukraine,UKR,Norway,NOR,0,0,17,0,17
2019,United States of America,USA,Norway,NOR,0,0,5,0,5
2019,Uzbekistan,UZB,Norway,NOR,0,0,10,5,15
2019,Venezuela (Bolivarian Republic of),VEN,Norway,NOR,0,0,5,0,5
2019,Yemen,YEM,Norway,NOR,0,5,0,5,10
2019,Stateless,XXA,Norway,NOR,0,0,35,11,46
2019,Unknown ,,Norway,NOR,0,0,5,0,5
2019,Unknown ,,New Zealand,NZL,129,0,98,12,239
2019,Syrian Arab Rep.,SYR,Paraguay,PRY,5,0,0,0,5
2019,Afghanistan,AFG,Poland,POL,0,0,5,0,5
2019,Egypt,EGY,Poland,POL,0,0,5,0,5
2019,Armenia,ARM,Poland,POL,0,0,19,0,19
2019,Azerbaijan,AZE,Poland,POL,0,0,12,0,12
2019,Bangladesh,BGD,Poland,POL,0,0,5,0,5
2019,Belarus,BLR,Poland,POL,0,0,10,0,10
2019,Georgia,GEO,Poland,POL,0,0,19,0,19
2019,India,IND,Poland,POL,0,0,5,0,5
2019,Iran (Islamic Rep. of),IRN,Poland,POL,0,0,12,0,12
2019,Iraq,IRQ,Poland,POL,0,0,10,0,10
2019,Kazakhstan,KAZ,Poland,POL,0,0,5,0,5
2019,Kyrgyzstan,KGZ,Poland,POL,0,0,5,0,5
2019,Lebanon,LBN,Poland,POL,0,0,5,0,5
2019,Mongolia,MNG,Poland,POL,0,0,5,0,5
2019,Pakistan,PAK,Poland,POL,0,0,17,0,17
2019,Russian Federation,RUS,Poland,POL,0,5,473,0,478
2019,Viet Nam,VNM,Poland,POL,0,0,16,0,16
2019,Tajikistan,TJK,Poland,POL,0,0,27,0,27
2019,Turkey,TUR,Poland,POL,0,0,5,0,5
2019,Ukraine,UKR,Poland,POL,5,0,142,0,147
2019,Uzbekistan,UZB,Poland,POL,0,0,5,0,5
2019,Unknown ,,South Africa,ZAF,59,0,53,22122,22234
2019,Afghanistan,AFG,Sweden,SWE,364,107,5312,420,6203
2019,Albania,ALB,Sweden,SWE,0,0,362,54,416
2019,Algeria,DZA,Sweden,SWE,0,0,53,5,58
2019,Angola,AGO,Sweden,SWE,0,0,28,0,28
2019,Egypt,EGY,Sweden,SWE,0,0,229,57,286
2019,Argentina,ARG,Sweden,SWE,0,0,10,0,10
2019,Armenia,ARM,Sweden,SWE,0,0,169,11,180
2019,Azerbaijan,AZE,Sweden,SWE,5,0,217,71,293
2019,Burundi,BDI,Sweden,SWE,0,0,33,0,33
2019,Bangladesh,BGD,Sweden,SWE,5,0,112,36,153
2019,Belarus,BLR,Sweden,SWE,0,0,69,11,80
2019,Bolivia (Plurinational State of),BOL,Sweden,SWE,0,0,38,5,43
2019,Brazil,BRA,Sweden,SWE,0,0,10,5,15
2019,Bosnia and Herzegovina,BIH,Sweden,SWE,0,0,50,5,55
2019,Canada,CAN,Sweden,SWE,0,0,10,0,10
2019,China,CHN,Sweden,SWE,0,0,24,0,24
2019,Chile,CHL,Sweden,SWE,0,0,33,0,33
2019,Cameroon,CMR,Sweden,SWE,0,0,53,12,65
2019,Congo,COG,Sweden,SWE,0,0,5,0,5
2019,Dem. Rep. of the Congo,COD,Sweden,SWE,0,0,44,0,44
2019,Colombia,COL,Sweden,SWE,0,0,306,32,338
2019,Cuba,CUB,Sweden,SWE,0,0,23,0,23
2019,Djibouti,DJI,Sweden,SWE,0,0,10,0,10
2019,Ecuador,ECU,Sweden,SWE,0,0,10,0,10
2019,Eritrea,ERI,Sweden,SWE,10,0,122,24,156
2019,Ethiopia,ETH,Sweden,SWE,10,0,411,41,462
2019,Gabon,GAB,Sweden,SWE,0,0,5,0,5
2019,Gambia,GMB,Sweden,SWE,5,0,102,5,112
2019,Palestinian,PSE,Sweden,SWE,5,0,126,41,172
2019,Georgia,GEO,Sweden,SWE,0,0,970,89,1059
2019,Ghana,GHA,Sweden,SWE,0,0,35,5,40
2019,Guinea-Bissau,GNB,Sweden,SWE,0,0,5,0,5
2019,Guatemala,GTM,Sweden,SWE,0,0,5,0,5
2019,Guinea,GIN,Sweden,SWE,0,0,33,0,33
2019,Honduras,HND,Sweden,SWE,0,0,13,0,13
2019,Cote d'Ivoire,CIV,Sweden,SWE,0,0,11,0,11
2019,India,IND,Sweden,SWE,0,0,57,5,62
2019,Iran (Islamic Rep. of),IRN,Sweden,SWE,161,5,774,164,1104
2019,Iraq,IRQ,Sweden,SWE,149,36,2318,407,2910
2019,Israel,ISR,Sweden,SWE,0,0,5,0,5
2019,Jordan,JOR,Sweden,SWE,0,0,80,24,104
2019,Kazakhstan,KAZ,Sweden,SWE,0,0,222,13,235
2019,Kenya,KEN,Sweden,SWE,0,0,27,0,27
2019,Kyrgyzstan,KGZ,Sweden,SWE,0,0,177,20,197
2019,Dem. People's Rep. of Korea,PRK,Sweden,SWE,0,0,5,0,5
2019,Kuwait,KWT,Sweden,SWE,0,0,20,0,20
2019,Liberia,LBR,Sweden,SWE,0,0,10,0,10
2019,Libya,LBY,Sweden,SWE,0,0,44,10,54
2019,Lebanon,LBN,Sweden,SWE,5,5,224,24,258
2019,Sri Lanka,LKA,Sweden,SWE,0,0,18,0,18
2019,North Macedonia,MKD,Sweden,SWE,0,0,47,0,47
2019,Rep. of Moldova,MDA,Sweden,SWE,0,0,5,5,10
2019,Mexico,MEX,Sweden,SWE,0,0,11,0,11
2019,Mali,MLI,Sweden,SWE,0,0,5,0,5
2019,Mongolia,MNG,Sweden,SWE,0,0,409,31,440
2019,Morocco,MAR,Sweden,SWE,0,0,201,20,221
2019,Montenegro,MNE,Sweden,SWE,0,0,13,5,18
2019,Nepal,NPL,Sweden,SWE,0,0,16,5,21
2019,Nicaragua,NIC,Sweden,SWE,0,0,262,10,272
2019,Nigeria,NGA,Sweden,SWE,15,0,203,29,247
2019,Pakistan,PAK,Sweden,SWE,11,0,164,42,217
2019,Peru,PER,Sweden,SWE,0,0,176,5,181
2019,Philippines,PHL,Sweden,SWE,0,0,16,0,16
2019,South Africa,ZAF,Sweden,SWE,0,0,10,0,10
2019,Russian Federation,RUS,Sweden,SWE,5,5,260,33,303
2019,Rwanda,RWA,Sweden,SWE,0,0,16,5,21
2019,El Salvador,SLV,Sweden,SWE,10,5,231,10,256
2019,Saudi Arabia,SAU,Sweden,SWE,0,0,5,0,5
2019,Serbia and Kosovo: S/RES/1244 (1999),SRB,Sweden,SWE,0,0,253,30,283
2019,Senegal,SEN,Sweden,SWE,0,0,14,0,14
2019,Sierra Leone,SLE,Sweden,SWE,0,0,12,0,12
2019,Somalia,SOM,Sweden,SWE,55,0,697,54,806
2019,Viet Nam,VNM,Sweden,SWE,0,0,41,0,41
2019,Sudan,SDN,Sweden,SWE,14,0,41,12,67
2019,Syrian Arab Rep.,SYR,Sweden,SWE,0,0,239,94,333
2019,United Rep. of Tanzania,TZA,Sweden,SWE,0,0,20,5,25
2019,Thailand,THA,Sweden,SWE,0,0,13,5,18
2019,Tajikistan,TJK,Sweden,SWE,0,0,51,0,51
2019,Tunisia,TUN,Sweden,SWE,0,0,85,14,99
2019,Turkey,TUR,Sweden,SWE,52,0,199,107,358
2019,Uganda,UGA,Sweden,SWE,5,0,21,5,31
2019,Ukraine,UKR,Sweden,SWE,0,0,502,60,562
2019,United States of America,USA,Sweden,SWE,0,0,18,5,23
2019,Uzbekistan,UZB,Sweden,SWE,0,0,235,40,275
2019,Venezuela (Bolivarian Republic of),VEN,Sweden,SWE,0,0,88,14,102
2019,Yemen,YEM,Sweden,SWE,0,0,18,5,23
2019,Zimbabwe,ZWE,Sweden,SWE,0,0,10,0,10
2019,Stateless,XXA,Sweden,SWE,38,0,366,62,466
2019,Unknown ,,Sweden,SWE,25,0,208,69,302
2019,Eritrea,ERI,Uganda,UGA,12,0,0,0,12
2019,Afghanistan,AFG,United States of America,USA,14,0,5,13,32
2019,Albania,ALB,United States of America,USA,33,0,17,14,64
2019,Algeria,DZA,United States of America,USA,0,0,0,5,5
2019,Angola,AGO,United States of America,USA,11,0,11,17,39
2019,Egypt,EGY,United States of America,USA,145,0,18,47,210
2019,Argentina,ARG,United States of America,USA,0,0,0,10,10
2019,Armenia,ARM,United States of America,USA,14,0,0,28,42
2019,Azerbaijan,AZE,United States of America,USA,21,0,0,5,26
2019,Burundi,BDI,United States of America,USA,36,0,5,0,41
2019,Belgium,BEL,United States of America,USA,0,0,5,0,5
2019,Bangladesh,BGD,United States of America,USA,133,0,33,48,214
2019,Bhutan,BTN,United States of America,USA,5,0,0,5,10
2019,Burkina Faso,BFA,United States of America,USA,70,0,19,23,112
2019,Belarus,BLR,United States of America,USA,23,0,5,19,47
2019,Bolivia (Plurinational State of),BOL,United States of America,USA,10,0,0,0,10
2019,Brazil,BRA,United States of America,USA,13,0,19,90,122
2019,Bosnia and Herzegovina,BIH,United States of America,USA,5,0,5,0,10
2019,Bulgaria,BGR,United States of America,USA,5,0,0,0,5
2019,Chad,TCD,United States of America,USA,5,0,0,0,5
2019,China,CHN,United States of America,USA,1930,0,521,980,3431
2019,Cameroon,CMR,United States of America,USA,35,0,5,21,61
2019,Congo,COG,United States of America,USA,18,0,10,11,39
2019,Dem. Rep. of the Congo,COD,United States of America,USA,28,0,14,18,60
2019,Colombia,COL,United States of America,USA,34,0,49,155,238
2019,Costa Rica,CRI,United States of America,USA,0,0,0,5,5
2019,Cuba,CUB,United States of America,USA,0,0,0,5,5
2019,Djibouti,DJI,United States of America,USA,11,0,0,0,11
2019,Dominican Rep.,DOM,United States of America,USA,5,0,0,10,15
2019,Ecuador,ECU,United States of America,USA,5,0,57,426,488
2019,Eritrea,ERI,United States of America,USA,63,0,0,15,78
2019,Ethiopia,ETH,United States of America,USA,131,0,13,40,184
2019,Fiji,FJI,United States of America,USA,5,0,0,5,10
2019,Gambia,GMB,United States of America,USA,17,0,5,16,38
2019,Palestinian,PSE,United States of America,USA,5,0,5,5,15
2019,Georgia,GEO,United States of America,USA,10,0,5,0,15
2019,Guatemala,GTM,United States of America,USA,41,0,180,418,639
2019,Guinea,GIN,United States of America,USA,45,0,16,17,78
2019,Guyana,GUY,United States of America,USA,0,0,11,0,11
2019,Haiti,HTI,United States of America,USA,23,0,86,100,209
2019,Honduras,HND,United States of America,USA,11,0,85,187,283
2019,Cote d'Ivoire,CIV,United States of America,USA,21,0,10,19,50
2019,India,IND,United States of America,USA,402,0,115,178,695
2019,Indonesia,IDN,United States of America,USA,33,0,10,31,74
2019,Iran (Islamic Rep. of),IRN,United States of America,USA,87,0,5,27,119
2019,Iraq,IRQ,United States of America,USA,109,0,20,71,200
2019,Israel,ISR,United States of America,USA,0,0,0,10,10
2019,Jamaica,JAM,United States of America,USA,0,0,0,5,5
2019,Jordan,JOR,United States of America,USA,14,0,5,33,52
2019,Kazakhstan,KAZ,United States of America,USA,26,0,5,17,48
2019,Kenya,KEN,United States of America,USA,35,0,13,13,61
2019,Kyrgyzstan,KGZ,United States of America,USA,64,0,10,20,94
2019,Rep. of Korea,KOR,United States of America,USA,0,0,0,5,5
2019,Lao People's Dem. Rep.,LAO,United States of America,USA,0,0,0,5,5
2019,Liberia,LBR,United States of America,USA,13,0,5,12,30
2019,Libya,LBY,United States of America,USA,0,0,5,37,42
2019,Lebanon,LBN,United States of America,USA,14,0,5,19,38
2019,Sri Lanka,LKA,United States of America,USA,43,0,18,20,81
2019,Mauritania,MRT,United States of America,USA,18,0,5,17,40
2019,Rep. of Moldova,MDA,United States of America,USA,67,0,5,17,89
2019,Mexico,MEX,United States of America,USA,21,0,277,1847,2145
2019,Mali,MLI,United States of America,USA,23,0,5,15,43
2019,Malaysia,MYS,United States of America,USA,0,0,0,5,5
2019,Malawi,MWI,United States of America,USA,0,0,0,5,5
2019,Mongolia,MNG,United States of America,USA,22,0,12,24,58
2019,Montenegro,MNE,United States of America,USA,0,0,0,5,5
2019,Myanmar,MMR,United States of America,USA,19,0,5,5,29
2019,Nepal,NPL,United States of America,USA,214,0,50,72,336
2019,Niger,NER,United States of America,USA,0,0,0,5,5
2019,Nicaragua,NIC,United States of America,USA,5,0,10,23,38
2019,Nigeria,NGA,United States of America,USA,148,0,25,109,282
2019,Pakistan,PAK,United States of America,USA,101,0,46,78,225
2019,Peru,PER,United States of America,USA,0,0,10,38,48
2019,Philippines,PHL,United States of America,USA,5,0,25,40,70
2019,Poland,POL,United States of America,USA,0,0,0,22,22
2019,Qatar,QAT,United States of America,USA,5,0,0,0,5
2019,Romania,ROU,United States of America,USA,0,0,10,34,44
2019,South Africa,ZAF,United States of America,USA,5,0,0,0,5
2019,Russian Federation,RUS,United States of America,USA,156,0,37,77,270
2019,Rwanda,RWA,United States of America,USA,18,0,10,19,47
2019,El Salvador,SLV,United States of America,USA,27,0,97,355,479
2019,Saudi Arabia,SAU,United States of America,USA,5,0,0,10,15
2019,Serbia and Kosovo: S/RES/1244 (1999),SRB,United States of America,USA,21,0,5,5,31
2019,Senegal,SEN,United States of America,USA,11,0,5,22,38
2019,Sierra Leone,SLE,United States of America,USA,10,0,0,0,10
2019,Viet Nam,VNM,United States of America,USA,10,0,0,0,10
2019,Sudan,SDN,United States of America,USA,16,0,5,16,37
2019,Syrian Arab Rep.,SYR,United States of America,USA,65,0,10,42,117
2019,Thailand,THA,United States of America,USA,0,0,0,11,11
2019,Tajikistan,TJK,United States of America,USA,11,0,0,0,11
2019,Togo,TGO,United States of America,USA,0,0,5,0,5
2019,Trinidad and Tobago,TTO,United States of America,USA,0,0,0,5,5
2019,Turkey,TUR,United States of America,USA,10,0,5,11,26
2019,United Arab Emirates,ARE,United States of America,USA,10,0,0,0,10
2019,Uganda,UGA,United States of America,USA,39,0,5,17,61
2019,Ukraine,UKR,United States of America,USA,83,0,42,75,200
2019,Uruguay,URY,United States of America,USA,0,0,0,5,5
2019,Uzbekistan,UZB,United States of America,USA,15,0,12,34,61
2019,Venezuela (Bolivarian Republic of),VEN,United States of America,USA,376,0,168,460,1004
2019,Yemen,YEM,United States of America,USA,14,0,0,10,24
2019,Zimbabwe,ZWE,United States of America,USA,5,0,0,5,10
2019,Unknown ,,United States of America,USA,254,0,91,2409,2754
2020,Iran (Islamic Rep. of),IRN,Armenia,ARM,0,0,5,0,5
2020,Afghanistan,AFG,Australia,AUS,19,0,51,10,80
2020,Albania,ALB,Australia,AUS,5,0,5,0,10
2020,Egypt,EGY,Australia,AUS,11,0,16,10,37
2020,Bangladesh,BGD,Australia,AUS,5,0,110,20,135
2020,Brazil,BRA,Australia,AUS,5,0,0,0,5
2020,Cambodia,KHM,Australia,AUS,5,0,0,0,5
2020,China,CHN,Australia,AUS,39,0,1023,303,1365
2020,Dem. Rep. of the Congo,COD,Australia,AUS,5,0,0,0,5
2020,Colombia,COL,Australia,AUS,5,0,5,0,10
2020,Ethiopia,ETH,Australia,AUS,0,0,11,0,11
2020,Fiji,FJI,Australia,AUS,10,0,47,83,140
2020,United Kingdom of Great Britain and Northern Ireland,GBR,Australia,AUS,0,0,21,0,21
2020,Germany,DEU,Australia,AUS,5,0,0,0,5
2020,Ghana,GHA,Australia,AUS,5,0,14,0,19
2020,India,IND,Australia,AUS,10,0,145,59,214
2020,Indonesia,IDN,Australia,AUS,0,0,78,29,107
2020,Iran (Islamic Rep. of),IRN,Australia,AUS,78,0,323,11,412
2020,Iraq,IRQ,Australia,AUS,44,0,91,30,165
2020,Jordan,JOR,Australia,AUS,0,0,11,0,11
2020,Kenya,KEN,Australia,AUS,14,0,0,0,14
2020,Rep. of Korea,KOR,Australia,AUS,0,0,20,5,25
2020,Liberia,LBR,Australia,AUS,0,0,5,0,5
2020,Libya,LBY,Australia,AUS,11,0,5,0,16
2020,Lebanon,LBN,Australia,AUS,15,0,45,12,72
2020,Sri Lanka,LKA,Australia,AUS,26,0,355,5,386
2020,Malaysia,MYS,Australia,AUS,65,0,1957,887,2909
2020,Mauritius,MUS,Australia,AUS,5,0,0,0,5
2020,Myanmar,MMR,Australia,AUS,5,0,21,5,31
2020,Nepal,NPL,Australia,AUS,0,0,42,10,52
2020,Nigeria,NGA,Australia,AUS,0,0,12,5,17
2020,Pakistan,PAK,Australia,AUS,25,0,385,35,445
2020,Philippines,PHL,Australia,AUS,0,0,0,5,5
2020,Papua New Guinea,PNG,Australia,AUS,5,0,15,0,20
2020,Portugal,PRT,Australia,AUS,0,0,5,0,5
2020,South Africa,ZAF,Australia,AUS,0,0,0,12,12
2020,Russian Federation,RUS,Australia,AUS,5,0,0,0,5
2020,Rwanda,RWA,Australia,AUS,0,0,5,0,5
2020,Saudi Arabia,SAU,Australia,AUS,0,0,0,5,5
2020,Sierra Leone,SLE,Australia,AUS,0,0,0,10,10
2020,Viet Nam,VNM,Australia,AUS,12,0,102,117,231
2020,Sudan,SDN,Australia,AUS,5,0,5,0,10
2020,Syrian Arab Rep.,SYR,Australia,AUS,11,0,0,0,11
2020,Thailand,THA,Australia,AUS,0,0,217,92,309
2020,Tonga,TON,Australia,AUS,0,0,0,5,5
2020,Turkey,TUR,Australia,AUS,0,0,12,5,17
2020,Uganda,UGA,Australia,AUS,0,0,14,0,14
2020,Ukraine,UKR,Australia,AUS,0,0,10,0,10
2020,Venezuela (Bolivarian Republic of),VEN,Australia,AUS,0,0,5,0,5
2020,Zambia,ZMB,Australia,AUS,5,0,0,0,5
2020,Zimbabwe,ZWE,Australia,AUS,10,0,5,0,15
2020,Stateless,XXA,Australia,AUS,11,0,13,5,29
2020,Unknown ,,Australia,AUS,5,0,0,0,5
2020,Afghanistan,AFG,Canada,CAN,22,0,44,0,83
2020,Albania,ALB,Canada,CAN,28,0,10,5,80
2020,Algeria,DZA,Canada,CAN,0,0,29,5,37
2020,Angola,AGO,Canada,CAN,0,0,38,0,43
2020,Egypt,EGY,Canada,CAN,0,0,36,20,73
2020,Argentina,ARG,Canada,CAN,0,0,0,5,5
2020,Azerbaijan,AZE,Canada,CAN,0,0,5,0,32
2020,Burundi,BDI,Canada,CAN,0,0,0,5,5
2020,Bangladesh,BGD,Canada,CAN,28,0,80,12,124
2020,Bahamas,BHS,Canada,CAN,0,0,27,0,39
2020,Botswana,BWA,Canada,CAN,0,0,5,0,5
2020,Brazil,BRA,Canada,CAN,0,0,62,0,68
2020,Cambodia,KHM,Canada,CAN,13,0,0,0,13
2020,Chad,TCD,Canada,CAN,24,0,0,5,50
2020,China,CHN,Canada,CAN,188,0,607,110,907
2020,Chile,CHL,Canada,CAN,0,0,13,0,37
2020,Cameroon,CMR,Canada,CAN,0,0,57,0,69
2020,Dem. Rep. of the Congo,COD,Canada,CAN,0,0,106,0,140
2020,Colombia,COL,Canada,CAN,65,0,251,42,358
2020,Cuba,CUB,Canada,CAN,0,0,11,0,11
2020,Czechia,CZE,Canada,CAN,0,0,0,13,13
2020,Djibouti,DJI,Canada,CAN,36,0,10,12,78
2020,Dominican Rep.,DOM,Canada,CAN,0,0,0,5,5
2020,Ecuador,ECU,Canada,CAN,0,0,5,0,5
2020,Eritrea,ERI,Canada,CAN,0,0,15,0,55
2020,Ethiopia,ETH,Canada,CAN,78,0,96,10,201
2020,Gambia,GMB,Canada,CAN,0,0,5,0,5
2020,Palestinian,PSE,Canada,CAN,30,0,43,0,86
2020,Georgia,GEO,Canada,CAN,0,0,28,0,40
2020,Germany,DEU,Canada,CAN,0,0,0,5,5
2020,Ghana,GHA,Canada,CAN,0,0,46,5,65
2020,Guatemala,GTM,Canada,CAN,0,0,28,5,35
2020,Guinea,GIN,Canada,CAN,0,0,5,5,10
2020,Guyana,GUY,Canada,CAN,0,0,5,0,5
2020,Haiti,HTI,Canada,CAN,58,0,904,78,1057
2020,Honduras,HND,Canada,CAN,0,0,0,5,31
2020,Croatia,HRV,Canada,CAN,0,0,5,0,5
2020,Hungary,HUN,Canada,CAN,43,0,12,10,80
2020,India,IND,Canada,CAN,87,0,393,11,515
2020,Iran (Islamic Rep. of),IRN,Canada,CAN,100,0,78,5,199
2020,Iraq,IRQ,Canada,CAN,39,0,46,0,95
2020,Israel,ISR,Canada,CAN,0,0,0,5,5
2020,Italy,ITA,Canada,CAN,0,0,13,0,13
2020,Jamaica,JAM,Canada,CAN,0,0,64,5,80
2020,Jordan,JOR,Canada,CAN,23,0,50,0,82
2020,Kenya,KEN,Canada,CAN,22,0,30,0,54
2020,Rep. of Korea,KOR,Canada,CAN,0,0,5,5,10
2020,Dem. People's Rep. of Korea,PRK,Canada,CAN,0,0,18,24,42
2020,Kuwait,KWT,Canada,CAN,0,0,5,0,5
2020,Liberia,LBR,Canada,CAN,0,0,5,0,5
2020,Libya,LBY,Canada,CAN,0,0,5,0,5
2020,Saint Lucia,LCA,Canada,CAN,0,0,12,0,12
2020,Lebanon,LBN,Canada,CAN,0,0,54,12,89
2020,Sri Lanka,LKA,Canada,CAN,86,0,75,22,191
2020,Lithuania,LTU,Canada,CAN,0,0,0,5,5
2020,Mexico,MEX,Canada,CAN,116,0,551,142,809
2020,Malaysia,MYS,Canada,CAN,0,0,0,5,5
2020,Mongolia,MNG,Canada,CAN,0,0,5,0,5
2020,Morocco,MAR,Canada,CAN,0,0,0,5,5
2020,Namibia,NAM,Canada,CAN,0,0,5,5,10
2020,Nepal,NPL,Canada,CAN,0,0,25,0,34
2020,Nigeria,NGA,Canada,CAN,616,0,1954,109,2884
2020,Pakistan,PAK,Canada,CAN,92,0,287,20,436
2020,Peru,PER,Canada,CAN,0,0,0,0,21
2020,Philippines,PHL,Canada,CAN,0,0,13,0,13
2020,Romania,ROU,Canada,CAN,0,0,5,0,42
2020,South Africa,ZAF,Canada,CAN,0,0,0,5,26
2020,Russian Federation,RUS,Canada,CAN,0,0,5,0,5
2020,El Salvador,SLV,Canada,CAN,0,0,59,13,93
2020,Saudi Arabia,SAU,Canada,CAN,0,0,13,10,23
2020,Senegal,SEN,Canada,CAN,0,0,0,5,5
2020,Singapore,SGP,Canada,CAN,0,0,5,0,5
2020,Somalia,SOM,Canada,CAN,42,0,86,0,167
2020,Sudan,SDN,Canada,CAN,0,0,5,0,5
2020,Syrian Arab Rep.,SYR,Canada,CAN,25,0,0,5,40
2020,United Rep. of Tanzania,TZA,Canada,CAN,15,0,21,0,43
2020,Thailand,THA,Canada,CAN,0,0,5,0,5
2020,Trinidad and Tobago,TTO,Canada,CAN,0,0,5,0,5
2020,Tunisia,TUN,Canada,CAN,0,0,0,5,5
2020,Turkey,TUR,Canada,CAN,55,0,49,13,143
2020,United Arab Emirates,ARE,Canada,CAN,0,0,0,5,5
2020,Uganda,UGA,Canada,CAN,19,0,5,5,63
2020,Ukraine,UKR,Canada,CAN,0,0,5,5,46
2020,United States of America,USA,Canada,CAN,12,0,376,25,433
2020,Saint Vincent and the Grenadines,VCT,Canada,CAN,0,0,13,5,18
2020,Venezuela (Bolivarian Republic of),VEN,Canada,CAN,22,0,57,5,91
2020,Zimbabwe,ZWE,Canada,CAN,0,0,15,10,47
2020,Unknown ,,Canada,CAN,370,0,657,656,632
2020,Cuba,CUB,Cayman Islands,CYM,0,0,0,5,5
2020,Colombia,COL,Chile,CHL,0,0,0,58,58
2020,Dominican Rep.,DOM,Chile,CHL,0,0,0,5,5
2020,Colombia,COL,Costa Rica,CRI,0,0,43,5,48
2020,Cuba,CUB,Costa Rica,CRI,0,0,50,0,50
2020,Dominican Rep.,DOM,Costa Rica,CRI,0,0,5,0,5
2020,Ghana,GHA,Costa Rica,CRI,0,0,5,0,5
2020,Haiti,HTI,Costa Rica,CRI,0,0,5,0,5
2020,Nicaragua,NIC,Costa Rica,CRI,0,0,552,10,562
2020,El Salvador,SLV,Costa Rica,CRI,5,0,173,10,188
2020,United States of America,USA,Costa Rica,CRI,0,0,5,0,5
2020,Venezuela (Bolivarian Republic of),VEN,Costa Rica,CRI,5,0,233,16,254
2020,Egypt,EGY,Cyprus,CYP,0,0,74,31,105
2020,Bangladesh,BGD,Cyprus,CYP,0,0,135,12,147
2020,Cameroon,CMR,Cyprus,CYP,0,0,5,0,5
2020,Dem. Rep. of the Congo,COD,Cyprus,CYP,0,0,5,0,5
2020,Gambia,GMB,Cyprus,CYP,0,0,14,5,19
2020,Palestinian,PSE,Cyprus,CYP,0,0,18,39,57
2020,Georgia,GEO,Cyprus,CYP,0,0,10,0,10
2020,India,IND,Cyprus,CYP,0,0,97,0,97
2020,Iraq,IRQ,Cyprus,CYP,22,5,0,71,98
2020,Lebanon,LBN,Cyprus,CYP,0,0,11,0,11
2020,Sri Lanka,LKA,Cyprus,CYP,0,0,74,0,74
2020,Nepal,NPL,Cyprus,CYP,0,0,98,10,108
2020,Nigeria,NGA,Cyprus,CYP,0,0,10,5,15
2020,Pakistan,PAK,Cyprus,CYP,0,0,109,33,142
2020,Philippines,PHL,Cyprus,CYP,0,0,26,0,26
2020,Somalia,SOM,Cyprus,CYP,0,0,0,5,5
2020,Viet Nam,VNM,Cyprus,CYP,0,0,53,0,53
2020,Syrian Arab Rep.,SYR,Cyprus,CYP,0,10,0,0,10
2020,Afghanistan,AFG,Denmark,DNK,5,5,32,0,42
2020,Egypt,EGY,Denmark,DNK,0,0,5,0,5
2020,Armenia,ARM,Denmark,DNK,0,12,0,0,12
2020,Burundi,BDI,Denmark,DNK,0,0,5,0,5
2020,Belarus,BLR,Denmark,DNK,0,0,5,0,5
2020,Cameroon,CMR,Denmark,DNK,0,0,5,0,5
2020,Dem. Rep. of the Congo,COD,Denmark,DNK,0,0,14,0,14
2020,Colombia,COL,Denmark,DNK,0,0,14,0,14
2020,Eritrea,ERI,Denmark,DNK,5,0,14,0,19
2020,Georgia,GEO,Denmark,DNK,0,0,36,0,36
2020,India,IND,Denmark,DNK,0,0,5,0,5
2020,Iran (Islamic Rep. of),IRN,Denmark,DNK,53,5,55,0,113
2020,Iraq,IRQ,Denmark,DNK,5,5,46,0,56
2020,Jordan,JOR,Denmark,DNK,0,0,5,0,5
2020,Kenya,KEN,Denmark,DNK,0,0,5,0,5
2020,Lebanon,LBN,Denmark,DNK,0,5,5,0,10
2020,Sri Lanka,LKA,Denmark,DNK,0,0,10,0,10
2020,Morocco,MAR,Denmark,DNK,0,0,13,0,13
2020,Myanmar,MMR,Denmark,DNK,0,0,10,0,10
2020,Nicaragua,NIC,Denmark,DNK,5,0,18,0,23
2020,Nigeria,NGA,Denmark,DNK,0,0,5,0,5
2020,Pakistan,PAK,Denmark,DNK,0,0,13,0,13
2020,Russian Federation,RUS,Denmark,DNK,5,0,24,0,29
2020,El Salvador,SLV,Denmark,DNK,0,0,5,0,5
2020,Somalia,SOM,Denmark,DNK,15,5,76,0,96
2020,Sudan,SDN,Denmark,DNK,0,0,5,0,5
2020,Syrian Arab Rep.,SYR,Denmark,DNK,10,0,18,0,28
2020,Tunisia,TUN,Denmark,DNK,0,0,5,0,5
2020,Turkey,TUR,Denmark,DNK,5,0,10,0,15
2020,Uganda,UGA,Denmark,DNK,0,0,5,0,5
2020,Ukraine,UKR,Denmark,DNK,0,0,11,0,11
2020,Venezuela (Bolivarian Republic of),VEN,Denmark,DNK,0,0,11,0,11
2020,Yemen,YEM,Denmark,DNK,0,0,5,0,5
2020,Stateless,XXA,Denmark,DNK,0,0,82,0,82
2020,Unknown ,,Denmark,DNK,0,0,5,0,5
2020,Afghanistan,AFG,France,FRA,501,2029,584,25,3139
2020,Albania,ALB,France,FRA,49,81,2382,11,2523
2020,Algeria,DZA,France,FRA,20,20,617,0,657
2020,Angola,AGO,France,FRA,36,18,306,0,360
2020,Egypt,EGY,France,FRA,45,0,92,5,142
2020,Armenia,ARM,France,FRA,18,22,843,10,893
2020,Azerbaijan,AZE,France,FRA,39,0,84,5,128
2020,Burundi,BDI,France,FRA,5,0,32,0,37
2020,Benin,BEN,France,FRA,0,5,29,0,34
2020,Bangladesh,BGD,France,FRA,293,126,1696,5,2120
2020,Burkina Faso,BFA,France,FRA,12,5,54,0,71
2020,Belarus,BLR,France,FRA,14,0,10,0,24
2020,Bolivia (Plurinational State of),BOL,France,FRA,0,0,5,0,5
2020,Brazil,BRA,France,FRA,0,0,12,0,12
2020,Bosnia and Herzegovina,BIH,France,FRA,5,0,182,0,187
2020,Cambodia,KHM,France,FRA,5,0,22,0,27
2020,Central African Rep.,CAF,France,FRA,27,30,116,0,173
2020,Chad,TCD,France,FRA,123,38,356,0,517
2020,China,CHN,France,FRA,5,0,443,5,453
2020,Chile,CHL,France,FRA,0,0,5,0,5
2020,Cameroon,CMR,France,FRA,53,19,186,5,263
2020,Congo,COG,France,FRA,46,14,306,0,366
2020,Dem. Rep. of the Congo,COD,France,FRA,198,68,1030,5,1301
2020,Comoros,COM,France,FRA,0,0,129,0,129
2020,Colombia,COL,France,FRA,5,16,37,0,58
2020,Cuba,CUB,France,FRA,5,0,21,0,26
2020,Djibouti,DJI,France,FRA,5,5,20,0,30
2020,Dominican Rep.,DOM,France,FRA,0,0,71,0,71
2020,Equatorial Guinea,GNQ,France,FRA,0,0,10,0,10
2020,Eritrea,ERI,France,FRA,98,5,66,0,169
2020,Ethiopia,ETH,France,FRA,109,10,162,0,281
2020,Gabon,GAB,France,FRA,14,5,54,0,73
2020,Gambia,GMB,France,FRA,0,5,62,0,67
2020,Palestinian,PSE,France,FRA,37,0,38,0,75
2020,Georgia,GEO,France,FRA,30,20,2519,17,2586
2020,Ghana,GHA,France,FRA,0,0,41,0,41
2020,Guinea-Bissau,GNB,France,FRA,0,0,27,0,27
2020,Guinea,GIN,France,FRA,823,143,3195,24,4185
2020,Haiti,HTI,France,FRA,22,10,1929,0,1961
2020,Honduras,HND,France,FRA,0,5,12,0,17
2020,Cote d'Ivoire,CIV,France,FRA,281,75,1419,16,1791
2020,India,IND,France,FRA,5,0,149,0,154
2020,Iran (Islamic Rep. of),IRN,France,FRA,104,5,71,5,185
2020,Iraq,IRQ,France,FRA,51,22,89,5,167
2020,Jordan,JOR,France,FRA,0,0,5,0,5
2020,Kazakhstan,KAZ,France,FRA,11,0,62,5,78
2020,Kenya,KEN,France,FRA,0,0,13,0,13
2020,Kyrgyzstan,KGZ,France,FRA,0,0,5,0,5
2020,Rep. of Korea,KOR,France,FRA,0,0,5,0,5
2020,Kuwait,KWT,France,FRA,19,0,11,0,30
2020,Lao People's Dem. Rep.,LAO,France,FRA,0,0,5,0,5
2020,Liberia,LBR,France,FRA,5,0,14,0,19
2020,Libya,LBY,France,FRA,29,106,70,0,205
2020,Lebanon,LBN,France,FRA,10,0,37,0,47
2020,Sri Lanka,LKA,France,FRA,252,26,737,10,1025
2020,Madagascar,MDG,France,FRA,0,0,22,0,22
2020,Mauritania,MRT,France,FRA,114,10,638,0,762
2020,North Macedonia,MKD,France,FRA,5,5,151,0,161
2020,Rep. of Moldova,MDA,France,FRA,0,5,126,0,131
2020,Mali,MLI,France,FRA,75,37,1591,5,1708
2020,Malaysia,MYS,France,FRA,5,0,0,0,5
2020,Mongolia,MNG,France,FRA,0,5,65,0,70
2020,Morocco,MAR,France,FRA,26,5,128,5,164
2020,Myanmar,MMR,France,FRA,0,0,10,0,10
2020,Nepal,NPL,France,FRA,10,0,26,0,36
2020,Niger,NER,France,FRA,5,0,28,0,33
2020,Nicaragua,NIC,France,FRA,0,0,5,0,5
2020,Nigeria,NGA,France,FRA,294,45,1594,5,1938
2020,Pakistan,PAK,France,FRA,120,26,1513,5,1664
2020,Peru,PER,France,FRA,0,5,11,0,16
2020,South Africa,ZAF,France,FRA,0,0,11,0,11
2020,Russian Federation,RUS,France,FRA,181,40,656,10,887
2020,Rwanda,RWA,France,FRA,20,0,39,0,59
2020,El Salvador,SLV,France,FRA,0,5,5,0,10
2020,Saudi Arabia,SAU,France,FRA,5,0,0,0,5
2020,Serbia and Kosovo: S/RES/1244 (1999),SRB,France,FRA,47,50,982,5,1084
2020,Senegal,SEN,France,FRA,96,14,737,5,852
2020,Sierra Leone,SLE,France,FRA,33,5,90,0,128
2020,Somalia,SOM,France,FRA,288,488,431,5,1212
2020,Viet Nam,VNM,France,FRA,0,0,13,0,13
2020,Sudan,SDN,France,FRA,440,244,661,13,1358
2020,Suriname,SUR,France,FRA,0,0,5,0,5
2020,South Sudan,SSD,France,FRA,0,12,5,0,17
2020,Syrian Arab Rep.,SYR,France,FRA,459,136,314,10,919
2020,United Rep. of Tanzania,TZA,France,FRA,0,0,5,0,5
2020,Tajikistan,TJK,France,FRA,0,5,21,0,26
2020,Turkmenistan,TKM,France,FRA,0,0,5,0,5
2020,Togo,TGO,France,FRA,14,5,39,0,58
2020,Tunisia,TUN,France,FRA,5,5,53,0,63
2020,Turkey,TUR,France,FRA,395,10,733,5,1143
2020,Uganda,UGA,France,FRA,5,0,5,0,10
2020,Ukraine,UKR,France,FRA,27,5,122,0,154
2020,United States of America,USA,France,FRA,0,0,5,0,5
2020,Uzbekistan,UZB,France,FRA,0,0,5,0,5
2020,Venezuela (Bolivarian Republic of),VEN,France,FRA,5,5,45,0,55
2020,Western Sahara,ESH,France,FRA,18,0,139,0,157
2020,Yemen,YEM,France,FRA,20,30,5,5,60
2020,Zimbabwe,ZWE,France,FRA,0,0,5,0,5
2020,Afghanistan,AFG,Greece,GRC,80,364,2068,159,2671
2020,Albania,ALB,Greece,GRC,0,5,2546,305,2856
2020,Algeria,DZA,Greece,GRC,0,5,235,59,299
2020,Angola,AGO,Greece,GRC,0,0,12,0,12
2020,Egypt,EGY,Greece,GRC,0,0,779,119,898
2020,Armenia,ARM,Greece,GRC,0,0,65,10,75
2020,Burundi,BDI,Greece,GRC,0,0,10,0,10
2020,Bangladesh,BGD,Greece,GRC,5,0,1564,182,1751
2020,Burkina Faso,BFA,Greece,GRC,0,0,23,5,28
2020,Belarus,BLR,Greece,GRC,0,0,12,0,12
2020,China,CHN,Greece,GRC,5,0,192,28,225
2020,Cameroon,CMR,Greece,GRC,25,10,222,13,270
2020,Congo,COG,Greece,GRC,0,0,24,5,29
2020,Dem. Rep. of the Congo,COD,Greece,GRC,46,16,718,39,819
2020,Comoros,COM,Greece,GRC,0,0,5,0,5
2020,Colombia,COL,Greece,GRC,0,0,5,0,5
2020,Cuba,CUB,Greece,GRC,0,0,5,5,10
2020,Dominican Rep.,DOM,Greece,GRC,0,0,5,0,5
2020,Eritrea,ERI,Greece,GRC,5,0,15,0,20
2020,Ethiopia,ETH,Greece,GRC,10,0,70,17,97
2020,Gambia,GMB,Greece,GRC,0,0,79,15,94
2020,Palestinian,PSE,Greece,GRC,5,0,24,0,29
2020,Georgia,GEO,Greece,GRC,0,0,1037,117,1154
2020,Ghana,GHA,Greece,GRC,0,0,102,11,113
2020,Guinea,GIN,Greece,GRC,5,0,55,10,70
2020,Haiti,HTI,Greece,GRC,0,5,13,0,18
2020,Cote d'Ivoire,CIV,Greece,GRC,0,0,20,5,25
2020,India,IND,Greece,GRC,0,0,149,14,163
2020,Indonesia,IDN,Greece,GRC,0,0,14,5,19
2020,Iran (Islamic Rep. of),IRN,Greece,GRC,53,0,347,39,439
2020,Iraq,IRQ,Greece,GRC,102,58,1775,96,2031
2020,Jordan,JOR,Greece,GRC,0,0,10,0,10
2020,Kazakhstan,KAZ,Greece,GRC,0,0,5,0,5
2020,Kenya,KEN,Greece,GRC,0,0,5,5,10
2020,Liberia,LBR,Greece,GRC,0,0,0,5,5
2020,Libya,LBY,Greece,GRC,0,5,5,0,10
2020,Lebanon,LBN,Greece,GRC,0,0,42,5,47
2020,Sri Lanka,LKA,Greece,GRC,0,0,21,0,21
2020,Mauritania,MRT,Greece,GRC,0,0,0,5,5
2020,North Macedonia,MKD,Greece,GRC,0,0,5,0,5
2020,Rep. of Moldova,MDA,Greece,GRC,0,0,20,0,20
2020,Mali,MLI,Greece,GRC,0,10,26,5,41
2020,Morocco,MAR,Greece,GRC,5,0,151,21,177
2020,Myanmar,MMR,Greece,GRC,5,0,10,0,15
2020,Nepal,NPL,Greece,GRC,0,0,64,0,64
2020,Niger,NER,Greece,GRC,0,0,5,5,10
2020,Nigeria,NGA,Greece,GRC,13,5,138,40,196
2020,Pakistan,PAK,Greece,GRC,18,5,5898,784,6705
2020,Paraguay,PRY,Greece,GRC,0,0,5,0,5
2020,Philippines,PHL,Greece,GRC,0,0,5,0,5
2020,Russian Federation,RUS,Greece,GRC,0,0,28,0,28
2020,Rwanda,RWA,Greece,GRC,0,0,5,0,5
2020,El Salvador,SLV,Greece,GRC,0,0,5,0,5
2020,Serbia and Kosovo: S/RES/1244 (1999),SRB,Greece,GRC,0,0,5,5,10
2020,Senegal,SEN,Greece,GRC,0,0,49,12,61
2020,Sierra Leone,SLE,Greece,GRC,0,5,36,5,46
2020,Somalia,SOM,Greece,GRC,5,5,44,0,54
2020,Viet Nam,VNM,Greece,GRC,0,0,5,0,5
2020,Sudan,SDN,Greece,GRC,0,0,29,0,29
2020,Syrian Arab Rep.,SYR,Greece,GRC,74,56,172,1398,1700
2020,United Rep. of Tanzania,TZA,Greece,GRC,0,0,5,0,5
2020,Togo,TGO,Greece,GRC,5,0,49,5,59
2020,Tunisia,TUN,Greece,GRC,0,0,21,5,26
2020,Turkey,TUR,Greece,GRC,5,0,49,5,59
2020,Uganda,UGA,Greece,GRC,5,0,23,0,28
2020,Ukraine,UKR,Greece,GRC,0,0,91,5,96
2020,Uzbekistan,UZB,Greece,GRC,0,0,5,0,5
2020,Venezuela (Bolivarian Republic of),VEN,Greece,GRC,0,0,12,0,12
2020,Yemen,YEM,Greece,GRC,0,0,5,0,5
2020,Zimbabwe,ZWE,Greece,GRC,0,0,11,0,11
2020,Stateless,XXA,Greece,GRC,5,0,12,0,17
2020,Afghanistan,AFG,Iceland,ISL,0,0,5,27,32
2020,Albania,ALB,Iceland,ISL,0,0,13,0,13
2020,Algeria,DZA,Iceland,ISL,0,0,5,0,5
2020,Egypt,EGY,Iceland,ISL,5,0,11,0,16
2020,Azerbaijan,AZE,Iceland,ISL,0,0,0,5,5
2020,Belarus,BLR,Iceland,ISL,0,0,5,0,5
2020,China,CHN,Iceland,ISL,0,0,0,5,5
2020,Chile,CHL,Iceland,ISL,0,0,5,0,5
2020,Dem. Rep. of the Congo,COD,Iceland,ISL,0,0,0,5,5
2020,Colombia,COL,Iceland,ISL,0,0,10,0,10
2020,Palestinian,PSE,Iceland,ISL,0,0,0,10,10
2020,Ghana,GHA,Iceland,ISL,0,0,12,0,12
2020,Iran (Islamic Rep. of),IRN,Iceland,ISL,0,0,0,10,10
2020,Iraq,IRQ,Iceland,ISL,0,0,14,103,117
2020,Libya,LBY,Iceland,ISL,0,0,0,5,5
2020,North Macedonia,MKD,Iceland,ISL,0,0,5,0,5
2020,Rep. of Moldova,MDA,Iceland,ISL,0,0,5,0,5
2020,Morocco,MAR,Iceland,ISL,0,0,10,0,10
2020,Nigeria,NGA,Iceland,ISL,0,0,29,35,64
2020,Pakistan,PAK,Iceland,ISL,0,0,15,5,20
2020,Romania,ROU,Iceland,ISL,0,0,0,5,5
2020,Russian Federation,RUS,Iceland,ISL,5,0,5,0,10
2020,Somalia,SOM,Iceland,ISL,0,0,5,11,16
2020,Syrian Arab Rep.,SYR,Iceland,ISL,0,0,0,16,16
2020,Tunisia,TUN,Iceland,ISL,0,0,5,0,5
2020,Turkey,TUR,Iceland,ISL,0,0,5,0,5
2020,Ukraine,UKR,Iceland,ISL,0,0,10,0,10
2020,Afghanistan,AFG,Ireland,IRL,5,0,0,5,10
2020,Albania,ALB,Ireland,IRL,28,5,84,21,138
2020,Algeria,DZA,Ireland,IRL,0,0,33,5,38
2020,Angola,AGO,Ireland,IRL,5,0,5,0,10
2020,Egypt,EGY,Ireland,IRL,0,0,12,0,12
2020,Bangladesh,BGD,Ireland,IRL,14,0,24,0,38
2020,Botswana,BWA,Ireland,IRL,5,0,0,0,5
2020,Brazil,BRA,Ireland,IRL,5,0,17,0,22
2020,Cameroon,CMR,Ireland,IRL,5,0,0,0,5
2020,Dem. Rep. of the Congo,COD,Ireland,IRL,24,0,21,5,50
2020,Georgia,GEO,Ireland,IRL,10,0,101,10,121
2020,Ghana,GHA,Ireland,IRL,0,0,10,0,10
2020,India,IND,Ireland,IRL,0,0,13,5,18
2020,Iran (Islamic Rep. of),IRN,Ireland,IRL,5,0,0,0,5
2020,Iraq,IRQ,Ireland,IRL,5,0,0,0,5
2020,Lebanon,LBN,Ireland,IRL,0,0,5,0,5
2020,Malaysia,MYS,Ireland,IRL,0,0,5,0,5
2020,Malawi,MWI,Ireland,IRL,12,0,20,0,32
2020,Morocco,MAR,Ireland,IRL,0,0,5,0,5
2020,Mauritius,MUS,Ireland,IRL,5,0,5,0,10
2020,Nepal,NPL,Ireland,IRL,0,0,5,0,5
2020,Nigeria,NGA,Ireland,IRL,24,0,40,11,75
2020,Pakistan,PAK,Ireland,IRL,33,0,95,15,143
2020,South Africa,ZAF,Ireland,IRL,14,0,59,10,83
2020,Russian Federation,RUS,Ireland,IRL,5,0,0,0,5
2020,Sierra Leone,SLE,Ireland,IRL,5,0,0,0,5
2020,Viet Nam,VNM,Ireland,IRL,0,0,5,0,5
2020,Eswatini,SWZ,Ireland,IRL,0,0,5,0,5
2020,Uganda,UGA,Ireland,IRL,5,0,0,0,5
2020,Ukraine,UKR,Ireland,IRL,13,0,0,0,13
2020,Zimbabwe,ZWE,Ireland,IRL,53,0,54,5,112
2020,Unknown ,,Japan,JPN,0,0,5271,1203,6474
2020,Afghanistan,AFG,Kazakhstan,KAZ,0,0,49,0,49
2020,Burundi,BDI,Kenya,KEN,0,0,0,19,19
2020,Dem. Rep. of the Congo,COD,Kenya,KEN,5,0,0,37,42
2020,Eritrea,ERI,Kenya,KEN,0,0,0,5,5
2020,Ethiopia,ETH,Kenya,KEN,0,0,0,275,275
2020,Rwanda,RWA,Kenya,KEN,0,0,0,25,25
2020,Somalia,SOM,Kenya,KEN,0,0,0,275,275
2020,Sudan,SDN,Kenya,KEN,0,0,0,10,10
2020,South Sudan,SSD,Kenya,KEN,0,0,0,32,32
2020,United Rep. of Tanzania,TZA,Kenya,KEN,0,0,0,5,5
2020,Uganda,UGA,Kenya,KEN,0,0,0,10,10
2020,Albania,ALB,Luxembourg,LUX,0,0,10,0,10
2020,Algeria,DZA,Luxembourg,LUX,0,0,10,0,10
2020,Georgia,GEO,Luxembourg,LUX,0,0,10,0,10
2020,Morocco,MAR,Luxembourg,LUX,0,0,5,0,5
2020,Serbia and Kosovo: S/RES/1244 (1999),SRB,Luxembourg,LUX,0,0,5,0,5
2020,Tunisia,TUN,Luxembourg,LUX,0,0,5,0,5
2020,Rwanda,RWA,Malawi,MWI,0,0,0,5,5
2020,Cameroon,CMR,Niger,NER,0,0,5,5,10
2020,Dem. Rep. of the Congo,COD,Niger,NER,0,0,11,0,11
2020,Guinea,GIN,Niger,NER,0,0,0,10,10
2020,Cote d'Ivoire,CIV,Niger,NER,0,0,5,0,5
2020,Nigeria,NGA,Niger,NER,0,0,5,5,10
2020,Sudan,SDN,Niger,NER,5,0,0,0,5
2020,Togo,TGO,Niger,NER,0,0,5,0,5
2020,Afghanistan,AFG,Norway,NOR,5,0,61,5,71
2020,Albania,ALB,Norway,NOR,0,0,23,0,23
2020,Angola,AGO,Norway,NOR,0,0,5,5,10
2020,Egypt,EGY,Norway,NOR,0,0,0,5,5
2020,Azerbaijan,AZE,Norway,NOR,0,0,5,0,5
2020,China,CHN,Norway,NOR,0,0,5,5,10
2020,Cameroon,CMR,Norway,NOR,5,0,0,0,5
2020,Dem. Rep. of the Congo,COD,Norway,NOR,0,0,5,0,5
2020,Colombia,COL,Norway,NOR,0,0,22,0,22
2020,Eritrea,ERI,Norway,NOR,5,0,33,17,55
2020,Ethiopia,ETH,Norway,NOR,0,0,64,5,69
2020,Gambia,GMB,Norway,NOR,0,0,5,0,5
2020,Georgia,GEO,Norway,NOR,0,0,16,0,16
2020,Ghana,GHA,Norway,NOR,0,0,5,0,5
2020,Greece,GRC,Norway,NOR,0,0,5,0,5
2020,Guinea,GIN,Norway,NOR,0,0,0,5,5
2020,Iran (Islamic Rep. of),IRN,Norway,NOR,19,0,135,10,164
2020,Iraq,IRQ,Norway,NOR,10,0,82,5,97
2020,Jordan,JOR,Norway,NOR,0,0,5,0,5
2020,Kyrgyzstan,KGZ,Norway,NOR,0,0,5,0,5
2020,Sri Lanka,LKA,Norway,NOR,0,0,10,0,10
2020,Mexico,MEX,Norway,NOR,0,0,5,0,5
2020,Malaysia,MYS,Norway,NOR,0,0,5,0,5
2020,Morocco,MAR,Norway,NOR,0,0,5,5,10
2020,Myanmar,MMR,Norway,NOR,0,0,5,0,5
2020,Nicaragua,NIC,Norway,NOR,0,0,15,0,15
2020,Nigeria,NGA,Norway,NOR,0,0,5,0,5
2020,Pakistan,PAK,Norway,NOR,0,0,18,14,32
2020,Peru,PER,Norway,NOR,0,0,14,0,14
2020,Poland,POL,Norway,NOR,0,0,5,0,5
2020,Russian Federation,RUS,Norway,NOR,0,0,59,5,64
2020,Serbia and Kosovo: S/RES/1244 (1999),SRB,Norway,NOR,0,0,15,0,15
2020,Somalia,SOM,Norway,NOR,0,0,36,5,41
2020,Viet Nam,VNM,Norway,NOR,0,0,5,0,5
2020,Sudan,SDN,Norway,NOR,0,0,5,0,5
2020,Syrian Arab Rep.,SYR,Norway,NOR,0,0,5,24,29
2020,Tunisia,TUN,Norway,NOR,0,0,5,0,5
2020,Turkey,TUR,Norway,NOR,5,0,23,0,28
2020,Ukraine,UKR,Norway,NOR,0,0,24,0,24
2020,Uzbekistan,UZB,Norway,NOR,0,0,5,0,5
2020,Venezuela (Bolivarian Republic of),VEN,Norway,NOR,0,0,14,5,19
2020,Yemen,YEM,Norway,NOR,0,5,0,0,5
2020,Zimbabwe,ZWE,Norway,NOR,0,0,5,0,5
2020,Stateless,XXA,Norway,NOR,0,0,83,14,97
2020,Unknown ,,Norway,NOR,0,0,5,0,5
2020,Unknown ,,New Zealand,NZL,0,60,79,13,152
2020,Afghanistan,AFG,Poland,POL,0,0,5,0,5
2020,Algeria,DZA,Poland,POL,0,0,10,0,10
2020,Angola,AGO,Poland,POL,0,0,5,0,5
2020,Egypt,EGY,Poland,POL,0,0,5,0,5
2020,Armenia,ARM,Poland,POL,0,0,20,0,20
2020,Azerbaijan,AZE,Poland,POL,0,0,18,0,18
2020,Bangladesh,BGD,Poland,POL,0,0,13,0,13
2020,Belarus,BLR,Poland,POL,0,0,32,0,32
2020,China,CHN,Poland,POL,0,0,5,0,5
2020,Cuba,CUB,Poland,POL,0,0,10,0,10
2020,Ethiopia,ETH,Poland,POL,0,0,5,0,5
2020,Gambia,GMB,Poland,POL,0,0,5,0,5
2020,Georgia,GEO,Poland,POL,0,0,40,0,40
2020,Guinea,GIN,Poland,POL,0,0,5,0,5
2020,India,IND,Poland,POL,0,0,16,0,16
2020,Iran (Islamic Rep. of),IRN,Poland,POL,0,0,10,0,10
2020,Iraq,IRQ,Poland,POL,0,0,10,0,10
2020,Kazakhstan,KAZ,Poland,POL,0,0,41,0,41
2020,Kyrgyzstan,KGZ,Poland,POL,0,0,49,0,49
2020,Lebanon,LBN,Poland,POL,0,5,0,0,5
2020,Rep. of Moldova,MDA,Poland,POL,0,0,5,0,5
2020,Nigeria,NGA,Poland,POL,0,0,10,0,10
2020,Pakistan,PAK,Poland,POL,0,0,5,0,5
2020,Russian Federation,RUS,Poland,POL,0,0,997,0,997
2020,Viet Nam,VNM,Poland,POL,0,0,5,0,5
2020,Tajikistan,TJK,Poland,POL,0,0,48,0,48
2020,Tunisia,TUN,Poland,POL,0,0,5,0,5
2020,Turkey,TUR,Poland,POL,0,0,10,0,10
2020,Uganda,UGA,Poland,POL,0,0,5,0,5
2020,Ukraine,UKR,Poland,POL,0,5,302,0,307
2020,Uzbekistan,UZB,Poland,POL,0,0,5,0,5
2020,Stateless,XXA,Poland,POL,0,0,5,0,5
2020,Afghanistan,AFG,South Africa,ZAF,5,0,0,0,5
2020,Algeria,DZA,South Africa,ZAF,47,0,0,0,47
2020,Angola,AGO,South Africa,ZAF,5,0,0,0,5
2020,Egypt,EGY,South Africa,ZAF,24,0,10,15,49
2020,Burundi,BDI,South Africa,ZAF,129,0,69,138,336
2020,Benin,BEN,South Africa,ZAF,13,0,0,0,13
2020,Bangladesh,BGD,South Africa,ZAF,2115,0,262,1402,3779
2020,Bahamas,BHS,South Africa,ZAF,5,0,0,0,5
2020,China,CHN,South Africa,ZAF,13,0,0,0,13
2020,Cameroon,CMR,South Africa,ZAF,175,0,16,29,220
2020,Congo,COG,South Africa,ZAF,52,0,27,46,125
2020,Dem. Rep. of the Congo,COD,South Africa,ZAF,724,0,207,499,1430
2020,Comoros,COM,South Africa,ZAF,5,0,0,0,5
2020,Eritrea,ERI,South Africa,ZAF,22,0,5,43,70
2020,Estonia,EST,South Africa,ZAF,5,0,0,0,5
2020,Ethiopia,ETH,South Africa,ZAF,2071,0,384,1704,4159
2020,Ghana,GHA,South Africa,ZAF,394,0,30,33,457
2020,Guinea,GIN,South Africa,ZAF,5,0,0,0,5
2020,Cote d'Ivoire,CIV,South Africa,ZAF,5,0,0,5,10
2020,India,IND,South Africa,ZAF,456,0,49,142,647
2020,Jordan,JOR,South Africa,ZAF,5,0,0,0,5
2020,Kenya,KEN,South Africa,ZAF,43,0,5,5,53
2020,Liberia,LBR,South Africa,ZAF,10,0,5,0,15
2020,Lesotho,LSO,South Africa,ZAF,10,0,0,0,10
2020,Mali,MLI,South Africa,ZAF,10,0,0,0,10
2020,Malawi,MWI,South Africa,ZAF,489,0,17,23,529
2020,Mozambique,MOZ,South Africa,ZAF,115,0,12,0,127
2020,Nepal,NPL,South Africa,ZAF,52,0,5,0,57
2020,Niger,NER,South Africa,ZAF,31,0,5,0,36
2020,Nigeria,NGA,South Africa,ZAF,1073,0,63,64,1200
2020,Pakistan,PAK,South Africa,ZAF,1154,0,115,308,1577
2020,Rwanda,RWA,South Africa,ZAF,13,0,13,26,52
2020,Senegal,SEN,South Africa,ZAF,78,0,24,23,125
2020,Somalia,SOM,South Africa,ZAF,176,0,68,205,449
2020,Eswatini,SWZ,South Africa,ZAF,10,0,0,0,10
2020,United Rep. of Tanzania,TZA,South Africa,ZAF,57,0,5,5,67
2020,Thailand,THA,South Africa,ZAF,5,0,0,0,5
2020,Togo,TGO,South Africa,ZAF,5,0,0,0,5
2020,Uganda,UGA,South Africa,ZAF,316,0,25,33,374
2020,Zambia,ZMB,South Africa,ZAF,21,0,5,0,26
2020,Zimbabwe,ZWE,South Africa,ZAF,2050,0,120,53,2223
2020,Yemen,YEM,Sudan,SDN,0,0,0,11,11
2020,Afghanistan,AFG,Sweden,SWE,161,41,1639,126,1967
2020,Albania,ALB,Sweden,SWE,0,0,358,35,393
2020,Algeria,DZA,Sweden,SWE,0,0,31,10,41
2020,Angola,AGO,Sweden,SWE,0,0,10,0,10
2020,Egypt,EGY,Sweden,SWE,5,0,280,47,332
2020,Argentina,ARG,Sweden,SWE,0,0,13,0,13
2020,Armenia,ARM,Sweden,SWE,0,12,128,11,151
2020,Australia,AUS,Sweden,SWE,0,0,5,0,5
2020,Azerbaijan,AZE,Sweden,SWE,0,0,229,68,297
2020,Bahrain,BHR,Sweden,SWE,0,0,0,5,5
2020,Burundi,BDI,Sweden,SWE,0,0,33,0,33
2020,Bangladesh,BGD,Sweden,SWE,0,0,108,38,146
2020,Burkina Faso,BFA,Sweden,SWE,0,0,5,0,5
2020,Belarus,BLR,Sweden,SWE,5,0,43,5,53
2020,Bolivia (Plurinational State of),BOL,Sweden,SWE,0,0,18,5,23
2020,Brazil,BRA,Sweden,SWE,0,0,5,0,5
2020,Bosnia and Herzegovina,BIH,Sweden,SWE,0,0,35,5,40
2020,Bulgaria,BGR,Sweden,SWE,0,0,0,5,5
2020,Chad,TCD,Sweden,SWE,0,0,5,0,5
2020,China,CHN,Sweden,SWE,0,0,20,0,20
2020,Chile,CHL,Sweden,SWE,0,0,54,5,59
2020,Cameroon,CMR,Sweden,SWE,0,0,68,17,85
2020,Congo,COG,Sweden,SWE,0,0,13,0,13
2020,Dem. Rep. of the Congo,COD,Sweden,SWE,0,5,49,5,59
2020,Colombia,COL,Sweden,SWE,0,0,356,27,383
2020,Costa Rica,CRI,Sweden,SWE,0,0,5,0,5
2020,Cuba,CUB,Sweden,SWE,0,0,21,0,21
2020,Djibouti,DJI,Sweden,SWE,0,0,15,0,15
2020,Ecuador,ECU,Sweden,SWE,0,0,18,0,18
2020,Eritrea,ERI,Sweden,SWE,0,0,130,12,142
2020,Ethiopia,ETH,Sweden,SWE,0,0,274,40,314
2020,Gambia,GMB,Sweden,SWE,0,0,81,5,86
2020,Palestinian,PSE,Sweden,SWE,0,0,252,63,315
2020,United Kingdom of Great Britain and Northern Ireland,GBR,Sweden,SWE,0,0,5,0,5
2020,Georgia,GEO,Sweden,SWE,0,0,389,28,417
2020,Ghana,GHA,Sweden,SWE,0,0,50,0,50
2020,Guinea-Bissau,GNB,Sweden,SWE,0,0,5,5,10
2020,Guatemala,GTM,Sweden,SWE,0,0,10,0,10
2020,Guinea,GIN,Sweden,SWE,0,0,19,0,19
2020,Honduras,HND,Sweden,SWE,0,10,31,0,41
2020,Cote d'Ivoire,CIV,Sweden,SWE,0,0,10,0,10
2020,India,IND,Sweden,SWE,0,0,60,11,71
2020,Iran (Islamic Rep. of),IRN,Sweden,SWE,150,5,548,178,881
2020,Iraq,IRQ,Sweden,SWE,69,18,1620,194,1901
2020,Israel,ISR,Sweden,SWE,0,0,10,0,10
2020,Jamaica,JAM,Sweden,SWE,0,0,5,0,5
2020,Jordan,JOR,Sweden,SWE,0,0,141,35,176
2020,Kazakhstan,KAZ,Sweden,SWE,0,0,231,10,241
2020,Kenya,KEN,Sweden,SWE,0,0,32,0,32
2020,Kyrgyzstan,KGZ,Sweden,SWE,0,0,115,5,120
2020,Kuwait,KWT,Sweden,SWE,0,0,0,5,5
2020,Liberia,LBR,Sweden,SWE,0,0,5,0,5
2020,Libya,LBY,Sweden,SWE,0,0,34,10,44
2020,Lebanon,LBN,Sweden,SWE,0,0,244,26,270
2020,Sri Lanka,LKA,Sweden,SWE,0,0,25,5,30
2020,Mauritania,MRT,Sweden,SWE,0,0,5,0,5
2020,North Macedonia,MKD,Sweden,SWE,0,0,59,11,70
2020,Rep. of Moldova,MDA,Sweden,SWE,0,0,10,0,10
2020,Mexico,MEX,Sweden,SWE,0,0,5,0,5
2020,Mali,MLI,Sweden,SWE,0,0,10,0,10
2020,Malaysia,MYS,Sweden,SWE,0,0,0,5,5
2020,Mongolia,MNG,Sweden,SWE,0,0,272,10,282
2020,Morocco,MAR,Sweden,SWE,0,0,148,27,175
2020,Mozambique,MOZ,Sweden,SWE,0,0,5,0,5
2020,Montenegro,MNE,Sweden,SWE,0,0,11,0,11
2020,Nepal,NPL,Sweden,SWE,0,0,11,0,11
2020,Nicaragua,NIC,Sweden,SWE,0,0,277,11,288
2020,Nigeria,NGA,Sweden,SWE,0,0,258,34,292
2020,Pakistan,PAK,Sweden,SWE,5,0,210,28,243
2020,Peru,PER,Sweden,SWE,0,0,153,10,163
2020,Philippines,PHL,Sweden,SWE,0,0,17,0,17
2020,South Africa,ZAF,Sweden,SWE,0,0,10,0,10
2020,Russian Federation,RUS,Sweden,SWE,5,5,263,28,301
2020,Rwanda,RWA,Sweden,SWE,0,0,20,5,25
2020,El Salvador,SLV,Sweden,SWE,5,5,222,5,237
2020,Saudi Arabia,SAU,Sweden,SWE,0,0,0,5,5
2020,Serbia and Kosovo: S/RES/1244 (1999),SRB,Sweden,SWE,0,0,181,45,226
2020,Senegal,SEN,Sweden,SWE,0,0,12,0,12
2020,Sierra Leone,SLE,Sweden,SWE,0,0,15,0,15
2020,Somalia,SOM,Sweden,SWE,19,0,480,32,531
2020,Viet Nam,VNM,Sweden,SWE,0,0,28,5,33
2020,Sudan,SDN,Sweden,SWE,0,0,66,13,79
2020,Syrian Arab Rep.,SYR,Sweden,SWE,5,5,254,82,346
2020,United Rep. of Tanzania,TZA,Sweden,SWE,0,0,38,5,43
2020,Thailand,THA,Sweden,SWE,0,0,10,0,10
2020,Tajikistan,TJK,Sweden,SWE,0,0,53,5,58
2020,Turkmenistan,TKM,Sweden,SWE,5,0,0,0,5
2020,Tunisia,TUN,Sweden,SWE,5,0,55,0,60
2020,Turkey,TUR,Sweden,SWE,19,5,174,51,249
2020,Uganda,UGA,Sweden,SWE,5,0,34,5,44
2020,Ukraine,UKR,Sweden,SWE,5,0,460,52,517
2020,United States of America,USA,Sweden,SWE,0,0,14,5,19
2020,Uzbekistan,UZB,Sweden,SWE,0,0,385,92,477
2020,Venezuela (Bolivarian Republic of),VEN,Sweden,SWE,0,0,153,22,175
2020,Yemen,YEM,Sweden,SWE,0,0,20,11,31
2020,Zambia,ZMB,Sweden,SWE,0,0,5,0,5
2020,Stateless,XXA,Sweden,SWE,13,11,341,78,443
2020,Unknown ,,Sweden,SWE,0,0,198,73,271
2020,Afghanistan,AFG,United States of America,USA,5,0,0,0,5
2020,Albania,ALB,United States of America,USA,27,0,5,12,44
2020,Angola,AGO,United States of America,USA,12,0,23,0,35
2020,Egypt,EGY,United States of America,USA,48,0,16,31,95
2020,Argentina,ARG,United States of America,USA,0,0,0,5,5
2020,Armenia,ARM,United States of America,USA,0,0,0,12,12
2020,Azerbaijan,AZE,United States of America,USA,11,0,0,0,11
2020,Burundi,BDI,United States of America,USA,12,0,5,0,17
2020,Benin,BEN,United States of America,USA,0,0,5,0,5
2020,Bangladesh,BGD,United States of America,USA,63,0,19,43,125
2020,Burkina Faso,BFA,United States of America,USA,27,0,5,0,32
2020,Belarus,BLR,United States of America,USA,13,0,0,11,24
2020,Bolivia (Plurinational State of),BOL,United States of America,USA,0,0,0,10,10
2020,Brazil,BRA,United States of America,USA,0,0,15,68,83
2020,Cambodia,KHM,United States of America,USA,5,0,0,0,5
2020,China,CHN,United States of America,USA,738,0,217,399,1354
2020,Cameroon,CMR,United States of America,USA,16,0,10,24,50
2020,Congo,COG,United States of America,USA,11,0,5,11,27
2020,Dem. Rep. of the Congo,COD,United States of America,USA,10,0,0,19,29
2020,Colombia,COL,United States of America,USA,40,0,44,67,151
2020,Costa Rica,CRI,United States of America,USA,0,0,0,10,10
2020,Dominican Rep.,DOM,United States of America,USA,5,0,0,0,5
2020,Ecuador,ECU,United States of America,USA,5,0,55,475,535
2020,Eritrea,ERI,United States of America,USA,14,0,0,5,19
2020,Ethiopia,ETH,United States of America,USA,31,0,12,20,63
2020,Fiji,FJI,United States of America,USA,0,0,5,0,5
2020,Gabon,GAB,United States of America,USA,5,0,0,0,5
2020,Gambia,GMB,United States of America,USA,5,0,5,13,23
2020,Palestinian,PSE,United States of America,USA,5,0,0,0,5
2020,Georgia,GEO,United States of America,USA,10,0,5,10,25
2020,Guatemala,GTM,United States of America,USA,17,0,111,314,442
2020,Guinea,GIN,United States of America,USA,10,0,0,5,15
2020,Guyana,GUY,United States of America,USA,0,0,0,11,11
2020,Haiti,HTI,United States of America,USA,12,0,33,48,93
2020,Honduras,HND,United States of America,USA,11,0,49,103,163
2020,Cote d'Ivoire,CIV,United States of America,USA,12,0,5,5,22
2020,India,IND,United States of America,USA,183,0,77,88,348
2020,Indonesia,IDN,United States of America,USA,10,0,12,22,44
2020,Iran (Islamic Rep. of),IRN,United States of America,USA,23,0,0,10,33
2020,Iraq,IRQ,United States of America,USA,61,0,10,37,108
2020,Jamaica,JAM,United States of America,USA,0,0,0,5,5
2020,Jordan,JOR,United States of America,USA,0,0,5,13,18
2020,Kazakhstan,KAZ,United States of America,USA,11,0,5,11,27
2020,Kenya,KEN,United States of America,USA,13,0,0,5,18
2020,Kyrgyzstan,KGZ,United States of America,USA,29,0,10,0,39
2020,Kuwait,KWT,United States of America,USA,0,0,5,0,5
2020,Lao People's Dem. Rep.,LAO,United States of America,USA,0,0,0,5,5
2020,Liberia,LBR,United States of America,USA,13,0,0,26,39
2020,Libya,LBY,United States of America,USA,12,0,10,10,32
2020,Sri Lanka,LKA,United States of America,USA,20,0,5,5,30
2020,Rep. of Moldova,MDA,United States of America,USA,18,0,10,5,33
2020,Mexico,MEX,United States of America,USA,11,0,165,1149,1325
2020,Mali,MLI,United States of America,USA,13,0,0,0,13
2020,Malaysia,MYS,United States of America,USA,0,0,0,5,5
2020,Mongolia,MNG,United States of America,USA,5,0,0,11,16
2020,Morocco,MAR,United States of America,USA,0,0,0,5,5
2020,Myanmar,MMR,United States of America,USA,10,0,0,0,10
2020,Nepal,NPL,United States of America,USA,86,0,17,30,133
2020,Nicaragua,NIC,United States of America,USA,5,0,10,5,20
2020,Nigeria,NGA,United States of America,USA,111,0,33,48,192
2020,Oman,OMN,United States of America,USA,5,0,0,0,5
2020,Pakistan,PAK,United States of America,USA,30,0,19,44,93
2020,Peru,PER,United States of America,USA,0,0,10,41,51
2020,Philippines,PHL,United States of America,USA,5,0,5,35,45
2020,Poland,POL,United States of America,USA,0,0,0,23,23
2020,Romania,ROU,United States of America,USA,5,0,5,11,21
2020,South Africa,ZAF,United States of America,USA,0,0,10,0,10
2020,Russian Federation,RUS,United States of America,USA,63,0,13,40,116
2020,Rwanda,RWA,United States of America,USA,22,0,10,0,32
2020,El Salvador,SLV,United States of America,USA,19,0,87,338,444
2020,Saudi Arabia,SAU,United States of America,USA,14,0,0,0,14
2020,Serbia and Kosovo: S/RES/1244 (1999),SRB,United States of America,USA,14,0,5,0,19
2020,Senegal,SEN,United States of America,USA,0,0,0,11,11
2020,Sierra Leone,SLE,United States of America,USA,5,0,0,0,5
2020,Somalia,SOM,United States of America,USA,0,0,0,5,5
2020,Sudan,SDN,United States of America,USA,5,0,0,0,5
2020,Syrian Arab Rep.,SYR,United States of America,USA,28,0,0,10,38
2020,Tajikistan,TJK,United States of America,USA,5,0,0,0,5
2020,Turkey,TUR,United States of America,USA,5,0,0,0,5
2020,United Arab Emirates,ARE,United States of America,USA,0,0,0,5,5
2020,Uganda,UGA,United States of America,USA,24,0,5,17,46
2020,Ukraine,UKR,United States of America,USA,49,0,13,46,108
2020,Uzbekistan,UZB,United States of America,USA,23,0,5,5,33
2020,Venezuela (Bolivarian Republic of),VEN,United States of America,USA,265,0,160,171,596
2020,Yemen,YEM,United States of America,USA,14,0,0,0,14
2020,Zimbabwe,ZWE,United States of America,USA,5,0,0,0,5
2020,Unknown ,,United States of America,USA,123,0,74,282,479
2000,Afghanistan,AFG,United Kingdom of Great Britain and Northern Ireland,GBR,0,10,0,0,10
2000,Albania,ALB,United Kingdom of Great Britain and Northern Ireland,GBR,0,5,0,0,5
2000,Algeria,DZA,United Kingdom of Great Britain and Northern Ireland,GBR,0,415,0,85,500
2000,Angola,AGO,United Kingdom of Great Britain and Northern Ireland,GBR,0,240,0,90,330
2000,Bangladesh,BGD,United Kingdom of Great Britain and Northern Ireland,GBR,0,290,0,35,325
2000,China,CHN,United Kingdom of Great Britain and Northern Ireland,GBR,0,165,0,45,210
2000,Dem. Rep. of the Congo,COD,United Kingdom of Great Britain and Northern Ireland,GBR,0,610,0,75,685
2000,Colombia,COL,United Kingdom of Great Britain and Northern Ireland,GBR,0,180,0,10,190
2000,Ecuador,ECU,United Kingdom of Great Britain and Northern Ireland,GBR,0,100,0,5,105
2000,Ethiopia,ETH,United Kingdom of Great Britain and Northern Ireland,GBR,0,390,0,30,420
2000,Gambia,GMB,United Kingdom of Great Britain and Northern Ireland,GBR,0,30,0,5,35
2000,Ghana,GHA,United Kingdom of Great Britain and Northern Ireland,GBR,0,90,0,35,125
2000,Cote d'Ivoire,CIV,United Kingdom of Great Britain and Northern Ireland,GBR,0,70,0,5,75
2000,India,IND,United Kingdom of Great Britain and Northern Ireland,GBR,0,175,0,50,225
2000,Iran (Islamic Rep. of),IRN,United Kingdom of Great Britain and Northern Ireland,GBR,0,210,0,25,235
2000,Iraq,IRQ,United Kingdom of Great Britain and Northern Ireland,GBR,0,10,0,0,10
2000,Kenya,KEN,United Kingdom of Great Britain and Northern Ireland,GBR,0,625,0,70,695
2000,Sri Lanka,LKA,United Kingdom of Great Britain and Northern Ireland,GBR,0,895,0,100,995
2000,Nigeria,NGA,United Kingdom of Great Britain and Northern Ireland,GBR,0,290,0,45,335
2000,Pakistan,PAK,United Kingdom of Great Britain and Northern Ireland,GBR,0,685,0,65,750
2000,Poland,POL,United Kingdom of Great Britain and Northern Ireland,GBR,0,10,0,10,20
2000,Romania,ROU,United Kingdom of Great Britain and Northern Ireland,GBR,0,45,0,30,75
2000,Russian Federation,RUS,United Kingdom of Great Britain and Northern Ireland,GBR,0,185,0,35,220
2000,Rwanda,RWA,United Kingdom of Great Britain and Northern Ireland,GBR,0,30,0,0,30
2000,Serbia and Kosovo: S/RES/1244 (1999),SRB,United Kingdom of Great Britain and Northern Ireland,GBR,0,165,0,35,200
2000,Sierra Leone,SLE,United Kingdom of Great Britain and Northern Ireland,GBR,0,365,0,40,405
2000,Somalia,SOM,United Kingdom of Great Britain and Northern Ireland,GBR,0,55,0,15,70
2000,Sudan,SDN,United Kingdom of Great Britain and Northern Ireland,GBR,0,300,0,20,320
2000,United Rep. of Tanzania,TZA,United Kingdom of Great Britain and Northern Ireland,GBR,0,80,0,5,85
2000,Turkey,TUR,United Kingdom of Great Britain and Northern Ireland,GBR,0,1215,0,80,1295
2000,Uganda,UGA,United Kingdom of Great Britain and Northern Ireland,GBR,0,195,0,10,205
2000,Ukraine,UKR,United Kingdom of Great Britain and Northern Ireland,GBR,0,155,0,20,175
2000,Zimbabwe,ZWE,United Kingdom of Great Britain and Northern Ireland,GBR,0,35,0,5,40
2000,Unknown ,,United Kingdom of Great Britain and Northern Ireland,GBR,0,2005,0,245,2250
2006,Unknown ,,South Africa,ZAF,4674,0,24651,0,29325
2007,Afghanistan,AFG,Italy,ITA,5,5,0,22,32
2007,Albania,ALB,Italy,ITA,0,17,5,10,32
2007,Algeria,DZA,Italy,ITA,0,0,0,5,5
2007,Armenia,ARM,Italy,ITA,0,0,5,0,5
2007,Azerbaijan,AZE,Italy,ITA,5,5,0,5,15
2007,Bangladesh,BGD,Italy,ITA,0,231,65,162,458
2007,Burkina Faso,BFA,Italy,ITA,0,5,0,0,5
2007,Belarus,BLR,Italy,ITA,0,5,0,5,10
2007,Bosnia and Herzegovina,BIH,Italy,ITA,0,5,0,5,10
2007,Central African Rep.,CAF,Italy,ITA,0,5,0,0,5
2007,China,CHN,Italy,ITA,0,11,0,16,27
2007,Cameroon,CMR,Italy,ITA,5,22,0,10,37
2007,Congo,COG,Italy,ITA,5,11,0,5,21
2007,Dem. Rep. of the Congo,COD,Italy,ITA,5,5,0,5,15
2007,Colombia,COL,Italy,ITA,0,16,5,20,41
2007,Eritrea,ERI,Italy,ITA,19,117,5,387,528
2007,Ethiopia,ETH,Italy,ITA,10,60,0,70,140
2007,Gambia,GMB,Italy,ITA,0,5,0,23,28
2007,Palestinian,PSE,Italy,ITA,0,5,5,82,92
2007,Georgia,GEO,Italy,ITA,0,5,0,18,23
2007,Ghana,GHA,Italy,ITA,0,109,5,34,148
2007,Cote d'Ivoire,CIV,Italy,ITA,5,80,5,28,118
2007,India,IND,Italy,ITA,0,16,11,59,86
2007,Iran (Islamic Rep. of),IRN,Italy,ITA,5,10,0,24,39
2007,Iraq,IRQ,Italy,ITA,5,10,0,102,117
2007,Liberia,LBR,Italy,ITA,0,394,46,111,551
2007,Libya,LBY,Italy,ITA,0,0,0,5,5
2007,Sri Lanka,LKA,Italy,ITA,0,49,0,165,214
2007,North Macedonia,MKD,Italy,ITA,0,136,30,65,231
2007,Rep. of Moldova,MDA,Italy,ITA,0,40,10,20,70
2007,Mali,MLI,Italy,ITA,0,5,0,5,10
2007,Morocco,MAR,Italy,ITA,0,5,0,10,15
2007,Niger,NER,Italy,ITA,0,0,0,5,5
2007,Nigeria,NGA,Italy,ITA,0,317,156,306,779
2007,Pakistan,PAK,Italy,ITA,0,167,35,491,693
2007,Romania,ROU,Italy,ITA,0,0,0,5,5
2007,South Africa,ZAF,Italy,ITA,0,0,0,5,5
2007,Russian Federation,RUS,Italy,ITA,0,14,10,17,41
2007,Serbia and Kosovo: S/RES/1244 (1999),SRB,Italy,ITA,5,1607,104,418,2134
2007,Senegal,SEN,Italy,ITA,0,10,0,14,24
2007,Sierra Leone,SLE,Italy,ITA,0,53,23,43,119
2007,Somalia,SOM,Italy,ITA,5,26,0,460,491
2007,Viet Nam,VNM,Italy,ITA,0,5,0,0,5
2007,Sudan,SDN,Italy,ITA,13,175,16,141,345
2007,Togo,TGO,Italy,ITA,5,22,0,5,32
2007,Tunisia,TUN,Italy,ITA,0,0,0,5,5
2007,Turkey,TUR,Italy,ITA,5,156,15,66,242
2007,Ukraine,UKR,Italy,ITA,0,33,5,42,80
2007,Uruguay,URY,Italy,ITA,0,0,0,5,5
2007,Zimbabwe,ZWE,Italy,ITA,0,5,0,0,5
2000,Afghanistan,AFG,Switzerland,CHE,0,46,0,0,46
2000,Albania,ALB,Switzerland,CHE,0,10,0,0,10
2000,Algeria,DZA,Switzerland,CHE,0,42,0,0,42
2000,Angola,AGO,Switzerland,CHE,0,166,0,0,166
2000,Armenia,ARM,Switzerland,CHE,0,5,0,0,5
2000,Burundi,BDI,Switzerland,CHE,0,5,0,0,5
2000,Bangladesh,BGD,Switzerland,CHE,0,20,0,0,20
2000,Bolivia (Plurinational State of),BOL,Switzerland,CHE,0,5,0,0,5
2000,Bosnia and Herzegovina,BIH,Switzerland,CHE,0,265,0,0,265
2000,Cambodia,KHM,Switzerland,CHE,0,5,0,0,5
2000,China,CHN,Switzerland,CHE,0,10,0,0,10
2000,Chile,CHL,Switzerland,CHE,0,15,0,0,15
2000,Cameroon,CMR,Switzerland,CHE,0,13,0,0,13
2000,Congo,COG,Switzerland,CHE,0,5,0,0,5
2000,Dem. Rep. of the Congo,COD,Switzerland,CHE,0,80,0,0,80
2000,Colombia,COL,Switzerland,CHE,0,5,0,0,5
2000,Cuba,CUB,Switzerland,CHE,0,10,0,0,10
2000,Ecuador,ECU,Switzerland,CHE,0,5,0,0,5
2000,Eritrea,ERI,Switzerland,CHE,0,67,0,0,67
2000,Ethiopia,ETH,Switzerland,CHE,0,82,0,0,82
2000,Ghana,GHA,Switzerland,CHE,0,15,0,0,15
2000,Guinea-Bissau,GNB,Switzerland,CHE,0,5,0,0,5
2000,Guinea,GIN,Switzerland,CHE,0,5,0,0,5
2000,Croatia,HRV,Switzerland,CHE,0,22,0,0,22
2000,Cote d'Ivoire,CIV,Switzerland,CHE,0,17,0,0,17
2000,India,IND,Switzerland,CHE,0,5,0,0,5
2000,Iran (Islamic Rep. of),IRN,Switzerland,CHE,0,30,0,0,30
2000,Iraq,IRQ,Switzerland,CHE,0,20,0,0,20
2000,Liberia,LBR,Switzerland,CHE,0,5,0,0,5
2000,Lebanon,LBN,Switzerland,CHE,0,26,0,0,26
2000,Sri Lanka,LKA,Switzerland,CHE,0,2047,0,0,2047
2000,North Macedonia,MKD,Switzerland,CHE,0,11,0,0,11
2000,Nigeria,NGA,Switzerland,CHE,0,38,0,0,38
2000,Pakistan,PAK,Switzerland,CHE,0,43,0,0,43
2000,Romania,ROU,Switzerland,CHE,0,13,0,0,13
2000,Russian Federation,RUS,Switzerland,CHE,0,5,0,0,5
2000,Rwanda,RWA,Switzerland,CHE,0,11,0,0,11
2000,Serbia and Kosovo: S/RES/1244 (1999),SRB,Switzerland,CHE,0,1894,0,0,1894
2000,Sierra Leone,SLE,Switzerland,CHE,0,5,0,0,5
2000,Somalia,SOM,Switzerland,CHE,0,73,0,0,73
2000,Viet Nam,VNM,Switzerland,CHE,0,5,0,0,5
2000,Sudan,SDN,Switzerland,CHE,0,10,0,0,10
2000,Syrian Arab Rep.,SYR,Switzerland,CHE,0,21,0,0,21
2000,Togo,TGO,Switzerland,CHE,0,10,0,0,10
2000,Tunisia,TUN,Switzerland,CHE,0,5,0,0,5
2000,Turkey,TUR,Switzerland,CHE,0,331,0,0,331
2000,Stateless,XXA,Switzerland,CHE,0,5,0,0,5
2001,Afghanistan,AFG,Switzerland,CHE,0,41,0,0,41
2001,Albania,ALB,Switzerland,CHE,0,15,0,0,15
2001,Algeria,DZA,Switzerland,CHE,0,61,0,0,61
2001,Angola,AGO,Switzerland,CHE,0,194,0,0,194
2001,Armenia,ARM,Switzerland,CHE,0,12,0,0,12
2001,Bangladesh,BGD,Switzerland,CHE,0,30,0,0,30
2001,Bosnia and Herzegovina,BIH,Switzerland,CHE,0,549,0,0,549
2001,Dem. Rep. of the Congo,COD,Switzerland,CHE,0,133,0,0,133
2001,Colombia,COL,Switzerland,CHE,0,15,0,0,15
2001,Eritrea,ERI,Switzerland,CHE,0,111,0,0,111
2001,Ethiopia,ETH,Switzerland,CHE,0,92,0,0,92
2001,Guinea,GIN,Switzerland,CHE,0,5,0,0,5
2001,India,IND,Switzerland,CHE,0,18,0,0,18
2001,Iran (Islamic Rep. of),IRN,Switzerland,CHE,0,55,0,0,55
2001,Iraq,IRQ,Switzerland,CHE,0,30,0,0,30
2001,Lebanon,LBN,Switzerland,CHE,0,20,0,0,20
2001,Sri Lanka,LKA,Switzerland,CHE,0,6457,0,0,6457
2001,Pakistan,PAK,Switzerland,CHE,0,20,0,0,20
2001,Russian Federation,RUS,Switzerland,CHE,0,11,0,0,11
2001,Serbia and Kosovo: S/RES/1244 (1999),SRB,Switzerland,CHE,0,2262,0,0,2262
2001,Sierra Leone,SLE,Switzerland,CHE,0,5,0,0,5
2001,Somalia,SOM,Switzerland,CHE,0,164,0,0,164
2001,Syrian Arab Rep.,SYR,Switzerland,CHE,0,15,0,0,15
2001,Turkey,TUR,Switzerland,CHE,0,395,0,0,395
2001,Unknown ,,Switzerland,CHE,0,301,0,0,301
2002,Afghanistan,AFG,Switzerland,CHE,0,45,0,0,45
2002,Albania,ALB,Switzerland,CHE,0,10,0,0,10
2002,Algeria,DZA,Switzerland,CHE,0,56,0,0,56
2002,Angola,AGO,Switzerland,CHE,0,192,0,0,192
2002,Bangladesh,BGD,Switzerland,CHE,0,43,0,0,43
2002,Bosnia and Herzegovina,BIH,Switzerland,CHE,0,629,0,0,629
2002,Dem. Rep. of the Congo,COD,Switzerland,CHE,0,163,0,0,163
2002,Colombia,COL,Switzerland,CHE,0,5,0,0,5
2002,Eritrea,ERI,Switzerland,CHE,0,115,0,0,115
2002,Ethiopia,ETH,Switzerland,CHE,0,79,0,0,79
2002,Georgia,GEO,Switzerland,CHE,0,5,0,0,5
2002,Guinea,GIN,Switzerland,CHE,0,5,0,0,5
2002,India,IND,Switzerland,CHE,0,17,0,0,17
2002,Iran (Islamic Rep. of),IRN,Switzerland,CHE,0,78,0,0,78
2002,Iraq,IRQ,Switzerland,CHE,0,82,0,0,82
2002,Lebanon,LBN,Switzerland,CHE,0,14,0,0,14
2002,Sri Lanka,LKA,Switzerland,CHE,0,4157,0,0,4157
2002,Pakistan,PAK,Switzerland,CHE,0,37,0,0,37
2002,Russian Federation,RUS,Switzerland,CHE,0,10,0,0,10
2002,Serbia and Kosovo: S/RES/1244 (1999),SRB,Switzerland,CHE,0,1999,0,0,1999
2002,Sierra Leone,SLE,Switzerland,CHE,0,10,0,0,10
2002,Somalia,SOM,Switzerland,CHE,0,262,0,0,262
2002,Syrian Arab Rep.,SYR,Switzerland,CHE,0,27,0,0,27
2002,Turkey,TUR,Switzerland,CHE,0,346,0,0,346
2002,Unknown ,,Switzerland,CHE,0,341,0,0,341
2003,Afghanistan,AFG,Switzerland,CHE,0,42,0,0,42
2003,Albania,ALB,Switzerland,CHE,0,11,0,0,11
2003,Algeria,DZA,Switzerland,CHE,0,63,0,0,63
2003,Angola,AGO,Switzerland,CHE,0,294,0,0,294
2003,Armenia,ARM,Switzerland,CHE,0,13,0,0,13
2003,Bangladesh,BGD,Switzerland,CHE,0,99,0,0,99
2003,Bosnia and Herzegovina,BIH,Switzerland,CHE,0,514,0,0,514
2003,Dem. Rep. of the Congo,COD,Switzerland,CHE,0,142,0,0,142
2003,Colombia,COL,Switzerland,CHE,0,13,0,0,13
2003,Eritrea,ERI,Switzerland,CHE,0,46,0,0,46
2003,Ethiopia,ETH,Switzerland,CHE,0,71,0,0,71
2003,Guinea,GIN,Switzerland,CHE,0,20,0,0,20
2003,India,IND,Switzerland,CHE,0,5,0,0,5
2003,Iran (Islamic Rep. of),IRN,Switzerland,CHE,0,59,0,0,59
2003,Iraq,IRQ,Switzerland,CHE,0,72,0,0,72
2003,Lebanon,LBN,Switzerland,CHE,0,20,0,0,20
2003,Sri Lanka,LKA,Switzerland,CHE,0,1655,0,0,1655
2003,Pakistan,PAK,Switzerland,CHE,0,37,0,0,37
2003,Russian Federation,RUS,Switzerland,CHE,0,10,0,0,10
2003,Serbia and Kosovo: S/RES/1244 (1999),SRB,Switzerland,CHE,0,1629,0,0,1629
2003,Sierra Leone,SLE,Switzerland,CHE,0,10,0,0,10
2003,Somalia,SOM,Switzerland,CHE,0,223,0,0,223
2003,Syrian Arab Rep.,SYR,Switzerland,CHE,0,23,0,0,23
2003,Turkey,TUR,Switzerland,CHE,0,308,0,0,308
2003,Unknown ,,Switzerland,CHE,0,469,0,0,469
2004,Afghanistan,AFG,Switzerland,CHE,0,83,0,0,83
2004,Albania,ALB,Switzerland,CHE,0,16,0,0,16
2004,Algeria,DZA,Switzerland,CHE,0,52,0,0,52
2004,Angola,AGO,Switzerland,CHE,0,254,0,0,254
2004,Armenia,ARM,Switzerland,CHE,0,12,0,0,12
2004,Azerbaijan,AZE,Switzerland,CHE,0,5,0,0,5
2004,Burundi,BDI,Switzerland,CHE,0,15,0,0,15
2004,Benin,BEN,Switzerland,CHE,0,5,0,0,5
2004,Bangladesh,BGD,Switzerland,CHE,0,117,0,0,117
2004,Burkina Faso,BFA,Switzerland,CHE,0,14,0,0,14
2004,Bosnia and Herzegovina,BIH,Switzerland,CHE,0,545,0,0,545
2004,Chad,TCD,Switzerland,CHE,0,5,0,0,5
2004,Cameroon,CMR,Switzerland,CHE,0,59,0,0,59
2004,Congo,COG,Switzerland,CHE,0,5,0,0,5
2004,Dem. Rep. of the Congo,COD,Switzerland,CHE,0,145,0,0,145
2004,Colombia,COL,Switzerland,CHE,0,5,0,0,5
2004,Cuba,CUB,Switzerland,CHE,0,5,0,0,5
2004,Ecuador,ECU,Switzerland,CHE,0,5,0,0,5
2004,Eritrea,ERI,Switzerland,CHE,0,22,0,0,22
2004,Ethiopia,ETH,Switzerland,CHE,0,70,0,0,70
2004,Gambia,GMB,Switzerland,CHE,0,5,0,0,5
2004,Georgia,GEO,Switzerland,CHE,0,5,0,0,5
2004,Ghana,GHA,Switzerland,CHE,0,5,0,0,5
2004,Guinea,GIN,Switzerland,CHE,0,34,0,0,34
2004,Croatia,HRV,Switzerland,CHE,0,14,0,0,14
2004,Cote d'Ivoire,CIV,Switzerland,CHE,0,21,0,0,21
2004,India,IND,Switzerland,CHE,0,5,0,0,5
2004,Iran (Islamic Rep. of),IRN,Switzerland,CHE,0,41,0,0,41
2004,Iraq,IRQ,Switzerland,CHE,0,93,0,0,93
2004,Jordan,JOR,Switzerland,CHE,0,5,0,0,5
2004,Kyrgyzstan,KGZ,Switzerland,CHE,0,5,0,0,5
2004,Kuwait,KWT,Switzerland,CHE,0,5,0,0,5
2004,Lao People's Dem. Rep.,LAO,Switzerland,CHE,0,5,0,0,5
2004,Liberia,LBR,Switzerland,CHE,0,5,0,0,5
2004,Libya,LBY,Switzerland,CHE,0,5,0,0,5
2004,Lebanon,LBN,Switzerland,CHE,0,34,0,0,34
2004,Sri Lanka,LKA,Switzerland,CHE,0,815,0,0,815
2004,North Macedonia,MKD,Switzerland,CHE,0,35,0,0,35
2004,Rep. of Moldova,MDA,Switzerland,CHE,0,5,0,0,5
2004,Nigeria,NGA,Switzerland,CHE,0,89,0,0,89
2004,Pakistan,PAK,Switzerland,CHE,0,62,0,0,62
2004,Russian Federation,RUS,Switzerland,CHE,0,34,0,0,34
2004,Rwanda,RWA,Switzerland,CHE,0,16,0,0,16
2004,Serbia and Kosovo: S/RES/1244 (1999),SRB,Switzerland,CHE,0,1300,0,0,1300
2004,Senegal,SEN,Switzerland,CHE,0,5,0,0,5
2004,Sierra Leone,SLE,Switzerland,CHE,0,5,0,0,5
2004,Somalia,SOM,Switzerland,CHE,0,250,0,0,250
2004,Viet Nam,VNM,Switzerland,CHE,0,10,0,0,10
2004,Sudan,SDN,Switzerland,CHE,0,22,0,0,22
2004,Syrian Arab Rep.,SYR,Switzerland,CHE,0,29,0,0,29
2004,Togo,TGO,Switzerland,CHE,0,25,0,0,25
2004,Tunisia,TUN,Switzerland,CHE,0,16,0,0,16
2004,Turkey,TUR,Switzerland,CHE,0,300,0,0,300
2004,Yemen,YEM,Switzerland,CHE,0,5,0,0,5
2004,Stateless,XXA,Switzerland,CHE,0,24,0,0,24
2000,Afghanistan,AFG,United States of America,USA,151,0,31,68,250
2000,Albania,ALB,United States of America,USA,389,0,404,405,1198
2000,Algeria,DZA,United States of America,USA,32,0,45,46,123
2000,Angola,AGO,United States of America,USA,10,0,15,21,46
2000,Egypt,EGY,United States of America,USA,218,0,75,140,433
2000,Argentina,ARG,United States of America,USA,15,0,41,55,111
2000,Armenia,ARM,United States of America,USA,84,0,160,296,540
2000,Australia,AUS,United States of America,USA,0,0,5,0,5
2000,Azerbaijan,AZE,United States of America,USA,32,0,34,123,189
2000,Bahrain,BHR,United States of America,USA,5,0,5,10,20
2000,Barbados,BRB,United States of America,USA,0,0,0,5,5
2000,Burundi,BDI,United States of America,USA,10,0,34,18,62
2000,Benin,BEN,United States of America,USA,5,0,0,0,5
2000,Bangladesh,BGD,United States of America,USA,174,0,328,376,878
2000,Bahamas,BHS,United States of America,USA,0,0,0,5,5
2000,Burkina Faso,BFA,United States of America,USA,5,0,10,11,26
2000,Belarus,BLR,United States of America,USA,25,0,16,28,69
2000,Bolivia (Plurinational State of),BOL,United States of America,USA,0,0,18,28,46
2000,Brazil,BRA,United States of America,USA,13,0,60,160,233
2000,Bosnia and Herzegovina,BIH,United States of America,USA,5,0,0,10,15
2000,Bulgaria,BGR,United States of America,USA,14,0,60,91,165
2000,Belize,BLZ,United States of America,USA,0,0,0,14,14
2000,Cambodia,KHM,United States of America,USA,37,0,57,70,164
2000,Canada,CAN,United States of America,USA,5,0,5,10,20
2000,Chad,TCD,United States of America,USA,5,0,5,0,10
2000,China,CHN,United States of America,USA,612,0,3055,4198,7865
2000,Chile,CHL,United States of America,USA,5,0,17,10,32
2000,Cameroon,CMR,United States of America,USA,89,0,71,56,216
2000,Congo,COG,United States of America,USA,99,0,86,72,257
2000,Dem. Rep. of the Congo,COD,United States of America,USA,29,0,15,28,72
2000,Colombia,COL,United States of America,USA,186,0,271,351,808
2000,Costa Rica,CRI,United States of America,USA,0,0,5,10,15
2000,Cuba,CUB,United States of America,USA,99,0,243,1433,1775
2000,Cabo Verde,CPV,United States of America,USA,0,0,0,5,5
2000,Denmark,DNK,United States of America,USA,5,0,0,0,5
2000,Dominica,DMA,United States of America,USA,0,0,0,5,5
2000,Dominican Rep.,DOM,United States of America,USA,0,0,13,35,48
2000,Ecuador,ECU,United States of America,USA,0,0,28,103,131
2000,Eritrea,ERI,United States of America,USA,33,0,40,31,104
2000,Estonia,EST,United States of America,USA,0,0,10,11,21
2000,Ethiopia,ETH,United States of America,USA,234,0,199,197,630
2000,Fiji,FJI,United States of America,USA,65,0,39,98,202
2000,France,FRA,United States of America,USA,0,0,0,16,16
2000,Gabon,GAB,United States of America,USA,0,0,0,5,5
2000,Gambia,GMB,United States of America,USA,15,0,44,34,93
2000,United Kingdom of Great Britain and Northern Ireland,GBR,United States of America,USA,10,0,22,35,67
2000,Georgia,GEO,United States of America,USA,54,0,31,56,141
2000,Germany,DEU,United States of America,USA,5,0,16,10,31
2000,Ghana,GHA,United States of America,USA,22,0,84,83,189
2000,Guinea-Bissau,GNB,United States of America,USA,0,0,10,5,15
2000,Greece,GRC,United States of America,USA,0,0,0,5,5
2000,Grenada,GRD,United States of America,USA,0,0,0,10,10
2000,Guatemala,GTM,United States of America,USA,187,0,1288,2301,3776
2000,Guinea,GIN,United States of America,USA,40,0,48,52,140
2000,Guyana,GUY,United States of America,USA,0,0,35,55,90
2000,Haiti,HTI,United States of America,USA,204,0,1855,1396,3455
2000,Honduras,HND,United States of America,USA,15,0,138,666,819
2000,Croatia,HRV,United States of America,USA,12,0,20,30,62
2000,Hungary,HUN,United States of America,USA,5,0,5,15,25
2000,Cote d'Ivoire,CIV,United States of America,USA,14,0,24,34,72
2000,India,IND,United States of America,USA,515,0,684,993,2192
2000,Indonesia,IDN,United States of America,USA,157,0,120,178,455
2000,Iran (Islamic Rep. of),IRN,United States of America,USA,171,0,186,362,719
2000,Iraq,IRQ,United States of America,USA,82,0,55,103,240
2000,Israel,ISR,United States of America,USA,5,0,28,41,74
2000,Italy,ITA,United States of America,USA,0,0,0,5,5
2000,Jamaica,JAM,United States of America,USA,0,0,43,76,119
2000,Jordan,JOR,United States of America,USA,14,0,48,86,148
2000,Japan,JPN,United States of America,USA,0,0,0,5,5
2000,Kazakhstan,KAZ,United States of America,USA,37,0,18,30,85
2000,Kenya,KEN,United States of America,USA,26,0,26,26,78
2000,Kyrgyzstan,KGZ,United States of America,USA,5,0,5,5,15
2000,Rep. of Korea,KOR,United States of America,USA,0,0,5,23,28
2000,Kuwait,KWT,United States of America,USA,5,0,19,5,29
2000,Lao People's Dem. Rep.,LAO,United States of America,USA,5,0,72,220,297
2000,Liberia,LBR,United States of America,USA,94,0,111,238,443
2000,Libya,LBY,United States of America,USA,5,0,0,5,10
2000,Lebanon,LBN,United States of America,USA,48,0,87,113,248
2000,Sri Lanka,LKA,United States of America,USA,171,0,79,140,390
2000,Lithuania,LTU,United States of America,USA,5,0,10,13,28
2000,Latvia,LVA,United States of America,USA,5,0,13,12,30
2000,Mauritania,MRT,United States of America,USA,98,0,328,192,618
2000,North Macedonia,MKD,United States of America,USA,5,0,40,34,79
2000,Rep. of Moldova,MDA,United States of America,USA,5,0,0,10,15
2000,Mexico,MEX,United States of America,USA,48,0,410,4586,5044
2000,Mali,MLI,United States of America,USA,5,0,28,35,68
2000,Malaysia,MYS,United States of America,USA,5,0,5,17,27
2000,Mongolia,MNG,United States of America,USA,0,0,5,13,18
2000,Morocco,MAR,United States of America,USA,5,0,15,12,32
2000,Myanmar,MMR,United States of America,USA,81,0,37,64,182
2000,Nepal,NPL,United States of America,USA,39,0,46,29,114
2000,Niger,NER,United States of America,USA,5,0,5,10,20
2000,Nicaragua,NIC,United States of America,USA,5,0,55,212,272
2000,Nigeria,NGA,United States of America,USA,79,0,196,286,561
2000,New Zealand,NZL,United States of America,USA,0,0,0,5,5
2000,Oman,OMN,United States of America,USA,0,0,0,5,5
2000,Pakistan,PAK,United States of America,USA,178,0,242,438,858
2000,Panama,PAN,United States of America,USA,5,0,21,43,69
2000,Paraguay,PRY,United States of America,USA,0,0,10,10,20
2000,Peru,PER,United States of America,USA,250,0,436,497,1183
2000,Philippines,PHL,United States of America,USA,34,0,123,418,575
2000,Poland,POL,United States of America,USA,0,0,19,83,102
2000,Portugal,PRT,United States of America,USA,0,0,0,15,15
2000,Romania,ROU,United States of America,USA,40,0,63,198,301
2000,South Africa,ZAF,United States of America,USA,10,0,21,17,48
2000,Russian Federation,RUS,United States of America,USA,417,0,236,481,1134
2000,Rwanda,RWA,United States of America,USA,19,0,19,32,70
2000,El Salvador,SLV,United States of America,USA,145,0,1374,2514,4033
2000,Saudi Arabia,SAU,United States of America,USA,0,0,5,5,10
2000,Serbia and Kosovo: S/RES/1244 (1999),SRB,United States of America,USA,48,0,28,44,120
2000,Senegal,SEN,United States of America,USA,10,0,30,37,77
2000,Seychelles,SYC,United States of America,USA,0,0,0,5,5
2000,Singapore,SGP,United States of America,USA,0,0,0,5,5
2000,Sierra Leone,SLE,United States of America,USA,68,0,75,128,271
2000,Somalia,SOM,United States of America,USA,410,0,548,700,1658
2000,Spain,ESP,United States of America,USA,0,0,0,5,5
2000,Viet Nam,VNM,United States of America,USA,16,0,169,309,494
2000,Sudan,SDN,United States of America,USA,65,0,49,88,202
2000,Suriname,SUR,United States of America,USA,17,0,25,31,73
2000,Slovakia,SVK,United States of America,USA,5,0,12,10,27
2000,Sweden,SWE,United States of America,USA,0,0,0,5,5
2000,Switzerland,CHE,United States of America,USA,0,0,5,0,5
2000,Syrian Arab Rep.,SYR,United States of America,USA,18,0,18,63,99
2000,United Rep. of Tanzania,TZA,United States of America,USA,0,0,5,5,10
2000,Thailand,THA,United States of America,USA,0,0,5,32,37
2000,Tajikistan,TJK,United States of America,USA,0,0,0,10,10
2000,Turkmenistan,TKM,United States of America,USA,10,0,5,5,20
2000,Togo,TGO,United States of America,USA,20,0,28,32,80
2000,Tonga,TON,United States of America,USA,0,0,0,5,5
2000,Trinidad and Tobago,TTO,United States of America,USA,5,0,22,44,71
2000,Tunisia,TUN,United States of America,USA,5,0,5,5,15
2000,Turkey,TUR,United States of America,USA,13,0,15,22,50
2000,Uganda,UGA,United States of America,USA,40,0,24,36,100
2000,Ukraine,UKR,United States of America,USA,96,0,125,153,374
2000,Uruguay,URY,United States of America,USA,0,0,0,5,5
2000,Uzbekistan,UZB,United States of America,USA,45,0,13,13,71
2000,Saint Vincent and the Grenadines,VCT,United States of America,USA,0,0,0,5,5
2000,Venezuela (Bolivarian Republic of),VEN,United States of America,USA,0,0,14,36,50
2000,Yemen,YEM,United States of America,USA,13,0,35,46,94
2000,Zambia,ZMB,United States of America,USA,5,0,0,0,5
2000,Zimbabwe,ZWE,United States of America,USA,5,0,0,5,10
2000,Stateless,XXA,United States of America,USA,21,0,22,49,92
2000,Unknown ,,United States of America,USA,253,0,222,415,890
2001,Afghanistan,AFG,United States of America,USA,129,0,27,91,247
2001,Albania,ALB,United States of America,USA,498,0,520,405,1423
2001,Algeria,DZA,United States of America,USA,26,0,24,22,72
2001,Angola,AGO,United States of America,USA,10,0,12,22,44
2001,Egypt,EGY,United States of America,USA,193,0,76,123,392
2001,Argentina,ARG,United States of America,USA,5,0,15,48,68
2001,Armenia,ARM,United States of America,USA,203,0,241,435,879
2001,Australia,AUS,United States of America,USA,0,0,0,5,5
2001,Azerbaijan,AZE,United States of America,USA,31,0,31,116,178
2001,Bahrain,BHR,United States of America,USA,0,0,0,5,5
2001,Burundi,BDI,United States of America,USA,11,0,21,28,60
2001,Belgium,BEL,United States of America,USA,0,0,5,5,10
2001,Bangladesh,BGD,United States of America,USA,121,0,194,226,541
2001,Bahamas,BHS,United States of America,USA,0,0,5,5,10
2001,Burkina Faso,BFA,United States of America,USA,5,0,0,5,10
2001,Belarus,BLR,United States of America,USA,19,0,14,24,57
2001,Bolivia (Plurinational State of),BOL,United States of America,USA,11,0,5,22,38
2001,Brazil,BRA,United States of America,USA,10,0,38,204,252
2001,Bosnia and Herzegovina,BIH,United States of America,USA,5,0,5,17,27
2001,Bulgaria,BGR,United States of America,USA,60,0,57,94,211
2001,Belize,BLZ,United States of America,USA,0,0,0,10,10
2001,Cambodia,KHM,United States of America,USA,21,0,34,72,127
2001,Canada,CAN,United States of America,USA,0,0,5,5,10
2001,Central African Rep.,CAF,United States of America,USA,5,0,0,0,5
2001,Chad,TCD,United States of America,USA,5,0,5,5,15
2001,China,CHN,United States of America,USA,661,0,3403,2004,6068
2001,Chile,CHL,United States of America,USA,11,0,10,12,33
2001,Cameroon,CMR,United States of America,USA,129,0,113,53,295
2001,Congo,COG,United States of America,USA,124,0,96,113,333
2001,Dem. Rep. of the Congo,COD,United States of America,USA,30,0,19,22,71
2001,Colombia,COL,United States of America,USA,379,0,618,570,1567
2001,Costa Rica,CRI,United States of America,USA,0,0,0,11,11
2001,Cuba,CUB,United States of America,USA,73,0,149,819,1041
2001,Cabo Verde,CPV,United States of America,USA,0,0,0,5,5
2001,Czechia,CZE,United States of America,USA,5,0,11,12,28
2001,Dominica,DMA,United States of America,USA,0,0,0,5,5
2001,Dominican Rep.,DOM,United States of America,USA,5,0,24,34,63
2001,Ecuador,ECU,United States of America,USA,5,0,29,69,103
2001,Eritrea,ERI,United States of America,USA,59,0,50,32,141
2001,Estonia,EST,United States of America,USA,12,0,10,10,32
2001,Ethiopia,ETH,United States of America,USA,215,0,214,172,601
2001,Fiji,FJI,United States of America,USA,115,0,25,67,207
2001,Finland,FIN,United States of America,USA,0,0,0,5,5
2001,France,FRA,United States of America,USA,5,0,0,11,16
2001,Gabon,GAB,United States of America,USA,0,0,5,0,5
2001,Gambia,GMB,United States of America,USA,17,0,25,40,82
2001,United Kingdom of Great Britain and Northern Ireland,GBR,United States of America,USA,13,0,11,22,46
2001,Georgia,GEO,United States of America,USA,55,0,46,64,165
2001,Germany,DEU,United States of America,USA,10,0,10,19,39
2001,Ghana,GHA,United States of America,USA,17,0,75,80,172
2001,Guinea-Bissau,GNB,United States of America,USA,0,0,0,5,5
2001,Guatemala,GTM,United States of America,USA,135,0,749,1373,2257
2001,Guinea,GIN,United States of America,USA,63,0,97,95,255
2001,Guyana,GUY,United States of America,USA,10,0,20,39,69
2001,Haiti,HTI,United States of America,USA,357,0,2547,1135,4039
2001,"China, Hong Kong SAR",HKG,United States of America,USA,0,0,0,5,5
2001,Honduras,HND,United States of America,USA,22,0,119,347,488
2001,Croatia,HRV,United States of America,USA,5,0,5,15,25
2001,Hungary,HUN,United States of America,USA,0,0,5,5,10
2001,Cote d'Ivoire,CIV,United States of America,USA,10,0,30,37,77
2001,India,IND,United States of America,USA,495,0,503,708,1706
2001,Indonesia,IDN,United States of America,USA,176,0,170,230,576
2001,Iran (Islamic Rep. of),IRN,United States of America,USA,228,0,182,306,716
2001,Iraq,IRQ,United States of America,USA,186,0,69,97,352
2001,Israel,ISR,United States of America,USA,5,0,12,28,45
2001,Italy,ITA,United States of America,USA,0,0,0,5,5
2001,Jamaica,JAM,United States of America,USA,5,0,37,80,122
2001,Jordan,JOR,United States of America,USA,18,0,53,65,136
2001,Kazakhstan,KAZ,United States of America,USA,21,0,25,26,72
2001,Kenya,KEN,United States of America,USA,42,0,37,30,109
2001,Kyrgyzstan,KGZ,United States of America,USA,10,0,5,5,20
2001,Rep. of Korea,KOR,United States of America,USA,0,0,5,10,15
2001,Kuwait,KWT,United States of America,USA,5,0,10,10,25
2001,Lao People's Dem. Rep.,LAO,United States of America,USA,11,0,50,111,172
2001,Liberia,LBR,United States of America,USA,129,0,84,253,466
2001,Libya,LBY,United States of America,USA,5,0,5,5,15
2001,Saint Lucia,LCA,United States of America,USA,0,0,0,5,5
2001,Lebanon,LBN,United States of America,USA,55,0,49,74,178
2001,Sri Lanka,LKA,United States of America,USA,214,0,88,145,447
2001,Lithuania,LTU,United States of America,USA,5,0,13,14,32
2001,Latvia,LVA,United States of America,USA,5,0,10,13,28
2001,Mauritania,MRT,United States of America,USA,88,0,215,167,470
2001,North Macedonia,MKD,United States of America,USA,15,0,48,41,104
2001,Rep. of Moldova,MDA,United States of America,USA,10,0,11,11,32
2001,Mexico,MEX,United States of America,USA,45,0,446,4028,4519
2001,Mali,MLI,United States of America,USA,5,0,10,17,32
2001,Malaysia,MYS,United States of America,USA,5,0,5,13,23
2001,Mongolia,MNG,United States of America,USA,0,0,0,5,5
2001,Morocco,MAR,United States of America,USA,0,0,14,10,24
2001,Myanmar,MMR,United States of America,USA,120,0,25,93,238
2001,Nepal,NPL,United States of America,USA,31,0,22,19,72
2001,Netherlands,NLD,United States of America,USA,0,0,0,5,5
2001,Niger,NER,United States of America,USA,5,0,5,5,15
2001,Nicaragua,NIC,United States of America,USA,10,0,73,89,172
2001,Nigeria,NGA,United States of America,USA,72,0,180,193,445
2001,Oman,OMN,United States of America,USA,5,0,0,0,5
2001,Pakistan,PAK,United States of America,USA,154,0,271,304,729
2001,Panama,PAN,United States of America,USA,5,0,5,19,29
2001,Paraguay,PRY,United States of America,USA,0,0,0,5,5
2001,Peru,PER,United States of America,USA,128,0,143,244,515
2001,Philippines,PHL,United States of America,USA,37,0,89,268,394
2001,Poland,POL,United States of America,USA,5,0,12,53,70
2001,Portugal,PRT,United States of America,USA,0,0,0,5,5
2001,Romania,ROU,United States of America,USA,58,0,52,120,230
2001,South Africa,ZAF,United States of America,USA,5,0,18,10,33
2001,Russian Federation,RUS,United States of America,USA,349,0,221,442,1012
2001,Rwanda,RWA,United States of America,USA,24,0,13,16,53
2001,El Salvador,SLV,United States of America,USA,86,0,500,2435,3021
2001,Saudi Arabia,SAU,United States of America,USA,5,0,5,5,15
2001,Serbia and Kosovo: S/RES/1244 (1999),SRB,United States of America,USA,186,0,233,306,725
2001,Senegal,SEN,United States of America,USA,10,0,27,32,69
2001,Seychelles,SYC,United States of America,USA,10,0,16,5,31
2001,Singapore,SGP,United States of America,USA,0,0,5,5,10
2001,Sierra Leone,SLE,United States of America,USA,89,0,104,172,365
2001,Somalia,SOM,United States of America,USA,349,0,377,469,1195
2001,Spain,ESP,United States of America,USA,0,0,0,5,5
2001,Viet Nam,VNM,United States of America,USA,15,0,85,161,261
2001,Saint Kitts and Nevis,KNA,United States of America,USA,0,0,0,5,5
2001,Sudan,SDN,United States of America,USA,77,0,71,85,233
2001,Suriname,SUR,United States of America,USA,5,0,10,12,27
2001,Slovakia,SVK,United States of America,USA,0,0,5,5,10
2001,Slovenia,SVN,United States of America,USA,0,0,0,5,5
2001,Sweden,SWE,United States of America,USA,0,0,5,0,5
2001,Syrian Arab Rep.,SYR,United States of America,USA,17,0,28,40,85
2001,United Rep. of Tanzania,TZA,United States of America,USA,5,0,5,10,20
2001,Thailand,THA,United States of America,USA,0,0,10,31,41
2001,Tajikistan,TJK,United States of America,USA,0,0,0,5,5
2001,Turkmenistan,TKM,United States of America,USA,5,0,0,0,5
2001,Togo,TGO,United States of America,USA,28,0,22,17,67
2001,Trinidad and Tobago,TTO,United States of America,USA,0,0,5,21,26
2001,Tunisia,TUN,United States of America,USA,0,0,5,5,10
2001,Turkey,TUR,United States of America,USA,17,0,22,36,75
2001,Uganda,UGA,United States of America,USA,50,0,47,44,141
2001,Ukraine,UKR,United States of America,USA,86,0,90,125,301
2001,Uzbekistan,UZB,United States of America,USA,29,0,20,28,77
2001,Venezuela (Bolivarian Republic of),VEN,United States of America,USA,5,0,10,30,45
2001,Yemen,YEM,United States of America,USA,19,0,35,26,80
2001,Zambia,ZMB,United States of America,USA,0,0,0,5,5
2001,Zimbabwe,ZWE,United States of America,USA,0,0,5,14,19
2001,Stateless,XXA,United States of America,USA,15,0,15,35,65
2002,Afghanistan,AFG,United States of America,USA,74,0,57,85,216
2002,Albania,ALB,United States of America,USA,515,0,807,468,1790
2002,Algeria,DZA,United States of America,USA,15,0,30,29,74
2002,Andorra,AND,United States of America,USA,0,0,5,0,5
2002,Angola,AGO,United States of America,USA,5,0,24,13,42
2002,Egypt,EGY,United States of America,USA,228,0,138,166,532
2002,Argentina,ARG,United States of America,USA,13,0,25,73,111
2002,Armenia,ARM,United States of America,USA,322,0,437,579,1338
2002,Austria,AUT,United States of America,USA,0,0,0,5,5
2002,Azerbaijan,AZE,United States of America,USA,38,0,36,168,242
2002,Burundi,BDI,United States of America,USA,10,0,19,19,48
2002,Belgium,BEL,United States of America,USA,0,0,0,5,5
2002,Benin,BEN,United States of America,USA,5,0,0,0,5
2002,Bermuda,BMU,United States of America,USA,0,0,0,5,5
2002,Bangladesh,BGD,United States of America,USA,104,0,134,173,411
2002,Bahamas,BHS,United States of America,USA,0,0,10,10,20
2002,Bhutan,BTN,United States of America,USA,5,0,0,5,10
2002,Burkina Faso,BFA,United States of America,USA,0,0,5,5,10
2002,Belarus,BLR,United States of America,USA,17,0,18,40,75
2002,Bolivia (Plurinational State of),BOL,United States of America,USA,0,0,10,25,35
2002,Brazil,BRA,United States of America,USA,10,0,43,77,130
2002,Bosnia and Herzegovina,BIH,United States of America,USA,23,0,10,20,53
2002,Bulgaria,BGR,United States of America,USA,47,0,76,84,207
2002,Belize,BLZ,United States of America,USA,0,0,5,10,15
2002,Cambodia,KHM,United States of America,USA,10,0,42,52,104
2002,Canada,CAN,United States of America,USA,5,0,0,5,10
2002,Central African Rep.,CAF,United States of America,USA,0,0,0,5,5
2002,Chad,TCD,United States of America,USA,5,0,5,5,15
2002,China,CHN,United States of America,USA,808,0,4239,2688,7735
2002,Chile,CHL,United States of America,USA,0,0,10,11,21
2002,Cameroon,CMR,United States of America,USA,116,0,152,92,360
2002,Congo,COG,United States of America,USA,129,0,125,119,373
2002,Dem. Rep. of the Congo,COD,United States of America,USA,36,0,40,32,108
2002,Colombia,COL,United States of America,USA,1019,0,1723,1173,3915
2002,Costa Rica,CRI,United States of America,USA,0,0,5,5,10
2002,Cuba,CUB,United States of America,USA,23,0,140,666,829
2002,Cabo Verde,CPV,United States of America,USA,0,0,0,5,5
2002,Czechia,CZE,United States of America,USA,5,0,10,12,27
2002,Djibouti,DJI,United States of America,USA,0,0,0,10,10
2002,Dominican Rep.,DOM,United States of America,USA,5,0,26,39,70
2002,Ecuador,ECU,United States of America,USA,0,0,29,62,91
2002,Equatorial Guinea,GNQ,United States of America,USA,0,0,0,5,5
2002,Eritrea,ERI,United States of America,USA,42,0,89,43,174
2002,Estonia,EST,United States of America,USA,5,0,10,18,33
2002,Ethiopia,ETH,United States of America,USA,232,0,339,216,787
2002,Fiji,FJI,United States of America,USA,89,0,93,85,267
2002,France,FRA,United States of America,USA,0,0,11,5,16
2002,Gabon,GAB,United States of America,USA,0,0,0,5,5
2002,Gambia,GMB,United States of America,USA,18,0,25,27,70
2002,Palestinian,PSE,United States of America,USA,0,0,10,5,15
2002,United Kingdom of Great Britain and Northern Ireland,GBR,United States of America,USA,14,0,15,25,54
2002,Georgia,GEO,United States of America,USA,66,0,60,61,187
2002,Germany,DEU,United States of America,USA,0,0,12,11,23
2002,Ghana,GHA,United States of America,USA,10,0,45,53,108
2002,Guinea-Bissau,GNB,United States of America,USA,0,0,0,5,5
2002,Greece,GRC,United States of America,USA,0,0,5,12,17
2002,Guatemala,GTM,United States of America,USA,113,0,727,1156,1996
2002,Guinea,GIN,United States of America,USA,94,0,144,174,412
2002,Guyana,GUY,United States of America,USA,5,0,23,48,76
2002,Haiti,HTI,United States of America,USA,479,0,2408,985,3872
2002,"China, Hong Kong SAR",HKG,United States of America,USA,5,0,0,5,10
2002,Honduras,HND,United States of America,USA,16,0,137,271,424
2002,Croatia,HRV,United States of America,USA,5,0,10,15,30
2002,Hungary,HUN,United States of America,USA,0,0,5,5,10
2002,Cote d'Ivoire,CIV,United States of America,USA,13,0,34,41,88
2002,India,IND,United States of America,USA,493,0,556,749,1798
2002,Indonesia,IDN,United States of America,USA,283,0,546,444,1273
2002,Iran (Islamic Rep. of),IRN,United States of America,USA,210,0,191,325,726
2002,Iraq,IRQ,United States of America,USA,280,0,135,115,530
2002,Israel,ISR,United States of America,USA,5,0,16,35,56
2002,Italy,ITA,United States of America,USA,0,0,5,10,15
2002,Jamaica,JAM,United States of America,USA,5,0,47,83,135
2002,Jordan,JOR,United States of America,USA,14,0,57,76,147
2002,Japan,JPN,United States of America,USA,0,0,0,10,10
2002,Kazakhstan,KAZ,United States of America,USA,28,0,30,39,97
2002,Kenya,KEN,United States of America,USA,30,0,35,40,105
2002,Kyrgyzstan,KGZ,United States of America,USA,5,0,14,17,36
2002,Rep. of Korea,KOR,United States of America,USA,0,0,5,23,28
2002,Dem. People's Rep. of Korea,PRK,United States of America,USA,5,0,0,0,5
2002,Kuwait,KWT,United States of America,USA,5,0,12,5,22
2002,Lao People's Dem. Rep.,LAO,United States of America,USA,12,0,38,105,155
2002,Liberia,LBR,United States of America,USA,141,0,92,333,566
2002,Libya,LBY,United States of America,USA,0,0,0,5,5
2002,Lebanon,LBN,United States of America,USA,53,0,80,80,213
2002,Sri Lanka,LKA,United States of America,USA,140,0,134,183,457
2002,Lithuania,LTU,United States of America,USA,0,0,15,13,28
2002,Latvia,LVA,United States of America,USA,5,0,22,12,39
2002,Mauritania,MRT,United States of America,USA,118,0,183,221,522
2002,North Macedonia,MKD,United States of America,USA,18,0,41,34,93
2002,Rep. of Moldova,MDA,United States of America,USA,10,0,5,16,31
2002,Mexico,MEX,United States of America,USA,37,0,546,6814,7397
2002,Mali,MLI,United States of America,USA,5,0,5,18,28
2002,Malaysia,MYS,United States of America,USA,5,0,5,11,21
2002,Malawi,MWI,United States of America,USA,5,0,0,0,5
2002,Mongolia,MNG,United States of America,USA,0,0,5,5,10
2002,Morocco,MAR,United States of America,USA,5,0,5,10,20
2002,Myanmar,MMR,United States of America,USA,126,0,39,68,233
2002,Nepal,NPL,United States of America,USA,37,0,24,25,86
2002,Niger,NER,United States of America,USA,5,0,24,5,34
2002,Nicaragua,NIC,United States of America,USA,5,0,67,66,138
2002,Nigeria,NGA,United States of America,USA,43,0,178,176,397
2002,Pakistan,PAK,United States of America,USA,180,0,237,355,772
2002,Panama,PAN,United States of America,USA,0,0,0,5,5
2002,Paraguay,PRY,United States of America,USA,0,0,5,5,10
2002,Peru,PER,United States of America,USA,88,0,107,218,413
2002,Philippines,PHL,United States of America,USA,22,0,78,238,338
2002,Poland,POL,United States of America,USA,10,0,56,46,112
2002,Portugal,PRT,United States of America,USA,0,0,0,5,5
2002,Romania,ROU,United States of America,USA,49,0,66,93,208
2002,South Africa,ZAF,United States of America,USA,16,0,13,14,43
2002,Russian Federation,RUS,United States of America,USA,314,0,203,440,957
2002,Rwanda,RWA,United States of America,USA,17,0,19,23,59
2002,El Salvador,SLV,United States of America,USA,41,0,288,2340,2669
2002,Saudi Arabia,SAU,United States of America,USA,0,0,5,5,10
2002,Serbia and Kosovo: S/RES/1244 (1999),SRB,United States of America,USA,176,0,316,269,761
2002,Senegal,SEN,United States of America,USA,5,0,22,18,45
2002,Seychelles,SYC,United States of America,USA,15,0,10,0,25
2002,Singapore,SGP,United States of America,USA,5,0,5,0,10
2002,Sierra Leone,SLE,United States of America,USA,110,0,155,171,436
2002,Somalia,SOM,United States of America,USA,236,0,248,472,956
2002,Spain,ESP,United States of America,USA,0,0,5,0,5
2002,Viet Nam,VNM,United States of America,USA,10,0,76,116,202
2002,Sudan,SDN,United States of America,USA,86,0,95,118,299
2002,Suriname,SUR,United States of America,USA,0,0,5,11,16
2002,Slovakia,SVK,United States of America,USA,0,0,5,14,19
2002,Slovenia,SVN,United States of America,USA,0,0,5,0,5
2002,Syrian Arab Rep.,SYR,United States of America,USA,10,0,27,61,98
2002,United Rep. of Tanzania,TZA,United States of America,USA,5,0,11,12,28
2002,Thailand,THA,United States of America,USA,0,0,12,20,32
2002,Tajikistan,TJK,United States of America,USA,0,0,5,5,10
2002,Turkmenistan,TKM,United States of America,USA,5,0,0,0,5
2002,Togo,TGO,United States of America,USA,43,0,35,42,120
2002,Tonga,TON,United States of America,USA,0,0,0,5,5
2002,Trinidad and Tobago,TTO,United States of America,USA,0,0,11,21,32
2002,Tunisia,TUN,United States of America,USA,0,0,11,0,11
2002,Turkey,TUR,United States of America,USA,23,0,54,49,126
2002,Uganda,UGA,United States of America,USA,40,0,63,44,147
2002,Ukraine,UKR,United States of America,USA,96,0,134,172,402
2002,Uruguay,URY,United States of America,USA,0,0,5,10,15
2002,Uzbekistan,UZB,United States of America,USA,45,0,24,66,135
2002,Venezuela (Bolivarian Republic of),VEN,United States of America,USA,24,0,34,33,91
2002,Yemen,YEM,United States of America,USA,10,0,45,34,89
2002,Zambia,ZMB,United States of America,USA,5,0,0,13,18
2002,Zimbabwe,ZWE,United States of America,USA,21,0,25,15,61
2002,Stateless,XXA,United States of America,USA,21,0,29,45,95
2002,Unknown ,,United States of America,USA,0,0,12,5,17
2003,Afghanistan,AFG,United States of America,USA,70,0,51,61,182
2003,Albania,ALB,United States of America,USA,717,0,787,559,2063
2003,Algeria,DZA,United States of America,USA,15,0,34,22,71
2003,Angola,AGO,United States of America,USA,5,0,23,13,41
2003,Egypt,EGY,United States of America,USA,277,0,162,177,616
2003,Argentina,ARG,United States of America,USA,10,0,56,95,161
2003,Armenia,ARM,United States of America,USA,412,0,575,562,1549
2003,Australia,AUS,United States of America,USA,0,0,5,5,10
2003,Austria,AUT,United States of America,USA,0,0,0,5,5
2003,Azerbaijan,AZE,United States of America,USA,46,0,24,102,172
2003,Bahrain,BHR,United States of America,USA,5,0,0,5,10
2003,Burundi,BDI,United States of America,USA,19,0,16,10,45
2003,Belgium,BEL,United States of America,USA,5,0,14,5,24
2003,Benin,BEN,United States of America,USA,0,0,5,5,10
2003,Bangladesh,BGD,United States of America,USA,107,0,93,210,410
2003,Bahamas,BHS,United States of America,USA,0,0,5,5,10
2003,Burkina Faso,BFA,United States of America,USA,5,0,11,5,21
2003,Belarus,BLR,United States of America,USA,47,0,24,71,142
2003,Bolivia (Plurinational State of),BOL,United States of America,USA,5,0,10,36,51
2003,Brazil,BRA,United States of America,USA,19,0,61,178,258
2003,Bosnia and Herzegovina,BIH,United States of America,USA,10,0,14,15,39
2003,Bulgaria,BGR,United States of America,USA,47,0,53,88,188
2003,Belize,BLZ,United States of America,USA,0,0,5,10,15
2003,Cambodia,KHM,United States of America,USA,28,0,88,73,189
2003,Canada,CAN,United States of America,USA,5,0,5,5,15
2003,Central African Rep.,CAF,United States of America,USA,10,0,14,14,38
2003,Chad,TCD,United States of America,USA,0,0,12,0,12
2003,China,CHN,United States of America,USA,1140,0,4597,2910,8647
2003,Chile,CHL,United States of America,USA,5,0,10,24,39
2003,Cameroon,CMR,United States of America,USA,186,0,260,187,633
2003,Congo,COG,United States of America,USA,125,0,156,120,401
2003,Dem. Rep. of the Congo,COD,United States of America,USA,38,0,69,25,132
2003,Colombia,COL,United States of America,USA,1589,0,3062,1799,6450
2003,Costa Rica,CRI,United States of America,USA,0,0,5,5,10
2003,Cuba,CUB,United States of America,USA,37,0,167,465,669
2003,Cabo Verde,CPV,United States of America,USA,0,0,0,5,5
2003,Czechia,CZE,United States of America,USA,5,0,12,28,45
2003,Dominica,DMA,United States of America,USA,0,0,0,5,5
2003,Dominican Rep.,DOM,United States of America,USA,0,0,45,42,87
2003,Ecuador,ECU,United States of America,USA,13,0,53,99,165
2003,Eritrea,ERI,United States of America,USA,66,0,65,36,167
2003,Estonia,EST,United States of America,USA,10,0,12,15,37
2003,Ethiopia,ETH,United States of America,USA,239,0,269,187,695
2003,Fiji,FJI,United States of America,USA,97,0,151,192,440
2003,Finland,FIN,United States of America,USA,0,0,0,5,5
2003,France,FRA,United States of America,USA,5,0,11,21,37
2003,Gabon,GAB,United States of America,USA,0,0,0,5,5
2003,Gambia,GMB,United States of America,USA,30,0,33,38,101
2003,Palestinian,PSE,United States of America,USA,0,0,5,5,10
2003,United Kingdom of Great Britain and Northern Ireland,GBR,United States of America,USA,10,0,15,25,50
2003,Georgia,GEO,United States of America,USA,58,0,84,103,245
2003,Germany,DEU,United States of America,USA,5,0,5,10,20
2003,Ghana,GHA,United States of America,USA,10,0,36,43,89
2003,Guinea-Bissau,GNB,United States of America,USA,5,0,5,0,10
2003,Greece,GRC,United States of America,USA,0,0,0,5,5
2003,Guatemala,GTM,United States of America,USA,162,0,762,1317,2241
2003,Guinea,GIN,United States of America,USA,155,0,234,159,548
2003,Guyana,GUY,United States of America,USA,5,0,118,91,214
2003,Haiti,HTI,United States of America,USA,566,0,2433,1130,4129
2003,"China, Hong Kong SAR",HKG,United States of America,USA,0,0,0,5,5
2003,Honduras,HND,United States of America,USA,34,0,202,354,590
2003,Croatia,HRV,United States of America,USA,0,0,5,13,18
2003,Hungary,HUN,United States of America,USA,0,0,12,14,26
2003,Cote d'Ivoire,CIV,United States of America,USA,38,0,56,41,135
2003,India,IND,United States of America,USA,595,0,951,974,2520
2003,Indonesia,IDN,United States of America,USA,366,0,809,508,1683
2003,Iran (Islamic Rep. of),IRN,United States of America,USA,212,0,187,317,716
2003,Iraq,IRQ,United States of America,USA,197,0,206,125,528
2003,Israel,ISR,United States of America,USA,11,0,32,44,87
2003,Italy,ITA,United States of America,USA,0,0,10,5,15
2003,Jamaica,JAM,United States of America,USA,5,0,51,67,123
2003,Jordan,JOR,United States of America,USA,33,0,74,102,209
2003,Japan,JPN,United States of America,USA,0,0,5,11,16
2003,Kazakhstan,KAZ,United States of America,USA,39,0,13,16,68
2003,Kenya,KEN,United States of America,USA,47,0,95,71,213
2003,Kyrgyzstan,KGZ,United States of America,USA,13,0,5,10,28
2003,Rep. of Korea,KOR,United States of America,USA,0,0,11,15,26
2003,Dem. People's Rep. of Korea,PRK,United States of America,USA,5,0,0,0,5
2003,Kuwait,KWT,United States of America,USA,0,0,5,12,17
2003,Lao People's Dem. Rep.,LAO,United States of America,USA,10,0,46,206,262
2003,Liberia,LBR,United States of America,USA,146,0,98,346,590
2003,Libya,LBY,United States of America,USA,0,0,5,10,15
2003,Saint Lucia,LCA,United States of America,USA,0,0,0,5,5
2003,Lebanon,LBN,United States of America,USA,38,0,55,85,178
2003,Lesotho,LSO,United States of America,USA,0,0,5,0,5
2003,Sri Lanka,LKA,United States of America,USA,55,0,131,113,299
2003,Lithuania,LTU,United States of America,USA,11,0,21,35,67
2003,Latvia,LVA,United States of America,USA,12,0,14,26,52
2003,"China, Macao SAR",MAC,United States of America,USA,0,0,5,0,5
2003,Mauritania,MRT,United States of America,USA,181,0,237,292,710
2003,North Macedonia,MKD,United States of America,USA,22,0,51,42,115
2003,Rep. of Moldova,MDA,United States of America,USA,14,0,19,19,52
2003,Mexico,MEX,United States of America,USA,64,0,612,11699,12375
2003,Mali,MLI,United States of America,USA,5,0,10,27,42
2003,Malaysia,MYS,United States of America,USA,11,0,10,14,35
2003,Mongolia,MNG,United States of America,USA,5,0,0,12,17
2003,Morocco,MAR,United States of America,USA,10,0,14,13,37
2003,Myanmar,MMR,United States of America,USA,118,0,70,95,283
2003,Nepal,NPL,United States of America,USA,57,0,34,46,137
2003,Niger,NER,United States of America,USA,13,0,15,14,42
2003,Nicaragua,NIC,United States of America,USA,5,0,104,87,196
2003,Nigeria,NGA,United States of America,USA,50,0,172,158,380
2003,Niue,NIU,United States of America,USA,0,0,5,0,5
2003,Pakistan,PAK,United States of America,USA,227,0,270,393,890
2003,Panama,PAN,United States of America,USA,0,0,10,13,23
2003,Paraguay,PRY,United States of America,USA,0,0,10,0,10
2003,Peru,PER,United States of America,USA,117,0,222,246,585
2003,Philippines,PHL,United States of America,USA,26,0,128,345,499
2003,Poland,POL,United States of America,USA,10,0,23,49,82
2003,Portugal,PRT,United States of America,USA,0,0,10,5,15
2003,Qatar,QAT,United States of America,USA,0,0,0,5,5
2003,Romania,ROU,United States of America,USA,79,0,71,122,272
2003,South Africa,ZAF,United States of America,USA,5,0,32,33,70
2003,Russian Federation,RUS,United States of America,USA,401,0,248,540,1189
2003,Rwanda,RWA,United States of America,USA,23,0,13,12,48
2003,El Salvador,SLV,United States of America,USA,30,0,485,1645,2160
2003,Saudi Arabia,SAU,United States of America,USA,0,0,5,12,17
2003,Serbia and Kosovo: S/RES/1244 (1999),SRB,United States of America,USA,179,0,316,202,697
2003,Senegal,SEN,United States of America,USA,13,0,36,28,77
2003,Seychelles,SYC,United States of America,USA,0,0,5,0,5
2003,Sierra Leone,SLE,United States of America,USA,116,0,189,156,461
2003,Somalia,SOM,United States of America,USA,149,0,164,277,590
2003,Spain,ESP,United States of America,USA,0,0,0,5,5
2003,Viet Nam,VNM,United States of America,USA,10,0,82,124,216
2003,Sudan,SDN,United States of America,USA,96,0,114,69,279
2003,Suriname,SUR,United States of America,USA,0,0,5,10,15
2003,Slovakia,SVK,United States of America,USA,0,0,5,5,10
2003,Slovenia,SVN,United States of America,USA,5,0,10,0,15
2003,Sweden,SWE,United States of America,USA,5,0,5,5,15
2003,Syrian Arab Rep.,SYR,United States of America,USA,25,0,29,57,111
2003,United Rep. of Tanzania,TZA,United States of America,USA,5,0,24,16,45
2003,Thailand,THA,United States of America,USA,0,0,11,25,36
2003,Tajikistan,TJK,United States of America,USA,5,0,0,5,10
2003,Turkmenistan,TKM,United States of America,USA,5,0,0,10,15
2003,Togo,TGO,United States of America,USA,62,0,58,44,164
2003,Tonga,TON,United States of America,USA,0,0,0,5,5
2003,Trinidad and Tobago,TTO,United States of America,USA,5,0,5,20,30
2003,Tunisia,TUN,United States of America,USA,5,0,15,15,35
2003,Turkey,TUR,United States of America,USA,36,0,61,41,138
2003,United Arab Emirates,ARE,United States of America,USA,0,0,0,5,5
2003,Uganda,UGA,United States of America,USA,53,0,48,45,146
2003,Ukraine,UKR,United States of America,USA,106,0,110,154,370
2003,Uruguay,URY,United States of America,USA,0,0,0,11,11
2003,Uzbekistan,UZB,United States of America,USA,91,0,42,70,203
2003,Venezuela (Bolivarian Republic of),VEN,United States of America,USA,35,0,67,69,171
2003,Yemen,YEM,United States of America,USA,26,0,41,42,109
2003,Zambia,ZMB,United States of America,USA,5,0,13,10,28
2003,Zimbabwe,ZWE,United States of America,USA,54,0,72,42,168
2003,Stateless,XXA,United States of America,USA,30,0,25,54,109
2003,Unknown ,,United States of America,USA,0,0,20,0,20
2004,Afghanistan,AFG,United States of America,USA,58,0,35,75,168
2004,Albania,ALB,United States of America,USA,726,0,629,450,1805
2004,Algeria,DZA,United States of America,USA,13,0,36,42,91
2004,Angola,AGO,United States of America,USA,10,0,18,16,44
2004,Egypt,EGY,United States of America,USA,268,0,166,158,592
2004,Argentina,ARG,United States of America,USA,18,0,304,215,537
2004,Armenia,ARM,United States of America,USA,305,0,391,452,1148
2004,Australia,AUS,United States of America,USA,0,0,5,0,5
2004,Austria,AUT,United States of America,USA,0,0,10,5,15
2004,Azerbaijan,AZE,United States of America,USA,31,0,21,73,125
2004,Burundi,BDI,United States of America,USA,13,0,19,21,53
2004,Belgium,BEL,United States of America,USA,0,0,0,5,5
2004,Benin,BEN,United States of America,USA,5,0,5,0,10
2004,Bangladesh,BGD,United States of America,USA,149,0,162,198,509
2004,Bahamas,BHS,United States of America,USA,0,0,5,10,15
2004,Bhutan,BTN,United States of America,USA,0,0,0,5,5
2004,Burkina Faso,BFA,United States of America,USA,5,0,12,10,27
2004,Belarus,BLR,United States of America,USA,56,0,23,89,168
2004,Bolivia (Plurinational State of),BOL,United States of America,USA,5,0,20,15,40
2004,Brazil,BRA,United States of America,USA,33,0,80,321,434
2004,Bosnia and Herzegovina,BIH,United States of America,USA,5,0,18,18,41
2004,Bulgaria,BGR,United States of America,USA,43,0,52,88,183
2004,Belize,BLZ,United States of America,USA,5,0,5,5,15
2004,Cambodia,KHM,United States of America,USA,31,0,62,75,168
2004,Canada,CAN,United States of America,USA,5,0,0,0,5
2004,Central African Rep.,CAF,United States of America,USA,0,0,21,15,36
2004,Chad,TCD,United States of America,USA,5,0,10,5,20
2004,China,CHN,United States of America,USA,1256,0,3070,2055,6381
2004,Chile,CHL,United States of America,USA,5,0,11,19,35
2004,Cameroon,CMR,United States of America,USA,273,0,299,229,801
2004,Congo,COG,United States of America,USA,130,0,122,114,366
2004,Dem. Rep. of the Congo,COD,United States of America,USA,24,0,27,48,99
2004,Colombia,COL,United States of America,USA,1476,0,3082,2076,6634
2004,Costa Rica,CRI,United States of America,USA,5,0,11,5,21
2004,Cuba,CUB,United States of America,USA,32,0,104,424,560
2004,Cabo Verde,CPV,United States of America,USA,0,0,0,5,5
2004,Czechia,CZE,United States of America,USA,5,0,16,21,42
2004,Denmark,DNK,United States of America,USA,0,0,5,0,5
2004,Dominica,DMA,United States of America,USA,0,0,0,5,5
2004,Dominican Rep.,DOM,United States of America,USA,5,0,24,56,85
2004,Ecuador,ECU,United States of America,USA,5,0,35,81,121
2004,Eritrea,ERI,United States of America,USA,61,0,35,38,134
2004,Estonia,EST,United States of America,USA,10,0,5,22,37
2004,Ethiopia,ETH,United States of America,USA,260,0,233,258,751
2004,Fiji,FJI,United States of America,USA,95,0,135,327,557
2004,France,FRA,United States of America,USA,5,0,5,32,42
2004,Micronesia (Federated States of),FSM,United States of America,USA,0,0,0,5,5
2004,Gabon,GAB,United States of America,USA,5,0,0,0,5
2004,Gambia,GMB,United States of America,USA,17,0,36,41,94
2004,Palestinian,PSE,United States of America,USA,0,0,10,0,10
2004,United Kingdom of Great Britain and Northern Ireland,GBR,United States of America,USA,5,0,15,23,43
2004,Georgia,GEO,United States of America,USA,66,0,80,106,252
2004,Germany,DEU,United States of America,USA,5,0,10,10,25
2004,Ghana,GHA,United States of America,USA,5,0,32,30,67
2004,Guinea-Bissau,GNB,United States of America,USA,5,0,5,5,15
2004,Greece,GRC,United States of America,USA,5,0,5,5,15
2004,Guatemala,GTM,United States of America,USA,177,0,869,2140,3186
2004,Guinea,GIN,United States of America,USA,259,0,221,143,623
2004,Guyana,GUY,United States of America,USA,32,0,152,87,271
2004,Haiti,HTI,United States of America,USA,535,0,2382,1170,4087
2004,"China, Hong Kong SAR",HKG,United States of America,USA,0,0,0,5,5
2004,Honduras,HND,United States of America,USA,46,0,238,347,631
2004,Croatia,HRV,United States of America,USA,5,0,5,5,15
2004,Hungary,HUN,United States of America,USA,5,0,5,15,25
2004,Cote d'Ivoire,CIV,United States of America,USA,78,0,94,74,246
2004,India,IND,United States of America,USA,451,0,621,1000,2072
2004,Indonesia,IDN,United States of America,USA,429,0,1226,733,2388
2004,Iran (Islamic Rep. of),IRN,United States of America,USA,203,0,162,345,710
2004,Iraq,IRQ,United States of America,USA,115,0,206,99,420
2004,Israel,ISR,United States of America,USA,10,0,41,31,82
2004,Italy,ITA,United States of America,USA,0,0,10,5,15
2004,Jamaica,JAM,United States of America,USA,5,0,46,64,115
2004,Jordan,JOR,United States of America,USA,28,0,49,91,168
2004,Japan,JPN,United States of America,USA,0,0,10,12,22
2004,Kazakhstan,KAZ,United States of America,USA,28,0,27,27,82
2004,Kenya,KEN,United States of America,USA,62,0,86,123,271
2004,Kyrgyzstan,KGZ,United States of America,USA,16,0,10,11,37
2004,Rep. of Korea,KOR,United States of America,USA,5,0,5,10,20
2004,Dem. People's Rep. of Korea,PRK,United States of America,USA,0,0,0,5,5
2004,Kuwait,KWT,United States of America,USA,10,0,10,20,40
2004,Lao People's Dem. Rep.,LAO,United States of America,USA,5,0,45,294,344
2004,Liberia,LBR,United States of America,USA,91,0,103,328,522
2004,Libya,LBY,United States of America,USA,0,0,0,5,5
2004,Lebanon,LBN,United States of America,USA,41,0,85,108,234
2004,Sri Lanka,LKA,United States of America,USA,63,0,65,116,244
2004,Lithuania,LTU,United States of America,USA,10,0,17,37,64
2004,Latvia,LVA,United States of America,USA,17,0,12,21,50
2004,Madagascar,MDG,United States of America,USA,0,0,0,5,5
2004,Mauritania,MRT,United States of America,USA,219,0,211,477,907
2004,North Macedonia,MKD,United States of America,USA,14,0,52,43,109
2004,Rep. of Moldova,MDA,United States of America,USA,13,0,17,21,51
2004,Mexico,MEX,United States of America,USA,68,0,594,10271,10933
2004,Mali,MLI,United States of America,USA,10,0,16,22,48
2004,Malaysia,MYS,United States of America,USA,5,0,10,14,29
2004,Malawi,MWI,United States of America,USA,10,0,0,0,10
2004,Mongolia,MNG,United States of America,USA,13,0,28,13,54
2004,Morocco,MAR,United States of America,USA,0,0,18,18,36
2004,Malta,MLT,United States of America,USA,0,0,0,5,5
2004,Myanmar,MMR,United States of America,USA,138,0,70,73,281
2004,Nepal,NPL,United States of America,USA,93,0,48,41,182
2004,Netherlands,NLD,United States of America,USA,0,0,10,0,10
2004,Niger,NER,United States of America,USA,5,0,20,21,46
2004,Nicaragua,NIC,United States of America,USA,5,0,93,91,189
2004,Nigeria,NGA,United States of America,USA,50,0,132,140,322
2004,New Zealand,NZL,United States of America,USA,0,0,0,5,5
2004,Pakistan,PAK,United States of America,USA,164,0,367,450,981
2004,Panama,PAN,United States of America,USA,10,0,10,11,31
2004,Paraguay,PRY,United States of America,USA,0,0,5,5,10
2004,Peru,PER,United States of America,USA,111,0,214,282,607
2004,Philippines,PHL,United States of America,USA,29,0,117,352,498
2004,Poland,POL,United States of America,USA,5,0,19,43,67
2004,Portugal,PRT,United States of America,USA,0,0,0,12,12
2004,Qatar,QAT,United States of America,USA,0,0,0,5,5
2004,Romania,ROU,United States of America,USA,61,0,69,85,215
2004,South Africa,ZAF,United States of America,USA,5,0,23,23,51
2004,Russian Federation,RUS,United States of America,USA,407,0,268,666,1341
2004,Rwanda,RWA,United States of America,USA,28,0,10,17,55
2004,El Salvador,SLV,United States of America,USA,42,0,609,1606,2257
2004,Saudi Arabia,SAU,United States of America,USA,5,0,5,5,15
2004,Serbia and Kosovo: S/RES/1244 (1999),SRB,United States of America,USA,210,0,202,169,581
2004,Senegal,SEN,United States of America,USA,17,0,34,30,81
2004,Seychelles,SYC,United States of America,USA,5,0,5,0,10
2004,Singapore,SGP,United States of America,USA,5,0,5,5,15
2004,Sierra Leone,SLE,United States of America,USA,122,0,170,185,477
2004,Somalia,SOM,United States of America,USA,89,0,61,221,371
2004,Spain,ESP,United States of America,USA,0,0,5,10,15
2004,Viet Nam,VNM,United States of America,USA,5,0,95,110,210
2004,Sudan,SDN,United States of America,USA,67,0,58,56,181
2004,Suriname,SUR,United States of America,USA,0,0,0,10,10
2004,Slovakia,SVK,United States of America,USA,0,0,10,5,15
2004,Slovenia,SVN,United States of America,USA,0,0,5,0,5
2004,Syrian Arab Rep.,SYR,United States of America,USA,10,0,50,48,108
2004,United Rep. of Tanzania,TZA,United States of America,USA,0,0,18,13,31
2004,Thailand,THA,United States of America,USA,0,0,12,35,47
2004,Tajikistan,TJK,United States of America,USA,5,0,0,5,10
2004,Turkmenistan,TKM,United States of America,USA,16,0,0,11,27
2004,Togo,TGO,United States of America,USA,67,0,128,86,281
2004,Tonga,TON,United States of America,USA,0,0,5,5,10
2004,Trinidad and Tobago,TTO,United States of America,USA,0,0,10,24,34
2004,Tunisia,TUN,United States of America,USA,0,0,12,12,24
2004,Turkey,TUR,United States of America,USA,27,0,41,40,108
2004,United Arab Emirates,ARE,United States of America,USA,5,0,5,5,15
2004,Uganda,UGA,United States of America,USA,50,0,49,39,138
2004,Ukraine,UKR,United States of America,USA,90,0,101,147,338
2004,Uruguay,URY,United States of America,USA,5,0,20,28,53
2004,Uzbekistan,UZB,United States of America,USA,76,0,43,106,225
2004,Venezuela (Bolivarian Republic of),VEN,United States of America,USA,57,0,252,229,538
2004,Samoa,WSM,United States of America,USA,0,0,0,5,5
2004,Yemen,YEM,United States of America,USA,10,0,43,43,96
2004,Zambia,ZMB,United States of America,USA,5,0,13,12,30
2004,Zimbabwe,ZWE,United States of America,USA,71,0,48,71,190
2004,Stateless,XXA,United States of America,USA,59,0,38,51,148
2004,Unknown ,,United States of America,USA,0,0,11,5,16
2005,Afghanistan,AFG,United States of America,USA,33,0,30,39,102
2005,Albania,ALB,United States of America,USA,609,0,514,442,1565
2005,Algeria,DZA,United States of America,USA,23,0,37,26,86
2005,Angola,AGO,United States of America,USA,5,0,22,28,55
2005,Egypt,EGY,United States of America,USA,195,0,101,167,463
2005,Argentina,ARG,United States of America,USA,10,0,230,184,424
2005,Armenia,ARM,United States of America,USA,268,0,325,332,925
2005,Austria,AUT,United States of America,USA,5,0,0,0,5
2005,Azerbaijan,AZE,United States of America,USA,30,0,25,38,93
2005,Bahrain,BHR,United States of America,USA,0,0,5,0,5
2005,Barbados,BRB,United States of America,USA,0,0,0,5,5
2005,Burundi,BDI,United States of America,USA,11,0,16,14,41
2005,Belgium,BEL,United States of America,USA,5,0,0,11,16
2005,Benin,BEN,United States of America,USA,0,0,5,5,10
2005,Bangladesh,BGD,United States of America,USA,121,0,118,198,437
2005,Bahamas,BHS,United States of America,USA,5,0,11,5,21
2005,Burkina Faso,BFA,United States of America,USA,5,0,14,10,29
2005,Belarus,BLR,United States of America,USA,89,0,32,94,215
2005,Bolivia (Plurinational State of),BOL,United States of America,USA,5,0,15,16,36
2005,Brazil,BRA,United States of America,USA,24,0,74,532,630
2005,Bosnia and Herzegovina,BIH,United States of America,USA,10,0,11,21,42
2005,Bulgaria,BGR,United States of America,USA,77,0,40,82,199
2005,Belize,BLZ,United States of America,USA,0,0,5,5,10
2005,Cambodia,KHM,United States of America,USA,30,0,68,55,153
2005,Canada,CAN,United States of America,USA,5,0,5,14,24
2005,Central African Rep.,CAF,United States of America,USA,18,0,14,19,51
2005,Chad,TCD,United States of America,USA,10,0,0,10,20
2005,China,CHN,United States of America,USA,1458,0,2592,1777,5827
2005,Chile,CHL,United States of America,USA,5,0,17,17,39
2005,Cameroon,CMR,United States of America,USA,264,0,244,266,774
2005,Congo,COG,United States of America,USA,76,0,75,85,236
2005,Dem. Rep. of the Congo,COD,United States of America,USA,38,0,49,45,132
2005,Colombia,COL,United States of America,USA,1155,0,2312,2481,5948
2005,Costa Rica,CRI,United States of America,USA,0,0,5,5,10
2005,Cuba,CUB,United States of America,USA,21,0,100,441,562
2005,Czechia,CZE,United States of America,USA,5,0,10,28,43
2005,Dominican Rep.,DOM,United States of America,USA,0,0,37,50,87
2005,Ecuador,ECU,United States of America,USA,11,0,34,68,113
2005,Eritrea,ERI,United States of America,USA,68,0,35,46,149
2005,Estonia,EST,United States of America,USA,5,0,10,29,44
2005,Ethiopia,ETH,United States of America,USA,264,0,189,178,631
2005,Fiji,FJI,United States of America,USA,35,0,94,118,247
2005,Finland,FIN,United States of America,USA,0,0,0,5,5
2005,France,FRA,United States of America,USA,5,0,10,28,43
2005,Gabon,GAB,United States of America,USA,0,0,5,5,10
2005,Gambia,GMB,United States of America,USA,30,0,46,97,173
2005,Palestinian,PSE,United States of America,USA,0,0,5,10,15
2005,United Kingdom of Great Britain and Northern Ireland,GBR,United States of America,USA,10,0,19,14,43
2005,Georgia,GEO,United States of America,USA,64,0,70,76,210
2005,Germany,DEU,United States of America,USA,5,0,18,13,36
2005,Ghana,GHA,United States of America,USA,5,0,24,32,61
2005,Guinea-Bissau,GNB,United States of America,USA,5,0,5,0,10
2005,Greece,GRC,United States of America,USA,10,0,5,0,15
2005,Guatemala,GTM,United States of America,USA,142,0,824,1865,2831
2005,Guinea,GIN,United States of America,USA,258,0,215,170,643
2005,Guyana,GUY,United States of America,USA,30,0,104,82,216
2005,Haiti,HTI,United States of America,USA,656,0,2788,1359,4803
2005,"China, Hong Kong SAR",HKG,United States of America,USA,0,0,5,0,5
2005,Honduras,HND,United States of America,USA,66,0,334,350,750
2005,Croatia,HRV,United States of America,USA,0,0,10,5,15
2005,Hungary,HUN,United States of America,USA,0,0,5,5,10
2005,Cote d'Ivoire,CIV,United States of America,USA,109,0,84,90,283
2005,India,IND,United States of America,USA,311,0,510,622,1443
2005,Indonesia,IDN,United States of America,USA,374,0,1276,786,2436
2005,Ireland,IRL,United States of America,USA,0,0,0,5,5
2005,Iran (Islamic Rep. of),IRN,United States of America,USA,143,0,133,181,457
2005,Iraq,IRQ,United States of America,USA,96,0,121,95,312
2005,Israel,ISR,United States of America,USA,17,0,37,47,101
2005,Italy,ITA,United States of America,USA,0,0,5,10,15
2005,Jamaica,JAM,United States of America,USA,0,0,52,95,147
2005,Jordan,JOR,United States of America,USA,21,0,63,94,178
2005,Japan,JPN,United States of America,USA,0,0,13,19,32
2005,Kazakhstan,KAZ,United States of America,USA,13,0,13,13,39
2005,Kenya,KEN,United States of America,USA,54,0,85,156,295
2005,Kyrgyzstan,KGZ,United States of America,USA,12,0,5,17,34
2005,Rep. of Korea,KOR,United States of America,USA,0,0,16,17,33
2005,Dem. People's Rep. of Korea,PRK,United States of America,USA,0,0,5,0,5
2005,Kuwait,KWT,United States of America,USA,5,0,5,5,15
2005,Lao People's Dem. Rep.,LAO,United States of America,USA,19,0,43,82,144
2005,Liberia,LBR,United States of America,USA,70,0,68,195,333
2005,Lebanon,LBN,United States of America,USA,23,0,66,93,182
2005,Sri Lanka,LKA,United States of America,USA,74,0,64,135,273
2005,Lithuania,LTU,United States of America,USA,5,0,22,37,64
2005,Latvia,LVA,United States of America,USA,5,0,10,25,40
2005,Mauritania,MRT,United States of America,USA,193,0,308,426,927
2005,North Macedonia,MKD,United States of America,USA,22,0,44,32,98
2005,Rep. of Moldova,MDA,United States of America,USA,5,0,10,16,31
2005,Mexico,MEX,United States of America,USA,34,0,360,8348,8742
2005,Mali,MLI,United States of America,USA,18,0,19,34,71
2005,Malaysia,MYS,United States of America,USA,5,0,10,13,28
2005,Malawi,MWI,United States of America,USA,0,0,5,0,5
2005,Mongolia,MNG,United States of America,USA,25,0,43,33,101
2005,Morocco,MAR,United States of America,USA,5,0,17,26,48
2005,Myanmar,MMR,United States of America,USA,165,0,47,67,279
2005,Nepal,NPL,United States of America,USA,85,0,60,78,223
2005,Netherlands,NLD,United States of America,USA,0,0,5,5,10
2005,Niger,NER,United States of America,USA,5,0,13,28,46
2005,Nicaragua,NIC,United States of America,USA,16,0,79,323,418
2005,Nigeria,NGA,United States of America,USA,34,0,138,131,303
2005,Oman,OMN,United States of America,USA,0,0,0,5,5
2005,Pakistan,PAK,United States of America,USA,140,0,328,350,818
2005,Panama,PAN,United States of America,USA,5,0,5,14,24
2005,Paraguay,PRY,United States of America,USA,0,0,5,10,15
2005,Peru,PER,United States of America,USA,59,0,178,212,449
2005,Philippines,PHL,United States of America,USA,27,0,62,216,305
2005,Poland,POL,United States of America,USA,5,0,30,84,119
2005,Portugal,PRT,United States of America,USA,0,0,5,22,27
2005,Romania,ROU,United States of America,USA,18,0,45,67,130
2005,South Africa,ZAF,United States of America,USA,5,0,13,28,46
2005,Russian Federation,RUS,United States of America,USA,422,0,295,596,1313
2005,Rwanda,RWA,United States of America,USA,19,0,18,13,50
2005,El Salvador,SLV,United States of America,USA,64,0,698,1638,2400
2005,Saudi Arabia,SAU,United States of America,USA,5,0,5,17,27
2005,Serbia and Kosovo: S/RES/1244 (1999),SRB,United States of America,USA,228,0,198,152,578
2005,Senegal,SEN,United States of America,USA,26,0,41,45,112
2005,Seychelles,SYC,United States of America,USA,5,0,0,0,5
2005,Singapore,SGP,United States of America,USA,0,0,5,0,5
2005,Sierra Leone,SLE,United States of America,USA,81,0,147,199,427
2005,Somalia,SOM,United States of America,USA,89,0,68,276,433
2005,Spain,ESP,United States of America,USA,0,0,10,13,23
2005,Viet Nam,VNM,United States of America,USA,10,0,55,84,149
2005,Sudan,SDN,United States of America,USA,55,0,36,73,164
2005,Suriname,SUR,United States of America,USA,0,0,5,0,5
2005,Slovakia,SVK,United States of America,USA,5,0,5,10,20
2005,Sweden,SWE,United States of America,USA,0,0,0,5,5
2005,Syrian Arab Rep.,SYR,United States of America,USA,11,0,43,52,106
2005,United Rep. of Tanzania,TZA,United States of America,USA,5,0,14,29,48
2005,Thailand,THA,United States of America,USA,0,0,10,18,28
2005,Tajikistan,TJK,United States of America,USA,10,0,0,5,15
2005,Turkmenistan,TKM,United States of America,USA,13,0,5,11,29
2005,Togo,TGO,United States of America,USA,102,0,78,106,286
2005,Tonga,TON,United States of America,USA,0,0,0,5,5
2005,Trinidad and Tobago,TTO,United States of America,USA,5,0,10,30,45
2005,Tunisia,TUN,United States of America,USA,5,0,14,18,37
2005,Turkey,TUR,United States of America,USA,12,0,44,60,116
2005,Uganda,UGA,United States of America,USA,53,0,28,45,126
2005,Ukraine,UKR,United States of America,USA,69,0,101,115,285
2005,Uruguay,URY,United States of America,USA,0,0,14,16,30
2005,Uzbekistan,UZB,United States of America,USA,94,0,55,96,245
2005,Venezuela (Bolivarian Republic of),VEN,United States of America,USA,154,0,506,399,1059
2005,Samoa,WSM,United States of America,USA,0,0,0,5,5
2005,Yemen,YEM,United States of America,USA,10,0,41,22,73
2005,Zambia,ZMB,United States of America,USA,10,0,10,10,30
2005,Zimbabwe,ZWE,United States of America,USA,58,0,85,117,260
2005,Stateless,XXA,United States of America,USA,71,0,28,48,147
2005,Unknown ,,United States of America,USA,5,0,17,0,22
2006,Afghanistan,AFG,United States of America,USA,24,0,10,26,60
2006,Albania,ALB,United States of America,USA,506,0,391,310,1207
2006,Algeria,DZA,United States of America,USA,13,0,22,20,55
2006,Angola,AGO,United States of America,USA,16,0,19,5,40
2006,Egypt,EGY,United States of America,USA,240,0,62,145,447
2006,Argentina,ARG,United States of America,USA,10,0,144,122,276
2006,Armenia,ARM,United States of America,USA,286,0,161,285,732
2006,Azerbaijan,AZE,United States of America,USA,27,0,11,21,59
2006,Bahrain,BHR,United States of America,USA,0,0,10,5,15
2006,Burundi,BDI,United States of America,USA,12,0,5,10,27
2006,Belgium,BEL,United States of America,USA,5,0,0,13,18
2006,Benin,BEN,United States of America,USA,0,0,5,5,10
2006,Bangladesh,BGD,United States of America,USA,114,0,83,193,390
2006,Bahamas,BHS,United States of America,USA,0,0,5,5,10
2006,Burkina Faso,BFA,United States of America,USA,13,0,10,20,43
2006,Belarus,BLR,United States of America,USA,105,0,47,94,246
2006,Bolivia (Plurinational State of),BOL,United States of America,USA,0,0,0,14,14
2006,Brazil,BRA,United States of America,USA,32,0,93,125,250
2006,Bosnia and Herzegovina,BIH,United States of America,USA,5,0,16,16,37
2006,Bulgaria,BGR,United States of America,USA,72,0,39,66,177
2006,Belize,BLZ,United States of America,USA,0,0,5,13,18
2006,Cambodia,KHM,United States of America,USA,20,0,56,40,116
2006,Canada,CAN,United States of America,USA,5,0,5,11,21
2006,Central African Rep.,CAF,United States of America,USA,10,0,20,16,46
2006,Chad,TCD,United States of America,USA,15,0,5,10,30
2006,China,CHN,United States of America,USA,4060,0,2119,2079,8258
2006,Chile,CHL,United States of America,USA,0,0,5,10,15
2006,Cameroon,CMR,United States of America,USA,358,0,165,187,710
2006,Congo,COG,United States of America,USA,89,0,46,79,214
2006,Dem. Rep. of the Congo,COD,United States of America,USA,27,0,36,35,98
2006,Colombia,COL,United States of America,USA,775,0,1644,1926,4345
2006,Costa Rica,CRI,United States of America,USA,0,0,0,11,11
2006,Cuba,CUB,United States of America,USA,26,0,79,535,640
2006,Cabo Verde,CPV,United States of America,USA,0,0,0,5,5
2006,Czechia,CZE,United States of America,USA,5,0,10,33,48
2006,Dominican Rep.,DOM,United States of America,USA,0,0,17,52,69
2006,Ecuador,ECU,United States of America,USA,11,0,29,66,106
2006,Eritrea,ERI,United States of America,USA,93,0,29,86,208
2006,Estonia,EST,United States of America,USA,5,0,5,19,29
2006,Ethiopia,ETH,United States of America,USA,342,0,168,153,663
2006,Fiji,FJI,United States of America,USA,45,0,50,97,192
2006,France,FRA,United States of America,USA,0,0,5,5,10
2006,Gabon,GAB,United States of America,USA,5,0,0,5,10
2006,Gambia,GMB,United States of America,USA,46,0,34,142,222
2006,Palestinian,PSE,United States of America,USA,0,0,5,10,15
2006,United Kingdom of Great Britain and Northern Ireland,GBR,United States of America,USA,0,0,10,23,33
2006,Georgia,GEO,United States of America,USA,58,0,44,53,155
2006,Germany,DEU,United States of America,USA,10,0,5,5,20
2006,Ghana,GHA,United States of America,USA,5,0,20,28,53
2006,Guinea-Bissau,GNB,United States of America,USA,0,0,5,5,10
2006,Greece,GRC,United States of America,USA,5,0,0,5,10
2006,Guatemala,GTM,United States of America,USA,157,0,886,2169,3212
2006,Guinea,GIN,United States of America,USA,356,0,202,163,721
2006,Guyana,GUY,United States of America,USA,16,0,76,86,178
2006,Haiti,HTI,United States of America,USA,570,0,2517,2260,5347
2006,Honduras,HND,United States of America,USA,66,0,421,391,878
2006,Croatia,HRV,United States of America,USA,0,0,5,5,10
2006,Hungary,HUN,United States of America,USA,0,0,5,5,10
2006,Cote d'Ivoire,CIV,United States of America,USA,159,0,81,97,337
2006,India,IND,United States of America,USA,450,0,458,491,1399
2006,Indonesia,IDN,United States of America,USA,314,0,1088,705,2107
2006,Iran (Islamic Rep. of),IRN,United States of America,USA,118,0,85,176,379
2006,Iraq,IRQ,United States of America,USA,190,0,125,91,406
2006,Israel,ISR,United States of America,USA,17,0,21,43,81
2006,Italy,ITA,United States of America,USA,5,0,10,10,25
2006,Jamaica,JAM,United States of America,USA,5,0,44,87,136
2006,Jordan,JOR,United States of America,USA,27,0,45,65,137
2006,Japan,JPN,United States of America,USA,5,0,5,15,25
2006,Kazakhstan,KAZ,United States of America,USA,22,0,12,25,59
2006,Kenya,KEN,United States of America,USA,55,0,117,129,301
2006,Kyrgyzstan,KGZ,United States of America,USA,20,0,10,13,43
2006,Rep. of Korea,KOR,United States of America,USA,0,0,5,14,19
2006,Dem. People's Rep. of Korea,PRK,United States of America,USA,5,0,0,0,5
2006,Kuwait,KWT,United States of America,USA,0,0,5,10,15
2006,Lao People's Dem. Rep.,LAO,United States of America,USA,11,0,35,54,100
2006,Liberia,LBR,United States of America,USA,59,0,63,143,265
2006,Libya,LBY,United States of America,USA,0,0,5,0,5
2006,Lebanon,LBN,United States of America,USA,26,0,47,110,183
2006,Lesotho,LSO,United States of America,USA,0,0,0,5,5
2006,Sri Lanka,LKA,United States of America,USA,81,0,47,75,203
2006,Lithuania,LTU,United States of America,USA,18,0,18,54,90
2006,Latvia,LVA,United States of America,USA,12,0,5,17,34
2006,Madagascar,MDG,United States of America,USA,0,0,0,5,5
2006,Mauritania,MRT,United States of America,USA,218,0,194,271,683
2006,North Macedonia,MKD,United States of America,USA,20,0,22,21,63
2006,Rep. of Moldova,MDA,United States of America,USA,0,0,5,21,26
2006,Mexico,MEX,United States of America,USA,48,0,295,4927,5270
2006,Mali,MLI,United States of America,USA,61,0,36,72,169
2006,Malaysia,MYS,United States of America,USA,5,0,5,5,15
2006,Malawi,MWI,United States of America,USA,0,0,0,5,5
2006,Mongolia,MNG,United States of America,USA,38,0,26,24,88
2006,Morocco,MAR,United States of America,USA,10,0,22,17,49
2006,Myanmar,MMR,United States of America,USA,153,0,40,65,258
2006,Nepal,NPL,United States of America,USA,163,0,67,68,298
2006,Niger,NER,United States of America,USA,10,0,24,25,59
2006,Nicaragua,NIC,United States of America,USA,15,0,110,1036,1161
2006,Nigeria,NGA,United States of America,USA,27,0,89,104,220
2006,Pakistan,PAK,United States of America,USA,174,0,250,364,788
2006,Panama,PAN,United States of America,USA,5,0,0,5,10
2006,Paraguay,PRY,United States of America,USA,0,0,5,5,10
2006,Peru,PER,United States of America,USA,82,0,126,193,401
2006,Philippines,PHL,United States of America,USA,17,0,65,167,249
2006,Poland,POL,United States of America,USA,5,0,22,231,258
2006,Portugal,PRT,United States of America,USA,5,0,5,27,37
2006,Romania,ROU,United States of America,USA,43,0,33,84,160
2006,South Africa,ZAF,United States of America,USA,20,0,15,36,71
2006,Russian Federation,RUS,United States of America,USA,391,0,201,503,1095
2006,Rwanda,RWA,United States of America,USA,21,0,10,5,36
2006,El Salvador,SLV,United States of America,USA,95,0,1003,2914,4012
2006,Saudi Arabia,SAU,United States of America,USA,13,0,0,10,23
2006,Serbia and Kosovo: S/RES/1244 (1999),SRB,United States of America,USA,185,0,99,121,405
2006,Senegal,SEN,United States of America,USA,15,0,41,35,91
2006,Seychelles,SYC,United States of America,USA,0,0,5,5,10
2006,Singapore,SGP,United States of America,USA,0,0,0,5,5
2006,Sierra Leone,SLE,United States of America,USA,78,0,108,146,332
2006,Somalia,SOM,United States of America,USA,111,0,60,174,345
2006,Spain,ESP,United States of America,USA,0,0,10,5,15
2006,Viet Nam,VNM,United States of America,USA,10,0,39,58,107
2006,Sudan,SDN,United States of America,USA,44,0,27,53,124
2006,Suriname,SUR,United States of America,USA,0,0,0,5,5
2006,Slovakia,SVK,United States of America,USA,0,0,0,20,20
2006,Sweden,SWE,United States of America,USA,0,0,0,5,5
2006,Syrian Arab Rep.,SYR,United States of America,USA,19,0,31,36,86
2006,United Rep. of Tanzania,TZA,United States of America,USA,17,0,15,19,51
2006,Thailand,THA,United States of America,USA,0,0,5,12,17
2006,Tajikistan,TJK,United States of America,USA,5,0,0,0,5
2006,Turkmenistan,TKM,United States of America,USA,22,0,10,15,47
2006,Togo,TGO,United States of America,USA,146,0,74,109,329
2006,Tonga,TON,United States of America,USA,0,0,0,5,5
2006,Trinidad and Tobago,TTO,United States of America,USA,5,0,5,31,41
2006,Tunisia,TUN,United States of America,USA,0,0,5,14,19
2006,Turkey,TUR,United States of America,USA,33,0,24,45,102
2006,United Arab Emirates,ARE,United States of America,USA,5,0,0,0,5
2006,Uganda,UGA,United States of America,USA,36,0,32,39,107
2006,Ukraine,UKR,United States of America,USA,44,0,91,136,271
2006,Uruguay,URY,United States of America,USA,0,0,15,14,29
2006,Uzbekistan,UZB,United States of America,USA,95,0,62,95,252
2006,Venezuela (Bolivarian Republic of),VEN,United States of America,USA,274,0,586,433,1293
2006,Yemen,YEM,United States of America,USA,10,0,28,52,90
2006,Zambia,ZMB,United States of America,USA,10,0,5,25,40
2006,Zimbabwe,ZWE,United States of America,USA,62,0,69,101,232
2006,Stateless,XXA,United States of America,USA,86,0,26,46,158
2006,Unknown ,,United States of America,USA,0,0,5,5,10
2007,Afghanistan,AFG,United States of America,USA,10,0,5,19,34
2007,Albania,ALB,United States of America,USA,283,0,146,160,589
2007,Algeria,DZA,United States of America,USA,5,0,0,10,15
2007,Angola,AGO,United States of America,USA,5,0,0,5,10
2007,Egypt,EGY,United States of America,USA,198,0,40,101,339
2007,Argentina,ARG,United States of America,USA,10,0,5,43,58
2007,Armenia,ARM,United States of America,USA,149,0,79,152,380
2007,Azerbaijan,AZE,United States of America,USA,10,0,0,10,20
2007,Burundi,BDI,United States of America,USA,0,0,5,0,5
2007,Bangladesh,BGD,United States of America,USA,62,0,29,93,184
2007,Bahamas,BHS,United States of America,USA,0,0,0,5,5
2007,Burkina Faso,BFA,United States of America,USA,16,0,10,16,42
2007,Belarus,BLR,United States of America,USA,51,0,16,41,108
2007,Brazil,BRA,United States of America,USA,24,0,15,70,109
2007,Bosnia and Herzegovina,BIH,United States of America,USA,10,0,0,0,10
2007,Bulgaria,BGR,United States of America,USA,34,0,25,47,106
2007,Cambodia,KHM,United States of America,USA,10,0,17,24,51
2007,Central African Rep.,CAF,United States of America,USA,5,0,0,0,5
2007,Chad,TCD,United States of America,USA,17,0,5,10,32
2007,China,CHN,United States of America,USA,2298,0,687,1183,4168
2007,Chile,CHL,United States of America,USA,0,0,0,10,10
2007,Cameroon,CMR,United States of America,USA,174,0,115,101,390
2007,Congo,COG,United States of America,USA,57,0,25,44,126
2007,Dem. Rep. of the Congo,COD,United States of America,USA,15,0,10,10,35
2007,Colombia,COL,United States of America,USA,583,0,1001,1269,2853
2007,Costa Rica,CRI,United States of America,USA,0,0,0,10,10
2007,Cuba,CUB,United States of America,USA,0,0,0,160,160
2007,Cabo Verde,CPV,United States of America,USA,0,0,0,5,5
2007,Czechia,CZE,United States of America,USA,0,0,0,10,10
2007,Dominican Rep.,DOM,United States of America,USA,0,0,0,5,5
2007,Ecuador,ECU,United States of America,USA,5,0,14,42,61
2007,Eritrea,ERI,United States of America,USA,38,0,12,17,67
2007,Estonia,EST,United States of America,USA,10,0,10,10,30
2007,Ethiopia,ETH,United States of America,USA,183,0,101,96,380
2007,Fiji,FJI,United States of America,USA,22,0,15,45,82
2007,France,FRA,United States of America,USA,0,0,5,5,10
2007,Gambia,GMB,United States of America,USA,50,0,37,135,222
2007,United Kingdom of Great Britain and Northern Ireland,GBR,United States of America,USA,5,0,5,5,15
2007,Georgia,GEO,United States of America,USA,19,0,23,43,85
2007,Ghana,GHA,United States of America,USA,5,0,5,11,21
2007,Guinea-Bissau,GNB,United States of America,USA,5,0,0,5,10
2007,Greece,GRC,United States of America,USA,5,0,0,0,5
2007,Guatemala,GTM,United States of America,USA,62,0,710,2671,3443
2007,Guinea,GIN,United States of America,USA,279,0,126,135,540
2007,Guyana,GUY,United States of America,USA,10,0,0,11,21
2007,Haiti,HTI,United States of America,USA,414,0,1530,2828,4772
2007,Honduras,HND,United States of America,USA,5,0,11,150,166
2007,Croatia,HRV,United States of America,USA,0,0,0,5,5
2007,Hungary,HUN,United States of America,USA,0,0,0,5,5
2007,Cote d'Ivoire,CIV,United States of America,USA,114,0,71,117,302
2007,India,IND,United States of America,USA,314,0,253,322,889
2007,Indonesia,IDN,United States of America,USA,180,0,388,268,836
2007,Iran (Islamic Rep. of),IRN,United States of America,USA,82,0,30,65,177
2007,Iraq,IRQ,United States of America,USA,63,0,35,39,137
2007,Israel,ISR,United States of America,USA,5,0,10,14,29
2007,Jamaica,JAM,United States of America,USA,0,0,0,30,30
2007,Jordan,JOR,United States of America,USA,5,0,19,18,42
2007,Japan,JPN,United States of America,USA,0,0,5,10,15
2007,Kazakhstan,KAZ,United States of America,USA,26,0,5,10,41
2007,Kenya,KEN,United States of America,USA,48,0,63,100,211
2007,Rep. of Korea,KOR,United States of America,USA,0,0,0,5,5
2007,Lao People's Dem. Rep.,LAO,United States of America,USA,5,0,10,27,42
2007,Liberia,LBR,United States of America,USA,36,0,32,101,169
2007,Lebanon,LBN,United States of America,USA,15,0,13,27,55
2007,Sri Lanka,LKA,United States of America,USA,65,0,16,14,95
2007,Lithuania,LTU,United States of America,USA,0,0,10,64,74
2007,Latvia,LVA,United States of America,USA,0,0,5,5,10
2007,Mauritania,MRT,United States of America,USA,157,0,129,135,421
2007,North Macedonia,MKD,United States of America,USA,11,0,5,5,21
2007,Rep. of Moldova,MDA,United States of America,USA,5,0,5,5,15
2007,Mexico,MEX,United States of America,USA,25,0,105,2657,2787
2007,Mali,MLI,United States of America,USA,51,0,30,76,157
2007,Malaysia,MYS,United States of America,USA,5,0,10,5,20
2007,Mongolia,MNG,United States of America,USA,43,0,28,13,84
2007,Morocco,MAR,United States of America,USA,5,0,0,5,10
2007,Myanmar,MMR,United States of America,USA,47,0,17,28,92
2007,Nepal,NPL,United States of America,USA,116,0,54,64,234
2007,Niger,NER,United States of America,USA,5,0,0,10,15
2007,Nicaragua,NIC,United States of America,USA,5,0,30,1424,1459
2007,Nigeria,NGA,United States of America,USA,18,0,17,59,94
2007,Pakistan,PAK,United States of America,USA,73,0,52,117,242
2007,Paraguay,PRY,United States of America,USA,0,0,0,5,5
2007,Peru,PER,United States of America,USA,40,0,98,132,270
2007,Philippines,PHL,United States of America,USA,5,0,27,75,107
2007,Poland,POL,United States of America,USA,5,0,5,40,50
2007,Portugal,PRT,United States of America,USA,0,0,0,5,5
2007,Romania,ROU,United States of America,USA,11,0,5,162,178
2007,South Africa,ZAF,United States of America,USA,0,0,5,0,5
2007,Russian Federation,RUS,United States of America,USA,205,0,117,285,607
2007,Rwanda,RWA,United States of America,USA,5,0,0,5,10
2007,El Salvador,SLV,United States of America,USA,21,0,250,3458,3729
2007,Saudi Arabia,SAU,United States of America,USA,5,0,0,5,10
2007,Serbia and Kosovo: S/RES/1244 (1999),SRB,United States of America,USA,104,0,32,72,208
2007,Senegal,SEN,United States of America,USA,17,0,13,25,55
2007,Sierra Leone,SLE,United States of America,USA,42,0,47,69,158
2007,Somalia,SOM,United States of America,USA,42,0,32,60,134
2007,Spain,ESP,United States of America,USA,0,0,0,5,5
2007,Viet Nam,VNM,United States of America,USA,5,0,0,12,17
2007,Sudan,SDN,United States of America,USA,10,0,5,24,39
2007,Slovakia,SVK,United States of America,USA,0,0,0,5,5
2007,Sweden,SWE,United States of America,USA,0,0,0,5,5
2007,Syrian Arab Rep.,SYR,United States of America,USA,10,0,10,14,34
2007,United Rep. of Tanzania,TZA,United States of America,USA,5,0,10,10,25
2007,Thailand,THA,United States of America,USA,5,0,0,5,10
2007,Tajikistan,TJK,United States of America,USA,5,0,0,0,5
2007,Turkmenistan,TKM,United States of America,USA,12,0,5,5,22
2007,Togo,TGO,United States of America,USA,57,0,33,36,126
2007,Trinidad and Tobago,TTO,United States of America,USA,0,0,5,14,19
2007,Turkey,TUR,United States of America,USA,13,0,5,10,28
2007,Uganda,UGA,United States of America,USA,30,0,11,19,60
2007,Ukraine,UKR,United States of America,USA,31,0,22,100,153
2007,Uruguay,URY,United States of America,USA,0,0,0,15,15
2007,Uzbekistan,UZB,United States of America,USA,59,0,32,72,163
2007,Venezuela (Bolivarian Republic of),VEN,United States of America,USA,269,0,407,434,1110
2007,Yemen,YEM,United States of America,USA,5,0,10,5,20
2007,Zimbabwe,ZWE,United States of America,USA,50,0,40,45,135
2007,Stateless,XXA,United States of America,USA,60,0,14,20,94
2008,Afghanistan,AFG,United States of America,USA,11,0,0,0,11
2008,Albania,ALB,United States of America,USA,200,0,89,94,383
2008,Angola,AGO,United States of America,USA,5,0,0,0,5
2008,Egypt,EGY,United States of America,USA,153,0,29,61,243
2008,Argentina,ARG,United States of America,USA,5,0,10,21,36
2008,Armenia,ARM,United States of America,USA,115,0,66,126,307
2008,Azerbaijan,AZE,United States of America,USA,5,0,0,5,10
2008,Burundi,BDI,United States of America,USA,0,0,0,5,5
2008,Belgium,BEL,United States of America,USA,5,0,0,5,10
2008,Bangladesh,BGD,United States of America,USA,45,0,10,45,100
2008,Bahamas,BHS,United States of America,USA,0,0,0,5,5
2008,Burkina Faso,BFA,United States of America,USA,20,0,10,22,52
2008,Belarus,BLR,United States of America,USA,52,0,13,22,87
2008,Bolivia (Plurinational State of),BOL,United States of America,USA,5,0,0,10,15
2008,Brazil,BRA,United States of America,USA,18,0,19,64,101
2008,Bosnia and Herzegovina,BIH,United States of America,USA,5,0,0,0,5
2008,Bulgaria,BGR,United States of America,USA,35,0,10,28,73
2008,Cambodia,KHM,United States of America,USA,5,0,10,20,35
2008,Canada,CAN,United States of America,USA,0,0,5,10,15
2008,Central African Rep.,CAF,United States of America,USA,10,0,5,0,15
2008,Chad,TCD,United States of America,USA,13,0,5,10,28
2008,China,CHN,United States of America,USA,2132,0,966,1066,4164
2008,Chile,CHL,United States of America,USA,0,0,0,5,5
2008,Cameroon,CMR,United States of America,USA,117,0,78,99,294
2008,Congo,COG,United States of America,USA,46,0,22,32,100
2008,Dem. Rep. of the Congo,COD,United States of America,USA,12,0,10,5,27
2008,Colombia,COL,United States of America,USA,467,0,666,843,1976
2008,Costa Rica,CRI,United States of America,USA,0,0,0,10,10
2008,Cuba,CUB,United States of America,USA,0,0,5,68,73
2008,Czechia,CZE,United States of America,USA,5,0,0,19,24
2008,Dominican Rep.,DOM,United States of America,USA,0,0,0,5,5
2008,Ecuador,ECU,United States of America,USA,5,0,11,27,43
2008,Eritrea,ERI,United States of America,USA,34,0,11,14,59
2008,Estonia,EST,United States of America,USA,0,0,5,10,15
2008,Ethiopia,ETH,United States of America,USA,214,0,99,79,392
2008,Fiji,FJI,United States of America,USA,17,0,10,44,71
2008,France,FRA,United States of America,USA,0,0,0,5,5
2008,Gambia,GMB,United States of America,USA,43,0,39,85,167
2008,United Kingdom of Great Britain and Northern Ireland,GBR,United States of America,USA,5,0,5,12,22
2008,Georgia,GEO,United States of America,USA,17,0,17,16,50
2008,Ghana,GHA,United States of America,USA,5,0,5,11,21
2008,Guatemala,GTM,United States of America,USA,89,0,684,2242,3015
2008,Guinea,GIN,United States of America,USA,208,0,117,113,438
2008,Guyana,GUY,United States of America,USA,0,0,5,11,16
2008,Haiti,HTI,United States of America,USA,375,0,1402,1917,3694
2008,Honduras,HND,United States of America,USA,5,0,21,111,137
2008,Hungary,HUN,United States of America,USA,0,0,0,10,10
2008,Cote d'Ivoire,CIV,United States of America,USA,83,0,61,95,239
2008,India,IND,United States of America,USA,225,0,189,222,636
2008,Indonesia,IDN,United States of America,USA,171,0,311,204,686
2008,Iran (Islamic Rep. of),IRN,United States of America,USA,51,0,14,57,122
2008,Iraq,IRQ,United States of America,USA,92,0,16,32,140
2008,Israel,ISR,United States of America,USA,13,0,5,10,28
2008,Jamaica,JAM,United States of America,USA,0,0,5,12,17
2008,Jordan,JOR,United States of America,USA,13,0,17,22,52
2008,Japan,JPN,United States of America,USA,0,0,0,5,5
2008,Kazakhstan,KAZ,United States of America,USA,10,0,10,5,25
2008,Kenya,KEN,United States of America,USA,48,0,39,95,182
2008,Dem. People's Rep. of Korea,PRK,United States of America,USA,0,0,0,5,5
2008,Lao People's Dem. Rep.,LAO,United States of America,USA,5,0,5,14,24
2008,Liberia,LBR,United States of America,USA,26,0,15,53,94
2008,Lebanon,LBN,United States of America,USA,12,0,20,26,58
2008,Sri Lanka,LKA,United States of America,USA,58,0,19,26,103
2008,Lithuania,LTU,United States of America,USA,0,0,10,23,33
2008,Latvia,LVA,United States of America,USA,0,0,5,5,10
2008,Mauritania,MRT,United States of America,USA,76,0,91,61,228
2008,North Macedonia,MKD,United States of America,USA,0,0,5,5,10
2008,Rep. of Moldova,MDA,United States of America,USA,12,0,5,24,41
2008,Mexico,MEX,United States of America,USA,38,0,69,2004,2111
2008,Mali,MLI,United States of America,USA,23,0,43,71,137
2008,Malaysia,MYS,United States of America,USA,0,0,5,0,5
2008,Malawi,MWI,United States of America,USA,0,0,0,5,5
2008,Mongolia,MNG,United States of America,USA,33,0,15,25,73
2008,Morocco,MAR,United States of America,USA,15,0,5,5,25
2008,Myanmar,MMR,United States of America,USA,28,0,10,10,48
2008,Nepal,NPL,United States of America,USA,128,0,53,45,226
2008,Niger,NER,United States of America,USA,5,0,5,5,15
2008,Nicaragua,NIC,United States of America,USA,5,0,32,274,311
2008,Nigeria,NGA,United States of America,USA,14,0,22,45,81
2008,Pakistan,PAK,United States of America,USA,70,0,32,83,185
2008,Paraguay,PRY,United States of America,USA,0,0,0,5,5
2008,Peru,PER,United States of America,USA,38,0,44,107,189
2008,Philippines,PHL,United States of America,USA,10,0,10,55,75
2008,Poland,POL,United States of America,USA,5,0,5,40,50
2008,Portugal,PRT,United States of America,USA,0,0,0,5,5
2008,Romania,ROU,United States of America,USA,17,0,5,32,54
2008,South Africa,ZAF,United States of America,USA,0,0,10,5,15
2008,Russian Federation,RUS,United States of America,USA,319,0,110,318,747
2008,Rwanda,RWA,United States of America,USA,10,0,5,0,15
2008,El Salvador,SLV,United States of America,USA,33,0,274,3147,3454
2008,Serbia and Kosovo: S/RES/1244 (1999),SRB,United States of America,USA,117,0,30,66,213
2008,Senegal,SEN,United States of America,USA,10,0,16,20,46
2008,Sierra Leone,SLE,United States of America,USA,43,0,47,39,129
2008,Somalia,SOM,United States of America,USA,24,0,23,52,99
2008,Viet Nam,VNM,United States of America,USA,5,0,5,15,25
2008,Sudan,SDN,United States of America,USA,18,0,10,21,49
2008,Slovakia,SVK,United States of America,USA,0,0,0,5,5
2008,Syrian Arab Rep.,SYR,United States of America,USA,5,0,10,12,27
2008,United Rep. of Tanzania,TZA,United States of America,USA,5,0,5,5,15
2008,Turkmenistan,TKM,United States of America,USA,5,0,0,0,5
2008,Togo,TGO,United States of America,USA,41,0,22,19,82
2008,Tonga,TON,United States of America,USA,0,0,0,5,5
2008,Trinidad and Tobago,TTO,United States of America,USA,0,0,0,5,5
2008,Turkey,TUR,United States of America,USA,0,0,0,11,11
2008,Uganda,UGA,United States of America,USA,18,0,5,17,40
2008,Ukraine,UKR,United States of America,USA,46,0,22,67,135
2008,Uruguay,URY,United States of America,USA,0,0,0,5,5
2008,Uzbekistan,UZB,United States of America,USA,51,0,31,52,134
2008,Venezuela (Bolivarian Republic of),VEN,United States of America,USA,260,0,315,287,862
2008,Yemen,YEM,United States of America,USA,5,0,13,5,23
2008,Zambia,ZMB,United States of America,USA,0,0,5,0,5
2008,Zimbabwe,ZWE,United States of America,USA,40,0,31,54,125
2008,Stateless,XXA,United States of America,USA,37,0,17,20,74
2009,Afghanistan,AFG,United States of America,USA,5,0,5,22,32
2009,Albania,ALB,United States of America,USA,211,0,121,122,454
2009,Algeria,DZA,United States of America,USA,5,0,13,17,35
2009,Angola,AGO,United States of America,USA,5,0,5,14,24
2009,Egypt,EGY,United States of America,USA,173,0,58,111,342
2009,Argentina,ARG,United States of America,USA,10,0,13,47,70
2009,Armenia,ARM,United States of America,USA,196,0,98,224,518
2009,Azerbaijan,AZE,United States of America,USA,13,0,5,22,40
2009,Burundi,BDI,United States of America,USA,15,0,10,5,30
2009,Belgium,BEL,United States of America,USA,5,0,5,10,20
2009,Benin,BEN,United States of America,USA,5,0,5,5,15
2009,Bangladesh,BGD,United States of America,USA,47,0,52,111,210
2009,Bahamas,BHS,United States of America,USA,0,0,5,0,5
2009,Bhutan,BTN,United States of America,USA,5,0,0,5,10
2009,Burkina Faso,BFA,United States of America,USA,39,0,5,30,74
2009,Belarus,BLR,United States of America,USA,73,0,18,61,152
2009,Bolivia (Plurinational State of),BOL,United States of America,USA,0,0,10,14,24
2009,Brazil,BRA,United States of America,USA,22,0,65,95,182
2009,Bosnia and Herzegovina,BIH,United States of America,USA,17,0,12,28,57
2009,Bulgaria,BGR,United States of America,USA,42,0,21,59,122
2009,Belize,BLZ,United States of America,USA,0,0,5,5,10
2009,Cambodia,KHM,United States of America,USA,12,0,30,22,64
2009,Canada,CAN,United States of America,USA,11,0,5,11,27
2009,Central African Rep.,CAF,United States of America,USA,16,0,10,19,45
2009,Chad,TCD,United States of America,USA,40,0,10,30,80
2009,China,CHN,United States of America,USA,3419,0,1660,2094,7173
2009,Chile,CHL,United States of America,USA,5,0,5,5,15
2009,Cameroon,CMR,United States of America,USA,203,0,84,144,431
2009,Congo,COG,United States of America,USA,48,0,24,74,146
2009,Dem. Rep. of the Congo,COD,United States of America,USA,19,0,13,10,42
2009,Colombia,COL,United States of America,USA,356,0,506,714,1576
2009,Costa Rica,CRI,United States of America,USA,0,0,5,13,18
2009,Cuba,CUB,United States of America,USA,15,0,99,226,340
2009,Czechia,CZE,United States of America,USA,0,0,5,13,18
2009,Djibouti,DJI,United States of America,USA,5,0,0,0,5
2009,Dominican Rep.,DOM,United States of America,USA,5,0,27,31,63
2009,Ecuador,ECU,United States of America,USA,5,0,28,94,127
2009,Eritrea,ERI,United States of America,USA,196,0,23,57,276
2009,Estonia,EST,United States of America,USA,10,0,10,26,46
2009,Ethiopia,ETH,United States of America,USA,409,0,112,171,692
2009,Fiji,FJI,United States of America,USA,29,0,24,28,81
2009,Finland,FIN,United States of America,USA,5,0,0,5,10
2009,France,FRA,United States of America,USA,0,0,5,12,17
2009,Gambia,GMB,United States of America,USA,49,0,53,95,197
2009,United Kingdom of Great Britain and Northern Ireland,GBR,United States of America,USA,5,0,15,17,37
2009,Georgia,GEO,United States of America,USA,24,0,28,56,108
2009,Germany,DEU,United States of America,USA,0,0,12,12,24
2009,Ghana,GHA,United States of America,USA,10,0,28,32,70
2009,Guinea-Bissau,GNB,United States of America,USA,5,0,5,5,15
2009,Grenada,GRD,United States of America,USA,0,0,0,5,5
2009,Guatemala,GTM,United States of America,USA,155,0,1156,3417,4728
2009,Guinea,GIN,United States of America,USA,193,0,98,152,443
2009,Guyana,GUY,United States of America,USA,0,0,23,40,63
2009,Haiti,HTI,United States of America,USA,406,0,1589,1262,3257
2009,"China, Hong Kong SAR",HKG,United States of America,USA,0,0,5,0,5
2009,Honduras,HND,United States of America,USA,46,0,400,425,871
2009,Croatia,HRV,United States of America,USA,0,0,5,0,5
2009,Hungary,HUN,United States of America,USA,0,0,5,10,15
2009,Cote d'Ivoire,CIV,United States of America,USA,96,0,66,160,322
2009,India,IND,United States of America,USA,260,0,232,372,864
2009,Indonesia,IDN,United States of America,USA,155,0,335,346,836
2009,Iran (Islamic Rep. of),IRN,United States of America,USA,91,0,48,136,275
2009,Iraq,IRQ,United States of America,USA,364,0,49,93,506
2009,Israel,ISR,United States of America,USA,17,0,18,40,75
2009,Italy,ITA,United States of America,USA,0,0,10,11,21
2009,Jamaica,JAM,United States of America,USA,0,0,80,63,143
2009,Jordan,JOR,United States of America,USA,20,0,38,61,119
2009,Japan,JPN,United States of America,USA,0,0,5,10,15
2009,Kazakhstan,KAZ,United States of America,USA,20,0,10,25,55
2009,Kenya,KEN,United States of America,USA,94,0,94,125,313
2009,Kyrgyzstan,KGZ,United States of America,USA,5,0,5,21,31
2009,Rep. of Korea,KOR,United States of America,USA,0,0,5,23,28
2009,Dem. People's Rep. of Korea,PRK,United States of America,USA,0,0,5,5,10
2009,Kuwait,KWT,United States of America,USA,5,0,5,10,20
2009,Lao People's Dem. Rep.,LAO,United States of America,USA,13,0,26,38,77
2009,Liberia,LBR,United States of America,USA,31,0,55,110,196
2009,Libya,LBY,United States of America,USA,5,0,0,5,10
2009,Lebanon,LBN,United States of America,USA,10,0,46,67,123
2009,Sri Lanka,LKA,United States of America,USA,112,0,61,98,271
2009,Lithuania,LTU,United States of America,USA,0,0,5,18,23
2009,Latvia,LVA,United States of America,USA,0,0,0,13,13
2009,Mauritania,MRT,United States of America,USA,94,0,44,242,380
2009,North Macedonia,MKD,United States of America,USA,15,0,16,10,41
2009,Rep. of Moldova,MDA,United States of America,USA,22,0,17,81,120
2009,Mexico,MEX,United States of America,USA,62,0,366,2974,3402
2009,Mali,MLI,United States of America,USA,71,0,64,136,271
2009,Malaysia,MYS,United States of America,USA,0,0,12,13,25
2009,Malawi,MWI,United States of America,USA,0,0,5,11,16
2009,Mongolia,MNG,United States of America,USA,28,0,43,55,126
2009,Morocco,MAR,United States of America,USA,5,0,13,23,41
2009,Montenegro,MNE,United States of America,USA,47,0,15,16,78
2009,Myanmar,MMR,United States of America,USA,108,0,23,42,173
2009,Namibia,NAM,United States of America,USA,0,0,5,0,5
2009,Nepal,NPL,United States of America,USA,171,0,81,82,334
2009,Netherlands,NLD,United States of America,USA,0,0,5,5,10
2009,Niger,NER,United States of America,USA,14,0,14,39,67
2009,Nicaragua,NIC,United States of America,USA,19,0,135,196,350
2009,Nigeria,NGA,United States of America,USA,29,0,73,92,194
2009,Oman,OMN,United States of America,USA,0,0,0,5,5
2009,Pakistan,PAK,United States of America,USA,99,0,114,242,455
2009,Panama,PAN,United States of America,USA,0,0,5,5,10
2009,Paraguay,PRY,United States of America,USA,0,0,0,5,5
2009,Peru,PER,United States of America,USA,39,0,82,94,215
2009,Philippines,PHL,United States of America,USA,13,0,57,91,161
2009,Poland,POL,United States of America,USA,5,0,17,48,70
2009,Portugal,PRT,United States of America,USA,0,0,0,5,5
2009,Romania,ROU,United States of America,USA,30,0,31,57,118
2009,South Africa,ZAF,United States of America,USA,5,0,10,10,25
2009,Russian Federation,RUS,United States of America,USA,280,0,150,502,932
2009,Rwanda,RWA,United States of America,USA,24,0,5,25,54
2009,El Salvador,SLV,United States of America,USA,117,0,1236,4426,5779
2009,Saudi Arabia,SAU,United States of America,USA,5,0,0,0,5
2009,Serbia and Kosovo: S/RES/1244 (1999),SRB,United States of America,USA,108,0,41,47,196
2009,Senegal,SEN,United States of America,USA,24,0,30,70,124
2009,Singapore,SGP,United States of America,USA,5,0,0,0,5
2009,Sierra Leone,SLE,United States of America,USA,29,0,38,103,170
2009,Somalia,SOM,United States of America,USA,167,0,40,94,301
2009,Spain,ESP,United States of America,USA,5,0,0,5,10
2009,Viet Nam,VNM,United States of America,USA,10,0,31,39,80
2009,Sudan,SDN,United States of America,USA,40,0,33,53,126
2009,Slovakia,SVK,United States of America,USA,0,0,0,12,12
2009,Slovenia,SVN,United States of America,USA,0,0,0,5,5
2009,Sweden,SWE,United States of America,USA,5,0,0,0,5
2009,Syrian Arab Rep.,SYR,United States of America,USA,15,0,12,44,71
2009,United Rep. of Tanzania,TZA,United States of America,USA,5,0,10,19,34
2009,Thailand,THA,United States of America,USA,0,0,10,12,22
2009,Tajikistan,TJK,United States of America,USA,5,0,0,12,17
2009,Turkmenistan,TKM,United States of America,USA,14,0,5,18,37
2009,Togo,TGO,United States of America,USA,39,0,23,90,152
2009,Tonga,TON,United States of America,USA,0,0,0,5,5
2009,Trinidad and Tobago,TTO,United States of America,USA,0,0,18,18,36
2009,Tunisia,TUN,United States of America,USA,0,0,5,11,16
2009,Turkey,TUR,United States of America,USA,17,0,10,28,55
2009,United Arab Emirates,ARE,United States of America,USA,0,0,0,5,5
2009,Uganda,UGA,United States of America,USA,28,0,21,25,74
2009,Ukraine,UKR,United States of America,USA,26,0,56,126,208
2009,Uruguay,URY,United States of America,USA,0,0,0,10,10
2009,Uzbekistan,UZB,United States of America,USA,64,0,48,95,207
2009,Saint Vincent and the Grenadines,VCT,United States of America,USA,0,0,5,0,5
2009,Venezuela (Bolivarian Republic of),VEN,United States of America,USA,191,0,295,356,842
2009,Yemen,YEM,United States of America,USA,5,0,10,22,37
2009,Zambia,ZMB,United States of America,USA,5,0,5,5,15
2009,Zimbabwe,ZWE,United States of America,USA,69,0,51,90,210
2009,Stateless,XXA,United States of America,USA,82,0,20,74,176
2009,Unknown ,,United States of America,USA,12,0,53,64,129
2010,Afghanistan,AFG,United States of America,USA,5,0,10,23,38
2010,Albania,ALB,United States of America,USA,148,0,104,94,346
2010,Algeria,DZA,United States of America,USA,0,0,5,5,10
2010,Angola,AGO,United States of America,USA,0,0,10,5,15
2010,Egypt,EGY,United States of America,USA,216,0,40,146,402
2010,Argentina,ARG,United States of America,USA,10,0,14,34,58
2010,Armenia,ARM,United States of America,USA,206,0,99,226,531
2010,Australia,AUS,United States of America,USA,0,0,5,5,10
2010,Austria,AUT,United States of America,USA,0,0,0,5,5
2010,Azerbaijan,AZE,United States of America,USA,10,0,10,24,44
2010,Bahrain,BHR,United States of America,USA,0,0,0,10,10
2010,Burundi,BDI,United States of America,USA,5,0,5,10,20
2010,Belgium,BEL,United States of America,USA,5,0,5,10,20
2010,Benin,BEN,United States of America,USA,5,0,5,5,15
2010,Bangladesh,BGD,United States of America,USA,48,0,27,121,196
2010,Bahamas,BHS,United States of America,USA,0,0,5,14,19
2010,Bhutan,BTN,United States of America,USA,0,0,0,5,5
2010,Burkina Faso,BFA,United States of America,USA,49,0,15,27,91
2010,Belarus,BLR,United States of America,USA,67,0,27,58,152
2010,Bolivia (Plurinational State of),BOL,United States of America,USA,10,0,10,17,37
2010,Brazil,BRA,United States of America,USA,17,0,58,94,169
2010,Bosnia and Herzegovina,BIH,United States of America,USA,5,0,17,14,36
2010,Bulgaria,BGR,United States of America,USA,20,0,16,36,72
2010,Belize,BLZ,United States of America,USA,0,0,13,10,23
2010,Cambodia,KHM,United States of America,USA,13,0,15,34,62
2010,Canada,CAN,United States of America,USA,5,0,5,13,23
2010,Central African Rep.,CAF,United States of America,USA,10,0,5,5,20
2010,Chad,TCD,United States of America,USA,28,0,5,12,45
2010,China,CHN,United States of America,USA,3796,0,1523,2079,7398
2010,Chile,CHL,United States of America,USA,0,0,5,12,17
2010,Cameroon,CMR,United States of America,USA,196,0,57,128,381
2010,Congo,COG,United States of America,USA,56,0,25,38,119
2010,Dem. Rep. of the Congo,COD,United States of America,USA,16,0,29,26,71
2010,Colombia,COL,United States of America,USA,234,0,380,581,1195
2010,Costa Rica,CRI,United States of America,USA,0,0,5,11,16
2010,Cuba,CUB,United States of America,USA,10,0,106,221,337
2010,Czechia,CZE,United States of America,USA,5,0,5,5,15
2010,Djibouti,DJI,United States of America,USA,0,0,0,5,5
2010,Dominica,DMA,United States of America,USA,0,0,0,5,5
2010,Dominican Rep.,DOM,United States of America,USA,11,0,30,36,77
2010,Ecuador,ECU,United States of America,USA,5,0,63,91,159
2010,Eritrea,ERI,United States of America,USA,179,0,29,57,265
2010,Estonia,EST,United States of America,USA,0,0,5,5,10
2010,Ethiopia,ETH,United States of America,USA,407,0,106,159,672
2010,Fiji,FJI,United States of America,USA,18,0,15,32,65
2010,France,FRA,United States of America,USA,0,0,0,12,12
2010,Gabon,GAB,United States of America,USA,0,0,0,5,5
2010,Gambia,GMB,United States of America,USA,42,0,41,90,173
2010,Palestinian,PSE,United States of America,USA,0,0,5,0,5
2010,United Kingdom of Great Britain and Northern Ireland,GBR,United States of America,USA,0,0,5,20,25
2010,Georgia,GEO,United States of America,USA,32,0,17,36,85
2010,Germany,DEU,United States of America,USA,11,0,15,23,49
2010,Ghana,GHA,United States of America,USA,10,0,31,29,70
2010,Greece,GRC,United States of America,USA,0,0,5,5,10
2010,Guatemala,GTM,United States of America,USA,166,0,1004,2527,3697
2010,Guinea,GIN,United States of America,USA,186,0,76,143,405
2010,Guyana,GUY,United States of America,USA,5,0,13,43,61
2010,Haiti,HTI,United States of America,USA,167,0,496,2717,3380
2010,Honduras,HND,United States of America,USA,65,0,364,416,845
2010,Hungary,HUN,United States of America,USA,0,0,10,17,27
2010,Cote d'Ivoire,CIV,United States of America,USA,66,0,44,92,202
2010,India,IND,United States of America,USA,241,0,224,385,850
2010,Indonesia,IDN,United States of America,USA,116,0,293,315,724
2010,Iran (Islamic Rep. of),IRN,United States of America,USA,83,0,46,130,259
2010,Iraq,IRQ,United States of America,USA,149,0,46,64,259
2010,Israel,ISR,United States of America,USA,10,0,17,19,46
2010,Italy,ITA,United States of America,USA,5,0,10,5,20
2010,Jamaica,JAM,United States of America,USA,5,0,79,68,152
2010,Jordan,JOR,United States of America,USA,19,0,30,55,104
2010,Japan,JPN,United States of America,USA,0,0,5,0,5
2010,Kazakhstan,KAZ,United States of America,USA,17,0,12,28,57
2010,Kenya,KEN,United States of America,USA,90,0,116,135,341
2010,Kyrgyzstan,KGZ,United States of America,USA,10,0,5,23,38
2010,Rep. of Korea,KOR,United States of America,USA,5,0,16,28,49
2010,Dem. People's Rep. of Korea,PRK,United States of America,USA,0,0,0,5,5
2010,Kuwait,KWT,United States of America,USA,5,0,5,10,20
2010,Lao People's Dem. Rep.,LAO,United States of America,USA,5,0,17,37,59
2010,Liberia,LBR,United States of America,USA,25,0,45,95,165
2010,Libya,LBY,United States of America,USA,5,0,0,0,5
2010,Lebanon,LBN,United States of America,USA,26,0,41,55,122
2010,Sri Lanka,LKA,United States of America,USA,111,0,51,65,227
2010,Lithuania,LTU,United States of America,USA,0,0,10,18,28
2010,Latvia,LVA,United States of America,USA,0,0,5,5,10
2010,Mauritania,MRT,United States of America,USA,59,0,47,75,181
2010,North Macedonia,MKD,United States of America,USA,10,0,5,15,30
2010,Rep. of Moldova,MDA,United States of America,USA,46,0,34,119,199
2010,Mexico,MEX,United States of America,USA,49,0,508,2516,3073
2010,Mali,MLI,United States of America,USA,74,0,50,97,221
2010,Malaysia,MYS,United States of America,USA,10,0,5,10,25
2010,Mongolia,MNG,United States of America,USA,50,0,33,59,142
2010,Morocco,MAR,United States of America,USA,5,0,19,21,45
2010,Myanmar,MMR,United States of America,USA,80,0,20,55,155
2010,Namibia,NAM,United States of America,USA,0,0,0,10,10
2010,Nepal,NPL,United States of America,USA,230,0,109,103,442
2010,Netherlands,NLD,United States of America,USA,5,0,5,5,15
2010,Niger,NER,United States of America,USA,5,0,14,21,40
2010,Nicaragua,NIC,United States of America,USA,15,0,106,145,266
2010,Nigeria,NGA,United States of America,USA,35,0,70,84,189
2010,Pakistan,PAK,United States of America,USA,113,0,123,207,443
2010,Panama,PAN,United States of America,USA,0,0,0,5,5
2010,Paraguay,PRY,United States of America,USA,0,0,5,5,10
2010,Peru,PER,United States of America,USA,25,0,93,124,242
2010,Philippines,PHL,United States of America,USA,5,0,48,134,187
2010,Poland,POL,United States of America,USA,0,0,20,33,53
2010,Portugal,PRT,United States of America,USA,0,0,0,5,5
2010,Romania,ROU,United States of America,USA,27,0,20,47,94
2010,South Africa,ZAF,United States of America,USA,0,0,13,11,24
2010,Russian Federation,RUS,United States of America,USA,335,0,147,420,902
2010,Rwanda,RWA,United States of America,USA,25,0,5,18,48
2010,El Salvador,SLV,United States of America,USA,146,0,1103,3138,4387
2010,Saudi Arabia,SAU,United States of America,USA,5,0,0,5,10
2010,Serbia and Kosovo: S/RES/1244 (1999),SRB,United States of America,USA,114,0,39,57,210
2010,Senegal,SEN,United States of America,USA,18,0,28,61,107
2010,Seychelles,SYC,United States of America,USA,0,0,0,5,5
2010,Singapore,SGP,United States of America,USA,0,0,5,5,10
2010,Sierra Leone,SLE,United States of America,USA,27,0,48,49,124
2010,Somalia,SOM,United States of America,USA,208,0,57,117,382
2010,Spain,ESP,United States of America,USA,0,0,0,5,5
2010,Viet Nam,VNM,United States of America,USA,10,0,28,62,100
2010,Saint Kitts and Nevis,KNA,United States of America,USA,0,0,5,5,10
2010,Sudan,SDN,United States of America,USA,35,0,25,42,102
2010,Suriname,SUR,United States of America,USA,0,0,0,10,10
2010,Slovakia,SVK,United States of America,USA,0,0,0,5,5
2010,Slovenia,SVN,United States of America,USA,0,0,0,5,5
2010,Sweden,SWE,United States of America,USA,0,0,0,5,5
2010,Switzerland,CHE,United States of America,USA,0,0,5,0,5
2010,Syrian Arab Rep.,SYR,United States of America,USA,13,0,17,41,71
2010,United Rep. of Tanzania,TZA,United States of America,USA,5,0,11,12,28
2010,Thailand,THA,United States of America,USA,5,0,5,22,32
2010,Tajikistan,TJK,United States of America,USA,10,0,5,12,27
2010,Turkmenistan,TKM,United States of America,USA,5,0,5,5,15
2010,Togo,TGO,United States of America,USA,45,0,20,47,112
2010,Tonga,TON,United States of America,USA,0,0,5,20,25
2010,Trinidad and Tobago,TTO,United States of America,USA,0,0,10,28,38
2010,Tunisia,TUN,United States of America,USA,0,0,5,5,10
2010,Turkey,TUR,United States of America,USA,12,0,30,29,71
2010,Uganda,UGA,United States of America,USA,26,0,22,18,66
2010,Ukraine,UKR,United States of America,USA,62,0,64,116,242
2010,Uruguay,URY,United States of America,USA,0,0,0,15,15
2010,Uzbekistan,UZB,United States of America,USA,54,0,54,101,209
2010,Saint Vincent and the Grenadines,VCT,United States of America,USA,0,0,0,5,5
2010,Venezuela (Bolivarian Republic of),VEN,United States of America,USA,181,0,207,290,678
2010,Yemen,YEM,United States of America,USA,5,0,11,27,43
2010,Zambia,ZMB,United States of America,USA,5,0,5,10,20
2010,Zimbabwe,ZWE,United States of America,USA,52,0,48,54,154
2010,Stateless,XXA,United States of America,USA,85,0,22,48,155
2010,Unknown ,,United States of America,USA,10,0,35,30,75
2011,Afghanistan,AFG,United States of America,USA,19,0,25,29,73
2011,Albania,ALB,United States of America,USA,136,0,67,78,281
2011,Algeria,DZA,United States of America,USA,5,0,15,10,30
2011,Angola,AGO,United States of America,USA,5,0,5,5,15
2011,Egypt,EGY,United States of America,USA,335,0,43,121,499
2011,Argentina,ARG,United States of America,USA,5,0,5,29,39
2011,Armenia,ARM,United States of America,USA,143,0,63,158,364
2011,Australia,AUS,United States of America,USA,0,0,0,5,5
2011,Azerbaijan,AZE,United States of America,USA,12,0,10,25,47
2011,Barbados,BRB,United States of America,USA,0,0,0,5,5
2011,Burundi,BDI,United States of America,USA,10,0,10,5,25
2011,Belgium,BEL,United States of America,USA,5,0,0,14,19
2011,Benin,BEN,United States of America,USA,5,0,5,5,15
2011,Bangladesh,BGD,United States of America,USA,47,0,50,159,256
2011,Bahamas,BHS,United States of America,USA,0,0,14,10,24
2011,Bhutan,BTN,United States of America,USA,5,0,0,10,15
2011,Burkina Faso,BFA,United States of America,USA,40,0,17,27,84
2011,Belarus,BLR,United States of America,USA,86,0,17,50,153
2011,Bolivia (Plurinational State of),BOL,United States of America,USA,10,0,10,23,43
2011,Brazil,BRA,United States of America,USA,22,0,60,118,200
2011,Bosnia and Herzegovina,BIH,United States of America,USA,5,0,20,21,46
2011,Bulgaria,BGR,United States of America,USA,23,0,16,41,80
2011,Belize,BLZ,United States of America,USA,5,0,15,5,25
2011,Cambodia,KHM,United States of America,USA,10,0,13,18,41
2011,Canada,CAN,United States of America,USA,11,0,12,12,35
2011,Central African Rep.,CAF,United States of America,USA,5,0,10,12,27
2011,Chad,TCD,United States of America,USA,20,0,5,10,35
2011,China,CHN,United States of America,USA,5084,0,1820,2225,9129
2011,Chile,CHL,United States of America,USA,5,0,10,5,20
2011,Cameroon,CMR,United States of America,USA,198,0,47,127,372
2011,Congo,COG,United States of America,USA,60,0,22,42,124
2011,Dem. Rep. of the Congo,COD,United States of America,USA,13,0,16,21,50
2011,Colombia,COL,United States of America,USA,193,0,217,401,811
2011,Costa Rica,CRI,United States of America,USA,0,0,5,5,10
2011,Cuba,CUB,United States of America,USA,13,0,82,187,282
2011,Czechia,CZE,United States of America,USA,0,0,5,10,15
2011,Djibouti,DJI,United States of America,USA,5,0,0,10,15
2011,Dominica,DMA,United States of America,USA,0,0,5,0,5
2011,Dominican Rep.,DOM,United States of America,USA,10,0,53,88,151
2011,Ecuador,ECU,United States of America,USA,19,0,55,180,254
2011,Eritrea,ERI,United States of America,USA,508,0,64,113,685
2011,Estonia,EST,United States of America,USA,0,0,0,10,10
2011,Ethiopia,ETH,United States of America,USA,522,0,87,137,746
2011,Fiji,FJI,United States of America,USA,5,0,20,26,51
2011,France,FRA,United States of America,USA,5,0,5,11,21
2011,Gabon,GAB,United States of America,USA,5,0,5,10,20
2011,Gambia,GMB,United States of America,USA,58,0,46,85,189
2011,Palestinian,PSE,United States of America,USA,0,0,0,5,5
2011,United Kingdom of Great Britain and Northern Ireland,GBR,United States of America,USA,5,0,12,23,40
2011,Georgia,GEO,United States of America,USA,31,0,14,29,74
2011,Germany,DEU,United States of America,USA,5,0,13,25,43
2011,Ghana,GHA,United States of America,USA,10,0,28,32,70
2011,Guinea-Bissau,GNB,United States of America,USA,0,0,5,5,10
2011,Greece,GRC,United States of America,USA,0,0,5,5,10
2011,Guatemala,GTM,United States of America,USA,182,0,985,2119,3286
2011,Guinea,GIN,United States of America,USA,176,0,105,161,442
2011,Guyana,GUY,United States of America,USA,5,0,32,34,71
2011,Haiti,HTI,United States of America,USA,61,0,158,845,1064
2011,"China, Hong Kong SAR",HKG,United States of America,USA,0,0,0,5,5
2011,Honduras,HND,United States of America,USA,83,0,474,523,1080
2011,Croatia,HRV,United States of America,USA,5,0,5,10,20
2011,Hungary,HUN,United States of America,USA,5,0,10,28,43
2011,Cote d'Ivoire,CIV,United States of America,USA,78,0,77,128,283
2011,India,IND,United States of America,USA,287,0,353,1070,1710
2011,Indonesia,IDN,United States of America,USA,107,0,197,218,522
2011,Ireland,IRL,United States of America,USA,0,0,0,5,5
2011,Iran (Islamic Rep. of),IRN,United States of America,USA,112,0,51,114,277
2011,Iraq,IRQ,United States of America,USA,115,0,55,60,230
2011,Israel,ISR,United States of America,USA,15,0,11,32,58
2011,Italy,ITA,United States of America,USA,10,0,10,0,20
2011,Jamaica,JAM,United States of America,USA,10,0,170,132,312
2011,Jordan,JOR,United States of America,USA,12,0,23,43,78
2011,Japan,JPN,United States of America,USA,0,0,0,5,5
2011,Kazakhstan,KAZ,United States of America,USA,15,0,14,31,60
2011,Kenya,KEN,United States of America,USA,90,0,115,107,312
2011,Kyrgyzstan,KGZ,United States of America,USA,24,0,19,47,90
2011,Rep. of Korea,KOR,United States of America,USA,5,0,13,28,46
2011,Kuwait,KWT,United States of America,USA,5,0,5,5,15
2011,Lao People's Dem. Rep.,LAO,United States of America,USA,0,0,19,19,38
2011,Liberia,LBR,United States of America,USA,22,0,46,123,191
2011,Libya,LBY,United States of America,USA,0,0,0,15,15
2011,Lebanon,LBN,United States of America,USA,32,0,29,47,108
2011,Sri Lanka,LKA,United States of America,USA,89,0,81,116,286
2011,Lithuania,LTU,United States of America,USA,5,0,5,0,10
2011,Latvia,LVA,United States of America,USA,5,0,5,12,22
2011,Mauritania,MRT,United States of America,USA,55,0,53,72,180
2011,North Macedonia,MKD,United States of America,USA,10,0,10,10,30
2011,Rep. of Moldova,MDA,United States of America,USA,69,0,63,94,226
2011,Mexico,MEX,United States of America,USA,107,0,1210,2961,4278
2011,Mali,MLI,United States of America,USA,85,0,38,100,223
2011,Malaysia,MYS,United States of America,USA,0,0,5,15,20
2011,Malawi,MWI,United States of America,USA,0,0,0,5,5
2011,Mongolia,MNG,United States of America,USA,51,0,88,98,237
2011,Morocco,MAR,United States of America,USA,5,0,10,29,44
2011,Mauritius,MUS,United States of America,USA,0,0,0,5,5
2011,Myanmar,MMR,United States of America,USA,72,0,22,29,123
2011,Namibia,NAM,United States of America,USA,0,0,0,5,5
2011,Nepal,NPL,United States of America,USA,372,0,178,170,720
2011,Netherlands,NLD,United States of America,USA,0,0,5,0,5
2011,Niger,NER,United States of America,USA,5,0,20,28,53
2011,Nicaragua,NIC,United States of America,USA,21,0,106,146,273
2011,Nigeria,NGA,United States of America,USA,32,0,82,92,206
2011,Niue,NIU,United States of America,USA,5,0,5,5,15
2011,Pakistan,PAK,United States of America,USA,169,0,113,229,511
2011,Panama,PAN,United States of America,USA,0,0,0,5,5
2011,Paraguay,PRY,United States of America,USA,5,0,0,0,5
2011,Peru,PER,United States of America,USA,23,0,51,99,173
2011,Philippines,PHL,United States of America,USA,5,0,55,100,160
2011,Poland,POL,United States of America,USA,5,0,10,32,47
2011,Portugal,PRT,United States of America,USA,0,0,0,5,5
2011,Qatar,QAT,United States of America,USA,5,0,0,0,5
2011,Romania,ROU,United States of America,USA,17,0,21,81,119
2011,South Africa,ZAF,United States of America,USA,5,0,5,19,29
2011,Russian Federation,RUS,United States of America,USA,188,0,103,291,582
2011,Rwanda,RWA,United States of America,USA,19,0,13,15,47
2011,El Salvador,SLV,United States of America,USA,180,0,1336,2669,4185
2011,Saudi Arabia,SAU,United States of America,USA,10,0,11,5,26
2011,Serbia and Kosovo: S/RES/1244 (1999),SRB,United States of America,USA,20,0,14,19,53
2011,Senegal,SEN,United States of America,USA,26,0,39,64,129
2011,Singapore,SGP,United States of America,USA,0,0,5,0,5
2011,Sierra Leone,SLE,United States of America,USA,28,0,38,53,119
2011,Somalia,SOM,United States of America,USA,173,0,90,92,355
2011,Spain,ESP,United States of America,USA,0,0,0,23,23
2011,Viet Nam,VNM,United States of America,USA,14,0,27,38,79
2011,Saint Kitts and Nevis,KNA,United States of America,USA,0,0,5,0,5
2011,Sudan,SDN,United States of America,USA,42,0,44,48,134
2011,Suriname,SUR,United States of America,USA,0,0,5,5,10
2011,Slovakia,SVK,United States of America,USA,0,0,5,5,10
2011,Slovenia,SVN,United States of America,USA,0,0,0,5,5
2011,Sweden,SWE,United States of America,USA,0,0,5,0,5
2011,Syrian Arab Rep.,SYR,United States of America,USA,16,0,19,30,65
2011,United Rep. of Tanzania,TZA,United States of America,USA,10,0,10,23,43
2011,Thailand,THA,United States of America,USA,5,0,12,10,27
2011,Tajikistan,TJK,United States of America,USA,14,0,10,17,41
2011,Turkmenistan,TKM,United States of America,USA,10,0,5,5,20
2011,Togo,TGO,United States of America,USA,20,0,11,39,70
2011,Trinidad and Tobago,TTO,United States of America,USA,0,0,31,22,53
2011,Tunisia,TUN,United States of America,USA,0,0,5,12,17
2011,Turkey,TUR,United States of America,USA,18,0,20,28,66
2011,United Arab Emirates,ARE,United States of America,USA,0,0,0,5,5
2011,Uganda,UGA,United States of America,USA,32,0,17,24,73
2011,Ukraine,UKR,United States of America,USA,56,0,82,114,252
2011,Uruguay,URY,United States of America,USA,0,0,0,5,5
2011,Uzbekistan,UZB,United States of America,USA,70,0,35,75,180
2011,Saint Vincent and the Grenadines,VCT,United States of America,USA,0,0,0,5,5
2011,Venezuela (Bolivarian Republic of),VEN,United States of America,USA,201,0,159,237,597
2011,Yemen,YEM,United States of America,USA,36,0,10,35,81
2011,Zambia,ZMB,United States of America,USA,5,0,11,5,21
2011,Zimbabwe,ZWE,United States of America,USA,44,0,34,50,128
2011,Unknown ,,United States of America,USA,466,0,154,302,922
2012,Afghanistan,AFG,United States of America,USA,30,0,13,37,80
2012,Albania,ALB,United States of America,USA,76,0,55,69,200
2012,Algeria,DZA,United States of America,USA,10,0,5,12,27
2012,Angola,AGO,United States of America,USA,0,0,10,5,15
2012,Antigua and Barbuda,ATG,United States of America,USA,0,0,5,0,5
2012,Egypt,EGY,United States of America,USA,268,0,45,151,464
2012,Argentina,ARG,United States of America,USA,5,0,5,49,59
2012,Armenia,ARM,United States of America,USA,93,0,63,145,301
2012,Australia,AUS,United States of America,USA,0,0,5,0,5
2012,Azerbaijan,AZE,United States of America,USA,16,0,5,22,43
2012,Burundi,BDI,United States of America,USA,87,0,57,217,361
2012,Belgium,BEL,United States of America,USA,5,0,5,5,15
2012,Benin,BEN,United States of America,USA,0,0,5,5,10
2012,Bahamas,BHS,United States of America,USA,5,0,5,5,15
2012,Burkina Faso,BFA,United States of America,USA,58,0,14,21,93
2012,Belarus,BLR,United States of America,USA,78,0,10,47,135
2012,Bolivia (Plurinational State of),BOL,United States of America,USA,5,0,13,39,57
2012,Brazil,BRA,United States of America,USA,25,0,49,214,288
2012,Bosnia and Herzegovina,BIH,United States of America,USA,0,0,20,19,39
2012,Bulgaria,BGR,United States of America,USA,17,0,20,27,64
2012,Belize,BLZ,United States of America,USA,5,0,11,13,29
2012,Cambodia,KHM,United States of America,USA,10,0,12,11,33
2012,Canada,CAN,United States of America,USA,5,0,10,14,29
2012,Central African Rep.,CAF,United States of America,USA,5,0,5,5,15
2012,Chad,TCD,United States of America,USA,16,0,5,14,35
2012,China,CHN,United States of America,USA,5131,0,1487,2768,9386
2012,Chile,CHL,United States of America,USA,0,0,10,5,15
2012,Cameroon,CMR,United States of America,USA,176,0,69,110,355
2012,Congo,COG,United States of America,USA,64,0,30,62,156
2012,Dem. Rep. of the Congo,COD,United States of America,USA,13,0,10,25,48
2012,Colombia,COL,United States of America,USA,125,0,124,389,638
2012,Costa Rica,CRI,United States of America,USA,0,0,5,16,21
2012,Cuba,CUB,United States of America,USA,5,0,59,117,181
2012,Czechia,CZE,United States of America,USA,0,0,5,10,15
2012,Djibouti,DJI,United States of America,USA,5,0,5,0,10
2012,Dominica,DMA,United States of America,USA,0,0,5,5,10
2012,Dominican Rep.,DOM,United States of America,USA,10,0,63,135,208
2012,Ecuador,ECU,United States of America,USA,15,0,41,256,312
2012,Eritrea,ERI,United States of America,USA,311,0,47,47,405
2012,Ethiopia,ETH,United States of America,USA,441,0,73,125,639
2012,Fiji,FJI,United States of America,USA,14,0,13,26,53
2012,France,FRA,United States of America,USA,0,0,10,10,20
2012,Gabon,GAB,United States of America,USA,0,0,0,5,5
2012,Gambia,GMB,United States of America,USA,72,0,45,87,204
2012,Palestinian,PSE,United States of America,USA,0,0,0,5,5
2012,United Kingdom of Great Britain and Northern Ireland,GBR,United States of America,USA,10,0,10,14,34
2012,Georgia,GEO,United States of America,USA,17,0,15,45,77
2012,Germany,DEU,United States of America,USA,0,0,15,20,35
2012,Ghana,GHA,United States of America,USA,5,0,40,53,98
2012,Guinea-Bissau,GNB,United States of America,USA,0,0,0,5,5
2012,Grenada,GRD,United States of America,USA,0,0,0,5,5
2012,Guatemala,GTM,United States of America,USA,214,0,903,3188,4305
2012,Guinea,GIN,United States of America,USA,156,0,64,169,389
2012,Guyana,GUY,United States of America,USA,5,0,17,42,64
2012,Haiti,HTI,United States of America,USA,55,0,177,587,819
2012,Honduras,HND,United States of America,USA,83,0,455,828,1366
2012,Croatia,HRV,United States of America,USA,0,0,0,5,5
2012,Hungary,HUN,United States of America,USA,0,0,5,15,20
2012,Cote d'Ivoire,CIV,United States of America,USA,61,0,41,113,215
2012,India,IND,United States of America,USA,103,0,186,415,704
2012,Indonesia,IDN,United States of America,USA,116,0,151,336,603
2012,Iran (Islamic Rep. of),IRN,United States of America,USA,90,0,39,118,247
2012,Iraq,IRQ,United States of America,USA,109,0,58,73,240
2012,Israel,ISR,United States of America,USA,5,0,10,23,38
2012,Italy,ITA,United States of America,USA,0,0,5,10,15
2012,Jamaica,JAM,United States of America,USA,13,0,110,110,233
2012,Jordan,JOR,United States of America,USA,16,0,27,46,89
2012,Japan,JPN,United States of America,USA,0,0,5,10,15
2012,Kazakhstan,KAZ,United States of America,USA,16,0,10,34,60
2012,Kenya,KEN,United States of America,USA,72,0,85,168,325
2012,Kyrgyzstan,KGZ,United States of America,USA,30,0,19,31,80
2012,Rep. of Korea,KOR,United States of America,USA,0,0,25,43,68
2012,Dem. People's Rep. of Korea,PRK,United States of America,USA,5,0,5,5,15
2012,Kuwait,KWT,United States of America,USA,5,0,0,5,10
2012,Lao People's Dem. Rep.,LAO,United States of America,USA,0,0,30,23,53
2012,Liberia,LBR,United States of America,USA,5,0,27,38,70
2012,Libya,LBY,United States of America,USA,5,0,5,38,48
2012,Saint Lucia,LCA,United States of America,USA,0,0,0,10,10
2012,Lebanon,LBN,United States of America,USA,19,0,30,58,107
2012,Sri Lanka,LKA,United States of America,USA,109,0,38,96,243
2012,Lithuania,LTU,United States of America,USA,0,0,5,11,16
2012,"China, Macao SAR",MAC,United States of America,USA,0,0,0,5,5
2012,Mauritania,MRT,United States of America,USA,44,0,27,49,120
2012,North Macedonia,MKD,United States of America,USA,0,0,10,10,20
2012,Rep. of Moldova,MDA,United States of America,USA,96,0,41,109,246
2012,Mexico,MEX,United States of America,USA,148,0,1437,5415,7000
2012,Mali,MLI,United States of America,USA,78,0,36,97,211
2012,Malaysia,MYS,United States of America,USA,5,0,5,19,29
2012,Malawi,MWI,United States of America,USA,5,0,5,5,15
2012,Morocco,MAR,United States of America,USA,10,0,10,18,38
2012,Montenegro,MNE,United States of America,USA,39,0,66,120,225
2012,Myanmar,MMR,United States of America,USA,54,0,21,37,112
2012,Nepal,NPL,United States of America,USA,72,0,34,59,165
2012,Netherlands,NLD,United States of America,USA,0,0,0,5,5
2012,Niger,NER,United States of America,USA,10,0,12,28,50
2012,Nicaragua,NIC,United States of America,USA,15,0,86,184,285
2012,Nigeria,NGA,United States of America,USA,39,0,104,119,262
2012,Niue,NIU,United States of America,USA,5,0,0,10,15
2012,Norway,NOR,United States of America,USA,0,0,0,5,5
2012,Pakistan,PAK,United States of America,USA,185,0,98,261,544
2012,Panama,PAN,United States of America,USA,0,0,5,14,19
2012,Paraguay,PRY,United States of America,USA,0,0,5,5,10
2012,Peru,PER,United States of America,USA,21,0,52,196,269
2012,Philippines,PHL,United States of America,USA,10,0,48,194,252
2012,Poland,POL,United States of America,USA,0,0,17,19,36
2012,Portugal,PRT,United States of America,USA,5,0,5,5,15
2012,Romania,ROU,United States of America,USA,21,0,11,79,111
2012,South Africa,ZAF,United States of America,USA,5,0,10,10,25
2012,Russian Federation,RUS,United States of America,USA,182,0,116,252,550
2012,Rwanda,RWA,United States of America,USA,21,0,12,24,57
2012,El Salvador,SLV,United States of America,USA,186,0,1131,3097,4414
2012,Saudi Arabia,SAU,United States of America,USA,5,0,0,10,15
2012,Serbia and Kosovo: S/RES/1244 (1999),SRB,United States of America,USA,32,0,19,21,72
2012,Senegal,SEN,United States of America,USA,26,0,19,108,153
2012,Singapore,SGP,United States of America,USA,5,0,0,0,5
2012,Sierra Leone,SLE,United States of America,USA,29,0,23,53,105
2012,Somalia,SOM,United States of America,USA,108,0,57,146,311
2012,Spain,ESP,United States of America,USA,5,0,0,14,19
2012,Viet Nam,VNM,United States of America,USA,10,0,36,55,101
2012,Sudan,SDN,United States of America,USA,48,0,30,39,117
2012,Suriname,SUR,United States of America,USA,0,0,0,12,12
2012,Slovakia,SVK,United States of America,USA,0,0,0,10,10
2012,Sweden,SWE,United States of America,USA,0,0,0,5,5
2012,Syrian Arab Rep.,SYR,United States of America,USA,46,0,13,53,112
2012,United Rep. of Tanzania,TZA,United States of America,USA,10,0,16,14,40
2012,Thailand,THA,United States of America,USA,5,0,10,15,30
2012,Tajikistan,TJK,United States of America,USA,5,0,5,23,33
2012,Turkmenistan,TKM,United States of America,USA,10,0,5,11,26
2012,Togo,TGO,United States of America,USA,27,0,18,31,76
2012,Tonga,TON,United States of America,USA,0,0,0,5,5
2012,Trinidad and Tobago,TTO,United States of America,USA,5,0,12,51,68
2012,Tunisia,TUN,United States of America,USA,0,0,5,11,16
2012,Turkey,TUR,United States of America,USA,18,0,13,39,70
2012,United Arab Emirates,ARE,United States of America,USA,0,0,0,5,5
2012,Uganda,UGA,United States of America,USA,24,0,16,38,78
2012,Ukraine,UKR,United States of America,USA,36,0,22,72,130
2012,Uruguay,URY,United States of America,USA,0,0,0,18,18
2012,Uzbekistan,UZB,United States of America,USA,53,0,33,79,165
2012,Saint Vincent and the Grenadines,VCT,United States of America,USA,0,0,5,0,5
2012,Venezuela (Bolivarian Republic of),VEN,United States of America,USA,101,0,108,261,470
2012,Yemen,YEM,United States of America,USA,11,0,12,22,45
2012,Zambia,ZMB,United States of America,USA,0,0,5,5,10
2012,Zimbabwe,ZWE,United States of America,USA,34,0,25,70,129
2012,Unknown ,,United States of America,USA,453,0,128,312,893
2013,Afghanistan,AFG,United States of America,USA,16,0,10,12,38
2013,Albania,ALB,United States of America,USA,70,0,25,49,144
2013,Algeria,DZA,United States of America,USA,0,0,0,5,5
2013,Andorra,AND,United States of America,USA,0,0,5,0,5
2013,Angola,AGO,United States of America,USA,0,0,5,5,10
2013,Egypt,EGY,United States of America,USA,304,0,27,99,430
2013,Argentina,ARG,United States of America,USA,0,0,10,35,45
2013,Armenia,ARM,United States of America,USA,47,0,41,109,197
2013,Azerbaijan,AZE,United States of America,USA,0,0,0,5,5
2013,Bahrain,BHR,United States of America,USA,0,0,0,5,5
2013,Burundi,BDI,United States of America,USA,16,0,10,5,31
2013,Belgium,BEL,United States of America,USA,5,0,0,5,10
2013,Benin,BEN,United States of America,USA,10,0,5,0,15
2013,Bangladesh,BGD,United States of America,USA,69,0,29,103,201
2013,Bahamas,BHS,United States of America,USA,0,0,5,0,5
2013,Burkina Faso,BFA,United States of America,USA,53,0,11,17,81
2013,Belarus,BLR,United States of America,USA,58,0,12,33,103
2013,Bolivia (Plurinational State of),BOL,United States of America,USA,0,0,0,31,31
2013,Brazil,BRA,United States of America,USA,5,0,34,134,173
2013,Bosnia and Herzegovina,BIH,United States of America,USA,0,0,11,5,16
2013,Bulgaria,BGR,United States of America,USA,5,0,10,14,29
2013,Belize,BLZ,United States of America,USA,0,0,19,15,34
2013,Cambodia,KHM,United States of America,USA,41,0,22,10,73
2013,Canada,CAN,United States of America,USA,0,0,0,5,5
2013,Central African Rep.,CAF,United States of America,USA,5,0,0,5,10
2013,Cayman Islands,CYM,United States of America,USA,5,0,0,0,5
2013,Chad,TCD,United States of America,USA,5,0,0,0,5
2013,China,CHN,United States of America,USA,4395,0,1182,1609,7186
2013,Chile,CHL,United States of America,USA,0,0,5,13,18
2013,Cameroon,CMR,United States of America,USA,96,0,22,49,167
2013,Congo,COG,United States of America,USA,43,0,21,30,94
2013,Dem. Rep. of the Congo,COD,United States of America,USA,15,0,10,12,37
2013,Colombia,COL,United States of America,USA,60,0,124,336,520
2013,Costa Rica,CRI,United States of America,USA,0,0,5,0,5
2013,Cuba,CUB,United States of America,USA,5,0,51,71,127
2013,Czechia,CZE,United States of America,USA,0,0,0,10,10
2013,Djibouti,DJI,United States of America,USA,5,0,5,0,10
2013,Dominican Rep.,DOM,United States of America,USA,5,0,66,84,155
2013,Ecuador,ECU,United States of America,USA,28,0,68,305,401
2013,Eritrea,ERI,United States of America,USA,226,0,17,10,253
2013,Ethiopia,ETH,United States of America,USA,379,0,68,74,521
2013,Fiji,FJI,United States of America,USA,0,0,10,14,24
2013,France,FRA,United States of America,USA,0,0,0,10,10
2013,Gambia,GMB,United States of America,USA,81,0,32,69,182
2013,United Kingdom of Great Britain and Northern Ireland,GBR,United States of America,USA,10,0,0,19,29
2013,Georgia,GEO,United States of America,USA,10,0,0,18,28
2013,Germany,DEU,United States of America,USA,0,0,15,30,45
2013,Ghana,GHA,United States of America,USA,12,0,20,29,61
2013,Guatemala,GTM,United States of America,USA,164,0,833,2338,3335
2013,Guinea,GIN,United States of America,USA,97,0,50,101,248
2013,Guyana,GUY,United States of America,USA,5,0,17,5,27
2013,Haiti,HTI,United States of America,USA,42,0,270,185,497
2013,Honduras,HND,United States of America,USA,104,0,662,701,1467
2013,Croatia,HRV,United States of America,USA,5,0,0,0,5
2013,Cote d'Ivoire,CIV,United States of America,USA,64,0,35,74,173
2013,India,IND,United States of America,USA,342,0,265,383,990
2013,Indonesia,IDN,United States of America,USA,68,0,73,308,449
2013,Iran (Islamic Rep. of),IRN,United States of America,USA,67,0,36,72,175
2013,Iraq,IRQ,United States of America,USA,52,0,34,62,148
2013,Israel,ISR,United States of America,USA,0,0,10,24,34
2013,Italy,ITA,United States of America,USA,0,0,5,0,5
2013,Jamaica,JAM,United States of America,USA,0,0,97,72,169
2013,Jordan,JOR,United States of America,USA,11,0,10,42,63
2013,Japan,JPN,United States of America,USA,0,0,0,10,10
2013,Kazakhstan,KAZ,United States of America,USA,33,0,0,25,58
2013,Kenya,KEN,United States of America,USA,43,0,58,109,210
2013,Kyrgyzstan,KGZ,United States of America,USA,32,0,12,13,57
2013,Rep. of Korea,KOR,United States of America,USA,0,0,15,24,39
2013,Lao People's Dem. Rep.,LAO,United States of America,USA,0,0,10,11,21
2013,Liberia,LBR,United States of America,USA,10,0,19,49,78
2013,Libya,LBY,United States of America,USA,0,0,0,13,13
2013,Lebanon,LBN,United States of America,USA,5,0,17,41,63
2013,Sri Lanka,LKA,United States of America,USA,102,0,30,52,184
2013,Lithuania,LTU,United States of America,USA,0,0,12,5,17
2013,Mauritania,MRT,United States of America,USA,35,0,21,18,74
2013,North Macedonia,MKD,United States of America,USA,5,0,5,10,20
2013,Rep. of Moldova,MDA,United States of America,USA,66,0,24,40,130
2013,Mexico,MEX,United States of America,USA,146,0,1676,5819,7641
2013,Mali,MLI,United States of America,USA,74,0,24,89,187
2013,Malaysia,MYS,United States of America,USA,0,0,0,12,12
2013,Malawi,MWI,United States of America,USA,0,0,0,10,10
2013,Mongolia,MNG,United States of America,USA,26,0,38,89,153
2013,Morocco,MAR,United States of America,USA,5,0,10,18,33
2013,Myanmar,MMR,United States of America,USA,36,0,5,20,61
2013,Nepal,NPL,United States of America,USA,366,0,119,132,617
2013,Netherlands,NLD,United States of America,USA,0,0,5,0,5
2013,Niger,NER,United States of America,USA,0,0,10,19,29
2013,Nicaragua,NIC,United States of America,USA,13,0,83,101,197
2013,Nigeria,NGA,United States of America,USA,31,0,57,55,143
2013,Niue,NIU,United States of America,USA,5,0,0,0,5
2013,New Zealand,NZL,United States of America,USA,0,0,0,5,5
2013,Oman,OMN,United States of America,USA,0,0,0,5,5
2013,Pakistan,PAK,United States of America,USA,97,0,50,206,353
2013,Panama,PAN,United States of America,USA,0,0,5,0,5
2013,Peru,PER,United States of America,USA,5,0,48,129,182
2013,Philippines,PHL,United States of America,USA,5,0,27,157,189
2013,Poland,POL,United States of America,USA,0,0,0,20,20
2013,Romania,ROU,United States of America,USA,28,0,24,62,114
2013,South Africa,ZAF,United States of America,USA,0,0,5,5,10
2013,Russian Federation,RUS,United States of America,USA,169,0,70,167,406
2013,Rwanda,RWA,United States of America,USA,28,0,12,10,50
2013,El Salvador,SLV,United States of America,USA,186,0,1270,2137,3593
2013,Saudi Arabia,SAU,United States of America,USA,5,0,0,5,10
2013,Serbia and Kosovo: S/RES/1244 (1999),SRB,United States of America,USA,40,0,12,5,57
2013,Senegal,SEN,United States of America,USA,18,0,23,72,113
2013,Sierra Leone,SLE,United States of America,USA,10,0,15,21,46
2013,Somalia,SOM,United States of America,USA,90,0,87,50,227
2013,Spain,ESP,United States of America,USA,0,0,10,5,15
2013,Viet Nam,VNM,United States of America,USA,0,0,22,29,51
2013,Sudan,SDN,United States of America,USA,25,0,30,30,85
2013,Syrian Arab Rep.,SYR,United States of America,USA,52,0,5,108,165
2013,United Rep. of Tanzania,TZA,United States of America,USA,0,0,5,0,5
2013,Thailand,THA,United States of America,USA,0,0,10,0,10
2013,Tajikistan,TJK,United States of America,USA,11,0,0,12,23
2013,Turkmenistan,TKM,United States of America,USA,0,0,0,5,5
2013,Togo,TGO,United States of America,USA,5,0,12,18,35
2013,Trinidad and Tobago,TTO,United States of America,USA,0,0,10,31,41
2013,Turkey,TUR,United States of America,USA,0,0,17,18,35
2013,Uganda,UGA,United States of America,USA,28,0,12,20,60
2013,Ukraine,UKR,United States of America,USA,53,0,40,71,164
2013,Uzbekistan,UZB,United States of America,USA,39,0,20,26,85
2013,Venezuela (Bolivarian Republic of),VEN,United States of America,USA,79,0,79,185,343
2013,Yemen,YEM,United States of America,USA,11,0,24,16,51
2013,Zimbabwe,ZWE,United States of America,USA,19,0,18,34,71
2013,Unknown ,,United States of America,USA,491,0,295,712,1498
2014,Afghanistan,AFG,United States of America,USA,17,0,5,5,27
2014,Albania,ALB,United States of America,USA,74,10,35,63,182
2014,Angola,AGO,United States of America,USA,0,0,5,0,5
2014,Egypt,EGY,United States of America,USA,247,23,23,95,388
2014,Argentina,ARG,United States of America,USA,0,0,0,12,12
2014,Armenia,ARM,United States of America,USA,36,0,20,106,162
2014,Azerbaijan,AZE,United States of America,USA,10,0,5,5,20
2014,Burundi,BDI,United States of America,USA,27,0,12,0,39
2014,Belgium,BEL,United States of America,USA,0,0,5,0,5
2014,Benin,BEN,United States of America,USA,5,0,0,5,10
2014,Bangladesh,BGD,United States of America,USA,67,10,43,118,238
2014,Bahamas,BHS,United States of America,USA,0,0,5,0,5
2014,Bhutan,BTN,United States of America,USA,0,0,5,0,5
2014,Burkina Faso,BFA,United States of America,USA,65,10,13,21,109
2014,Belarus,BLR,United States of America,USA,35,0,5,13,53
2014,Bolivia (Plurinational State of),BOL,United States of America,USA,0,0,10,19,29
2014,Brazil,BRA,United States of America,USA,5,10,25,153,193
2014,Bosnia and Herzegovina,BIH,United States of America,USA,0,0,0,10,10
2014,Bulgaria,BGR,United States of America,USA,5,0,0,0,5
2014,Belize,BLZ,United States of America,USA,0,0,15,10,25
2014,Cambodia,KHM,United States of America,USA,0,0,5,10,15
2014,China,CHN,United States of America,USA,4173,370,1119,1760,7422
2014,Chile,CHL,United States of America,USA,0,0,5,10,15
2014,Cameroon,CMR,United States of America,USA,109,5,23,46,183
2014,Congo,COG,United States of America,USA,15,0,5,21,41
2014,Dem. Rep. of the Congo,COD,United States of America,USA,10,5,10,0,25
2014,Colombia,COL,United States of America,USA,66,25,116,205,412
2014,Costa Rica,CRI,United States of America,USA,0,0,5,10,15
2014,Cuba,CUB,United States of America,USA,10,12,42,58,122
2014,Czechia,CZE,United States of America,USA,0,0,5,0,5
2014,Djibouti,DJI,United States of America,USA,10,0,0,0,10
2014,Dominican Rep.,DOM,United States of America,USA,13,5,49,88,155
2014,Ecuador,ECU,United States of America,USA,23,25,110,509,667
2014,Eritrea,ERI,United States of America,USA,153,14,35,5,207
2014,Ethiopia,ETH,United States of America,USA,312,28,71,55,466
2014,Fiji,FJI,United States of America,USA,5,0,5,0,10
2014,Gambia,GMB,United States of America,USA,68,16,20,62,166
2014,United Kingdom of Great Britain and Northern Ireland,GBR,United States of America,USA,5,0,5,13,23
2014,Georgia,GEO,United States of America,USA,11,0,0,10,21
2014,Germany,DEU,United States of America,USA,0,0,0,5,5
2014,Ghana,GHA,United States of America,USA,14,5,35,31,85
2014,Greece,GRC,United States of America,USA,10,0,0,5,15
2014,Guatemala,GTM,United States of America,USA,202,116,981,2157,3456
2014,Guinea,GIN,United States of America,USA,54,17,23,76,170
2014,Guyana,GUY,United States of America,USA,0,0,10,20,30
2014,Haiti,HTI,United States of America,USA,72,30,350,183,635
2014,Honduras,HND,United States of America,USA,184,119,1047,963,2313
2014,Hungary,HUN,United States of America,USA,5,0,5,17,27
2014,Cote d'Ivoire,CIV,United States of America,USA,50,13,21,68,152
2014,India,IND,United States of America,USA,373,52,281,439,1145
2014,Indonesia,IDN,United States of America,USA,47,14,36,214,311
2014,Ireland,IRL,United States of America,USA,0,0,5,0,5
2014,Iran (Islamic Rep. of),IRN,United States of America,USA,58,13,21,54,146
2014,Iraq,IRQ,United States of America,USA,66,20,36,59,181
2014,Israel,ISR,United States of America,USA,0,0,5,20,25
2014,Jamaica,JAM,United States of America,USA,5,12,69,61,147
2014,Jordan,JOR,United States of America,USA,5,0,10,23,38
2014,Kazakhstan,KAZ,United States of America,USA,18,5,12,20,55
2014,Kenya,KEN,United States of America,USA,35,21,43,121,220
2014,Kyrgyzstan,KGZ,United States of America,USA,41,0,5,23,69
2014,Rep. of Korea,KOR,United States of America,USA,0,0,5,19,24
2014,Lao People's Dem. Rep.,LAO,United States of America,USA,0,0,5,18,23
2014,Liberia,LBR,United States of America,USA,11,5,17,35,68
2014,Libya,LBY,United States of America,USA,0,5,0,5,10
2014,Lebanon,LBN,United States of America,USA,0,0,5,17,22
2014,Sri Lanka,LKA,United States of America,USA,58,0,19,45,122
2014,Mauritania,MRT,United States of America,USA,25,0,14,17,56
2014,North Macedonia,MKD,United States of America,USA,0,0,0,5,5
2014,Rep. of Moldova,MDA,United States of America,USA,57,5,18,36,116
2014,Mexico,MEX,United States of America,USA,123,130,1820,5801,7874
2014,Mali,MLI,United States of America,USA,54,17,19,71,161
2014,Malaysia,MYS,United States of America,USA,5,0,0,19,24
2014,Mongolia,MNG,United States of America,USA,23,5,17,62,107
2014,Morocco,MAR,United States of America,USA,0,0,10,12,22
2014,Mauritius,MUS,United States of America,USA,5,0,0,0,5
2014,Myanmar,MMR,United States of America,USA,30,5,10,5,50
2014,Nepal,NPL,United States of America,USA,299,62,114,131,606
2014,Niger,NER,United States of America,USA,10,0,0,10,20
2014,Nicaragua,NIC,United States of America,USA,25,16,66,117,224
2014,Nigeria,NGA,United States of America,USA,58,14,71,92,235
2014,Niue,NIU,United States of America,USA,5,0,0,0,5
2014,Pakistan,PAK,United States of America,USA,102,17,48,161,328
2014,Peru,PER,United States of America,USA,20,5,34,137,196
2014,Philippines,PHL,United States of America,USA,0,0,33,136,169
2014,Poland,POL,United States of America,USA,0,0,0,10,10
2014,Romania,ROU,United States of America,USA,26,10,16,43,95
2014,South Africa,ZAF,United States of America,USA,0,0,0,5,5
2014,Russian Federation,RUS,United States of America,USA,111,21,50,112,294
2014,Rwanda,RWA,United States of America,USA,42,5,5,0,52
2014,El Salvador,SLV,United States of America,USA,247,126,1430,2254,4057
2014,Saudi Arabia,SAU,United States of America,USA,5,0,0,5,10
2014,Serbia and Kosovo: S/RES/1244 (1999),SRB,United States of America,USA,23,5,0,16,44
2014,Senegal,SEN,United States of America,USA,21,5,19,48,93
2014,Sierra Leone,SLE,United States of America,USA,10,11,17,27,65
2014,Somalia,SOM,United States of America,USA,121,14,169,38,342
2014,Spain,ESP,United States of America,USA,0,0,5,5,10
2014,Viet Nam,VNM,United States of America,USA,0,5,24,23,52
2014,Sudan,SDN,United States of America,USA,19,5,30,24,78
2014,Slovakia,SVK,United States of America,USA,0,0,0,5,5
2014,Syrian Arab Rep.,SYR,United States of America,USA,60,5,14,83,162
2014,Tajikistan,TJK,United States of America,USA,12,5,10,10,37
2014,Turkmenistan,TKM,United States of America,USA,0,0,5,10,15
2014,Togo,TGO,United States of America,USA,12,0,0,5,17
2014,Trinidad and Tobago,TTO,United States of America,USA,0,5,11,24,40
2014,Tunisia,TUN,United States of America,USA,0,0,10,0,10
2014,Turkey,TUR,United States of America,USA,5,5,0,31,41
2014,Uganda,UGA,United States of America,USA,21,5,5,17,48
2014,Ukraine,UKR,United States of America,USA,43,11,30,63,147
2014,Uzbekistan,UZB,United States of America,USA,43,5,10,26,84
2014,Venezuela (Bolivarian Republic of),VEN,United States of America,USA,98,27,58,120,303
2014,Yemen,YEM,United States of America,USA,15,5,5,14,39
2014,Zimbabwe,ZWE,United States of America,USA,5,5,11,23,44
2014,Guadeloupe,GLP,United States of America,USA,0,0,5,0,5
2014,Unknown ,,United States of America,USA,358,115,284,688,1445
2015,Afghanistan,AFG,United States of America,USA,13,0,16,14,43
2015,Albania,ALB,United States of America,USA,84,0,26,59,169
2015,Egypt,EGY,United States of America,USA,141,0,25,120,286
2015,Argentina,ARG,United States of America,USA,0,0,0,22,22
2015,Armenia,ARM,United States of America,USA,26,0,15,131,172
2015,Azerbaijan,AZE,United States of America,USA,11,0,0,10,21
2015,Burundi,BDI,United States of America,USA,24,0,15,5,44
2015,Belgium,BEL,United States of America,USA,0,0,0,5,5
2015,Benin,BEN,United States of America,USA,5,0,0,5,10
2015,Bangladesh,BGD,United States of America,USA,91,0,220,107,418
2015,Bahamas,BHS,United States of America,USA,0,0,5,5,10
2015,Burkina Faso,BFA,United States of America,USA,59,0,10,20,89
2015,Belarus,BLR,United States of America,USA,33,10,0,24,67
2015,Bolivia (Plurinational State of),BOL,United States of America,USA,0,0,0,15,15
2015,Brazil,BRA,United States of America,USA,0,0,18,112,130
2015,Bosnia and Herzegovina,BIH,United States of America,USA,0,0,5,0,5
2015,Bulgaria,BGR,United States of America,USA,0,0,0,5,5
2015,Belize,BLZ,United States of America,USA,0,0,10,10,20
2015,Cambodia,KHM,United States of America,USA,0,0,5,0,5
2015,Canada,CAN,United States of America,USA,0,0,0,5,5
2015,Chad,TCD,United States of America,USA,0,0,0,10,10
2015,China,CHN,United States of America,USA,3333,0,710,3287,7330
2015,Chile,CHL,United States of America,USA,0,0,5,5,10
2015,Cameroon,CMR,United States of America,USA,91,0,33,66,190
2015,Congo,COG,United States of America,USA,18,0,10,21,49
2015,Dem. Rep. of the Congo,COD,United States of America,USA,13,0,10,10,33
2015,Colombia,COL,United States of America,USA,55,0,51,188,294
2015,Costa Rica,CRI,United States of America,USA,0,0,0,5,5
2015,Cuba,CUB,United States of America,USA,10,0,49,59,118
2015,Czechia,CZE,United States of America,USA,0,0,0,5,5
2015,Djibouti,DJI,United States of America,USA,5,0,0,10,15
2015,Dominican Rep.,DOM,United States of America,USA,5,13,43,89,150
2015,Ecuador,ECU,United States of America,USA,38,0,72,788,898
2015,Eritrea,ERI,United States of America,USA,131,0,63,12,206
2015,Ethiopia,ETH,United States of America,USA,242,0,53,74,369
2015,Fiji,FJI,United States of America,USA,0,0,0,14,14
2015,France,FRA,United States of America,USA,0,0,0,5,5
2015,Micronesia (Federated States of),FSM,United States of America,USA,0,0,5,0,5
2015,Gambia,GMB,United States of America,USA,58,0,5,52,115
2015,United Kingdom of Great Britain and Northern Ireland,GBR,United States of America,USA,0,0,5,5,10
2015,Georgia,GEO,United States of America,USA,5,0,0,10,15
2015,Germany,DEU,United States of America,USA,0,0,14,5,19
2015,Ghana,GHA,United States of America,USA,42,5,108,47,202
2015,Guatemala,GTM,United States of America,USA,440,0,1023,3372,4835
2015,Guinea,GIN,United States of America,USA,37,40,26,66,169
2015,Guyana,GUY,United States of America,USA,0,0,10,23,33
2015,Haiti,HTI,United States of America,USA,43,0,140,500,683
2015,Honduras,HND,United States of America,USA,372,84,1358,2304,4118
2015,Hungary,HUN,United States of America,USA,0,0,0,5,5
2015,Cote d'Ivoire,CIV,United States of America,USA,22,0,10,66,98
2015,India,IND,United States of America,USA,292,0,199,703,1194
2015,Indonesia,IDN,United States of America,USA,16,0,12,263,291
2015,Iran (Islamic Rep. of),IRN,United States of America,USA,40,0,10,66,116
2015,Iraq,IRQ,United States of America,USA,60,0,20,87,167
2015,Israel,ISR,United States of America,USA,0,0,0,17,17
2015,Jamaica,JAM,United States of America,USA,5,29,55,59,148
2015,Jordan,JOR,United States of America,USA,0,0,5,27,32
2015,Kazakhstan,KAZ,United States of America,USA,13,0,0,20,33
2015,Kenya,KEN,United States of America,USA,22,0,20,81,123
2015,Kyrgyzstan,KGZ,United States of America,USA,46,0,10,34,90
2015,Rep. of Korea,KOR,United States of America,USA,0,0,0,18,18
2015,Lao People's Dem. Rep.,LAO,United States of America,USA,0,0,11,5,16
2015,Liberia,LBR,United States of America,USA,5,0,10,35,50
2015,Libya,LBY,United States of America,USA,0,0,0,5,5
2015,Lebanon,LBN,United States of America,USA,10,0,5,14,29
2015,Sri Lanka,LKA,United States of America,USA,43,0,25,78,146
2015,Mauritania,MRT,United States of America,USA,15,0,5,38,58
2015,North Macedonia,MKD,United States of America,USA,0,0,0,5,5
2015,Rep. of Moldova,MDA,United States of America,USA,33,0,10,43,86
2015,Mexico,MEX,United States of America,USA,268,96,1846,5686,7896
2015,Mali,MLI,United States of America,USA,21,0,13,59,93
2015,Malaysia,MYS,United States of America,USA,0,0,0,17,17
2015,Mongolia,MNG,United States of America,USA,5,0,10,86,101
2015,Morocco,MAR,United States of America,USA,5,0,5,0,10
2015,Myanmar,MMR,United States of America,USA,18,0,12,20,50
2015,Namibia,NAM,United States of America,USA,5,0,0,0,5
2015,Nepal,NPL,United States of America,USA,239,0,79,172,490
2015,Netherlands,NLD,United States of America,USA,0,0,5,0,5
2015,Niger,NER,United States of America,USA,0,0,5,10,15
2015,Nicaragua,NIC,United States of America,USA,13,0,55,102,170
2015,Nigeria,NGA,United States of America,USA,72,0,65,77,214
2015,Niue,NIU,United States of America,USA,0,0,0,5,5
2015,Pakistan,PAK,United States of America,USA,58,0,48,168,274
2015,Peru,PER,United States of America,USA,17,0,25,119,161
2015,Philippines,PHL,United States of America,USA,0,0,13,125,138
2015,Poland,POL,United States of America,USA,0,0,0,10,10
2015,Portugal,PRT,United States of America,USA,0,0,0,5,5
2015,Romania,ROU,United States of America,USA,23,0,20,134,177
2015,South Africa,ZAF,United States of America,USA,0,0,0,16,16
2015,Russian Federation,RUS,United States of America,USA,106,0,22,164,292
2015,Rwanda,RWA,United States of America,USA,16,0,0,14,30
2015,El Salvador,SLV,United States of America,USA,371,80,1668,4473,6592
2015,Saudi Arabia,SAU,United States of America,USA,5,0,0,0,5
2015,Serbia and Kosovo: S/RES/1244 (1999),SRB,United States of America,USA,20,0,0,10,30
2015,Senegal,SEN,United States of America,USA,13,0,5,51,69
2015,Sierra Leone,SLE,United States of America,USA,5,0,5,20,30
2015,Somalia,SOM,United States of America,USA,178,0,357,38,573
2015,Spain,ESP,United States of America,USA,0,0,5,10,15
2015,Viet Nam,VNM,United States of America,USA,0,0,17,31,48
2015,Sudan,SDN,United States of America,USA,17,0,10,13,40
2015,Syrian Arab Rep.,SYR,United States of America,USA,104,0,26,62,192
2015,Thailand,THA,United States of America,USA,0,0,5,0,5
2015,Tajikistan,TJK,United States of America,USA,10,0,0,5,15
2015,Turkmenistan,TKM,United States of America,USA,5,0,0,0,5
2015,Togo,TGO,United States of America,USA,5,0,5,12,22
2015,Trinidad and Tobago,TTO,United States of America,USA,0,0,5,5,10
2015,Turkey,TUR,United States of America,USA,5,0,5,28,38
2015,Uganda,UGA,United States of America,USA,10,0,0,15,25
2015,Ukraine,UKR,United States of America,USA,36,0,16,102,154
2015,Uzbekistan,UZB,United States of America,USA,15,0,0,56,71
2015,Saint Vincent and the Grenadines,VCT,United States of America,USA,27,0,0,20,47
2015,Venezuela (Bolivarian Republic of),VEN,United States of America,USA,22,0,34,122,178
2015,Yemen,YEM,United States of America,USA,5,0,5,13,23
2015,Zimbabwe,ZWE,United States of America,USA,0,0,0,17,17
2015,Unknown ,,United States of America,USA,316,244,264,627,1451
2016,Afghanistan,AFG,United States of America,USA,27,0,10,38,75
2016,Albania,ALB,United States of America,USA,102,0,33,136,271
2016,Algeria,DZA,United States of America,USA,0,0,0,10,10
2016,Angola,AGO,United States of America,USA,5,0,0,18,23
2016,Egypt,EGY,United States of America,USA,149,0,19,146,314
2016,Argentina,ARG,United States of America,USA,0,0,0,24,24
2016,Armenia,ARM,United States of America,USA,22,0,16,134,172
2016,Azerbaijan,AZE,United States of America,USA,10,0,0,12,22
2016,Burundi,BDI,United States of America,USA,24,0,0,16,40
2016,Benin,BEN,United States of America,USA,0,0,0,5,5
2016,Bangladesh,BGD,United States of America,USA,91,0,119,187,397
2016,Bhutan,BTN,United States of America,USA,5,0,0,11,16
2016,Burkina Faso,BFA,United States of America,USA,75,0,23,55,153
2016,Belarus,BLR,United States of America,USA,23,0,0,29,52
2016,Bolivia (Plurinational State of),BOL,United States of America,USA,0,0,5,30,35
2016,Brazil,BRA,United States of America,USA,5,0,45,191,241
2016,Bosnia and Herzegovina,BIH,United States of America,USA,0,0,5,24,29
2016,Bulgaria,BGR,United States of America,USA,5,0,0,17,22
2016,Belize,BLZ,United States of America,USA,0,0,11,15,26
2016,Cambodia,KHM,United States of America,USA,0,0,5,0,5
2016,Canada,CAN,United States of America,USA,5,0,0,0,5
2016,Chad,TCD,United States of America,USA,5,0,0,5,10
2016,China,CHN,United States of America,USA,3131,0,563,4221,7915
2016,Chile,CHL,United States of America,USA,0,0,0,12,12
2016,Cameroon,CMR,United States of America,USA,137,0,48,70,255
2016,Congo,COG,United States of America,USA,28,0,12,22,62
2016,Dem. Rep. of the Congo,COD,United States of America,USA,5,0,5,18,28
2016,Colombia,COL,United States of America,USA,28,0,62,292,382
2016,Costa Rica,CRI,United States of America,USA,0,0,5,21,26
2016,Cuba,CUB,United States of America,USA,10,0,57,48,115
2016,Dominican Rep.,DOM,United States of America,USA,5,0,48,117,170
2016,Ecuador,ECU,United States of America,USA,51,0,95,1431,1577
2016,Eritrea,ERI,United States of America,USA,163,0,90,12,265
2016,Ethiopia,ETH,United States of America,USA,176,0,40,86,302
2016,Fiji,FJI,United States of America,USA,0,0,0,5,5
2016,Gambia,GMB,United States of America,USA,42,0,26,68,136
2016,United Kingdom of Great Britain and Northern Ireland,GBR,United States of America,USA,0,0,0,5,5
2016,Georgia,GEO,United States of America,USA,5,0,0,14,19
2016,Ghana,GHA,United States of America,USA,80,0,193,80,353
2016,Guinea-Bissau,GNB,United States of America,USA,0,0,0,5,5
2016,Guatemala,GTM,United States of America,USA,696,0,1666,3956,6318
2016,Guinea,GIN,United States of America,USA,48,0,57,73,178
2016,Guyana,GUY,United States of America,USA,0,0,5,23,28
2016,Haiti,HTI,United States of America,USA,30,0,159,503,692
2016,Honduras,HND,United States of America,USA,707,0,2109,3030,5846
2016,Cote d'Ivoire,CIV,United States of America,USA,15,0,21,84,120
2016,India,IND,United States of America,USA,331,0,223,950,1504
2016,Indonesia,IDN,United States of America,USA,14,0,5,212,231
2016,Iran (Islamic Rep. of),IRN,United States of America,USA,52,0,19,114,185
2016,Iraq,IRQ,United States of America,USA,30,0,36,97,163
2016,Israel,ISR,United States of America,USA,0,0,5,15,20
2016,Italy,ITA,United States of America,USA,0,0,0,5,5
2016,Jamaica,JAM,United States of America,USA,0,0,70,71,141
2016,Jordan,JOR,United States of America,USA,0,0,5,34,39
2016,Kazakhstan,KAZ,United States of America,USA,22,0,5,28,55
2016,Kenya,KEN,United States of America,USA,10,0,14,74,98
2016,Kyrgyzstan,KGZ,United States of America,USA,48,0,10,53,111
2016,Rep. of Korea,KOR,United States of America,USA,5,0,5,22,32
2016,Lao People's Dem. Rep.,LAO,United States of America,USA,0,0,5,0,5
2016,Liberia,LBR,United States of America,USA,12,0,10,27,49
2016,Lebanon,LBN,United States of America,USA,0,0,12,30,42
2016,Sri Lanka,LKA,United States of America,USA,38,0,22,81,141
2016,Mauritania,MRT,United States of America,USA,11,0,5,32,48
2016,North Macedonia,MKD,United States of America,USA,0,0,0,5,5
2016,Rep. of Moldova,MDA,United States of America,USA,24,0,0,57,81
2016,Mexico,MEX,United States of America,USA,502,0,2796,8531,11829
2016,Mali,MLI,United States of America,USA,27,0,22,78,127
2016,Malaysia,MYS,United States of America,USA,0,0,0,29,29
2016,Mongolia,MNG,United States of America,USA,5,0,0,68,73
2016,Morocco,MAR,United States of America,USA,5,0,0,12,17
2016,Myanmar,MMR,United States of America,USA,12,0,10,17,39
2016,Nepal,NPL,United States of America,USA,265,0,66,267,598
2016,Niger,NER,United States of America,USA,0,0,10,15,25
2016,Nicaragua,NIC,United States of America,USA,14,0,60,147,221
2016,Nigeria,NGA,United States of America,USA,53,0,57,99,209
2016,Pakistan,PAK,United States of America,USA,83,0,47,224,354
2016,Peru,PER,United States of America,USA,12,0,30,166,208
2016,Philippines,PHL,United States of America,USA,0,0,25,129,154
2016,Poland,POL,United States of America,USA,0,0,0,20,20
2016,Romania,ROU,United States of America,USA,35,0,26,174,235
2016,South Africa,ZAF,United States of America,USA,0,0,0,5,5
2016,Russian Federation,RUS,United States of America,USA,66,0,18,167,251
2016,Rwanda,RWA,United States of America,USA,20,0,0,17,37
2016,El Salvador,SLV,United States of America,USA,924,0,2636,5432,8992
2016,Saudi Arabia,SAU,United States of America,USA,5,0,5,5,15
2016,Serbia and Kosovo: S/RES/1244 (1999),SRB,United States of America,USA,24,0,0,22,46
2016,Senegal,SEN,United States of America,USA,11,0,33,103,147
2016,Sierra Leone,SLE,United States of America,USA,10,0,11,15,36
2016,Somalia,SOM,United States of America,USA,123,0,278,50,451
2016,Viet Nam,VNM,United States of America,USA,0,0,12,29,41
2016,Sudan,SDN,United States of America,USA,26,0,12,5,43
2016,Syrian Arab Rep.,SYR,United States of America,USA,77,0,16,91,184
2016,United Rep. of Tanzania,TZA,United States of America,USA,0,0,5,0,5
2016,Thailand,THA,United States of America,USA,0,0,0,5,5
2016,Tajikistan,TJK,United States of America,USA,0,0,5,10,15
2016,Turkmenistan,TKM,United States of America,USA,0,0,0,5,5
2016,Togo,TGO,United States of America,USA,0,0,11,10,21
2016,Trinidad and Tobago,TTO,United States of America,USA,0,0,10,25,35
2016,Tunisia,TUN,United States of America,USA,5,0,0,5,10
2016,Turkey,TUR,United States of America,USA,0,0,12,26,38
2016,Uganda,UGA,United States of America,USA,16,0,0,22,38
2016,Ukraine,UKR,United States of America,USA,54,0,21,109,184
2016,Uruguay,URY,United States of America,USA,0,0,0,10,10
2016,Uzbekistan,UZB,United States of America,USA,24,0,0,88,112
2016,Saint Vincent and the Grenadines,VCT,United States of America,USA,0,0,0,5,5
2016,Venezuela (Bolivarian Republic of),VEN,United States of America,USA,35,0,55,147,237
2016,Yemen,YEM,United States of America,USA,5,0,0,20,25
2016,Zimbabwe,ZWE,United States of America,USA,5,0,5,23,33
2016,Unknown ,,United States of America,USA,337,0,240,686,1263
2017,Afghanistan,AFG,United States of America,USA,24,0,16,10,50
2017,Albania,ALB,United States of America,USA,88,0,37,35,160
2017,Angola,AGO,United States of America,USA,5,0,18,0,23
2017,Egypt,EGY,United States of America,USA,53,0,15,10,78
2017,Argentina,ARG,United States of America,USA,5,0,5,5,15
2017,Armenia,ARM,United States of America,USA,21,0,25,23,69
2017,Azerbaijan,AZE,United States of America,USA,5,0,0,0,5
2017,Burundi,BDI,United States of America,USA,0,0,5,5,10
2017,Benin,BEN,United States of America,USA,0,0,5,0,5
2017,Bangladesh,BGD,United States of America,USA,91,0,80,35,206
2017,Bahamas,BHS,United States of America,USA,0,0,5,0,5
2017,Bhutan,BTN,United States of America,USA,0,0,5,0,5
2017,Burkina Faso,BFA,United States of America,USA,5,0,17,0,22
2017,Belarus,BLR,United States of America,USA,5,0,0,0,5
2017,Bolivia (Plurinational State of),BOL,United States of America,USA,0,0,5,5,10
2017,Brazil,BRA,United States of America,USA,11,0,81,85,177
2017,Bosnia and Herzegovina,BIH,United States of America,USA,0,0,17,5,22
2017,Belize,BLZ,United States of America,USA,0,0,12,5,17
2017,Cambodia,KHM,United States of America,USA,0,0,10,0,10
2017,Canada,CAN,United States of America,USA,0,0,5,0,5
2017,Central African Rep.,CAF,United States of America,USA,5,0,0,0,5
2017,Chad,TCD,United States of America,USA,5,0,5,0,10
2017,China,CHN,United States of America,USA,740,0,256,233,1229
2017,Chile,CHL,United States of America,USA,0,0,5,0,5
2017,Cameroon,CMR,United States of America,USA,217,0,87,18,322
2017,Congo,COG,United States of America,USA,18,0,31,10,59
2017,Dem. Rep. of the Congo,COD,United States of America,USA,16,0,32,0,48
2017,Colombia,COL,United States of America,USA,21,0,72,70,163
2017,Costa Rica,CRI,United States of America,USA,0,0,5,0,5
2017,Cuba,CUB,United States of America,USA,75,0,220,76,371
2017,Cabo Verde,CPV,United States of America,USA,0,0,5,0,5
2017,Czechia,CZE,United States of America,USA,5,0,0,0,5
2017,Djibouti,DJI,United States of America,USA,5,0,0,0,5
2017,Dominican Rep.,DOM,United States of America,USA,5,0,66,102,173
2017,Ecuador,ECU,United States of America,USA,86,0,156,318,560
2017,Eritrea,ERI,United States of America,USA,254,0,255,23,532
2017,Ethiopia,ETH,United States of America,USA,46,0,35,27,108
2017,Micronesia (Federated States of),FSM,United States of America,USA,0,0,5,0,5
2017,Gambia,GMB,United States of America,USA,17,0,54,0,71
2017,Palestinian,PSE,United States of America,USA,0,0,0,5,5
2017,United Kingdom of Great Britain and Northern Ireland,GBR,United States of America,USA,0,0,5,0,5
2017,Georgia,GEO,United States of America,USA,5,0,10,0,15
2017,Ghana,GHA,United States of America,USA,57,0,115,41,213
2017,Guinea-Bissau,GNB,United States of America,USA,0,0,5,0,5
2017,Guatemala,GTM,United States of America,USA,987,0,2762,2144,5893
2017,Guinea,GIN,United States of America,USA,86,0,115,13,214
2017,Guyana,GUY,United States of America,USA,0,0,5,5,10
2017,Haiti,HTI,United States of America,USA,85,0,1112,405,1602
2017,Honduras,HND,United States of America,USA,996,0,3322,1917,6235
2017,Hungary,HUN,United States of America,USA,0,0,11,0,11
2017,Cote d'Ivoire,CIV,United States of America,USA,0,0,18,0,18
2017,India,IND,United States of America,USA,436,0,296,271,1003
2017,Indonesia,IDN,United States of America,USA,0,0,0,10,10
2017,Iran (Islamic Rep. of),IRN,United States of America,USA,10,0,22,23,55
2017,Iraq,IRQ,United States of America,USA,15,0,41,21,77
2017,Israel,ISR,United States of America,USA,0,0,10,0,10
2017,Jamaica,JAM,United States of America,USA,10,0,68,41,119
2017,Jordan,JOR,United States of America,USA,5,0,18,10,33
2017,Kenya,KEN,United States of America,USA,5,0,29,13,47
2017,Rep. of Korea,KOR,United States of America,USA,0,0,5,0,5
2017,Dem. People's Rep. of Korea,PRK,United States of America,USA,0,0,0,5,5
2017,Lao People's Dem. Rep.,LAO,United States of America,USA,0,0,5,10,15
2017,Liberia,LBR,United States of America,USA,0,0,32,21,53
2017,Lebanon,LBN,United States of America,USA,0,0,5,0,5
2017,Sri Lanka,LKA,United States of America,USA,18,0,10,15,43
2017,Lithuania,LTU,United States of America,USA,0,0,5,0,5
2017,North Macedonia,MKD,United States of America,USA,5,0,0,0,5
2017,Rep. of Moldova,MDA,United States of America,USA,0,0,10,0,10
2017,Mexico,MEX,United States of America,USA,573,0,3221,2667,6461
2017,Mali,MLI,United States of America,USA,5,0,22,0,27
2017,Mongolia,MNG,United States of America,USA,0,0,5,0,5
2017,Myanmar,MMR,United States of America,USA,5,0,13,0,18
2017,Nepal,NPL,United States of America,USA,185,0,81,42,308
2017,Netherlands,NLD,United States of America,USA,0,0,5,0,5
2017,Niger,NER,United States of America,USA,0,0,5,0,5
2017,Nicaragua,NIC,United States of America,USA,30,0,97,93,220
2017,Nigeria,NGA,United States of America,USA,62,0,84,39,185
2017,New Zealand,NZL,United States of America,USA,0,0,0,5,5
2017,Pakistan,PAK,United States of America,USA,44,0,76,40,160
2017,Peru,PER,United States of America,USA,22,0,58,68,148
2017,Philippines,PHL,United States of America,USA,0,0,41,28,69
2017,Portugal,PRT,United States of America,USA,0,0,0,5,5
2017,Romania,ROU,United States of America,USA,43,0,67,167,277
2017,South Africa,ZAF,United States of America,USA,0,0,5,0,5
2017,Russian Federation,RUS,United States of America,USA,23,0,29,11,63
2017,El Salvador,SLV,United States of America,USA,1439,0,4278,2756,8473
2017,Saudi Arabia,SAU,United States of America,USA,5,0,0,0,5
2017,Serbia and Kosovo: S/RES/1244 (1999),SRB,United States of America,USA,5,0,5,0,10
2017,Senegal,SEN,United States of America,USA,14,0,82,5,101
2017,Sierra Leone,SLE,United States of America,USA,5,0,25,15,45
2017,Somalia,SOM,United States of America,USA,86,0,130,49,265
2017,Spain,ESP,United States of America,USA,0,0,10,10,20
2017,Viet Nam,VNM,United States of America,USA,0,0,21,15,36
2017,Sudan,SDN,United States of America,USA,12,0,19,17,48
2017,South Sudan,SSD,United States of America,USA,0,0,5,0,5
2017,Syrian Arab Rep.,SYR,United States of America,USA,94,0,23,16,133
2017,United Rep. of Tanzania,TZA,United States of America,USA,5,0,0,0,5
2017,Thailand,THA,United States of America,USA,0,0,10,5,15
2017,Tajikistan,TJK,United States of America,USA,0,0,0,5,5
2017,Togo,TGO,United States of America,USA,11,0,22,0,33
2017,Trinidad and Tobago,TTO,United States of America,USA,0,0,13,10,23
2017,Tunisia,TUN,United States of America,USA,0,0,5,0,5
2017,Turkey,TUR,United States of America,USA,15,0,13,15,43
2017,Uganda,UGA,United States of America,USA,10,0,0,0,10
2017,Ukraine,UKR,United States of America,USA,38,0,33,27,98
2017,Uzbekistan,UZB,United States of America,USA,5,0,10,11,26
2017,Venezuela (Bolivarian Republic of),VEN,United States of America,USA,41,0,58,37,136
2017,Yemen,YEM,United States of America,USA,5,0,5,11,21
2017,Zimbabwe,ZWE,United States of America,USA,5,0,5,0,10
2017,Guadeloupe,GLP,United States of America,USA,0,0,5,0,5
2017,Unknown ,,United States of America,USA,85,0,152,401,638
2018,Afghanistan,AFG,United States of America,USA,16,0,18,5,39
2018,Albania,ALB,United States of America,USA,142,0,46,16,204
2018,Angola,AGO,United States of America,USA,10,0,29,0,39
2018,Egypt,EGY,United States of America,USA,32,0,15,21,68
2018,Argentina,ARG,United States of America,USA,0,0,10,5,15
2018,Armenia,ARM,United States of America,USA,71,0,34,29,134
2018,Austria,AUT,United States of America,USA,10,0,0,0,10
2018,Azerbaijan,AZE,United States of America,USA,10,0,0,0,10
2018,Burundi,BDI,United States of America,USA,10,0,10,0,20
2018,Benin,BEN,United States of America,USA,0,0,5,0,5
2018,Bangladesh,BGD,United States of America,USA,218,0,143,31,392
2018,Bahamas,BHS,United States of America,USA,0,0,5,0,5
2018,Bhutan,BTN,United States of America,USA,0,0,5,0,5
2018,Burkina Faso,BFA,United States of America,USA,10,0,10,0,20
2018,Belarus,BLR,United States of America,USA,10,0,5,0,15
2018,Bolivia (Plurinational State of),BOL,United States of America,USA,0,0,5,5,10
2018,Brazil,BRA,United States of America,USA,22,0,179,149,350
2018,Bosnia and Herzegovina,BIH,United States of America,USA,0,0,10,5,15
2018,Belize,BLZ,United States of America,USA,0,0,23,0,23
2018,Cambodia,KHM,United States of America,USA,0,0,5,5,10
2018,Chad,TCD,United States of America,USA,0,0,5,0,5
2018,China,CHN,United States of America,USA,1388,0,552,193,2133
2018,Chile,CHL,United States of America,USA,0,0,5,5,10
2018,Cameroon,CMR,United States of America,USA,341,0,135,25,501
2018,Dem. Rep. of the Congo,COD,United States of America,USA,46,0,82,10,138
2018,Colombia,COL,United States of America,USA,22,0,105,58,185
2018,Costa Rica,CRI,United States of America,USA,0,0,10,10,20
2018,Cuba,CUB,United States of America,USA,249,0,332,177,758
2018,Dominican Rep.,DOM,United States of America,USA,5,0,66,84,155
2018,Ecuador,ECU,United States of America,USA,111,0,410,304,825
2018,Eritrea,ERI,United States of America,USA,264,0,204,13,481
2018,Ethiopia,ETH,United States of America,USA,52,0,48,13,113
2018,Fiji,FJI,United States of America,USA,0,0,5,0,5
2018,France,FRA,United States of America,USA,0,0,5,0,5
2018,Micronesia (Federated States of),FSM,United States of America,USA,0,0,5,0,5
2018,Gambia,GMB,United States of America,USA,5,0,23,10,38
2018,United Kingdom of Great Britain and Northern Ireland,GBR,United States of America,USA,0,0,5,0,5
2018,Georgia,GEO,United States of America,USA,13,0,12,0,25
2018,Germany,DEU,United States of America,USA,0,0,0,5,5
2018,Ghana,GHA,United States of America,USA,26,0,50,50,126
2018,Greece,GRC,United States of America,USA,0,0,0,5,5
2018,Guatemala,GTM,United States of America,USA,983,0,5483,2655,9121
2018,Guinea,GIN,United States of America,USA,39,0,45,5,89
2018,Guyana,GUY,United States of America,USA,0,0,11,5,16
2018,Haiti,HTI,United States of America,USA,43,0,840,316,1199
2018,Honduras,HND,United States of America,USA,1109,0,5424,2427,8960
2018,Hungary,HUN,United States of America,USA,0,0,11,12,23
2018,Cote d'Ivoire,CIV,United States of America,USA,5,0,16,0,21
2018,India,IND,United States of America,USA,1022,0,716,248,1986
2018,Indonesia,IDN,United States of America,USA,0,0,15,0,15
2018,Iran (Islamic Rep. of),IRN,United States of America,USA,22,0,25,17,64
2018,Iraq,IRQ,United States of America,USA,13,0,38,20,71
2018,Israel,ISR,United States of America,USA,0,0,5,0,5
2018,Italy,ITA,United States of America,USA,0,0,10,0,10
2018,Jamaica,JAM,United States of America,USA,10,0,110,36,156
2018,Jordan,JOR,United States of America,USA,5,0,11,5,21
2018,Kazakhstan,KAZ,United States of America,USA,0,0,5,0,5
2018,Kenya,KEN,United States of America,USA,5,0,32,18,55
2018,Kyrgyzstan,KGZ,United States of America,USA,14,0,15,0,29
2018,Rep. of Korea,KOR,United States of America,USA,0,0,14,5,19
2018,Lao People's Dem. Rep.,LAO,United States of America,USA,0,0,16,0,16
2018,Liberia,LBR,United States of America,USA,0,0,29,5,34
2018,Libya,LBY,United States of America,USA,0,0,5,0,5
2018,Lebanon,LBN,United States of America,USA,0,0,5,5,10
2018,Sri Lanka,LKA,United States of America,USA,29,0,32,10,71
2018,Latvia,LVA,United States of America,USA,5,0,0,0,5
2018,Mauritania,MRT,United States of America,USA,0,0,5,0,5
2018,Rep. of Moldova,MDA,United States of America,USA,5,0,10,0,15
2018,Mexico,MEX,United States of America,USA,624,0,4808,3192,8624
2018,Mali,MLI,United States of America,USA,5,0,15,5,25
2018,Mongolia,MNG,United States of America,USA,0,0,5,5,10
2018,Morocco,MAR,United States of America,USA,0,0,5,0,5
2018,Myanmar,MMR,United States of America,USA,5,0,17,0,22
2018,Nepal,NPL,United States of America,USA,352,0,141,28,521
2018,Niger,NER,United States of America,USA,0,0,5,0,5
2018,Nicaragua,NIC,United States of America,USA,57,0,202,139,398
2018,Nigeria,NGA,United States of America,USA,53,0,121,44,218
2018,New Zealand,NZL,United States of America,USA,0,0,0,5,5
2018,Pakistan,PAK,United States of America,USA,61,0,78,68,207
2018,Panama,PAN,United States of America,USA,0,0,10,0,10
2018,Peru,PER,United States of America,USA,24,0,83,76,183
2018,Philippines,PHL,United States of America,USA,5,0,28,16,49
2018,Portugal,PRT,United States of America,USA,0,0,0,5,5
2018,Romania,ROU,United States of America,USA,41,0,126,223,390
2018,South Africa,ZAF,United States of America,USA,0,0,0,5,5
2018,Russian Federation,RUS,United States of America,USA,64,0,58,31,153
2018,Rwanda,RWA,United States of America,USA,10,0,0,0,10
2018,El Salvador,SLV,United States of America,USA,1797,0,7079,3145,12021
2018,Saudi Arabia,SAU,United States of America,USA,0,0,5,0,5
2018,Serbia and Kosovo: S/RES/1244 (1999),SRB,United States of America,USA,10,0,0,5,15
2018,Senegal,SEN,United States of America,USA,5,0,18,5,28
2018,Sierra Leone,SLE,United States of America,USA,10,0,15,0,25
2018,Somalia,SOM,United States of America,USA,35,0,80,55,170
2018,Spain,ESP,United States of America,USA,0,0,5,5,10
2018,Viet Nam,VNM,United States of America,USA,5,0,31,23,59
2018,Sudan,SDN,United States of America,USA,14,0,24,11,49
2018,South Sudan,SSD,United States of America,USA,0,0,14,0,14
2018,Syrian Arab Rep.,SYR,United States of America,USA,67,0,10,18,95
2018,United Rep. of Tanzania,TZA,United States of America,USA,0,0,10,0,10
2018,Thailand,THA,United States of America,USA,0,0,10,0,10
2018,Tajikistan,TJK,United States of America,USA,5,0,0,0,5
2018,Turkmenistan,TKM,United States of America,USA,10,0,0,0,10
2018,Togo,TGO,United States of America,USA,5,0,10,0,15
2018,Trinidad and Tobago,TTO,United States of America,USA,0,0,14,10,24
2018,Tunisia,TUN,United States of America,USA,5,0,5,0,10
2018,Turkey,TUR,United States of America,USA,24,0,15,18,57
2018,Uganda,UGA,United States of America,USA,24,0,14,0,38
2018,Ukraine,UKR,United States of America,USA,53,0,38,23,114
2018,Uruguay,URY,United States of America,USA,0,0,0,5,5
2018,Uzbekistan,UZB,United States of America,USA,18,0,21,12,51
2018,Venezuela (Bolivarian Republic of),VEN,United States of America,USA,80,0,115,88,283
2018,Zambia,ZMB,United States of America,USA,0,0,18,0,18
2018,Unknown ,,United States of America,USA,79,0,100,1768,1947
2019,Afghanistan,AFG,United States of America,USA,16,0,5,0,21
2019,Albania,ALB,United States of America,USA,84,0,36,10,130
2019,Algeria,DZA,United States of America,USA,0,0,5,0,5
2019,Angola,AGO,United States of America,USA,13,0,16,22,51
2019,Egypt,EGY,United States of America,USA,28,0,19,18,65
2019,Argentina,ARG,United States of America,USA,0,0,11,0,11
2019,Armenia,ARM,United States of America,USA,67,0,49,36,152
2019,Azerbaijan,AZE,United States of America,USA,12,0,5,0,17
2019,Burundi,BDI,United States of America,USA,11,0,5,5,21
2019,Benin,BEN,United States of America,USA,0,0,5,0,5
2019,Bangladesh,BGD,United States of America,USA,259,0,311,26,596
2019,Bahamas,BHS,United States of America,USA,0,0,5,0,5
2019,Bhutan,BTN,United States of America,USA,0,0,10,5,15
2019,Burkina Faso,BFA,United States of America,USA,12,0,11,0,23
2019,Belarus,BLR,United States of America,USA,17,0,0,0,17
2019,Bolivia (Plurinational State of),BOL,United States of America,USA,0,0,5,0,5
2019,Brazil,BRA,United States of America,USA,42,0,454,182,678
2019,Bosnia and Herzegovina,BIH,United States of America,USA,5,0,13,5,23
2019,Belize,BLZ,United States of America,USA,0,0,20,5,25
2019,Cambodia,KHM,United States of America,USA,0,0,5,0,5
2019,Canada,CAN,United States of America,USA,0,0,5,0,5
2019,Chad,TCD,United States of America,USA,10,0,0,0,10
2019,China,CHN,United States of America,USA,1469,0,535,170,2174
2019,Chile,CHL,United States of America,USA,0,0,5,10,15
2019,Cameroon,CMR,United States of America,USA,672,0,173,17,862
2019,Congo,COG,United States of America,USA,10,0,18,10,38
2019,Dem. Rep. of the Congo,COD,United States of America,USA,38,0,40,0,78
2019,Colombia,COL,United States of America,USA,14,0,149,90,253
2019,Costa Rica,CRI,United States of America,USA,0,0,10,0,10
2019,Cuba,CUB,United States of America,USA,1031,0,1419,420,2870
2019,Czechia,CZE,United States of America,USA,0,0,5,0,5
2019,Dominican Rep.,DOM,United States of America,USA,11,0,111,82,204
2019,Ecuador,ECU,United States of America,USA,125,0,623,333,1081
2019,Eritrea,ERI,United States of America,USA,217,0,137,18,372
2019,Ethiopia,ETH,United States of America,USA,35,0,30,5,70
2019,Fiji,FJI,United States of America,USA,0,0,5,0,5
2019,France,FRA,United States of America,USA,0,0,0,5,5
2019,Micronesia (Federated States of),FSM,United States of America,USA,0,0,5,0,5
2019,Gambia,GMB,United States of America,USA,10,0,10,0,20
2019,United Kingdom of Great Britain and Northern Ireland,GBR,United States of America,USA,0,0,10,0,10
2019,Georgia,GEO,United States of America,USA,21,0,26,0,47
2019,Ghana,GHA,United States of America,USA,52,0,56,49,157
2019,Greece,GRC,United States of America,USA,0,0,11,0,11
2019,Guatemala,GTM,United States of America,USA,1811,0,11756,3361,16928
2019,Guinea,GIN,United States of America,USA,39,0,26,0,65
2019,Guyana,GUY,United States of America,USA,0,0,10,5,15
2019,Haiti,HTI,United States of America,USA,63,0,992,256,1311
2019,Honduras,HND,United States of America,USA,1448,0,10578,3091,15117
2019,Hungary,HUN,United States of America,USA,0,0,12,5,17
2019,Cote d'Ivoire,CIV,United States of America,USA,5,0,11,5,21
2019,India,IND,United States of America,USA,1604,0,1173,306,3083
2019,Indonesia,IDN,United States of America,USA,0,0,5,5,10
2019,Iran (Islamic Rep. of),IRN,United States of America,USA,18,0,20,12,50
2019,Iraq,IRQ,United States of America,USA,22,0,36,26,84
2019,Israel,ISR,United States of America,USA,0,0,0,5,5
2019,Italy,ITA,United States of America,USA,0,0,5,5,10
2019,Jamaica,JAM,United States of America,USA,12,0,90,43,145
2019,Jordan,JOR,United States of America,USA,5,0,11,10,26
2019,Japan,JPN,United States of America,USA,0,0,5,0,5
2019,Kazakhstan,KAZ,United States of America,USA,0,0,10,5,15
2019,Kenya,KEN,United States of America,USA,10,0,28,17,55
2019,Kyrgyzstan,KGZ,United States of America,USA,34,0,10,5,49
2019,Rep. of Korea,KOR,United States of America,USA,0,0,10,13,23
2019,Lao People's Dem. Rep.,LAO,United States of America,USA,0,0,10,0,10
2019,Liberia,LBR,United States of America,USA,0,0,28,5,33
2019,Libya,LBY,United States of America,USA,0,0,5,0,5
2019,Lebanon,LBN,United States of America,USA,5,0,11,0,16
2019,Sri Lanka,LKA,United States of America,USA,32,0,63,28,123
2019,Lithuania,LTU,United States of America,USA,5,0,0,0,5
2019,Mauritania,MRT,United States of America,USA,10,0,10,0,20
2019,North Macedonia,MKD,United States of America,USA,0,0,0,5,5
2019,Rep. of Moldova,MDA,United States of America,USA,10,0,0,0,10
2019,Mexico,MEX,United States of America,USA,916,0,6980,2607,10503
2019,Mali,MLI,United States of America,USA,0,0,10,0,10
2019,Mongolia,MNG,United States of America,USA,10,0,5,5,20
2019,Morocco,MAR,United States of America,USA,0,0,5,5,10
2019,Myanmar,MMR,United States of America,USA,5,0,14,5,24
2019,Nepal,NPL,United States of America,USA,348,0,173,21,542
2019,Nicaragua,NIC,United States of America,USA,509,0,837,244,1590
2019,Nigeria,NGA,United States of America,USA,45,0,98,48,191
2019,Pakistan,PAK,United States of America,USA,69,0,78,32,179
2019,Peru,PER,United States of America,USA,47,0,163,67,277
2019,Philippines,PHL,United States of America,USA,0,0,24,16,40
2019,Poland,POL,United States of America,USA,0,0,5,0,5
2019,Portugal,PRT,United States of America,USA,0,0,0,12,12
2019,Romania,ROU,United States of America,USA,43,0,152,210,405
2019,South Africa,ZAF,United States of America,USA,0,0,5,0,5
2019,Russian Federation,RUS,United States of America,USA,223,0,114,16,353
2019,Rwanda,RWA,United States of America,USA,10,0,0,0,10
2019,El Salvador,SLV,United States of America,USA,2585,0,12071,2740,17396
2019,Saudi Arabia,SAU,United States of America,USA,5,0,10,0,15
2019,Serbia and Kosovo: S/RES/1244 (1999),SRB,United States of America,USA,14,0,10,0,24
2019,Senegal,SEN,United States of America,USA,5,0,12,0,17
2019,Sierra Leone,SLE,United States of America,USA,13,0,20,0,33
2019,Somalia,SOM,United States of America,USA,27,0,46,32,105
2019,Spain,ESP,United States of America,USA,0,0,5,15,20
2019,Viet Nam,VNM,United States of America,USA,76,0,51,10,137
2019,Sudan,SDN,United States of America,USA,15,0,20,10,45
2019,South Sudan,SSD,United States of America,USA,0,0,10,0,10
2019,Syrian Arab Rep.,SYR,United States of America,USA,64,0,5,5,74
2019,United Rep. of Tanzania,TZA,United States of America,USA,0,0,5,0,5
2019,Thailand,THA,United States of America,USA,0,0,5,0,5
2019,Tajikistan,TJK,United States of America,USA,5,0,0,0,5
2019,Togo,TGO,United States of America,USA,10,0,12,0,22
2019,Trinidad and Tobago,TTO,United States of America,USA,0,0,19,5,24
2019,Tunisia,TUN,United States of America,USA,0,0,5,0,5
2019,Turkey,TUR,United States of America,USA,81,0,23,20,124
2019,Uganda,UGA,United States of America,USA,30,0,16,0,46
2019,Ukraine,UKR,United States of America,USA,68,0,55,15,138
2019,Uzbekistan,UZB,United States of America,USA,92,0,62,5,159
2019,Venezuela (Bolivarian Republic of),VEN,United States of America,USA,444,0,268,156,868
2019,Yemen,YEM,United States of America,USA,10,0,16,5,31
2019,Zimbabwe,ZWE,United States of America,USA,5,0,5,0,10
2019,Unknown ,,United States of America,USA,96,0,88,5448,5632
2020,Afghanistan,AFG,United States of America,USA,13,0,5,0,18
2020,Albania,ALB,United States of America,USA,18,0,21,0,39
2020,Angola,AGO,United States of America,USA,5,0,27,0,32
2020,Egypt,EGY,United States of America,USA,12,0,14,5,31
2020,Argentina,ARG,United States of America,USA,0,0,10,0,10
2020,Armenia,ARM,United States of America,USA,49,0,29,21,99
2020,Azerbaijan,AZE,United States of America,USA,5,0,0,0,5
2020,Burundi,BDI,United States of America,USA,0,0,5,0,5
2020,Bangladesh,BGD,United States of America,USA,118,0,88,23,229
2020,Bahamas,BHS,United States of America,USA,0,0,5,0,5
2020,Burkina Faso,BFA,United States of America,USA,10,0,10,0,20
2020,Belarus,BLR,United States of America,USA,0,0,0,12,12
2020,Bolivia (Plurinational State of),BOL,United States of America,USA,0,0,10,0,10
2020,Brazil,BRA,United States of America,USA,39,0,266,111,416
2020,Bosnia and Herzegovina,BIH,United States of America,USA,0,0,5,0,5
2020,Belize,BLZ,United States of America,USA,0,0,5,0,5
2020,Cambodia,KHM,United States of America,USA,0,0,5,0,5
2020,China,CHN,United States of America,USA,403,0,190,110,703
2020,Chile,CHL,United States of America,USA,0,0,13,5,18
2020,Cameroon,CMR,United States of America,USA,434,0,635,34,1103
2020,Congo,COG,United States of America,USA,5,0,24,5,34
2020,Dem. Rep. of the Congo,COD,United States of America,USA,24,0,60,0,84
2020,Colombia,COL,United States of America,USA,12,0,58,37,107
2020,Costa Rica,CRI,United States of America,USA,0,0,5,0,5
2020,Cuba,CUB,United States of America,USA,844,0,1651,1218,3713
2020,Czechia,CZE,United States of America,USA,0,0,10,0,10
2020,Dominican Rep.,DOM,United States of America,USA,10,0,78,69,157
2020,Ecuador,ECU,United States of America,USA,68,0,325,180,573
2020,Eritrea,ERI,United States of America,USA,70,0,91,10,171
2020,Ethiopia,ETH,United States of America,USA,26,0,16,5,47
2020,France,FRA,United States of America,USA,0,0,0,5,5
2020,Micronesia (Federated States of),FSM,United States of America,USA,0,0,5,0,5
2020,Gambia,GMB,United States of America,USA,0,0,14,0,14
2020,Palestinian,PSE,United States of America,USA,5,0,0,0,5
2020,United Kingdom of Great Britain and Northern Ireland,GBR,United States of America,USA,0,0,5,0,5
2020,Georgia,GEO,United States of America,USA,16,0,43,5,64
2020,Germany,DEU,United States of America,USA,0,0,13,0,13
2020,Ghana,GHA,United States of America,USA,18,0,30,30,78
2020,Guatemala,GTM,United States of America,USA,1026,0,6362,2051,9439
2020,Guinea,GIN,United States of America,USA,18,0,20,5,43
2020,Guyana,GUY,United States of America,USA,0,0,14,0,14
2020,Haiti,HTI,United States of America,USA,26,0,372,198,596
2020,Honduras,HND,United States of America,USA,700,0,5502,1784,7986
2020,Hungary,HUN,United States of America,USA,0,0,5,10,15
2020,Cote d'Ivoire,CIV,United States of America,USA,0,0,12,0,12
2020,India,IND,United States of America,USA,584,0,412,169,1165
2020,Indonesia,IDN,United States of America,USA,5,0,5,0,10
2020,Iran (Islamic Rep. of),IRN,United States of America,USA,14,0,5,0,19
2020,Iraq,IRQ,United States of America,USA,5,0,23,17,45
2020,Israel,ISR,United States of America,USA,0,0,5,0,5
2020,Italy,ITA,United States of America,USA,0,0,11,0,11
2020,Jamaica,JAM,United States of America,USA,0,0,82,32,114
2020,Jordan,JOR,United States of America,USA,0,0,17,0,17
2020,Kazakhstan,KAZ,United States of America,USA,13,0,0,5,18
2020,Kenya,KEN,United States of America,USA,5,0,20,11,36
2020,Kyrgyzstan,KGZ,United States of America,USA,5,0,10,5,20
2020,Rep. of Korea,KOR,United States of America,USA,0,0,10,10,20
2020,Lao People's Dem. Rep.,LAO,United States of America,USA,0,0,11,10,21
2020,Liberia,LBR,United States of America,USA,0,0,28,10,38
2020,Lebanon,LBN,United States of America,USA,0,0,5,0,5
2020,Sri Lanka,LKA,United States of America,USA,21,0,50,5,76
2020,Mauritania,MRT,United States of America,USA,16,0,24,0,40
2020,Rep. of Moldova,MDA,United States of America,USA,5,0,5,0,10
2020,Mexico,MEX,United States of America,USA,469,0,3427,1450,5346
2020,Mali,MLI,United States of America,USA,0,0,11,0,11
2020,Myanmar,MMR,United States of America,USA,0,0,14,5,19
2020,Nepal,NPL,United States of America,USA,100,0,49,10,159
2020,Nicaragua,NIC,United States of America,USA,211,0,433,147,791
2020,Nigeria,NGA,United States of America,USA,26,0,47,36,109
2020,Pakistan,PAK,United States of America,USA,29,0,56,19,104
2020,Panama,PAN,United States of America,USA,0,0,5,5,10
2020,Peru,PER,United States of America,USA,11,0,77,39,127
2020,Philippines,PHL,United States of America,USA,0,0,20,5,25
2020,Romania,ROU,United States of America,USA,11,0,67,71,149
2020,South Africa,ZAF,United States of America,USA,0,0,10,0,10
2020,Russian Federation,RUS,United States of America,USA,78,0,79,19,176
2020,Rwanda,RWA,United States of America,USA,0,0,5,0,5
2020,El Salvador,SLV,United States of America,USA,1226,0,5888,1468,8582
2020,Saudi Arabia,SAU,United States of America,USA,0,0,5,0,5
2020,Serbia and Kosovo: S/RES/1244 (1999),SRB,United States of America,USA,0,0,5,0,5
2020,Senegal,SEN,United States of America,USA,5,0,11,0,16
2020,Sierra Leone,SLE,United States of America,USA,0,0,10,0,10
2020,Somalia,SOM,United States of America,USA,13,0,29,23,65
2020,Spain,ESP,United States of America,USA,0,0,0,5,5
2020,Viet Nam,VNM,United States of America,USA,59,0,37,16,112
2020,Sudan,SDN,United States of America,USA,5,0,25,12,42
2020,South Sudan,SSD,United States of America,USA,0,0,13,0,13
2020,Syrian Arab Rep.,SYR,United States of America,USA,30,0,5,11,46
2020,United Rep. of Tanzania,TZA,United States of America,USA,0,0,5,0,5
2020,Thailand,THA,United States of America,USA,0,0,5,0,5
2020,Tajikistan,TJK,United States of America,USA,0,0,5,0,5
2020,Togo,TGO,United States of America,USA,0,0,11,0,11
2020,Trinidad and Tobago,TTO,United States of America,USA,0,0,5,5,10
2020,Tunisia,TUN,United States of America,USA,0,0,5,0,5
2020,Turkey,TUR,United States of America,USA,22,0,18,22,62
2020,Uganda,UGA,United States of America,USA,15,0,16,0,31
2020,Ukraine,UKR,United States of America,USA,5,0,21,24,50
2020,Uzbekistan,UZB,United States of America,USA,33,0,27,0,60
2020,Venezuela (Bolivarian Republic of),VEN,United States of America,USA,379,0,586,101,1066
2020,Yemen,YEM,United States of America,USA,11,0,12,0,23
2020,Unknown ,,United States of America,USA,65,0,84,264,413
2005,Burundi,BDI,Israel,ISR,0,0,0,5,5
2005,Cameroon,CMR,Israel,ISR,0,0,0,5,5
2005,Congo,COG,Israel,ISR,0,0,0,5,5
2005,Dem. Rep. of the Congo,COD,Israel,ISR,0,10,0,5,15
2005,Colombia,COL,Israel,ISR,0,0,0,5,5
2005,Ecuador,ECU,Israel,ISR,0,0,0,5,5
2005,Eritrea,ERI,Israel,ISR,0,0,0,5,5
2005,Ethiopia,ETH,Israel,ISR,0,0,0,221,221
2005,Ghana,GHA,Israel,ISR,0,0,0,21,21
2005,Guinea,GIN,Israel,ISR,0,0,0,32,32
2005,Cote d'Ivoire,CIV,Israel,ISR,0,34,0,0,34
2005,India,IND,Israel,ISR,0,0,0,5,5
2005,Kenya,KEN,Israel,ISR,0,0,0,5,5
2005,Liberia,LBR,Israel,ISR,0,5,0,0,5
2005,Sri Lanka,LKA,Israel,ISR,0,0,0,19,19
2005,Morocco,MAR,Israel,ISR,0,0,0,5,5
2005,Myanmar,MMR,Israel,ISR,0,0,0,5,5
2005,Nigeria,NGA,Israel,ISR,0,0,31,85,116
2005,Philippines,PHL,Israel,ISR,0,0,0,5,5
2005,Sierra Leone,SLE,Israel,ISR,5,0,0,0,5
2005,Somalia,SOM,Israel,ISR,0,0,0,5,5
2005,Sudan,SDN,Israel,ISR,0,0,0,15,15
2005,Togo,TGO,Israel,ISR,0,0,5,15,20
2005,Turkey,TUR,Israel,ISR,0,0,27,20,47
2005,Zimbabwe,ZWE,Israel,ISR,0,0,5,0,5
2005,Unknown ,,Israel,ISR,0,0,0,109,109
2005,Burundi,BDI,Zambia,ZMB,10,0,5,0,15
2005,Dem. Rep. of the Congo,COD,Zambia,ZMB,45,0,22,0,67
2005,Rwanda,RWA,Zambia,ZMB,5,0,5,0,10
2005,Somalia,SOM,Zambia,ZMB,0,0,5,0,5
2005,Unknown ,,Zambia,ZMB,5,0,0,0,5
2006,Central African Rep.,CAF,Chad,TCD,0,0,5,0,5
2006,Congo,COG,Chad,TCD,0,0,10,0,10
2006,Dem. Rep. of the Congo,COD,Chad,TCD,0,5,63,0,68
2006,Liberia,LBR,Chad,TCD,0,0,5,0,5
2006,Rwanda,RWA,Chad,TCD,0,0,5,0,5
2006,Sudan,SDN,Chad,TCD,0,0,43,0,43
2006,Togo,TGO,Chad,TCD,0,0,17,0,17
2006,Burundi,BDI,Zambia,ZMB,0,0,5,0,5
2006,Dem. Rep. of the Congo,COD,Zambia,ZMB,10,0,5,0,15
2006,Rwanda,RWA,Zambia,ZMB,5,0,5,0,10
2007,Congo,COG,Chad,TCD,0,0,5,0,5
2007,Dem. Rep. of the Congo,COD,Chad,TCD,0,0,10,0,10
2007,Liberia,LBR,Chad,TCD,0,0,5,0,5
2007,Sudan,SDN,Chad,TCD,0,0,15,0,15
2007,Burundi,BDI,Zambia,ZMB,5,0,10,0,15
2007,Dem. Rep. of the Congo,COD,Zambia,ZMB,32,5,26,22,85
2007,Rwanda,RWA,Zambia,ZMB,0,0,5,5,10
2007,Somalia,SOM,Zambia,ZMB,10,0,5,0,15
2007,Unknown ,,Zambia,ZMB,0,0,5,5,10
2008,Cote d'Ivoire,CIV,Liberia,LBR,37,0,0,12,49
2008,Nigeria,NGA,Liberia,LBR,0,0,0,5,5
2008,Sierra Leone,SLE,Liberia,LBR,0,0,0,5,5
2008,Burundi,BDI,Zambia,ZMB,0,0,15,15,30
2008,Dem. Rep. of the Congo,COD,Zambia,ZMB,0,48,16,23,87
2008,Ethiopia,ETH,Zambia,ZMB,0,0,5,0,5
2008,Rwanda,RWA,Zambia,ZMB,0,5,0,0,5
2008,Somalia,SOM,Zambia,ZMB,0,15,19,0,34
2008,Zimbabwe,ZWE,Zambia,ZMB,10,0,0,18,28
2009,Sri Lanka,LKA,Timor-Leste,TLS,0,0,0,10,10
2014,Central African Rep.,CAF,Senegal,SEN,0,0,10,0,10
2014,Chad,TCD,Senegal,SEN,0,0,5,0,5
2014,Dem. Rep. of the Congo,COD,Senegal,SEN,0,0,11,0,11
2014,Gambia,GMB,Senegal,SEN,27,0,13,0,40
2014,Cote d'Ivoire,CIV,Senegal,SEN,0,0,10,0,10
2014,Mali,MLI,Senegal,SEN,0,0,5,0,5
2014,Togo,TGO,Senegal,SEN,0,0,5,0,5
2015,Central African Rep.,CAF,Senegal,SEN,97,0,0,0,97
2015,Gambia,GMB,Senegal,SEN,38,0,0,0,38
2000,Afghanistan,AFG,Austria,AUT,295,0,217,3343,3855
2000,Albania,ALB,Austria,AUT,10,0,51,19,80
2000,Algeria,DZA,Austria,AUT,0,0,48,60,108
2000,Angola,AGO,Austria,AUT,0,0,44,32,76
2000,Egypt,EGY,Austria,AUT,0,0,0,5,5
2000,Armenia,ARM,Austria,AUT,20,0,54,45,119
2000,Azerbaijan,AZE,Austria,AUT,12,0,13,5,30
2000,Belgium,BEL,Austria,AUT,0,0,0,5,5
2000,Bangladesh,BGD,Austria,AUT,0,0,40,270,310
2000,Bhutan,BTN,Austria,AUT,0,0,0,5,5
2000,Burkina Faso,BFA,Austria,AUT,0,0,0,5,5
2000,Belarus,BLR,Austria,AUT,0,0,5,35,40
2000,Bosnia and Herzegovina,BIH,Austria,AUT,11,0,81,66,158
2000,Bulgaria,BGR,Austria,AUT,0,0,5,14,19
2000,Cambodia,KHM,Austria,AUT,5,0,0,0,5
2000,China,CHN,Austria,AUT,5,0,32,42,79
2000,Cameroon,CMR,Austria,AUT,5,0,14,10,29
2000,Congo,COG,Austria,AUT,5,0,5,13,23
2000,Dem. Rep. of the Congo,COD,Austria,AUT,32,0,41,30,103
2000,Colombia,COL,Austria,AUT,10,0,5,17,32
2000,Cuba,CUB,Austria,AUT,0,0,0,5,5
2000,Czechia,CZE,Austria,AUT,0,0,0,20,20
2000,Dominican Rep.,DOM,Austria,AUT,0,0,0,5,5
2000,Equatorial Guinea,GNQ,Austria,AUT,0,0,11,15,26
2000,Eritrea,ERI,Austria,AUT,0,0,0,5,5
2000,Ethiopia,ETH,Austria,AUT,5,0,5,10,20
2000,Gambia,GMB,Austria,AUT,0,0,24,15,39
2000,Georgia,GEO,Austria,AUT,5,0,5,12,22
2000,Ghana,GHA,Austria,AUT,0,0,26,13,39
2000,Guinea-Bissau,GNB,Austria,AUT,0,0,5,0,5
2000,Croatia,HRV,Austria,AUT,5,0,5,21,31
2000,Hungary,HUN,Austria,AUT,0,0,10,5,15
2000,Cote d'Ivoire,CIV,Austria,AUT,0,0,0,5,5
2000,India,IND,Austria,AUT,0,0,268,2061,2329
2000,Iran (Islamic Rep. of),IRN,Austria,AUT,63,0,368,3217,3648
2000,Iraq,IRQ,Austria,AUT,98,0,241,2125,2464
2000,Israel,ISR,Austria,AUT,0,0,0,5,5
2000,Jordan,JOR,Austria,AUT,0,0,5,5,10
2000,Kazakhstan,KAZ,Austria,AUT,0,0,5,5,10
2000,Kyrgyzstan,KGZ,Austria,AUT,0,0,0,5,5
2000,Liberia,LBR,Austria,AUT,0,0,31,14,45
2000,Libya,LBY,Austria,AUT,0,0,0,5,5
2000,Lebanon,LBN,Austria,AUT,0,0,12,31,43
2000,Sri Lanka,LKA,Austria,AUT,0,0,33,173,206
2000,Lithuania,LTU,Austria,AUT,0,0,0,16,16
2000,Mauritania,MRT,Austria,AUT,0,0,5,0,5
2000,North Macedonia,MKD,Austria,AUT,0,0,12,14,26
2000,Rep. of Moldova,MDA,Austria,AUT,0,0,27,51,78
2000,Mongolia,MNG,Austria,AUT,0,0,5,5,10
2000,Morocco,MAR,Austria,AUT,0,0,0,5,5
2000,Myanmar,MMR,Austria,AUT,0,0,0,5,5
2000,Nepal,NPL,Austria,AUT,0,0,0,25,25
2000,Nigeria,NGA,Austria,AUT,0,0,142,95,237
2000,Pakistan,PAK,Austria,AUT,0,0,100,428,528
2000,Poland,POL,Austria,AUT,0,0,0,5,5
2000,Romania,ROU,Austria,AUT,5,0,17,40,62
2000,Russian Federation,RUS,Austria,AUT,22,0,48,117,187
2000,Rwanda,RWA,Austria,AUT,12,0,10,10,32
2000,Serbia and Kosovo: S/RES/1244 (1999),SRB,Austria,AUT,292,0,2025,1212,3529
2000,Senegal,SEN,Austria,AUT,0,0,5,10,15
2000,Sierra Leone,SLE,Austria,AUT,5,0,179,74,258
2000,Somalia,SOM,Austria,AUT,10,0,30,140,180
2000,Viet Nam,VNM,Austria,AUT,5,0,0,5,10
2000,Sudan,SDN,Austria,AUT,5,0,54,29,88
2000,Slovakia,SVK,Austria,AUT,0,0,0,17,17
2000,Syrian Arab Rep.,SYR,Austria,AUT,0,0,26,142,168
2000,Tajikistan,TJK,Austria,AUT,11,0,0,5,16
2000,Tunisia,TUN,Austria,AUT,0,0,0,10,10
2000,Turkey,TUR,Austria,AUT,18,0,165,157,340
2000,Uganda,UGA,Austria,AUT,0,0,41,20,61
2000,Ukraine,UKR,Austria,AUT,5,0,20,44,69
2000,Uzbekistan,UZB,Austria,AUT,0,0,5,0,5
2000,Stateless,XXA,Austria,AUT,5,0,23,164,192
2000,Unknown ,,Austria,AUT,5,0,122,56,183
2000,Afghanistan,AFG,Italy,ITA,30,0,321,0,351
2000,Albania,ALB,Italy,ITA,38,0,97,0,135
2000,Algeria,DZA,Italy,ITA,0,0,15,0,15
2000,Angola,AGO,Italy,ITA,31,0,16,0,47
2000,Egypt,EGY,Italy,ITA,5,0,10,0,15
2000,Armenia,ARM,Italy,ITA,10,0,10,0,20
2000,Azerbaijan,AZE,Italy,ITA,5,0,5,0,10
2000,Burundi,BDI,Italy,ITA,5,0,0,0,5
2000,Benin,BEN,Italy,ITA,5,0,0,0,5
2000,Bangladesh,BGD,Italy,ITA,5,0,50,0,55
2000,Bosnia and Herzegovina,BIH,Italy,ITA,10,0,17,0,27
2000,China,CHN,Italy,ITA,0,0,19,0,19
2000,Cameroon,CMR,Italy,ITA,19,0,0,0,19
2000,Congo,COG,Italy,ITA,95,0,29,0,124
2000,Dem. Rep. of the Congo,COD,Italy,ITA,51,0,35,0,86
2000,Colombia,COL,Italy,ITA,12,0,14,0,26
2000,Cuba,CUB,Italy,ITA,5,0,10,0,15
2000,Eritrea,ERI,Italy,ITA,13,0,5,0,18
2000,Ethiopia,ETH,Italy,ITA,48,0,26,0,74
2000,Palestinian,PSE,Italy,ITA,10,0,20,5,35
2000,Georgia,GEO,Italy,ITA,15,0,14,0,29
2000,Ghana,GHA,Italy,ITA,5,0,10,0,15
2000,Guinea-Bissau,GNB,Italy,ITA,0,0,15,0,15
2000,Guinea,GIN,Italy,ITA,0,0,5,0,5
2000,Croatia,HRV,Italy,ITA,5,0,5,0,10
2000,Cote d'Ivoire,CIV,Italy,ITA,5,0,0,0,5
2000,Iran (Islamic Rep. of),IRN,Italy,ITA,87,0,118,0,205
2000,Iraq,IRQ,Italy,ITA,150,0,5455,59,5664
2000,Kazakhstan,KAZ,Italy,ITA,5,0,0,0,5
2000,Liberia,LBR,Italy,ITA,5,0,5,0,10
2000,Libya,LBY,Italy,ITA,0,0,5,0,5
2000,Lebanon,LBN,Italy,ITA,0,0,10,0,10
2000,Sri Lanka,LKA,Italy,ITA,10,0,46,0,56
2000,North Macedonia,MKD,Italy,ITA,0,0,58,0,58
2000,Rep. of Moldova,MDA,Italy,ITA,0,0,14,0,14
2000,Morocco,MAR,Italy,ITA,0,0,5,0,5
2000,Nigeria,NGA,Italy,ITA,0,0,16,0,16
2000,Pakistan,PAK,Italy,ITA,10,0,23,0,33
2000,Peru,PER,Italy,ITA,5,0,0,0,5
2000,Romania,ROU,Italy,ITA,0,0,114,0,114
2000,Russian Federation,RUS,Italy,ITA,63,0,63,0,126
2000,Rwanda,RWA,Italy,ITA,12,0,17,0,29
2000,Senegal,SEN,Italy,ITA,0,0,5,0,5
2000,Sierra Leone,SLE,Italy,ITA,14,0,60,0,74
2000,Somalia,SOM,Italy,ITA,10,0,78,0,88
2000,Viet Nam,VNM,Italy,ITA,5,0,0,0,5
2000,Sudan,SDN,Italy,ITA,31,0,25,0,56
2000,Syrian Arab Rep.,SYR,Italy,ITA,5,0,44,0,49
2000,Togo,TGO,Italy,ITA,10,0,0,0,10
2000,Tunisia,TUN,Italy,ITA,18,0,13,0,31
2000,Turkey,TUR,Italy,ITA,222,0,3327,29,3578
2000,Ukraine,UKR,Italy,ITA,5,0,5,0,10
2000,Uzbekistan,UZB,Italy,ITA,0,0,5,0,5
2000,Unknown ,,Italy,ITA,554,0,12981,0,13535
2001,Afghanistan,AFG,Austria,AUT,432,0,335,0,767
2001,Albania,ALB,Austria,AUT,20,0,38,0,58
2001,Algeria,DZA,Austria,AUT,0,0,36,0,36
2001,Angola,AGO,Austria,AUT,10,0,14,0,24
2001,Egypt,EGY,Austria,AUT,0,0,5,0,5
2001,Armenia,ARM,Austria,AUT,5,0,108,0,113
2001,Azerbaijan,AZE,Austria,AUT,5,0,10,0,15
2001,Burundi,BDI,Austria,AUT,5,0,0,0,5
2001,Benin,BEN,Austria,AUT,0,0,5,0,5
2001,Bangladesh,BGD,Austria,AUT,0,0,63,0,63
2001,Belarus,BLR,Austria,AUT,0,0,5,0,5
2001,Bosnia and Herzegovina,BIH,Austria,AUT,5,0,52,0,57
2001,Bulgaria,BGR,Austria,AUT,0,0,5,0,5
2001,China,CHN,Austria,AUT,0,0,42,0,42
2001,Cameroon,CMR,Austria,AUT,5,0,10,0,15
2001,Congo,COG,Austria,AUT,5,0,5,0,10
2001,Dem. Rep. of the Congo,COD,Austria,AUT,25,0,25,0,50
2001,Ethiopia,ETH,Austria,AUT,5,0,12,0,17
2001,Gabon,GAB,Austria,AUT,0,0,5,0,5
2001,Gambia,GMB,Austria,AUT,0,0,69,0,69
2001,Georgia,GEO,Austria,AUT,5,0,57,0,62
2001,Ghana,GHA,Austria,AUT,0,0,27,0,27
2001,Guinea,GIN,Austria,AUT,0,0,5,0,5
2001,Croatia,HRV,Austria,AUT,0,0,5,0,5
2001,Cote d'Ivoire,CIV,Austria,AUT,0,0,5,0,5
2001,India,IND,Austria,AUT,0,0,294,0,294
2001,Iran (Islamic Rep. of),IRN,Austria,AUT,134,0,334,0,468
2001,Iraq,IRQ,Austria,AUT,87,0,239,0,326
2001,Israel,ISR,Austria,AUT,0,0,10,0,10
2001,Jordan,JOR,Austria,AUT,0,0,5,0,5
2001,Kazakhstan,KAZ,Austria,AUT,0,0,5,0,5
2001,Kyrgyzstan,KGZ,Austria,AUT,15,0,0,0,15
2001,Liberia,LBR,Austria,AUT,0,0,26,0,26
2001,Libya,LBY,Austria,AUT,0,0,5,0,5
2001,Lebanon,LBN,Austria,AUT,0,0,5,0,5
2001,Sri Lanka,LKA,Austria,AUT,0,0,22,0,22
2001,Lithuania,LTU,Austria,AUT,0,0,5,0,5
2001,Mauritania,MRT,Austria,AUT,0,0,5,0,5
2001,North Macedonia,MKD,Austria,AUT,0,0,71,0,71
2001,Rep. of Moldova,MDA,Austria,AUT,5,0,40,0,45
2001,Mongolia,MNG,Austria,AUT,0,0,5,0,5
2001,Nigeria,NGA,Austria,AUT,0,0,216,0,216
2001,Pakistan,PAK,Austria,AUT,5,0,91,0,96
2001,Romania,ROU,Austria,AUT,5,0,12,0,17
2001,Russian Federation,RUS,Austria,AUT,18,0,84,0,102
2001,Rwanda,RWA,Austria,AUT,16,0,0,0,16
2001,Serbia and Kosovo: S/RES/1244 (1999),SRB,Austria,AUT,206,0,692,0,898
2001,Senegal,SEN,Austria,AUT,0,0,17,0,17
2001,Sierra Leone,SLE,Austria,AUT,5,0,114,0,119
2001,Somalia,SOM,Austria,AUT,5,0,42,0,47
2001,Viet Nam,VNM,Austria,AUT,5,0,5,0,10
2001,Sudan,SDN,Austria,AUT,5,0,25,0,30
2001,Syrian Arab Rep.,SYR,Austria,AUT,11,0,32,0,43
2001,Tunisia,TUN,Austria,AUT,5,0,13,0,18
2001,Turkey,TUR,Austria,AUT,49,0,284,0,333
2001,Uganda,UGA,Austria,AUT,0,0,33,0,33
2001,Ukraine,UKR,Austria,AUT,5,0,42,0,47
2001,Stateless,XXA,Austria,AUT,13,0,31,0,44
2001,Unknown ,,Austria,AUT,10,0,80,21502,21592
2001,Afghanistan,AFG,Italy,ITA,81,0,373,0,454
2001,Albania,ALB,Italy,ITA,22,36,92,0,150
2001,Algeria,DZA,Italy,ITA,5,5,17,0,27
2001,Angola,AGO,Italy,ITA,16,5,5,0,26
2001,Bangladesh,BGD,Italy,ITA,11,0,50,0,61
2001,Bosnia and Herzegovina,BIH,Italy,ITA,15,15,15,0,45
2001,Cameroon,CMR,Italy,ITA,22,0,5,0,27
2001,Congo,COG,Italy,ITA,72,16,0,0,88
2001,Dem. Rep. of the Congo,COD,Italy,ITA,85,0,26,0,111
2001,Colombia,COL,Italy,ITA,27,20,13,0,60
2001,Eritrea,ERI,Italy,ITA,21,5,21,0,47
2001,Ethiopia,ETH,Italy,ITA,65,10,20,0,95
2001,Gambia,GMB,Italy,ITA,10,0,10,0,20
2001,Palestinian,PSE,Italy,ITA,5,0,22,0,27
2001,Iran (Islamic Rep. of),IRN,Italy,ITA,89,0,92,0,181
2001,Iraq,IRQ,Italy,ITA,189,81,4312,0,4582
2001,Lebanon,LBN,Italy,ITA,11,0,10,0,21
2001,Sri Lanka,LKA,Italy,ITA,10,5,97,0,112
2001,North Macedonia,MKD,Italy,ITA,0,16,5,0,21
2001,Rep. of Moldova,MDA,Italy,ITA,5,0,33,0,38
2001,Nigeria,NGA,Italy,ITA,10,0,89,0,99
2001,Pakistan,PAK,Italy,ITA,10,0,50,0,60
2001,Romania,ROU,Italy,ITA,14,15,239,0,268
2001,Russian Federation,RUS,Italy,ITA,106,11,56,0,173
2001,Rwanda,RWA,Italy,ITA,19,0,0,0,19
2001,Serbia and Kosovo: S/RES/1244 (1999),SRB,Italy,ITA,649,198,1583,0,2430
2001,Sierra Leone,SLE,Italy,ITA,52,16,96,0,164
2001,Somalia,SOM,Italy,ITA,22,10,60,0,92
2001,Sudan,SDN,Italy,ITA,22,5,11,0,38
2001,Togo,TGO,Italy,ITA,22,0,5,0,27
2001,Tunisia,TUN,Italy,ITA,14,0,12,0,26
2001,Turkey,TUR,Italy,ITA,313,55,2984,0,3352
2001,Ukraine,UKR,Italy,ITA,5,5,27,0,37
2001,Unknown ,,Italy,ITA,86,24,124,0,234
2002,Afghanistan,AFG,Austria,AUT,263,0,308,5229,5800
2002,Albania,ALB,Austria,AUT,25,0,22,37,84
2002,Algeria,DZA,Austria,AUT,0,0,37,154,191
2002,Angola,AGO,Austria,AUT,13,0,16,5,34
2002,Egypt,EGY,Austria,AUT,0,0,11,29,40
2002,Armenia,ARM,Austria,AUT,10,0,205,1684,1899
2002,Azerbaijan,AZE,Austria,AUT,5,0,17,83,105
2002,Burundi,BDI,Austria,AUT,0,0,0,5,5
2002,Benin,BEN,Austria,AUT,0,0,0,5,5
2002,Bangladesh,BGD,Austria,AUT,0,0,52,823,875
2002,Burkina Faso,BFA,Austria,AUT,0,0,0,5,5
2002,Belarus,BLR,Austria,AUT,0,0,18,70,88
2002,Bosnia and Herzegovina,BIH,Austria,AUT,5,0,47,70,122
2002,Bulgaria,BGR,Austria,AUT,0,0,5,45,50
2002,China,CHN,Austria,AUT,0,0,66,324,390
2002,Cameroon,CMR,Austria,AUT,12,0,5,21,38
2002,Congo,COG,Austria,AUT,10,0,0,5,15
2002,Dem. Rep. of the Congo,COD,Austria,AUT,27,0,18,29,74
2002,Colombia,COL,Austria,AUT,0,0,5,5,10
2002,Czechia,CZE,Austria,AUT,0,0,0,13,13
2002,Ethiopia,ETH,Austria,AUT,5,0,10,17,32
2002,Gambia,GMB,Austria,AUT,5,0,18,48,71
2002,Georgia,GEO,Austria,AUT,13,0,136,1324,1473
2002,Ghana,GHA,Austria,AUT,0,0,25,34,59
2002,Guinea-Bissau,GNB,Austria,AUT,0,0,0,5,5
2002,Guinea,GIN,Austria,AUT,0,0,17,33,50
2002,Croatia,HRV,Austria,AUT,0,0,0,10,10
2002,Hungary,HUN,Austria,AUT,0,0,0,13,13
2002,Cote d'Ivoire,CIV,Austria,AUT,0,0,5,10,15
2002,India,IND,Austria,AUT,0,0,192,2328,2520
2002,Iran (Islamic Rep. of),IRN,Austria,AUT,160,0,136,391,687
2002,Iraq,IRQ,Austria,AUT,117,0,159,3946,4222
2002,Israel,ISR,Austria,AUT,0,0,0,15,15
2002,Jordan,JOR,Austria,AUT,0,0,0,5,5
2002,Kazakhstan,KAZ,Austria,AUT,0,0,0,10,10
2002,Kyrgyzstan,KGZ,Austria,AUT,0,0,15,13,28
2002,Liberia,LBR,Austria,AUT,0,0,5,78,83
2002,Lebanon,LBN,Austria,AUT,0,0,5,30,35
2002,Sri Lanka,LKA,Austria,AUT,0,0,5,58,63
2002,Lithuania,LTU,Austria,AUT,0,0,5,25,30
2002,Latvia,LVA,Austria,AUT,0,0,0,5,5
2002,Mauritania,MRT,Austria,AUT,0,0,5,5,10
2002,North Macedonia,MKD,Austria,AUT,0,0,235,381,616
2002,Rep. of Moldova,MDA,Austria,AUT,0,0,77,516,593
2002,Mali,MLI,Austria,AUT,0,0,0,5,5
2002,Malawi,MWI,Austria,AUT,0,0,5,0,5
2002,Mongolia,MNG,Austria,AUT,0,0,19,45,64
2002,Morocco,MAR,Austria,AUT,0,0,5,13,18
2002,Nepal,NPL,Austria,AUT,0,0,5,75,80
2002,Nigeria,NGA,Austria,AUT,5,0,322,388,715
2002,Pakistan,PAK,Austria,AUT,5,0,49,282,336
2002,Romania,ROU,Austria,AUT,5,0,5,56,66
2002,Russian Federation,RUS,Austria,AUT,36,0,91,953,1080
2002,Rwanda,RWA,Austria,AUT,0,0,0,5,5
2002,Serbia and Kosovo: S/RES/1244 (1999),SRB,Austria,AUT,191,0,1249,1547,2987
2002,Senegal,SEN,Austria,AUT,0,0,12,21,33
2002,Sierra Leone,SLE,Austria,AUT,11,0,48,73,132
2002,Somalia,SOM,Austria,AUT,15,0,20,189,224
2002,Viet Nam,VNM,Austria,AUT,0,0,5,16,21
2002,Sudan,SDN,Austria,AUT,10,0,18,70,98
2002,Slovakia,SVK,Austria,AUT,0,0,0,43,43
2002,Slovenia,SVN,Austria,AUT,0,0,0,5,5
2002,Syrian Arab Rep.,SYR,Austria,AUT,10,0,5,79,94
2002,Tajikistan,TJK,Austria,AUT,5,0,0,10,15
2002,Togo,TGO,Austria,AUT,0,0,0,5,5
2002,Tunisia,TUN,Austria,AUT,0,0,10,28,38
2002,Turkey,TUR,Austria,AUT,68,0,352,1950,2370
2002,Uganda,UGA,Austria,AUT,0,0,16,18,34
2002,Ukraine,UKR,Austria,AUT,10,0,67,195,272
2002,Uzbekistan,UZB,Austria,AUT,0,0,0,5,5
2002,Zimbabwe,ZWE,Austria,AUT,0,0,0,5,5
2002,Stateless,XXA,Austria,AUT,5,0,30,375,410
2002,Unknown ,,Austria,AUT,5,0,47,119,171
2002,Afghanistan,AFG,Italy,ITA,10,32,368,0,410
2002,Albania,ALB,Italy,ITA,5,5,51,0,61
2002,Angola,AGO,Italy,ITA,10,13,16,0,39
2002,Bangladesh,BGD,Italy,ITA,5,0,212,0,217
2002,Bosnia and Herzegovina,BIH,Italy,ITA,0,10,40,0,50
2002,Cameroon,CMR,Italy,ITA,10,5,19,0,34
2002,Congo,COG,Italy,ITA,33,10,19,0,62
2002,Dem. Rep. of the Congo,COD,Italy,ITA,35,14,27,0,76
2002,Colombia,COL,Italy,ITA,20,14,60,0,94
2002,Eritrea,ERI,Italy,ITA,25,29,101,0,155
2002,Ethiopia,ETH,Italy,ITA,47,12,53,0,112
2002,Palestinian,PSE,Italy,ITA,0,5,35,0,40
2002,Georgia,GEO,Italy,ITA,5,0,13,0,18
2002,Ghana,GHA,Italy,ITA,0,0,5,0,5
2002,Cote d'Ivoire,CIV,Italy,ITA,0,0,5,0,5
2002,India,IND,Italy,ITA,5,0,11,0,16
2002,Iran (Islamic Rep. of),IRN,Italy,ITA,41,10,58,0,109
2002,Iraq,IRQ,Italy,ITA,124,63,5796,0,5983
2002,Sri Lanka,LKA,Italy,ITA,344,81,810,0,1235
2002,North Macedonia,MKD,Italy,ITA,5,5,118,0,128
2002,Rep. of Moldova,MDA,Italy,ITA,0,0,45,0,45
2002,Nigeria,NGA,Italy,ITA,14,15,379,0,408
2002,Pakistan,PAK,Italy,ITA,5,0,81,0,86
2002,Romania,ROU,Italy,ITA,0,5,356,0,361
2002,Russian Federation,RUS,Italy,ITA,5,10,93,0,108
2002,Serbia and Kosovo: S/RES/1244 (1999),SRB,Italy,ITA,94,198,915,0,1207
2002,Sierra Leone,SLE,Italy,ITA,11,42,71,0,124
2002,Somalia,SOM,Italy,ITA,5,12,61,0,78
2002,Sudan,SDN,Italy,ITA,28,25,56,0,109
2002,Syrian Arab Rep.,SYR,Italy,ITA,17,0,41,0,58
2002,Togo,TGO,Italy,ITA,26,5,20,0,51
2002,Turkey,TUR,Italy,ITA,138,50,2705,0,2893
2002,Stateless,XXA,Italy,ITA,0,0,5,0,5
2002,Unknown ,,Italy,ITA,47,29,241,0,317
2003,Afghanistan,AFG,Austria,AUT,339,0,168,0,507
2003,Albania,ALB,Austria,AUT,30,0,21,0,51
2003,Algeria,DZA,Austria,AUT,0,0,61,0,61
2003,Angola,AGO,Austria,AUT,21,0,12,0,33
2003,Egypt,EGY,Austria,AUT,0,0,11,0,11
2003,Armenia,ARM,Austria,AUT,26,0,126,0,152
2003,Azerbaijan,AZE,Austria,AUT,13,0,17,0,30
2003,Benin,BEN,Austria,AUT,0,0,5,0,5
2003,Bangladesh,BGD,Austria,AUT,0,0,85,0,85
2003,Burkina Faso,BFA,Austria,AUT,0,0,5,0,5
2003,Belarus,BLR,Austria,AUT,0,0,20,0,20
2003,Bolivia (Plurinational State of),BOL,Austria,AUT,5,0,0,0,5
2003,Bosnia and Herzegovina,BIH,Austria,AUT,14,0,53,0,67
2003,Bulgaria,BGR,Austria,AUT,0,0,5,0,5
2003,China,CHN,Austria,AUT,10,0,149,0,159
2003,Cameroon,CMR,Austria,AUT,12,0,5,0,17
2003,Congo,COG,Austria,AUT,10,0,0,0,10
2003,Dem. Rep. of the Congo,COD,Austria,AUT,30,0,5,0,35
2003,Czechia,CZE,Austria,AUT,0,0,5,0,5
2003,Eritrea,ERI,Austria,AUT,5,0,0,0,5
2003,Ethiopia,ETH,Austria,AUT,14,0,0,0,14
2003,Gambia,GMB,Austria,AUT,0,0,43,0,43
2003,Georgia,GEO,Austria,AUT,60,0,233,0,293
2003,Ghana,GHA,Austria,AUT,0,0,17,0,17
2003,Guinea-Bissau,GNB,Austria,AUT,0,0,5,0,5
2003,Guinea,GIN,Austria,AUT,5,0,14,0,19
2003,Croatia,HRV,Austria,AUT,0,0,5,0,5
2003,Cote d'Ivoire,CIV,Austria,AUT,0,0,12,0,12
2003,India,IND,Austria,AUT,0,0,694,0,694
2003,Iran (Islamic Rep. of),IRN,Austria,AUT,164,0,101,0,265
2003,Iraq,IRQ,Austria,AUT,143,0,49,0,192
2003,Kazakhstan,KAZ,Austria,AUT,10,0,0,0,10
2003,Kyrgyzstan,KGZ,Austria,AUT,5,0,0,0,5
2003,Liberia,LBR,Austria,AUT,0,0,15,0,15
2003,Lebanon,LBN,Austria,AUT,0,0,5,0,5
2003,Sri Lanka,LKA,Austria,AUT,0,0,5,0,5
2003,North Macedonia,MKD,Austria,AUT,5,0,261,0,266
2003,Rep. of Moldova,MDA,Austria,AUT,0,0,175,0,175
2003,Mongolia,MNG,Austria,AUT,0,0,23,0,23
2003,Morocco,MAR,Austria,AUT,0,0,10,0,10
2003,Nepal,NPL,Austria,AUT,0,0,5,0,5
2003,Nigeria,NGA,Austria,AUT,5,0,371,0,376
2003,Pakistan,PAK,Austria,AUT,0,0,84,0,84
2003,Romania,ROU,Austria,AUT,0,0,10,0,10
2003,Russian Federation,RUS,Austria,AUT,788,0,237,0,1025
2003,Rwanda,RWA,Austria,AUT,13,0,0,0,13
2003,Serbia and Kosovo: S/RES/1244 (1999),SRB,Austria,AUT,162,0,1090,0,1252
2003,Senegal,SEN,Austria,AUT,0,0,10,0,10
2003,Sierra Leone,SLE,Austria,AUT,5,0,27,0,32
2003,Somalia,SOM,Austria,AUT,24,0,11,0,35
2003,Viet Nam,VNM,Austria,AUT,0,0,10,0,10
2003,Sudan,SDN,Austria,AUT,16,0,11,0,27
2003,Syrian Arab Rep.,SYR,Austria,AUT,18,0,14,0,32
2003,Turkmenistan,TKM,Austria,AUT,10,0,0,0,10
2003,Tunisia,TUN,Austria,AUT,0,0,5,0,5
2003,Turkey,TUR,Austria,AUT,73,0,424,0,497
2003,Uganda,UGA,Austria,AUT,0,0,5,0,5
2003,Ukraine,UKR,Austria,AUT,10,0,91,0,101
2003,Uzbekistan,UZB,Austria,AUT,0,0,10,0,10
2003,Stateless,XXA,Austria,AUT,24,0,51,0,75
2003,Unknown ,,Austria,AUT,5,0,56,29280,29341
2003,Afghanistan,AFG,Italy,ITA,5,0,181,0,186
2003,Albania,ALB,Italy,ITA,0,0,41,5,46
2003,Angola,AGO,Italy,ITA,10,0,29,0,39
2003,Bangladesh,BGD,Italy,ITA,0,0,205,0,205
2003,Cameroon,CMR,Italy,ITA,18,0,34,0,52
2003,Congo,COG,Italy,ITA,55,0,65,5,125
2003,Dem. Rep. of the Congo,COD,Italy,ITA,51,0,57,0,108
2003,Colombia,COL,Italy,ITA,11,0,32,0,43
2003,Eritrea,ERI,Italy,ITA,83,0,289,0,372
2003,Ethiopia,ETH,Italy,ITA,62,0,55,0,117
2003,Palestinian,PSE,Italy,ITA,5,0,118,0,123
2003,Georgia,GEO,Italy,ITA,5,0,23,0,28
2003,Ghana,GHA,Italy,ITA,5,0,145,0,150
2003,Cote d'Ivoire,CIV,Italy,ITA,5,0,44,0,49
2003,India,IND,Italy,ITA,0,0,63,0,63
2003,Iran (Islamic Rep. of),IRN,Italy,ITA,19,0,26,0,45
2003,Iraq,IRQ,Italy,ITA,22,0,1417,0,1439
2003,Liberia,LBR,Italy,ITA,23,0,564,0,587
2003,Sri Lanka,LKA,Italy,ITA,5,0,831,0,836
2003,North Macedonia,MKD,Italy,ITA,0,0,138,0,138
2003,Rep. of Moldova,MDA,Italy,ITA,0,0,55,0,55
2003,Nigeria,NGA,Italy,ITA,18,0,414,0,432
2003,Pakistan,PAK,Italy,ITA,0,0,599,0,599
2003,Romania,ROU,Italy,ITA,0,0,314,0,314
2003,Russian Federation,RUS,Italy,ITA,10,0,53,0,63
2003,Serbia and Kosovo: S/RES/1244 (1999),SRB,Italy,ITA,26,0,1133,5,1164
2003,Sierra Leone,SLE,Italy,ITA,18,0,260,0,278
2003,Somalia,SOM,Italy,ITA,23,0,514,0,537
2003,Sudan,SDN,Italy,ITA,44,0,450,0,494
2003,Togo,TGO,Italy,ITA,68,0,50,0,118
2003,Turkey,TUR,Italy,ITA,80,0,1942,0,2022
2003,Ukraine,UKR,Italy,ITA,5,0,31,0,36
2003,Unknown ,,Italy,ITA,51,2181,328,5,2565
2004,Congo,COG,Angola,AGO,10,0,5,0,15
2004,Dem. Rep. of the Congo,COD,Angola,AGO,20,0,22,0,42
2004,Cote d'Ivoire,CIV,Angola,AGO,19,0,12,0,31
2004,Liberia,LBR,Angola,AGO,22,0,30,0,52
2004,Rwanda,RWA,Angola,AGO,28,0,5,0,33
2004,Sierra Leone,SLE,Angola,AGO,11,0,15,0,26
2004,Afghanistan,AFG,Austria,AUT,744,158,110,5397,6409
2004,Albania,ALB,Austria,AUT,16,5,19,18,58
2004,Algeria,DZA,Austria,AUT,0,0,60,135,195
2004,Angola,AGO,Austria,AUT,21,5,10,13,49
2004,Egypt,EGY,Austria,AUT,5,0,0,10,15
2004,Armenia,ARM,Austria,AUT,35,12,80,182,309
2004,Azerbaijan,AZE,Austria,AUT,23,5,13,30,71
2004,Burundi,BDI,Austria,AUT,0,5,5,5,15
2004,Benin,BEN,Austria,AUT,0,0,5,0,5
2004,Bangladesh,BGD,Austria,AUT,0,0,97,301,398
2004,Belarus,BLR,Austria,AUT,5,0,19,72,96
2004,Bosnia and Herzegovina,BIH,Austria,AUT,10,5,56,82,153
2004,Bulgaria,BGR,Austria,AUT,0,0,5,11,16
2004,Canada,CAN,Austria,AUT,0,0,0,5,5
2004,China,CHN,Austria,AUT,5,0,87,353,445
2004,Cameroon,CMR,Austria,AUT,10,0,15,20,45
2004,Congo,COG,Austria,AUT,5,0,5,5,15
2004,Dem. Rep. of the Congo,COD,Austria,AUT,46,5,15,23,89
2004,Colombia,COL,Austria,AUT,0,0,5,0,5
2004,Cuba,CUB,Austria,AUT,0,0,0,5,5
2004,Czechia,CZE,Austria,AUT,0,0,0,5,5
2004,Eritrea,ERI,Austria,AUT,5,0,0,0,5
2004,Estonia,EST,Austria,AUT,0,0,5,0,5
2004,Ethiopia,ETH,Austria,AUT,11,5,0,10,26
2004,Gambia,GMB,Austria,AUT,5,0,65,57,127
2004,Georgia,GEO,Austria,AUT,53,18,398,750,1219
2004,Germany,DEU,Austria,AUT,0,0,0,5,5
2004,Ghana,GHA,Austria,AUT,0,0,42,29,71
2004,Guinea-Bissau,GNB,Austria,AUT,0,0,23,29,52
2004,Guinea,GIN,Austria,AUT,5,0,14,47,66
2004,Croatia,HRV,Austria,AUT,5,0,5,5,15
2004,Cote d'Ivoire,CIV,Austria,AUT,5,0,5,10,20
2004,India,IND,Austria,AUT,0,0,491,1243,1734
2004,Iran (Islamic Rep. of),IRN,Austria,AUT,414,10,114,304,842
2004,Iraq,IRQ,Austria,AUT,128,251,80,244,703
2004,Israel,ISR,Austria,AUT,0,0,5,32,37
2004,Jordan,JOR,Austria,AUT,0,0,5,5,10
2004,Kazakhstan,KAZ,Austria,AUT,5,0,10,5,20
2004,Kyrgyzstan,KGZ,Austria,AUT,5,0,5,16,26
2004,Liberia,LBR,Austria,AUT,0,5,49,40,94
2004,Libya,LBY,Austria,AUT,0,0,0,5,5
2004,Lebanon,LBN,Austria,AUT,0,0,5,34,39
2004,Sri Lanka,LKA,Austria,AUT,0,0,12,73,85
2004,Lithuania,LTU,Austria,AUT,0,0,5,5,10
2004,Latvia,LVA,Austria,AUT,0,0,0,5,5
2004,Mauritania,MRT,Austria,AUT,0,0,5,5,10
2004,North Macedonia,MKD,Austria,AUT,5,11,210,133,359
2004,Rep. of Moldova,MDA,Austria,AUT,10,5,224,1074,1313
2004,Mali,MLI,Austria,AUT,0,0,10,10,20
2004,Mongolia,MNG,Austria,AUT,5,0,51,133,189
2004,Morocco,MAR,Austria,AUT,0,0,11,18,29
2004,Nepal,NPL,Austria,AUT,0,0,5,21,26
2004,Niger,NER,Austria,AUT,0,0,0,5,5
2004,Nigeria,NGA,Austria,AUT,5,5,452,541,1003
2004,Pakistan,PAK,Austria,AUT,5,0,120,425,550
2004,Philippines,PHL,Austria,AUT,0,0,0,5,5
2004,Poland,POL,Austria,AUT,0,0,5,5,10
2004,Romania,ROU,Austria,AUT,5,0,37,84,126
2004,Russian Federation,RUS,Austria,AUT,2905,348,193,848,4294
2004,Rwanda,RWA,Austria,AUT,5,0,0,5,10
2004,Serbia and Kosovo: S/RES/1244 (1999),SRB,Austria,AUT,419,60,919,859,2257
2004,Senegal,SEN,Austria,AUT,0,0,5,13,18
2004,Sierra Leone,SLE,Austria,AUT,5,0,23,49,77
2004,Somalia,SOM,Austria,AUT,12,10,5,27,54
2004,Viet Nam,VNM,Austria,AUT,0,0,13,17,30
2004,Sudan,SDN,Austria,AUT,21,0,19,35,75
2004,Slovakia,SVK,Austria,AUT,0,0,0,5,5
2004,Syrian Arab Rep.,SYR,Austria,AUT,21,0,14,54,89
2004,United Rep. of Tanzania,TZA,Austria,AUT,0,0,5,0,5
2004,Tajikistan,TJK,Austria,AUT,0,0,0,10,10
2004,Turkmenistan,TKM,Austria,AUT,0,0,0,5,5
2004,Tunisia,TUN,Austria,AUT,0,0,5,12,17
2004,Turkey,TUR,Austria,AUT,94,24,643,800,1561
2004,Uganda,UGA,Austria,AUT,0,0,0,10,10
2004,Ukraine,UKR,Austria,AUT,18,10,76,139,243
2004,Uzbekistan,UZB,Austria,AUT,11,0,5,19,35
2004,Yemen,YEM,Austria,AUT,0,0,0,5,5
2004,Zimbabwe,ZWE,Austria,AUT,0,0,5,5,10
2004,Stateless,XXA,Austria,AUT,10,5,27,142,184
2004,Unknown ,,Austria,AUT,83,5,96,180,364
2004,Colombia,COL,Costa Rica,CRI,712,0,572,0,1284
2004,Cuba,CUB,Costa Rica,CRI,65,0,0,0,65
2004,Nicaragua,NIC,Costa Rica,CRI,37,0,0,0,37
2004,Venezuela (Bolivarian Republic of),VEN,Costa Rica,CRI,13,0,0,0,13
2004,Unknown ,,Costa Rica,CRI,11,0,0,0,11
2004,Burundi,BDI,Ethiopia,ETH,5,0,0,0,5
2004,Dem. Rep. of the Congo,COD,Ethiopia,ETH,5,0,0,0,5
2004,Eritrea,ERI,Ethiopia,ETH,2187,0,0,0,2187
2004,Somalia,SOM,Ethiopia,ETH,5,0,0,0,5
2004,Sudan,SDN,Ethiopia,ETH,39,0,0,0,39
2004,Afghanistan,AFG,Finland,FIN,0,31,0,5,36
2004,Albania,ALB,Finland,FIN,0,5,12,5,22
2004,Algeria,DZA,Finland,FIN,0,0,18,13,31
2004,Angola,AGO,Finland,FIN,0,48,10,5,63
2004,Armenia,ARM,Finland,FIN,0,5,5,17,27
2004,Azerbaijan,AZE,Finland,FIN,5,15,5,10,35
2004,Bangladesh,BGD,Finland,FIN,0,5,19,5,29
2004,Belarus,BLR,Finland,FIN,0,0,11,13,24
2004,Bosnia and Herzegovina,BIH,Finland,FIN,0,19,12,5,36
2004,Bulgaria,BGR,Finland,FIN,0,0,0,10,10
2004,China,CHN,Finland,FIN,0,14,5,26,45
2004,Cameroon,CMR,Finland,FIN,0,10,5,0,15
2004,Congo,COG,Finland,FIN,0,5,0,0,5
2004,Dem. Rep. of the Congo,COD,Finland,FIN,0,29,46,5,80
2004,Cuba,CUB,Finland,FIN,0,0,5,0,5
2004,Ecuador,ECU,Finland,FIN,0,0,0,5,5
2004,Ethiopia,ETH,Finland,FIN,0,5,10,0,15
2004,Georgia,GEO,Finland,FIN,0,0,5,16,21
2004,Ghana,GHA,Finland,FIN,0,0,5,0,5
2004,Croatia,HRV,Finland,FIN,0,0,0,5,5
2004,Hungary,HUN,Finland,FIN,0,0,0,5,5
2004,India,IND,Finland,FIN,0,0,5,0,5
2004,Iran (Islamic Rep. of),IRN,Finland,FIN,0,37,60,10,107
2004,Iraq,IRQ,Finland,FIN,0,207,0,17,224
2004,Kazakhstan,KAZ,Finland,FIN,0,0,5,5,10
2004,Liberia,LBR,Finland,FIN,0,5,5,0,10
2004,Libya,LBY,Finland,FIN,0,0,5,5,10
2004,Sri Lanka,LKA,Finland,FIN,0,5,5,0,10
2004,North Macedonia,MKD,Finland,FIN,0,0,32,55,87
2004,Rep. of Moldova,MDA,Finland,FIN,0,5,0,29,34
2004,Nigeria,NGA,Finland,FIN,0,13,66,5,84
2004,Romania,ROU,Finland,FIN,0,0,0,26,26
2004,Russian Federation,RUS,Finland,FIN,10,51,23,41,125
2004,Rwanda,RWA,Finland,FIN,0,0,5,0,5
2004,Serbia and Kosovo: S/RES/1244 (1999),SRB,Finland,FIN,0,79,138,153,370
2004,Senegal,SEN,Finland,FIN,0,0,5,0,5
2004,Sierra Leone,SLE,Finland,FIN,0,11,5,0,16
2004,Somalia,SOM,Finland,FIN,0,85,0,0,85
2004,Slovakia,SVK,Finland,FIN,0,0,5,11,16
2004,Syrian Arab Rep.,SYR,Finland,FIN,0,10,14,0,24
2004,Tajikistan,TJK,Finland,FIN,5,0,0,0,5
2004,Togo,TGO,Finland,FIN,0,0,5,0,5
2004,Turkey,TUR,Finland,FIN,0,35,115,10,160
2004,Ukraine,UKR,Finland,FIN,0,0,13,0,13
2004,Uzbekistan,UZB,Finland,FIN,0,0,5,0,5
2004,Stateless,XXA,Finland,FIN,0,5,18,0,23
2004,Unknown ,,Finland,FIN,0,5,10,5,20
2004,Burkina Faso,BFA,Ghana,GHA,0,0,0,5,5
2004,Dem. Rep. of the Congo,COD,Ghana,GHA,0,0,14,0,14
2004,Cote d'Ivoire,CIV,Ghana,GHA,10,0,0,97,107
2004,Mali,MLI,Ghana,GHA,0,0,0,5,5
2004,Rwanda,RWA,Ghana,GHA,5,0,5,0,10
2004,Seychelles,SYC,Ghana,GHA,0,0,5,0,5
2004,Sudan,SDN,Ghana,GHA,10,0,0,0,10
2004,Togo,TGO,Ghana,GHA,0,0,0,22,22
2004,Afghanistan,AFG,Italy,ITA,14,50,38,0,102
2004,Albania,ALB,Italy,ITA,10,5,27,5,47
2004,Algeria,DZA,Italy,ITA,0,0,11,0,11
2004,Angola,AGO,Italy,ITA,10,10,22,0,42
2004,Egypt,EGY,Italy,ITA,0,0,5,0,5
2004,Armenia,ARM,Italy,ITA,0,0,5,0,5
2004,Azerbaijan,AZE,Italy,ITA,0,0,5,0,5
2004,Benin,BEN,Italy,ITA,0,0,5,0,5
2004,Bangladesh,BGD,Italy,ITA,0,5,84,0,89
2004,Burkina Faso,BFA,Italy,ITA,5,0,5,0,10
2004,Bosnia and Herzegovina,BIH,Italy,ITA,0,0,10,0,10
2004,Bulgaria,BGR,Italy,ITA,0,0,5,0,5
2004,Chad,TCD,Italy,ITA,5,5,18,0,28
2004,China,CHN,Italy,ITA,5,0,18,0,23
2004,Cameroon,CMR,Italy,ITA,28,12,37,0,77
2004,Congo,COG,Italy,ITA,46,30,78,0,154
2004,Dem. Rep. of the Congo,COD,Italy,ITA,25,19,29,0,73
2004,Colombia,COL,Italy,ITA,5,0,12,0,17
2004,Cuba,CUB,Italy,ITA,5,0,5,0,10
2004,Ecuador,ECU,Italy,ITA,0,0,5,0,5
2004,Eritrea,ERI,Italy,ITA,190,418,250,0,858
2004,Ethiopia,ETH,Italy,ITA,73,81,77,0,231
2004,Gambia,GMB,Italy,ITA,0,0,20,0,20
2004,Palestinian,PSE,Italy,ITA,5,5,128,0,138
2004,Georgia,GEO,Italy,ITA,0,0,32,0,32
2004,Ghana,GHA,Italy,ITA,0,55,115,0,170
2004,Guinea-Bissau,GNB,Italy,ITA,0,0,5,0,5
2004,Guinea,GIN,Italy,ITA,5,0,0,0,5
2004,Cote d'Ivoire,CIV,Italy,ITA,11,88,80,0,179
2004,India,IND,Italy,ITA,0,0,14,0,14
2004,Iran (Islamic Rep. of),IRN,Italy,ITA,31,5,32,0,68
2004,Iraq,IRQ,Italy,ITA,21,62,388,0,471
2004,Liberia,LBR,Italy,ITA,23,631,774,0,1428
2004,Lebanon,LBN,Italy,ITA,0,0,5,0,5
2004,Sri Lanka,LKA,Italy,ITA,0,5,141,14,160
2004,Mauritania,MRT,Italy,ITA,5,0,15,0,20
2004,North Macedonia,MKD,Italy,ITA,5,5,60,0,70
2004,Rep. of Moldova,MDA,Italy,ITA,5,0,46,0,51
2004,Mali,MLI,Italy,ITA,0,0,15,0,15
2004,Morocco,MAR,Italy,ITA,0,0,11,0,11
2004,Niger,NER,Italy,ITA,0,0,15,0,15
2004,Nigeria,NGA,Italy,ITA,14,29,573,0,616
2004,Pakistan,PAK,Italy,ITA,0,5,227,0,232
2004,Peru,PER,Italy,ITA,0,0,5,0,5
2004,Romania,ROU,Italy,ITA,5,10,505,0,520
2004,Russian Federation,RUS,Italy,ITA,5,0,41,0,46
2004,Rwanda,RWA,Italy,ITA,5,0,0,0,5
2004,Serbia and Kosovo: S/RES/1244 (1999),SRB,Italy,ITA,27,64,597,5,693
2004,Senegal,SEN,Italy,ITA,0,0,12,0,12
2004,Sierra Leone,SLE,Italy,ITA,12,29,202,0,243
2004,Somalia,SOM,Italy,ITA,52,454,134,0,640
2004,Sudan,SDN,Italy,ITA,38,180,424,0,642
2004,Slovakia,SVK,Italy,ITA,0,0,0,5,5
2004,Syrian Arab Rep.,SYR,Italy,ITA,10,0,0,0,10
2004,Togo,TGO,Italy,ITA,48,44,72,0,164
2004,Tunisia,TUN,Italy,ITA,0,0,5,0,5
2004,Turkey,TUR,Italy,ITA,18,16,293,5,332
2004,Uganda,UGA,Italy,ITA,0,5,5,0,10
2004,Ukraine,UKR,Italy,ITA,5,0,21,0,26
2004,Zimbabwe,ZWE,Italy,ITA,0,0,5,0,5
2004,Bangladesh,BGD,Rep. of Korea,KOR,12,0,0,0,12
2004,Egypt,EGY,Latvia,LVA,0,0,5,0,5
2004,Burundi,BDI,Mozambique,MOZ,83,0,0,0,83
2004,Congo,COG,Mozambique,MOZ,0,0,0,5,5
2004,Dem. Rep. of the Congo,COD,Mozambique,MOZ,174,0,0,0,174
2004,Ethiopia,ETH,Mozambique,MOZ,5,0,0,0,5
2004,Liberia,LBR,Mozambique,MOZ,0,0,0,15,15
2004,Rwanda,RWA,Mozambique,MOZ,36,0,0,0,36
2004,Somalia,SOM,Mozambique,MOZ,10,0,0,0,10
2004,Uganda,UGA,Mozambique,MOZ,0,0,0,23,23
2004,Unknown ,,Mozambique,MOZ,0,0,0,57,57
2004,Burundi,BDI,Namibia,NAM,0,0,0,10,10
2004,Dem. Rep. of the Congo,COD,Namibia,NAM,27,0,0,33,60
2004,Rwanda,RWA,Namibia,NAM,0,0,0,114,114
2004,Colombia,COL,Nicaragua,NIC,10,0,0,5,15
2004,Cuba,CUB,Nicaragua,NIC,5,0,0,0,5
2004,Egypt,EGY,Romania,ROU,0,5,0,0,5
2004,Bangladesh,BGD,Romania,ROU,0,0,14,0,14
2004,China,CHN,Romania,ROU,0,0,86,25,111
2004,Cameroon,CMR,Romania,ROU,0,0,5,0,5
2004,Congo,COG,Romania,ROU,5,5,5,0,15
2004,Dem. Rep. of the Congo,COD,Romania,ROU,0,0,5,0,5
2004,Ethiopia,ETH,Romania,ROU,5,0,5,0,10
2004,Palestinian,PSE,Romania,ROU,5,0,5,0,10
2004,Georgia,GEO,Romania,ROU,0,0,13,0,13
2004,India,IND,Romania,ROU,0,0,65,0,65
2004,Iran (Islamic Rep. of),IRN,Romania,ROU,10,5,16,0,31
2004,Iraq,IRQ,Romania,ROU,30,22,37,14,103
2004,Jordan,JOR,Romania,ROU,0,0,5,0,5
2004,Liberia,LBR,Romania,ROU,0,0,5,0,5
2004,Lebanon,LBN,Romania,ROU,0,0,5,0,5
2004,Rep. of Moldova,MDA,Romania,ROU,0,0,5,0,5
2004,Nigeria,NGA,Romania,ROU,0,0,5,0,5
2004,Pakistan,PAK,Romania,ROU,0,0,15,0,15
2004,Russian Federation,RUS,Romania,ROU,0,0,5,0,5
2004,Serbia and Kosovo: S/RES/1244 (1999),SRB,Romania,ROU,5,0,0,10,15
2004,Somalia,SOM,Romania,ROU,26,0,5,0,31
2004,Sudan,SDN,Romania,ROU,0,0,10,0,10
2004,Syrian Arab Rep.,SYR,Romania,ROU,0,5,16,0,21
2004,Turkey,TUR,Romania,ROU,10,0,30,5,45
2004,Eritrea,ERI,Sudan,SDN,6430,0,266,0,6696
2004,Ethiopia,ETH,Sudan,SDN,28,0,38,0,66
2004,Unknown ,,Sudan,SDN,1270,0,0,0,1270
2005,Dem. Rep. of the Congo,COD,Angola,AGO,13,0,0,0,13
2005,Guinea,GIN,Angola,AGO,0,0,5,0,5
2005,Cote d'Ivoire,CIV,Angola,AGO,32,0,19,0,51
2005,Liberia,LBR,Angola,AGO,11,0,10,0,21
2005,Malawi,MWI,Angola,AGO,0,0,5,0,5
2005,Sierra Leone,SLE,Angola,AGO,10,0,5,0,15
2005,Somalia,SOM,Angola,AGO,5,0,0,0,5
2005,Afghanistan,AFG,Austria,AUT,517,164,139,204,1024
2005,Albania,ALB,Austria,AUT,10,10,32,16,68
2005,Algeria,DZA,Austria,AUT,0,0,58,113,171
2005,Angola,AGO,Austria,AUT,12,10,10,10,42
2005,Egypt,EGY,Austria,AUT,5,0,10,11,26
2005,Armenia,ARM,Austria,AUT,39,36,98,85,258
2005,Azerbaijan,AZE,Austria,AUT,26,5,19,20,70
2005,Burundi,BDI,Austria,AUT,0,0,5,5,10
2005,Benin,BEN,Austria,AUT,0,0,0,5,5
2005,Bangladesh,BGD,Austria,AUT,0,0,112,455,567
2005,Belarus,BLR,Austria,AUT,10,0,64,170,244
2005,Bosnia and Herzegovina,BIH,Austria,AUT,34,12,77,35,158
2005,Bulgaria,BGR,Austria,AUT,0,5,14,22,41
2005,China,CHN,Austria,AUT,11,0,126,245,382
2005,Cameroon,CMR,Austria,AUT,24,0,16,18,58
2005,Congo,COG,Austria,AUT,10,0,0,0,10
2005,Dem. Rep. of the Congo,COD,Austria,AUT,69,0,17,10,96
2005,Colombia,COL,Austria,AUT,5,0,0,5,10
2005,Cuba,CUB,Austria,AUT,5,0,0,0,5
2005,Czechia,CZE,Austria,AUT,0,0,5,0,5
2005,Eritrea,ERI,Austria,AUT,10,0,0,0,10
2005,Ethiopia,ETH,Austria,AUT,14,0,0,5,19
2005,Gambia,GMB,Austria,AUT,0,0,95,75,170
2005,Georgia,GEO,Austria,AUT,58,33,475,536,1102
2005,Ghana,GHA,Austria,AUT,0,0,43,18,61
2005,Guinea-Bissau,GNB,Austria,AUT,0,0,20,47,67
2005,Guinea,GIN,Austria,AUT,5,0,14,57,76
2005,Croatia,HRV,Austria,AUT,0,0,5,5,10
2005,Hungary,HUN,Austria,AUT,0,0,0,5,5
2005,Cote d'Ivoire,CIV,Austria,AUT,0,0,10,16,26
2005,India,IND,Austria,AUT,0,0,353,975,1328
2005,Iran (Islamic Rep. of),IRN,Austria,AUT,247,19,40,302,608
2005,Iraq,IRQ,Austria,AUT,130,56,49,163,398
2005,Israel,ISR,Austria,AUT,0,0,5,21,26
2005,Jordan,JOR,Austria,AUT,0,0,5,5,10
2005,Kazakhstan,KAZ,Austria,AUT,5,0,5,5,15
2005,Kenya,KEN,Austria,AUT,0,0,5,0,5
2005,Kyrgyzstan,KGZ,Austria,AUT,27,5,5,29,66
2005,Liberia,LBR,Austria,AUT,0,0,33,17,50
2005,Libya,LBY,Austria,AUT,0,0,0,5,5
2005,Lebanon,LBN,Austria,AUT,0,0,18,30,48
2005,Sri Lanka,LKA,Austria,AUT,0,0,5,44,49
2005,Lithuania,LTU,Austria,AUT,0,0,11,5,16
2005,Mauritania,MRT,Austria,AUT,0,0,0,5,5
2005,North Macedonia,MKD,Austria,AUT,10,10,166,113,299
2005,Rep. of Moldova,MDA,Austria,AUT,5,11,214,1097,1327
2005,Mali,MLI,Austria,AUT,0,0,12,10,22
2005,Mongolia,MNG,Austria,AUT,5,10,53,278,346
2005,Morocco,MAR,Austria,AUT,0,0,12,10,22
2005,Nepal,NPL,Austria,AUT,0,0,12,20,32
2005,Nigeria,NGA,Austria,AUT,5,10,631,483,1129
2005,Pakistan,PAK,Austria,AUT,10,0,96,367,473
2005,Poland,POL,Austria,AUT,0,0,5,10,15
2005,Romania,ROU,Austria,AUT,12,0,38,58,108
2005,Russian Federation,RUS,Austria,AUT,2427,216,251,597,3491
2005,Rwanda,RWA,Austria,AUT,5,0,0,5,10
2005,Serbia and Kosovo: S/RES/1244 (1999),SRB,Austria,AUT,462,91,1013,829,2395
2005,Senegal,SEN,Austria,AUT,0,0,10,17,27
2005,Sierra Leone,SLE,Austria,AUT,5,0,15,47,67
2005,Somalia,SOM,Austria,AUT,58,5,5,11,79
2005,Viet Nam,VNM,Austria,AUT,5,0,12,5,22
2005,Sudan,SDN,Austria,AUT,29,0,21,35,85
2005,Slovakia,SVK,Austria,AUT,0,0,5,0,5
2005,Syrian Arab Rep.,SYR,Austria,AUT,53,5,15,25,98
2005,Tajikistan,TJK,Austria,AUT,5,0,0,20,25
2005,Togo,TGO,Austria,AUT,10,0,10,5,25
2005,Tunisia,TUN,Austria,AUT,0,0,0,10,10
2005,Turkey,TUR,Austria,AUT,70,14,592,373,1049
2005,Uganda,UGA,Austria,AUT,5,0,5,0,10
2005,Ukraine,UKR,Austria,AUT,32,13,138,152,335
2005,Uzbekistan,UZB,Austria,AUT,5,5,0,5,15
2005,Zimbabwe,ZWE,Austria,AUT,0,0,5,5,10
2005,Stateless,XXA,Austria,AUT,32,24,52,203,311
2005,Unknown ,,Austria,AUT,128,0,94,146,368
2005,Angola,AGO,Brazil,BRA,11,0,35,88,134
2005,Argentina,ARG,Brazil,BRA,0,0,5,0,5
2005,Burundi,BDI,Brazil,BRA,10,0,5,15,30
2005,Bolivia (Plurinational State of),BOL,Brazil,BRA,0,0,5,0,5
2005,Cameroon,CMR,Brazil,BRA,0,0,0,5,5
2005,Dem. Rep. of the Congo,COD,Brazil,BRA,23,0,37,38,98
2005,Colombia,COL,Brazil,BRA,73,0,24,5,102
2005,Cuba,CUB,Brazil,BRA,0,0,29,32,61
2005,Ethiopia,ETH,Brazil,BRA,5,0,0,0,5
2005,Guinea-Bissau,GNB,Brazil,BRA,0,0,10,30,40
2005,Cote d'Ivoire,CIV,Brazil,BRA,5,0,0,5,10
2005,India,IND,Brazil,BRA,0,0,5,10,15
2005,Iran (Islamic Rep. of),IRN,Brazil,BRA,0,0,5,5,10
2005,Iraq,IRQ,Brazil,BRA,12,0,5,5,22
2005,Kenya,KEN,Brazil,BRA,0,0,0,5,5
2005,Liberia,LBR,Brazil,BRA,0,0,5,25,30
2005,Nigeria,NGA,Brazil,BRA,0,0,10,24,34
2005,Peru,PER,Brazil,BRA,0,0,30,36,66
2005,Romania,ROU,Brazil,BRA,0,0,5,21,26
2005,Rwanda,RWA,Brazil,BRA,0,0,0,5,5
2005,Senegal,SEN,Brazil,BRA,0,0,0,5,5
2005,Sierra Leone,SLE,Brazil,BRA,0,0,0,10,10
2005,Somalia,SOM,Brazil,BRA,0,0,0,5,5
2005,Sudan,SDN,Brazil,BRA,5,0,0,5,10
2005,United Rep. of Tanzania,TZA,Brazil,BRA,0,0,0,14,14
2005,Tunisia,TUN,Brazil,BRA,0,0,0,5,5
2005,Unknown ,,Brazil,BRA,0,0,0,10,10
2005,Bangladesh,BGD,Bosnia and Herzegovina,BIH,0,0,0,10,10
2005,North Macedonia,MKD,Bosnia and Herzegovina,BIH,0,0,0,15,15
2005,Pakistan,PAK,Bosnia and Herzegovina,BIH,0,0,0,5,5
2005,Serbia and Kosovo: S/RES/1244 (1999),SRB,Bosnia and Herzegovina,BIH,0,0,16,20,36
2005,Ukraine,UKR,Bosnia and Herzegovina,BIH,0,0,5,0,5
2005,Congo,COG,Chad,TCD,0,0,5,0,5
2005,Dem. Rep. of the Congo,COD,Chad,TCD,0,19,18,0,37
2005,Eritrea,ERI,Chad,TCD,0,5,0,0,5
2005,Ethiopia,ETH,Chad,TCD,0,5,0,0,5
2005,Rwanda,RWA,Chad,TCD,0,5,5,0,10
2005,Sudan,SDN,Chad,TCD,0,12,0,0,12
2005,Togo,TGO,Chad,TCD,0,5,5,0,10
2005,Azerbaijan,AZE,Estonia,EST,0,0,5,0,5
2005,Iraq,IRQ,Estonia,EST,0,0,5,0,5
2005,Russian Federation,RUS,Estonia,EST,0,0,5,0,5
2005,Uzbekistan,UZB,Estonia,EST,0,0,5,0,5
2005,Dem. Rep. of the Congo,COD,Ethiopia,ETH,60,0,0,0,60
2005,Eritrea,ERI,Ethiopia,ETH,2966,0,0,0,2966
2005,Afghanistan,AFG,Finland,FIN,0,100,0,5,105
2005,Albania,ALB,Finland,FIN,0,0,0,10,10
2005,Algeria,DZA,Finland,FIN,0,0,0,13,13
2005,Angola,AGO,Finland,FIN,0,23,12,5,40
2005,Egypt,EGY,Finland,FIN,0,0,0,11,11
2005,Armenia,ARM,Finland,FIN,0,0,5,11,16
2005,Azerbaijan,AZE,Finland,FIN,0,0,0,12,12
2005,Bangladesh,BGD,Finland,FIN,0,5,10,13,28
2005,Belarus,BLR,Finland,FIN,0,0,10,14,24
2005,Bosnia and Herzegovina,BIH,Finland,FIN,0,0,5,22,27
2005,Bulgaria,BGR,Finland,FIN,0,0,0,480,480
2005,China,CHN,Finland,FIN,0,5,0,5,10
2005,Cameroon,CMR,Finland,FIN,0,10,10,0,20
2005,Dem. Rep. of the Congo,COD,Finland,FIN,0,16,5,0,21
2005,Czechia,CZE,Finland,FIN,0,0,0,5,5
2005,Ethiopia,ETH,Finland,FIN,0,0,10,0,10
2005,Georgia,GEO,Finland,FIN,0,0,0,19,19
2005,Ghana,GHA,Finland,FIN,0,0,0,5,5
2005,Croatia,HRV,Finland,FIN,0,0,5,0,5
2005,India,IND,Finland,FIN,0,0,0,5,5
2005,Iran (Islamic Rep. of),IRN,Finland,FIN,0,16,35,15,66
2005,Iraq,IRQ,Finland,FIN,0,95,0,17,112
2005,Kazakhstan,KAZ,Finland,FIN,0,0,5,0,5
2005,Kyrgyzstan,KGZ,Finland,FIN,0,5,0,5,10
2005,Libya,LBY,Finland,FIN,0,0,0,5,5
2005,Sri Lanka,LKA,Finland,FIN,0,0,5,0,5
2005,Latvia,LVA,Finland,FIN,0,5,0,5,10
2005,North Macedonia,MKD,Finland,FIN,0,0,5,47,52
2005,Rep. of Moldova,MDA,Finland,FIN,0,0,0,23,23
2005,Nigeria,NGA,Finland,FIN,0,5,31,21,57
2005,Romania,ROU,Finland,FIN,0,0,5,57,62
2005,Russian Federation,RUS,Finland,FIN,5,36,17,107,165
2005,Serbia and Kosovo: S/RES/1244 (1999),SRB,Finland,FIN,0,48,31,141,220
2005,Somalia,SOM,Finland,FIN,5,154,0,5,164
2005,Viet Nam,VNM,Finland,FIN,0,0,0,5,5
2005,Slovakia,SVK,Finland,FIN,0,0,0,62,62
2005,Syrian Arab Rep.,SYR,Finland,FIN,0,0,0,10,10
2005,Turkey,TUR,Finland,FIN,0,31,20,51,102
2005,Ukraine,UKR,Finland,FIN,0,0,5,5,10
2005,Stateless,XXA,Finland,FIN,0,14,0,0,14
2005,Unknown ,,Finland,FIN,0,5,0,0,5
2005,Afghanistan,AFG,Italy,ITA,12,54,25,0,91
2005,Albania,ALB,Italy,ITA,0,10,20,0,30
2005,Azerbaijan,AZE,Italy,ITA,10,0,5,0,15
2005,Bangladesh,BGD,Italy,ITA,5,33,315,0,353
2005,Chad,TCD,Italy,ITA,0,5,5,0,10
2005,Cameroon,CMR,Italy,ITA,36,15,30,0,81
2005,Congo,COG,Italy,ITA,26,26,20,0,72
2005,Dem. Rep. of the Congo,COD,Italy,ITA,32,15,0,0,47
2005,Colombia,COL,Italy,ITA,11,19,23,0,53
2005,Cuba,CUB,Italy,ITA,5,5,5,0,15
2005,Eritrea,ERI,Italy,ITA,245,1675,45,0,1965
2005,Ethiopia,ETH,Italy,ITA,103,488,134,0,725
2005,Palestinian,PSE,Italy,ITA,5,15,129,0,149
2005,Ghana,GHA,Italy,ITA,0,31,433,0,464
2005,Cote d'Ivoire,CIV,Italy,ITA,23,430,277,0,730
2005,India,IND,Italy,ITA,0,5,77,0,82
2005,Iran (Islamic Rep. of),IRN,Italy,ITA,41,23,12,0,76
2005,Iraq,IRQ,Italy,ITA,22,49,71,0,142
2005,Liberia,LBR,Italy,ITA,18,111,649,0,778
2005,Sri Lanka,LKA,Italy,ITA,5,28,15,0,48
2005,North Macedonia,MKD,Italy,ITA,5,10,40,0,55
2005,Rep. of Moldova,MDA,Italy,ITA,5,11,42,0,58
2005,Mali,MLI,Italy,ITA,0,0,48,0,48
2005,Nigeria,NGA,Italy,ITA,31,72,517,0,620
2005,Pakistan,PAK,Italy,ITA,11,47,336,0,394
2005,Romania,ROU,Italy,ITA,0,17,193,0,210
2005,Russian Federation,RUS,Italy,ITA,5,10,30,0,45
2005,Serbia and Kosovo: S/RES/1244 (1999),SRB,Italy,ITA,38,142,803,0,983
2005,Senegal,SEN,Italy,ITA,0,0,10,0,10
2005,Sierra Leone,SLE,Italy,ITA,5,34,115,0,154
2005,Somalia,SOM,Italy,ITA,23,194,21,0,238
2005,Sudan,SDN,Italy,ITA,46,493,259,0,798
2005,Syrian Arab Rep.,SYR,Italy,ITA,10,5,0,0,15
2005,Togo,TGO,Italy,ITA,46,209,216,0,471
2005,Turkey,TUR,Italy,ITA,22,51,159,0,232
2005,Unknown ,,Italy,ITA,58,42,484,3596,4180
2005,Bangladesh,BGD,Rep. of Korea,KOR,0,0,5,0,5
2005,China,CHN,Rep. of Korea,KOR,0,0,48,5,53
2005,Dem. Rep. of the Congo,COD,Rep. of Korea,KOR,0,12,0,0,12
2005,Cote d'Ivoire,CIV,Rep. of Korea,KOR,0,0,0,5,5
2005,Liberia,LBR,Rep. of Korea,KOR,0,0,0,5,5
2005,Sri Lanka,LKA,Rep. of Korea,KOR,0,0,5,0,5
2005,Myanmar,MMR,Rep. of Korea,KOR,5,0,10,0,15
2005,Pakistan,PAK,Rep. of Korea,KOR,0,0,5,0,5
2005,Iraq,IRQ,Latvia,LVA,0,0,0,5,5
2005,Afghanistan,AFG,Rep. of Moldova,MDA,0,5,0,0,5
2005,Dem. Rep. of the Congo,COD,Rep. of Moldova,MDA,0,0,0,5,5
2005,Palestinian,PSE,Rep. of Moldova,MDA,10,0,0,11,21
2005,Georgia,GEO,Rep. of Moldova,MDA,0,0,0,5,5
2005,Iraq,IRQ,Rep. of Moldova,MDA,0,5,0,5,10
2005,Jordan,JOR,Rep. of Moldova,MDA,5,0,0,5,10
2005,Kyrgyzstan,KGZ,Rep. of Moldova,MDA,5,0,0,0,5
2005,Russian Federation,RUS,Rep. of Moldova,MDA,5,5,19,23,52
2005,Sudan,SDN,Rep. of Moldova,MDA,0,0,5,0,5
2005,Syrian Arab Rep.,SYR,Rep. of Moldova,MDA,5,0,0,0,5
2005,Colombia,COL,Panama,PAN,46,70,149,0,265
2005,Cuba,CUB,Panama,PAN,5,0,0,0,5
2005,Egypt,EGY,Papua New Guinea,PNG,5,0,0,0,5
2005,Indonesia,IDN,Papua New Guinea,PNG,0,186,0,0,186
2005,Russian Federation,RUS,Papua New Guinea,PNG,5,0,0,0,5
2005,Algeria,DZA,Romania,ROU,0,0,5,0,5
2005,Egypt,EGY,Romania,ROU,0,0,5,0,5
2005,Bangladesh,BGD,Romania,ROU,0,0,51,0,51
2005,China,CHN,Romania,ROU,0,0,39,10,49
2005,Congo,COG,Romania,ROU,5,0,5,0,10
2005,Palestinian,PSE,Romania,ROU,0,0,5,0,5
2005,Georgia,GEO,Romania,ROU,0,0,13,0,13
2005,Guinea,GIN,Romania,ROU,0,0,5,0,5
2005,Cote d'Ivoire,CIV,Romania,ROU,0,0,5,0,5
2005,India,IND,Romania,ROU,0,0,25,5,30
2005,Iran (Islamic Rep. of),IRN,Romania,ROU,0,0,18,5,23
2005,Iraq,IRQ,Romania,ROU,26,5,40,5,76
2005,Jordan,JOR,Romania,ROU,0,0,10,0,10
2005,Liberia,LBR,Romania,ROU,0,0,23,0,23
2005,Lebanon,LBN,Romania,ROU,0,0,5,0,5
2005,Rep. of Moldova,MDA,Romania,ROU,0,0,5,0,5
2005,Nigeria,NGA,Romania,ROU,0,0,19,0,19
2005,Pakistan,PAK,Romania,ROU,0,0,35,5,40
2005,Somalia,SOM,Romania,ROU,10,0,11,0,21
2005,Sudan,SDN,Romania,ROU,5,0,5,0,10
2005,Syrian Arab Rep.,SYR,Romania,ROU,0,0,31,5,36
2005,Turkey,TUR,Romania,ROU,5,0,29,10,44
2005,Ukraine,UKR,Romania,ROU,0,0,5,0,5
2005,Uzbekistan,UZB,Romania,ROU,5,0,0,0,5
2005,Afghanistan,AFG,Spain,ESP,0,0,5,5,10
2005,Albania,ALB,Spain,ESP,13,0,0,0,13
2005,Algeria,DZA,Spain,ESP,0,0,85,488,573
2005,Angola,AGO,Spain,ESP,0,0,17,5,22
2005,Egypt,EGY,Spain,ESP,0,5,0,5,10
2005,Argentina,ARG,Spain,ESP,0,0,0,5,5
2005,Armenia,ARM,Spain,ESP,5,0,66,26,97
2005,Azerbaijan,AZE,Spain,ESP,0,0,0,5,5
2005,Benin,BEN,Spain,ESP,0,0,0,5,5
2005,Bangladesh,BGD,Spain,ESP,0,0,14,27,41
2005,Burkina Faso,BFA,Spain,ESP,0,0,0,5,5
2005,Belarus,BLR,Spain,ESP,0,0,20,5,25
2005,Bolivia (Plurinational State of),BOL,Spain,ESP,0,0,0,10,10
2005,Bosnia and Herzegovina,BIH,Spain,ESP,0,0,10,5,15
2005,Central African Rep.,CAF,Spain,ESP,0,0,0,5,5
2005,China,CHN,Spain,ESP,0,0,0,10,10
2005,Chile,CHL,Spain,ESP,0,0,0,5,5
2005,Cameroon,CMR,Spain,ESP,0,0,40,41,81
2005,Congo,COG,Spain,ESP,0,0,16,5,21
2005,Dem. Rep. of the Congo,COD,Spain,ESP,5,0,92,67,164
2005,Colombia,COL,Spain,ESP,98,27,596,512,1233
2005,Cuba,CUB,Spain,ESP,17,17,51,29,114
2005,Ecuador,ECU,Spain,ESP,0,0,0,5,5
2005,Equatorial Guinea,GNQ,Spain,ESP,18,0,21,5,44
2005,Ethiopia,ETH,Spain,ESP,5,0,22,0,27
2005,Gambia,GMB,Spain,ESP,0,0,23,53,76
2005,Georgia,GEO,Spain,ESP,5,0,27,10,42
2005,Ghana,GHA,Spain,ESP,0,0,5,31,36
2005,Guinea-Bissau,GNB,Spain,ESP,0,0,31,91,122
2005,Guatemala,GTM,Spain,ESP,0,0,5,0,5
2005,Guinea,GIN,Spain,ESP,0,0,27,158,185
2005,Haiti,HTI,Spain,ESP,0,0,0,5,5
2005,Cote d'Ivoire,CIV,Spain,ESP,0,11,25,13,49
2005,India,IND,Spain,ESP,0,0,5,16,21
2005,Iran (Islamic Rep. of),IRN,Spain,ESP,5,0,15,5,25
2005,Iraq,IRQ,Spain,ESP,5,10,0,5,20
2005,Kazakhstan,KAZ,Spain,ESP,0,0,10,0,10
2005,Kyrgyzstan,KGZ,Spain,ESP,0,0,5,0,5
2005,Liberia,LBR,Spain,ESP,0,5,14,43,62
2005,Sri Lanka,LKA,Spain,ESP,0,0,5,0,5
2005,Mauritania,MRT,Spain,ESP,5,0,13,13,31
2005,North Macedonia,MKD,Spain,ESP,0,0,5,10,15
2005,Mexico,MEX,Spain,ESP,0,0,5,0,5
2005,Mali,MLI,Spain,ESP,0,0,80,192,272
2005,Mongolia,MNG,Spain,ESP,0,0,0,18,18
2005,Morocco,MAR,Spain,ESP,5,0,16,35,56
2005,Mozambique,MOZ,Spain,ESP,0,0,0,5,5
2005,Niger,NER,Spain,ESP,0,0,0,12,12
2005,Nigeria,NGA,Spain,ESP,0,0,135,605,740
2005,Pakistan,PAK,Spain,ESP,0,0,0,11,11
2005,Peru,PER,Spain,ESP,0,0,5,5,10
2005,Romania,ROU,Spain,ESP,0,0,5,10,15
2005,Russian Federation,RUS,Spain,ESP,23,20,58,33,134
2005,Rwanda,RWA,Spain,ESP,0,0,5,0,5
2005,Serbia and Kosovo: S/RES/1244 (1999),SRB,Spain,ESP,5,5,30,19,59
2005,Senegal,SEN,Spain,ESP,0,0,0,11,11
2005,Sierra Leone,SLE,Spain,ESP,0,0,5,55,60
2005,Somalia,SOM,Spain,ESP,5,5,5,0,15
2005,Sudan,SDN,Spain,ESP,0,0,43,15,58
2005,Slovakia,SVK,Spain,ESP,0,0,5,0,5
2005,Syrian Arab Rep.,SYR,Spain,ESP,0,0,0,5,5
2005,Togo,TGO,Spain,ESP,0,0,5,0,5
2005,Turkey,TUR,Spain,ESP,0,0,11,10,21
2005,Uganda,UGA,Spain,ESP,0,0,0,5,5
2005,Ukraine,UKR,Spain,ESP,0,0,19,10,29
2005,Uzbekistan,UZB,Spain,ESP,0,0,0,5,5
2005,Venezuela (Bolivarian Republic of),VEN,Spain,ESP,0,0,10,10,20
2005,Stateless,XXA,Spain,ESP,5,5,11,17,38
2005,Eritrea,ERI,Sudan,SDN,5942,0,69,194,6205
2005,Ethiopia,ETH,Sudan,SDN,17,0,10,0,27
2005,Somalia,SOM,Sudan,SDN,0,0,5,5,10
2005,Afghanistan,AFG,Tajikistan,TJK,53,0,211,402,666
2005,Iran (Islamic Rep. of),IRN,Tajikistan,TJK,0,0,14,0,14
2006,China,CHN,Albania,ALB,5,0,0,0,5
2006,India,IND,Albania,ALB,0,0,0,5,5
2006,Serbia and Kosovo: S/RES/1244 (1999),SRB,Albania,ALB,0,5,0,0,5
2006,Chad,TCD,Angola,AGO,0,0,10,0,10
2006,Congo,COG,Angola,AGO,0,0,5,0,5
2006,Dem. Rep. of the Congo,COD,Angola,AGO,5,0,13,0,18
2006,Eritrea,ERI,Angola,AGO,5,0,0,0,5
2006,Ethiopia,ETH,Angola,AGO,0,0,5,0,5
2006,Guinea,GIN,Angola,AGO,5,0,12,0,17
2006,Cote d'Ivoire,CIV,Angola,AGO,61,0,65,0,126
2006,Liberia,LBR,Angola,AGO,35,0,13,0,48
2006,Mauritania,MRT,Angola,AGO,5,0,5,0,10
2006,Sierra Leone,SLE,Angola,AGO,13,5,40,0,58
2006,Somalia,SOM,Angola,AGO,0,0,5,0,5
2006,Sudan,SDN,Angola,AGO,5,0,10,0,15
2006,Afghanistan,AFG,Austria,AUT,475,212,128,145,960
2006,Albania,ALB,Austria,AUT,16,0,21,10,47
2006,Algeria,DZA,Austria,AUT,0,0,74,66,140
2006,Angola,AGO,Austria,AUT,17,0,5,5,27
2006,Egypt,EGY,Austria,AUT,0,0,23,24,47
2006,Armenia,ARM,Austria,AUT,100,35,125,91,351
2006,Azerbaijan,AZE,Austria,AUT,31,10,15,15,71
2006,Burundi,BDI,Austria,AUT,0,0,0,5,5
2006,Bangladesh,BGD,Austria,AUT,5,5,47,103,160
2006,Belarus,BLR,Austria,AUT,5,0,95,131,231
2006,Bosnia and Herzegovina,BIH,Austria,AUT,17,21,105,137,280
2006,Bulgaria,BGR,Austria,AUT,0,0,17,27,44
2006,China,CHN,Austria,AUT,25,0,126,189,340
2006,Cameroon,CMR,Austria,AUT,16,0,13,13,42
2006,Congo,COG,Austria,AUT,10,0,5,5,20
2006,Dem. Rep. of the Congo,COD,Austria,AUT,55,0,5,5,65
2006,Colombia,COL,Austria,AUT,10,0,0,0,10
2006,Eritrea,ERI,Austria,AUT,5,0,0,0,5
2006,Estonia,EST,Austria,AUT,0,0,5,0,5
2006,Ethiopia,ETH,Austria,AUT,16,0,0,0,16
2006,Gambia,GMB,Austria,AUT,5,0,42,31,78
2006,Georgia,GEO,Austria,AUT,38,27,504,311,880
2006,Ghana,GHA,Austria,AUT,5,0,28,14,47
2006,Guinea-Bissau,GNB,Austria,AUT,0,0,31,23,54
2006,Guinea,GIN,Austria,AUT,5,0,12,13,30
2006,Croatia,HRV,Austria,AUT,0,0,5,5,10
2006,Hungary,HUN,Austria,AUT,0,0,5,5,10
2006,Cote d'Ivoire,CIV,Austria,AUT,0,0,5,10,15
2006,India,IND,Austria,AUT,0,5,432,342,779
2006,Iran (Islamic Rep. of),IRN,Austria,AUT,211,15,62,80,368
2006,Iraq,IRQ,Austria,AUT,92,46,50,122,310
2006,Israel,ISR,Austria,AUT,0,0,0,10,10
2006,Jordan,JOR,Austria,AUT,0,0,5,0,5
2006,Kazakhstan,KAZ,Austria,AUT,0,0,5,5,10
2006,Kyrgyzstan,KGZ,Austria,AUT,25,5,21,16,67
2006,Liberia,LBR,Austria,AUT,5,0,30,16,51
2006,Libya,LBY,Austria,AUT,0,0,5,0,5
2006,Lebanon,LBN,Austria,AUT,0,0,12,19,31
2006,Sri Lanka,LKA,Austria,AUT,0,0,5,14,19
2006,Mauritania,MRT,Austria,AUT,0,0,0,5,5
2006,North Macedonia,MKD,Austria,AUT,10,11,157,106,284
2006,Rep. of Moldova,MDA,Austria,AUT,13,10,259,748,1030
2006,Mali,MLI,Austria,AUT,0,0,10,5,15
2006,Mongolia,MNG,Austria,AUT,0,10,159,208,377
2006,Morocco,MAR,Austria,AUT,5,0,16,17,38
2006,Nepal,NPL,Austria,AUT,10,0,14,12,36
2006,Nigeria,NGA,Austria,AUT,11,11,352,320,694
2006,Pakistan,PAK,Austria,AUT,5,5,90,105,205
2006,Philippines,PHL,Austria,AUT,0,0,0,5,5
2006,Poland,POL,Austria,AUT,0,0,5,0,5
2006,Romania,ROU,Austria,AUT,5,0,73,43,121
2006,South Africa,ZAF,Austria,AUT,0,0,5,0,5
2006,Russian Federation,RUS,Austria,AUT,2091,214,398,458,3161
2006,Rwanda,RWA,Austria,AUT,5,0,0,0,5
2006,Serbia and Kosovo: S/RES/1244 (1999),SRB,Austria,AUT,318,168,1530,869,2885
2006,Senegal,SEN,Austria,AUT,0,0,11,10,21
2006,Sierra Leone,SLE,Austria,AUT,0,0,23,16,39
2006,Somalia,SOM,Austria,AUT,103,18,10,31,162
2006,Viet Nam,VNM,Austria,AUT,5,0,10,5,20
2006,Sudan,SDN,Austria,AUT,26,0,21,11,58
2006,Slovakia,SVK,Austria,AUT,0,0,0,5,5
2006,Syrian Arab Rep.,SYR,Austria,AUT,47,0,20,22,89
2006,Togo,TGO,Austria,AUT,0,0,5,0,5
2006,Tunisia,TUN,Austria,AUT,0,0,5,10,15
2006,Turkey,TUR,Austria,AUT,113,30,380,307,830
2006,Uganda,UGA,Austria,AUT,5,0,0,10,15
2006,Ukraine,UKR,Austria,AUT,20,10,107,95,232
2006,Uzbekistan,UZB,Austria,AUT,13,5,5,10,33
2006,Stateless,XXA,Austria,AUT,41,18,80,78,217
2006,Unknown ,,Austria,AUT,16,0,24,19,59
2006,China,CHN,Bosnia and Herzegovina,BIH,0,0,0,5,5
2006,Palestinian,PSE,Bosnia and Herzegovina,BIH,5,0,0,0,5
2006,Iraq,IRQ,Bosnia and Herzegovina,BIH,0,0,0,5,5
2006,North Macedonia,MKD,Bosnia and Herzegovina,BIH,0,0,0,10,10
2006,Rep. of Moldova,MDA,Bosnia and Herzegovina,BIH,0,0,5,0,5
2006,Russian Federation,RUS,Bosnia and Herzegovina,BIH,0,0,0,5,5
2006,Serbia and Kosovo: S/RES/1244 (1999),SRB,Bosnia and Herzegovina,BIH,0,0,23,67,90
2006,Colombia,COL,Costa Rica,CRI,383,0,0,0,383
2006,Cuba,CUB,Costa Rica,CRI,22,0,0,0,22
2006,Venezuela (Bolivarian Republic of),VEN,Costa Rica,CRI,26,0,0,0,26
2006,Unknown ,,Costa Rica,CRI,12,0,0,0,12
2006,Angola,AGO,Gabon,GAB,0,0,0,31,31
2006,Central African Rep.,CAF,Gabon,GAB,0,0,5,0,5
2006,Chad,TCD,Gabon,GAB,0,0,39,291,330
2006,Cameroon,CMR,Gabon,GAB,0,0,5,5,10
2006,Congo,COG,Gabon,GAB,0,0,51,5,56
2006,Dem. Rep. of the Congo,COD,Gabon,GAB,0,0,72,524,596
2006,Equatorial Guinea,GNQ,Gabon,GAB,0,0,5,35,40
2006,Cote d'Ivoire,CIV,Gabon,GAB,0,0,14,0,14
2006,Liberia,LBR,Gabon,GAB,0,0,0,17,17
2006,Mauritania,MRT,Gabon,GAB,0,0,0,16,16
2006,Niger,NER,Gabon,GAB,0,0,0,10,10
2006,Nigeria,NGA,Gabon,GAB,0,0,5,0,5
2006,Rwanda,RWA,Gabon,GAB,0,0,5,5,10
2006,Sierra Leone,SLE,Gabon,GAB,0,0,0,12,12
2006,Togo,TGO,Gabon,GAB,0,0,5,0,5
2006,Iran (Islamic Rep. of),IRN,Georgia,GEO,0,0,11,0,11
2006,Russian Federation,RUS,Georgia,GEO,10,0,0,0,10
2006,Afghanistan,AFG,Greece,GRC,10,10,1009,121,1150
2006,Albania,ALB,Greece,GRC,0,0,10,14,24
2006,Algeria,DZA,Greece,GRC,0,0,27,10,37
2006,Egypt,EGY,Greece,GRC,0,0,20,11,31
2006,Armenia,ARM,Greece,GRC,0,0,16,18,34
2006,Azerbaijan,AZE,Greece,GRC,0,5,10,5,20
2006,Burundi,BDI,Greece,GRC,0,0,14,10,24
2006,Bangladesh,BGD,Greece,GRC,0,0,2790,375,3165
2006,Burkina Faso,BFA,Greece,GRC,0,0,22,0,22
2006,Belarus,BLR,Greece,GRC,0,0,0,17,17
2006,Bulgaria,BGR,Greece,GRC,0,0,10,29,39
2006,Chad,TCD,Greece,GRC,0,0,5,0,5
2006,China,CHN,Greece,GRC,0,0,26,159,185
2006,Cameroon,CMR,Greece,GRC,0,0,10,0,10
2006,Dem. Rep. of the Congo,COD,Greece,GRC,10,5,24,10,49
2006,Eritrea,ERI,Greece,GRC,0,0,18,26,44
2006,Ethiopia,ETH,Greece,GRC,0,0,142,64,206
2006,Gambia,GMB,Greece,GRC,0,0,5,0,5
2006,Georgia,GEO,Greece,GRC,0,0,221,354,575
2006,Ghana,GHA,Greece,GRC,0,0,79,15,94
2006,Guinea,GIN,Greece,GRC,0,0,30,0,30
2006,Cote d'Ivoire,CIV,Greece,GRC,0,5,71,5,81
2006,India,IND,Greece,GRC,0,0,120,61,181
2006,Indonesia,IDN,Greece,GRC,0,0,5,5,10
2006,Iran (Islamic Rep. of),IRN,Greece,GRC,10,5,480,66,561
2006,Iraq,IRQ,Greece,GRC,0,0,1756,218,1974
2006,Kazakhstan,KAZ,Greece,GRC,0,0,5,0,5
2006,Liberia,LBR,Greece,GRC,0,0,10,0,10
2006,Libya,LBY,Greece,GRC,5,0,0,0,5
2006,Lebanon,LBN,Greece,GRC,0,0,27,5,32
2006,Sri Lanka,LKA,Greece,GRC,0,0,93,33,126
2006,Mauritania,MRT,Greece,GRC,0,0,55,0,55
2006,Rep. of Moldova,MDA,Greece,GRC,0,0,32,42,74
2006,Mali,MLI,Greece,GRC,0,0,5,0,5
2006,Morocco,MAR,Greece,GRC,0,0,0,5,5
2006,Myanmar,MMR,Greece,GRC,0,0,19,26,45
2006,Nepal,NPL,Greece,GRC,0,0,0,5,5
2006,Nigeria,NGA,Greece,GRC,0,12,499,102,613
2006,Pakistan,PAK,Greece,GRC,0,0,1752,373,2125
2006,Philippines,PHL,Greece,GRC,0,0,14,10,24
2006,Romania,ROU,Greece,GRC,0,0,15,71,86
2006,Russian Federation,RUS,Greece,GRC,0,0,22,84,106
2006,Rwanda,RWA,Greece,GRC,0,0,20,5,25
2006,Senegal,SEN,Greece,GRC,0,0,54,5,59
2006,Sierra Leone,SLE,Greece,GRC,0,0,35,11,46
2006,Somalia,SOM,Greece,GRC,5,5,154,69,233
2006,Sudan,SDN,Greece,GRC,0,5,197,38,240
2006,Syrian Arab Rep.,SYR,Greece,GRC,0,0,134,26,160
2006,United Rep. of Tanzania,TZA,Greece,GRC,0,0,13,0,13
2006,Tunisia,TUN,Greece,GRC,0,0,5,0,5
2006,Turkey,TUR,Greece,GRC,0,0,114,14,128
2006,Uganda,UGA,Greece,GRC,0,0,11,5,16
2006,Ukraine,UKR,Greece,GRC,0,0,15,41,56
2006,Uzbekistan,UZB,Greece,GRC,0,0,0,5,5
2006,Unknown ,,Greece,GRC,11,0,186,43,240
2006,Afghanistan,AFG,Italy,ITA,51,120,86,0,257
2006,Albania,ALB,Italy,ITA,0,5,19,0,24
2006,Algeria,DZA,Italy,ITA,0,5,16,0,21
2006,Angola,AGO,Italy,ITA,5,11,5,0,21
2006,Egypt,EGY,Italy,ITA,0,0,21,0,21
2006,Armenia,ARM,Italy,ITA,5,13,10,0,28
2006,Azerbaijan,AZE,Italy,ITA,13,15,5,0,33
2006,Burundi,BDI,Italy,ITA,0,5,0,0,5
2006,Benin,BEN,Italy,ITA,0,0,13,0,13
2006,Bangladesh,BGD,Italy,ITA,13,65,397,0,475
2006,Burkina Faso,BFA,Italy,ITA,5,10,21,0,36
2006,Belarus,BLR,Italy,ITA,0,5,10,0,15
2006,Brazil,BRA,Italy,ITA,0,0,5,0,5
2006,Bosnia and Herzegovina,BIH,Italy,ITA,0,5,5,0,10
2006,Bulgaria,BGR,Italy,ITA,0,5,27,0,32
2006,Central African Rep.,CAF,Italy,ITA,0,5,0,0,5
2006,Chad,TCD,Italy,ITA,0,10,20,0,30
2006,China,CHN,Italy,ITA,0,5,0,0,5
2006,Cameroon,CMR,Italy,ITA,38,41,29,0,108
2006,Congo,COG,Italy,ITA,40,67,35,0,142
2006,Dem. Rep. of the Congo,COD,Italy,ITA,23,23,0,0,46
2006,Colombia,COL,Italy,ITA,23,151,122,0,296
2006,Cuba,CUB,Italy,ITA,5,11,5,0,21
2006,Cabo Verde,CPV,Italy,ITA,17,0,0,0,17
2006,Ecuador,ECU,Italy,ITA,0,0,5,0,5
2006,Eritrea,ERI,Italy,ITA,177,2139,404,0,2720
2006,Ethiopia,ETH,Italy,ITA,151,307,121,0,579
2006,Gambia,GMB,Italy,ITA,5,10,45,0,60
2006,Palestinian,PSE,Italy,ITA,0,12,103,0,115
2006,Georgia,GEO,Italy,ITA,0,10,15,0,25
2006,Ghana,GHA,Italy,ITA,0,28,561,0,589
2006,Guinea-Bissau,GNB,Italy,ITA,0,5,5,0,10
2006,Guinea,GIN,Italy,ITA,5,27,41,0,73
2006,Cote d'Ivoire,CIV,Italy,ITA,52,400,168,0,620
2006,India,IND,Italy,ITA,0,13,157,0,170
2006,Iran (Islamic Rep. of),IRN,Italy,ITA,27,32,32,0,91
2006,Iraq,IRQ,Italy,ITA,22,74,293,0,389
2006,Jordan,JOR,Italy,ITA,0,0,5,0,5
2006,Liberia,LBR,Italy,ITA,5,105,484,0,594
2006,Lebanon,LBN,Italy,ITA,5,29,17,0,51
2006,Sri Lanka,LKA,Italy,ITA,5,27,189,0,221
2006,Mauritania,MRT,Italy,ITA,5,5,5,0,15
2006,North Macedonia,MKD,Italy,ITA,0,5,79,0,84
2006,Rep. of Moldova,MDA,Italy,ITA,0,10,63,0,73
2006,Mali,MLI,Italy,ITA,0,5,93,0,98
2006,Morocco,MAR,Italy,ITA,5,11,342,0,358
2006,Myanmar,MMR,Italy,ITA,0,0,5,0,5
2006,Niger,NER,Italy,ITA,5,10,116,0,131
2006,Nigeria,NGA,Italy,ITA,29,248,808,0,1085
2006,Pakistan,PAK,Italy,ITA,10,70,698,0,778
2006,Peru,PER,Italy,ITA,0,0,5,0,5
2006,Philippines,PHL,Italy,ITA,0,0,5,0,5
2006,Poland,POL,Italy,ITA,0,0,5,0,5
2006,Romania,ROU,Italy,ITA,0,5,347,0,352
2006,Russian Federation,RUS,Italy,ITA,5,19,43,0,67
2006,Rwanda,RWA,Italy,ITA,5,0,0,0,5
2006,El Salvador,SLV,Italy,ITA,0,5,0,0,5
2006,Serbia and Kosovo: S/RES/1244 (1999),SRB,Italy,ITA,36,212,740,0,988
2006,Senegal,SEN,Italy,ITA,0,5,24,0,29
2006,Sierra Leone,SLE,Italy,ITA,5,26,116,0,147
2006,Somalia,SOM,Italy,ITA,16,118,247,0,381
2006,Viet Nam,VNM,Italy,ITA,0,0,5,0,5
2006,Sudan,SDN,Italy,ITA,82,243,251,0,576
2006,Syrian Arab Rep.,SYR,Italy,ITA,11,5,13,0,29
2006,Togo,TGO,Italy,ITA,78,398,170,0,646
2006,Tunisia,TUN,Italy,ITA,0,5,50,0,55
2006,Turkey,TUR,Italy,ITA,37,76,165,0,278
2006,Uganda,UGA,Italy,ITA,5,5,0,0,10
2006,Ukraine,UKR,Italy,ITA,0,27,37,0,64
2006,Unknown ,,Italy,ITA,0,0,0,3596,3596
2006,Afghanistan,AFG,Kyrgyzstan,KGZ,14,0,47,14,75
2006,Iran (Islamic Rep. of),IRN,Kyrgyzstan,KGZ,5,0,5,0,10
2006,Russian Federation,RUS,Kyrgyzstan,KGZ,0,0,0,155,155
2006,Syrian Arab Rep.,SYR,Kyrgyzstan,KGZ,0,0,5,0,5
2006,Tajikistan,TJK,Kyrgyzstan,KGZ,5,0,0,0,5
2006,Uzbekistan,UZB,Kyrgyzstan,KGZ,0,0,5,40,45
2006,Bangladesh,BGD,Rep. of Korea,KOR,0,0,5,0,5
2006,China,CHN,Rep. of Korea,KOR,0,5,63,16,84
2006,Iran (Islamic Rep. of),IRN,Rep. of Korea,KOR,0,5,0,0,5
2006,Liberia,LBR,Rep. of Korea,KOR,0,0,0,5,5
2006,Myanmar,MMR,Rep. of Korea,KOR,10,5,0,5,20
2006,Nepal,NPL,Rep. of Korea,KOR,0,0,0,5,5
2006,Nigeria,NGA,Rep. of Korea,KOR,0,0,11,0,11
2006,Pakistan,PAK,Rep. of Korea,KOR,0,0,5,0,5
2006,Uganda,UGA,Rep. of Korea,KOR,0,0,13,5,18
2006,Russian Federation,RUS,Latvia,LVA,0,0,0,5,5
2006,Somalia,SOM,Latvia,LVA,0,5,0,0,5
2006,Afghanistan,AFG,Rep. of Moldova,MDA,0,5,0,0,5
2006,Armenia,ARM,Rep. of Moldova,MDA,5,11,0,5,21
2006,Azerbaijan,AZE,Rep. of Moldova,MDA,0,5,0,0,5
2006,Ethiopia,ETH,Rep. of Moldova,MDA,0,5,0,0,5
2006,Palestinian,PSE,Rep. of Moldova,MDA,0,5,0,0,5
2006,Georgia,GEO,Rep. of Moldova,MDA,0,5,0,5,10
2006,Iran (Islamic Rep. of),IRN,Rep. of Moldova,MDA,0,5,0,0,5
2006,Jordan,JOR,Rep. of Moldova,MDA,0,0,5,0,5
2006,Lebanon,LBN,Rep. of Moldova,MDA,0,0,5,5,10
2006,Russian Federation,RUS,Rep. of Moldova,MDA,0,5,0,5,10
2006,Serbia and Kosovo: S/RES/1244 (1999),SRB,Rep. of Moldova,MDA,5,0,0,0,5
2006,Sudan,SDN,Rep. of Moldova,MDA,0,5,0,0,5
2006,Syrian Arab Rep.,SYR,Rep. of Moldova,MDA,0,10,5,5,20
2006,Tajikistan,TJK,Rep. of Moldova,MDA,0,5,0,0,5
2006,Turkey,TUR,Rep. of Moldova,MDA,0,0,5,5,10
2006,Angola,AGO,Mozambique,MOZ,0,0,0,5,5
2006,Burundi,BDI,Mozambique,MOZ,179,0,0,5,184
2006,Congo,COG,Mozambique,MOZ,16,0,0,0,16
2006,Dem. Rep. of the Congo,COD,Mozambique,MOZ,335,0,0,0,335
2006,Rwanda,RWA,Mozambique,MOZ,119,0,0,0,119
2006,Afghanistan,AFG,Romania,ROU,0,0,5,0,5
2006,Albania,ALB,Romania,ROU,0,0,0,5,5
2006,Egypt,EGY,Romania,ROU,0,0,5,0,5
2006,Bangladesh,BGD,Romania,ROU,0,0,0,19,19
2006,Bolivia (Plurinational State of),BOL,Romania,ROU,0,0,0,5,5
2006,China,CHN,Romania,ROU,0,0,42,5,47
2006,Congo,COG,Romania,ROU,0,0,5,0,5
2006,Dem. Rep. of the Congo,COD,Romania,ROU,0,0,0,5,5
2006,Djibouti,DJI,Romania,ROU,0,0,0,5,5
2006,Eritrea,ERI,Romania,ROU,5,0,0,0,5
2006,Palestinian,PSE,Romania,ROU,0,0,0,22,22
2006,Georgia,GEO,Romania,ROU,0,0,19,0,19
2006,Cote d'Ivoire,CIV,Romania,ROU,0,0,5,5,10
2006,India,IND,Romania,ROU,0,0,0,14,14
2006,Iran (Islamic Rep. of),IRN,Romania,ROU,0,0,11,26,37
2006,Iraq,IRQ,Romania,ROU,31,0,33,28,92
2006,Israel,ISR,Romania,ROU,0,0,5,0,5
2006,Jordan,JOR,Romania,ROU,0,0,0,5,5
2006,Liberia,LBR,Romania,ROU,0,0,5,0,5
2006,Libya,LBY,Romania,ROU,0,0,0,5,5
2006,Lebanon,LBN,Romania,ROU,0,0,0,5,5
2006,Sri Lanka,LKA,Romania,ROU,0,0,0,5,5
2006,Rep. of Moldova,MDA,Romania,ROU,0,0,5,10,15
2006,Nigeria,NGA,Romania,ROU,0,0,5,0,5
2006,Pakistan,PAK,Romania,ROU,0,0,16,5,21
2006,Russian Federation,RUS,Romania,ROU,0,0,10,5,15
2006,Sierra Leone,SLE,Romania,ROU,0,0,0,5,5
2006,Somalia,SOM,Romania,ROU,5,0,40,5,50
2006,Sudan,SDN,Romania,ROU,0,0,0,10,10
2006,Syrian Arab Rep.,SYR,Romania,ROU,5,0,11,5,21
2006,Tunisia,TUN,Romania,ROU,0,0,0,5,5
2006,Turkey,TUR,Romania,ROU,0,0,20,5,25
2006,Zimbabwe,ZWE,Romania,ROU,0,0,5,0,5
2006,Eritrea,ERI,Sudan,SDN,8568,0,16,25,8609
2006,Ethiopia,ETH,Sudan,SDN,922,0,29,0,951
2006,Somalia,SOM,Sudan,SDN,209,0,0,0,209
2006,Albania,ALB,Slovenia,SVN,0,0,10,18,28
2006,Armenia,ARM,Slovenia,SVN,0,0,5,0,5
2006,Bangladesh,BGD,Slovenia,SVN,0,0,5,0,5
2006,Bosnia and Herzegovina,BIH,Slovenia,SVN,0,0,94,31,125
2006,Palestinian,PSE,Slovenia,SVN,0,0,5,5,10
2006,Georgia,GEO,Slovenia,SVN,0,0,0,10,10
2006,Croatia,HRV,Slovenia,SVN,0,0,5,0,5
2006,Hungary,HUN,Slovenia,SVN,0,0,5,0,5
2006,India,IND,Slovenia,SVN,0,0,5,0,5
2006,Iran (Islamic Rep. of),IRN,Slovenia,SVN,0,0,5,5,10
2006,Iraq,IRQ,Slovenia,SVN,0,0,5,5,10
2006,Kazakhstan,KAZ,Slovenia,SVN,0,0,5,0,5
2006,Sri Lanka,LKA,Slovenia,SVN,0,0,0,5,5
2006,North Macedonia,MKD,Slovenia,SVN,0,0,10,24,34
2006,Rep. of Moldova,MDA,Slovenia,SVN,0,0,5,5,10
2006,Pakistan,PAK,Slovenia,SVN,0,0,5,5,10
2006,Russian Federation,RUS,Slovenia,SVN,0,0,5,0,5
2006,Serbia and Kosovo: S/RES/1244 (1999),SRB,Slovenia,SVN,0,5,345,154,504
2006,Turkey,TUR,Slovenia,SVN,0,0,21,30,51
2006,Uzbekistan,UZB,Slovenia,SVN,0,0,0,5,5
2006,Unknown ,,Slovenia,SVN,0,0,5,0,5
2006,Rwanda,RWA,United Rep. of Tanzania,TZA,194,0,0,0,194
2006,Somalia,SOM,United Rep. of Tanzania,TZA,764,0,0,0,764
2006,Myanmar,MMR,Thailand,THA,0,15762,129,1438,17329
2006,Afghanistan,AFG,Tajikistan,TJK,46,0,187,0,233
2006,Burundi,BDI,Zimbabwe,ZWE,195,0,0,5,200
2006,Dem. Rep. of the Congo,COD,Zimbabwe,ZWE,366,0,17,343,726
2006,Rwanda,RWA,Zimbabwe,ZWE,5,0,0,26,31
2006,Unknown ,,Zimbabwe,ZWE,5,0,5,2118,2128
2007,North Macedonia,MKD,Albania,ALB,0,0,0,10,10
2007,Nepal,NPL,Albania,ALB,0,0,0,10,10
2007,Serbia and Kosovo: S/RES/1244 (1999),SRB,Albania,ALB,5,0,0,5,10
2007,Chad,TCD,Angola,AGO,0,0,5,0,5
2007,Dem. Rep. of the Congo,COD,Angola,AGO,22,0,10,0,32
2007,Eritrea,ERI,Angola,AGO,0,0,5,0,5
2007,Guinea,GIN,Angola,AGO,5,0,5,0,10
2007,Cote d'Ivoire,CIV,Angola,AGO,15,0,19,0,34
2007,Mauritania,MRT,Angola,AGO,5,0,5,0,10
2007,Sierra Leone,SLE,Angola,AGO,5,0,0,0,5
2007,Somalia,SOM,Angola,AGO,10,0,5,0,15
2007,Sudan,SDN,Angola,AGO,17,0,5,0,22
2007,Afghanistan,AFG,Austria,AUT,497,306,151,157,1111
2007,Albania,ALB,Austria,AUT,10,10,22,11,53
2007,Algeria,DZA,Austria,AUT,11,0,102,61,174
2007,Angola,AGO,Austria,AUT,22,5,10,5,42
2007,Egypt,EGY,Austria,AUT,10,0,41,21,72
2007,Armenia,ARM,Austria,AUT,135,60,196,52,443
2007,Azerbaijan,AZE,Austria,AUT,73,14,37,11,135
2007,Burundi,BDI,Austria,AUT,0,0,5,5,10
2007,Benin,BEN,Austria,AUT,0,0,5,0,5
2007,Bangladesh,BGD,Austria,AUT,5,0,29,50,84
2007,Burkina Faso,BFA,Austria,AUT,0,0,0,5,5
2007,Belarus,BLR,Austria,AUT,15,5,85,47,152
2007,Bosnia and Herzegovina,BIH,Austria,AUT,11,20,67,55,153
2007,Bulgaria,BGR,Austria,AUT,0,0,13,10,23
2007,China,CHN,Austria,AUT,35,10,165,95,305
2007,Cameroon,CMR,Austria,AUT,32,0,13,20,65
2007,Congo,COG,Austria,AUT,13,0,0,5,18
2007,Dem. Rep. of the Congo,COD,Austria,AUT,40,0,10,10,60
2007,Cuba,CUB,Austria,AUT,5,0,0,5,10
2007,Dominican Rep.,DOM,Austria,AUT,0,0,5,0,5
2007,Eritrea,ERI,Austria,AUT,5,0,0,0,5
2007,Estonia,EST,Austria,AUT,0,0,0,5,5
2007,Ethiopia,ETH,Austria,AUT,10,0,5,0,15
2007,Gambia,GMB,Austria,AUT,5,0,93,45,143
2007,Georgia,GEO,Austria,AUT,56,57,480,161,754
2007,Ghana,GHA,Austria,AUT,0,0,24,20,44
2007,Guinea-Bissau,GNB,Austria,AUT,0,0,20,24,44
2007,Guinea,GIN,Austria,AUT,5,0,23,30,58
2007,Croatia,HRV,Austria,AUT,0,0,11,5,16
2007,Cote d'Ivoire,CIV,Austria,AUT,5,0,10,0,15
2007,India,IND,Austria,AUT,0,5,312,167,484
2007,Iran (Islamic Rep. of),IRN,Austria,AUT,318,44,45,40,447
2007,Iraq,IRQ,Austria,AUT,215,143,96,94,548
2007,Israel,ISR,Austria,AUT,0,0,5,10,15
2007,Jordan,JOR,Austria,AUT,5,0,5,5,15
2007,Kazakhstan,KAZ,Austria,AUT,5,0,0,0,5
2007,Kenya,KEN,Austria,AUT,0,0,5,5,10
2007,Kyrgyzstan,KGZ,Austria,AUT,22,0,31,16,69
2007,Liberia,LBR,Austria,AUT,0,0,38,38,76
2007,Lebanon,LBN,Austria,AUT,18,5,16,26,65
2007,Sri Lanka,LKA,Austria,AUT,5,0,24,27,56
2007,Lithuania,LTU,Austria,AUT,0,0,5,0,5
2007,Mauritania,MRT,Austria,AUT,0,0,10,5,15
2007,North Macedonia,MKD,Austria,AUT,18,24,188,64,294
2007,Rep. of Moldova,MDA,Austria,AUT,13,22,160,540,735
2007,Mali,MLI,Austria,AUT,0,0,12,5,17
2007,Mongolia,MNG,Austria,AUT,23,12,154,156,345
2007,Morocco,MAR,Austria,AUT,0,0,55,29,84
2007,Montenegro,MNE,Austria,AUT,0,5,14,0,19
2007,Nepal,NPL,Austria,AUT,5,0,15,5,25
2007,Nigeria,NGA,Austria,AUT,20,19,514,341,894
2007,Pakistan,PAK,Austria,AUT,5,5,62,69,141
2007,Peru,PER,Austria,AUT,0,0,5,0,5
2007,Poland,POL,Austria,AUT,0,0,5,0,5
2007,Romania,ROU,Austria,AUT,5,0,50,18,73
2007,Russian Federation,RUS,Austria,AUT,2636,427,542,477,4082
2007,Serbia and Kosovo: S/RES/1244 (1999),SRB,Austria,AUT,240,325,1759,580,2904
2007,Senegal,SEN,Austria,AUT,0,0,5,11,16
2007,Sierra Leone,SLE,Austria,AUT,5,0,19,23,47
2007,Somalia,SOM,Austria,AUT,191,22,41,71,325
2007,Viet Nam,VNM,Austria,AUT,10,0,10,5,25
2007,Sudan,SDN,Austria,AUT,29,0,20,17,66
2007,Slovakia,SVK,Austria,AUT,0,0,5,0,5
2007,Syrian Arab Rep.,SYR,Austria,AUT,86,5,18,24,133
2007,Tajikistan,TJK,Austria,AUT,5,5,0,0,10
2007,Togo,TGO,Austria,AUT,5,0,5,5,15
2007,Tunisia,TUN,Austria,AUT,0,0,15,5,20
2007,Turkey,TUR,Austria,AUT,195,32,531,258,1016
2007,Uganda,UGA,Austria,AUT,0,0,5,5,10
2007,Ukraine,UKR,Austria,AUT,20,10,127,58,215
2007,Uzbekistan,UZB,Austria,AUT,14,0,10,0,24
2007,Yemen,YEM,Austria,AUT,5,0,0,0,5
2007,Zimbabwe,ZWE,Austria,AUT,0,0,0,5,5
2007,Stateless,XXA,Austria,AUT,50,22,61,61,194
2007,Unknown ,,Austria,AUT,24,5,22,5,56
2007,Serbia and Kosovo: S/RES/1244 (1999),SRB,Bosnia and Herzegovina,BIH,0,0,0,18,18
2007,Afghanistan,AFG,Bulgaria,BGR,5,18,33,36,92
2007,Albania,ALB,Bulgaria,BGR,0,0,10,0,10
2007,Algeria,DZA,Bulgaria,BGR,0,0,5,0,5
2007,Armenia,ARM,Bulgaria,BGR,0,5,30,23,58
2007,Bangladesh,BGD,Bulgaria,BGR,0,0,10,10,20
2007,China,CHN,Bulgaria,BGR,0,0,5,0,5
2007,Colombia,COL,Bulgaria,BGR,0,0,0,5,5
2007,Georgia,GEO,Bulgaria,BGR,0,0,5,0,5
2007,Guinea,GIN,Bulgaria,BGR,0,0,5,0,5
2007,Cote d'Ivoire,CIV,Bulgaria,BGR,0,0,5,0,5
2007,Iran (Islamic Rep. of),IRN,Bulgaria,BGR,0,10,18,5,33
2007,Iraq,IRQ,Bulgaria,BGR,0,276,10,100,386
2007,Lebanon,LBN,Bulgaria,BGR,0,5,10,5,20
2007,Nigeria,NGA,Bulgaria,BGR,0,0,13,5,18
2007,Russian Federation,RUS,Bulgaria,BGR,0,0,5,5,10
2007,Serbia and Kosovo: S/RES/1244 (1999),SRB,Bulgaria,BGR,0,0,5,0,5
2007,Viet Nam,VNM,Bulgaria,BGR,0,0,0,5,5
2007,Sudan,SDN,Bulgaria,BGR,0,5,5,0,10
2007,Syrian Arab Rep.,SYR,Bulgaria,BGR,5,0,5,0,10
2007,United Rep. of Tanzania,TZA,Bulgaria,BGR,0,0,5,5,10
2007,Turkey,TUR,Bulgaria,BGR,0,0,10,0,10
2007,Stateless,XXA,Bulgaria,BGR,0,0,27,27,54
2007,Afghanistan,AFG,Canada,CAN,121,0,29,26,176
2007,Albania,ALB,Canada,CAN,87,0,60,16,163
2007,Algeria,DZA,Canada,CAN,14,0,10,10,34
2007,Angola,AGO,Canada,CAN,10,0,5,0,15
2007,Egypt,EGY,Canada,CAN,18,0,16,5,39
2007,Argentina,ARG,Canada,CAN,0,0,10,5,15
2007,Armenia,ARM,Canada,CAN,5,0,10,5,20
2007,Austria,AUT,Canada,CAN,0,0,0,5,5
2007,Azerbaijan,AZE,Canada,CAN,12,0,0,5,17
2007,Barbados,BRB,Canada,CAN,5,0,10,5,20
2007,Burundi,BDI,Canada,CAN,193,0,38,5,236
2007,Bangladesh,BGD,Canada,CAN,46,0,46,13,105
2007,Belarus,BLR,Canada,CAN,10,0,0,0,10
2007,Bolivia (Plurinational State of),BOL,Canada,CAN,5,0,5,0,10
2007,Botswana,BWA,Canada,CAN,0,0,5,0,5
2007,Brazil,BRA,Canada,CAN,5,0,15,17,37
2007,Bosnia and Herzegovina,BIH,Canada,CAN,0,0,5,0,5
2007,Bulgaria,BGR,Canada,CAN,5,0,5,5,15
2007,Cambodia,KHM,Canada,CAN,5,0,5,0,10
2007,Chad,TCD,Canada,CAN,22,0,25,0,47
2007,China,CHN,Canada,CAN,728,0,326,76,1130
2007,Chile,CHL,Canada,CAN,5,0,16,5,26
2007,Cameroon,CMR,Canada,CAN,30,0,18,5,53
2007,Congo,COG,Canada,CAN,5,0,5,0,10
2007,Dem. Rep. of the Congo,COD,Canada,CAN,160,0,76,13,249
2007,Colombia,COL,Canada,CAN,737,0,142,61,940
2007,Costa Rica,CRI,Canada,CAN,5,0,22,11,38
2007,Cuba,CUB,Canada,CAN,67,0,21,31,119
2007,Denmark,DNK,Canada,CAN,0,0,5,0,5
2007,Djibouti,DJI,Canada,CAN,5,0,0,0,5
2007,Dominican Rep.,DOM,Canada,CAN,10,0,11,10,31
2007,Ecuador,ECU,Canada,CAN,13,0,5,0,18
2007,Eritrea,ERI,Canada,CAN,107,0,5,0,112
2007,Estonia,EST,Canada,CAN,0,0,0,5,5
2007,Ethiopia,ETH,Canada,CAN,135,0,26,10,171
2007,Fiji,FJI,Canada,CAN,0,0,13,5,18
2007,France,FRA,Canada,CAN,0,0,5,0,5
2007,Gabon,GAB,Canada,CAN,0,0,5,0,5
2007,Palestinian,PSE,Canada,CAN,11,0,5,0,16
2007,United Kingdom of Great Britain and Northern Ireland,GBR,Canada,CAN,0,0,5,0,5
2007,Georgia,GEO,Canada,CAN,20,0,16,5,41
2007,Germany,DEU,Canada,CAN,5,0,10,10,25
2007,Ghana,GHA,Canada,CAN,5,0,15,5,25
2007,Grenada,GRD,Canada,CAN,5,0,10,5,20
2007,Guatemala,GTM,Canada,CAN,54,0,38,14,106
2007,Guinea,GIN,Canada,CAN,27,0,21,0,48
2007,Guyana,GUY,Canada,CAN,16,0,104,12,132
2007,Haiti,HTI,Canada,CAN,124,0,75,53,252
2007,"China, Hong Kong SAR",HKG,Canada,CAN,0,0,5,0,5
2007,Honduras,HND,Canada,CAN,36,0,50,29,115
2007,Croatia,HRV,Canada,CAN,0,0,5,5,10
2007,Hungary,HUN,Canada,CAN,5,0,15,5,25
2007,Cote d'Ivoire,CIV,Canada,CAN,12,0,13,5,30
2007,India,IND,Canada,CAN,44,0,196,114,354
2007,Indonesia,IDN,Canada,CAN,11,0,18,0,29
2007,Iran (Islamic Rep. of),IRN,Canada,CAN,89,0,17,17,123
2007,Iraq,IRQ,Canada,CAN,45,0,11,15,71
2007,Israel,ISR,Canada,CAN,32,0,101,54,187
2007,Italy,ITA,Canada,CAN,0,0,5,5,10
2007,Jamaica,JAM,Canada,CAN,28,0,43,17,88
2007,Jordan,JOR,Canada,CAN,14,0,10,5,29
2007,Kazakhstan,KAZ,Canada,CAN,0,0,5,0,5
2007,Kenya,KEN,Canada,CAN,29,0,13,0,42
2007,Kyrgyzstan,KGZ,Canada,CAN,10,0,5,0,15
2007,Rep. of Korea,KOR,Canada,CAN,5,0,77,12,94
2007,Dem. People's Rep. of Korea,PRK,Canada,CAN,0,0,0,10,10
2007,Liberia,LBR,Canada,CAN,0,0,10,0,10
2007,Libya,LBY,Canada,CAN,10,0,5,5,20
2007,Saint Lucia,LCA,Canada,CAN,22,0,45,22,89
2007,Lebanon,LBN,Canada,CAN,33,0,56,31,120
2007,Sri Lanka,LKA,Canada,CAN,702,0,61,34,797
2007,Mauritania,MRT,Canada,CAN,10,0,5,0,15
2007,North Macedonia,MKD,Canada,CAN,5,0,5,0,10
2007,Mexico,MEX,Canada,CAN,378,0,2132,1104,3614
2007,Mali,MLI,Canada,CAN,5,0,5,0,10
2007,Malaysia,MYS,Canada,CAN,5,0,25,5,35
2007,Mongolia,MNG,Canada,CAN,13,0,5,0,18
2007,Morocco,MAR,Canada,CAN,17,0,10,5,32
2007,Montenegro,MNE,Canada,CAN,17,0,30,5,52
2007,Mauritius,MUS,Canada,CAN,0,0,5,0,5
2007,Myanmar,MMR,Canada,CAN,13,0,5,0,18
2007,Namibia,NAM,Canada,CAN,0,0,5,0,5
2007,Nepal,NPL,Canada,CAN,59,0,5,5,69
2007,Netherlands,NLD,Canada,CAN,0,0,5,0,5
2007,Nicaragua,NIC,Canada,CAN,0,0,11,5,16
2007,Nigeria,NGA,Canada,CAN,132,0,125,44,301
2007,Pakistan,PAK,Canada,CAN,195,0,150,54,399
2007,Panama,PAN,Canada,CAN,0,0,5,0,5
2007,Peru,PER,Canada,CAN,70,0,55,13,138
2007,Philippines,PHL,Canada,CAN,17,0,42,5,64
2007,Poland,POL,Canada,CAN,5,0,12,10,27
2007,Portugal,PRT,Canada,CAN,5,0,12,5,22
2007,Romania,ROU,Canada,CAN,10,0,12,27,49
2007,South Africa,ZAF,Canada,CAN,0,0,10,0,10
2007,Russian Federation,RUS,Canada,CAN,68,0,22,27,117
2007,Rwanda,RWA,Canada,CAN,104,0,26,5,135
2007,El Salvador,SLV,Canada,CAN,67,0,68,25,160
2007,Serbia and Kosovo: S/RES/1244 (1999),SRB,Canada,CAN,0,0,5,0,5
2007,Senegal,SEN,Canada,CAN,15,0,5,0,20
2007,Sierra Leone,SLE,Canada,CAN,5,0,5,0,10
2007,Solomon Islands,SLB,Canada,CAN,10,0,0,0,10
2007,Somalia,SOM,Canada,CAN,121,0,10,20,151
2007,Spain,ESP,Canada,CAN,0,0,5,5,10
2007,Viet Nam,VNM,Canada,CAN,0,0,5,5,10
2007,Sudan,SDN,Canada,CAN,33,0,0,5,38
2007,Suriname,SUR,Canada,CAN,0,0,5,0,5
2007,Slovakia,SVK,Canada,CAN,5,0,0,0,5
2007,Slovenia,SVN,Canada,CAN,5,0,0,0,5
2007,Sweden,SWE,Canada,CAN,0,0,5,0,5
2007,Syrian Arab Rep.,SYR,Canada,CAN,5,0,5,10,20
2007,United Rep. of Tanzania,TZA,Canada,CAN,0,0,5,0,5
2007,Thailand,THA,Canada,CAN,0,0,0,5,5
2007,Togo,TGO,Canada,CAN,11,0,5,0,16
2007,Trinidad and Tobago,TTO,Canada,CAN,14,0,41,13,68
2007,Tunisia,TUN,Canada,CAN,10,0,5,10,25
2007,Turkey,TUR,Canada,CAN,54,0,77,47,178
2007,Uganda,UGA,Canada,CAN,31,0,5,0,36
2007,Ukraine,UKR,Canada,CAN,65,0,27,27,119
2007,Uruguay,URY,Canada,CAN,5,0,14,0,19
2007,United States of America,USA,Canada,CAN,10,0,113,89,212
2007,Uzbekistan,UZB,Canada,CAN,5,0,5,0,10
2007,Saint Vincent and the Grenadines,VCT,Canada,CAN,45,0,96,25,166
2007,Venezuela (Bolivarian Republic of),VEN,Canada,CAN,36,0,32,5,73
2007,Yemen,YEM,Canada,CAN,5,0,0,0,5
2007,Zimbabwe,ZWE,Canada,CAN,186,0,75,17,278
2007,Unknown ,,Canada,CAN,5,0,5,11,21
2007,Colombia,COL,Costa Rica,CRI,131,0,452,0,583
2007,Cuba,CUB,Costa Rica,CRI,24,0,31,0,55
2007,Nicaragua,NIC,Costa Rica,CRI,0,0,5,0,5
2007,El Salvador,SLV,Costa Rica,CRI,0,0,16,0,16
2007,Venezuela (Bolivarian Republic of),VEN,Costa Rica,CRI,21,0,13,0,34
2007,Afghanistan,AFG,Ecuador,ECU,0,5,0,0,5
2007,Andorra,AND,Ecuador,ECU,0,0,0,5,5
2007,Argentina,ARG,Ecuador,ECU,0,0,11,0,11
2007,Bolivia (Plurinational State of),BOL,Ecuador,ECU,0,0,5,0,5
2007,China,CHN,Ecuador,ECU,0,0,5,0,5
2007,Chile,CHL,Ecuador,ECU,0,0,5,0,5
2007,Colombia,COL,Ecuador,ECU,866,2071,3403,105,6445
2007,Cuba,CUB,Ecuador,ECU,14,15,5,0,34
2007,Cabo Verde,CPV,Ecuador,ECU,0,0,5,0,5
2007,Dominican Rep.,DOM,Ecuador,ECU,0,0,17,0,17
2007,Ecuador,ECU,Ecuador,ECU,0,10,5,5,20
2007,Haiti,HTI,Ecuador,ECU,0,0,5,0,5
2007,Iraq,IRQ,Ecuador,ECU,0,5,0,0,5
2007,Rep. of Korea,KOR,Ecuador,ECU,0,0,5,0,5
2007,Liberia,LBR,Ecuador,ECU,0,0,5,0,5
2007,Nepal,NPL,Ecuador,ECU,0,0,5,0,5
2007,Peru,PER,Ecuador,ECU,0,5,2419,17,2441
2007,South Africa,ZAF,Ecuador,ECU,0,0,5,0,5
2007,Venezuela (Bolivarian Republic of),VEN,Ecuador,ECU,0,0,10,0,10
2007,Unknown ,,Ecuador,ECU,0,5,5,0,10
2007,Angola,AGO,Gabon,GAB,0,0,0,5,5
2007,Congo,COG,Gabon,GAB,5,0,100,18,123
2007,Dem. Rep. of the Congo,COD,Gabon,GAB,0,0,10,0,10
2007,Equatorial Guinea,GNQ,Gabon,GAB,18,0,0,0,18
2007,Russian Federation,RUS,Georgia,GEO,10,0,5,0,15
2007,Afghanistan,AFG,Kyrgyzstan,KGZ,22,0,125,56,203
2007,Iran (Islamic Rep. of),IRN,Kyrgyzstan,KGZ,0,0,5,13,18
2007,Dem. People's Rep. of Korea,PRK,Kyrgyzstan,KGZ,5,0,0,0,5
2007,Russian Federation,RUS,Kyrgyzstan,KGZ,0,0,0,15,15
2007,Syrian Arab Rep.,SYR,Kyrgyzstan,KGZ,5,0,0,0,5
2007,Uzbekistan,UZB,Kyrgyzstan,KGZ,0,0,0,185,185
2007,Bangladesh,BGD,Rep. of Korea,KOR,5,0,0,0,5
2007,China,CHN,Rep. of Korea,KOR,0,0,32,16,48
2007,Dem. Rep. of the Congo,COD,Rep. of Korea,KOR,0,0,5,0,5
2007,Ethiopia,ETH,Rep. of Korea,KOR,0,0,5,5,10
2007,Cote d'Ivoire,CIV,Rep. of Korea,KOR,0,5,5,5,15
2007,Iran (Islamic Rep. of),IRN,Rep. of Korea,KOR,0,0,5,0,5
2007,Kyrgyzstan,KGZ,Rep. of Korea,KOR,0,0,5,0,5
2007,Sri Lanka,LKA,Rep. of Korea,KOR,0,0,0,5,5
2007,Myanmar,MMR,Rep. of Korea,KOR,5,5,0,5,15
2007,Nepal,NPL,Rep. of Korea,KOR,0,0,0,13,13
2007,Nigeria,NGA,Rep. of Korea,KOR,0,0,16,5,21
2007,Pakistan,PAK,Rep. of Korea,KOR,0,0,5,0,5
2007,Viet Nam,VNM,Rep. of Korea,KOR,0,0,5,0,5
2007,Uganda,UGA,Rep. of Korea,KOR,0,0,0,10,10
2007,Afghanistan,AFG,Rep. of Moldova,MDA,0,5,0,0,5
2007,Armenia,ARM,Rep. of Moldova,MDA,0,5,5,5,15
2007,Jordan,JOR,Rep. of Moldova,MDA,0,5,5,0,10
2007,Lebanon,LBN,Rep. of Moldova,MDA,0,0,5,0,5
2007,Russian Federation,RUS,Rep. of Moldova,MDA,0,0,5,0,5
2007,Sudan,SDN,Rep. of Moldova,MDA,0,5,0,0,5
2007,Turkey,TUR,Rep. of Moldova,MDA,0,0,10,0,10
2007,Burundi,BDI,Malawi,MWI,5,0,29,85,119
2007,Dem. Rep. of the Congo,COD,Malawi,MWI,30,0,14,77,121
2007,Eritrea,ERI,Malawi,MWI,0,0,0,505,505
2007,Ethiopia,ETH,Malawi,MWI,0,0,78,1471,1549
2007,Rwanda,RWA,Malawi,MWI,127,0,1680,415,2222
2007,Somalia,SOM,Malawi,MWI,0,0,0,940,940
2007,Sudan,SDN,Malawi,MWI,0,0,0,10,10
2007,Zambia,ZMB,Malawi,MWI,0,0,0,5,5
2007,Egypt,EGY,Romania,ROU,0,0,5,0,5
2007,Bangladesh,BGD,Romania,ROU,0,0,5,0,5
2007,China,CHN,Romania,ROU,0,0,10,5,15
2007,Cameroon,CMR,Romania,ROU,0,0,5,0,5
2007,Dem. Rep. of the Congo,COD,Romania,ROU,0,0,5,0,5
2007,Palestinian,PSE,Romania,ROU,0,0,22,0,22
2007,Georgia,GEO,Romania,ROU,0,0,5,0,5
2007,Guinea,GIN,Romania,ROU,0,0,5,0,5
2007,India,IND,Romania,ROU,0,0,15,0,15
2007,Iran (Islamic Rep. of),IRN,Romania,ROU,0,0,19,5,24
2007,Iraq,IRQ,Romania,ROU,107,5,61,10,183
2007,Israel,ISR,Romania,ROU,0,0,5,0,5
2007,Jordan,JOR,Romania,ROU,5,0,5,0,10
2007,Lebanon,LBN,Romania,ROU,0,0,5,0,5
2007,Rep. of Moldova,MDA,Romania,ROU,0,0,15,0,15
2007,Nigeria,NGA,Romania,ROU,0,0,5,0,5
2007,Pakistan,PAK,Romania,ROU,0,0,14,0,14
2007,Russian Federation,RUS,Romania,ROU,0,0,5,0,5
2007,Serbia and Kosovo: S/RES/1244 (1999),SRB,Romania,ROU,0,0,92,80,172
2007,Somalia,SOM,Romania,ROU,15,5,17,0,37
2007,Sudan,SDN,Romania,ROU,0,0,5,0,5
2007,Syrian Arab Rep.,SYR,Romania,ROU,0,0,14,0,14
2007,Tunisia,TUN,Romania,ROU,0,0,5,0,5
2007,Turkey,TUR,Romania,ROU,0,5,22,10,37
2007,Ukraine,UKR,Romania,ROU,0,0,5,0,5
2007,Zimbabwe,ZWE,Romania,ROU,0,0,5,0,5
2007,Afghanistan,AFG,Spain,ESP,0,0,5,0,5
2007,Albania,ALB,Spain,ESP,0,0,5,0,5
2007,Algeria,DZA,Spain,ESP,5,0,195,0,200
2007,Angola,AGO,Spain,ESP,0,0,5,0,5
2007,Egypt,EGY,Spain,ESP,0,0,5,0,5
2007,Argentina,ARG,Spain,ESP,0,0,5,0,5
2007,Armenia,ARM,Spain,ESP,0,0,83,0,83
2007,Azerbaijan,AZE,Spain,ESP,10,0,0,0,10
2007,Bangladesh,BGD,Spain,ESP,0,0,33,0,33
2007,Bhutan,BTN,Spain,ESP,0,0,5,0,5
2007,Burkina Faso,BFA,Spain,ESP,0,0,5,0,5
2007,Belarus,BLR,Spain,ESP,0,0,12,0,12
2007,Bolivia (Plurinational State of),BOL,Spain,ESP,0,0,10,0,10
2007,Bosnia and Herzegovina,BIH,Spain,ESP,0,0,10,0,10
2007,Chad,TCD,Spain,ESP,0,0,5,0,5
2007,Cameroon,CMR,Spain,ESP,0,0,30,0,30
2007,Congo,COG,Spain,ESP,0,0,5,0,5
2007,Dem. Rep. of the Congo,COD,Spain,ESP,5,0,51,0,56
2007,Colombia,COL,Spain,ESP,24,5,1652,0,1681
2007,Costa Rica,CRI,Spain,ESP,0,0,10,0,10
2007,Cuba,CUB,Spain,ESP,19,0,54,0,73
2007,Dominican Rep.,DOM,Spain,ESP,0,0,24,0,24
2007,Ecuador,ECU,Spain,ESP,0,0,5,0,5
2007,Equatorial Guinea,GNQ,Spain,ESP,14,0,19,0,33
2007,Eritrea,ERI,Spain,ESP,10,0,19,0,29
2007,Ethiopia,ETH,Spain,ESP,5,0,10,0,15
2007,Gambia,GMB,Spain,ESP,0,0,39,0,39
2007,Georgia,GEO,Spain,ESP,0,0,16,0,16
2007,Ghana,GHA,Spain,ESP,0,0,5,0,5
2007,Guinea-Bissau,GNB,Spain,ESP,0,0,13,0,13
2007,Guatemala,GTM,Spain,ESP,0,0,5,0,5
2007,Guinea,GIN,Spain,ESP,0,0,69,0,69
2007,Honduras,HND,Spain,ESP,0,0,5,0,5
2007,Cote d'Ivoire,CIV,Spain,ESP,0,0,99,0,99
2007,India,IND,Spain,ESP,0,0,28,0,28
2007,Iran (Islamic Rep. of),IRN,Spain,ESP,0,0,23,0,23
2007,Iraq,IRQ,Spain,ESP,18,0,1021,0,1039
2007,Kazakhstan,KAZ,Spain,ESP,5,0,5,0,10
2007,Kenya,KEN,Spain,ESP,0,0,5,0,5
2007,Kyrgyzstan,KGZ,Spain,ESP,0,0,5,0,5
2007,Liberia,LBR,Spain,ESP,0,0,20,0,20
2007,Lebanon,LBN,Spain,ESP,0,0,5,0,5
2007,Sri Lanka,LKA,Spain,ESP,0,0,5,0,5
2007,Mauritania,MRT,Spain,ESP,0,0,23,0,23
2007,Rep. of Moldova,MDA,Spain,ESP,0,0,10,0,10
2007,Mali,MLI,Spain,ESP,0,0,5,0,5
2007,Morocco,MAR,Spain,ESP,5,0,317,0,322
2007,Nepal,NPL,Spain,ESP,0,0,31,0,31
2007,Nigeria,NGA,Spain,ESP,0,0,607,0,607
2007,Pakistan,PAK,Spain,ESP,0,0,11,0,11
2007,Paraguay,PRY,Spain,ESP,0,0,5,0,5
2007,Peru,PER,Spain,ESP,0,0,5,0,5
2007,Russian Federation,RUS,Spain,ESP,20,0,96,0,116
2007,Rwanda,RWA,Spain,ESP,10,0,0,0,10
2007,El Salvador,SLV,Spain,ESP,0,0,15,0,15
2007,Serbia and Kosovo: S/RES/1244 (1999),SRB,Spain,ESP,0,0,10,0,10
2007,Senegal,SEN,Spain,ESP,0,0,38,0,38
2007,Sierra Leone,SLE,Spain,ESP,5,0,38,0,43
2007,Somalia,SOM,Spain,ESP,0,0,98,0,98
2007,Viet Nam,VNM,Spain,ESP,0,0,5,0,5
2007,Sudan,SDN,Spain,ESP,0,0,57,0,57
2007,Syrian Arab Rep.,SYR,Spain,ESP,0,0,33,0,33
2007,Togo,TGO,Spain,ESP,0,0,10,0,10
2007,Turkey,TUR,Spain,ESP,0,0,19,0,19
2007,Uganda,UGA,Spain,ESP,0,0,5,0,5
2007,Ukraine,UKR,Spain,ESP,0,0,15,0,15
2007,Uzbekistan,UZB,Spain,ESP,0,0,10,0,10
2007,Venezuela (Bolivarian Republic of),VEN,Spain,ESP,0,0,18,0,18
2007,Stateless,XXA,Spain,ESP,52,0,10,0,62
2007,Unknown ,,Spain,ESP,19,0,5,0,24
2007,Burundi,BDI,United Rep. of Tanzania,TZA,302,0,0,0,302
2007,Dem. Rep. of the Congo,COD,United Rep. of Tanzania,TZA,27,0,0,0,27
2007,Ethiopia,ETH,United Rep. of Tanzania,TZA,5,0,0,0,5
2007,Somalia,SOM,United Rep. of Tanzania,TZA,684,0,0,0,684
2007,Myanmar,MMR,Thailand,THA,0,2657,0,2673,5330
2007,Afghanistan,AFG,Tajikistan,TJK,325,0,516,0,841
2008,Serbia and Kosovo: S/RES/1244 (1999),SRB,Albania,ALB,0,0,0,5,5
2008,Chad,TCD,Angola,AGO,10,0,0,0,10
2008,Dem. Rep. of the Congo,COD,Angola,AGO,11,0,17,0,28
2008,Guinea,GIN,Angola,AGO,0,0,5,0,5
2008,Cote d'Ivoire,CIV,Angola,AGO,26,0,16,0,42
2008,Liberia,LBR,Angola,AGO,0,0,11,0,11
2008,Mauritania,MRT,Angola,AGO,5,0,10,0,15
2008,Rwanda,RWA,Angola,AGO,21,0,5,0,26
2008,Sierra Leone,SLE,Angola,AGO,5,0,10,0,15
2008,Somalia,SOM,Angola,AGO,5,0,5,0,10
2008,Sudan,SDN,Angola,AGO,10,0,5,0,15
2008,Afghanistan,AFG,Austria,AUT,486,391,217,221,1315
2008,Albania,ALB,Austria,AUT,5,5,23,14,47
2008,Algeria,DZA,Austria,AUT,0,0,111,69,180
2008,Angola,AGO,Austria,AUT,10,0,5,0,15
2008,Egypt,EGY,Austria,AUT,5,0,44,23,72
2008,Armenia,ARM,Austria,AUT,105,95,353,61,614
2008,Azerbaijan,AZE,Austria,AUT,59,11,37,18,125
2008,Bangladesh,BGD,Austria,AUT,5,10,21,24,60
2008,Belarus,BLR,Austria,AUT,10,5,51,32,98
2008,Bolivia (Plurinational State of),BOL,Austria,AUT,0,0,5,0,5
2008,Bosnia and Herzegovina,BIH,Austria,AUT,11,12,69,37,129
2008,Bulgaria,BGR,Austria,AUT,0,0,5,5,10
2008,China,CHN,Austria,AUT,19,14,162,98,293
2008,Cameroon,CMR,Austria,AUT,29,0,24,10,63
2008,Congo,COG,Austria,AUT,10,5,5,0,20
2008,Dem. Rep. of the Congo,COD,Austria,AUT,27,5,5,11,48
2008,Eritrea,ERI,Austria,AUT,5,0,5,0,10
2008,Estonia,EST,Austria,AUT,5,0,0,0,5
2008,Ethiopia,ETH,Austria,AUT,5,5,10,5,25
2008,Gambia,GMB,Austria,AUT,5,5,93,42,145
2008,Georgia,GEO,Austria,AUT,61,49,380,129,619
2008,Ghana,GHA,Austria,AUT,5,0,37,15,57
2008,Guinea-Bissau,GNB,Austria,AUT,0,0,5,16,21
2008,Guatemala,GTM,Austria,AUT,5,0,0,0,5
2008,Guinea,GIN,Austria,AUT,5,0,16,17,38
2008,Croatia,HRV,Austria,AUT,0,0,5,0,5
2008,Hungary,HUN,Austria,AUT,0,0,0,5,5
2008,Cote d'Ivoire,CIV,Austria,AUT,5,0,5,5,15
2008,India,IND,Austria,AUT,5,5,438,179,627
2008,Iran (Islamic Rep. of),IRN,Austria,AUT,198,16,78,51,343
2008,Iraq,IRQ,Austria,AUT,240,146,95,64,545
2008,Israel,ISR,Austria,AUT,0,0,0,5,5
2008,Italy,ITA,Austria,AUT,0,0,0,5,5
2008,Kazakhstan,KAZ,Austria,AUT,5,0,12,5,22
2008,Kenya,KEN,Austria,AUT,0,0,5,0,5
2008,Kyrgyzstan,KGZ,Austria,AUT,43,5,38,39,125
2008,Liberia,LBR,Austria,AUT,0,0,25,19,44
2008,Libya,LBY,Austria,AUT,0,0,0,5,5
2008,Lebanon,LBN,Austria,AUT,0,0,26,18,44
2008,Sri Lanka,LKA,Austria,AUT,5,0,5,15,25
2008,Mauritania,MRT,Austria,AUT,0,0,5,0,5
2008,North Macedonia,MKD,Austria,AUT,11,11,229,74,325
2008,Rep. of Moldova,MDA,Austria,AUT,10,5,182,166,363
2008,Mali,MLI,Austria,AUT,0,0,5,10,15
2008,Mongolia,MNG,Austria,AUT,20,18,94,89,221
2008,Morocco,MAR,Austria,AUT,0,0,72,20,92
2008,Montenegro,MNE,Austria,AUT,0,10,18,0,28
2008,Myanmar,MMR,Austria,AUT,5,0,0,0,5
2008,Nepal,NPL,Austria,AUT,5,0,12,10,27
2008,Nigeria,NGA,Austria,AUT,12,20,671,323,1026
2008,Pakistan,PAK,Austria,AUT,12,5,53,70,140
2008,Philippines,PHL,Austria,AUT,0,0,5,0,5
2008,Romania,ROU,Austria,AUT,0,0,23,20,43
2008,Russian Federation,RUS,Austria,AUT,1557,433,1682,332,4004
2008,Serbia and Kosovo: S/RES/1244 (1999),SRB,Austria,AUT,148,183,1486,625,2442
2008,Senegal,SEN,Austria,AUT,0,0,5,10,15
2008,Sierra Leone,SLE,Austria,AUT,5,0,19,10,34
2008,Somalia,SOM,Austria,AUT,118,37,48,125,328
2008,Viet Nam,VNM,Austria,AUT,5,0,28,10,43
2008,Sudan,SDN,Austria,AUT,15,0,16,17,48
2008,Syrian Arab Rep.,SYR,Austria,AUT,68,5,25,12,110
2008,Tajikistan,TJK,Austria,AUT,0,5,5,0,10
2008,Togo,TGO,Austria,AUT,0,0,5,0,5
2008,Tunisia,TUN,Austria,AUT,0,0,11,5,16
2008,Turkey,TUR,Austria,AUT,246,24,508,251,1029
2008,Uganda,UGA,Austria,AUT,0,0,5,5,10
2008,Ukraine,UKR,Austria,AUT,33,25,204,81,343
2008,Uzbekistan,UZB,Austria,AUT,39,0,15,0,54
2008,Zimbabwe,ZWE,Austria,AUT,5,5,0,0,10
2008,Stateless,XXA,Austria,AUT,55,29,67,43,194
2008,Unknown ,,Austria,AUT,5,5,23,12,45
2008,Sri Lanka,LKA,Bosnia and Herzegovina,BIH,0,0,0,5,5
2008,North Macedonia,MKD,Bosnia and Herzegovina,BIH,0,0,0,5,5
2008,Serbia and Kosovo: S/RES/1244 (1999),SRB,Bosnia and Herzegovina,BIH,0,0,35,183,218
2008,Bolivia (Plurinational State of),BOL,Costa Rica,CRI,10,0,0,0,10
2008,Colombia,COL,Costa Rica,CRI,268,0,542,0,810
2008,Cuba,CUB,Costa Rica,CRI,51,0,16,0,67
2008,Guatemala,GTM,Costa Rica,CRI,0,0,5,0,5
2008,Haiti,HTI,Costa Rica,CRI,5,0,0,0,5
2008,Israel,ISR,Costa Rica,CRI,5,0,0,0,5
2008,Nicaragua,NIC,Costa Rica,CRI,0,0,12,0,12
2008,Peru,PER,Costa Rica,CRI,0,0,5,0,5
2008,El Salvador,SLV,Costa Rica,CRI,5,0,10,0,15
2008,United States of America,USA,Costa Rica,CRI,0,0,5,0,5
2008,Venezuela (Bolivarian Republic of),VEN,Costa Rica,CRI,44,0,26,0,70
2008,Afghanistan,AFG,Ecuador,ECU,0,10,0,0,10
2008,Argentina,ARG,Ecuador,ECU,0,0,5,0,5
2008,Bolivia (Plurinational State of),BOL,Ecuador,ECU,0,0,10,0,10
2008,China,CHN,Ecuador,ECU,0,0,13,0,13
2008,Chile,CHL,Ecuador,ECU,0,0,10,0,10
2008,Cameroon,CMR,Ecuador,ECU,0,0,10,0,10
2008,Colombia,COL,Ecuador,ECU,35,4296,3824,220,8375
2008,Cuba,CUB,Ecuador,ECU,0,57,25,0,82
2008,Dominican Rep.,DOM,Ecuador,ECU,0,0,27,0,27
2008,Haiti,HTI,Ecuador,ECU,0,0,5,5,10
2008,Honduras,HND,Ecuador,ECU,0,5,0,0,5
2008,Rep. of Korea,KOR,Ecuador,ECU,0,0,5,0,5
2008,Nepal,NPL,Ecuador,ECU,0,5,5,0,10
2008,Peru,PER,Ecuador,ECU,0,17,2360,70,2447
2008,South Africa,ZAF,Ecuador,ECU,0,0,5,0,5
2008,Stateless,XXA,Ecuador,ECU,0,0,5,0,5
2008,Unknown ,,Ecuador,ECU,0,31,10,10,51
2008,Chad,TCD,Gabon,GAB,5,0,5,0,10
2008,Congo,COG,Gabon,GAB,5,0,5,203,213
2008,Dem. Rep. of the Congo,COD,Gabon,GAB,0,0,5,13,18
2008,Togo,TGO,Gabon,GAB,0,0,5,0,5
2008,Azerbaijan,AZE,Georgia,GEO,0,0,0,5,5
2008,Iraq,IRQ,Georgia,GEO,5,0,0,0,5
2008,Russian Federation,RUS,Georgia,GEO,14,0,0,0,14
2008,Central African Rep.,CAF,Guinea,GIN,0,0,0,5,5
2008,Chad,TCD,Guinea,GIN,13,0,0,5,18
2008,Cameroon,CMR,Guinea,GIN,0,0,0,5,5
2008,Congo,COG,Guinea,GIN,0,0,0,5,5
2008,Dem. Rep. of the Congo,COD,Guinea,GIN,0,0,0,43,43
2008,Guinea-Bissau,GNB,Guinea,GIN,0,0,0,10,10
2008,Cote d'Ivoire,CIV,Guinea,GIN,5,0,0,730,735
2008,Liberia,LBR,Guinea,GIN,0,0,5,1117,1122
2008,Nigeria,NGA,Guinea,GIN,0,0,0,5,5
2008,Sierra Leone,SLE,Guinea,GIN,0,0,0,1777,1777
2008,Afghanistan,AFG,Cote d'Ivoire,CIV,0,0,0,5,5
2008,Angola,AGO,Cote d'Ivoire,CIV,0,0,0,5,5
2008,Burundi,BDI,Cote d'Ivoire,CIV,0,0,0,5,5
2008,Central African Rep.,CAF,Cote d'Ivoire,CIV,0,0,5,172,177
2008,Chad,TCD,Cote d'Ivoire,CIV,0,0,5,5,10
2008,Cameroon,CMR,Cote d'Ivoire,CIV,0,0,0,12,12
2008,Congo,COG,Cote d'Ivoire,CIV,5,0,59,572,636
2008,Dem. Rep. of the Congo,COD,Cote d'Ivoire,CIV,11,0,40,102,153
2008,Palestinian,PSE,Cote d'Ivoire,CIV,0,0,0,5,5
2008,Ghana,GHA,Cote d'Ivoire,CIV,0,0,0,5,5
2008,Guinea,GIN,Cote d'Ivoire,CIV,0,0,5,29,34
2008,Liberia,LBR,Cote d'Ivoire,CIV,0,0,10,0,10
2008,Sri Lanka,LKA,Cote d'Ivoire,CIV,0,0,0,10,10
2008,Mauritania,MRT,Cote d'Ivoire,CIV,0,0,0,5,5
2008,Nigeria,NGA,Cote d'Ivoire,CIV,0,0,28,0,28
2008,Romania,ROU,Cote d'Ivoire,CIV,0,0,0,5,5
2008,Rwanda,RWA,Cote d'Ivoire,CIV,5,0,0,44,49
2008,Sierra Leone,SLE,Cote d'Ivoire,CIV,0,0,30,294,324
2008,Togo,TGO,Cote d'Ivoire,CIV,0,0,46,47,93
2008,Egypt,EGY,Rep. of Korea,KOR,0,0,0,5,5
2008,Bangladesh,BGD,Rep. of Korea,KOR,0,0,5,0,5
2008,China,CHN,Rep. of Korea,KOR,0,0,13,10,23
2008,Cameroon,CMR,Rep. of Korea,KOR,0,0,0,5,5
2008,Dem. Rep. of the Congo,COD,Rep. of Korea,KOR,10,0,0,0,10
2008,Ethiopia,ETH,Rep. of Korea,KOR,0,11,0,0,11
2008,Ghana,GHA,Rep. of Korea,KOR,0,0,5,5,10
2008,Sri Lanka,LKA,Rep. of Korea,KOR,0,0,0,17,17
2008,Myanmar,MMR,Rep. of Korea,KOR,18,10,0,5,33
2008,Nepal,NPL,Rep. of Korea,KOR,0,0,33,31,64
2008,Nigeria,NGA,Rep. of Korea,KOR,0,0,5,5,10
2008,South Africa,ZAF,Rep. of Korea,KOR,0,0,0,5,5
2008,Uganda,UGA,Rep. of Korea,KOR,0,0,5,10,15
2008,Afghanistan,AFG,North Macedonia,MKD,0,0,0,5,5
2008,Serbia and Kosovo: S/RES/1244 (1999),SRB,North Macedonia,MKD,0,46,17,47,110
2008,Afghanistan,AFG,Rep. of Moldova,MDA,0,0,0,5,5
2008,Armenia,ARM,Rep. of Moldova,MDA,0,5,19,0,24
2008,Azerbaijan,AZE,Rep. of Moldova,MDA,0,5,0,0,5
2008,Jordan,JOR,Rep. of Moldova,MDA,0,0,5,0,5
2008,Russian Federation,RUS,Rep. of Moldova,MDA,5,5,0,0,10
2008,Sudan,SDN,Rep. of Moldova,MDA,0,0,5,0,5
2008,Syrian Arab Rep.,SYR,Rep. of Moldova,MDA,0,0,0,5,5
2008,Turkey,TUR,Rep. of Moldova,MDA,0,0,5,0,5
2008,Uzbekistan,UZB,Rep. of Moldova,MDA,0,0,5,0,5
2008,Burundi,BDI,Malawi,MWI,311,0,0,39,350
2008,Dem. Rep. of the Congo,COD,Malawi,MWI,844,0,0,12,856
2008,Rwanda,RWA,Malawi,MWI,71,0,231,121,423
2008,Somalia,SOM,Malawi,MWI,13,0,0,22,35
2008,Sudan,SDN,Malawi,MWI,5,0,0,0,5
2008,Dem. Rep. of the Congo,COD,Portugal,PRT,5,5,0,0,10
2008,Colombia,COL,Portugal,PRT,0,17,5,0,22
2008,Eritrea,ERI,Portugal,PRT,5,5,0,0,10
2008,Guinea-Bissau,GNB,Portugal,PRT,5,0,0,0,5
2008,Guinea,GIN,Portugal,PRT,0,5,5,0,10
2008,Sri Lanka,LKA,Portugal,PRT,0,5,0,0,5
2008,Nigeria,NGA,Portugal,PRT,0,5,5,0,10
2008,Russian Federation,RUS,Portugal,PRT,0,0,5,0,5
2008,Senegal,SEN,Portugal,PRT,0,0,5,0,5
2008,Somalia,SOM,Portugal,PRT,0,19,0,0,19
2008,Afghanistan,AFG,Romania,ROU,0,0,5,0,5
2008,Albania,ALB,Romania,ROU,0,0,0,5,5
2008,Bangladesh,BGD,Romania,ROU,0,0,143,0,143
2008,Bulgaria,BGR,Romania,ROU,0,0,5,0,5
2008,China,CHN,Romania,ROU,0,0,43,5,48
2008,Cameroon,CMR,Romania,ROU,0,0,10,0,10
2008,Congo,COG,Romania,ROU,0,0,5,0,5
2008,Cuba,CUB,Romania,ROU,0,0,5,0,5
2008,Ecuador,ECU,Romania,ROU,0,0,5,0,5
2008,Georgia,GEO,Romania,ROU,0,0,46,0,46
2008,Guinea,GIN,Romania,ROU,0,0,5,0,5
2008,Cote d'Ivoire,CIV,Romania,ROU,0,0,5,0,5
2008,India,IND,Romania,ROU,0,0,122,0,122
2008,Iran (Islamic Rep. of),IRN,Romania,ROU,0,0,5,0,5
2008,Iraq,IRQ,Romania,ROU,89,0,83,15,187
2008,Israel,ISR,Romania,ROU,0,0,5,0,5
2008,Lebanon,LBN,Romania,ROU,0,0,5,5,10
2008,Rep. of Moldova,MDA,Romania,ROU,0,0,11,0,11
2008,Morocco,MAR,Romania,ROU,0,0,0,5,5
2008,Pakistan,PAK,Romania,ROU,0,0,228,0,228
2008,Russian Federation,RUS,Romania,ROU,0,0,11,0,11
2008,Serbia and Kosovo: S/RES/1244 (1999),SRB,Romania,ROU,10,0,14,14,38
2008,Senegal,SEN,Romania,ROU,0,0,5,0,5
2008,Somalia,SOM,Romania,ROU,10,0,5,0,15
2008,Sudan,SDN,Romania,ROU,0,0,5,0,5
2008,Syrian Arab Rep.,SYR,Romania,ROU,0,0,10,0,10
2008,Turkey,TUR,Romania,ROU,0,0,48,18,66
2008,Eritrea,ERI,El Salvador,SLV,0,0,0,5,5
2008,Burundi,BDI,United Rep. of Tanzania,TZA,39,0,0,0,39
2008,Dem. Rep. of the Congo,COD,United Rep. of Tanzania,TZA,15,0,0,0,15
2008,Myanmar,MMR,Thailand,THA,755,0,150,40,945
2009,Afghanistan,AFG,Austria,AUT,587,535,585,267,1974
2009,Albania,ALB,Austria,AUT,5,5,45,34,89
2009,Algeria,DZA,Austria,AUT,0,5,221,62,288
2009,Angola,AGO,Austria,AUT,12,5,10,5,32
2009,Egypt,EGY,Austria,AUT,5,5,39,13,62
2009,Armenia,ARM,Austria,AUT,44,39,617,35,735
2009,Azerbaijan,AZE,Austria,AUT,24,5,92,31,152
2009,Burundi,BDI,Austria,AUT,5,0,5,0,10
2009,Benin,BEN,Austria,AUT,0,0,5,0,5
2009,Bangladesh,BGD,Austria,AUT,14,5,44,28,91
2009,Belarus,BLR,Austria,AUT,5,16,108,20,149
2009,Bosnia and Herzegovina,BIH,Austria,AUT,10,10,60,26,106
2009,Bulgaria,BGR,Austria,AUT,0,0,5,0,5
2009,China,CHN,Austria,AUT,48,5,451,124,628
2009,Cameroon,CMR,Austria,AUT,30,0,25,5,60
2009,Congo,COG,Austria,AUT,15,0,5,0,20
2009,Dem. Rep. of the Congo,COD,Austria,AUT,29,5,13,15,62
2009,Cuba,CUB,Austria,AUT,5,0,0,0,5
2009,Eritrea,ERI,Austria,AUT,10,5,5,0,20
2009,Ethiopia,ETH,Austria,AUT,13,5,5,0,23
2009,Gabon,GAB,Austria,AUT,0,0,5,0,5
2009,Gambia,GMB,Austria,AUT,13,0,139,21,173
2009,Georgia,GEO,Austria,AUT,62,60,1095,173,1390
2009,Ghana,GHA,Austria,AUT,0,5,71,10,86
2009,Guinea-Bissau,GNB,Austria,AUT,0,0,13,10,23
2009,Guinea,GIN,Austria,AUT,0,0,22,5,27
2009,Croatia,HRV,Austria,AUT,0,0,10,0,10
2009,Cote d'Ivoire,CIV,Austria,AUT,5,0,5,0,10
2009,India,IND,Austria,AUT,5,11,581,140,737
2009,Iran (Islamic Rep. of),IRN,Austria,AUT,153,17,98,63,331
2009,Iraq,IRQ,Austria,AUT,177,114,71,86,448
2009,Israel,ISR,Austria,AUT,0,0,13,0,13
2009,Jordan,JOR,Austria,AUT,0,0,5,5,10
2009,Kazakhstan,KAZ,Austria,AUT,5,0,30,10,45
2009,Kenya,KEN,Austria,AUT,5,0,5,0,10
2009,Kyrgyzstan,KGZ,Austria,AUT,26,12,49,10,97
2009,Liberia,LBR,Austria,AUT,0,5,35,10,50
2009,Libya,LBY,Austria,AUT,0,0,5,5,10
2009,Lebanon,LBN,Austria,AUT,0,5,24,11,40
2009,Sri Lanka,LKA,Austria,AUT,12,0,5,10,27
2009,Mauritania,MRT,Austria,AUT,0,0,5,0,5
2009,North Macedonia,MKD,Austria,AUT,0,31,362,49,442
2009,Rep. of Moldova,MDA,Austria,AUT,5,5,284,94,388
2009,Mali,MLI,Austria,AUT,0,0,5,0,5
2009,Mongolia,MNG,Austria,AUT,5,12,266,76,359
2009,Morocco,MAR,Austria,AUT,0,5,104,33,142
2009,Montenegro,MNE,Austria,AUT,0,0,5,0,5
2009,Nepal,NPL,Austria,AUT,5,5,45,10,65
2009,Niger,NER,Austria,AUT,0,0,11,0,11
2009,Nigeria,NGA,Austria,AUT,16,27,999,225,1267
2009,Pakistan,PAK,Austria,AUT,0,5,162,45,212
2009,Philippines,PHL,Austria,AUT,0,0,5,0,5
2009,Poland,POL,Austria,AUT,0,0,5,5,10
2009,Romania,ROU,Austria,AUT,0,0,17,5,22
2009,Russian Federation,RUS,Austria,AUT,1398,312,2731,561,5002
2009,Rwanda,RWA,Austria,AUT,10,0,5,0,15
2009,Serbia and Kosovo: S/RES/1244 (1999),SRB,Austria,AUT,90,118,2253,724,3185
2009,Senegal,SEN,Austria,AUT,0,0,5,5,10
2009,Sierra Leone,SLE,Austria,AUT,0,0,16,5,21
2009,Somalia,SOM,Austria,AUT,149,54,60,90,353
2009,Viet Nam,VNM,Austria,AUT,0,0,69,5,74
2009,Sudan,SDN,Austria,AUT,11,0,21,12,44
2009,Slovakia,SVK,Austria,AUT,0,0,5,0,5
2009,Syrian Arab Rep.,SYR,Austria,AUT,51,0,80,11,142
2009,Tajikistan,TJK,Austria,AUT,5,0,5,5,15
2009,Togo,TGO,Austria,AUT,5,0,5,0,10
2009,Tunisia,TUN,Austria,AUT,0,0,22,10,32
2009,Turkey,TUR,Austria,AUT,93,24,942,149,1208
2009,Uganda,UGA,Austria,AUT,0,0,0,5,5
2009,Ukraine,UKR,Austria,AUT,13,26,259,41,339
2009,United States of America,USA,Austria,AUT,0,0,0,5,5
2009,Uzbekistan,UZB,Austria,AUT,11,10,25,5,51
2009,Zimbabwe,ZWE,Austria,AUT,0,0,5,5,10
2009,Stateless,XXA,Austria,AUT,34,10,91,31,166
2009,Unknown ,,Austria,AUT,5,5,25,5,40
2009,India,IND,Bosnia and Herzegovina,BIH,0,0,0,5,5
2009,Serbia and Kosovo: S/RES/1244 (1999),SRB,Bosnia and Herzegovina,BIH,0,5,93,53,151
2009,Colombia,COL,Costa Rica,CRI,337,0,486,0,823
2009,Cuba,CUB,Costa Rica,CRI,43,0,5,0,48
2009,Ethiopia,ETH,Costa Rica,CRI,5,0,0,0,5
2009,Guatemala,GTM,Costa Rica,CRI,5,0,5,0,10
2009,Haiti,HTI,Costa Rica,CRI,5,0,0,0,5
2009,Honduras,HND,Costa Rica,CRI,0,0,13,0,13
2009,Iraq,IRQ,Costa Rica,CRI,5,0,0,0,5
2009,Nicaragua,NIC,Costa Rica,CRI,0,0,25,0,25
2009,El Salvador,SLV,Costa Rica,CRI,10,0,44,0,54
2009,United States of America,USA,Costa Rica,CRI,0,0,5,0,5
2009,Venezuela (Bolivarian Republic of),VEN,Costa Rica,CRI,41,0,10,0,51
2009,Afghanistan,AFG,Ecuador,ECU,25,0,0,0,25
2009,Argentina,ARG,Ecuador,ECU,0,0,5,0,5
2009,China,CHN,Ecuador,ECU,0,0,11,0,11
2009,Chile,CHL,Ecuador,ECU,0,0,5,0,5
2009,Colombia,COL,Ecuador,ECU,26223,0,1686,91,28000
2009,Cuba,CUB,Ecuador,ECU,34,0,569,17,620
2009,Dominican Rep.,DOM,Ecuador,ECU,0,0,15,0,15
2009,Haiti,HTI,Ecuador,ECU,5,0,43,0,48
2009,Sri Lanka,LKA,Ecuador,ECU,5,0,0,0,5
2009,Nepal,NPL,Ecuador,ECU,0,0,5,0,5
2009,Nigeria,NGA,Ecuador,ECU,5,0,5,0,10
2009,Pakistan,PAK,Ecuador,ECU,12,0,5,0,17
2009,Peru,PER,Ecuador,ECU,5,0,1009,35,1049
2009,South Africa,ZAF,Ecuador,ECU,0,0,5,0,5
2009,Russian Federation,RUS,Ecuador,ECU,5,0,0,0,5
2009,United States of America,USA,Ecuador,ECU,0,0,5,0,5
2009,Venezuela (Bolivarian Republic of),VEN,Ecuador,ECU,0,0,5,0,5
2009,Zimbabwe,ZWE,Ecuador,ECU,5,0,0,0,5
2009,Central African Rep.,CAF,Gabon,GAB,0,0,0,5,5
2009,Chad,TCD,Gabon,GAB,0,0,0,5,5
2009,Congo,COG,Gabon,GAB,5,0,5,72,82
2009,Dem. Rep. of the Congo,COD,Gabon,GAB,0,0,0,11,11
2009,Cote d'Ivoire,CIV,Gabon,GAB,0,0,0,5,5
2009,Iran (Islamic Rep. of),IRN,Georgia,GEO,0,0,5,0,5
2009,Russian Federation,RUS,Georgia,GEO,5,0,10,5,20
2009,Afghanistan,AFG,Hungary,HUN,5,140,167,736,1048
2009,Albania,ALB,Hungary,HUN,0,0,0,24,24
2009,Algeria,DZA,Hungary,HUN,0,0,5,31,36
2009,Egypt,EGY,Hungary,HUN,0,0,10,44,54
2009,Armenia,ARM,Hungary,HUN,0,0,5,15,20
2009,Bangladesh,BGD,Hungary,HUN,0,0,0,24,24
2009,Bosnia and Herzegovina,BIH,Hungary,HUN,0,0,5,17,22
2009,China,CHN,Hungary,HUN,0,0,33,216,249
2009,Cameroon,CMR,Hungary,HUN,0,0,5,0,5
2009,Dem. Rep. of the Congo,COD,Hungary,HUN,5,0,0,0,5
2009,Cuba,CUB,Hungary,HUN,5,0,0,5,10
2009,Ethiopia,ETH,Hungary,HUN,0,0,0,5,5
2009,Palestinian,PSE,Hungary,HUN,10,5,5,10,30
2009,Georgia,GEO,Hungary,HUN,0,10,25,126,161
2009,Ghana,GHA,Hungary,HUN,0,0,5,5,10
2009,Guinea,GIN,Hungary,HUN,0,0,5,0,5
2009,Cote d'Ivoire,CIV,Hungary,HUN,0,5,18,0,23
2009,India,IND,Hungary,HUN,0,0,5,0,5
2009,Indonesia,IDN,Hungary,HUN,0,0,0,5,5
2009,Iran (Islamic Rep. of),IRN,Hungary,HUN,10,0,10,38,58
2009,Iraq,IRQ,Hungary,HUN,11,24,19,48,102
2009,Jordan,JOR,Hungary,HUN,0,0,5,0,5
2009,Liberia,LBR,Hungary,HUN,0,0,5,0,5
2009,Lebanon,LBN,Hungary,HUN,0,0,0,19,19
2009,Sri Lanka,LKA,Hungary,HUN,0,0,0,23,23
2009,North Macedonia,MKD,Hungary,HUN,0,0,10,52,62
2009,Rep. of Moldova,MDA,Hungary,HUN,0,0,11,22,33
2009,Mongolia,MNG,Hungary,HUN,0,0,10,40,50
2009,Montenegro,MNE,Hungary,HUN,0,0,0,10,10
2009,Nigeria,NGA,Hungary,HUN,0,0,37,56,93
2009,Pakistan,PAK,Hungary,HUN,0,0,10,51,61
2009,Romania,ROU,Hungary,HUN,0,0,0,5,5
2009,Russian Federation,RUS,Hungary,HUN,0,0,10,13,23
2009,Serbia and Kosovo: S/RES/1244 (1999),SRB,Hungary,HUN,0,5,829,2441,3275
2009,Somalia,SOM,Hungary,HUN,100,13,11,63,187
2009,Viet Nam,VNM,Hungary,HUN,0,0,32,505,537
2009,Slovakia,SVK,Hungary,HUN,0,0,0,11,11
2009,Syrian Arab Rep.,SYR,Hungary,HUN,0,0,10,37,47
2009,Tunisia,TUN,Hungary,HUN,5,0,0,0,5
2009,Turkey,TUR,Hungary,HUN,0,0,19,120,139
2009,Ukraine,UKR,Hungary,HUN,0,0,0,5,5
2009,Unknown ,,Hungary,HUN,10,5,0,0,15
2009,Burundi,BDI,Cote d'Ivoire,CIV,0,0,0,5,5
2009,Chad,TCD,Cote d'Ivoire,CIV,14,0,0,0,14
2009,Congo,COG,Cote d'Ivoire,CIV,0,0,14,10,24
2009,Dem. Rep. of the Congo,COD,Cote d'Ivoire,CIV,5,0,47,0,52
2009,Equatorial Guinea,GNQ,Cote d'Ivoire,CIV,0,0,0,5,5
2009,Liberia,LBR,Cote d'Ivoire,CIV,0,0,10,18,28
2009,Nigeria,NGA,Cote d'Ivoire,CIV,0,0,24,0,24
2009,Rwanda,RWA,Cote d'Ivoire,CIV,0,0,0,17,17
2009,Sierra Leone,SLE,Cote d'Ivoire,CIV,0,0,15,12,27
2009,Togo,TGO,Cote d'Ivoire,CIV,5,0,20,42,67
2009,Egypt,EGY,Rep. of Korea,KOR,0,0,5,0,5
2009,Bangladesh,BGD,Rep. of Korea,KOR,21,0,25,10,56
2009,China,CHN,Rep. of Korea,KOR,0,0,86,10,96
2009,Cameroon,CMR,Rep. of Korea,KOR,0,0,5,0,5
2009,Dem. Rep. of the Congo,COD,Rep. of Korea,KOR,0,0,23,0,23
2009,Ethiopia,ETH,Rep. of Korea,KOR,5,0,14,0,19
2009,Ghana,GHA,Rep. of Korea,KOR,0,0,74,10,84
2009,Cote d'Ivoire,CIV,Rep. of Korea,KOR,0,0,36,10,46
2009,Iran (Islamic Rep. of),IRN,Rep. of Korea,KOR,0,0,10,5,15
2009,Kenya,KEN,Rep. of Korea,KOR,0,0,5,0,5
2009,Liberia,LBR,Rep. of Korea,KOR,0,0,24,5,29
2009,Sri Lanka,LKA,Rep. of Korea,KOR,0,0,128,30,158
2009,Myanmar,MMR,Rep. of Korea,KOR,37,5,62,14,118
2009,Nepal,NPL,Rep. of Korea,KOR,0,5,229,62,296
2009,Nigeria,NGA,Rep. of Korea,KOR,0,0,108,13,121
2009,Pakistan,PAK,Rep. of Korea,KOR,0,0,61,11,72
2009,South Africa,ZAF,Rep. of Korea,KOR,0,0,0,5,5
2009,Russian Federation,RUS,Rep. of Korea,KOR,0,0,0,5,5
2009,Togo,TGO,Rep. of Korea,KOR,0,0,5,0,5
2009,Uganda,UGA,Rep. of Korea,KOR,5,5,87,12,109
2009,Afghanistan,AFG,North Macedonia,MKD,0,0,0,69,69
2009,Albania,ALB,North Macedonia,MKD,0,0,0,5,5
2009,Serbia and Kosovo: S/RES/1244 (1999),SRB,North Macedonia,MKD,0,0,19,12,31
2009,Afghanistan,AFG,Rep. of Moldova,MDA,0,5,0,0,5
2009,Armenia,ARM,Rep. of Moldova,MDA,0,10,11,0,21
2009,Pakistan,PAK,Rep. of Moldova,MDA,0,5,0,0,5
2009,Russian Federation,RUS,Rep. of Moldova,MDA,0,5,5,0,10
2009,Spain,ESP,Rep. of Moldova,MDA,0,0,5,0,5
2009,Syrian Arab Rep.,SYR,Rep. of Moldova,MDA,0,0,5,0,5
2009,Albania,ALB,Montenegro,MNE,0,0,0,5,5
2009,North Macedonia,MKD,Montenegro,MNE,0,0,5,0,5
2009,Serbia and Kosovo: S/RES/1244 (1999),SRB,Montenegro,MNE,0,0,5,0,5
2009,Central African Rep.,CAF,Nigeria,NGA,0,0,0,5,5
2009,Cameroon,CMR,Nigeria,NGA,0,0,0,22,22
2009,Guinea,GIN,Nigeria,NGA,0,0,0,5,5
2009,Cote d'Ivoire,CIV,Nigeria,NGA,0,0,0,21,21
2009,Liberia,LBR,Nigeria,NGA,0,0,0,180,180
2009,Lebanon,LBN,Nigeria,NGA,0,0,0,5,5
2009,Sierra Leone,SLE,Nigeria,NGA,0,0,0,98,98
2009,Sudan,SDN,Nigeria,NGA,0,0,0,15,15
2009,Togo,TGO,Nigeria,NGA,0,0,0,12,12
2009,Colombia,COL,Paraguay,PRY,5,0,0,0,5
2009,Cuba,CUB,Paraguay,PRY,5,0,0,5,10
2009,Iraq,IRQ,Paraguay,PRY,5,0,0,0,5
2009,Afghanistan,AFG,Romania,ROU,14,5,37,0,56
2009,Albania,ALB,Romania,ROU,0,0,0,5,5
2009,Egypt,EGY,Romania,ROU,0,0,12,5,17
2009,Bangladesh,BGD,Romania,ROU,0,0,84,5,89
2009,China,CHN,Romania,ROU,0,0,60,24,84
2009,Cameroon,CMR,Romania,ROU,5,0,15,0,20
2009,Congo,COG,Romania,ROU,5,0,5,0,10
2009,Dem. Rep. of the Congo,COD,Romania,ROU,0,0,23,0,23
2009,Palestinian,PSE,Romania,ROU,0,0,5,0,5
2009,Georgia,GEO,Romania,ROU,0,0,24,0,24
2009,Guinea,GIN,Romania,ROU,0,0,5,0,5
2009,Cote d'Ivoire,CIV,Romania,ROU,0,0,5,0,5
2009,India,IND,Romania,ROU,0,0,64,0,64
2009,Iran (Islamic Rep. of),IRN,Romania,ROU,0,0,10,0,10
2009,Iraq,IRQ,Romania,ROU,27,13,53,5,98
2009,Israel,ISR,Romania,ROU,0,0,5,0,5
2009,Lebanon,LBN,Romania,ROU,0,0,0,5,5
2009,Sri Lanka,LKA,Romania,ROU,0,0,5,0,5
2009,Rep. of Moldova,MDA,Romania,ROU,5,0,111,26,142
2009,Nigeria,NGA,Romania,ROU,0,0,11,5,16
2009,Pakistan,PAK,Romania,ROU,0,0,119,5,124
2009,Russian Federation,RUS,Romania,ROU,0,0,5,0,5
2009,Serbia and Kosovo: S/RES/1244 (1999),SRB,Romania,ROU,0,0,5,15,20
2009,Senegal,SEN,Romania,ROU,0,0,5,0,5
2009,Somalia,SOM,Romania,ROU,5,0,10,0,15
2009,Syrian Arab Rep.,SYR,Romania,ROU,0,0,12,10,22
2009,Turkey,TUR,Romania,ROU,5,0,74,26,105
2009,Ukraine,UKR,Romania,ROU,0,0,5,0,5
2009,Colombia,COL,El Salvador,SLV,0,0,0,5,5
2009,Eritrea,ERI,El Salvador,SLV,0,0,0,26,26
2009,Nepal,NPL,El Salvador,SLV,0,0,0,5,5
2009,Somalia,SOM,El Salvador,SLV,0,0,0,5,5
2009,Central African Rep.,CAF,Sudan,SDN,16,0,0,0,16
2009,Chad,TCD,Sudan,SDN,81,0,0,0,81
2009,Eritrea,ERI,Sudan,SDN,10103,0,23,0,10126
2009,Ethiopia,ETH,Sudan,SDN,245,0,0,0,245
2009,Somalia,SOM,Sudan,SDN,42,0,0,0,42
2009,Burundi,BDI,United Rep. of Tanzania,TZA,5,0,0,175,180
2009,Dem. Rep. of the Congo,COD,United Rep. of Tanzania,TZA,31,0,12,49,92
2009,Rwanda,RWA,United Rep. of Tanzania,TZA,10,0,0,0,10
2009,Sudan,SDN,United Rep. of Tanzania,TZA,0,0,10,0,10
2009,Myanmar,MMR,Thailand,THA,6809,0,1128,0,7937
2009,Afghanistan,AFG,Tajikistan,TJK,894,0,200,0,1094
2009,Burundi,BDI,Uganda,UGA,607,0,46,35,688
2009,Dem. Rep. of the Congo,COD,Uganda,UGA,4426,0,14,237,4677
2009,Eritrea,ERI,Uganda,UGA,2277,0,0,174,2451
2009,Ethiopia,ETH,Uganda,UGA,331,0,41,48,420
2009,Kenya,KEN,Uganda,UGA,159,0,5,47,211
2009,Pakistan,PAK,Uganda,UGA,5,0,0,0,5
2009,Rwanda,RWA,Uganda,UGA,571,0,127,3722,4420
2009,Somalia,SOM,Uganda,UGA,1942,0,0,366,2308
2009,Sudan,SDN,Uganda,UGA,2797,0,26,122,2945
2009,Colombia,COL,Venezuela (Bolivarian Republic of),VEN,210,0,226,0,436
2009,Iran (Islamic Rep. of),IRN,Venezuela (Bolivarian Republic of),VEN,5,0,0,0,5
2009,Burundi,BDI,Zambia,ZMB,5,0,10,5,20
2009,Dem. Rep. of the Congo,COD,Zambia,ZMB,92,0,55,20,167
2009,Ethiopia,ETH,Zambia,ZMB,0,0,0,5,5
2009,Iraq,IRQ,Zambia,ZMB,0,0,5,0,5
2009,Rwanda,RWA,Zambia,ZMB,5,0,10,5,20
2009,Somalia,SOM,Zambia,ZMB,22,0,0,34,56
2009,Uganda,UGA,Zambia,ZMB,0,0,10,0,10
2009,Zimbabwe,ZWE,Zambia,ZMB,0,0,5,0,5
2010,Chad,TCD,Angola,AGO,16,0,0,0,16
2010,Dem. Rep. of the Congo,COD,Angola,AGO,16,0,0,0,16
2010,Guinea,GIN,Angola,AGO,16,0,0,0,16
2010,Cote d'Ivoire,CIV,Angola,AGO,21,0,0,0,21
2010,Mauritania,MRT,Angola,AGO,19,0,0,0,19
2010,Rwanda,RWA,Angola,AGO,13,0,0,0,13
2010,Sudan,SDN,Angola,AGO,24,0,0,0,24
2010,Unknown ,,Angola,AGO,11,0,0,0,11
2010,Afghanistan,AFG,Austria,AUT,584,669,962,165,2380
2010,Albania,ALB,Austria,AUT,11,0,86,13,110
2010,Algeria,DZA,Austria,AUT,5,0,243,85,333
2010,Angola,AGO,Austria,AUT,11,5,5,5,26
2010,Egypt,EGY,Austria,AUT,0,5,43,19,67
2010,Armenia,ARM,Austria,AUT,22,56,741,50,869
2010,Azerbaijan,AZE,Austria,AUT,46,27,130,14,217
2010,Burundi,BDI,Austria,AUT,0,0,10,0,10
2010,Benin,BEN,Austria,AUT,0,0,10,0,10
2010,Bangladesh,BGD,Austria,AUT,13,5,63,21,102
2010,Burkina Faso,BFA,Austria,AUT,0,0,5,0,5
2010,Belarus,BLR,Austria,AUT,5,11,103,15,134
2010,Bolivia (Plurinational State of),BOL,Austria,AUT,10,0,5,0,15
2010,Bosnia and Herzegovina,BIH,Austria,AUT,5,11,111,17,144
2010,Bulgaria,BGR,Austria,AUT,0,0,0,5,5
2010,China,CHN,Austria,AUT,32,10,468,120,630
2010,Chile,CHL,Austria,AUT,0,0,5,0,5
2010,Cameroon,CMR,Austria,AUT,18,0,43,5,66
2010,Congo,COG,Austria,AUT,11,5,5,5,26
2010,Dem. Rep. of the Congo,COD,Austria,AUT,52,5,16,10,83
2010,Cuba,CUB,Austria,AUT,0,0,5,0,5
2010,Eritrea,ERI,Austria,AUT,15,0,5,0,20
2010,Ethiopia,ETH,Austria,AUT,15,5,5,5,30
2010,Gambia,GMB,Austria,AUT,20,5,135,24,184
2010,Georgia,GEO,Austria,AUT,25,54,849,101,1029
2010,Ghana,GHA,Austria,AUT,0,5,87,5,97
2010,Guinea-Bissau,GNB,Austria,AUT,0,0,12,20,32
2010,Guinea,GIN,Austria,AUT,10,5,30,11,56
2010,Croatia,HRV,Austria,AUT,0,0,5,0,5
2010,Cote d'Ivoire,CIV,Austria,AUT,5,0,12,0,17
2010,India,IND,Austria,AUT,0,5,606,84,695
2010,Iran (Islamic Rep. of),IRN,Austria,AUT,222,15,141,47,425
2010,Iraq,IRQ,Austria,AUT,81,154,108,48,391
2010,Israel,ISR,Austria,AUT,0,0,12,0,12
2010,Jordan,JOR,Austria,AUT,0,0,5,0,5
2010,Kazakhstan,KAZ,Austria,AUT,5,0,18,5,28
2010,Kenya,KEN,Austria,AUT,0,0,5,5,10
2010,Kyrgyzstan,KGZ,Austria,AUT,10,14,21,5,50
2010,Liberia,LBR,Austria,AUT,0,0,53,5,58
2010,Libya,LBY,Austria,AUT,0,0,10,0,10
2010,Lebanon,LBN,Austria,AUT,0,0,55,17,72
2010,Sri Lanka,LKA,Austria,AUT,5,0,11,5,21
2010,Mauritania,MRT,Austria,AUT,0,0,5,0,5
2010,North Macedonia,MKD,Austria,AUT,0,5,291,55,351
2010,Rep. of Moldova,MDA,Austria,AUT,5,10,178,90,283
2010,Mali,MLI,Austria,AUT,0,0,10,14,24
2010,Mongolia,MNG,Austria,AUT,5,10,378,77,470
2010,Morocco,MAR,Austria,AUT,0,0,126,18,144
2010,Montenegro,MNE,Austria,AUT,0,0,14,0,14
2010,Nepal,NPL,Austria,AUT,5,0,77,17,99
2010,Niger,NER,Austria,AUT,0,0,13,0,13
2010,Nigeria,NGA,Austria,AUT,15,41,1182,216,1454
2010,Pakistan,PAK,Austria,AUT,5,0,185,30,220
2010,Romania,ROU,Austria,AUT,0,0,11,14,25
2010,Russian Federation,RUS,Austria,AUT,1082,341,2183,270,3876
2010,Rwanda,RWA,Austria,AUT,5,0,10,0,15
2010,Serbia and Kosovo: S/RES/1244 (1999),SRB,Austria,AUT,76,96,1772,411,2355
2010,Senegal,SEN,Austria,AUT,0,0,18,10,28
2010,Sierra Leone,SLE,Austria,AUT,0,0,22,5,27
2010,Somalia,SOM,Austria,AUT,189,84,42,50,365
2010,Viet Nam,VNM,Austria,AUT,0,0,10,5,15
2010,Sudan,SDN,Austria,AUT,21,5,19,17,62
2010,Syrian Arab Rep.,SYR,Austria,AUT,117,5,86,25,233
2010,Tajikistan,TJK,Austria,AUT,5,5,10,5,25
2010,Togo,TGO,Austria,AUT,0,0,5,0,5
2010,Tunisia,TUN,Austria,AUT,0,0,28,15,43
2010,Turkey,TUR,Austria,AUT,112,27,934,125,1198
2010,Uganda,UGA,Austria,AUT,0,0,0,5,5
2010,Ukraine,UKR,Austria,AUT,14,15,194,27,250
2010,Uzbekistan,UZB,Austria,AUT,5,0,10,0,15
2010,Zimbabwe,ZWE,Austria,AUT,5,0,10,0,15
2010,Stateless,XXA,Austria,AUT,49,25,137,37,248
2010,Unknown ,,Austria,AUT,10,0,65,11,86
2010,Dem. Rep. of the Congo,COD,Burundi,BDI,4640,349,0,0,4989
2010,Madagascar,MDG,Burundi,BDI,0,0,0,5,5
2010,Mauritania,MRT,Burundi,BDI,10,0,0,0,10
2010,Rwanda,RWA,Burundi,BDI,25,0,0,10,35
2010,Somalia,SOM,Burundi,BDI,16,0,0,0,16
2010,Ethiopia,ETH,Botswana,BWA,0,0,0,5,5
2010,Somalia,SOM,Botswana,BWA,0,0,0,13,13
2010,Zimbabwe,ZWE,Botswana,BWA,12,0,0,0,12
2010,Serbia and Kosovo: S/RES/1244 (1999),SRB,Bosnia and Herzegovina,BIH,0,0,225,22,247
2010,Cuba,CUB,Belize,BLZ,0,0,0,5,5
2010,Guatemala,GTM,Belize,BLZ,0,0,0,5,5
2010,Somalia,SOM,Belize,BLZ,0,0,0,5,5
2010,Afghanistan,AFG,Ecuador,ECU,10,0,5,10,25
2010,Angola,AGO,Ecuador,ECU,0,0,0,5,5
2010,Argentina,ARG,Ecuador,ECU,0,0,5,5,10
2010,Bangladesh,BGD,Ecuador,ECU,0,0,5,0,5
2010,Bolivia (Plurinational State of),BOL,Ecuador,ECU,0,0,5,5,10
2010,Brazil,BRA,Ecuador,ECU,0,0,5,0,5
2010,China,CHN,Ecuador,ECU,0,0,0,26,26
2010,Chile,CHL,Ecuador,ECU,0,0,5,5,10
2010,Cameroon,CMR,Ecuador,ECU,0,0,10,5,15
2010,Colombia,COL,Ecuador,ECU,1346,6520,1206,18248,27320
2010,Cuba,CUB,Ecuador,ECU,0,0,2188,127,2315
2010,Dominican Rep.,DOM,Ecuador,ECU,0,0,21,12,33
2010,Eritrea,ERI,Ecuador,ECU,5,0,5,0,10
2010,Ethiopia,ETH,Ecuador,ECU,0,0,0,5,5
2010,Gambia,GMB,Ecuador,ECU,0,0,0,5,5
2010,Ghana,GHA,Ecuador,ECU,0,0,0,5,5
2010,Guinea,GIN,Ecuador,ECU,0,0,5,0,5
2010,Haiti,HTI,Ecuador,ECU,0,0,79,30,109
2010,Cote d'Ivoire,CIV,Ecuador,ECU,0,0,0,5,5
2010,India,IND,Ecuador,ECU,0,0,5,5,10
2010,Iran (Islamic Rep. of),IRN,Ecuador,ECU,0,0,0,10,10
2010,Iraq,IRQ,Ecuador,ECU,0,0,0,12,12
2010,Liberia,LBR,Ecuador,ECU,0,0,0,5,5
2010,Sri Lanka,LKA,Ecuador,ECU,0,5,5,15,25
2010,Nepal,NPL,Ecuador,ECU,0,0,0,5,5
2010,Nigeria,NGA,Ecuador,ECU,10,0,48,0,58
2010,Pakistan,PAK,Ecuador,ECU,0,0,17,5,22
2010,Peru,PER,Ecuador,ECU,5,0,463,1243,1711
2010,Russian Federation,RUS,Ecuador,ECU,0,0,0,5,5
2010,Serbia and Kosovo: S/RES/1244 (1999),SRB,Ecuador,ECU,0,0,0,5,5
2010,Venezuela (Bolivarian Republic of),VEN,Ecuador,ECU,0,0,5,10,15
2010,Unknown ,,Ecuador,ECU,0,0,0,249,249
2010,Chad,TCD,Gabon,GAB,0,0,0,28,28
2010,Congo,COG,Gabon,GAB,0,0,0,155,155
2010,Armenia,ARM,Georgia,GEO,0,0,5,0,5
2010,Azerbaijan,AZE,Georgia,GEO,0,0,0,5,5
2010,Iran (Islamic Rep. of),IRN,Georgia,GEO,0,0,5,0,5
2010,Sri Lanka,LKA,Georgia,GEO,0,0,0,5,5
2010,Russian Federation,RUS,Georgia,GEO,10,0,12,5,27
2010,Ukraine,UKR,Georgia,GEO,0,0,5,0,5
2010,Congo,COG,Guinea,GIN,0,0,0,10,10
2010,Dem. Rep. of the Congo,COD,Guinea,GIN,5,0,0,12,17
2010,Cote d'Ivoire,CIV,Guinea,GIN,0,0,31,64,95
2010,Liberia,LBR,Guinea,GIN,0,0,95,372,467
2010,Sierra Leone,SLE,Guinea,GIN,5,0,0,142,147
2010,Togo,TGO,Guinea,GIN,0,0,0,57,57
2010,Burundi,BDI,Cote d'Ivoire,CIV,0,0,0,5,5
2010,Central African Rep.,CAF,Cote d'Ivoire,CIV,0,0,5,0,5
2010,Chad,TCD,Cote d'Ivoire,CIV,15,0,5,0,20
2010,Cameroon,CMR,Cote d'Ivoire,CIV,5,0,5,0,10
2010,Congo,COG,Cote d'Ivoire,CIV,0,0,27,5,32
2010,Dem. Rep. of the Congo,COD,Cote d'Ivoire,CIV,18,0,30,5,53
2010,Equatorial Guinea,GNQ,Cote d'Ivoire,CIV,0,0,0,5,5
2010,Gabon,GAB,Cote d'Ivoire,CIV,0,0,5,0,5
2010,Liberia,LBR,Cote d'Ivoire,CIV,0,0,10,0,10
2010,Nigeria,NGA,Cote d'Ivoire,CIV,5,0,25,0,30
2010,Rwanda,RWA,Cote d'Ivoire,CIV,10,0,0,15,25
2010,Senegal,SEN,Cote d'Ivoire,CIV,0,0,5,0,5
2010,Sierra Leone,SLE,Cote d'Ivoire,CIV,5,0,23,5,33
2010,Togo,TGO,Cote d'Ivoire,CIV,10,0,18,37,65
2010,Afghanistan,AFG,Rep. of Korea,KOR,0,5,0,0,5
2010,Bangladesh,BGD,Rep. of Korea,KOR,5,0,28,10,43
2010,China,CHN,Rep. of Korea,KOR,0,5,10,0,15
2010,Cameroon,CMR,Rep. of Korea,KOR,0,0,5,0,5
2010,Dem. Rep. of the Congo,COD,Rep. of Korea,KOR,5,5,0,0,10
2010,Ghana,GHA,Rep. of Korea,KOR,0,0,5,0,5
2010,Cote d'Ivoire,CIV,Rep. of Korea,KOR,0,5,5,0,10
2010,Iran (Islamic Rep. of),IRN,Rep. of Korea,KOR,5,5,10,0,20
2010,Kenya,KEN,Rep. of Korea,KOR,0,0,5,0,5
2010,Kyrgyzstan,KGZ,Rep. of Korea,KOR,0,0,0,24,24
2010,Sri Lanka,LKA,Rep. of Korea,KOR,0,0,5,5,10
2010,Myanmar,MMR,Rep. of Korea,KOR,13,5,0,0,18
2010,Nepal,NPL,Rep. of Korea,KOR,0,0,5,0,5
2010,Nigeria,NGA,Rep. of Korea,KOR,0,0,24,0,24
2010,Pakistan,PAK,Rep. of Korea,KOR,0,5,46,13,64
2010,Philippines,PHL,Rep. of Korea,KOR,0,0,5,0,5
2010,South Africa,ZAF,Rep. of Korea,KOR,0,0,5,0,5
2010,Russian Federation,RUS,Rep. of Korea,KOR,5,0,0,0,5
2010,Uganda,UGA,Rep. of Korea,KOR,0,5,0,0,5
2010,Uzbekistan,UZB,Rep. of Korea,KOR,5,0,0,0,5
2010,Eritrea,ERI,Liechtenstein,LIE,0,0,5,5,10
2010,North Macedonia,MKD,Liechtenstein,LIE,0,0,31,5,36
2010,Nigeria,NGA,Liechtenstein,LIE,0,0,0,11,11
2010,Russian Federation,RUS,Liechtenstein,LIE,0,0,14,18,32
2010,Serbia and Kosovo: S/RES/1244 (1999),SRB,Liechtenstein,LIE,0,0,5,0,5
2010,Somalia,SOM,Liechtenstein,LIE,0,0,0,5,5
2010,Afghanistan,AFG,North Macedonia,MKD,0,0,0,44,44
2010,Eritrea,ERI,North Macedonia,MKD,0,0,0,5,5
2010,Palestinian,PSE,North Macedonia,MKD,0,0,0,10,10
2010,Serbia and Kosovo: S/RES/1244 (1999),SRB,North Macedonia,MKD,0,0,10,11,21
2010,Somalia,SOM,North Macedonia,MKD,0,0,0,5,5
2010,Afghanistan,AFG,Rep. of Moldova,MDA,0,10,0,0,10
2010,Armenia,ARM,Rep. of Moldova,MDA,0,14,10,0,24
2010,Georgia,GEO,Rep. of Moldova,MDA,0,5,0,0,5
2010,Iraq,IRQ,Rep. of Moldova,MDA,0,0,0,5,5
2010,Kyrgyzstan,KGZ,Rep. of Moldova,MDA,0,5,0,0,5
2010,Romania,ROU,Rep. of Moldova,MDA,0,0,5,0,5
2010,Russian Federation,RUS,Rep. of Moldova,MDA,0,5,5,0,10
2010,Ukraine,UKR,Rep. of Moldova,MDA,0,0,5,0,5
2010,Russian Federation,RUS,Montenegro,MNE,0,0,5,0,5
2010,Serbia and Kosovo: S/RES/1244 (1999),SRB,Montenegro,MNE,0,0,0,5,5
2010,Afghanistan,AFG,Romania,ROU,13,22,79,0,114
2010,Albania,ALB,Romania,ROU,0,0,0,5,5
2010,Algeria,DZA,Romania,ROU,0,0,10,0,10
2010,Egypt,EGY,Romania,ROU,0,0,15,0,15
2010,Bangladesh,BGD,Romania,ROU,0,0,16,0,16
2010,China,CHN,Romania,ROU,0,0,56,24,80
2010,Cameroon,CMR,Romania,ROU,0,0,5,0,5
2010,Dem. Rep. of the Congo,COD,Romania,ROU,0,5,10,5,20
2010,Gambia,GMB,Romania,ROU,0,0,5,0,5
2010,Palestinian,PSE,Romania,ROU,0,0,5,5,10
2010,Georgia,GEO,Romania,ROU,0,0,5,0,5
2010,Cote d'Ivoire,CIV,Romania,ROU,0,0,5,0,5
2010,India,IND,Romania,ROU,0,0,15,5,20
2010,Iran (Islamic Rep. of),IRN,Romania,ROU,5,5,21,5,36
2010,Iraq,IRQ,Romania,ROU,18,0,38,34,90
2010,Sri Lanka,LKA,Romania,ROU,0,0,18,0,18
2010,Rep. of Moldova,MDA,Romania,ROU,0,0,90,28,118
2010,Morocco,MAR,Romania,ROU,0,0,5,5,10
2010,Myanmar,MMR,Romania,ROU,44,0,0,0,44
2010,Nigeria,NGA,Romania,ROU,0,0,20,5,25
2010,Pakistan,PAK,Romania,ROU,0,0,67,5,72
2010,Russian Federation,RUS,Romania,ROU,0,0,10,0,10
2010,Serbia and Kosovo: S/RES/1244 (1999),SRB,Romania,ROU,0,0,10,0,10
2010,Somalia,SOM,Romania,ROU,0,0,5,0,5
2010,Viet Nam,VNM,Romania,ROU,0,0,10,5,15
2010,Syrian Arab Rep.,SYR,Romania,ROU,0,0,14,0,14
2010,Tunisia,TUN,Romania,ROU,0,0,10,0,10
2010,Turkey,TUR,Romania,ROU,0,0,49,16,65
2010,Ukraine,UKR,Romania,ROU,0,0,10,0,10
2010,Stateless,XXA,Romania,ROU,5,0,5,5,15
2010,Central African Rep.,CAF,Sudan,SDN,20,0,0,0,20
2010,Chad,TCD,Sudan,SDN,319,0,0,0,319
2010,Dem. Rep. of the Congo,COD,Sudan,SDN,5,0,0,0,5
2010,Eritrea,ERI,Sudan,SDN,10798,0,243,497,11538
2010,Ethiopia,ETH,Sudan,SDN,215,0,5,5,225
2010,Somalia,SOM,Sudan,SDN,47,0,0,0,47
2010,Uganda,UGA,Sudan,SDN,5,0,0,0,5
2010,Afghanistan,AFG,Tajikistan,TJK,487,0,174,0,661
2010,Sri Lanka,LKA,Timor-Leste,TLS,0,0,0,5,5
2010,Burundi,BDI,Uganda,UGA,481,0,24,0,505
2010,Chad,TCD,Uganda,UGA,5,0,0,0,5
2010,Dem. Rep. of the Congo,COD,Uganda,UGA,2613,0,10,0,2623
2010,Eritrea,ERI,Uganda,UGA,13,0,136,0,149
2010,Ethiopia,ETH,Uganda,UGA,39,0,284,0,323
2010,Kenya,KEN,Uganda,UGA,5,0,0,0,5
2010,Rwanda,RWA,Uganda,UGA,96,0,124,0,220
2010,Somalia,SOM,Uganda,UGA,2361,0,0,0,2361
2010,Sudan,SDN,Uganda,UGA,38,0,5,0,43
2010,Angola,AGO,Zambia,ZMB,39,0,0,0,39
2010,Burundi,BDI,Zambia,ZMB,61,0,5,0,66
2010,Dem. Rep. of the Congo,COD,Zambia,ZMB,246,0,11,0,257
2010,Rwanda,RWA,Zambia,ZMB,171,0,5,0,176
2010,Somalia,SOM,Zambia,ZMB,5,0,0,0,5
2011,Iraq,IRQ,Albania,ALB,0,0,0,5,5
2011,Serbia and Kosovo: S/RES/1244 (1999),SRB,Albania,ALB,0,0,0,5,5
2011,Burundi,BDI,Angola,AGO,5,0,0,0,5
2011,Central African Rep.,CAF,Angola,AGO,5,0,0,0,5
2011,Chad,TCD,Angola,AGO,43,0,18,0,61
2011,Congo,COG,Angola,AGO,20,0,5,0,25
2011,Eritrea,ERI,Angola,AGO,0,0,5,0,5
2011,Guinea-Bissau,GNB,Angola,AGO,5,0,0,0,5
2011,Guinea,GIN,Angola,AGO,48,0,130,0,178
2011,Cote d'Ivoire,CIV,Angola,AGO,196,0,175,0,371
2011,Liberia,LBR,Angola,AGO,85,0,0,0,85
2011,Mauritania,MRT,Angola,AGO,152,0,0,0,152
2011,Rwanda,RWA,Angola,AGO,10,0,0,0,10
2011,Sierra Leone,SLE,Angola,AGO,194,0,17,0,211
2011,Somalia,SOM,Angola,AGO,178,0,0,0,178
2011,Sudan,SDN,Angola,AGO,122,0,62,0,184
2011,Western Sahara,ESH,Angola,AGO,10,0,0,0,10
2011,Afghanistan,AFG,Austria,AUT,822,887,800,154,2663
2011,Albania,ALB,Austria,AUT,5,5,76,10,96
2011,Algeria,DZA,Austria,AUT,10,0,316,170,496
2011,Angola,AGO,Austria,AUT,5,10,10,0,25
2011,Egypt,EGY,Austria,AUT,10,10,61,26,107
2011,Armenia,ARM,Austria,AUT,30,51,636,26,743
2011,Azerbaijan,AZE,Austria,AUT,13,18,113,10,154
2011,Benin,BEN,Austria,AUT,0,0,10,0,10
2011,Bangladesh,BGD,Austria,AUT,10,10,93,17,130
2011,Burkina Faso,BFA,Austria,AUT,5,0,5,0,10
2011,Belarus,BLR,Austria,AUT,5,0,47,10,62
2011,Bolivia (Plurinational State of),BOL,Austria,AUT,0,0,10,0,10
2011,Bosnia and Herzegovina,BIH,Austria,AUT,5,5,146,13,169
2011,Bulgaria,BGR,Austria,AUT,0,0,12,0,12
2011,China,CHN,Austria,AUT,50,5,279,63,397
2011,Cameroon,CMR,Austria,AUT,18,0,30,5,53
2011,Congo,COG,Austria,AUT,21,0,5,0,26
2011,Dem. Rep. of the Congo,COD,Austria,AUT,21,11,19,11,62
2011,Cuba,CUB,Austria,AUT,0,0,5,0,5
2011,Eritrea,ERI,Austria,AUT,12,0,5,5,22
2011,Ethiopia,ETH,Austria,AUT,12,5,10,5,32
2011,Gabon,GAB,Austria,AUT,0,0,0,5,5
2011,Gambia,GMB,Austria,AUT,10,5,90,21,126
2011,Georgia,GEO,Austria,AUT,11,39,511,62,623
2011,Ghana,GHA,Austria,AUT,0,0,36,0,36
2011,Guinea-Bissau,GNB,Austria,AUT,0,0,12,14,26
2011,Guinea,GIN,Austria,AUT,18,5,32,18,73
2011,Croatia,HRV,Austria,AUT,0,0,5,0,5
2011,Cote d'Ivoire,CIV,Austria,AUT,0,24,33,10,67
2011,India,IND,Austria,AUT,0,5,505,64,574
2011,Iran (Islamic Rep. of),IRN,Austria,AUT,275,11,100,37,423
2011,Iraq,IRQ,Austria,AUT,202,187,269,71,729
2011,Israel,ISR,Austria,AUT,0,0,5,5,10
2011,Jordan,JOR,Austria,AUT,0,0,5,5,10
2011,Kazakhstan,KAZ,Austria,AUT,5,0,38,0,43
2011,Kenya,KEN,Austria,AUT,10,0,10,0,20
2011,Kyrgyzstan,KGZ,Austria,AUT,28,14,64,16,122
2011,Liberia,LBR,Austria,AUT,0,0,24,0,24
2011,Libya,LBY,Austria,AUT,0,5,23,18,46
2011,Lebanon,LBN,Austria,AUT,5,5,55,15,80
2011,Sri Lanka,LKA,Austria,AUT,0,0,5,5,10
2011,North Macedonia,MKD,Austria,AUT,0,5,212,32,249
2011,Rep. of Moldova,MDA,Austria,AUT,0,10,82,26,118
2011,Mali,MLI,Austria,AUT,0,0,14,10,24
2011,Mongolia,MNG,Austria,AUT,5,23,342,41,411
2011,Morocco,MAR,Austria,AUT,0,0,205,59,264
2011,Montenegro,MNE,Austria,AUT,0,0,10,0,10
2011,Myanmar,MMR,Austria,AUT,0,0,5,0,5
2011,Nepal,NPL,Austria,AUT,0,5,56,10,71
2011,Niger,NER,Austria,AUT,0,0,5,0,5
2011,Nigeria,NGA,Austria,AUT,15,47,774,127,963
2011,Pakistan,PAK,Austria,AUT,5,5,303,110,423
2011,Philippines,PHL,Austria,AUT,0,0,5,0,5
2011,Romania,ROU,Austria,AUT,0,0,20,5,25
2011,South Africa,ZAF,Austria,AUT,0,5,5,0,10
2011,Russian Federation,RUS,Austria,AUT,1016,246,1958,271,3491
2011,Rwanda,RWA,Austria,AUT,0,5,5,0,10
2011,Serbia and Kosovo: S/RES/1244 (1999),SRB,Austria,AUT,57,86,1619,194,1956
2011,Senegal,SEN,Austria,AUT,0,0,10,16,26
2011,Sierra Leone,SLE,Austria,AUT,0,0,26,5,31
2011,Somalia,SOM,Austria,AUT,261,126,51,26,464
2011,Viet Nam,VNM,Austria,AUT,0,0,5,0,5
2011,Sudan,SDN,Austria,AUT,41,10,31,11,93
2011,Slovakia,SVK,Austria,AUT,0,0,5,5,10
2011,Syrian Arab Rep.,SYR,Austria,AUT,360,49,83,25,517
2011,Tajikistan,TJK,Austria,AUT,5,5,10,10,30
2011,Togo,TGO,Austria,AUT,0,0,5,0,5
2011,Tunisia,TUN,Austria,AUT,0,0,137,33,170
2011,Turkey,TUR,Austria,AUT,64,26,701,93,884
2011,Uganda,UGA,Austria,AUT,0,0,5,5,10
2011,Ukraine,UKR,Austria,AUT,11,20,152,19,202
2011,Uzbekistan,UZB,Austria,AUT,10,5,29,5,49
2011,Zimbabwe,ZWE,Austria,AUT,5,0,5,0,10
2011,Stateless,XXA,Austria,AUT,83,22,120,48,273
2011,Unknown ,,Austria,AUT,10,0,43,13,66
2011,Dem. Rep. of the Congo,COD,Burundi,BDI,5404,0,5,190,5599
2011,Rwanda,RWA,Burundi,BDI,30,0,0,5,35
2011,Somalia,SOM,Burundi,BDI,5,0,0,0,5
2011,Burundi,BDI,Botswana,BWA,16,0,5,0,21
2011,Dem. Rep. of the Congo,COD,Botswana,BWA,44,0,12,0,56
2011,Ethiopia,ETH,Botswana,BWA,0,0,0,5,5
2011,Namibia,NAM,Botswana,BWA,5,0,0,0,5
2011,Rwanda,RWA,Botswana,BWA,0,0,5,0,5
2011,Somalia,SOM,Botswana,BWA,14,0,5,13,32
2011,Sudan,SDN,Botswana,BWA,0,0,5,0,5
2011,Uganda,UGA,Botswana,BWA,20,0,5,0,25
2011,Zimbabwe,ZWE,Botswana,BWA,50,0,14,0,64
2011,Afghanistan,AFG,Bosnia and Herzegovina,BIH,0,0,0,10,10
2011,Algeria,DZA,Bosnia and Herzegovina,BIH,0,0,0,5,5
2011,Palestinian,PSE,Bosnia and Herzegovina,BIH,0,0,0,5,5
2011,Iran (Islamic Rep. of),IRN,Bosnia and Herzegovina,BIH,0,0,0,5,5
2011,Morocco,MAR,Bosnia and Herzegovina,BIH,0,0,0,5,5
2011,Pakistan,PAK,Bosnia and Herzegovina,BIH,0,0,0,5,5
2011,Serbia and Kosovo: S/RES/1244 (1999),SRB,Bosnia and Herzegovina,BIH,0,5,91,10,106
2011,Afghanistan,AFG,Bulgaria,BGR,0,27,10,13,50
2011,Algeria,DZA,Bulgaria,BGR,0,0,5,10,15
2011,Armenia,ARM,Bulgaria,BGR,0,0,21,0,21
2011,Azerbaijan,AZE,Bulgaria,BGR,0,0,5,0,5
2011,Ethiopia,ETH,Bulgaria,BGR,0,0,0,5,5
2011,Georgia,GEO,Bulgaria,BGR,0,0,0,10,10
2011,Iran (Islamic Rep. of),IRN,Bulgaria,BGR,0,5,13,10,28
2011,Iraq,IRQ,Bulgaria,BGR,5,119,180,127,431
2011,Kyrgyzstan,KGZ,Bulgaria,BGR,0,0,5,5,10
2011,Libya,LBY,Bulgaria,BGR,0,0,0,5,5
2011,Lebanon,LBN,Bulgaria,BGR,0,0,0,5,5
2011,Morocco,MAR,Bulgaria,BGR,0,0,5,16,21
2011,Nigeria,NGA,Bulgaria,BGR,0,0,11,0,11
2011,Pakistan,PAK,Bulgaria,BGR,0,0,5,17,22
2011,Russian Federation,RUS,Bulgaria,BGR,0,0,5,0,5
2011,Somalia,SOM,Bulgaria,BGR,0,5,5,0,10
2011,Sudan,SDN,Bulgaria,BGR,0,0,5,0,5
2011,Syrian Arab Rep.,SYR,Bulgaria,BGR,0,5,43,20,68
2011,Tunisia,TUN,Bulgaria,BGR,0,0,0,5,5
2011,Turkey,TUR,Bulgaria,BGR,0,5,0,5,10
2011,Stateless,XXA,Bulgaria,BGR,0,14,27,35,76
2011,Angola,AGO,Congo,COG,0,0,5,20,25
2011,Burundi,BDI,Congo,COG,0,0,0,5,5
2011,Central African Rep.,CAF,Congo,COG,0,0,0,98,98
2011,Chad,TCD,Congo,COG,0,0,5,97,102
2011,Cameroon,CMR,Congo,COG,0,0,0,5,5
2011,Dem. Rep. of the Congo,COD,Congo,COG,50,0,321,2423,2794
2011,Ethiopia,ETH,Congo,COG,0,0,0,5,5
2011,Guinea,GIN,Congo,COG,0,0,0,5,5
2011,Cote d'Ivoire,CIV,Congo,COG,0,0,0,55,55
2011,Liberia,LBR,Congo,COG,0,0,0,5,5
2011,Mauritania,MRT,Congo,COG,0,0,0,18,18
2011,Rwanda,RWA,Congo,COG,0,0,5,0,5
2011,Sierra Leone,SLE,Congo,COG,0,0,0,5,5
2011,Sudan,SDN,Congo,COG,0,0,0,12,12
2011,Togo,TGO,Congo,COG,0,0,0,5,5
2011,Afghanistan,AFG,Ecuador,ECU,5,0,5,0,10
2011,Argentina,ARG,Ecuador,ECU,0,0,14,0,14
2011,Benin,BEN,Ecuador,ECU,0,0,5,0,5
2011,Bangladesh,BGD,Ecuador,ECU,0,0,30,0,30
2011,Bolivia (Plurinational State of),BOL,Ecuador,ECU,0,0,5,0,5
2011,Botswana,BWA,Ecuador,ECU,0,0,5,0,5
2011,Chile,CHL,Ecuador,ECU,0,0,5,0,5
2011,Cameroon,CMR,Ecuador,ECU,0,0,14,0,14
2011,Colombia,COL,Ecuador,ECU,2652,0,7528,48,10228
2011,Cuba,CUB,Ecuador,ECU,0,0,1121,10,1131
2011,Dominican Rep.,DOM,Ecuador,ECU,0,0,31,0,31
2011,Guinea,GIN,Ecuador,ECU,0,0,5,0,5
2011,Haiti,HTI,Ecuador,ECU,0,0,225,5,230
2011,India,IND,Ecuador,ECU,0,0,11,0,11
2011,Iran (Islamic Rep. of),IRN,Ecuador,ECU,0,0,5,0,5
2011,Sri Lanka,LKA,Ecuador,ECU,0,0,12,0,12
2011,Mexico,MEX,Ecuador,ECU,0,0,5,0,5
2011,Mali,MLI,Ecuador,ECU,0,0,5,0,5
2011,Nepal,NPL,Ecuador,ECU,0,0,5,0,5
2011,Nigeria,NGA,Ecuador,ECU,0,0,80,0,80
2011,Pakistan,PAK,Ecuador,ECU,5,0,53,0,58
2011,Peru,PER,Ecuador,ECU,0,0,352,0,352
2011,Sierra Leone,SLE,Ecuador,ECU,0,0,10,0,10
2011,Spain,ESP,Ecuador,ECU,0,0,5,0,5
2011,Venezuela (Bolivarian Republic of),VEN,Ecuador,ECU,0,0,15,0,15
2011,Chad,TCD,Gabon,GAB,0,0,0,5,5
2011,Congo,COG,Gabon,GAB,0,0,0,1855,1855
2011,Dem. Rep. of the Congo,COD,Gabon,GAB,0,0,0,10,10
2011,Iran (Islamic Rep. of),IRN,Georgia,GEO,0,0,10,5,15
2011,Nepal,NPL,Georgia,GEO,0,0,5,0,5
2011,Nigeria,NGA,Georgia,GEO,0,0,5,0,5
2011,Russian Federation,RUS,Georgia,GEO,16,0,23,5,44
2011,Uzbekistan,UZB,Georgia,GEO,5,0,0,0,5
2011,Dem. Rep. of the Congo,COD,Guinea,GIN,11,0,0,0,11
2011,Cote d'Ivoire,CIV,Guinea,GIN,124,0,52,136,312
2011,Liberia,LBR,Guinea,GIN,65,0,93,0,158
2011,Rwanda,RWA,Guinea,GIN,5,0,0,0,5
2011,Sierra Leone,SLE,Guinea,GIN,0,0,30,0,30
2011,Togo,TGO,Guinea,GIN,0,0,10,0,10
2011,Afghanistan,AFG,Rep. of Korea,KOR,0,0,5,5,10
2011,Bangladesh,BGD,Rep. of Korea,KOR,0,0,33,5,38
2011,China,CHN,Rep. of Korea,KOR,0,5,0,5,10
2011,Dem. Rep. of the Congo,COD,Rep. of Korea,KOR,5,0,0,0,5
2011,Cote d'Ivoire,CIV,Rep. of Korea,KOR,0,5,25,0,30
2011,Iran (Islamic Rep. of),IRN,Rep. of Korea,KOR,0,0,5,0,5
2011,Kenya,KEN,Rep. of Korea,KOR,0,0,5,0,5
2011,Kyrgyzstan,KGZ,Rep. of Korea,KOR,0,0,47,17,64
2011,Liberia,LBR,Rep. of Korea,KOR,0,0,5,5,10
2011,Myanmar,MMR,Rep. of Korea,KOR,20,0,11,5,36
2011,Nigeria,NGA,Rep. of Korea,KOR,0,0,12,0,12
2011,Pakistan,PAK,Rep. of Korea,KOR,0,5,95,30,130
2011,South Africa,ZAF,Rep. of Korea,KOR,0,0,0,5,5
2011,Uganda,UGA,Rep. of Korea,KOR,0,0,10,5,15
2011,Algeria,DZA,Lesotho,LSO,5,0,0,0,5
2011,Afghanistan,AFG,North Macedonia,MKD,0,0,0,249,249
2011,Bosnia and Herzegovina,BIH,North Macedonia,MKD,0,0,0,5,5
2011,Palestinian,PSE,North Macedonia,MKD,0,0,0,27,27
2011,India,IND,North Macedonia,MKD,0,0,0,10,10
2011,Iran (Islamic Rep. of),IRN,North Macedonia,MKD,0,0,0,10,10
2011,Iraq,IRQ,North Macedonia,MKD,0,0,0,10,10
2011,Pakistan,PAK,North Macedonia,MKD,0,0,0,145,145
2011,Serbia and Kosovo: S/RES/1244 (1999),SRB,North Macedonia,MKD,0,0,0,18,18
2011,Somalia,SOM,North Macedonia,MKD,0,0,0,25,25
2011,Sudan,SDN,North Macedonia,MKD,0,0,0,5,5
2011,Afghanistan,AFG,Rep. of Moldova,MDA,0,10,0,0,10
2011,Armenia,ARM,Rep. of Moldova,MDA,0,0,17,0,17
2011,Iraq,IRQ,Rep. of Moldova,MDA,0,0,5,0,5
2011,Kazakhstan,KAZ,Rep. of Moldova,MDA,0,5,0,0,5
2011,Russian Federation,RUS,Rep. of Moldova,MDA,0,0,12,0,12
2011,Syrian Arab Rep.,SYR,Rep. of Moldova,MDA,0,0,5,0,5
2011,Tajikistan,TJK,Rep. of Moldova,MDA,0,0,5,0,5
2011,Turkey,TUR,Rep. of Moldova,MDA,0,0,5,0,5
2011,Ukraine,UKR,Rep. of Moldova,MDA,0,0,12,0,12
2011,Uzbekistan,UZB,Rep. of Moldova,MDA,0,0,5,0,5
2011,Cameroon,CMR,Mexico,MEX,5,0,0,0,5
2011,Dem. Rep. of the Congo,COD,Mexico,MEX,5,0,0,0,5
2011,Colombia,COL,Mexico,MEX,18,0,0,5,23
2011,Cuba,CUB,Mexico,MEX,5,0,0,0,5
2011,Ecuador,ECU,Mexico,MEX,0,0,0,5,5
2011,Ghana,GHA,Mexico,MEX,5,0,0,0,5
2011,Guatemala,GTM,Mexico,MEX,29,10,0,0,39
2011,Haiti,HTI,Mexico,MEX,10,0,0,0,10
2011,Honduras,HND,Mexico,MEX,37,0,0,0,37
2011,Cote d'Ivoire,CIV,Mexico,MEX,5,0,0,0,5
2011,Iran (Islamic Rep. of),IRN,Mexico,MEX,5,0,0,0,5
2011,Sri Lanka,LKA,Mexico,MEX,20,0,0,0,20
2011,Myanmar,MMR,Mexico,MEX,5,0,0,0,5
2011,Nepal,NPL,Mexico,MEX,5,0,0,0,5
2011,Nigeria,NGA,Mexico,MEX,17,0,0,0,17
2011,Peru,PER,Mexico,MEX,0,5,0,0,5
2011,El Salvador,SLV,Mexico,MEX,73,5,0,0,78
2011,Afghanistan,AFG,Montenegro,MNE,0,0,5,5,10
2011,Algeria,DZA,Montenegro,MNE,0,0,41,16,57
2011,Palestinian,PSE,Montenegro,MNE,0,0,5,18,23
2011,Iran (Islamic Rep. of),IRN,Montenegro,MNE,0,0,5,5,10
2011,Libya,LBY,Montenegro,MNE,0,0,5,0,5
2011,Morocco,MAR,Montenegro,MNE,0,0,48,16,64
2011,Pakistan,PAK,Montenegro,MNE,0,0,0,5,5
2011,Tunisia,TUN,Montenegro,MNE,0,0,18,10,28
2011,Central African Rep.,CAF,Nigeria,NGA,0,0,0,5,5
2011,Chad,TCD,Nigeria,NGA,0,0,0,12,12
2011,Cameroon,CMR,Nigeria,NGA,0,0,0,28,28
2011,Congo,COG,Nigeria,NGA,0,0,0,5,5
2011,Dem. Rep. of the Congo,COD,Nigeria,NGA,36,0,57,293,386
2011,Cote d'Ivoire,CIV,Nigeria,NGA,0,0,0,5,5
2011,Sudan,SDN,Nigeria,NGA,0,0,0,26,26
2011,Togo,TGO,Nigeria,NGA,0,0,0,5,5
2011,Afghanistan,AFG,Romania,ROU,16,17,58,5,96
2011,Algeria,DZA,Romania,ROU,0,0,436,5,441
2011,Angola,AGO,Romania,ROU,0,0,5,0,5
2011,Egypt,EGY,Romania,ROU,5,0,17,5,27
2011,Armenia,ARM,Romania,ROU,0,0,15,10,25
2011,Azerbaijan,AZE,Romania,ROU,0,0,5,0,5
2011,Bangladesh,BGD,Romania,ROU,0,0,17,0,17
2011,China,CHN,Romania,ROU,0,0,44,33,77
2011,Cameroon,CMR,Romania,ROU,5,0,20,5,30
2011,Dem. Rep. of the Congo,COD,Romania,ROU,0,5,0,5,10
2011,Cuba,CUB,Romania,ROU,0,0,5,0,5
2011,Palestinian,PSE,Romania,ROU,0,0,30,0,30
2011,Georgia,GEO,Romania,ROU,0,0,19,0,19
2011,Guinea,GIN,Romania,ROU,0,0,5,0,5
2011,India,IND,Romania,ROU,0,0,17,0,17
2011,Iran (Islamic Rep. of),IRN,Romania,ROU,5,0,20,20,45
2011,Iraq,IRQ,Romania,ROU,25,0,31,10,66
2011,Libya,LBY,Romania,ROU,0,0,20,0,20
2011,Lebanon,LBN,Romania,ROU,0,0,0,5,5
2011,Rep. of Moldova,MDA,Romania,ROU,0,0,46,19,65
2011,Morocco,MAR,Romania,ROU,0,0,202,10,212
2011,Nepal,NPL,Romania,ROU,0,0,5,0,5
2011,Nigeria,NGA,Romania,ROU,0,0,5,10,15
2011,Pakistan,PAK,Romania,ROU,0,0,97,10,107
2011,Philippines,PHL,Romania,ROU,0,0,5,5,10
2011,Russian Federation,RUS,Romania,ROU,0,0,5,0,5
2011,Serbia and Kosovo: S/RES/1244 (1999),SRB,Romania,ROU,0,0,5,0,5
2011,Senegal,SEN,Romania,ROU,0,0,5,0,5
2011,Viet Nam,VNM,Romania,ROU,0,0,0,5,5
2011,Sudan,SDN,Romania,ROU,5,0,5,0,10
2011,Syrian Arab Rep.,SYR,Romania,ROU,0,0,24,5,29
2011,Tunisia,TUN,Romania,ROU,0,0,200,10,210
2011,Turkey,TUR,Romania,ROU,0,5,22,5,32
2011,Ukraine,UKR,Romania,ROU,0,0,5,0,5
2011,Stateless,XXA,Romania,ROU,0,0,10,0,10
2011,Chad,TCD,Sudan,SDN,204,0,5,0,209
2011,Eritrea,ERI,Sudan,SDN,8653,0,142,30,8825
2011,Ethiopia,ETH,Sudan,SDN,158,0,5,0,163
2011,Guinea,GIN,Sudan,SDN,0,0,20,5,25
2011,Cote d'Ivoire,CIV,Sudan,SDN,0,0,41,5,46
2011,Liberia,LBR,Sudan,SDN,0,0,92,64,156
2011,Niger,NER,Sudan,SDN,0,0,5,0,5
2011,Sierra Leone,SLE,Sudan,SDN,0,0,12,0,12
2011,Somalia,SOM,Sudan,SDN,39,0,0,14,53
2011,Myanmar,MMR,Thailand,THA,0,0,0,8461,8461
2011,Afghanistan,AFG,Tajikistan,TJK,218,0,80,0,298
2011,Kyrgyzstan,KGZ,Tajikistan,TJK,47,0,0,0,47
2011,Burundi,BDI,Uganda,UGA,1684,0,14,0,1698
2011,Dem. Rep. of the Congo,COD,Uganda,UGA,2583,0,0,0,2583
2011,Eritrea,ERI,Uganda,UGA,5,0,826,0,831
2011,Ethiopia,ETH,Uganda,UGA,10,0,687,0,697
2011,Kenya,KEN,Uganda,UGA,5,0,0,0,5
2011,Pakistan,PAK,Uganda,UGA,0,0,17,0,17
2011,Rwanda,RWA,Uganda,UGA,43,0,921,0,964
2011,Somalia,SOM,Uganda,UGA,3173,0,0,0,3173
2011,Sudan,SDN,Uganda,UGA,64,0,16,0,80
2011,Afghanistan,AFG,Ukraine,UKR,110,0,73,90,273
2011,Egypt,EGY,Ukraine,UKR,0,0,0,5,5
2011,Azerbaijan,AZE,Ukraine,UKR,0,0,0,10,10
2011,Bangladesh,BGD,Ukraine,UKR,0,0,5,5,10
2011,Cameroon,CMR,Ukraine,UKR,0,0,5,0,5
2011,Dem. Rep. of the Congo,COD,Ukraine,UKR,0,0,13,0,13
2011,Palestinian,PSE,Ukraine,UKR,10,0,10,5,25
2011,Georgia,GEO,Ukraine,UKR,0,0,5,5,10
2011,Guinea,GIN,Ukraine,UKR,0,0,16,5,21
2011,Cote d'Ivoire,CIV,Ukraine,UKR,0,0,0,5,5
2011,Iran (Islamic Rep. of),IRN,Ukraine,UKR,0,0,5,0,5
2011,Iraq,IRQ,Ukraine,UKR,0,0,5,5,10
2011,Kyrgyzstan,KGZ,Ukraine,UKR,0,0,138,75,213
2011,Sri Lanka,LKA,Ukraine,UKR,0,0,0,5,5
2011,Nigeria,NGA,Ukraine,UKR,0,0,0,5,5
2011,Pakistan,PAK,Ukraine,UKR,0,0,5,11,16
2011,Russian Federation,RUS,Ukraine,UKR,0,0,0,16,16
2011,Somalia,SOM,Ukraine,UKR,5,0,50,80,135
2011,Syrian Arab Rep.,SYR,Ukraine,UKR,0,0,13,12,25
2011,Uzbekistan,UZB,Ukraine,UKR,0,0,5,5,10
2011,Stateless,XXA,Ukraine,UKR,0,0,0,5,5
2012,Serbia and Kosovo: S/RES/1244 (1999),SRB,Albania,ALB,5,0,0,0,5
2012,Somalia,SOM,Albania,ALB,0,0,0,5,5
2012,Afghanistan,AFG,Austria,AUT,969,816,1034,321,3140
2012,Albania,ALB,Austria,AUT,5,0,41,5,51
2012,Algeria,DZA,Austria,AUT,0,10,622,54,686
2012,Angola,AGO,Austria,AUT,5,0,5,0,10
2012,Egypt,EGY,Austria,AUT,15,10,84,18,127
2012,Armenia,ARM,Austria,AUT,19,35,245,13,312
2012,Azerbaijan,AZE,Austria,AUT,10,10,72,5,97
2012,Bangladesh,BGD,Austria,AUT,5,5,120,31,161
2012,Belarus,BLR,Austria,AUT,5,5,40,12,62
2012,Bosnia and Herzegovina,BIH,Austria,AUT,0,10,121,20,151
2012,Chad,TCD,Austria,AUT,0,0,5,0,5
2012,China,CHN,Austria,AUT,43,5,224,58,330
2012,Cameroon,CMR,Austria,AUT,21,0,19,5,45
2012,Congo,COG,Austria,AUT,11,0,5,0,16
2012,Dem. Rep. of the Congo,COD,Austria,AUT,32,10,5,5,52
2012,Eritrea,ERI,Austria,AUT,11,0,5,5,21
2012,Ethiopia,ETH,Austria,AUT,10,0,0,0,10
2012,Gambia,GMB,Austria,AUT,11,0,55,14,80
2012,Georgia,GEO,Austria,AUT,27,31,321,37,416
2012,Ghana,GHA,Austria,AUT,0,5,41,5,51
2012,Guinea-Bissau,GNB,Austria,AUT,0,0,14,10,24
2012,Guinea,GIN,Austria,AUT,5,5,27,11,48
2012,Cote d'Ivoire,CIV,Austria,AUT,5,5,5,0,15
2012,India,IND,Austria,AUT,0,0,325,55,380
2012,Iran (Islamic Rep. of),IRN,Austria,AUT,442,25,104,51,622
2012,Iraq,IRQ,Austria,AUT,161,197,362,47,767
2012,Israel,ISR,Austria,AUT,0,0,0,5,5
2012,Jordan,JOR,Austria,AUT,0,0,5,5,10
2012,Kazakhstan,KAZ,Austria,AUT,5,5,12,10,32
2012,Kenya,KEN,Austria,AUT,5,0,5,0,10
2012,Kyrgyzstan,KGZ,Austria,AUT,10,5,43,10,68
2012,Liberia,LBR,Austria,AUT,0,0,15,5,20
2012,Libya,LBY,Austria,AUT,0,0,25,10,35
2012,Lebanon,LBN,Austria,AUT,0,5,56,10,71
2012,Sri Lanka,LKA,Austria,AUT,0,0,10,12,22
2012,Mauritania,MRT,Austria,AUT,0,0,5,5,10
2012,North Macedonia,MKD,Austria,AUT,0,0,144,24,168
2012,Rep. of Moldova,MDA,Austria,AUT,0,0,33,14,47
2012,Mali,MLI,Austria,AUT,5,0,10,11,26
2012,Mongolia,MNG,Austria,AUT,5,15,209,34,263
2012,Morocco,MAR,Austria,AUT,0,0,302,61,363
2012,Montenegro,MNE,Austria,AUT,0,0,17,0,17
2012,Myanmar,MMR,Austria,AUT,5,0,0,0,5
2012,Nepal,NPL,Austria,AUT,0,0,58,5,63
2012,Niger,NER,Austria,AUT,0,0,0,5,5
2012,Nigeria,NGA,Austria,AUT,13,20,428,131,592
2012,Pakistan,PAK,Austria,AUT,14,10,1457,194,1675
2012,Romania,ROU,Austria,AUT,5,0,5,5,15
2012,Russian Federation,RUS,Austria,AUT,839,241,1999,245,3324
2012,Serbia and Kosovo: S/RES/1244 (1999),SRB,Austria,AUT,32,34,971,75,1112
2012,Senegal,SEN,Austria,AUT,0,0,18,13,31
2012,Sierra Leone,SLE,Austria,AUT,0,0,18,5,23
2012,Somalia,SOM,Austria,AUT,241,216,108,36,601
2012,Viet Nam,VNM,Austria,AUT,0,0,10,0,10
2012,Sudan,SDN,Austria,AUT,21,0,20,15,56
2012,Syrian Arab Rep.,SYR,Austria,AUT,542,239,100,22,903
2012,Tajikistan,TJK,Austria,AUT,10,5,0,10,25
2012,Togo,TGO,Austria,AUT,0,0,5,0,5
2012,Tunisia,TUN,Austria,AUT,0,0,155,22,177
2012,Turkey,TUR,Austria,AUT,33,15,337,48,433
2012,Uganda,UGA,Austria,AUT,0,0,10,0,10
2012,Ukraine,UKR,Austria,AUT,10,0,55,10,75
2012,Uzbekistan,UZB,Austria,AUT,5,0,38,5,48
2012,Zimbabwe,ZWE,Austria,AUT,0,0,5,0,5
2012,Stateless,XXA,Austria,AUT,48,48,104,18,218
2012,Unknown ,,Austria,AUT,10,5,30,5,50
2012,Dem. Rep. of the Congo,COD,Burundi,BDI,6393,0,65,5464,11922
2012,Rwanda,RWA,Burundi,BDI,27,0,0,260,287
2012,Somalia,SOM,Burundi,BDI,0,0,0,15,15
2012,Eritrea,ERI,Bosnia and Herzegovina,BIH,0,5,0,0,5
2012,Serbia and Kosovo: S/RES/1244 (1999),SRB,Bosnia and Herzegovina,BIH,0,0,27,0,27
2012,Syrian Arab Rep.,SYR,Bosnia and Herzegovina,BIH,0,5,0,5,10
2012,Afghanistan,AFG,Bulgaria,BGR,5,10,31,25,71
2012,Algeria,DZA,Bulgaria,BGR,0,0,5,12,17
2012,Egypt,EGY,Bulgaria,BGR,0,0,0,5,5
2012,Armenia,ARM,Bulgaria,BGR,0,0,23,0,23
2012,Azerbaijan,AZE,Bulgaria,BGR,0,0,5,0,5
2012,Bosnia and Herzegovina,BIH,Bulgaria,BGR,0,0,5,0,5
2012,Cameroon,CMR,Bulgaria,BGR,0,0,5,0,5
2012,Georgia,GEO,Bulgaria,BGR,0,0,0,5,5
2012,Ghana,GHA,Bulgaria,BGR,0,0,5,0,5
2012,Iran (Islamic Rep. of),IRN,Bulgaria,BGR,0,0,34,10,44
2012,Iraq,IRQ,Bulgaria,BGR,5,67,174,70,316
2012,Kyrgyzstan,KGZ,Bulgaria,BGR,0,0,5,0,5
2012,Lebanon,LBN,Bulgaria,BGR,0,0,5,0,5
2012,Morocco,MAR,Bulgaria,BGR,0,0,5,14,19
2012,Nigeria,NGA,Bulgaria,BGR,0,0,5,5,10
2012,Pakistan,PAK,Bulgaria,BGR,0,0,23,5,28
2012,Russian Federation,RUS,Bulgaria,BGR,0,0,5,5,10
2012,Somalia,SOM,Bulgaria,BGR,0,5,16,0,21
2012,Sudan,SDN,Bulgaria,BGR,0,0,5,0,5
2012,Syrian Arab Rep.,SYR,Bulgaria,BGR,0,57,27,52,136
2012,Tunisia,TUN,Bulgaria,BGR,0,0,5,5,10
2012,Turkey,TUR,Bulgaria,BGR,0,0,5,0,5
2012,Uzbekistan,UZB,Bulgaria,BGR,0,0,0,5,5
2012,Stateless,XXA,Bulgaria,BGR,5,13,44,22,84
2012,Central African Rep.,CAF,Chad,TCD,1585,0,0,0,1585
2012,Dem. Rep. of the Congo,COD,Chad,TCD,41,0,0,5,46
2012,Eritrea,ERI,Chad,TCD,35,0,0,0,35
2012,Cote d'Ivoire,CIV,Chad,TCD,5,0,0,0,5
2012,Somalia,SOM,Chad,TCD,5,0,0,0,5
2012,Sudan,SDN,Chad,TCD,2289,0,0,0,2289
2012,Angola,AGO,Congo,COG,0,0,0,19,19
2012,Central African Rep.,CAF,Congo,COG,0,0,0,13,13
2012,Dem. Rep. of the Congo,COD,Congo,COG,17,0,44,40,101
2012,Mauritania,MRT,Congo,COG,0,0,5,0,5
2012,Afghanistan,AFG,Ecuador,ECU,0,0,5,0,5
2012,Argentina,ARG,Ecuador,ECU,0,0,5,0,5
2012,Bangladesh,BGD,Ecuador,ECU,0,0,32,0,32
2012,Bhutan,BTN,Ecuador,ECU,0,0,22,0,22
2012,Bolivia (Plurinational State of),BOL,Ecuador,ECU,0,0,10,0,10
2012,Brazil,BRA,Ecuador,ECU,5,0,5,0,10
2012,Chile,CHL,Ecuador,ECU,0,0,5,0,5
2012,Cameroon,CMR,Ecuador,ECU,0,0,5,0,5
2012,Colombia,COL,Ecuador,ECU,1515,0,14661,0,16176
2012,Cuba,CUB,Ecuador,ECU,0,0,198,0,198
2012,Dominican Rep.,DOM,Ecuador,ECU,0,0,13,0,13
2012,Guatemala,GTM,Ecuador,ECU,0,0,5,0,5
2012,Haiti,HTI,Ecuador,ECU,0,0,96,0,96
2012,India,IND,Ecuador,ECU,0,0,20,0,20
2012,Iran (Islamic Rep. of),IRN,Ecuador,ECU,0,0,10,0,10
2012,Sri Lanka,LKA,Ecuador,ECU,0,0,5,0,5
2012,Mexico,MEX,Ecuador,ECU,0,0,5,0,5
2012,Nepal,NPL,Ecuador,ECU,0,0,10,0,10
2012,Nigeria,NGA,Ecuador,ECU,5,0,30,0,35
2012,Pakistan,PAK,Ecuador,ECU,0,0,49,0,49
2012,Peru,PER,Ecuador,ECU,0,0,162,0,162
2012,Russian Federation,RUS,Ecuador,ECU,10,0,5,0,15
2012,Sierra Leone,SLE,Ecuador,ECU,0,0,5,0,5
2012,Spain,ESP,Ecuador,ECU,0,0,5,0,5
2012,Syrian Arab Rep.,SYR,Ecuador,ECU,0,0,5,0,5
2012,United States of America,USA,Ecuador,ECU,0,0,5,0,5
2012,Venezuela (Bolivarian Republic of),VEN,Ecuador,ECU,5,0,5,0,10
2012,Unknown ,,Ecuador,ECU,0,0,5,0,5
2012,Dem. Rep. of the Congo,COD,Gabon,GAB,0,0,0,19,19
2012,Egypt,EGY,Georgia,GEO,0,0,0,5,5
2012,Armenia,ARM,Georgia,GEO,5,0,0,5,10
2012,Iran (Islamic Rep. of),IRN,Georgia,GEO,0,0,30,15,45
2012,Iraq,IRQ,Georgia,GEO,5,10,37,17,69
2012,Kyrgyzstan,KGZ,Georgia,GEO,5,0,0,0,5
2012,Sri Lanka,LKA,Georgia,GEO,5,0,0,0,5
2012,Nigeria,NGA,Georgia,GEO,0,0,5,0,5
2012,Russian Federation,RUS,Georgia,GEO,10,0,0,10,20
2012,Dem. Rep. of the Congo,COD,Guinea,GIN,5,0,0,0,5
2012,Cote d'Ivoire,CIV,Guinea,GIN,11,0,10,0,21
2012,Liberia,LBR,Guinea,GIN,11,0,118,0,129
2012,Mali,MLI,Guinea,GIN,0,40,0,0,40
2012,Sierra Leone,SLE,Guinea,GIN,0,0,10,0,10
2012,Togo,TGO,Guinea,GIN,10,0,0,0,10
2012,Afghanistan,AFG,Rep. of Korea,KOR,0,0,23,23,46
2012,Bangladesh,BGD,Rep. of Korea,KOR,16,0,5,10,31
2012,China,CHN,Rep. of Korea,KOR,0,5,0,5,10
2012,Cameroon,CMR,Rep. of Korea,KOR,0,0,5,5,10
2012,Dem. Rep. of the Congo,COD,Rep. of Korea,KOR,5,0,11,0,16
2012,Ethiopia,ETH,Rep. of Korea,KOR,5,0,0,5,10
2012,Guinea,GIN,Rep. of Korea,KOR,0,0,0,5,5
2012,Cote d'Ivoire,CIV,Rep. of Korea,KOR,0,5,0,0,5
2012,India,IND,Rep. of Korea,KOR,0,0,5,18,23
2012,Iran (Islamic Rep. of),IRN,Rep. of Korea,KOR,5,0,0,0,5
2012,Kyrgyzstan,KGZ,Rep. of Korea,KOR,0,0,11,5,16
2012,Liberia,LBR,Rep. of Korea,KOR,0,0,5,10,15
2012,Sri Lanka,LKA,Rep. of Korea,KOR,0,0,104,73,177
2012,Myanmar,MMR,Rep. of Korea,KOR,18,10,22,18,68
2012,Nepal,NPL,Rep. of Korea,KOR,0,0,5,5,10
2012,Nigeria,NGA,Rep. of Korea,KOR,0,0,5,14,19
2012,Pakistan,PAK,Rep. of Korea,KOR,0,0,151,143,294
2012,Russian Federation,RUS,Rep. of Korea,KOR,5,0,0,0,5
2012,Sudan,SDN,Rep. of Korea,KOR,0,0,5,0,5
2012,Uganda,UGA,Rep. of Korea,KOR,0,0,10,30,40
2012,Afghanistan,AFG,North Macedonia,MKD,0,0,0,234,234
2012,Algeria,DZA,North Macedonia,MKD,0,0,0,15,15
2012,Egypt,EGY,North Macedonia,MKD,0,0,0,5,5
2012,Bangladesh,BGD,North Macedonia,MKD,0,0,0,5,5
2012,Eritrea,ERI,North Macedonia,MKD,0,0,0,5,5
2012,Palestinian,PSE,North Macedonia,MKD,0,0,0,10,10
2012,Iran (Islamic Rep. of),IRN,North Macedonia,MKD,0,0,0,5,5
2012,Morocco,MAR,North Macedonia,MKD,0,0,0,23,23
2012,Pakistan,PAK,North Macedonia,MKD,0,0,0,113,113
2012,Serbia and Kosovo: S/RES/1244 (1999),SRB,North Macedonia,MKD,0,0,0,13,13
2012,Somalia,SOM,North Macedonia,MKD,0,0,0,70,70
2012,Sudan,SDN,North Macedonia,MKD,0,0,0,5,5
2012,Syrian Arab Rep.,SYR,North Macedonia,MKD,0,0,0,5,5
2012,Tunisia,TUN,North Macedonia,MKD,0,0,0,5,5
2012,Afghanistan,AFG,Montenegro,MNE,0,0,82,37,119
2012,Algeria,DZA,Montenegro,MNE,0,0,578,272,850
2012,Egypt,EGY,Montenegro,MNE,0,0,0,5,5
2012,Bangladesh,BGD,Montenegro,MNE,0,0,5,0,5
2012,Palestinian,PSE,Montenegro,MNE,0,0,5,5,10
2012,India,IND,Montenegro,MNE,0,0,10,0,10
2012,Iran (Islamic Rep. of),IRN,Montenegro,MNE,0,0,5,5,10
2012,Libya,LBY,Montenegro,MNE,0,0,5,0,5
2012,Morocco,MAR,Montenegro,MNE,0,0,95,39,134
2012,Nigeria,NGA,Montenegro,MNE,0,0,5,0,5
2012,Pakistan,PAK,Montenegro,MNE,0,0,73,25,98
2012,Syrian Arab Rep.,SYR,Montenegro,MNE,0,0,21,16,37
2012,Tunisia,TUN,Montenegro,MNE,0,0,99,61,160
2012,Egypt,EGY,Nigeria,NGA,5,0,0,0,5
2012,Chad,TCD,Nigeria,NGA,5,0,23,75,103
2012,Congo,COG,Nigeria,NGA,0,0,0,5,5
2012,Dem. Rep. of the Congo,COD,Nigeria,NGA,77,0,103,237,417
2012,Eritrea,ERI,Nigeria,NGA,5,0,0,0,5
2012,Guinea,GIN,Nigeria,NGA,0,0,0,5,5
2012,Cote d'Ivoire,CIV,Nigeria,NGA,111,0,0,0,111
2012,Liberia,LBR,Nigeria,NGA,0,0,0,21,21
2012,Mali,MLI,Nigeria,NGA,10,0,0,0,10
2012,Sudan,SDN,Nigeria,NGA,0,0,0,5,5
2012,Togo,TGO,Nigeria,NGA,5,0,0,0,5
2012,Afghanistan,AFG,Romania,ROU,23,11,174,10,218
2012,Algeria,DZA,Romania,ROU,0,0,601,26,627
2012,Angola,AGO,Romania,ROU,0,0,5,0,5
2012,Egypt,EGY,Romania,ROU,5,0,34,12,51
2012,Bangladesh,BGD,Romania,ROU,0,0,59,0,59
2012,Burkina Faso,BFA,Romania,ROU,0,0,5,0,5
2012,China,CHN,Romania,ROU,0,0,26,18,44
2012,Cameroon,CMR,Romania,ROU,0,0,18,5,23
2012,Dem. Rep. of the Congo,COD,Romania,ROU,0,5,0,0,5
2012,Eritrea,ERI,Romania,ROU,10,5,5,0,20
2012,Ethiopia,ETH,Romania,ROU,0,0,5,0,5
2012,Palestinian,PSE,Romania,ROU,12,5,56,5,78
2012,Georgia,GEO,Romania,ROU,0,0,5,0,5
2012,India,IND,Romania,ROU,0,0,18,0,18
2012,Iran (Islamic Rep. of),IRN,Romania,ROU,10,5,14,5,34
2012,Iraq,IRQ,Romania,ROU,16,10,24,5,55
2012,Libya,LBY,Romania,ROU,0,0,19,0,19
2012,Lebanon,LBN,Romania,ROU,0,0,5,5,10
2012,Sri Lanka,LKA,Romania,ROU,0,0,5,0,5
2012,Mauritania,MRT,Romania,ROU,0,0,5,0,5
2012,Rep. of Moldova,MDA,Romania,ROU,0,0,30,13,43
2012,Morocco,MAR,Romania,ROU,0,0,355,13,368
2012,Nepal,NPL,Romania,ROU,0,0,5,0,5
2012,Nigeria,NGA,Romania,ROU,0,0,28,5,33
2012,Pakistan,PAK,Romania,ROU,0,0,316,5,321
2012,Philippines,PHL,Romania,ROU,0,0,11,5,16
2012,Serbia and Kosovo: S/RES/1244 (1999),SRB,Romania,ROU,0,0,11,5,16
2012,Senegal,SEN,Romania,ROU,0,0,5,0,5
2012,Somalia,SOM,Romania,ROU,10,5,27,0,42
2012,Viet Nam,VNM,Romania,ROU,0,0,0,5,5
2012,Sudan,SDN,Romania,ROU,0,0,14,0,14
2012,Syrian Arab Rep.,SYR,Romania,ROU,63,69,76,5,213
2012,Tunisia,TUN,Romania,ROU,0,0,96,10,106
2012,Turkey,TUR,Romania,ROU,0,0,16,5,21
2012,Yemen,YEM,Romania,ROU,0,0,5,0,5
2012,Stateless,XXA,Romania,ROU,5,0,0,0,5
2012,Myanmar,MMR,Thailand,THA,0,0,0,67,67
2012,Afghanistan,AFG,Tajikistan,TJK,410,0,118,0,528
2012,Kyrgyzstan,KGZ,Tajikistan,TJK,47,0,0,0,47
2012,Burundi,BDI,Uganda,UGA,1843,0,596,0,2439
2012,Dem. Rep. of the Congo,COD,Uganda,UGA,3779,0,150,0,3929
2012,Eritrea,ERI,Uganda,UGA,22,0,193,0,215
2012,Ethiopia,ETH,Uganda,UGA,52,0,108,0,160
2012,Kenya,KEN,Uganda,UGA,5,0,15,0,20
2012,Pakistan,PAK,Uganda,UGA,11,0,11,0,22
2012,Rwanda,RWA,Uganda,UGA,146,0,157,0,303
2012,Somalia,SOM,Uganda,UGA,1902,0,5,0,1907
2012,Sudan,SDN,Uganda,UGA,796,0,26,0,822
2013,Afghanistan,AFG,Austria,AUT,1259,828,885,317,3289
2013,Albania,ALB,Austria,AUT,0,5,27,5,37
2013,Algeria,DZA,Austria,AUT,0,0,707,117,824
2013,Angola,AGO,Austria,AUT,5,0,0,0,5
2013,Egypt,EGY,Austria,AUT,10,5,107,17,139
2013,Armenia,ARM,Austria,AUT,12,38,296,17,363
2013,Azerbaijan,AZE,Austria,AUT,14,5,92,12,123
2013,Benin,BEN,Austria,AUT,0,0,5,0,5
2013,Bangladesh,BGD,Austria,AUT,19,14,181,28,242
2013,Burkina Faso,BFA,Austria,AUT,0,0,11,0,11
2013,Belarus,BLR,Austria,AUT,5,0,14,10,29
2013,Bosnia and Herzegovina,BIH,Austria,AUT,0,5,63,33,101
2013,Chad,TCD,Austria,AUT,0,0,5,0,5
2013,China,CHN,Austria,AUT,66,5,116,46,233
2013,Cameroon,CMR,Austria,AUT,26,0,13,0,39
2013,Congo,COG,Austria,AUT,10,0,12,0,22
2013,Dem. Rep. of the Congo,COD,Austria,AUT,26,5,14,0,45
2013,Cuba,CUB,Austria,AUT,0,0,13,5,18
2013,Eritrea,ERI,Austria,AUT,15,0,5,5,25
2013,Ethiopia,ETH,Austria,AUT,5,5,5,0,15
2013,Gambia,GMB,Austria,AUT,10,5,37,14,66
2013,Georgia,GEO,Austria,AUT,5,25,209,41,280
2013,Germany,DEU,Austria,AUT,0,0,0,5,5
2013,Ghana,GHA,Austria,AUT,0,5,28,5,38
2013,Guinea-Bissau,GNB,Austria,AUT,0,0,11,10,21
2013,Guinea,GIN,Austria,AUT,11,5,29,5,50
2013,Croatia,HRV,Austria,AUT,0,0,10,5,15
2013,Cote d'Ivoire,CIV,Austria,AUT,0,0,14,0,14
2013,India,IND,Austria,AUT,0,5,387,46,438
2013,Iran (Islamic Rep. of),IRN,Austria,AUT,520,16,136,28,700
2013,Iraq,IRQ,Austria,AUT,121,125,333,59,638
2013,Israel,ISR,Austria,AUT,0,0,5,0,5
2013,Jordan,JOR,Austria,AUT,5,0,5,0,10
2013,Kazakhstan,KAZ,Austria,AUT,0,5,30,0,35
2013,Kenya,KEN,Austria,AUT,5,0,0,5,10
2013,Kyrgyzstan,KGZ,Austria,AUT,5,13,55,10,83
2013,Liberia,LBR,Austria,AUT,0,0,21,0,21
2013,Libya,LBY,Austria,AUT,0,0,21,10,31
2013,Lebanon,LBN,Austria,AUT,5,0,28,5,38
2013,Sri Lanka,LKA,Austria,AUT,0,0,15,18,33
2013,Mauritania,MRT,Austria,AUT,0,0,32,5,37
2013,North Macedonia,MKD,Austria,AUT,0,0,121,16,137
2013,Rep. of Moldova,MDA,Austria,AUT,0,0,22,19,41
2013,Mali,MLI,Austria,AUT,0,5,23,5,33
2013,Mongolia,MNG,Austria,AUT,0,5,117,23,145
2013,Morocco,MAR,Austria,AUT,0,0,392,80,472
2013,Montenegro,MNE,Austria,AUT,0,0,10,0,10
2013,Myanmar,MMR,Austria,AUT,10,0,0,0,10
2013,Nepal,NPL,Austria,AUT,0,0,35,0,35
2013,Niger,NER,Austria,AUT,0,0,5,0,5
2013,Nigeria,NGA,Austria,AUT,10,24,653,90,777
2013,Pakistan,PAK,Austria,AUT,28,10,1387,156,1581
2013,Romania,ROU,Austria,AUT,0,0,5,5,10
2013,Russian Federation,RUS,Austria,AUT,673,175,1595,389,2832
2013,El Salvador,SLV,Austria,AUT,0,0,5,0,5
2013,Serbia and Kosovo: S/RES/1244 (1999),SRB,Austria,AUT,29,43,988,190,1250
2013,Senegal,SEN,Austria,AUT,0,0,29,10,39
2013,Sierra Leone,SLE,Austria,AUT,0,0,25,0,25
2013,Somalia,SOM,Austria,AUT,254,133,105,49,541
2013,Viet Nam,VNM,Austria,AUT,0,0,11,13,24
2013,Sudan,SDN,Austria,AUT,29,0,14,10,53
2013,South Sudan,SSD,Austria,AUT,0,0,5,0,5
2013,Slovakia,SVK,Austria,AUT,0,0,5,0,5
2013,Syrian Arab Rep.,SYR,Austria,AUT,838,253,189,70,1350
2013,Tajikistan,TJK,Austria,AUT,10,5,16,5,36
2013,Turkmenistan,TKM,Austria,AUT,5,0,0,0,5
2013,Tunisia,TUN,Austria,AUT,0,0,162,44,206
2013,Turkey,TUR,Austria,AUT,35,5,256,56,352
2013,Ukraine,UKR,Austria,AUT,5,10,67,10,92
2013,Uzbekistan,UZB,Austria,AUT,5,5,24,0,34
2013,Western Sahara,ESH,Austria,AUT,0,0,5,5,10
2013,Yemen,YEM,Austria,AUT,0,0,5,0,5
2013,Stateless,XXA,Austria,AUT,32,25,77,15,149
2013,Unknown ,,Austria,AUT,0,0,23,5,28
2013,Angola,AGO,Burundi,BDI,0,0,0,10,10
2013,Central African Rep.,CAF,Burundi,BDI,0,0,0,5,5
2013,Dem. Rep. of the Congo,COD,Burundi,BDI,7319,0,5,2713,10037
2013,Rwanda,RWA,Burundi,BDI,21,0,5,203,229
2013,Somalia,SOM,Burundi,BDI,0,0,0,10,10
2013,Central African Rep.,CAF,Chad,TCD,62,0,0,0,62
2013,Dem. Rep. of the Congo,COD,Chad,TCD,42,0,0,0,42
2013,Eritrea,ERI,Chad,TCD,5,0,0,0,5
2013,Rwanda,RWA,Chad,TCD,5,0,0,0,5
2013,Sudan,SDN,Chad,TCD,45,0,0,0,45
2013,Syrian Arab Rep.,SYR,Chad,TCD,11,0,0,0,11
2013,Central African Rep.,CAF,Congo,COG,0,0,0,23,23
2013,Chad,TCD,Congo,COG,11,0,0,12,23
2013,Dem. Rep. of the Congo,COD,Congo,COG,63,0,0,805,868
2013,Cote d'Ivoire,CIV,Congo,COG,0,0,0,33,33
2013,Mauritania,MRT,Congo,COG,0,0,0,5,5
2013,Rwanda,RWA,Congo,COG,21,0,0,12,33
2013,Sierra Leone,SLE,Congo,COG,0,0,0,5,5
2013,Sudan,SDN,Congo,COG,0,0,0,5,5
2013,Bolivia (Plurinational State of),BOL,Ecuador,ECU,0,0,5,0,5
2013,Colombia,COL,Ecuador,ECU,509,0,7947,2075,10531
2013,Costa Rica,CRI,Ecuador,ECU,0,0,5,0,5
2013,Cuba,CUB,Ecuador,ECU,0,0,45,22,67
2013,Dominican Rep.,DOM,Ecuador,ECU,0,0,16,5,21
2013,Haiti,HTI,Ecuador,ECU,0,0,37,0,37
2013,India,IND,Ecuador,ECU,0,0,5,0,5
2013,Iran (Islamic Rep. of),IRN,Ecuador,ECU,0,0,5,0,5
2013,Sri Lanka,LKA,Ecuador,ECU,0,0,0,5,5
2013,Nigeria,NGA,Ecuador,ECU,0,0,5,0,5
2013,Pakistan,PAK,Ecuador,ECU,0,0,12,5,17
2013,Peru,PER,Ecuador,ECU,0,0,26,10,36
2013,Russian Federation,RUS,Ecuador,ECU,0,0,5,0,5
2013,El Salvador,SLV,Ecuador,ECU,0,0,10,0,10
2013,Syrian Arab Rep.,SYR,Ecuador,ECU,0,0,5,0,5
2013,Venezuela (Bolivarian Republic of),VEN,Ecuador,ECU,0,0,10,0,10
2013,Dem. Rep. of the Congo,COD,Gabon,GAB,5,0,5,5,15
2013,Egypt,EGY,Georgia,GEO,0,5,13,45,63
2013,Bangladesh,BGD,Georgia,GEO,0,0,0,5,5
2013,Iran (Islamic Rep. of),IRN,Georgia,GEO,0,0,5,28,33
2013,Iraq,IRQ,Georgia,GEO,12,14,185,413,624
2013,Kazakhstan,KAZ,Georgia,GEO,0,0,5,0,5
2013,Morocco,MAR,Georgia,GEO,0,0,0,5,5
2013,Russian Federation,RUS,Georgia,GEO,11,0,15,13,39
2013,Syrian Arab Rep.,SYR,Georgia,GEO,0,24,0,25,49
2013,Nigeria,NGA,Israel,ISR,5,0,0,0,5
2013,Unknown ,,Israel,ISR,0,0,900,0,900
2013,Afghanistan,AFG,Rep. of Korea,KOR,0,0,37,0,37
2013,Egypt,EGY,Rep. of Korea,KOR,0,0,5,0,5
2013,Bangladesh,BGD,Rep. of Korea,KOR,10,0,5,5,20
2013,China,CHN,Rep. of Korea,KOR,0,5,0,0,5
2013,Cameroon,CMR,Rep. of Korea,KOR,0,0,11,10,21
2013,Ethiopia,ETH,Rep. of Korea,KOR,0,0,16,0,16
2013,Guinea,GIN,Rep. of Korea,KOR,0,0,5,0,5
2013,India,IND,Rep. of Korea,KOR,0,0,13,0,13
2013,Liberia,LBR,Rep. of Korea,KOR,0,0,10,10,20
2013,Sri Lanka,LKA,Rep. of Korea,KOR,0,0,92,152,244
2013,Mali,MLI,Rep. of Korea,KOR,5,0,0,0,5
2013,Mongolia,MNG,Rep. of Korea,KOR,0,0,5,0,5
2013,Myanmar,MMR,Rep. of Korea,KOR,14,0,17,5,36
2013,Nepal,NPL,Rep. of Korea,KOR,0,0,25,13,38
2013,Nigeria,NGA,Rep. of Korea,KOR,0,0,33,17,50
2013,Pakistan,PAK,Rep. of Korea,KOR,5,0,183,81,269
2013,South Africa,ZAF,Rep. of Korea,KOR,0,0,5,5,10
2013,Sudan,SDN,Rep. of Korea,KOR,5,0,0,0,5
2013,Syrian Arab Rep.,SYR,Rep. of Korea,KOR,0,0,0,10,10
2013,Uganda,UGA,Rep. of Korea,KOR,0,0,45,12,57
2013,Afghanistan,AFG,North Macedonia,MKD,0,0,0,116,116
2013,Algeria,DZA,North Macedonia,MKD,0,0,0,64,64
2013,Bangladesh,BGD,North Macedonia,MKD,0,0,0,13,13
2013,Burkina Faso,BFA,North Macedonia,MKD,0,0,0,5,5
2013,Comoros,COM,North Macedonia,MKD,0,0,0,21,21
2013,Eritrea,ERI,North Macedonia,MKD,0,0,0,10,10
2013,Gambia,GMB,North Macedonia,MKD,0,0,0,10,10
2013,Palestinian,PSE,North Macedonia,MKD,0,0,0,17,17
2013,Ghana,GHA,North Macedonia,MKD,0,0,0,5,5
2013,Guinea,GIN,North Macedonia,MKD,0,0,0,5,5
2013,Cote d'Ivoire,CIV,North Macedonia,MKD,0,0,0,12,12
2013,Iran (Islamic Rep. of),IRN,North Macedonia,MKD,0,0,0,5,5
2013,Iraq,IRQ,North Macedonia,MKD,0,0,0,5,5
2013,Mauritania,MRT,North Macedonia,MKD,0,0,0,14,14
2013,Mali,MLI,North Macedonia,MKD,0,0,0,13,13
2013,Morocco,MAR,North Macedonia,MKD,0,0,0,40,40
2013,Nigeria,NGA,North Macedonia,MKD,0,0,0,23,23
2013,Pakistan,PAK,North Macedonia,MKD,0,0,0,100,100
2013,Serbia and Kosovo: S/RES/1244 (1999),SRB,North Macedonia,MKD,0,0,0,28,28
2013,Senegal,SEN,North Macedonia,MKD,0,0,0,5,5
2013,Somalia,SOM,North Macedonia,MKD,0,0,0,74,74
2013,Sudan,SDN,North Macedonia,MKD,0,0,0,5,5
2013,Syrian Arab Rep.,SYR,North Macedonia,MKD,0,0,0,166,166
2013,Tunisia,TUN,North Macedonia,MKD,0,0,0,5,5
2013,Western Sahara,ESH,North Macedonia,MKD,0,0,0,5,5
2013,Afghanistan,AFG,Montenegro,MNE,0,0,10,176,186
2013,Algeria,DZA,Montenegro,MNE,0,0,161,592,753
2013,Egypt,EGY,Montenegro,MNE,0,0,0,36,36
2013,Bangladesh,BGD,Montenegro,MNE,0,0,0,18,18
2013,Dem. Rep. of the Congo,COD,Montenegro,MNE,0,0,0,5,5
2013,Comoros,COM,Montenegro,MNE,0,0,0,5,5
2013,Eritrea,ERI,Montenegro,MNE,0,0,0,286,286
2013,Ethiopia,ETH,Montenegro,MNE,0,0,0,5,5
2013,Palestinian,PSE,Montenegro,MNE,0,0,0,5,5
2013,Ghana,GHA,Montenegro,MNE,0,0,0,5,5
2013,Guinea,GIN,Montenegro,MNE,0,0,0,10,10
2013,India,IND,Montenegro,MNE,0,0,0,13,13
2013,Indonesia,IDN,Montenegro,MNE,0,0,0,5,5
2013,Iran (Islamic Rep. of),IRN,Montenegro,MNE,0,0,0,5,5
2013,Iraq,IRQ,Montenegro,MNE,0,0,0,5,5
2013,Morocco,MAR,Montenegro,MNE,0,0,84,216,300
2013,Nigeria,NGA,Montenegro,MNE,0,0,0,113,113
2013,Pakistan,PAK,Montenegro,MNE,0,0,93,899,992
2013,Russian Federation,RUS,Montenegro,MNE,0,0,5,0,5
2013,Serbia and Kosovo: S/RES/1244 (1999),SRB,Montenegro,MNE,0,0,5,0,5
2013,Senegal,SEN,Montenegro,MNE,0,0,0,5,5
2013,Somalia,SOM,Montenegro,MNE,0,0,0,193,193
2013,Sudan,SDN,Montenegro,MNE,0,0,0,117,117
2013,Syrian Arab Rep.,SYR,Montenegro,MNE,0,0,0,232,232
2013,Tunisia,TUN,Montenegro,MNE,0,0,28,114,142
2013,Yemen,YEM,Montenegro,MNE,0,0,0,10,10
2013,Myanmar,MMR,Thailand,THA,968,0,0,89,1057
2013,Afghanistan,AFG,Tajikistan,TJK,227,0,90,0,317
2013,Burundi,BDI,Uganda,UGA,158,0,712,574,1444
2013,Dem. Rep. of the Congo,COD,Uganda,UGA,6098,0,195,2714,9007
2013,Eritrea,ERI,Uganda,UGA,90,0,800,120,1010
2013,Ethiopia,ETH,Uganda,UGA,64,0,140,542,746
2013,Guinea,GIN,Uganda,UGA,0,0,0,5,5
2013,Kenya,KEN,Uganda,UGA,12,0,46,15,73
2013,Liberia,LBR,Uganda,UGA,0,0,0,5,5
2013,Pakistan,PAK,Uganda,UGA,14,0,29,0,43
2013,Rwanda,RWA,Uganda,UGA,144,0,208,2107,2459
2013,Sierra Leone,SLE,Uganda,UGA,0,0,0,5,5
2013,Somalia,SOM,Uganda,UGA,3004,0,0,2235,5239
2013,Sudan,SDN,Uganda,UGA,52,0,5,923,980
2013,South Sudan,SSD,Uganda,UGA,1473,0,64,81,1618
2013,United Rep. of Tanzania,TZA,Uganda,UGA,0,0,0,10,10
2014,Central African Rep.,CAF,Chad,TCD,887,0,0,0,887
2014,Dem. Rep. of the Congo,COD,Chad,TCD,5,0,0,0,5
2014,Sudan,SDN,Chad,TCD,5,0,0,0,5
2014,Central African Rep.,CAF,Congo,COG,27,32,0,0,59
2014,Chad,TCD,Congo,COG,0,0,0,5,5
2014,Dem. Rep. of the Congo,COD,Congo,COG,28,12,5,34,79
2014,Rwanda,RWA,Congo,COG,5,0,0,26,31
2014,Angola,AGO,Gabon,GAB,0,0,0,32,32
2014,Central African Rep.,CAF,Gabon,GAB,15,0,10,0,25
2014,Chad,TCD,Gabon,GAB,0,0,5,268,273
2014,Dem. Rep. of the Congo,COD,Gabon,GAB,0,0,10,284,294
2014,Equatorial Guinea,GNQ,Gabon,GAB,0,0,0,10,10
2014,Cote d'Ivoire,CIV,Gabon,GAB,0,0,0,18,18
2014,Liberia,LBR,Gabon,GAB,0,0,0,5,5
2014,Mauritania,MRT,Gabon,GAB,0,0,0,21,21
2014,Rwanda,RWA,Gabon,GAB,0,0,0,11,11
2014,Sierra Leone,SLE,Gabon,GAB,0,0,0,10,10
2014,Sudan,SDN,Gabon,GAB,0,0,0,5,5
2014,Togo,TGO,Gabon,GAB,0,0,0,5,5
2014,Nicaragua,NIC,Honduras,HND,10,0,0,0,10
2014,El Salvador,SLV,Honduras,HND,5,0,0,0,5
2014,Afghanistan,AFG,Rep. of Korea,KOR,0,5,10,10,25
2014,Egypt,EGY,Rep. of Korea,KOR,0,0,97,25,122
2014,Bangladesh,BGD,Rep. of Korea,KOR,0,0,47,11,58
2014,Burkina Faso,BFA,Rep. of Korea,KOR,0,0,5,0,5
2014,China,CHN,Rep. of Korea,KOR,0,0,93,37,130
2014,Cameroon,CMR,Rep. of Korea,KOR,0,0,34,14,48
2014,Dem. Rep. of the Congo,COD,Rep. of Korea,KOR,0,0,5,5,10
2014,Ethiopia,ETH,Rep. of Korea,KOR,43,0,0,5,48
2014,Ghana,GHA,Rep. of Korea,KOR,0,0,10,5,15
2014,Guinea,GIN,Rep. of Korea,KOR,0,0,12,5,17
2014,Cote d'Ivoire,CIV,Rep. of Korea,KOR,0,0,11,0,11
2014,Iran (Islamic Rep. of),IRN,Rep. of Korea,KOR,5,0,0,0,5
2014,Kenya,KEN,Rep. of Korea,KOR,0,0,10,0,10
2014,Liberia,LBR,Rep. of Korea,KOR,0,5,23,18,46
2014,Sri Lanka,LKA,Rep. of Korea,KOR,0,5,16,5,26
2014,Morocco,MAR,Rep. of Korea,KOR,0,0,10,5,15
2014,Myanmar,MMR,Rep. of Korea,KOR,0,5,0,10,15
2014,Nepal,NPL,Rep. of Korea,KOR,0,0,79,15,94
2014,Nigeria,NGA,Rep. of Korea,KOR,0,0,110,25,135
2014,Pakistan,PAK,Rep. of Korea,KOR,10,5,318,57,390
2014,Philippines,PHL,Rep. of Korea,KOR,0,0,5,0,5
2014,South Africa,ZAF,Rep. of Korea,KOR,0,0,37,13,50
2014,Somalia,SOM,Rep. of Korea,KOR,0,0,0,5,5
2014,Sudan,SDN,Rep. of Korea,KOR,0,0,5,0,5
2014,Syrian Arab Rep.,SYR,Rep. of Korea,KOR,0,502,10,61,573
2014,Uganda,UGA,Rep. of Korea,KOR,5,0,27,18,50
2014,Uzbekistan,UZB,Rep. of Korea,KOR,0,0,5,0,5
2014,Yemen,YEM,Rep. of Korea,KOR,5,0,5,13,23
2014,Afghanistan,AFG,North Macedonia,MKD,0,0,0,192,192
2014,Algeria,DZA,North Macedonia,MKD,0,0,0,26,26
2014,Bangladesh,BGD,North Macedonia,MKD,0,0,0,44,44
2014,Comoros,COM,North Macedonia,MKD,0,0,0,19,19
2014,Eritrea,ERI,North Macedonia,MKD,0,0,0,14,14
2014,Palestinian,PSE,North Macedonia,MKD,0,0,0,15,15
2014,Ghana,GHA,North Macedonia,MKD,0,0,0,5,5
2014,Cote d'Ivoire,CIV,North Macedonia,MKD,0,0,0,5,5
2014,India,IND,North Macedonia,MKD,0,0,0,5,5
2014,Mali,MLI,North Macedonia,MKD,0,0,0,10,10
2014,Morocco,MAR,North Macedonia,MKD,0,0,0,18,18
2014,Nigeria,NGA,North Macedonia,MKD,0,0,0,5,5
2014,Pakistan,PAK,North Macedonia,MKD,0,0,0,55,55
2014,Serbia and Kosovo: S/RES/1244 (1999),SRB,North Macedonia,MKD,0,0,5,0,5
2014,Senegal,SEN,North Macedonia,MKD,0,0,0,13,13
2014,Somalia,SOM,North Macedonia,MKD,0,0,0,59,59
2014,Syrian Arab Rep.,SYR,North Macedonia,MKD,11,0,0,314,325
2014,Togo,TGO,North Macedonia,MKD,0,0,0,5,5
2014,Afghanistan,AFG,Montenegro,MNE,0,0,0,14,14
2014,Algeria,DZA,Montenegro,MNE,0,0,5,32,37
2014,Egypt,EGY,Montenegro,MNE,0,0,0,5,5
2014,Cameroon,CMR,Montenegro,MNE,0,0,0,5,5
2014,Congo,COG,Montenegro,MNE,0,0,0,10,10
2014,Dem. Rep. of the Congo,COD,Montenegro,MNE,0,0,0,40,40
2014,Cuba,CUB,Montenegro,MNE,0,0,0,5,5
2014,Eritrea,ERI,Montenegro,MNE,0,0,0,362,362
2014,Gambia,GMB,Montenegro,MNE,0,0,0,15,15
2014,Guinea,GIN,Montenegro,MNE,0,0,0,12,12
2014,Cote d'Ivoire,CIV,Montenegro,MNE,0,0,0,5,5
2014,India,IND,Montenegro,MNE,0,0,0,10,10
2014,Iran (Islamic Rep. of),IRN,Montenegro,MNE,0,0,0,5,5
2014,Iraq,IRQ,Montenegro,MNE,0,0,0,5,5
2014,Mali,MLI,Montenegro,MNE,0,0,0,5,5
2014,Morocco,MAR,Montenegro,MNE,0,0,5,17,22
2014,Nigeria,NGA,Montenegro,MNE,0,0,0,29,29
2014,Pakistan,PAK,Montenegro,MNE,0,0,5,18,23
2014,Russian Federation,RUS,Montenegro,MNE,0,0,5,0,5
2014,Senegal,SEN,Montenegro,MNE,0,0,0,5,5
2014,Somalia,SOM,Montenegro,MNE,0,0,0,28,28
2014,Sudan,SDN,Montenegro,MNE,0,0,5,80,85
2014,Syrian Arab Rep.,SYR,Montenegro,MNE,0,0,0,1672,1672
2014,Tunisia,TUN,Montenegro,MNE,0,0,0,13,13
2014,Yemen,YEM,Montenegro,MNE,0,0,0,5,5
2014,Afghanistan,AFG,Tajikistan,TJK,159,0,204,1939,2302
2014,Burundi,BDI,Uganda,UGA,791,0,191,51,1033
2014,Bangladesh,BGD,Uganda,UGA,0,0,5,0,5
2014,Central African Rep.,CAF,Uganda,UGA,5,0,0,0,5
2014,Dem. Rep. of the Congo,COD,Uganda,UGA,10391,0,723,1203,12317
2014,Eritrea,ERI,Uganda,UGA,251,0,741,74,1066
2014,Ethiopia,ETH,Uganda,UGA,333,0,82,39,454
2014,Kenya,KEN,Uganda,UGA,0,0,10,0,10
2014,Pakistan,PAK,Uganda,UGA,0,0,19,0,19
2014,Rwanda,RWA,Uganda,UGA,285,0,359,97,741
2014,Somalia,SOM,Uganda,UGA,2697,0,5,96,2798
2014,Sudan,SDN,Uganda,UGA,448,0,5,0,453
2014,South Sudan,SSD,Uganda,UGA,2159,0,0,84,2243
2015,Afghanistan,AFG,Austria,AUT,2083,1263,2478,2306,8130
2015,Albania,ALB,Austria,AUT,0,5,88,20,113
2015,Algeria,DZA,Austria,AUT,0,0,459,205,664
2015,Angola,AGO,Austria,AUT,5,0,5,0,10
2015,Egypt,EGY,Austria,AUT,16,0,68,38,122
2015,Armenia,ARM,Austria,AUT,22,14,145,25,206
2015,Azerbaijan,AZE,Austria,AUT,11,5,24,17,57
2015,Burundi,BDI,Austria,AUT,5,0,0,0,5
2015,Benin,BEN,Austria,AUT,0,0,12,0,12
2015,Bangladesh,BGD,Austria,AUT,42,18,439,142,641
2015,Burkina Faso,BFA,Austria,AUT,0,0,5,0,5
2015,Belarus,BLR,Austria,AUT,0,0,13,10,23
2015,Bosnia and Herzegovina,BIH,Austria,AUT,11,10,100,42,163
2015,Bulgaria,BGR,Austria,AUT,0,0,0,5,5
2015,Chad,TCD,Austria,AUT,0,0,5,0,5
2015,China,CHN,Austria,AUT,54,0,82,46,182
2015,Cameroon,CMR,Austria,AUT,25,5,47,10,87
2015,Congo,COG,Austria,AUT,10,0,5,10,25
2015,Dem. Rep. of the Congo,COD,Austria,AUT,32,10,35,14,91
2015,Cuba,CUB,Austria,AUT,0,0,23,10,33
2015,Eritrea,ERI,Austria,AUT,39,10,10,13,72
2015,Ethiopia,ETH,Austria,AUT,10,5,13,5,33
2015,Gabon,GAB,Austria,AUT,0,0,10,0,10
2015,Gambia,GMB,Austria,AUT,20,0,103,22,145
2015,Georgia,GEO,Austria,AUT,0,33,129,43,205
2015,Germany,DEU,Austria,AUT,0,0,0,12,12
2015,Ghana,GHA,Austria,AUT,0,0,30,11,41
2015,Guinea-Bissau,GNB,Austria,AUT,0,0,5,5,10
2015,Guinea,GIN,Austria,AUT,26,11,32,5,74
2015,Croatia,HRV,Austria,AUT,0,0,5,0,5
2015,Hungary,HUN,Austria,AUT,0,0,0,5,5
2015,Cote d'Ivoire,CIV,Austria,AUT,0,0,30,0,30
2015,India,IND,Austria,AUT,0,5,165,51,221
2015,Iran (Islamic Rep. of),IRN,Austria,AUT,436,5,155,175,771
2015,Iraq,IRQ,Austria,AUT,637,266,571,1394,2868
2015,Jordan,JOR,Austria,AUT,13,0,5,0,18
2015,Kazakhstan,KAZ,Austria,AUT,5,0,19,5,29
2015,Kenya,KEN,Austria,AUT,5,0,5,0,10
2015,Kyrgyzstan,KGZ,Austria,AUT,13,5,27,5,50
2015,Kuwait,KWT,Austria,AUT,0,0,0,5,5
2015,Liberia,LBR,Austria,AUT,0,0,5,0,5
2015,Libya,LBY,Austria,AUT,13,5,53,30,101
2015,Lebanon,LBN,Austria,AUT,10,0,23,5,38
2015,Sri Lanka,LKA,Austria,AUT,5,13,20,10,48
2015,Mauritania,MRT,Austria,AUT,0,0,5,0,5
2015,North Macedonia,MKD,Austria,AUT,0,0,187,49,236
2015,Rep. of Moldova,MDA,Austria,AUT,0,0,10,10,20
2015,Mali,MLI,Austria,AUT,0,0,24,12,36
2015,Mongolia,MNG,Austria,AUT,5,5,67,21,98
2015,Morocco,MAR,Austria,AUT,0,0,258,92,350
2015,Montenegro,MNE,Austria,AUT,0,0,13,0,13
2015,Myanmar,MMR,Austria,AUT,5,0,5,5,15
2015,Nepal,NPL,Austria,AUT,0,5,18,5,28
2015,Niger,NER,Austria,AUT,0,0,5,0,5
2015,Nigeria,NGA,Austria,AUT,12,27,637,125,801
2015,Pakistan,PAK,Austria,AUT,25,5,1052,579,1661
2015,Romania,ROU,Austria,AUT,0,0,0,10,10
2015,Russian Federation,RUS,Austria,AUT,667,141,947,228,1983
2015,Rwanda,RWA,Austria,AUT,0,0,5,0,5
2015,Saudi Arabia,SAU,Austria,AUT,5,0,0,0,5
2015,Serbia and Kosovo: S/RES/1244 (1999),SRB,Austria,AUT,28,41,2802,585,3456
2015,Senegal,SEN,Austria,AUT,0,0,52,10,62
2015,Sierra Leone,SLE,Austria,AUT,0,0,17,5,22
2015,Somalia,SOM,Austria,AUT,548,279,247,79,1153
2015,Viet Nam,VNM,Austria,AUT,0,0,5,10,15
2015,Sudan,SDN,Austria,AUT,26,5,20,13,64
2015,South Sudan,SSD,Austria,AUT,0,0,5,0,5
2015,Syrian Arab Rep.,SYR,Austria,AUT,8114,183,752,1213,10262
2015,Tajikistan,TJK,Austria,AUT,10,10,40,0,60
2015,Turkmenistan,TKM,Austria,AUT,0,0,5,0,5
2015,Togo,TGO,Austria,AUT,0,0,5,0,5
2015,Tunisia,TUN,Austria,AUT,0,0,84,26,110
2015,Turkey,TUR,Austria,AUT,10,10,106,54,180
2015,Uganda,UGA,Austria,AUT,0,0,17,0,17
2015,Ukraine,UKR,Austria,AUT,22,10,115,47,194
2015,Uzbekistan,UZB,Austria,AUT,5,5,14,5,29
2015,Western Sahara,ESH,Austria,AUT,0,0,5,0,5
2015,Yemen,YEM,Austria,AUT,12,5,5,5,27
2015,Zambia,ZMB,Austria,AUT,0,5,5,0,10
2015,Stateless,XXA,Austria,AUT,1333,39,123,85,1580
2015,Unknown ,,Austria,AUT,29,0,29,10,68
2015,Central African Rep.,CAF,Chad,TCD,1041,0,15,0,1056
2015,Dem. Rep. of the Congo,COD,Chad,TCD,17,0,0,0,17
2015,Sudan,SDN,Chad,TCD,21,0,0,0,21
2015,Syrian Arab Rep.,SYR,Chad,TCD,5,0,0,0,5
2015,Angola,AGO,Congo,COG,0,0,0,18,18
2015,Burundi,BDI,Congo,COG,0,0,0,12,12
2015,Central African Rep.,CAF,Congo,COG,5,0,0,33,38
2015,Chad,TCD,Congo,COG,5,0,0,111,116
2015,Dem. Rep. of the Congo,COD,Congo,COG,42,0,0,1550,1592
2015,Guinea,GIN,Congo,COG,0,0,0,5,5
2015,Cote d'Ivoire,CIV,Congo,COG,0,0,0,57,57
2015,Liberia,LBR,Congo,COG,0,0,0,5,5
2015,Mauritania,MRT,Congo,COG,0,0,0,44,44
2015,Rwanda,RWA,Congo,COG,12,0,0,82,94
2015,Sierra Leone,SLE,Congo,COG,0,0,0,5,5
2015,Sudan,SDN,Congo,COG,0,0,0,5,5
2015,Syrian Arab Rep.,SYR,Congo,COG,5,0,0,0,5
2015,Central African Rep.,CAF,Gabon,GAB,0,10,0,0,10
2015,Congo,COG,Gabon,GAB,0,0,0,10,10
2015,Dem. Rep. of the Congo,COD,Gabon,GAB,0,5,0,0,5
2015,Nicaragua,NIC,Honduras,HND,5,0,0,11,16
2015,El Salvador,SLV,Honduras,HND,5,0,0,0,5
2015,Afghanistan,AFG,Hungary,HUN,25,65,367,39888,40345
2015,Albania,ALB,Hungary,HUN,0,0,29,214,243
2015,Algeria,DZA,Hungary,HUN,0,0,141,455,596
2015,Angola,AGO,Hungary,HUN,0,0,0,5,5
2015,Egypt,EGY,Hungary,HUN,5,0,12,71,88
2015,Armenia,ARM,Hungary,HUN,0,0,0,5,5
2015,Azerbaijan,AZE,Hungary,HUN,0,0,0,5,5
2015,Burundi,BDI,Hungary,HUN,0,0,0,5,5
2015,Benin,BEN,Hungary,HUN,0,0,0,5,5
2015,Bangladesh,BGD,Hungary,HUN,0,0,86,3075,3161
2015,Burkina Faso,BFA,Hungary,HUN,0,0,0,39,39
2015,Bosnia and Herzegovina,BIH,Hungary,HUN,0,0,5,5,10
2015,Central African Rep.,CAF,Hungary,HUN,0,0,0,5,5
2015,China,CHN,Hungary,HUN,0,0,0,5,5
2015,Cameroon,CMR,Hungary,HUN,0,0,23,540,563
2015,Congo,COG,Hungary,HUN,0,0,5,315,320
2015,Dem. Rep. of the Congo,COD,Hungary,HUN,0,0,5,546,551
2015,Comoros,COM,Hungary,HUN,0,0,5,152,157
2015,Cuba,CUB,Hungary,HUN,10,0,64,189,263
2015,Dominica,DMA,Hungary,HUN,0,0,0,5,5
2015,Dominican Rep.,DOM,Hungary,HUN,0,0,0,10,10
2015,Eritrea,ERI,Hungary,HUN,5,5,0,436,446
2015,Ethiopia,ETH,Hungary,HUN,0,0,5,27,32
2015,Gabon,GAB,Hungary,HUN,0,0,0,10,10
2015,Gambia,GMB,Hungary,HUN,0,0,11,138,149
2015,Palestinian,PSE,Hungary,HUN,10,5,5,987,1007
2015,Georgia,GEO,Hungary,HUN,5,0,10,24,39
2015,Ghana,GHA,Hungary,HUN,0,0,38,288,326
2015,Guinea,GIN,Hungary,HUN,0,0,10,89,99
2015,Haiti,HTI,Hungary,HUN,0,0,0,18,18
2015,Cote d'Ivoire,CIV,Hungary,HUN,5,0,22,257,284
2015,India,IND,Hungary,HUN,0,0,0,257,257
2015,Iran (Islamic Rep. of),IRN,Hungary,HUN,15,5,36,1442,1498
2015,Iraq,IRQ,Hungary,HUN,5,40,72,7247,7364
2015,Jordan,JOR,Hungary,HUN,0,0,0,5,5
2015,Kenya,KEN,Hungary,HUN,0,0,0,5,5
2015,Lao People's Dem. Rep.,LAO,Hungary,HUN,0,0,0,5,5
2015,Liberia,LBR,Hungary,HUN,0,0,5,12,17
2015,Libya,LBY,Hungary,HUN,0,0,0,46,46
2015,Lebanon,LBN,Hungary,HUN,0,0,0,12,12
2015,Sri Lanka,LKA,Hungary,HUN,0,0,0,88,88
2015,Mauritania,MRT,Hungary,HUN,0,0,5,55,60
2015,North Macedonia,MKD,Hungary,HUN,0,0,0,17,17
2015,Rep. of Moldova,MDA,Hungary,HUN,0,0,5,5,10
2015,Mali,MLI,Hungary,HUN,0,0,10,252,262
2015,Mongolia,MNG,Hungary,HUN,0,0,0,98,98
2015,Morocco,MAR,Hungary,HUN,0,0,41,212,253
2015,Montenegro,MNE,Hungary,HUN,0,0,0,5,5
2015,Myanmar,MMR,Hungary,HUN,0,0,0,45,45
2015,Nepal,NPL,Hungary,HUN,0,0,5,18,23
2015,Niger,NER,Hungary,HUN,0,0,0,12,12
2015,Nigeria,NGA,Hungary,HUN,5,0,126,753,884
2015,Pakistan,PAK,Hungary,HUN,0,5,257,11376,11638
2015,Russian Federation,RUS,Hungary,HUN,0,0,5,11,16
2015,Rwanda,RWA,Hungary,HUN,0,0,5,15,20
2015,Serbia and Kosovo: S/RES/1244 (1999),SRB,Hungary,HUN,0,0,1255,33582,34837
2015,Senegal,SEN,Hungary,HUN,0,0,10,204,214
2015,Sierra Leone,SLE,Hungary,HUN,0,0,5,96,101
2015,Somalia,SOM,Hungary,HUN,18,49,5,243,315
2015,Viet Nam,VNM,Hungary,HUN,0,0,18,18,36
2015,Sudan,SDN,Hungary,HUN,0,11,18,206,235
2015,South Sudan,SSD,Hungary,HUN,0,0,0,15,15
2015,Syrian Arab Rep.,SYR,Hungary,HUN,19,140,108,46902,47169
2015,Togo,TGO,Hungary,HUN,0,0,0,61,61
2015,Tunisia,TUN,Hungary,HUN,0,0,10,69,79
2015,Turkey,TUR,Hungary,HUN,0,0,17,270,287
2015,United Arab Emirates,ARE,Hungary,HUN,0,0,0,5,5
2015,Uganda,UGA,Hungary,HUN,0,0,5,67,72
2015,Ukraine,UKR,Hungary,HUN,0,0,5,22,27
2015,Uzbekistan,UZB,Hungary,HUN,0,0,0,11,11
2015,Western Sahara,ESH,Hungary,HUN,0,0,5,5,10
2015,Yemen,YEM,Hungary,HUN,0,12,0,41,53
2015,Stateless,XXA,Hungary,HUN,0,0,0,18,18
2015,Unknown ,,Hungary,HUN,15,5,17,602,639
2015,Eritrea,ERI,Israel,ISR,0,0,330,0,330
2015,Unknown ,,Israel,ISR,0,0,413,0,413
2015,Afghanistan,AFG,Rep. of Korea,KOR,5,10,5,5,25
2015,Algeria,DZA,Rep. of Korea,KOR,0,0,5,0,5
2015,Egypt,EGY,Rep. of Korea,KOR,0,0,388,60,448
2015,Bangladesh,BGD,Rep. of Korea,KOR,0,0,134,5,139
2015,Burkina Faso,BFA,Rep. of Korea,KOR,0,0,5,0,5
2015,Cambodia,KHM,Rep. of Korea,KOR,0,0,5,0,5
2015,China,CHN,Rep. of Korea,KOR,0,10,180,21,211
2015,Cameroon,CMR,Rep. of Korea,KOR,0,0,114,5,119
2015,Dem. Rep. of the Congo,COD,Rep. of Korea,KOR,0,0,5,0,5
2015,Ethiopia,ETH,Rep. of Korea,KOR,11,0,19,0,30
2015,Gambia,GMB,Rep. of Korea,KOR,0,0,5,0,5
2015,Ghana,GHA,Rep. of Korea,KOR,0,0,110,5,115
2015,Guinea,GIN,Rep. of Korea,KOR,0,0,13,0,13
2015,Cote d'Ivoire,CIV,Rep. of Korea,KOR,0,0,10,0,10
2015,India,IND,Rep. of Korea,KOR,0,0,34,5,39
2015,Iran (Islamic Rep. of),IRN,Rep. of Korea,KOR,5,0,0,0,5
2015,Iraq,IRQ,Rep. of Korea,KOR,0,10,10,0,20
2015,Jordan,JOR,Rep. of Korea,KOR,0,0,5,0,5
2015,Kazakhstan,KAZ,Rep. of Korea,KOR,0,0,5,5,10
2015,Kenya,KEN,Rep. of Korea,KOR,0,0,16,0,16
2015,Kyrgyzstan,KGZ,Rep. of Korea,KOR,0,0,5,5,10
2015,Liberia,LBR,Rep. of Korea,KOR,0,0,66,10,76
2015,Libya,LBY,Rep. of Korea,KOR,0,5,0,0,5
2015,Sri Lanka,LKA,Rep. of Korea,KOR,0,0,26,5,31
2015,Mali,MLI,Rep. of Korea,KOR,0,0,5,0,5
2015,Mongolia,MNG,Rep. of Korea,KOR,0,0,5,0,5
2015,Morocco,MAR,Rep. of Korea,KOR,0,0,41,5,46
2015,Myanmar,MMR,Rep. of Korea,KOR,5,5,17,0,27
2015,Nepal,NPL,Rep. of Korea,KOR,0,0,201,5,206
2015,Nigeria,NGA,Rep. of Korea,KOR,0,0,335,11,346
2015,Pakistan,PAK,Rep. of Korea,KOR,10,10,512,47,579
2015,Philippines,PHL,Rep. of Korea,KOR,0,0,35,0,35
2015,South Africa,ZAF,Rep. of Korea,KOR,0,0,88,23,111
2015,Russian Federation,RUS,Rep. of Korea,KOR,0,0,10,0,10
2015,Senegal,SEN,Rep. of Korea,KOR,0,0,19,0,19
2015,Sierra Leone,SLE,Rep. of Korea,KOR,0,0,5,0,5
2015,Viet Nam,VNM,Rep. of Korea,KOR,0,0,93,29,122
2015,Sudan,SDN,Rep. of Korea,KOR,0,0,5,0,5
2015,Syrian Arab Rep.,SYR,Rep. of Korea,KOR,0,142,0,5,147
2015,Thailand,THA,Rep. of Korea,KOR,0,0,45,0,45
2015,Togo,TGO,Rep. of Korea,KOR,0,0,5,0,5
2015,Tunisia,TUN,Rep. of Korea,KOR,0,0,10,0,10
2015,Uganda,UGA,Rep. of Korea,KOR,0,0,101,5,106
2015,Ukraine,UKR,Rep. of Korea,KOR,0,5,5,0,10
2015,Uzbekistan,UZB,Rep. of Korea,KOR,0,0,21,5,26
2015,Yemen,YEM,Rep. of Korea,KOR,0,0,61,5,66
2015,Afghanistan,AFG,North Macedonia,MKD,0,0,0,914,914
2015,Algeria,DZA,North Macedonia,MKD,0,0,0,17,17
2015,Egypt,EGY,North Macedonia,MKD,0,0,0,5,5
2015,Bangladesh,BGD,North Macedonia,MKD,0,0,0,30,30
2015,Cameroon,CMR,North Macedonia,MKD,0,0,0,5,5
2015,Congo,COG,North Macedonia,MKD,0,0,0,42,42
2015,Comoros,COM,North Macedonia,MKD,0,0,0,14,14
2015,Eritrea,ERI,North Macedonia,MKD,0,0,0,19,19
2015,Gambia,GMB,North Macedonia,MKD,0,0,0,5,5
2015,Palestinian,PSE,North Macedonia,MKD,0,0,0,70,70
2015,Ghana,GHA,North Macedonia,MKD,0,0,0,13,13
2015,Guinea,GIN,North Macedonia,MKD,0,0,0,10,10
2015,Cote d'Ivoire,CIV,North Macedonia,MKD,0,0,0,5,5
2015,India,IND,North Macedonia,MKD,0,0,0,5,5
2015,Iran (Islamic Rep. of),IRN,North Macedonia,MKD,0,0,0,35,35
2015,Iraq,IRQ,North Macedonia,MKD,0,0,0,179,179
2015,Kazakhstan,KAZ,North Macedonia,MKD,0,0,0,5,5
2015,Lebanon,LBN,North Macedonia,MKD,0,0,0,5,5
2015,Mauritania,MRT,North Macedonia,MKD,0,0,0,5,5
2015,Mali,MLI,North Macedonia,MKD,0,0,0,15,15
2015,Morocco,MAR,North Macedonia,MKD,0,0,0,42,42
2015,Myanmar,MMR,North Macedonia,MKD,0,0,0,10,10
2015,Nigeria,NGA,North Macedonia,MKD,0,0,0,30,30
2015,Pakistan,PAK,North Macedonia,MKD,0,0,0,137,137
2015,Russian Federation,RUS,North Macedonia,MKD,0,0,0,5,5
2015,Serbia and Kosovo: S/RES/1244 (1999),SRB,North Macedonia,MKD,0,0,5,5,10
2015,Senegal,SEN,North Macedonia,MKD,0,0,0,11,11
2015,Sierra Leone,SLE,North Macedonia,MKD,0,0,0,5,5
2015,Somalia,SOM,North Macedonia,MKD,0,0,0,116,116
2015,Sudan,SDN,North Macedonia,MKD,0,0,0,10,10
2015,Syrian Arab Rep.,SYR,North Macedonia,MKD,0,0,5,1644,1649
2015,Western Sahara,ESH,North Macedonia,MKD,0,0,0,5,5
2015,Afghanistan,AFG,Montenegro,MNE,0,0,0,5,5
2015,Armenia,ARM,Montenegro,MNE,0,0,0,5,5
2015,Bangladesh,BGD,Montenegro,MNE,0,0,0,10,10
2015,Cameroon,CMR,Montenegro,MNE,0,0,0,5,5
2015,Dem. Rep. of the Congo,COD,Montenegro,MNE,0,0,0,40,40
2015,Eritrea,ERI,Montenegro,MNE,0,0,0,185,185
2015,Gambia,GMB,Montenegro,MNE,0,0,0,34,34
2015,Palestinian,PSE,Montenegro,MNE,0,0,0,5,5
2015,India,IND,Montenegro,MNE,0,0,0,5,5
2015,Iran (Islamic Rep. of),IRN,Montenegro,MNE,0,0,0,5,5
2015,Iraq,IRQ,Montenegro,MNE,0,0,0,42,42
2015,Liberia,LBR,Montenegro,MNE,0,0,0,5,5
2015,Mauritania,MRT,Montenegro,MNE,0,0,0,5,5
2015,Mali,MLI,Montenegro,MNE,0,0,0,14,14
2015,Nigeria,NGA,Montenegro,MNE,0,0,0,24,24
2015,Serbia and Kosovo: S/RES/1244 (1999),SRB,Montenegro,MNE,0,0,0,5,5
2015,Somalia,SOM,Montenegro,MNE,0,0,0,156,156
2015,Sudan,SDN,Montenegro,MNE,0,0,0,38,38
2015,Syrian Arab Rep.,SYR,Montenegro,MNE,14,0,0,1018,1032
2015,Tunisia,TUN,Montenegro,MNE,0,0,0,5,5
2015,Ukraine,UKR,Montenegro,MNE,0,0,0,5,5
2015,Afghanistan,AFG,Tajikistan,TJK,248,0,125,0,373
2015,Egypt,EGY,Uganda,UGA,0,0,0,5,5
2015,Burundi,BDI,Uganda,UGA,7937,0,175,0,8112
2015,Chad,TCD,Uganda,UGA,0,0,5,0,5
2015,Dem. Rep. of the Congo,COD,Uganda,UGA,15079,0,1191,0,16270
2015,Eritrea,ERI,Uganda,UGA,492,0,1343,0,1835
2015,Ethiopia,ETH,Uganda,UGA,422,0,203,0,625
2015,Kenya,KEN,Uganda,UGA,0,0,5,131,136
2015,Mali,MLI,Uganda,UGA,0,0,5,0,5
2015,Pakistan,PAK,Uganda,UGA,133,0,11,0,144
2015,Rwanda,RWA,Uganda,UGA,166,0,554,0,720
2015,Somalia,SOM,Uganda,UGA,7350,0,0,0,7350
2015,Sudan,SDN,Uganda,UGA,360,0,5,0,365
2015,South Sudan,SSD,Uganda,UGA,34,0,0,0,34
2015,Syrian Arab Rep.,SYR,Uganda,UGA,5,0,5,0,10
2015,Yemen,YEM,Uganda,UGA,5,0,0,0,5
2016,Afghanistan,AFG,Austria,AUT,1756,1693,182,2489,6120
2016,Albania,ALB,Austria,AUT,0,5,83,16,104
2016,Algeria,DZA,Austria,AUT,5,0,594,330,929
2016,Egypt,EGY,Austria,AUT,29,0,40,62,131
2016,Armenia,ARM,Austria,AUT,12,22,77,44,155
2016,Azerbaijan,AZE,Austria,AUT,12,10,15,0,37
2016,Benin,BEN,Austria,AUT,0,0,5,0,5
2016,Bangladesh,BGD,Austria,AUT,38,10,46,112,206
2016,Burkina Faso,BFA,Austria,AUT,0,0,0,5,5
2016,Belarus,BLR,Austria,AUT,0,0,5,5,10
2016,Bosnia and Herzegovina,BIH,Austria,AUT,0,0,37,98,135
2016,China,CHN,Austria,AUT,58,5,55,70,188
2016,Cameroon,CMR,Austria,AUT,16,0,10,10,36
2016,Congo,COG,Austria,AUT,12,0,0,0,12
2016,Dem. Rep. of the Congo,COD,Austria,AUT,38,0,5,5,48
2016,Cuba,CUB,Austria,AUT,0,0,0,5,5
2016,Dominican Rep.,DOM,Austria,AUT,0,0,0,5,5
2016,Eritrea,ERI,Austria,AUT,56,5,0,41,102
2016,Ethiopia,ETH,Austria,AUT,13,5,0,13,31
2016,Gambia,GMB,Austria,AUT,10,0,10,116,136
2016,Georgia,GEO,Austria,AUT,5,10,128,69,212
2016,Ghana,GHA,Austria,AUT,0,0,22,40,62
2016,Guinea-Bissau,GNB,Austria,AUT,0,0,0,10,10
2016,Guinea,GIN,Austria,AUT,16,0,5,23,44
2016,Cote d'Ivoire,CIV,Austria,AUT,5,0,5,18,28
2016,India,IND,Austria,AUT,0,5,132,86,223
2016,Iran (Islamic Rep. of),IRN,Austria,AUT,439,5,33,735,1212
2016,Iraq,IRQ,Austria,AUT,1328,633,97,2191,4249
2016,Jordan,JOR,Austria,AUT,16,0,5,10,31
2016,Kazakhstan,KAZ,Austria,AUT,24,5,17,11,57
2016,Kenya,KEN,Austria,AUT,0,0,5,0,5
2016,Kyrgyzstan,KGZ,Austria,AUT,5,5,5,5,20
2016,Kuwait,KWT,Austria,AUT,0,0,0,5,5
2016,Liberia,LBR,Austria,AUT,0,0,0,5,5
2016,Libya,LBY,Austria,AUT,5,13,5,78,101
2016,Lebanon,LBN,Austria,AUT,12,0,5,77,94
2016,Sri Lanka,LKA,Austria,AUT,5,0,5,56,66
2016,North Macedonia,MKD,Austria,AUT,0,0,166,50,216
2016,Rep. of Moldova,MDA,Austria,AUT,0,0,5,10,15
2016,Mali,MLI,Austria,AUT,0,0,5,34,39
2016,Mongolia,MNG,Austria,AUT,0,0,27,24,51
2016,Morocco,MAR,Austria,AUT,5,0,723,439,1167
2016,Montenegro,MNE,Austria,AUT,0,0,5,0,5
2016,Nepal,NPL,Austria,AUT,0,0,5,20,25
2016,Niger,NER,Austria,AUT,0,0,0,5,5
2016,Nigeria,NGA,Austria,AUT,16,15,211,326,568
2016,Pakistan,PAK,Austria,AUT,30,5,353,910,1298
2016,Romania,ROU,Austria,AUT,0,0,5,5,10
2016,Russian Federation,RUS,Austria,AUT,460,92,359,181,1092
2016,Serbia and Kosovo: S/RES/1244 (1999),SRB,Austria,AUT,16,29,379,227,651
2016,Senegal,SEN,Austria,AUT,0,0,17,24,41
2016,Sierra Leone,SLE,Austria,AUT,0,0,5,5,10
2016,Somalia,SOM,Austria,AUT,494,384,20,149,1047
2016,Viet Nam,VNM,Austria,AUT,0,0,5,18,23
2016,Sudan,SDN,Austria,AUT,25,13,11,28,77
2016,Syrian Arab Rep.,SYR,Austria,AUT,15528,585,0,1130,17243
2016,Thailand,THA,Austria,AUT,0,0,0,5,5
2016,Tajikistan,TJK,Austria,AUT,54,0,13,0,67
2016,Togo,TGO,Austria,AUT,0,0,0,5,5
2016,Tunisia,TUN,Austria,AUT,0,0,68,66,134
2016,Turkey,TUR,Austria,AUT,10,5,40,201,256
2016,Uganda,UGA,Austria,AUT,5,0,0,0,5
2016,Ukraine,UKR,Austria,AUT,22,22,67,125,236
2016,Uzbekistan,UZB,Austria,AUT,0,0,13,0,13
2016,Western Sahara,ESH,Austria,AUT,0,0,0,5,5
2016,Yemen,YEM,Austria,AUT,21,5,0,10,36
2016,Unknown ,,Austria,AUT,1690,83,25,118,1916
2016,Central African Rep.,CAF,Chad,TCD,903,0,10,10,923
2016,Cameroon,CMR,Chad,TCD,0,0,0,5,5
2016,Dem. Rep. of the Congo,COD,Chad,TCD,10,0,0,73,83
2016,Eritrea,ERI,Chad,TCD,0,0,0,5,5
2016,Ethiopia,ETH,Chad,TCD,0,0,0,12,12
2016,Guinea,GIN,Chad,TCD,0,0,0,5,5
2016,Cote d'Ivoire,CIV,Chad,TCD,0,0,0,14,14
2016,Libya,LBY,Chad,TCD,0,0,0,13,13
2016,Nigeria,NGA,Chad,TCD,0,0,0,23,23
2016,Senegal,SEN,Chad,TCD,0,0,0,5,5
2016,Somalia,SOM,Chad,TCD,0,0,0,21,21
2016,Sudan,SDN,Chad,TCD,14,0,0,10,24
2016,Syrian Arab Rep.,SYR,Chad,TCD,5,0,0,16,21
2016,Central African Rep.,CAF,Congo,COG,11,0,0,0,11
2016,Dem. Rep. of the Congo,COD,Congo,COG,16,0,0,0,16
2016,Rwanda,RWA,Congo,COG,5,0,0,0,5
2016,Unknown ,,Ecuador,ECU,271,0,1434,0,1705
2016,Central African Rep.,CAF,Gabon,GAB,0,0,24,0,24
2016,Chad,TCD,Gabon,GAB,0,0,10,0,10
2016,Congo,COG,Gabon,GAB,0,0,5,0,5
2016,Dem. Rep. of the Congo,COD,Gabon,GAB,0,5,39,11,55
2016,Nicaragua,NIC,Honduras,HND,0,0,0,5,5
2016,Syrian Arab Rep.,SYR,Honduras,HND,0,0,0,5,5
2016,Afghanistan,AFG,Hungary,HUN,28,69,1484,15170,16751
2016,Albania,ALB,Hungary,HUN,0,0,5,27,32
2016,Algeria,DZA,Hungary,HUN,0,0,176,479,655
2016,Egypt,EGY,Hungary,HUN,0,0,41,193,234
2016,Armenia,ARM,Hungary,HUN,0,0,13,0,13
2016,Bangladesh,BGD,Hungary,HUN,0,0,91,1000,1091
2016,Burkina Faso,BFA,Hungary,HUN,0,0,5,0,5
2016,China,CHN,Hungary,HUN,0,0,5,12,17
2016,Cameroon,CMR,Hungary,HUN,5,5,12,60,82
2016,Congo,COG,Hungary,HUN,0,0,10,81,91
2016,Dem. Rep. of the Congo,COD,Hungary,HUN,10,0,13,70,93
2016,Comoros,COM,Hungary,HUN,0,0,0,5,5
2016,Cuba,CUB,Hungary,HUN,5,0,56,60,121
2016,Dominican Rep.,DOM,Hungary,HUN,0,0,0,5,5
2016,Eritrea,ERI,Hungary,HUN,0,0,5,137,142
2016,Ethiopia,ETH,Hungary,HUN,5,0,10,36,51
2016,Gambia,GMB,Hungary,HUN,0,0,0,28,28
2016,Palestinian,PSE,Hungary,HUN,5,5,31,229,270
2016,Georgia,GEO,Hungary,HUN,5,0,5,5,15
2016,Ghana,GHA,Hungary,HUN,0,0,10,37,47
2016,Guinea,GIN,Hungary,HUN,0,0,11,15,26
2016,Cote d'Ivoire,CIV,Hungary,HUN,0,0,10,27,37
2016,India,IND,Hungary,HUN,0,0,47,141,188
2016,Indonesia,IDN,Hungary,HUN,0,0,0,5,5
2016,Iran (Islamic Rep. of),IRN,Hungary,HUN,16,0,187,1395,1598
2016,Iraq,IRQ,Hungary,HUN,12,60,484,4513,5069
2016,Jordan,JOR,Hungary,HUN,0,0,0,5,5
2016,Liberia,LBR,Hungary,HUN,0,0,0,5,5
2016,Libya,LBY,Hungary,HUN,0,0,17,105,122
2016,Lebanon,LBN,Hungary,HUN,0,0,5,21,26
2016,Sri Lanka,LKA,Hungary,HUN,0,0,19,222,241
2016,Mauritania,MRT,Hungary,HUN,0,0,0,15,15
2016,Mali,MLI,Hungary,HUN,0,0,5,42,47
2016,Mongolia,MNG,Hungary,HUN,0,0,5,12,17
2016,Morocco,MAR,Hungary,HUN,0,0,219,791,1010
2016,Montenegro,MNE,Hungary,HUN,0,0,0,12,12
2016,Myanmar,MMR,Hungary,HUN,0,0,0,17,17
2016,Nepal,NPL,Hungary,HUN,0,0,10,46,56
2016,Nigeria,NGA,Hungary,HUN,5,5,63,155,228
2016,Pakistan,PAK,Hungary,HUN,5,5,535,6030,6575
2016,Russian Federation,RUS,Hungary,HUN,0,0,10,0,10
2016,Serbia and Kosovo: S/RES/1244 (1999),SRB,Hungary,HUN,0,0,36,445,481
2016,Senegal,SEN,Hungary,HUN,0,0,10,88,98
2016,Sierra Leone,SLE,Hungary,HUN,0,0,0,18,18
2016,Somalia,SOM,Hungary,HUN,17,18,20,333,388
2016,Viet Nam,VNM,Hungary,HUN,0,0,5,5,10
2016,Sudan,SDN,Hungary,HUN,5,0,13,48,66
2016,South Sudan,SSD,Hungary,HUN,0,0,0,5,5
2016,Syrian Arab Rep.,SYR,Hungary,HUN,10,84,908,16556,17558
2016,United Rep. of Tanzania,TZA,Hungary,HUN,0,0,0,5,5
2016,Tajikistan,TJK,Hungary,HUN,0,0,13,42,55
2016,Togo,TGO,Hungary,HUN,0,0,0,5,5
2016,Tunisia,TUN,Hungary,HUN,0,0,15,54,69
2016,Turkey,TUR,Hungary,HUN,0,0,27,412,439
2016,United Arab Emirates,ARE,Hungary,HUN,0,0,0,5,5
2016,Uganda,UGA,Hungary,HUN,0,0,0,13,13
2016,Ukraine,UKR,Hungary,HUN,5,0,5,20,30
2016,Western Sahara,ESH,Hungary,HUN,0,0,0,10,10
2016,Yemen,YEM,Hungary,HUN,0,5,0,18,23
2016,Stateless,XXA,Hungary,HUN,0,0,0,5,5
2016,Unknown ,,Hungary,HUN,16,5,10,161,192
2016,Unknown ,,Israel,ISR,0,0,2727,523,3250
2016,Afghanistan,AFG,Rep. of Korea,KOR,0,0,12,5,17
2016,Algeria,DZA,Rep. of Korea,KOR,0,0,5,0,5
2016,Egypt,EGY,Rep. of Korea,KOR,5,0,1029,92,1126
2016,Burundi,BDI,Rep. of Korea,KOR,0,0,5,0,5
2016,Bangladesh,BGD,Rep. of Korea,KOR,10,0,248,52,310
2016,Cambodia,KHM,Rep. of Korea,KOR,0,0,31,16,47
2016,China,CHN,Rep. of Korea,KOR,0,0,714,76,790
2016,Cameroon,CMR,Rep. of Korea,KOR,0,0,147,5,152
2016,Dem. Rep. of the Congo,COD,Rep. of Korea,KOR,0,0,10,0,10
2016,Ethiopia,ETH,Rep. of Korea,KOR,12,0,0,0,12
2016,Gambia,GMB,Rep. of Korea,KOR,0,0,14,0,14
2016,Ghana,GHA,Rep. of Korea,KOR,0,0,250,10,260
2016,Guinea,GIN,Rep. of Korea,KOR,0,0,19,0,19
2016,Cote d'Ivoire,CIV,Rep. of Korea,KOR,0,0,22,0,22
2016,India,IND,Rep. of Korea,KOR,0,0,151,51,202
2016,Indonesia,IDN,Rep. of Korea,KOR,0,0,5,0,5
2016,Iran (Islamic Rep. of),IRN,Rep. of Korea,KOR,0,0,5,0,5
2016,Iraq,IRQ,Rep. of Korea,KOR,0,10,19,14,43
2016,Jordan,JOR,Rep. of Korea,KOR,0,0,26,0,26
2016,Kazakhstan,KAZ,Rep. of Korea,KOR,5,0,136,40,181
2016,Kenya,KEN,Rep. of Korea,KOR,0,0,13,5,18
2016,Kyrgyzstan,KGZ,Rep. of Korea,KOR,0,0,27,10,37
2016,Liberia,LBR,Rep. of Korea,KOR,0,0,144,10,154
2016,Libya,LBY,Rep. of Korea,KOR,0,0,10,0,10
2016,Sri Lanka,LKA,Rep. of Korea,KOR,0,0,63,10,73
2016,Mali,MLI,Rep. of Korea,KOR,0,0,5,0,5
2016,Mongolia,MNG,Rep. of Korea,KOR,0,0,5,0,5
2016,Morocco,MAR,Rep. of Korea,KOR,0,0,101,10,111
2016,Myanmar,MMR,Rep. of Korea,KOR,0,0,22,0,22
2016,Nepal,NPL,Rep. of Korea,KOR,0,0,170,13,183
2016,Nigeria,NGA,Rep. of Korea,KOR,0,0,411,10,421
2016,Pakistan,PAK,Rep. of Korea,KOR,5,0,829,110,944
2016,Philippines,PHL,Rep. of Korea,KOR,0,0,99,5,104
2016,South Africa,ZAF,Rep. of Korea,KOR,0,0,105,19,124
2016,Russian Federation,RUS,Rep. of Korea,KOR,0,0,63,10,73
2016,Senegal,SEN,Rep. of Korea,KOR,0,0,45,0,45
2016,Sierra Leone,SLE,Rep. of Korea,KOR,0,0,0,5,5
2016,Viet Nam,VNM,Rep. of Korea,KOR,0,0,191,48,239
2016,Sudan,SDN,Rep. of Korea,KOR,0,0,17,0,17
2016,Syrian Arab Rep.,SYR,Rep. of Korea,KOR,0,229,5,12,246
2016,Thailand,THA,Rep. of Korea,KOR,0,0,71,18,89
2016,Tajikistan,TJK,Rep. of Korea,KOR,0,0,5,0,5
2016,Togo,TGO,Rep. of Korea,KOR,0,0,5,0,5
2016,Tunisia,TUN,Rep. of Korea,KOR,0,0,13,5,18
2016,Uganda,UGA,Rep. of Korea,KOR,5,0,97,5,107
2016,Ukraine,UKR,Rep. of Korea,KOR,0,5,10,0,15
2016,Uzbekistan,UZB,Rep. of Korea,KOR,0,0,92,32,124
2016,Yemen,YEM,Rep. of Korea,KOR,5,0,50,10,65
2016,Zimbabwe,ZWE,Rep. of Korea,KOR,0,0,5,0,5
2016,Stateless,XXA,Rep. of Korea,KOR,0,0,5,0,5
2016,Afghanistan,AFG,North Macedonia,MKD,0,5,5,158,168
2016,Algeria,DZA,North Macedonia,MKD,0,0,0,13,13
2016,Egypt,EGY,North Macedonia,MKD,0,0,0,5,5
2016,Bangladesh,BGD,North Macedonia,MKD,0,0,0,5,5
2016,Eritrea,ERI,North Macedonia,MKD,0,0,0,5,5
2016,Ethiopia,ETH,North Macedonia,MKD,0,0,0,5,5
2016,Palestinian,PSE,North Macedonia,MKD,0,0,0,13,13
2016,India,IND,North Macedonia,MKD,0,0,0,5,5
2016,Iran (Islamic Rep. of),IRN,North Macedonia,MKD,0,0,12,80,92
2016,Iraq,IRQ,North Macedonia,MKD,0,0,0,64,64
2016,Libya,LBY,North Macedonia,MKD,0,0,0,14,14
2016,Sri Lanka,LKA,North Macedonia,MKD,0,0,0,5,5
2016,Morocco,MAR,North Macedonia,MKD,0,0,0,40,40
2016,Pakistan,PAK,North Macedonia,MKD,0,0,0,120,120
2016,Somalia,SOM,North Macedonia,MKD,0,0,5,5,10
2016,Syrian Arab Rep.,SYR,North Macedonia,MKD,0,0,19,171,190
2016,Afghanistan,AFG,Montenegro,MNE,0,0,0,31,31
2016,Albania,ALB,Montenegro,MNE,0,0,5,0,5
2016,Algeria,DZA,Montenegro,MNE,0,0,0,12,12
2016,Bangladesh,BGD,Montenegro,MNE,0,0,0,5,5
2016,Cuba,CUB,Montenegro,MNE,5,0,5,0,10
2016,Palestinian,PSE,Montenegro,MNE,0,0,0,5,5
2016,Guinea,GIN,Montenegro,MNE,0,0,0,5,5
2016,India,IND,Montenegro,MNE,0,0,0,5,5
2016,Iran (Islamic Rep. of),IRN,Montenegro,MNE,0,0,0,19,19
2016,Iraq,IRQ,Montenegro,MNE,0,0,0,17,17
2016,Morocco,MAR,Montenegro,MNE,0,0,0,65,65
2016,Pakistan,PAK,Montenegro,MNE,0,0,0,18,18
2016,Serbia and Kosovo: S/RES/1244 (1999),SRB,Montenegro,MNE,0,0,5,5,10
2016,Somalia,SOM,Montenegro,MNE,0,0,0,5,5
2016,Syrian Arab Rep.,SYR,Montenegro,MNE,0,10,0,26,36
2016,Tunisia,TUN,Montenegro,MNE,0,0,0,5,5
2016,Ukraine,UKR,Montenegro,MNE,0,0,5,0,5
2016,Yemen,YEM,Montenegro,MNE,5,0,0,0,5
2016,Afghanistan,AFG,Philippines,PHL,5,0,0,0,5
2016,Burundi,BDI,Philippines,PHL,10,0,0,0,10
2016,Cambodia,KHM,Philippines,PHL,5,0,0,0,5
2016,Eritrea,ERI,Philippines,PHL,12,0,0,0,12
2016,Palestinian,PSE,Philippines,PHL,5,0,0,0,5
2016,Cote d'Ivoire,CIV,Philippines,PHL,5,0,0,0,5
2016,Iran (Islamic Rep. of),IRN,Philippines,PHL,5,0,0,0,5
2016,Pakistan,PAK,Philippines,PHL,18,0,0,5,23
2016,Somalia,SOM,Philippines,PHL,0,0,5,0,5
2016,Syrian Arab Rep.,SYR,Philippines,PHL,14,0,0,0,14
2016,Afghanistan,AFG,Senegal,SEN,10,0,0,0,10
2016,Central African Rep.,CAF,Senegal,SEN,0,153,0,0,153
2016,Dem. Rep. of the Congo,COD,Senegal,SEN,0,10,0,0,10
2016,Gambia,GMB,Senegal,SEN,26,14,0,0,40
2016,Afghanistan,AFG,Tajikistan,TJK,77,0,75,0,152
2016,Central African Rep.,CAF,Togo,TGO,33,0,50,0,83
2016,Dem. Rep. of the Congo,COD,Togo,TGO,5,0,0,0,5
2016,Cote d'Ivoire,CIV,Togo,TGO,0,0,23,0,23
2016,Mali,MLI,Togo,TGO,56,0,11,0,67
2016,Burundi,BDI,Uganda,UGA,671,0,25,573,1269
2016,Central African Rep.,CAF,Uganda,UGA,5,0,0,0,5
2016,Congo,COG,Uganda,UGA,0,0,0,5,5
2016,Dem. Rep. of the Congo,COD,Uganda,UGA,11850,0,1379,433,13662
2016,Eritrea,ERI,Uganda,UGA,522,0,1252,451,2225
2016,Ethiopia,ETH,Uganda,UGA,269,0,110,398,777
2016,India,IND,Uganda,UGA,0,0,0,25,25
2016,Kenya,KEN,Uganda,UGA,0,0,0,5,5
2016,Pakistan,PAK,Uganda,UGA,45,0,166,5,216
2016,Rwanda,RWA,Uganda,UGA,135,0,109,174,418
2016,Somalia,SOM,Uganda,UGA,5030,0,0,249,5279
2016,Sudan,SDN,Uganda,UGA,176,0,5,34,215
2016,South Sudan,SSD,Uganda,UGA,20,0,0,15,35
2016,Yemen,YEM,Uganda,UGA,29,0,0,0,29
2017,Afghanistan,AFG,Austria,AUT,4274,3248,564,1925,10011
2017,Albania,ALB,Austria,AUT,0,11,70,10,91
2017,Algeria,DZA,Austria,AUT,0,0,341,203,544
2017,Egypt,EGY,Austria,AUT,27,0,75,42,144
2017,Armenia,ARM,Austria,AUT,22,10,124,45,201
2017,Azerbaijan,AZE,Austria,AUT,19,5,16,5,45
2017,Benin,BEN,Austria,AUT,0,0,5,0,5
2017,Bangladesh,BGD,Austria,AUT,38,5,54,75,172
2017,Belarus,BLR,Austria,AUT,0,0,14,5,19
2017,Bosnia and Herzegovina,BIH,Austria,AUT,5,0,34,16,55
2017,China,CHN,Austria,AUT,65,5,112,117,299
2017,Chile,CHL,Austria,AUT,0,0,5,0,5
2017,Cameroon,CMR,Austria,AUT,20,0,20,14,54
2017,Congo,COG,Austria,AUT,15,0,5,0,20
2017,Dem. Rep. of the Congo,COD,Austria,AUT,39,5,20,5,69
2017,Cuba,CUB,Austria,AUT,0,0,0,5,5
2017,Czechia,CZE,Austria,AUT,0,0,0,5,5
2017,Eritrea,ERI,Austria,AUT,62,32,0,19,113
2017,Ethiopia,ETH,Austria,AUT,31,23,5,12,71
2017,Gambia,GMB,Austria,AUT,16,0,38,23,77
2017,Georgia,GEO,Austria,AUT,5,33,183,96,317
2017,Ghana,GHA,Austria,AUT,5,0,32,5,42
2017,Guinea-Bissau,GNB,Austria,AUT,0,0,5,5,10
2017,Guinea,GIN,Austria,AUT,10,0,5,10,25
2017,Hungary,HUN,Austria,AUT,0,0,0,5,5
2017,Cote d'Ivoire,CIV,Austria,AUT,5,0,5,5,15
2017,India,IND,Austria,AUT,0,5,288,120,413
2017,Iran (Islamic Rep. of),IRN,Austria,AUT,1304,25,49,376,1754
2017,Iraq,IRQ,Austria,AUT,1160,1057,305,996,3518
2017,Jordan,JOR,Austria,AUT,19,0,0,5,24
2017,Kazakhstan,KAZ,Austria,AUT,10,0,25,0,35
2017,Kenya,KEN,Austria,AUT,0,0,5,0,5
2017,Kyrgyzstan,KGZ,Austria,AUT,5,5,10,0,20
2017,Liberia,LBR,Austria,AUT,0,0,0,5,5
2017,Libya,LBY,Austria,AUT,17,22,17,80,136
2017,Lebanon,LBN,Austria,AUT,12,0,16,26,54
2017,Sri Lanka,LKA,Austria,AUT,14,0,5,24,43
2017,North Macedonia,MKD,Austria,AUT,0,0,112,20,132
2017,Rep. of Moldova,MDA,Austria,AUT,0,0,10,5,15
2017,Mali,MLI,Austria,AUT,0,0,0,5,5
2017,Mongolia,MNG,Austria,AUT,5,13,47,34,99
2017,Morocco,MAR,Austria,AUT,0,5,224,102,331
2017,Montenegro,MNE,Austria,AUT,0,0,5,0,5
2017,Nepal,NPL,Austria,AUT,5,0,12,14,31
2017,Nigeria,NGA,Austria,AUT,15,29,344,236,624
2017,New Zealand,NZL,Austria,AUT,0,0,5,0,5
2017,Pakistan,PAK,Austria,AUT,35,15,713,881,1644
2017,Philippines,PHL,Austria,AUT,5,0,5,0,10
2017,Romania,ROU,Austria,AUT,0,0,0,5,5
2017,Russian Federation,RUS,Austria,AUT,520,71,372,200,1163
2017,Saudi Arabia,SAU,Austria,AUT,0,0,0,5,5
2017,Serbia and Kosovo: S/RES/1244 (1999),SRB,Austria,AUT,11,12,262,71,356
2017,Senegal,SEN,Austria,AUT,0,0,5,5,10
2017,Sierra Leone,SLE,Austria,AUT,0,0,5,11,16
2017,Somalia,SOM,Austria,AUT,714,1007,37,128,1886
2017,Viet Nam,VNM,Austria,AUT,0,0,5,14,19
2017,Sudan,SDN,Austria,AUT,28,13,18,10,69
2017,Slovakia,SVK,Austria,AUT,0,0,0,5,5
2017,Syrian Arab Rep.,SYR,Austria,AUT,11827,1194,19,528,13568
2017,United Rep. of Tanzania,TZA,Austria,AUT,0,0,5,0,5
2017,Tajikistan,TJK,Austria,AUT,20,5,20,5,50
2017,Tunisia,TUN,Austria,AUT,0,0,56,29,85
2017,Turkey,TUR,Austria,AUT,30,0,99,87,216
2017,Uganda,UGA,Austria,AUT,10,0,5,0,15
2017,Ukraine,UKR,Austria,AUT,10,13,248,184,455
2017,Uzbekistan,UZB,Austria,AUT,0,0,17,5,22
2017,Venezuela (Bolivarian Republic of),VEN,Austria,AUT,0,0,0,5,5
2017,Western Sahara,ESH,Austria,AUT,0,0,0,5,5
2017,Yemen,YEM,Austria,AUT,26,82,0,10,118
2017,Unknown ,,Austria,AUT,1289,116,32,84,1521
2017,Afghanistan,AFG,Bulgaria,BGR,16,5,1041,5628,6690
2017,Algeria,DZA,Bulgaria,BGR,0,0,19,10,29
2017,Egypt,EGY,Bulgaria,BGR,0,0,5,0,5
2017,Armenia,ARM,Bulgaria,BGR,0,0,5,0,5
2017,Bangladesh,BGD,Bulgaria,BGR,0,0,18,11,29
2017,China,CHN,Bulgaria,BGR,0,0,5,0,5
2017,Congo,COG,Bulgaria,BGR,0,0,5,0,5
2017,Dem. Rep. of the Congo,COD,Bulgaria,BGR,0,0,5,0,5
2017,Ghana,GHA,Bulgaria,BGR,0,0,10,0,10
2017,Guinea,GIN,Bulgaria,BGR,0,0,5,0,5
2017,India,IND,Bulgaria,BGR,0,0,5,0,5
2017,Iran (Islamic Rep. of),IRN,Bulgaria,BGR,0,0,116,271,387
2017,Iraq,IRQ,Bulgaria,BGR,41,73,835,2255,3204
2017,Lebanon,LBN,Bulgaria,BGR,0,0,0,5,5
2017,Sri Lanka,LKA,Bulgaria,BGR,0,0,5,10,15
2017,Mali,MLI,Bulgaria,BGR,0,0,5,0,5
2017,Nepal,NPL,Bulgaria,BGR,0,0,5,5,10
2017,Nigeria,NGA,Bulgaria,BGR,0,0,5,0,5
2017,Pakistan,PAK,Bulgaria,BGR,5,0,158,1026,1189
2017,Russian Federation,RUS,Bulgaria,BGR,0,0,10,0,10
2017,Somalia,SOM,Bulgaria,BGR,0,0,5,0,5
2017,Syrian Arab Rep.,SYR,Bulgaria,BGR,726,802,95,398,2021
2017,Tunisia,TUN,Bulgaria,BGR,0,0,5,0,5
2017,Turkey,TUR,Bulgaria,BGR,0,0,5,5,10
2017,Ukraine,UKR,Bulgaria,BGR,0,0,25,5,30
2017,Stateless,XXA,Bulgaria,BGR,14,12,5,20,51
2017,Burundi,BDI,Central African Rep.,CAF,5,0,0,0,5
2017,Dem. Rep. of the Congo,COD,Central African Rep.,CAF,0,10,0,0,10
2017,Rwanda,RWA,Central African Rep.,CAF,5,0,0,0,5
2017,Turkey,TUR,Central African Rep.,CAF,5,0,0,0,5
2017,Burundi,BDI,Chad,TCD,5,0,0,0,5
2017,Central African Rep.,CAF,Chad,TCD,198,0,0,0,198
2017,Cameroon,CMR,Chad,TCD,0,0,0,511,511
2017,Dem. Rep. of the Congo,COD,Chad,TCD,47,0,0,0,47
2017,Eritrea,ERI,Chad,TCD,5,0,0,0,5
2017,Ethiopia,ETH,Chad,TCD,5,0,0,0,5
2017,Libya,LBY,Chad,TCD,10,0,0,0,10
2017,Nigeria,NGA,Chad,TCD,0,0,0,816,816
2017,Sudan,SDN,Chad,TCD,10,0,0,0,10
2017,South Sudan,SSD,Chad,TCD,5,0,0,0,5
2017,Syrian Arab Rep.,SYR,Chad,TCD,10,0,0,0,10
2017,Turkey,TUR,Chad,TCD,5,0,0,0,5
2017,Afghanistan,AFG,Ecuador,ECU,0,0,0,5,5
2017,Angola,AGO,Ecuador,ECU,0,0,0,5,5
2017,Egypt,EGY,Ecuador,ECU,0,0,0,5,5
2017,Argentina,ARG,Ecuador,ECU,0,0,0,18,18
2017,Bangladesh,BGD,Ecuador,ECU,0,0,0,10,10
2017,Bolivia (Plurinational State of),BOL,Ecuador,ECU,0,0,0,13,13
2017,Botswana,BWA,Ecuador,ECU,0,0,0,5,5
2017,Brazil,BRA,Ecuador,ECU,0,0,0,5,5
2017,China,CHN,Ecuador,ECU,0,0,0,19,19
2017,Chile,CHL,Ecuador,ECU,0,0,0,21,21
2017,Cameroon,CMR,Ecuador,ECU,0,0,0,24,24
2017,Congo,COG,Ecuador,ECU,0,0,0,5,5
2017,Colombia,COL,Ecuador,ECU,217,0,456,12276,12949
2017,Cuba,CUB,Ecuador,ECU,0,0,5,1576,1581
2017,Dominican Rep.,DOM,Ecuador,ECU,0,0,0,52,52
2017,Eritrea,ERI,Ecuador,ECU,0,0,0,5,5
2017,Ethiopia,ETH,Ecuador,ECU,0,0,0,5,5
2017,Ghana,GHA,Ecuador,ECU,0,0,0,10,10
2017,Guinea,GIN,Ecuador,ECU,0,0,0,10,10
2017,Haiti,HTI,Ecuador,ECU,0,0,10,182,192
2017,Cote d'Ivoire,CIV,Ecuador,ECU,0,0,0,5,5
2017,India,IND,Ecuador,ECU,0,0,0,10,10
2017,Iraq,IRQ,Ecuador,ECU,0,0,0,11,11
2017,Italy,ITA,Ecuador,ECU,0,0,0,5,5
2017,Lebanon,LBN,Ecuador,ECU,0,0,0,5,5
2017,Sri Lanka,LKA,Ecuador,ECU,0,0,0,10,10
2017,Mexico,MEX,Ecuador,ECU,0,0,0,12,12
2017,Mali,MLI,Ecuador,ECU,0,0,0,5,5
2017,Nepal,NPL,Ecuador,ECU,0,0,0,5,5
2017,Nigeria,NGA,Ecuador,ECU,0,0,0,59,59
2017,Pakistan,PAK,Ecuador,ECU,0,0,0,27,27
2017,Peru,PER,Ecuador,ECU,0,0,5,3406,3411
2017,South Africa,ZAF,Ecuador,ECU,0,0,0,5,5
2017,Russian Federation,RUS,Ecuador,ECU,0,0,0,5,5
2017,El Salvador,SLV,Ecuador,ECU,0,0,0,5,5
2017,Sierra Leone,SLE,Ecuador,ECU,0,0,0,5,5
2017,Spain,ESP,Ecuador,ECU,0,0,0,12,12
2017,Sudan,SDN,Ecuador,ECU,0,0,0,5,5
2017,Syrian Arab Rep.,SYR,Ecuador,ECU,0,0,5,5,10
2017,Turkey,TUR,Ecuador,ECU,0,0,0,28,28
2017,United States of America,USA,Ecuador,ECU,0,0,5,10,15
2017,Venezuela (Bolivarian Republic of),VEN,Ecuador,ECU,0,0,109,649,758
2017,Yemen,YEM,Ecuador,ECU,0,0,0,17,17
2017,Stateless,XXA,Ecuador,ECU,0,0,0,5,5
2017,Unknown ,,Ecuador,ECU,0,0,0,18,18
2017,Angola,AGO,Gabon,GAB,0,0,10,0,10
2017,Burundi,BDI,Gabon,GAB,0,0,5,0,5
2017,Central African Rep.,CAF,Gabon,GAB,0,11,284,0,295
2017,Chad,TCD,Gabon,GAB,0,24,613,5,642
2017,Dem. Rep. of the Congo,COD,Gabon,GAB,0,22,919,0,941
2017,Equatorial Guinea,GNQ,Gabon,GAB,0,0,5,0,5
2017,Liberia,LBR,Gabon,GAB,0,0,5,0,5
2017,Mauritania,MRT,Gabon,GAB,0,0,5,0,5
2017,Mali,MLI,Gabon,GAB,0,0,5,0,5
2017,Rwanda,RWA,Gabon,GAB,0,0,5,0,5
2017,Sierra Leone,SLE,Gabon,GAB,0,0,10,0,10
2017,South Sudan,SSD,Gabon,GAB,0,0,5,0,5
2017,Togo,TGO,Gabon,GAB,0,0,5,0,5
2017,Belarus,BLR,Israel,ISR,0,0,0,38,38
2017,Central African Rep.,CAF,Israel,ISR,0,0,0,5,5
2017,China,CHN,Israel,ISR,0,0,10,10,20
2017,Cameroon,CMR,Israel,ISR,0,0,5,0,5
2017,Dem. Rep. of the Congo,COD,Israel,ISR,0,0,0,5,5
2017,Colombia,COL,Israel,ISR,0,0,5,0,5
2017,Eritrea,ERI,Israel,ISR,0,0,787,374,1161
2017,Ethiopia,ETH,Israel,ISR,0,0,68,49,117
2017,Georgia,GEO,Israel,ISR,0,0,1117,540,1657
2017,Ghana,GHA,Israel,ISR,0,0,15,5,20
2017,Guinea,GIN,Israel,ISR,0,0,5,0,5
2017,Cote d'Ivoire,CIV,Israel,ISR,0,0,5,0,5
2017,India,IND,Israel,ISR,0,0,16,29,45
2017,Kazakhstan,KAZ,Israel,ISR,0,0,0,5,5
2017,Sri Lanka,LKA,Israel,ISR,0,0,27,18,45
2017,Rep. of Moldova,MDA,Israel,ISR,0,0,22,155,177
2017,Mongolia,MNG,Israel,ISR,0,0,5,14,19
2017,Myanmar,MMR,Israel,ISR,0,0,15,0,15
2017,Nigeria,NGA,Israel,ISR,0,0,35,17,52
2017,Philippines,PHL,Israel,ISR,0,0,0,5,5
2017,Romania,ROU,Israel,ISR,0,0,0,16,16
2017,South Africa,ZAF,Israel,ISR,0,0,0,22,22
2017,Russian Federation,RUS,Israel,ISR,0,0,5,166,171
2017,Sudan,SDN,Israel,ISR,0,0,16,71,87
2017,South Sudan,SSD,Israel,ISR,0,0,0,5,5
2017,Thailand,THA,Israel,ISR,0,0,10,0,10
2017,Turkey,TUR,Israel,ISR,0,0,0,5,5
2017,Uganda,UGA,Israel,ISR,0,0,5,0,5
2017,Ukraine,UKR,Israel,ISR,0,0,949,1876,2825
2017,Uzbekistan,UZB,Israel,ISR,0,0,5,16,21
2017,Unknown ,,Israel,ISR,0,0,0,15,15
2017,Afghanistan,AFG,Rep. of Korea,KOR,0,5,0,0,5
2017,Algeria,DZA,Rep. of Korea,KOR,0,0,31,5,36
2017,Angola,AGO,Rep. of Korea,KOR,0,0,5,0,5
2017,Egypt,EGY,Rep. of Korea,KOR,5,0,858,83,946
2017,Burundi,BDI,Rep. of Korea,KOR,5,10,0,0,15
2017,Bangladesh,BGD,Rep. of Korea,KOR,10,0,287,23,320
2017,Burkina Faso,BFA,Rep. of Korea,KOR,0,0,5,0,5
2017,Cambodia,KHM,Rep. of Korea,KOR,0,0,12,10,22
2017,China,CHN,Rep. of Korea,KOR,0,5,685,371,1061
2017,Cameroon,CMR,Rep. of Korea,KOR,0,0,96,10,106
2017,Dem. Rep. of the Congo,COD,Rep. of Korea,KOR,0,0,17,0,17
2017,Ethiopia,ETH,Rep. of Korea,KOR,23,5,26,10,64
2017,Gambia,GMB,Rep. of Korea,KOR,0,0,13,0,13
2017,Ghana,GHA,Rep. of Korea,KOR,0,0,84,5,89
2017,Guinea,GIN,Rep. of Korea,KOR,0,0,22,0,22
2017,Cote d'Ivoire,CIV,Rep. of Korea,KOR,0,0,18,0,18
2017,India,IND,Rep. of Korea,KOR,0,0,261,39,300
2017,Indonesia,IDN,Rep. of Korea,KOR,0,0,5,0,5
2017,Iran (Islamic Rep. of),IRN,Rep. of Korea,KOR,11,0,10,0,21
2017,Iraq,IRQ,Rep. of Korea,KOR,0,0,27,10,37
2017,Jordan,JOR,Rep. of Korea,KOR,0,0,16,0,16
2017,Kazakhstan,KAZ,Rep. of Korea,KOR,0,0,330,140,470
2017,Kenya,KEN,Rep. of Korea,KOR,0,0,17,0,17
2017,Kyrgyzstan,KGZ,Rep. of Korea,KOR,0,0,61,5,66
2017,Liberia,LBR,Rep. of Korea,KOR,0,0,106,5,111
2017,Libya,LBY,Rep. of Korea,KOR,0,0,5,0,5
2017,Lebanon,LBN,Rep. of Korea,KOR,0,0,5,0,5
2017,Sri Lanka,LKA,Rep. of Korea,KOR,0,0,59,13,72
2017,Mali,MLI,Rep. of Korea,KOR,0,0,10,0,10
2017,Mongolia,MNG,Rep. of Korea,KOR,0,0,56,14,70
2017,Morocco,MAR,Rep. of Korea,KOR,0,0,96,29,125
2017,Myanmar,MMR,Rep. of Korea,KOR,35,5,5,5,50
2017,Nepal,NPL,Rep. of Korea,KOR,0,0,142,46,188
2017,Nigeria,NGA,Rep. of Korea,KOR,0,0,284,14,298
2017,Pakistan,PAK,Rep. of Korea,KOR,10,0,728,101,839
2017,Philippines,PHL,Rep. of Korea,KOR,0,0,255,12,267
2017,South Africa,ZAF,Rep. of Korea,KOR,0,0,82,12,94
2017,Russian Federation,RUS,Rep. of Korea,KOR,0,0,249,101,350
2017,Senegal,SEN,Rep. of Korea,KOR,0,0,52,0,52
2017,Sierra Leone,SLE,Rep. of Korea,KOR,0,0,5,0,5
2017,Viet Nam,VNM,Rep. of Korea,KOR,0,0,114,16,130
2017,Sudan,SDN,Rep. of Korea,KOR,0,0,63,0,63
2017,Syrian Arab Rep.,SYR,Rep. of Korea,KOR,0,246,16,17,279
2017,United Rep. of Tanzania,TZA,Rep. of Korea,KOR,0,5,5,0,10
2017,Thailand,THA,Rep. of Korea,KOR,5,0,93,30,128
2017,Tajikistan,TJK,Rep. of Korea,KOR,0,0,12,5,17
2017,Tunisia,TUN,Rep. of Korea,KOR,0,0,21,5,26
2017,Turkey,TUR,Rep. of Korea,KOR,0,0,10,0,10
2017,Uganda,UGA,Rep. of Korea,KOR,0,5,134,5,144
2017,Ukraine,UKR,Rep. of Korea,KOR,0,0,5,5,10
2017,Uzbekistan,UZB,Rep. of Korea,KOR,0,0,81,11,92
2017,Yemen,YEM,Rep. of Korea,KOR,11,28,16,19,74
2017,Afghanistan,AFG,North Macedonia,MKD,0,0,0,12,12
2017,Iran (Islamic Rep. of),IRN,North Macedonia,MKD,0,0,0,16,16
2017,Iraq,IRQ,North Macedonia,MKD,0,0,0,11,11
2017,Pakistan,PAK,North Macedonia,MKD,0,0,0,64,64
2017,Serbia and Kosovo: S/RES/1244 (1999),SRB,North Macedonia,MKD,0,0,5,0,5
2017,Syrian Arab Rep.,SYR,North Macedonia,MKD,0,0,0,25,25
2017,Afghanistan,AFG,Montenegro,MNE,0,0,5,41,46
2017,Algeria,DZA,Montenegro,MNE,0,0,11,304,315
2017,Egypt,EGY,Montenegro,MNE,0,0,0,5,5
2017,Armenia,ARM,Montenegro,MNE,0,0,0,5,5
2017,Bangladesh,BGD,Montenegro,MNE,0,0,0,5,5
2017,Cuba,CUB,Montenegro,MNE,0,0,26,5,31
2017,Eritrea,ERI,Montenegro,MNE,0,0,0,5,5
2017,Palestinian,PSE,Montenegro,MNE,0,0,0,5,5
2017,India,IND,Montenegro,MNE,0,0,0,5,5
2017,Iran (Islamic Rep. of),IRN,Montenegro,MNE,0,0,0,40,40
2017,Iraq,IRQ,Montenegro,MNE,0,0,0,58,58
2017,Libya,LBY,Montenegro,MNE,0,0,0,5,5
2017,Morocco,MAR,Montenegro,MNE,0,0,5,61,66
2017,Nigeria,NGA,Montenegro,MNE,0,0,0,5,5
2017,Pakistan,PAK,Montenegro,MNE,0,0,0,69,69
2017,Russian Federation,RUS,Montenegro,MNE,0,0,5,10,15
2017,Somalia,SOM,Montenegro,MNE,0,0,0,5,5
2017,Syrian Arab Rep.,SYR,Montenegro,MNE,0,0,0,25,25
2017,Tunisia,TUN,Montenegro,MNE,0,0,0,11,11
2017,Ukraine,UKR,Montenegro,MNE,0,0,5,0,5
2017,China,CHN,Philippines,PHL,0,0,0,5,5
2017,Palestinian,PSE,Philippines,PHL,5,0,0,0,5
2017,Cote d'Ivoire,CIV,Philippines,PHL,5,0,0,0,5
2017,Iran (Islamic Rep. of),IRN,Philippines,PHL,5,0,0,5,10
2017,Iraq,IRQ,Philippines,PHL,10,0,0,0,10
2017,Sri Lanka,LKA,Philippines,PHL,5,0,0,0,5
2017,Nigeria,NGA,Philippines,PHL,5,0,0,0,5
2017,Pakistan,PAK,Philippines,PHL,32,0,5,14,51
2017,Somalia,SOM,Philippines,PHL,5,0,5,5,15
2017,Viet Nam,VNM,Philippines,PHL,5,0,0,0,5
2017,Syrian Arab Rep.,SYR,Philippines,PHL,19,5,5,5,34
2017,Turkey,TUR,Philippines,PHL,5,0,0,10,15
2017,Unknown ,,Philippines,PHL,0,0,0,5,5
2017,Burundi,BDI,Senegal,SEN,5,0,0,0,5
2017,Central African Rep.,CAF,Senegal,SEN,82,0,0,22,104
2017,Gambia,GMB,Senegal,SEN,0,0,0,23,23
2017,Afghanistan,AFG,Slovakia,SVK,0,5,0,5,10
2017,Armenia,ARM,Slovakia,SVK,0,0,0,5,5
2017,China,CHN,Slovakia,SVK,0,0,0,5,5
2017,Cameroon,CMR,Slovakia,SVK,5,0,0,0,5
2017,Cuba,CUB,Slovakia,SVK,10,0,0,0,10
2017,Iraq,IRQ,Slovakia,SVK,5,0,5,10,20
2017,Libya,LBY,Slovakia,SVK,0,5,5,0,10
2017,Sri Lanka,LKA,Slovakia,SVK,0,0,0,5,5
2017,Morocco,MAR,Slovakia,SVK,0,0,5,5,10
2017,Pakistan,PAK,Slovakia,SVK,0,0,10,5,15
2017,Poland,POL,Slovakia,SVK,0,0,0,5,5
2017,Viet Nam,VNM,Slovakia,SVK,0,0,0,17,17
2017,Syrian Arab Rep.,SYR,Slovakia,SVK,5,0,0,5,10
2017,Turkey,TUR,Slovakia,SVK,0,0,5,0,5
2017,Ukraine,UKR,Slovakia,SVK,0,5,5,5,15
2017,Afghanistan,AFG,Slovenia,SVN,5,0,188,454,647
2017,Algeria,DZA,Slovenia,SVN,0,0,46,106,152
2017,Egypt,EGY,Slovenia,SVN,0,0,0,5,5
2017,Bangladesh,BGD,Slovenia,SVN,0,0,0,5,5
2017,China,CHN,Slovenia,SVN,0,0,0,10,10
2017,Cuba,CUB,Slovenia,SVN,0,0,0,11,11
2017,Eritrea,ERI,Slovenia,SVN,29,0,0,0,29
2017,Palestinian,PSE,Slovenia,SVN,10,0,0,0,10
2017,India,IND,Slovenia,SVN,0,0,5,0,5
2017,Iran (Islamic Rep. of),IRN,Slovenia,SVN,5,0,34,43,82
2017,Iraq,IRQ,Slovenia,SVN,5,0,13,12,30
2017,Libya,LBY,Slovenia,SVN,0,0,0,25,25
2017,Sri Lanka,LKA,Slovenia,SVN,0,0,0,5,5
2017,Morocco,MAR,Slovenia,SVN,0,0,10,29,39
2017,Nepal,NPL,Slovenia,SVN,0,0,0,5,5
2017,Nigeria,NGA,Slovenia,SVN,0,0,12,5,17
2017,Pakistan,PAK,Slovenia,SVN,0,0,64,71,135
2017,Russian Federation,RUS,Slovenia,SVN,0,0,5,0,5
2017,Serbia and Kosovo: S/RES/1244 (1999),SRB,Slovenia,SVN,0,0,25,40,65
2017,Somalia,SOM,Slovenia,SVN,0,0,5,0,5
2017,Syrian Arab Rep.,SYR,Slovenia,SVN,87,10,5,24,126
2017,Tunisia,TUN,Slovenia,SVN,0,0,5,10,15
2017,Turkey,TUR,Slovenia,SVN,0,0,32,83,115
2017,Afghanistan,AFG,Tajikistan,TJK,56,0,53,0,109
2017,Central African Rep.,CAF,Togo,TGO,5,0,72,0,77
2017,Cameroon,CMR,Togo,TGO,0,0,5,0,5
2017,Gabon,GAB,Togo,TGO,0,0,5,0,5
2017,Cote d'Ivoire,CIV,Togo,TGO,5,0,73,0,78
2017,Liberia,LBR,Togo,TGO,0,0,5,0,5
2017,Mali,MLI,Togo,TGO,0,0,15,0,15
2017,Egypt,EGY,Uganda,UGA,0,0,5,0,5
2017,Burundi,BDI,Uganda,UGA,5045,0,78,878,6001
2017,Bangladesh,BGD,Uganda,UGA,0,0,5,0,5
2017,Central African Rep.,CAF,Uganda,UGA,5,0,0,0,5
2017,Chad,TCD,Uganda,UGA,0,0,5,0,5
2017,Congo,COG,Uganda,UGA,54,0,5,0,59
2017,Dem. Rep. of the Congo,COD,Uganda,UGA,36552,0,3417,0,39969
2017,Eritrea,ERI,Uganda,UGA,1557,0,3013,0,4570
2017,Ethiopia,ETH,Uganda,UGA,718,0,280,0,998
2017,Kenya,KEN,Uganda,UGA,5,0,15,187,207
2017,Mali,MLI,Uganda,UGA,0,0,5,0,5
2017,Pakistan,PAK,Uganda,UGA,195,0,224,0,419
2017,Rwanda,RWA,Uganda,UGA,301,0,377,1358,2036
2017,Somalia,SOM,Uganda,UGA,13426,0,10,26,13462
2017,Sudan,SDN,Uganda,UGA,763,0,21,0,784
2017,South Sudan,SSD,Uganda,UGA,151,0,0,460,611
2017,Syrian Arab Rep.,SYR,Uganda,UGA,5,0,5,0,10
2017,Yemen,YEM,Uganda,UGA,33,0,0,0,33
2018,Afghanistan,AFG,Austria,AUT,4979,2062,1825,914,9780
2018,Albania,ALB,Austria,AUT,0,0,40,5,45
2018,Algeria,DZA,Austria,AUT,0,0,147,42,189
2018,Angola,AGO,Austria,AUT,0,5,5,0,10
2018,Egypt,EGY,Austria,AUT,26,0,98,16,140
2018,Armenia,ARM,Austria,AUT,5,13,169,32,219
2018,Azerbaijan,AZE,Austria,AUT,11,0,15,11,37
2018,Burundi,BDI,Austria,AUT,5,0,0,0,5
2018,Benin,BEN,Austria,AUT,0,0,10,0,10
2018,Bangladesh,BGD,Austria,AUT,30,14,67,34,145
2018,Burkina Faso,BFA,Austria,AUT,0,0,5,0,5
2018,Belarus,BLR,Austria,AUT,0,5,16,10,31
2018,Brazil,BRA,Austria,AUT,0,0,5,0,5
2018,Bosnia and Herzegovina,BIH,Austria,AUT,0,0,20,13,33
2018,China,CHN,Austria,AUT,81,5,108,52,246
2018,Cameroon,CMR,Austria,AUT,15,5,14,0,34
2018,Congo,COG,Austria,AUT,5,0,5,0,10
2018,Dem. Rep. of the Congo,COD,Austria,AUT,18,10,24,0,52
2018,Colombia,COL,Austria,AUT,0,0,10,5,15
2018,Cuba,CUB,Austria,AUT,0,0,5,0,5
2018,Czechia,CZE,Austria,AUT,0,0,0,5,5
2018,Eritrea,ERI,Austria,AUT,39,24,0,5,68
2018,Ethiopia,ETH,Austria,AUT,22,15,11,5,53
2018,Gambia,GMB,Austria,AUT,10,0,60,10,80
2018,Georgia,GEO,Austria,AUT,5,30,411,85,531
2018,Germany,DEU,Austria,AUT,0,0,0,5,5
2018,Ghana,GHA,Austria,AUT,0,0,22,5,27
2018,Guinea-Bissau,GNB,Austria,AUT,0,0,5,0,5
2018,Guinea,GIN,Austria,AUT,5,0,22,5,32
2018,Cote d'Ivoire,CIV,Austria,AUT,5,0,5,0,10
2018,India,IND,Austria,AUT,0,0,304,79,383
2018,Iran (Islamic Rep. of),IRN,Austria,AUT,1370,51,140,172,1733
2018,Iraq,IRQ,Austria,AUT,731,536,525,609,2401
2018,Jordan,JOR,Austria,AUT,12,0,12,5,29
2018,Kazakhstan,KAZ,Austria,AUT,5,5,14,16,40
2018,Kenya,KEN,Austria,AUT,0,0,5,0,5
2018,Kyrgyzstan,KGZ,Austria,AUT,11,0,5,5,21
2018,Liberia,LBR,Austria,AUT,0,0,5,0,5
2018,Libya,LBY,Austria,AUT,0,12,5,28,45
2018,Lebanon,LBN,Austria,AUT,18,20,11,14,63
2018,Sri Lanka,LKA,Austria,AUT,5,0,14,13,32
2018,Mauritania,MRT,Austria,AUT,0,0,5,0,5
2018,North Macedonia,MKD,Austria,AUT,0,5,31,22,58
2018,Rep. of Moldova,MDA,Austria,AUT,0,0,12,13,25
2018,Mali,MLI,Austria,AUT,0,0,5,0,5
2018,Mongolia,MNG,Austria,AUT,0,0,47,10,57
2018,Morocco,MAR,Austria,AUT,0,5,95,28,128
2018,Nepal,NPL,Austria,AUT,0,0,10,5,15
2018,Nigeria,NGA,Austria,AUT,18,29,567,87,701
2018,Pakistan,PAK,Austria,AUT,34,10,411,249,704
2018,Philippines,PHL,Austria,AUT,5,0,0,5,10
2018,Romania,ROU,Austria,AUT,0,0,5,0,5
2018,Russian Federation,RUS,Austria,AUT,526,109,602,161,1398
2018,Rwanda,RWA,Austria,AUT,10,0,0,0,10
2018,Serbia and Kosovo: S/RES/1244 (1999),SRB,Austria,AUT,18,10,180,58,266
2018,Senegal,SEN,Austria,AUT,5,0,19,5,29
2018,Sierra Leone,SLE,Austria,AUT,0,0,10,5,15
2018,Somalia,SOM,Austria,AUT,768,665,64,54,1551
2018,Viet Nam,VNM,Austria,AUT,0,0,5,5,10
2018,Sudan,SDN,Austria,AUT,31,10,5,5,51
2018,Slovakia,SVK,Austria,AUT,0,0,0,5,5
2018,Syrian Arab Rep.,SYR,Austria,AUT,4951,414,93,102,5560
2018,Tajikistan,TJK,Austria,AUT,52,5,17,5,79
2018,Togo,TGO,Austria,AUT,0,0,5,0,5
2018,Tunisia,TUN,Austria,AUT,0,0,51,18,69
2018,Turkey,TUR,Austria,AUT,83,5,100,70,258
2018,Uganda,UGA,Austria,AUT,5,0,5,0,10
2018,Ukraine,UKR,Austria,AUT,23,25,260,74,382
2018,Uzbekistan,UZB,Austria,AUT,5,0,35,5,45
2018,Venezuela (Bolivarian Republic of),VEN,Austria,AUT,0,0,5,0,5
2018,Yemen,YEM,Austria,AUT,68,28,0,5,101
2018,Unknown ,,Austria,AUT,656,56,48,43,803
2018,Afghanistan,AFG,Bulgaria,BGR,20,16,709,520,1265
2018,Algeria,DZA,Bulgaria,BGR,0,0,5,5,10
2018,Egypt,EGY,Bulgaria,BGR,5,0,10,0,15
2018,China,CHN,Bulgaria,BGR,0,0,5,0,5
2018,Eritrea,ERI,Bulgaria,BGR,10,0,0,0,10
2018,Iran (Islamic Rep. of),IRN,Bulgaria,BGR,0,5,38,32,75
2018,Iraq,IRQ,Bulgaria,BGR,5,25,404,885,1319
2018,Kazakhstan,KAZ,Bulgaria,BGR,0,0,5,0,5
2018,Morocco,MAR,Bulgaria,BGR,0,0,5,0,5
2018,Nigeria,NGA,Bulgaria,BGR,0,0,5,0,5
2018,Pakistan,PAK,Bulgaria,BGR,10,0,116,47,173
2018,Syrian Arab Rep.,SYR,Bulgaria,BGR,261,351,11,74,697
2018,Tunisia,TUN,Bulgaria,BGR,0,0,5,0,5
2018,Turkey,TUR,Bulgaria,BGR,0,0,20,5,25
2018,Ukraine,UKR,Bulgaria,BGR,0,0,10,11,21
2018,Stateless,XXA,Bulgaria,BGR,0,17,5,0,22
2018,Chad,TCD,Central African Rep.,CAF,56,0,0,0,56
2018,Cameroon,CMR,Central African Rep.,CAF,10,0,11,0,21
2018,Dem. Rep. of the Congo,COD,Central African Rep.,CAF,99,0,0,72,171
2018,Liberia,LBR,Central African Rep.,CAF,5,0,0,0,5
2018,Rwanda,RWA,Central African Rep.,CAF,26,0,0,10,36
2018,Sudan,SDN,Central African Rep.,CAF,10,0,0,0,10
2018,South Sudan,SSD,Central African Rep.,CAF,14,0,0,0,14
2018,Turkey,TUR,Central African Rep.,CAF,14,0,0,0,14
2018,Central African Rep.,CAF,Chad,TCD,287,0,5,47,339
2018,Dem. Rep. of the Congo,COD,Chad,TCD,25,0,0,20,45
2018,Eritrea,ERI,Chad,TCD,5,0,0,0,5
2018,Ethiopia,ETH,Chad,TCD,11,0,0,0,11
2018,Libya,LBY,Chad,TCD,10,0,0,0,10
2018,Sudan,SDN,Chad,TCD,35,0,5,0,40
2018,Syrian Arab Rep.,SYR,Chad,TCD,16,0,0,5,21
2018,Yemen,YEM,Chad,TCD,5,0,0,0,5
2018,Afghanistan,AFG,Ecuador,ECU,54,0,0,0,54
2018,Angola,AGO,Ecuador,ECU,0,0,14,0,14
2018,Argentina,ARG,Ecuador,ECU,0,0,5,0,5
2018,Cameroon,CMR,Ecuador,ECU,5,0,5,0,10
2018,Dem. Rep. of the Congo,COD,Ecuador,ECU,0,0,18,0,18
2018,Colombia,COL,Ecuador,ECU,4468,0,1057,20,5545
2018,Cuba,CUB,Ecuador,ECU,0,0,27,0,27
2018,Iran (Islamic Rep. of),IRN,Ecuador,ECU,18,0,0,0,18
2018,Iraq,IRQ,Ecuador,ECU,26,0,0,0,26
2018,Libya,LBY,Ecuador,ECU,5,0,0,0,5
2018,Sri Lanka,LKA,Ecuador,ECU,5,0,0,0,5
2018,Nigeria,NGA,Ecuador,ECU,5,0,5,0,10
2018,Pakistan,PAK,Ecuador,ECU,5,0,0,0,5
2018,Panama,PAN,Ecuador,ECU,0,0,5,0,5
2018,El Salvador,SLV,Ecuador,ECU,15,0,0,0,15
2018,Saudi Arabia,SAU,Ecuador,ECU,0,0,5,0,5
2018,Spain,ESP,Ecuador,ECU,0,0,5,0,5
2018,Syrian Arab Rep.,SYR,Ecuador,ECU,63,0,17,0,80
2018,Ukraine,UKR,Ecuador,ECU,13,0,0,0,13
2018,Venezuela (Bolivarian Republic of),VEN,Ecuador,ECU,10,0,5907,5,5922
2018,Yemen,YEM,Ecuador,ECU,50,0,27,0,77
2018,Central African Rep.,CAF,Gabon,GAB,0,0,5,0,5
2018,Chad,TCD,Gabon,GAB,0,0,18,0,18
2018,Dem. Rep. of the Congo,COD,Gabon,GAB,0,0,23,0,23
2018,Central African Rep.,CAF,Cote d'Ivoire,CIV,95,0,0,76,171
2018,Chad,TCD,Cote d'Ivoire,CIV,0,0,0,5,5
2018,Dem. Rep. of the Congo,COD,Cote d'Ivoire,CIV,0,0,5,22,27
2018,Eritrea,ERI,Cote d'Ivoire,CIV,5,0,0,0,5
2018,Ethiopia,ETH,Cote d'Ivoire,CIV,5,0,0,0,5
2018,Palestinian,PSE,Cote d'Ivoire,CIV,0,0,0,5,5
2018,Guinea,GIN,Cote d'Ivoire,CIV,0,0,0,12,12
2018,Iraq,IRQ,Cote d'Ivoire,CIV,5,0,0,0,5
2018,Liberia,LBR,Cote d'Ivoire,CIV,0,0,5,23,28
2018,Mali,MLI,Cote d'Ivoire,CIV,0,0,0,17,17
2018,Nigeria,NGA,Cote d'Ivoire,CIV,0,0,0,17,17
2018,Somalia,SOM,Cote d'Ivoire,CIV,5,0,0,0,5
2018,Syrian Arab Rep.,SYR,Cote d'Ivoire,CIV,80,0,0,0,80
2018,Togo,TGO,Cote d'Ivoire,CIV,0,0,0,5,5
2018,Armenia,ARM,Israel,ISR,0,0,5,5,10
2018,Azerbaijan,AZE,Israel,ISR,0,0,5,10,15
2018,Belarus,BLR,Israel,ISR,0,0,13,80,93
2018,China,CHN,Israel,ISR,0,0,15,23,38
2018,Colombia,COL,Israel,ISR,0,0,33,10,43
2018,Eritrea,ERI,Israel,ISR,5,0,686,429,1120
2018,Ethiopia,ETH,Israel,ISR,0,11,146,38,195
2018,Georgia,GEO,Israel,ISR,0,5,878,502,1385
2018,Ghana,GHA,Israel,ISR,0,0,38,13,51
2018,Greece,GRC,Israel,ISR,0,0,0,5,5
2018,Guinea,GIN,Israel,ISR,0,0,5,0,5
2018,Cote d'Ivoire,CIV,Israel,ISR,0,0,10,0,10
2018,India,IND,Israel,ISR,0,0,93,44,137
2018,Kazakhstan,KAZ,Israel,ISR,0,0,5,20,25
2018,Kenya,KEN,Israel,ISR,0,0,5,0,5
2018,Kyrgyzstan,KGZ,Israel,ISR,0,0,0,10,10
2018,Sri Lanka,LKA,Israel,ISR,0,0,69,32,101
2018,Rep. of Moldova,MDA,Israel,ISR,0,0,68,143,211
2018,Mongolia,MNG,Israel,ISR,0,0,50,41,91
2018,Myanmar,MMR,Israel,ISR,0,0,14,0,14
2018,Nepal,NPL,Israel,ISR,0,0,5,0,5
2018,Nigeria,NGA,Israel,ISR,0,0,54,30,84
2018,Philippines,PHL,Israel,ISR,0,0,5,0,5
2018,Romania,ROU,Israel,ISR,0,0,5,10,15
2018,South Africa,ZAF,Israel,ISR,0,0,10,19,29
2018,Russian Federation,RUS,Israel,ISR,0,0,209,397,606
2018,Sierra Leone,SLE,Israel,ISR,0,0,12,0,12
2018,Sudan,SDN,Israel,ISR,0,485,10,77,572
2018,South Sudan,SSD,Israel,ISR,0,0,0,5,5
2018,Thailand,THA,Israel,ISR,0,0,5,0,5
2018,Turkey,TUR,Israel,ISR,0,0,10,20,30
2018,Ukraine,UKR,Israel,ISR,0,0,2575,2839,5414
2018,Uzbekistan,UZB,Israel,ISR,0,0,16,15,31
2018,Unknown ,,Israel,ISR,0,0,5,5,10
2018,Afghanistan,AFG,Rep. of Korea,KOR,0,0,5,0,5
2018,Algeria,DZA,Rep. of Korea,KOR,0,0,19,13,32
2018,Angola,AGO,Rep. of Korea,KOR,0,0,10,0,10
2018,Egypt,EGY,Rep. of Korea,KOR,5,0,310,73,388
2018,Burundi,BDI,Rep. of Korea,KOR,13,5,0,0,18
2018,Bangladesh,BGD,Rep. of Korea,KOR,5,5,106,60,176
2018,Burkina Faso,BFA,Rep. of Korea,KOR,0,0,10,0,10
2018,Cambodia,KHM,Rep. of Korea,KOR,0,0,0,5,5
2018,China,CHN,Rep. of Korea,KOR,0,5,340,354,699
2018,Cameroon,CMR,Rep. of Korea,KOR,0,0,64,16,80
2018,Dem. Rep. of the Congo,COD,Rep. of Korea,KOR,10,0,5,0,15
2018,Eritrea,ERI,Rep. of Korea,KOR,5,0,0,0,5
2018,Ethiopia,ETH,Rep. of Korea,KOR,14,5,72,5,96
2018,Gambia,GMB,Rep. of Korea,KOR,0,0,14,5,19
2018,Ghana,GHA,Rep. of Korea,KOR,0,0,34,19,53
2018,Guinea,GIN,Rep. of Korea,KOR,0,0,23,0,23
2018,Cote d'Ivoire,CIV,Rep. of Korea,KOR,0,5,19,5,29
2018,India,IND,Rep. of Korea,KOR,0,0,85,97,182
2018,Iran (Islamic Rep. of),IRN,Rep. of Korea,KOR,5,0,10,10,25
2018,Iraq,IRQ,Rep. of Korea,KOR,0,0,15,5,20
2018,Jordan,JOR,Rep. of Korea,KOR,5,0,5,5,15
2018,Kazakhstan,KAZ,Rep. of Korea,KOR,0,0,379,325,704
2018,Kenya,KEN,Rep. of Korea,KOR,0,0,23,5,28
2018,Kyrgyzstan,KGZ,Rep. of Korea,KOR,0,0,33,11,44
2018,Liberia,LBR,Rep. of Korea,KOR,0,0,82,14,96
2018,Sri Lanka,LKA,Rep. of Korea,KOR,0,0,43,35,78
2018,Mali,MLI,Rep. of Korea,KOR,0,0,17,5,22
2018,Malaysia,MYS,Rep. of Korea,KOR,0,0,54,181,235
2018,Mongolia,MNG,Rep. of Korea,KOR,0,0,60,26,86
2018,Morocco,MAR,Rep. of Korea,KOR,0,0,61,26,87
2018,Myanmar,MMR,Rep. of Korea,KOR,10,0,0,0,10
2018,Nepal,NPL,Rep. of Korea,KOR,0,0,27,57,84
2018,Nigeria,NGA,Rep. of Korea,KOR,0,0,163,21,184
2018,Pakistan,PAK,Rep. of Korea,KOR,13,5,335,67,420
2018,Philippines,PHL,Rep. of Korea,KOR,0,0,72,97,169
2018,South Africa,ZAF,Rep. of Korea,KOR,0,0,49,20,69
2018,Russian Federation,RUS,Rep. of Korea,KOR,0,0,325,199,524
2018,Senegal,SEN,Rep. of Korea,KOR,0,0,94,5,99
2018,Viet Nam,VNM,Rep. of Korea,KOR,0,0,17,13,30
2018,Sudan,SDN,Rep. of Korea,KOR,5,0,22,0,27
2018,Eswatini,SWZ,Rep. of Korea,KOR,0,0,0,5,5
2018,Syrian Arab Rep.,SYR,Rep. of Korea,KOR,0,54,10,10,74
2018,United Rep. of Tanzania,TZA,Rep. of Korea,KOR,0,0,5,5,10
2018,Thailand,THA,Rep. of Korea,KOR,5,0,63,99,167
2018,Tajikistan,TJK,Rep. of Korea,KOR,0,0,5,5,10
2018,Togo,TGO,Rep. of Korea,KOR,0,0,5,0,5
2018,Tunisia,TUN,Rep. of Korea,KOR,0,0,11,5,16
2018,Turkey,TUR,Rep. of Korea,KOR,0,0,18,10,28
2018,Uganda,UGA,Rep. of Korea,KOR,5,0,43,15,63
2018,Ukraine,UKR,Rep. of Korea,KOR,0,0,5,11,16
2018,Uzbekistan,UZB,Rep. of Korea,KOR,0,0,14,21,35
2018,Yemen,YEM,Rep. of Korea,KOR,10,425,23,39,497
2018,Zimbabwe,ZWE,Rep. of Korea,KOR,0,0,5,0,5
2018,Afghanistan,AFG,North Macedonia,MKD,0,0,5,44,49
2018,Algeria,DZA,North Macedonia,MKD,0,0,0,5,5
2018,Bangladesh,BGD,North Macedonia,MKD,0,0,0,12,12
2018,Congo,COG,North Macedonia,MKD,0,5,0,5,10
2018,India,IND,North Macedonia,MKD,0,0,0,5,5
2018,Iran (Islamic Rep. of),IRN,North Macedonia,MKD,0,0,0,18,18
2018,Iraq,IRQ,North Macedonia,MKD,0,0,0,73,73
2018,Libya,LBY,North Macedonia,MKD,0,0,0,5,5
2018,Sri Lanka,LKA,North Macedonia,MKD,0,0,0,5,5
2018,Morocco,MAR,North Macedonia,MKD,0,0,0,5,5
2018,Pakistan,PAK,North Macedonia,MKD,0,0,5,84,89
2018,Syrian Arab Rep.,SYR,North Macedonia,MKD,0,0,0,12,12
2018,Turkey,TUR,North Macedonia,MKD,0,0,0,19,19
2018,Afghanistan,AFG,Montenegro,MNE,0,0,0,47,47
2018,Algeria,DZA,Montenegro,MNE,0,0,0,366,366
2018,Egypt,EGY,Montenegro,MNE,0,0,0,10,10
2018,Bangladesh,BGD,Montenegro,MNE,0,0,0,5,5
2018,Cuba,CUB,Montenegro,MNE,0,0,5,5,10
2018,Eritrea,ERI,Montenegro,MNE,0,0,0,5,5
2018,Palestinian,PSE,Montenegro,MNE,0,0,0,151,151
2018,Ghana,GHA,Montenegro,MNE,0,5,0,0,5
2018,India,IND,Montenegro,MNE,0,0,0,5,5
2018,Iran (Islamic Rep. of),IRN,Montenegro,MNE,5,0,0,51,56
2018,Iraq,IRQ,Montenegro,MNE,0,0,0,239,239
2018,Libya,LBY,Montenegro,MNE,0,0,0,107,107
2018,Morocco,MAR,Montenegro,MNE,0,0,0,180,180
2018,Nepal,NPL,Montenegro,MNE,0,0,0,17,17
2018,Pakistan,PAK,Montenegro,MNE,0,0,0,645,645
2018,Russian Federation,RUS,Montenegro,MNE,0,0,0,5,5
2018,Sweden,SWE,Montenegro,MNE,0,0,5,0,5
2018,Syrian Arab Rep.,SYR,Montenegro,MNE,0,0,0,1197,1197
2018,Tunisia,TUN,Montenegro,MNE,0,0,0,17,17
2018,Yemen,YEM,Montenegro,MNE,0,0,0,31,31
2018,Burundi,BDI,Philippines,PHL,5,0,0,0,5
2018,Cambodia,KHM,Philippines,PHL,0,0,0,5,5
2018,Central African Rep.,CAF,Philippines,PHL,0,0,5,0,5
2018,Cameroon,CMR,Philippines,PHL,10,0,0,5,15
2018,Palestinian,PSE,Philippines,PHL,10,0,0,0,10
2018,Cote d'Ivoire,CIV,Philippines,PHL,5,0,10,0,15
2018,Iraq,IRQ,Philippines,PHL,5,0,0,0,5
2018,Lebanon,LBN,Philippines,PHL,5,0,0,0,5
2018,Nigeria,NGA,Philippines,PHL,0,0,0,5,5
2018,Pakistan,PAK,Philippines,PHL,14,0,0,5,19
2018,Rwanda,RWA,Philippines,PHL,0,0,5,0,5
2018,Saudi Arabia,SAU,Philippines,PHL,5,0,0,0,5
2018,Somalia,SOM,Philippines,PHL,5,0,5,0,10
2018,Syrian Arab Rep.,SYR,Philippines,PHL,38,0,0,0,38
2018,Turkey,TUR,Philippines,PHL,17,0,0,0,17
2018,Yemen,YEM,Philippines,PHL,5,0,0,0,5
2018,Algeria,DZA,Senegal,SEN,0,0,0,10,10
2018,Angola,AGO,Senegal,SEN,0,0,0,12,12
2018,Burundi,BDI,Senegal,SEN,5,0,0,14,19
2018,Benin,BEN,Senegal,SEN,0,0,0,5,5
2018,Central African Rep.,CAF,Senegal,SEN,56,0,0,58,114
2018,Chad,TCD,Senegal,SEN,0,0,0,30,30
2018,Cameroon,CMR,Senegal,SEN,0,0,0,28,28
2018,Congo,COG,Senegal,SEN,0,0,0,223,223
2018,Dem. Rep. of the Congo,COD,Senegal,SEN,0,0,0,188,188
2018,Gambia,GMB,Senegal,SEN,10,0,0,50,60
2018,Ghana,GHA,Senegal,SEN,0,0,0,30,30
2018,Guinea-Bissau,GNB,Senegal,SEN,0,0,0,90,90
2018,Guinea,GIN,Senegal,SEN,0,0,0,16,16
2018,Cote d'Ivoire,CIV,Senegal,SEN,0,0,0,147,147
2018,India,IND,Senegal,SEN,0,0,0,5,5
2018,Liberia,LBR,Senegal,SEN,0,0,0,341,341
2018,Sri Lanka,LKA,Senegal,SEN,0,0,0,81,81
2018,Mauritania,MRT,Senegal,SEN,5,0,0,44,49
2018,Niger,NER,Senegal,SEN,0,0,0,5,5
2018,Nigeria,NGA,Senegal,SEN,0,0,0,322,322
2018,Rwanda,RWA,Senegal,SEN,0,0,0,5,5
2018,Somalia,SOM,Senegal,SEN,0,0,0,5,5
2018,Syrian Arab Rep.,SYR,Senegal,SEN,0,0,0,5,5
2018,United Rep. of Tanzania,TZA,Senegal,SEN,0,0,0,5,5
2018,Togo,TGO,Senegal,SEN,0,0,0,63,63
2018,Turkey,TUR,Senegal,SEN,0,0,0,24,24
2018,Afghanistan,AFG,Slovakia,SVK,5,11,10,10,36
2018,Algeria,DZA,Slovakia,SVK,0,0,5,0,5
2018,Azerbaijan,AZE,Slovakia,SVK,0,0,0,12,12
2018,China,CHN,Slovakia,SVK,0,0,0,5,5
2018,Georgia,GEO,Slovakia,SVK,0,0,0,5,5
2018,India,IND,Slovakia,SVK,0,0,5,0,5
2018,Iran (Islamic Rep. of),IRN,Slovakia,SVK,0,0,10,5,15
2018,Iraq,IRQ,Slovakia,SVK,0,0,5,15,20
2018,Pakistan,PAK,Slovakia,SVK,0,0,5,5,10
2018,Russian Federation,RUS,Slovakia,SVK,0,0,5,5,10
2018,Viet Nam,VNM,Slovakia,SVK,0,0,10,0,10
2018,Ukraine,UKR,Slovakia,SVK,0,0,5,0,5
2018,Yemen,YEM,Slovakia,SVK,0,19,0,0,19
2018,Afghanistan,AFG,Tajikistan,TJK,580,0,66,0,646
2019,Afghanistan,AFG,Austria,AUT,4070,1225,1849,1167,8311
2019,Albania,ALB,Austria,AUT,0,0,45,11,56
2019,Algeria,DZA,Austria,AUT,0,0,94,31,125
2019,Egypt,EGY,Austria,AUT,19,0,59,33,111
2019,Armenia,ARM,Austria,AUT,10,10,120,10,150
2019,Azerbaijan,AZE,Austria,AUT,5,0,14,5,24
2019,Benin,BEN,Austria,AUT,0,0,5,0,5
2019,Bangladesh,BGD,Austria,AUT,25,10,147,94,276
2019,Belarus,BLR,Austria,AUT,0,0,5,12,17
2019,Brazil,BRA,Austria,AUT,0,0,0,5,5
2019,Bosnia and Herzegovina,BIH,Austria,AUT,5,0,27,157,189
2019,Bulgaria,BGR,Austria,AUT,0,0,0,26,26
2019,China,CHN,Austria,AUT,90,5,91,56,242
2019,Cameroon,CMR,Austria,AUT,11,5,18,5,39
2019,Congo,COG,Austria,AUT,5,0,0,0,5
2019,Dem. Rep. of the Congo,COD,Austria,AUT,5,5,11,5,26
2019,Colombia,COL,Austria,AUT,0,0,0,5,5
2019,Cuba,CUB,Austria,AUT,5,0,11,0,16
2019,Czechia,CZE,Austria,AUT,0,0,0,30,30
2019,Dominican Rep.,DOM,Austria,AUT,0,0,0,10,10
2019,Ecuador,ECU,Austria,AUT,0,0,0,5,5
2019,Eritrea,ERI,Austria,AUT,44,16,0,0,60
2019,Ethiopia,ETH,Austria,AUT,21,5,18,5,49
2019,France,FRA,Austria,AUT,0,0,0,5,5
2019,Gambia,GMB,Austria,AUT,10,0,36,11,57
2019,United Kingdom of Great Britain and Northern Ireland,GBR,Austria,AUT,0,0,0,5,5
2019,Georgia,GEO,Austria,AUT,5,32,364,64,465
2019,Germany,DEU,Austria,AUT,0,0,0,106,106
2019,Ghana,GHA,Austria,AUT,0,0,13,5,18
2019,Greece,GRC,Austria,AUT,0,0,0,5,5
2019,Guinea,GIN,Austria,AUT,12,0,12,0,24
2019,Croatia,HRV,Austria,AUT,0,0,0,58,58
2019,Hungary,HUN,Austria,AUT,0,0,0,61,61
2019,Cote d'Ivoire,CIV,Austria,AUT,5,0,10,0,15
2019,India,IND,Austria,AUT,0,0,286,51,337
2019,Ireland,IRL,Austria,AUT,0,0,0,5,5
2019,Iran (Islamic Rep. of),IRN,Austria,AUT,786,5,242,77,1110
2019,Iraq,IRQ,Austria,AUT,300,264,611,332,1507
2019,Israel,ISR,Austria,AUT,0,0,5,0,5
2019,Italy,ITA,Austria,AUT,0,0,0,21,21
2019,Jordan,JOR,Austria,AUT,5,0,19,0,24
2019,Kazakhstan,KAZ,Austria,AUT,10,0,25,5,40
2019,Kenya,KEN,Austria,AUT,0,0,5,0,5
2019,Kyrgyzstan,KGZ,Austria,AUT,0,0,15,0,15
2019,Kuwait,KWT,Austria,AUT,5,0,0,5,10
2019,Liberia,LBR,Austria,AUT,0,0,5,0,5
2019,Libya,LBY,Austria,AUT,12,20,10,13,55
2019,Lebanon,LBN,Austria,AUT,5,0,24,16,45
2019,Sri Lanka,LKA,Austria,AUT,10,0,5,0,15
2019,Lithuania,LTU,Austria,AUT,0,0,0,5,5
2019,North Macedonia,MKD,Austria,AUT,0,0,48,56,104
2019,Rep. of Moldova,MDA,Austria,AUT,0,0,16,12,28
2019,Mongolia,MNG,Austria,AUT,0,0,73,5,78
2019,Morocco,MAR,Austria,AUT,5,5,88,11,109
2019,Nepal,NPL,Austria,AUT,0,0,16,5,21
2019,Netherlands,NLD,Austria,AUT,0,0,0,5,5
2019,Nigeria,NGA,Austria,AUT,23,28,376,74,501
2019,Pakistan,PAK,Austria,AUT,20,0,243,81,344
2019,Philippines,PHL,Austria,AUT,5,0,10,0,15
2019,Poland,POL,Austria,AUT,0,0,0,41,41
2019,Portugal,PRT,Austria,AUT,0,0,0,5,5
2019,Romania,ROU,Austria,AUT,0,0,5,267,272
2019,Russian Federation,RUS,Austria,AUT,378,50,1032,178,1638
2019,Serbia and Kosovo: S/RES/1244 (1999),SRB,Austria,AUT,14,5,193,348,560
2019,Senegal,SEN,Austria,AUT,0,0,5,0,5
2019,Sierra Leone,SLE,Austria,AUT,5,0,10,0,15
2019,Somalia,SOM,Austria,AUT,751,139,91,55,1036
2019,Spain,ESP,Austria,AUT,0,0,0,5,5
2019,Viet Nam,VNM,Austria,AUT,0,0,10,10,20
2019,Sudan,SDN,Austria,AUT,16,19,10,5,50
2019,Slovakia,SVK,Austria,AUT,0,0,0,47,47
2019,Slovenia,SVN,Austria,AUT,0,0,0,13,13
2019,Syrian Arab Rep.,SYR,Austria,AUT,2534,295,169,87,3085
2019,Tajikistan,TJK,Austria,AUT,30,0,19,0,49
2019,Togo,TGO,Austria,AUT,0,0,5,0,5
2019,Tunisia,TUN,Austria,AUT,0,0,44,15,59
2019,Turkey,TUR,Austria,AUT,86,5,181,281,553
2019,Uganda,UGA,Austria,AUT,0,0,5,5,10
2019,Ukraine,UKR,Austria,AUT,12,10,363,47,432
2019,United States of America,USA,Austria,AUT,0,0,5,0,5
2019,Uzbekistan,UZB,Austria,AUT,0,0,83,5,88
2019,Venezuela (Bolivarian Republic of),VEN,Austria,AUT,0,25,5,0,30
2019,Yemen,YEM,Austria,AUT,40,13,0,0,53
2019,Unknown ,,Austria,AUT,311,32,60,40,443
2019,Afghanistan,AFG,Bulgaria,BGR,38,0,631,612,1281
2019,Algeria,DZA,Bulgaria,BGR,0,0,18,5,23
2019,Egypt,EGY,Bulgaria,BGR,0,0,5,0,5
2019,Bangladesh,BGD,Bulgaria,BGR,0,0,11,0,11
2019,India,IND,Bulgaria,BGR,0,0,5,0,5
2019,Iran (Islamic Rep. of),IRN,Bulgaria,BGR,21,0,63,13,97
2019,Iraq,IRQ,Bulgaria,BGR,50,0,233,300,583
2019,Libya,LBY,Bulgaria,BGR,0,0,5,0,5
2019,Lebanon,LBN,Bulgaria,BGR,5,0,5,5,15
2019,Mali,MLI,Bulgaria,BGR,0,0,5,0,5
2019,Morocco,MAR,Bulgaria,BGR,0,0,16,5,21
2019,Myanmar,MMR,Bulgaria,BGR,0,0,5,0,5
2019,Nigeria,NGA,Bulgaria,BGR,0,0,10,0,10
2019,Pakistan,PAK,Bulgaria,BGR,5,0,80,31,116
2019,Russian Federation,RUS,Bulgaria,BGR,0,0,11,0,11
2019,Syrian Arab Rep.,SYR,Bulgaria,BGR,335,0,10,61,406
2019,Turkey,TUR,Bulgaria,BGR,0,0,5,5,10
2019,Ukraine,UKR,Bulgaria,BGR,0,0,5,0,5
2019,Stateless,XXA,Bulgaria,BGR,21,0,5,5,31
2019,Chad,TCD,Central African Rep.,CAF,10,0,53,10,73
2019,Cameroon,CMR,Central African Rep.,CAF,21,0,5,0,26
2019,Congo,COG,Central African Rep.,CAF,0,0,0,5,5
2019,Dem. Rep. of the Congo,COD,Central African Rep.,CAF,13,0,116,51,180
2019,Liberia,LBR,Central African Rep.,CAF,0,0,0,5,5
2019,Sudan,SDN,Central African Rep.,CAF,0,0,0,5,5
2019,South Sudan,SSD,Central African Rep.,CAF,0,0,0,5,5
2019,Togo,TGO,Central African Rep.,CAF,0,0,0,10,10
2019,Turkey,TUR,Central African Rep.,CAF,5,0,0,0,5
2019,Central African Rep.,CAF,Chad,TCD,57,0,0,567,624
2019,Cameroon,CMR,Chad,TCD,0,0,0,5,5
2019,Dem. Rep. of the Congo,COD,Chad,TCD,0,0,0,16,16
2019,Eritrea,ERI,Chad,TCD,0,0,0,10,10
2019,Ethiopia,ETH,Chad,TCD,0,0,0,5,5
2019,Libya,LBY,Chad,TCD,0,0,0,5,5
2019,Nigeria,NGA,Chad,TCD,0,0,0,12,12
2019,Sudan,SDN,Chad,TCD,5,0,0,158,163
2019,South Sudan,SSD,Chad,TCD,0,0,0,5,5
2019,Syrian Arab Rep.,SYR,Chad,TCD,0,0,0,14,14
2019,Yemen,YEM,Chad,TCD,0,0,0,5,5
2019,Afghanistan,AFG,Ecuador,ECU,10,0,0,0,10
2019,Angola,AGO,Ecuador,ECU,0,0,5,14,19
2019,Egypt,EGY,Ecuador,ECU,0,0,0,5,5
2019,Chile,CHL,Ecuador,ECU,5,0,0,5,10
2019,Cameroon,CMR,Ecuador,ECU,10,0,0,5,15
2019,Dem. Rep. of the Congo,COD,Ecuador,ECU,5,0,5,22,32
2019,Colombia,COL,Ecuador,ECU,2671,0,694,1753,5118
2019,Cuba,CUB,Ecuador,ECU,0,0,31,19,50
2019,Dominican Rep.,DOM,Ecuador,ECU,0,0,5,5,10
2019,Haiti,HTI,Ecuador,ECU,0,0,5,0,5
2019,Cote d'Ivoire,CIV,Ecuador,ECU,0,0,5,0,5
2019,Iran (Islamic Rep. of),IRN,Ecuador,ECU,20,0,0,5,25
2019,Lebanon,LBN,Ecuador,ECU,10,0,5,0,15
2019,Sri Lanka,LKA,Ecuador,ECU,0,0,0,5,5
2019,Nicaragua,NIC,Ecuador,ECU,0,0,0,5,5
2019,Nigeria,NGA,Ecuador,ECU,10,0,0,0,10
2019,Peru,PER,Ecuador,ECU,0,0,12,5,17
2019,Russian Federation,RUS,Ecuador,ECU,5,0,0,0,5
2019,El Salvador,SLV,Ecuador,ECU,18,0,0,0,18
2019,Saudi Arabia,SAU,Ecuador,ECU,5,0,0,5,10
2019,Syrian Arab Rep.,SYR,Ecuador,ECU,45,0,0,17,62
2019,Turkmenistan,TKM,Ecuador,ECU,0,0,10,0,10
2019,Turkey,TUR,Ecuador,ECU,0,0,0,5,5
2019,Vanuatu,VUT,Ecuador,ECU,0,0,5,0,5
2019,Venezuela (Bolivarian Republic of),VEN,Ecuador,ECU,369,0,5203,1721,7293
2019,Yemen,YEM,Ecuador,ECU,46,0,0,48,94
2019,Dem. Rep. of the Congo,COD,Gabon,GAB,0,0,0,24,24
2019,Equatorial Guinea,GNQ,Gabon,GAB,0,0,0,5,5
2019,Central African Rep.,CAF,Gambia,GMB,0,0,0,5,5
2019,Senegal,SEN,Gambia,GMB,0,0,0,138,138
2019,Burkina Faso,BFA,Cote d'Ivoire,CIV,0,0,5,0,5
2019,Central African Rep.,CAF,Cote d'Ivoire,CIV,44,0,5,0,49
2019,Cameroon,CMR,Cote d'Ivoire,CIV,0,0,13,0,13
2019,Congo,COG,Cote d'Ivoire,CIV,0,0,0,11,11
2019,Dem. Rep. of the Congo,COD,Cote d'Ivoire,CIV,0,0,0,15,15
2019,Guinea,GIN,Cote d'Ivoire,CIV,0,0,5,0,5
2019,Iraq,IRQ,Cote d'Ivoire,CIV,5,0,0,0,5
2019,Liberia,LBR,Cote d'Ivoire,CIV,0,0,0,32,32
2019,Mauritania,MRT,Cote d'Ivoire,CIV,0,0,0,10,10
2019,Mali,MLI,Cote d'Ivoire,CIV,5,0,0,0,5
2019,Syrian Arab Rep.,SYR,Cote d'Ivoire,CIV,34,0,0,0,34
2019,Togo,TGO,Cote d'Ivoire,CIV,0,0,10,0,10
2019,Turkey,TUR,Cote d'Ivoire,CIV,12,0,0,0,12
2019,Armenia,ARM,Israel,ISR,0,0,5,11,16
2019,Azerbaijan,AZE,Israel,ISR,0,0,0,5,5
2019,Burkina Faso,BFA,Israel,ISR,0,0,5,0,5
2019,Belarus,BLR,Israel,ISR,0,0,15,99,114
2019,Bulgaria,BGR,Israel,ISR,0,0,0,5,5
2019,China,CHN,Israel,ISR,0,0,52,16,68
2019,Cameroon,CMR,Israel,ISR,0,0,5,0,5
2019,Dem. Rep. of the Congo,COD,Israel,ISR,0,0,5,10,15
2019,Colombia,COL,Israel,ISR,0,0,19,17,36
2019,Ecuador,ECU,Israel,ISR,0,0,5,0,5
2019,Eritrea,ERI,Israel,ISR,5,0,15,654,674
2019,Ethiopia,ETH,Israel,ISR,0,0,114,37,151
2019,Georgia,GEO,Israel,ISR,0,0,349,431,780
2019,Ghana,GHA,Israel,ISR,0,0,97,28,125
2019,Greece,GRC,Israel,ISR,0,0,0,5,5
2019,Guinea,GIN,Israel,ISR,0,0,22,0,22
2019,Cote d'Ivoire,CIV,Israel,ISR,0,0,5,5,10
2019,India,IND,Israel,ISR,0,0,267,72,339
2019,Kazakhstan,KAZ,Israel,ISR,0,0,5,17,22
2019,Kenya,KEN,Israel,ISR,0,0,5,0,5
2019,Kyrgyzstan,KGZ,Israel,ISR,0,0,0,10,10
2019,Sri Lanka,LKA,Israel,ISR,0,0,279,56,335
2019,Latvia,LVA,Israel,ISR,0,0,0,5,5
2019,Rep. of Moldova,MDA,Israel,ISR,0,0,105,132,237
2019,Myanmar,MMR,Israel,ISR,0,0,5,0,5
2019,Nepal,NPL,Israel,ISR,0,0,64,10,74
2019,Nigeria,NGA,Israel,ISR,0,0,123,22,145
2019,Philippines,PHL,Israel,ISR,0,0,13,10,23
2019,Romania,ROU,Israel,ISR,0,0,10,15,25
2019,South Africa,ZAF,Israel,ISR,0,0,10,35,45
2019,Russian Federation,RUS,Israel,ISR,0,0,776,740,1516
2019,Sierra Leone,SLE,Israel,ISR,0,0,5,0,5
2019,Spain,ESP,Israel,ISR,0,0,0,5,5
2019,Sudan,SDN,Israel,ISR,0,119,0,90,209
2019,South Sudan,SSD,Israel,ISR,0,0,0,5,5
2019,Thailand,THA,Israel,ISR,0,0,5,0,5
2019,Turkey,TUR,Israel,ISR,0,0,38,42,80
2019,Uganda,UGA,Israel,ISR,0,0,0,5,5
2019,Ukraine,UKR,Israel,ISR,0,5,1039,2392,3436
2019,Uzbekistan,UZB,Israel,ISR,0,0,66,33,99
2019,Unknown ,,Israel,ISR,0,0,5,0,5
2019,Algeria,DZA,Rep. of Korea,KOR,0,0,45,16,61
2019,Angola,AGO,Rep. of Korea,KOR,0,0,13,5,18
2019,Egypt,EGY,Rep. of Korea,KOR,0,5,350,84,439
2019,Bangladesh,BGD,Rep. of Korea,KOR,5,0,129,114,248
2019,Burkina Faso,BFA,Rep. of Korea,KOR,0,0,5,5,10
2019,Cambodia,KHM,Rep. of Korea,KOR,0,0,0,14,14
2019,China,CHN,Rep. of Korea,KOR,0,0,375,638,1013
2019,Cameroon,CMR,Rep. of Korea,KOR,0,0,51,38,89
2019,Dem. Rep. of the Congo,COD,Rep. of Korea,KOR,5,0,5,0,10
2019,Colombia,COL,Rep. of Korea,KOR,0,0,5,0,5
2019,Ethiopia,ETH,Rep. of Korea,KOR,5,0,19,5,29
2019,Gambia,GMB,Rep. of Korea,KOR,0,0,36,5,41
2019,Ghana,GHA,Rep. of Korea,KOR,0,0,107,29,136
2019,Guinea-Bissau,GNB,Rep. of Korea,KOR,0,0,5,0,5
2019,Guinea,GIN,Rep. of Korea,KOR,0,0,52,5,57
2019,Cote d'Ivoire,CIV,Rep. of Korea,KOR,0,0,15,0,15
2019,India,IND,Rep. of Korea,KOR,0,0,413,138,551
2019,Indonesia,IDN,Rep. of Korea,KOR,0,0,36,18,54
2019,Iran (Islamic Rep. of),IRN,Rep. of Korea,KOR,0,0,32,11,43
2019,Iraq,IRQ,Rep. of Korea,KOR,0,0,5,0,5
2019,Jordan,JOR,Rep. of Korea,KOR,0,0,5,0,5
2019,Kazakhstan,KAZ,Rep. of Korea,KOR,0,0,863,898,1761
2019,Kenya,KEN,Rep. of Korea,KOR,0,0,12,5,17
2019,Kyrgyzstan,KGZ,Rep. of Korea,KOR,0,0,44,27,71
2019,Liberia,LBR,Rep. of Korea,KOR,0,0,101,36,137
2019,Sri Lanka,LKA,Rep. of Korea,KOR,0,0,41,41,82
2019,Mali,MLI,Rep. of Korea,KOR,0,0,46,5,51
2019,Malaysia,MYS,Rep. of Korea,KOR,0,0,185,418,603
2019,Mongolia,MNG,Rep. of Korea,KOR,0,0,121,96,217
2019,Morocco,MAR,Rep. of Korea,KOR,0,0,134,79,213
2019,Mozambique,MOZ,Rep. of Korea,KOR,0,0,5,0,5
2019,Myanmar,MMR,Rep. of Korea,KOR,5,0,5,5,15
2019,Nepal,NPL,Rep. of Korea,KOR,0,0,59,27,86
2019,Nigeria,NGA,Rep. of Korea,KOR,0,0,314,51,365
2019,Pakistan,PAK,Rep. of Korea,KOR,5,0,362,163,530
2019,Peru,PER,Rep. of Korea,KOR,0,0,5,0,5
2019,Philippines,PHL,Rep. of Korea,KOR,0,0,113,146,259
2019,South Africa,ZAF,Rep. of Korea,KOR,0,0,68,19,87
2019,Russian Federation,RUS,Rep. of Korea,KOR,0,0,536,675,1211
2019,Rwanda,RWA,Rep. of Korea,KOR,0,0,5,0,5
2019,Senegal,SEN,Rep. of Korea,KOR,0,0,68,10,78
2019,Sierra Leone,SLE,Rep. of Korea,KOR,0,0,5,0,5
2019,Viet Nam,VNM,Rep. of Korea,KOR,0,0,48,55,103
2019,Sudan,SDN,Rep. of Korea,KOR,0,0,18,0,18
2019,Syrian Arab Rep.,SYR,Rep. of Korea,KOR,0,22,0,0,22
2019,United Rep. of Tanzania,TZA,Rep. of Korea,KOR,0,0,14,5,19
2019,Thailand,THA,Rep. of Korea,KOR,0,0,77,224,301
2019,Tajikistan,TJK,Rep. of Korea,KOR,0,0,5,0,5
2019,Togo,TGO,Rep. of Korea,KOR,0,0,5,0,5
2019,Tunisia,TUN,Rep. of Korea,KOR,0,0,22,17,39
2019,Turkey,TUR,Rep. of Korea,KOR,0,0,58,35,93
2019,Uganda,UGA,Rep. of Korea,KOR,0,0,30,15,45
2019,Ukraine,UKR,Rep. of Korea,KOR,0,0,11,13,24
2019,Uzbekistan,UZB,Rep. of Korea,KOR,0,0,36,30,66
2019,Venezuela (Bolivarian Republic of),VEN,Rep. of Korea,KOR,0,0,5,0,5
2019,Yemen,YEM,Rep. of Korea,KOR,5,195,11,13,224
2019,Zimbabwe,ZWE,Rep. of Korea,KOR,0,0,5,0,5
2019,Afghanistan,AFG,North Macedonia,MKD,0,0,0,114,114
2019,Algeria,DZA,North Macedonia,MKD,0,0,0,10,10
2019,Egypt,EGY,North Macedonia,MKD,0,0,0,5,5
2019,Bangladesh,BGD,North Macedonia,MKD,0,0,0,32,32
2019,Iraq,IRQ,North Macedonia,MKD,0,0,0,29,29
2019,Libya,LBY,North Macedonia,MKD,0,0,0,10,10
2019,Morocco,MAR,North Macedonia,MKD,0,0,0,5,5
2019,Pakistan,PAK,North Macedonia,MKD,0,0,5,111,116
2019,Syrian Arab Rep.,SYR,North Macedonia,MKD,0,0,0,45,45
2019,Afghanistan,AFG,Montenegro,MNE,0,0,0,55,55
2019,Algeria,DZA,Montenegro,MNE,0,0,0,256,256
2019,Egypt,EGY,Montenegro,MNE,0,0,0,5,5
2019,Palestinian,PSE,Montenegro,MNE,0,0,0,50,50
2019,Iran (Islamic Rep. of),IRN,Montenegro,MNE,0,0,5,38,43
2019,Iraq,IRQ,Montenegro,MNE,0,0,0,257,257
2019,Jordan,JOR,Montenegro,MNE,0,0,0,5,5
2019,Libya,LBY,Montenegro,MNE,0,0,0,78,78
2019,Morocco,MAR,Montenegro,MNE,0,0,0,417,417
2019,Nepal,NPL,Montenegro,MNE,0,0,0,15,15
2019,Pakistan,PAK,Montenegro,MNE,0,0,0,104,104
2019,Somalia,SOM,Montenegro,MNE,0,0,0,5,5
2019,Sudan,SDN,Montenegro,MNE,0,0,0,5,5
2019,Syrian Arab Rep.,SYR,Montenegro,MNE,5,0,0,279,284
2019,Tunisia,TUN,Montenegro,MNE,0,0,0,10,10
2019,Cambodia,KHM,Philippines,PHL,5,0,0,0,5
2019,Cameroon,CMR,Philippines,PHL,12,0,11,0,23
2019,Dem. Rep. of the Congo,COD,Philippines,PHL,5,0,5,0,10
2019,Cote d'Ivoire,CIV,Philippines,PHL,5,0,5,0,10
2019,Iran (Islamic Rep. of),IRN,Philippines,PHL,5,0,0,0,5
2019,Morocco,MAR,Philippines,PHL,5,0,0,0,5
2019,Rwanda,RWA,Philippines,PHL,0,0,5,0,5
2019,Saudi Arabia,SAU,Philippines,PHL,0,0,5,0,5
2019,Somalia,SOM,Philippines,PHL,5,0,0,0,5
2019,Viet Nam,VNM,Philippines,PHL,5,0,0,0,5
2019,Syrian Arab Rep.,SYR,Philippines,PHL,14,0,0,0,14
2019,Turkey,TUR,Philippines,PHL,26,0,0,0,26
2019,Yemen,YEM,Philippines,PHL,5,0,0,0,5
2019,Afghanistan,AFG,Senegal,SEN,0,0,0,5,5
2019,Central African Rep.,CAF,Senegal,SEN,61,0,0,32,93
2019,Chad,TCD,Senegal,SEN,0,0,0,5,5
2019,Dem. Rep. of the Congo,COD,Senegal,SEN,0,0,0,5,5
2019,Gambia,GMB,Senegal,SEN,10,0,0,16,26
2019,Cote d'Ivoire,CIV,Senegal,SEN,0,0,0,5,5
2019,Liberia,LBR,Senegal,SEN,0,0,0,5,5
2019,Turkey,TUR,Senegal,SEN,12,0,0,5,17
2019,Afghanistan,AFG,Tajikistan,TJK,1920,0,210,0,2130
2020,Afghanistan,AFG,Austria,AUT,2875,1198,1447,1173,6693
2020,Albania,ALB,Austria,AUT,0,0,29,17,46
2020,Algeria,DZA,Austria,AUT,0,0,152,51,203
2020,Angola,AGO,Austria,AUT,0,0,13,0,13
2020,Egypt,EGY,Austria,AUT,10,10,106,45,171
2020,Armenia,ARM,Austria,AUT,10,5,111,5,131
2020,Azerbaijan,AZE,Austria,AUT,0,0,25,10,35
2020,Benin,BEN,Austria,AUT,0,0,5,0,5
2020,Bangladesh,BGD,Austria,AUT,23,5,216,99,343
2020,Belarus,BLR,Austria,AUT,0,0,10,10,20
2020,Bosnia and Herzegovina,BIH,Austria,AUT,0,0,15,5,20
2020,China,CHN,Austria,AUT,49,0,72,25,146
2020,Cameroon,CMR,Austria,AUT,10,5,11,0,26
2020,Congo,COG,Austria,AUT,0,0,5,0,5
2020,Dem. Rep. of the Congo,COD,Austria,AUT,23,5,21,5,54
2020,Colombia,COL,Austria,AUT,0,0,5,0,5
2020,Cuba,CUB,Austria,AUT,0,0,5,0,5
2020,Eritrea,ERI,Austria,AUT,42,5,5,0,52
2020,Ethiopia,ETH,Austria,AUT,16,5,11,5,37
2020,Gambia,GMB,Austria,AUT,0,5,31,5,41
2020,Georgia,GEO,Austria,AUT,5,19,208,37,269
2020,Germany,DEU,Austria,AUT,0,0,5,0,5
2020,Ghana,GHA,Austria,AUT,0,0,14,0,14
2020,Guinea-Bissau,GNB,Austria,AUT,0,5,0,0,5
2020,Guinea,GIN,Austria,AUT,0,0,14,0,14
2020,Cote d'Ivoire,CIV,Austria,AUT,0,0,5,0,5
2020,India,IND,Austria,AUT,0,0,212,51,263
2020,Iran (Islamic Rep. of),IRN,Austria,AUT,705,17,286,89,1097
2020,Iraq,IRQ,Austria,AUT,246,573,668,257,1744
2020,Israel,ISR,Austria,AUT,0,0,0,5,5
2020,Jordan,JOR,Austria,AUT,0,0,0,5,5
2020,Kazakhstan,KAZ,Austria,AUT,0,5,5,0,10
2020,Kenya,KEN,Austria,AUT,0,0,0,5,5
2020,Kyrgyzstan,KGZ,Austria,AUT,5,0,12,0,17
2020,Liberia,LBR,Austria,AUT,0,0,5,0,5
2020,Libya,LBY,Austria,AUT,10,5,5,44,64
2020,Lebanon,LBN,Austria,AUT,10,0,52,5,67
2020,Sri Lanka,LKA,Austria,AUT,0,0,13,0,13
2020,North Macedonia,MKD,Austria,AUT,0,0,33,22,55
2020,Rep. of Moldova,MDA,Austria,AUT,0,5,14,5,24
2020,Mali,MLI,Austria,AUT,0,0,0,5,5
2020,Mongolia,MNG,Austria,AUT,13,10,86,0,109
2020,Morocco,MAR,Austria,AUT,0,5,364,70,439
2020,Montenegro,MNE,Austria,AUT,0,0,5,0,5
2020,Nepal,NPL,Austria,AUT,0,0,13,5,18
2020,Nigeria,NGA,Austria,AUT,10,33,191,60,294
2020,Pakistan,PAK,Austria,AUT,35,5,197,70,307
2020,Philippines,PHL,Austria,AUT,5,0,5,0,10
2020,Romania,ROU,Austria,AUT,0,0,11,0,11
2020,Russian Federation,RUS,Austria,AUT,237,35,1247,270,1789
2020,Serbia and Kosovo: S/RES/1244 (1999),SRB,Austria,AUT,5,5,163,102,275
2020,Senegal,SEN,Austria,AUT,0,0,10,0,10
2020,Sierra Leone,SLE,Austria,AUT,0,0,5,0,5
2020,Somalia,SOM,Austria,AUT,566,145,52,43,806
2020,Viet Nam,VNM,Austria,AUT,0,0,0,5,5
2020,Sudan,SDN,Austria,AUT,5,11,5,0,21
2020,Syrian Arab Rep.,SYR,Austria,AUT,2751,318,62,411,3542
2020,Tajikistan,TJK,Austria,AUT,12,0,5,0,17
2020,Tunisia,TUN,Austria,AUT,0,0,33,10,43
2020,Turkey,TUR,Austria,AUT,113,5,113,89,320
2020,Uganda,UGA,Austria,AUT,5,0,5,0,10
2020,Ukraine,UKR,Austria,AUT,10,5,175,19,209
2020,United States of America,USA,Austria,AUT,0,0,5,0,5
2020,Uzbekistan,UZB,Austria,AUT,0,0,23,10,33
2020,Venezuela (Bolivarian Republic of),VEN,Austria,AUT,0,28,5,0,33
2020,Yemen,YEM,Austria,AUT,30,14,0,5,49
2020,Unknown ,,Austria,AUT,221,24,50,38,333
2020,Afghanistan,AFG,Bulgaria,BGR,5,5,858,226,1094
2020,Algeria,DZA,Bulgaria,BGR,0,0,41,5,46
2020,Egypt,EGY,Bulgaria,BGR,0,0,10,0,10
2020,Bangladesh,BGD,Bulgaria,BGR,0,0,19,5,24
2020,China,CHN,Bulgaria,BGR,0,0,0,5,5
2020,Cameroon,CMR,Bulgaria,BGR,0,0,5,0,5
2020,Georgia,GEO,Bulgaria,BGR,0,0,5,0,5
2020,Iran (Islamic Rep. of),IRN,Bulgaria,BGR,0,0,45,25,70
2020,Iraq,IRQ,Bulgaria,BGR,0,23,147,124,294
2020,Libya,LBY,Bulgaria,BGR,0,0,13,0,13
2020,Lebanon,LBN,Bulgaria,BGR,0,0,5,0,5
2020,Morocco,MAR,Bulgaria,BGR,0,0,92,5,97
2020,Nigeria,NGA,Bulgaria,BGR,0,0,10,0,10
2020,Pakistan,PAK,Bulgaria,BGR,0,0,56,14,70
2020,Russian Federation,RUS,Bulgaria,BGR,0,0,14,0,14
2020,Syrian Arab Rep.,SYR,Bulgaria,BGR,97,668,5,23,793
2020,Turkmenistan,TKM,Bulgaria,BGR,0,0,5,0,5
2020,Tunisia,TUN,Bulgaria,BGR,0,0,5,0,5
2020,Turkey,TUR,Bulgaria,BGR,0,0,13,0,13
2020,Ukraine,UKR,Bulgaria,BGR,0,0,11,0,11
2020,Venezuela (Bolivarian Republic of),VEN,Bulgaria,BGR,0,0,5,0,5
2020,Yemen,YEM,Bulgaria,BGR,0,0,5,0,5
2020,Stateless,XXA,Bulgaria,BGR,0,10,12,5,27
2020,Dem. Rep. of the Congo,COD,Central African Rep.,CAF,20,0,5,0,25
2020,Central African Rep.,CAF,Chad,TCD,32,0,0,20,52
2020,Libya,LBY,Chad,TCD,0,0,0,5,5
2020,Nigeria,NGA,Chad,TCD,0,0,0,5,5
2020,Sudan,SDN,Chad,TCD,5,0,0,113,118
2020,Syrian Arab Rep.,SYR,Chad,TCD,5,0,0,0,5
2020,Cameroon,CMR,Ecuador,ECU,0,5,0,0,5
2020,Colombia,COL,Ecuador,ECU,763,147,0,32,942
2020,Cuba,CUB,Ecuador,ECU,0,0,0,5,5
2020,Lebanon,LBN,Ecuador,ECU,5,0,0,0,5
2020,Rwanda,RWA,Ecuador,ECU,5,0,0,0,5
2020,Syrian Arab Rep.,SYR,Ecuador,ECU,0,10,0,0,10
2020,Venezuela (Bolivarian Republic of),VEN,Ecuador,ECU,32,10,0,109,151
2020,Yemen,YEM,Ecuador,ECU,5,23,0,0,28
2020,Central African Rep.,CAF,Cote d'Ivoire,CIV,27,0,12,0,39
2020,Congo,COG,Cote d'Ivoire,CIV,5,0,5,0,10
2020,Dem. Rep. of the Congo,COD,Cote d'Ivoire,CIV,0,0,10,0,10
2020,Syrian Arab Rep.,SYR,Cote d'Ivoire,CIV,5,0,5,0,10
2020,Albania,ALB,Israel,ISR,0,0,0,10,10
2020,Armenia,ARM,Israel,ISR,0,0,0,11,11
2020,Azerbaijan,AZE,Israel,ISR,0,0,11,11,22
2020,Belarus,BLR,Israel,ISR,0,5,29,233,267
2020,China,CHN,Israel,ISR,0,0,31,21,52
2020,Cameroon,CMR,Israel,ISR,0,0,5,5,10
2020,Congo,COG,Israel,ISR,0,0,5,0,5
2020,Dem. Rep. of the Congo,COD,Israel,ISR,0,0,0,11,11
2020,Colombia,COL,Israel,ISR,0,0,53,21,74
2020,Eritrea,ERI,Israel,ISR,10,5,294,325,634
2020,Ethiopia,ETH,Israel,ISR,0,5,54,18,77
2020,Georgia,GEO,Israel,ISR,0,0,659,395,1054
2020,Ghana,GHA,Israel,ISR,0,0,67,11,78
2020,Greece,GRC,Israel,ISR,0,0,0,5,5
2020,Guinea,GIN,Israel,ISR,0,0,5,0,5
2020,Hungary,HUN,Israel,ISR,0,0,0,5,5
2020,Cote d'Ivoire,CIV,Israel,ISR,0,0,5,0,5
2020,India,IND,Israel,ISR,0,0,192,96,288
2020,Kazakhstan,KAZ,Israel,ISR,0,0,0,33,33
2020,Kenya,KEN,Israel,ISR,0,0,5,0,5
2020,Kyrgyzstan,KGZ,Israel,ISR,0,0,5,11,16
2020,Sri Lanka,LKA,Israel,ISR,0,0,176,55,231
2020,North Macedonia,MKD,Israel,ISR,0,0,0,49,49
2020,Rep. of Moldova,MDA,Israel,ISR,0,0,69,160,229
2020,Mexico,MEX,Israel,ISR,0,0,5,0,5
2020,Malawi,MWI,Israel,ISR,0,0,0,5,5
2020,Mongolia,MNG,Israel,ISR,0,0,0,5,5
2020,Montenegro,MNE,Israel,ISR,0,0,0,12,12
2020,Nepal,NPL,Israel,ISR,0,0,21,5,26
2020,Nigeria,NGA,Israel,ISR,0,0,32,27,59
2020,Philippines,PHL,Israel,ISR,0,0,5,0,5
2020,Romania,ROU,Israel,ISR,0,0,5,14,19
2020,South Africa,ZAF,Israel,ISR,0,0,5,46,51
2020,Russian Federation,RUS,Israel,ISR,0,5,963,1320,2288
2020,Serbia and Kosovo: S/RES/1244 (1999),SRB,Israel,ISR,0,0,0,62,62
2020,Viet Nam,VNM,Israel,ISR,0,0,5,0,5
2020,Sudan,SDN,Israel,ISR,0,10,0,99,109
2020,South Sudan,SSD,Israel,ISR,0,5,11,5,21
2020,Thailand,THA,Israel,ISR,0,0,10,0,10
2020,Tajikistan,TJK,Israel,ISR,0,0,0,5,5
2020,Turkey,TUR,Israel,ISR,0,0,99,65,164
2020,Uganda,UGA,Israel,ISR,0,0,0,5,5
2020,Ukraine,UKR,Israel,ISR,0,23,1746,1686,3455
2020,Uzbekistan,UZB,Israel,ISR,0,0,58,47,105
2020,Unknown ,,Israel,ISR,0,0,5,0,5
2020,Afghanistan,AFG,Rep. of Korea,KOR,0,0,0,12,12
2020,Algeria,DZA,Rep. of Korea,KOR,0,0,78,37,115
2020,Angola,AGO,Rep. of Korea,KOR,0,0,16,5,21
2020,Egypt,EGY,Rep. of Korea,KOR,10,0,334,179,523
2020,Argentina,ARG,Rep. of Korea,KOR,0,0,0,5,5
2020,Burundi,BDI,Rep. of Korea,KOR,11,0,0,0,11
2020,Benin,BEN,Rep. of Korea,KOR,0,0,0,5,5
2020,Bangladesh,BGD,Rep. of Korea,KOR,0,0,316,112,428
2020,Burkina Faso,BFA,Rep. of Korea,KOR,0,0,10,0,10
2020,Brazil,BRA,Rep. of Korea,KOR,0,0,0,5,5
2020,Cambodia,KHM,Rep. of Korea,KOR,0,0,24,27,51
2020,China,CHN,Rep. of Korea,KOR,0,0,564,653,1217
2020,Cameroon,CMR,Rep. of Korea,KOR,0,0,121,23,144
2020,Dem. Rep. of the Congo,COD,Rep. of Korea,KOR,0,0,14,0,14
2020,Colombia,COL,Rep. of Korea,KOR,0,0,0,5,5
2020,Ethiopia,ETH,Rep. of Korea,KOR,5,0,54,5,64
2020,Gambia,GMB,Rep. of Korea,KOR,0,0,43,0,43
2020,Ghana,GHA,Rep. of Korea,KOR,0,0,128,27,155
2020,Guinea-Bissau,GNB,Rep. of Korea,KOR,0,0,5,0,5
2020,Guinea,GIN,Rep. of Korea,KOR,0,0,59,11,70
2020,Haiti,HTI,Rep. of Korea,KOR,0,0,5,0,5
2020,Cote d'Ivoire,CIV,Rep. of Korea,KOR,0,0,18,0,18
2020,India,IND,Rep. of Korea,KOR,0,0,430,257,687
2020,Indonesia,IDN,Rep. of Korea,KOR,0,0,10,16,26
2020,Iran (Islamic Rep. of),IRN,Rep. of Korea,KOR,0,0,14,5,19
2020,Iraq,IRQ,Rep. of Korea,KOR,0,0,12,5,17
2020,Jordan,JOR,Rep. of Korea,KOR,0,0,13,0,13
2020,Kazakhstan,KAZ,Rep. of Korea,KOR,0,0,883,1183,2066
2020,Kenya,KEN,Rep. of Korea,KOR,0,0,21,5,26
2020,Kyrgyzstan,KGZ,Rep. of Korea,KOR,0,0,58,37,95
2020,Liberia,LBR,Rep. of Korea,KOR,0,0,133,22,155
2020,Libya,LBY,Rep. of Korea,KOR,0,5,0,5,10
2020,Sri Lanka,LKA,Rep. of Korea,KOR,0,0,150,55,205
2020,Mali,MLI,Rep. of Korea,KOR,0,0,25,0,25
2020,Malaysia,MYS,Rep. of Korea,KOR,0,0,208,629,837
2020,Mongolia,MNG,Rep. of Korea,KOR,0,0,136,110,246
2020,Morocco,MAR,Rep. of Korea,KOR,0,0,195,119,314
2020,Mozambique,MOZ,Rep. of Korea,KOR,0,0,5,0,5
2020,Myanmar,MMR,Rep. of Korea,KOR,0,0,5,5,10
2020,Nepal,NPL,Rep. of Korea,KOR,0,0,144,72,216
2020,Nigeria,NGA,Rep. of Korea,KOR,0,0,280,43,323
2020,Pakistan,PAK,Rep. of Korea,KOR,10,0,429,213,652
2020,Philippines,PHL,Rep. of Korea,KOR,0,0,67,109,176
2020,South Africa,ZAF,Rep. of Korea,KOR,0,0,44,18,62
2020,Russian Federation,RUS,Rep. of Korea,KOR,0,0,931,1333,2264
2020,Rwanda,RWA,Rep. of Korea,KOR,0,0,5,5,10
2020,Senegal,SEN,Rep. of Korea,KOR,0,0,47,5,52
2020,Sierra Leone,SLE,Rep. of Korea,KOR,0,0,5,0,5
2020,Viet Nam,VNM,Rep. of Korea,KOR,0,0,63,154,217
2020,Sudan,SDN,Rep. of Korea,KOR,11,0,0,10,21
2020,Syrian Arab Rep.,SYR,Rep. of Korea,KOR,0,35,5,5,45
2020,United Rep. of Tanzania,TZA,Rep. of Korea,KOR,0,0,14,5,19
2020,Thailand,THA,Rep. of Korea,KOR,0,0,96,105,201
2020,Tajikistan,TJK,Rep. of Korea,KOR,0,0,0,13,13
2020,Togo,TGO,Rep. of Korea,KOR,0,0,5,0,5
2020,Tunisia,TUN,Rep. of Korea,KOR,0,0,35,17,52
2020,Turkey,TUR,Rep. of Korea,KOR,0,0,119,108,227
2020,Uganda,UGA,Rep. of Korea,KOR,0,0,28,10,38
2020,Ukraine,UKR,Rep. of Korea,KOR,0,0,19,26,45
2020,United States of America,USA,Rep. of Korea,KOR,0,0,5,0,5
2020,Uzbekistan,UZB,Rep. of Korea,KOR,0,0,91,97,188
2020,Venezuela (Bolivarian Republic of),VEN,Rep. of Korea,KOR,0,0,0,12,12
2020,Yemen,YEM,Rep. of Korea,KOR,5,112,5,5,127
2020,Zimbabwe,ZWE,Rep. of Korea,KOR,0,0,5,0,5
2020,Afghanistan,AFG,North Macedonia,MKD,0,5,5,46,56
2020,Iraq,IRQ,North Macedonia,MKD,0,0,0,12,12
2020,Morocco,MAR,North Macedonia,MKD,0,0,5,22,27
2020,Pakistan,PAK,North Macedonia,MKD,0,0,5,35,40
2020,Syrian Arab Rep.,SYR,North Macedonia,MKD,0,0,5,28,33
2020,Turkey,TUR,North Macedonia,MKD,0,0,12,10,22
2020,Afghanistan,AFG,Montenegro,MNE,0,0,0,69,69
2020,Algeria,DZA,Montenegro,MNE,0,0,0,141,141
2020,Egypt,EGY,Montenegro,MNE,0,0,0,5,5
2020,Cuba,CUB,Montenegro,MNE,0,0,0,5,5
2020,Palestinian,PSE,Montenegro,MNE,0,0,0,10,10
2020,Iran (Islamic Rep. of),IRN,Montenegro,MNE,10,0,0,26,36
2020,Iraq,IRQ,Montenegro,MNE,0,0,0,5,5
2020,Libya,LBY,Montenegro,MNE,0,0,0,10,10
2020,Morocco,MAR,Montenegro,MNE,0,0,0,481,481
2020,Pakistan,PAK,Montenegro,MNE,0,0,0,23,23
2020,Russian Federation,RUS,Montenegro,MNE,0,0,0,10,10
2020,Serbia and Kosovo: S/RES/1244 (1999),SRB,Montenegro,MNE,0,0,0,5,5
2020,Syrian Arab Rep.,SYR,Montenegro,MNE,0,0,0,15,15
2020,Turkey,TUR,Montenegro,MNE,0,0,0,5,5
2020,Afghanistan,AFG,Philippines,PHL,0,0,0,5,5
2020,Egypt,EGY,Philippines,PHL,0,0,0,5,5
2020,Cameroon,CMR,Philippines,PHL,5,0,5,0,10
2020,Dem. Rep. of the Congo,COD,Philippines,PHL,0,0,0,5,5
2020,Eritrea,ERI,Philippines,PHL,0,0,0,5,5
2020,Palestinian,PSE,Philippines,PHL,0,0,0,5,5
2020,Guatemala,GTM,Philippines,PHL,0,0,0,5,5
2020,Cote d'Ivoire,CIV,Philippines,PHL,0,0,5,5,10
2020,Iran (Islamic Rep. of),IRN,Philippines,PHL,0,0,0,5,5
2020,Iraq,IRQ,Philippines,PHL,0,0,0,5,5
2020,Malaysia,MYS,Philippines,PHL,5,0,0,0,5
2020,Pakistan,PAK,Philippines,PHL,5,0,0,0,5
2020,Saudi Arabia,SAU,Philippines,PHL,5,0,0,0,5
2020,Somalia,SOM,Philippines,PHL,0,0,0,5,5
2020,Viet Nam,VNM,Philippines,PHL,5,0,0,0,5
2020,Syrian Arab Rep.,SYR,Philippines,PHL,14,0,0,0,14
2020,Turkey,TUR,Philippines,PHL,5,0,0,0,5
2020,Unknown ,,Philippines,PHL,0,0,0,5,5
2020,Afghanistan,AFG,Senegal,SEN,0,0,0,5,5
2020,Afghanistan,AFG,Tajikistan,TJK,1935,0,145,0,2080
2000,Afghanistan,AFG,Albania,ALB,0,0,0,5,5
2000,Iraq,IRQ,Albania,ALB,5,0,5,30,40
2000,Russian Federation,RUS,Albania,ALB,0,0,0,5,5
2000,Serbia and Kosovo: S/RES/1244 (1999),SRB,Albania,ALB,5,5,0,0,10
2000,Turkey,TUR,Albania,ALB,5,0,0,31,36
2000,Afghanistan,AFG,Australia,AUS,1329,0,94,10,1433
2000,Albania,ALB,Australia,AUS,5,0,45,5,55
2000,Algeria,DZA,Australia,AUS,5,0,14,19,38
2000,Angola,AGO,Australia,AUS,0,0,5,0,5
2000,Egypt,EGY,Australia,AUS,5,0,78,5,88
2000,Argentina,ARG,Australia,AUS,0,0,5,0,5
2000,Armenia,ARM,Australia,AUS,0,0,10,0,10
2000,Bahrain,BHR,Australia,AUS,0,0,5,0,5
2000,Bangladesh,BGD,Australia,AUS,5,0,185,11,201
2000,Belarus,BLR,Australia,AUS,0,0,14,5,19
2000,Bolivia (Plurinational State of),BOL,Australia,AUS,0,0,10,0,10
2000,Brazil,BRA,Australia,AUS,0,0,12,0,12
2000,Bosnia and Herzegovina,BIH,Australia,AUS,0,0,10,0,10
2000,Bulgaria,BGR,Australia,AUS,0,0,28,0,28
2000,Cambodia,KHM,Australia,AUS,0,0,54,0,54
2000,Canada,CAN,Australia,AUS,0,0,5,0,5
2000,China,CHN,Australia,AUS,11,0,1246,54,1311
2000,Chile,CHL,Australia,AUS,0,0,31,5,36
2000,Cameroon,CMR,Australia,AUS,0,0,5,0,5
2000,Congo,COG,Australia,AUS,5,0,5,0,10
2000,Colombia,COL,Australia,AUS,31,0,93,5,129
2000,Cuba,CUB,Australia,AUS,0,0,5,0,5
2000,Cyprus,CYP,Australia,AUS,0,0,5,0,5
2000,Ecuador,ECU,Australia,AUS,0,0,21,0,21
2000,Eritrea,ERI,Australia,AUS,0,0,5,0,5
2000,Estonia,EST,Australia,AUS,0,0,5,5,10
2000,Ethiopia,ETH,Australia,AUS,21,0,11,0,32
2000,Fiji,FJI,Australia,AUS,0,0,576,37,613
2000,Finland,FIN,Australia,AUS,0,0,5,0,5
2000,Palestinian,PSE,Australia,AUS,15,0,46,5,66
2000,United Kingdom of Great Britain and Northern Ireland,GBR,Australia,AUS,0,0,16,0,16
2000,Georgia,GEO,Australia,AUS,0,0,12,0,12
2000,Germany,DEU,Australia,AUS,0,0,10,0,10
2000,Ghana,GHA,Australia,AUS,0,0,12,0,12
2000,Greece,GRC,Australia,AUS,0,0,0,5,5
2000,"China, Hong Kong SAR",HKG,Australia,AUS,0,0,10,0,10
2000,Croatia,HRV,Australia,AUS,0,0,10,0,10
2000,Hungary,HUN,Australia,AUS,0,0,5,0,5
2000,India,IND,Australia,AUS,5,0,757,29,791
2000,Indonesia,IDN,Australia,AUS,0,0,810,42,852
2000,Iran (Islamic Rep. of),IRN,Australia,AUS,148,0,336,18,502
2000,Iraq,IRQ,Australia,AUS,2008,0,218,13,2239
2000,Israel,ISR,Australia,AUS,0,0,14,0,14
2000,Italy,ITA,Australia,AUS,0,0,5,0,5
2000,Jordan,JOR,Australia,AUS,5,0,26,0,31
2000,Kazakhstan,KAZ,Australia,AUS,0,0,5,0,5
2000,Kenya,KEN,Australia,AUS,0,0,14,0,14
2000,Kyrgyzstan,KGZ,Australia,AUS,0,0,5,0,5
2000,Rep. of Korea,KOR,Australia,AUS,0,0,179,5,184
2000,Dem. People's Rep. of Korea,PRK,Australia,AUS,0,0,5,0,5
2000,Kuwait,KWT,Australia,AUS,10,0,0,0,10
2000,Lao People's Dem. Rep.,LAO,Australia,AUS,0,0,5,0,5
2000,Liberia,LBR,Australia,AUS,0,0,5,0,5
2000,Lebanon,LBN,Australia,AUS,5,0,149,5,159
2000,Sri Lanka,LKA,Australia,AUS,117,0,385,18,520
2000,Lithuania,LTU,Australia,AUS,0,0,5,0,5
2000,Latvia,LVA,Australia,AUS,0,0,12,0,12
2000,North Macedonia,MKD,Australia,AUS,10,0,45,5,60
2000,Rep. of Moldova,MDA,Australia,AUS,0,0,35,0,35
2000,Mexico,MEX,Australia,AUS,0,0,5,0,5
2000,Malaysia,MYS,Australia,AUS,0,0,258,5,263
2000,Mongolia,MNG,Australia,AUS,0,0,11,0,11
2000,Morocco,MAR,Australia,AUS,0,0,11,0,11
2000,Mauritius,MUS,Australia,AUS,0,0,5,0,5
2000,Myanmar,MMR,Australia,AUS,28,0,71,10,109
2000,Nepal,NPL,Australia,AUS,0,0,93,5,98
2000,Nigeria,NGA,Australia,AUS,0,0,78,5,83
2000,Pakistan,PAK,Australia,AUS,18,0,171,15,204
2000,Peru,PER,Australia,AUS,0,0,39,0,39
2000,Philippines,PHL,Australia,AUS,0,0,722,28,750
2000,Papua New Guinea,PNG,Australia,AUS,0,0,5,0,5
2000,Poland,POL,Australia,AUS,0,0,10,0,10
2000,Portugal,PRT,Australia,AUS,0,0,5,0,5
2000,Romania,ROU,Australia,AUS,0,0,24,0,24
2000,South Africa,ZAF,Australia,AUS,0,0,36,0,36
2000,Russian Federation,RUS,Australia,AUS,38,0,110,12,160
2000,Rwanda,RWA,Australia,AUS,0,0,5,0,5
2000,El Salvador,SLV,Australia,AUS,0,0,14,0,14
2000,Serbia and Kosovo: S/RES/1244 (1999),SRB,Australia,AUS,93,0,111,5,209
2000,Singapore,SGP,Australia,AUS,0,0,5,0,5
2000,Sierra Leone,SLE,Australia,AUS,0,0,11,5,16
2000,Somalia,SOM,Australia,AUS,11,0,16,0,27
2000,Viet Nam,VNM,Australia,AUS,0,0,126,5,131
2000,Sudan,SDN,Australia,AUS,0,0,10,0,10
2000,Slovenia,SVN,Australia,AUS,0,0,5,0,5
2000,Syrian Arab Rep.,SYR,Australia,AUS,10,0,30,5,45
2000,United Rep. of Tanzania,TZA,Australia,AUS,0,0,5,0,5
2000,Thailand,THA,Australia,AUS,0,0,153,0,153
2000,Tonga,TON,Australia,AUS,0,0,24,0,24
2000,Tunisia,TUN,Australia,AUS,0,0,5,0,5
2000,Turkey,TUR,Australia,AUS,38,0,99,5,142
2000,Uganda,UGA,Australia,AUS,0,0,5,0,5
2000,Ukraine,UKR,Australia,AUS,0,0,164,0,164
2000,Uruguay,URY,Australia,AUS,0,0,5,0,5
2000,United States of America,USA,Australia,AUS,0,0,10,0,10
2000,Uzbekistan,UZB,Australia,AUS,0,0,5,0,5
2000,Vanuatu,VUT,Australia,AUS,0,0,5,0,5
2000,Samoa,WSM,Australia,AUS,0,0,5,0,5
2000,Yemen,YEM,Australia,AUS,0,0,5,0,5
2000,Zimbabwe,ZWE,Australia,AUS,0,0,13,5,18
2000,Stateless,XXA,Australia,AUS,44,0,34,5,83
2000,Unknown ,,Australia,AUS,14,0,102,15,131
2000,Colombia,COL,Costa Rica,CRI,439,0,40,38,517
2000,Cuba,CUB,Costa Rica,CRI,66,0,5,0,71
2000,Peru,PER,Costa Rica,CRI,5,0,5,0,10
2000,Unknown ,,Costa Rica,CRI,20,0,10,0,30
2000,Afghanistan,AFG,Czechia,CZE,14,0,100,1147,1261
2000,Algeria,DZA,Czechia,CZE,0,0,26,34,60
2000,Angola,AGO,Czechia,CZE,0,0,5,5,10
2000,Armenia,ARM,Czechia,CZE,0,0,59,57,116
2000,Azerbaijan,AZE,Czechia,CZE,5,0,0,10,15
2000,Bangladesh,BGD,Czechia,CZE,0,0,13,36,49
2000,Belarus,BLR,Czechia,CZE,24,0,16,27,67
2000,Bosnia and Herzegovina,BIH,Czechia,CZE,0,0,5,0,5
2000,Bulgaria,BGR,Czechia,CZE,0,0,60,21,81
2000,China,CHN,Czechia,CZE,0,0,10,206,216
2000,Dem. Rep. of the Congo,COD,Czechia,CZE,0,0,5,5,10
2000,Cuba,CUB,Czechia,CZE,0,0,5,0,5
2000,Palestinian,PSE,Czechia,CZE,0,0,0,5,5
2000,Georgia,GEO,Czechia,CZE,0,0,5,13,18
2000,Ghana,GHA,Czechia,CZE,0,0,5,0,5
2000,India,IND,Czechia,CZE,0,0,5,423,428
2000,Iran (Islamic Rep. of),IRN,Czechia,CZE,0,0,0,66,66
2000,Iraq,IRQ,Czechia,CZE,5,0,0,85,90
2000,Jordan,JOR,Czechia,CZE,0,0,5,0,5
2000,Kazakhstan,KAZ,Czechia,CZE,0,0,13,23,36
2000,Kyrgyzstan,KGZ,Czechia,CZE,0,0,5,11,16
2000,Lebanon,LBN,Czechia,CZE,0,0,0,10,10
2000,Sri Lanka,LKA,Czechia,CZE,5,0,12,347,364
2000,Lithuania,LTU,Czechia,CZE,0,0,5,0,5
2000,North Macedonia,MKD,Czechia,CZE,0,0,12,24,36
2000,Rep. of Moldova,MDA,Czechia,CZE,0,0,95,192,287
2000,Mongolia,MNG,Czechia,CZE,0,0,5,0,5
2000,Morocco,MAR,Czechia,CZE,0,0,5,0,5
2000,Nigeria,NGA,Czechia,CZE,0,0,10,5,15
2000,Pakistan,PAK,Czechia,CZE,0,0,18,67,85
2000,Poland,POL,Czechia,CZE,0,0,0,5,5
2000,Romania,ROU,Czechia,CZE,0,0,90,120,210
2000,Russian Federation,RUS,Czechia,CZE,5,0,110,218,333
2000,Serbia and Kosovo: S/RES/1244 (1999),SRB,Czechia,CZE,5,0,50,86,141
2000,Sierra Leone,SLE,Czechia,CZE,0,0,0,5,5
2000,Somalia,SOM,Czechia,CZE,0,0,0,5,5
2000,Viet Nam,VNM,Czechia,CZE,0,0,140,159,299
2000,Sudan,SDN,Czechia,CZE,0,0,5,18,23
2000,Slovakia,SVK,Czechia,CZE,0,0,573,115,688
2000,Syrian Arab Rep.,SYR,Czechia,CZE,0,0,0,25,25
2000,Turkmenistan,TKM,Czechia,CZE,5,0,0,0,5
2000,Tunisia,TUN,Czechia,CZE,0,0,0,5,5
2000,Turkey,TUR,Czechia,CZE,0,0,0,75,75
2000,Ukraine,UKR,Czechia,CZE,5,0,224,122,351
2000,Uzbekistan,UZB,Czechia,CZE,0,0,5,5,10
2000,Stateless,XXA,Czechia,CZE,5,0,5,15,25
2000,Unknown ,,Czechia,CZE,0,0,11,24,35
2000,Afghanistan,AFG,United Kingdom of Great Britain and Northern Ireland,GBR,375,695,460,1055,2585
2000,Albania,ALB,United Kingdom of Great Britain and Northern Ireland,GBR,25,35,1480,395,1935
2000,Algeria,DZA,United Kingdom of Great Britain and Northern Ireland,GBR,65,45,760,570,1440
2000,Angola,AGO,United Kingdom of Great Britain and Northern Ireland,GBR,70,200,205,220,695
2000,Bangladesh,BGD,United Kingdom of Great Britain and Northern Ireland,GBR,20,35,560,310,925
2000,China,CHN,United Kingdom of Great Britain and Northern Ireland,GBR,40,130,3665,1815,5650
2000,Dem. Rep. of the Congo,COD,United Kingdom of Great Britain and Northern Ireland,GBR,145,180,610,380,1315
2000,Colombia,COL,United Kingdom of Great Britain and Northern Ireland,GBR,60,60,1600,175,1895
2000,Czechia,CZE,United Kingdom of Great Britain and Northern Ireland,GBR,10,10,1565,210,1795
2000,Ecuador,ECU,United Kingdom of Great Britain and Northern Ireland,GBR,25,20,490,165,700
2000,Ethiopia,ETH,United Kingdom of Great Britain and Northern Ireland,GBR,40,80,220,135,475
2000,Gambia,GMB,United Kingdom of Great Britain and Northern Ireland,GBR,5,10,15,15,45
2000,Ghana,GHA,United Kingdom of Great Britain and Northern Ireland,GBR,40,35,155,70,300
2000,Cote d'Ivoire,CIV,United Kingdom of Great Britain and Northern Ireland,GBR,15,15,90,175,295
2000,India,IND,United Kingdom of Great Britain and Northern Ireland,GBR,40,45,1185,945,2215
2000,Iran (Islamic Rep. of),IRN,United Kingdom of Great Britain and Northern Ireland,GBR,390,255,1595,1220,3460
2000,Iraq,IRQ,United Kingdom of Great Britain and Northern Ireland,GBR,845,2455,825,1390,5515
2000,Kenya,KEN,United Kingdom of Great Britain and Northern Ireland,GBR,50,90,535,250,925
2000,Sri Lanka,LKA,United Kingdom of Great Britain and Northern Ireland,GBR,900,285,5115,1760,8060
2000,Nigeria,NGA,United Kingdom of Great Britain and Northern Ireland,GBR,20,90,415,355,880
2000,Pakistan,PAK,United Kingdom of Great Britain and Northern Ireland,GBR,125,120,2445,1275,3965
2000,Poland,POL,United Kingdom of Great Britain and Northern Ireland,GBR,20,20,1445,320,1805
2000,Romania,ROU,United Kingdom of Great Britain and Northern Ireland,GBR,15,20,1590,1100,2725
2000,Russian Federation,RUS,United Kingdom of Great Britain and Northern Ireland,GBR,25,45,530,370,970
2000,Rwanda,RWA,United Kingdom of Great Britain and Northern Ireland,GBR,85,165,150,290,690
2000,Serbia and Kosovo: S/RES/1244 (1999),SRB,United Kingdom of Great Britain and Northern Ireland,GBR,275,815,10860,2975,14925
2000,Sierra Leone,SLE,United Kingdom of Great Britain and Northern Ireland,GBR,95,575,145,330,1145
2000,Somalia,SOM,United Kingdom of Great Britain and Northern Ireland,GBR,5310,3575,695,1675,11255
2000,Sudan,SDN,United Kingdom of Great Britain and Northern Ireland,GBR,110,70,270,130,580
2000,United Rep. of Tanzania,TZA,United Kingdom of Great Britain and Northern Ireland,GBR,5,10,40,20,75
2000,Turkey,TUR,United Kingdom of Great Britain and Northern Ireland,GBR,180,135,1095,995,2405
2000,Uganda,UGA,United Kingdom of Great Britain and Northern Ireland,GBR,20,30,250,230,530
2000,Ukraine,UKR,United Kingdom of Great Britain and Northern Ireland,GBR,15,35,760,285,1095
2000,Zimbabwe,ZWE,United Kingdom of Great Britain and Northern Ireland,GBR,20,10,435,90,555
2000,Unknown ,,United Kingdom of Great Britain and Northern Ireland,GBR,895,1110,7895,3845,13745
2000,Algeria,DZA,Malta,MLT,5,0,0,0,5
2000,Palestinian,PSE,Malta,MLT,0,0,5,0,5
2000,Iraq,IRQ,Malta,MLT,5,0,10,0,15
2000,Libya,LBY,Malta,MLT,0,0,5,0,5
2000,Sri Lanka,LKA,Malta,MLT,5,0,0,0,5
2000,Morocco,MAR,Malta,MLT,5,0,0,0,5
2000,Pakistan,PAK,Malta,MLT,0,0,5,0,5
2000,Sierra Leone,SLE,Malta,MLT,0,0,5,0,5
2000,Somalia,SOM,Malta,MLT,5,0,0,0,5
2000,Sudan,SDN,Malta,MLT,0,0,5,0,5
2001,Bangladesh,BGD,Albania,ALB,5,0,0,0,5
2001,Iraq,IRQ,Albania,ALB,0,0,0,13,13
2001,North Macedonia,MKD,Albania,ALB,0,16,5,5,26
2001,Serbia and Kosovo: S/RES/1244 (1999),SRB,Albania,ALB,5,0,5,5,15
2001,Turkey,TUR,Albania,ALB,0,0,0,32,32
2001,Afghanistan,AFG,Australia,AUS,1666,0,429,5,2100
2001,Albania,ALB,Australia,AUS,0,0,35,5,40
2001,Algeria,DZA,Australia,AUS,0,0,17,5,22
2001,Angola,AGO,Australia,AUS,0,0,5,0,5
2001,Egypt,EGY,Australia,AUS,10,0,43,12,65
2001,Argentina,ARG,Australia,AUS,0,0,21,0,21
2001,Armenia,ARM,Australia,AUS,0,0,10,0,10
2001,Azerbaijan,AZE,Australia,AUS,0,0,5,0,5
2001,Burundi,BDI,Australia,AUS,5,0,5,0,10
2001,Bangladesh,BGD,Australia,AUS,0,0,219,18,237
2001,Belarus,BLR,Australia,AUS,5,0,11,0,16
2001,Bolivia (Plurinational State of),BOL,Australia,AUS,0,0,5,0,5
2001,Brazil,BRA,Australia,AUS,0,0,33,0,33
2001,Bosnia and Herzegovina,BIH,Australia,AUS,0,0,5,0,5
2001,Bulgaria,BGR,Australia,AUS,0,0,5,0,5
2001,Cambodia,KHM,Australia,AUS,0,0,14,0,14
2001,China,CHN,Australia,AUS,11,0,1001,56,1068
2001,Chile,CHL,Australia,AUS,0,0,41,5,46
2001,Cameroon,CMR,Australia,AUS,0,0,5,0,5
2001,Congo,COG,Australia,AUS,0,0,17,0,17
2001,Colombia,COL,Australia,AUS,23,0,93,5,121
2001,Cyprus,CYP,Australia,AUS,0,0,14,0,14
2001,Czechia,CZE,Australia,AUS,0,0,5,0,5
2001,Ecuador,ECU,Australia,AUS,0,0,30,0,30
2001,Eritrea,ERI,Australia,AUS,0,0,5,0,5
2001,Estonia,EST,Australia,AUS,0,0,5,0,5
2001,Ethiopia,ETH,Australia,AUS,5,0,10,0,15
2001,Fiji,FJI,Australia,AUS,0,0,768,25,793
2001,France,FRA,Australia,AUS,0,0,5,0,5
2001,Palestinian,PSE,Australia,AUS,39,0,119,0,158
2001,United Kingdom of Great Britain and Northern Ireland,GBR,Australia,AUS,0,0,11,0,11
2001,Georgia,GEO,Australia,AUS,5,0,10,0,15
2001,Ghana,GHA,Australia,AUS,0,0,37,5,42
2001,Greece,GRC,Australia,AUS,0,0,0,5,5
2001,Guinea,GIN,Australia,AUS,0,0,5,0,5
2001,"China, Hong Kong SAR",HKG,Australia,AUS,0,0,5,0,5
2001,Croatia,HRV,Australia,AUS,0,0,5,0,5
2001,India,IND,Australia,AUS,0,0,476,39,515
2001,Indonesia,IDN,Australia,AUS,5,0,763,33,801
2001,Iran (Islamic Rep. of),IRN,Australia,AUS,190,0,439,22,651
2001,Iraq,IRQ,Australia,AUS,1081,0,230,16,1327
2001,Israel,ISR,Australia,AUS,0,0,22,5,27
2001,Italy,ITA,Australia,AUS,0,0,11,5,16
2001,Jordan,JOR,Australia,AUS,5,0,31,0,36
2001,Kenya,KEN,Australia,AUS,0,0,5,0,5
2001,Kyrgyzstan,KGZ,Australia,AUS,0,0,16,0,16
2001,Rep. of Korea,KOR,Australia,AUS,0,0,169,16,185
2001,Dem. People's Rep. of Korea,PRK,Australia,AUS,0,0,5,0,5
2001,Kuwait,KWT,Australia,AUS,5,0,0,0,5
2001,Lao People's Dem. Rep.,LAO,Australia,AUS,0,0,12,0,12
2001,Lebanon,LBN,Australia,AUS,10,0,125,5,140
2001,Sri Lanka,LKA,Australia,AUS,95,0,228,19,342
2001,Lithuania,LTU,Australia,AUS,0,0,20,0,20
2001,Latvia,LVA,Australia,AUS,0,0,10,0,10
2001,Mauritania,MRT,Australia,AUS,0,0,5,0,5
2001,North Macedonia,MKD,Australia,AUS,0,0,68,10,78
2001,Rep. of Moldova,MDA,Australia,AUS,0,0,21,0,21
2001,Malaysia,MYS,Australia,AUS,0,0,234,11,245
2001,Mongolia,MNG,Australia,AUS,0,0,55,0,55
2001,Morocco,MAR,Australia,AUS,0,0,5,0,5
2001,Myanmar,MMR,Australia,AUS,11,0,66,10,87
2001,Nepal,NPL,Australia,AUS,0,0,66,0,66
2001,Nigeria,NGA,Australia,AUS,5,0,80,5,90
2001,Pakistan,PAK,Australia,AUS,44,0,90,10,144
2001,Peru,PER,Australia,AUS,0,0,81,0,81
2001,Philippines,PHL,Australia,AUS,0,0,202,5,207
2001,Papua New Guinea,PNG,Australia,AUS,0,0,13,0,13
2001,Poland,POL,Australia,AUS,0,0,11,0,11
2001,Romania,ROU,Australia,AUS,0,0,24,0,24
2001,South Africa,ZAF,Australia,AUS,0,0,38,0,38
2001,Russian Federation,RUS,Australia,AUS,5,0,75,5,85
2001,Rwanda,RWA,Australia,AUS,0,0,5,0,5
2001,El Salvador,SLV,Australia,AUS,0,0,5,0,5
2001,Singapore,SGP,Australia,AUS,5,0,5,0,10
2001,Sierra Leone,SLE,Australia,AUS,0,0,10,0,10
2001,Solomon Islands,SLB,Australia,AUS,5,0,14,0,19
2001,Somalia,SOM,Australia,AUS,0,0,10,0,10
2001,Viet Nam,VNM,Australia,AUS,0,0,187,14,201
2001,Sudan,SDN,Australia,AUS,5,0,5,0,10
2001,Slovakia,SVK,Australia,AUS,0,0,5,0,5
2001,Syrian Arab Rep.,SYR,Australia,AUS,5,0,42,0,47
2001,United Rep. of Tanzania,TZA,Australia,AUS,0,0,5,0,5
2001,Thailand,THA,Australia,AUS,0,0,175,5,180
2001,Tonga,TON,Australia,AUS,0,0,59,12,71
2001,Tunisia,TUN,Australia,AUS,0,0,10,0,10
2001,Turkey,TUR,Australia,AUS,18,0,79,5,102
2001,Uganda,UGA,Australia,AUS,0,0,5,0,5
2001,Ukraine,UKR,Australia,AUS,0,0,108,5,113
2001,Uruguay,URY,Australia,AUS,0,0,18,0,18
2001,United States of America,USA,Australia,AUS,0,0,5,5,10
2001,Uzbekistan,UZB,Australia,AUS,0,0,14,0,14
2001,Venezuela (Bolivarian Republic of),VEN,Australia,AUS,0,0,5,0,5
2001,Samoa,WSM,Australia,AUS,0,0,5,0,5
2001,Yemen,YEM,Australia,AUS,0,0,5,0,5
2001,Zimbabwe,ZWE,Australia,AUS,5,0,32,5,42
2001,Stateless,XXA,Australia,AUS,25,0,25,0,50
2001,Unknown ,,Australia,AUS,49,0,102,5,156
2001,Dem. Rep. of the Congo,COD,Burundi,BDI,11,0,0,0,11
2001,Rwanda,RWA,Burundi,BDI,0,0,0,46,46
2001,United Rep. of Tanzania,TZA,Burundi,BDI,0,0,0,10,10
2001,Colombia,COL,Costa Rica,CRI,2126,0,1545,277,3948
2001,Cuba,CUB,Costa Rica,CRI,70,0,12,0,82
2001,Guatemala,GTM,Costa Rica,CRI,5,0,0,0,5
2001,Peru,PER,Costa Rica,CRI,13,0,11,0,24
2001,Unknown ,,Costa Rica,CRI,5,0,19,10,34
2001,Afghanistan,AFG,Czechia,CZE,10,0,50,536,596
2001,Algeria,DZA,Czechia,CZE,0,0,44,72,116
2001,Angola,AGO,Czechia,CZE,0,0,5,0,5
2001,Armenia,ARM,Czechia,CZE,0,0,193,391,584
2001,Azerbaijan,AZE,Czechia,CZE,0,0,5,34,39
2001,Belarus,BLR,Czechia,CZE,23,0,108,121,252
2001,Bosnia and Herzegovina,BIH,Czechia,CZE,0,0,5,0,5
2001,Bulgaria,BGR,Czechia,CZE,0,0,171,77,248
2001,China,CHN,Czechia,CZE,0,0,5,5,10
2001,Georgia,GEO,Czechia,CZE,5,0,138,481,624
2001,Ghana,GHA,Czechia,CZE,0,0,0,10,10
2001,Guinea,GIN,Czechia,CZE,0,0,0,5,5
2001,Cote d'Ivoire,CIV,Czechia,CZE,0,0,5,5,10
2001,India,IND,Czechia,CZE,0,0,5,1397,1402
2001,Iran (Islamic Rep. of),IRN,Czechia,CZE,10,0,5,10,25
2001,Iraq,IRQ,Czechia,CZE,5,0,0,269,274
2001,Kazakhstan,KAZ,Czechia,CZE,0,0,48,0,48
2001,Kyrgyzstan,KGZ,Czechia,CZE,0,0,5,10,15
2001,Sri Lanka,LKA,Czechia,CZE,0,0,10,170,180
2001,Lithuania,LTU,Czechia,CZE,0,0,5,10,15
2001,North Macedonia,MKD,Czechia,CZE,0,0,50,0,50
2001,Rep. of Moldova,MDA,Czechia,CZE,0,0,758,669,1427
2001,Mongolia,MNG,Czechia,CZE,0,0,106,0,106
2001,Nigeria,NGA,Czechia,CZE,0,0,11,16,27
2001,Pakistan,PAK,Czechia,CZE,0,0,10,90,100
2001,Romania,ROU,Czechia,CZE,0,0,514,1174,1688
2001,Russian Federation,RUS,Czechia,CZE,5,0,205,256,466
2001,Serbia and Kosovo: S/RES/1244 (1999),SRB,Czechia,CZE,10,0,82,15,107
2001,Viet Nam,VNM,Czechia,CZE,0,0,691,209,900
2001,Slovakia,SVK,Czechia,CZE,0,0,290,56,346
2001,Syrian Arab Rep.,SYR,Czechia,CZE,0,0,0,22,22
2001,Turkey,TUR,Czechia,CZE,0,0,0,64,64
2001,Ukraine,UKR,Czechia,CZE,5,0,2441,87,2533
2001,Uzbekistan,UZB,Czechia,CZE,0,0,10,0,10
2001,Stateless,XXA,Czechia,CZE,0,0,14,15,29
2001,Unknown ,,Czechia,CZE,5,0,43,457,505
2001,Afghanistan,AFG,United Kingdom of Great Britain and Northern Ireland,GBR,2260,7370,1070,1460,12160
2001,Albania,ALB,United Kingdom of Great Britain and Northern Ireland,GBR,30,160,1120,400,1710
2001,Algeria,DZA,United Kingdom of Great Britain and Northern Ireland,GBR,60,75,1925,600,2660
2001,Angola,AGO,United Kingdom of Great Britain and Northern Ireland,GBR,100,495,475,185,1255
2001,Burundi,BDI,United Kingdom of Great Britain and Northern Ireland,GBR,225,250,380,245,1100
2001,Bangladesh,BGD,United Kingdom of Great Britain and Northern Ireland,GBR,10,40,645,260,955
2001,China,CHN,United Kingdom of Great Britain and Northern Ireland,GBR,15,160,2890,1220,4285
2001,Dem. Rep. of the Congo,COD,United Kingdom of Great Britain and Northern Ireland,GBR,310,330,1530,260,2430
2001,Colombia,COL,United Kingdom of Great Britain and Northern Ireland,GBR,40,55,550,105,750
2001,Czechia,CZE,United Kingdom of Great Britain and Northern Ireland,GBR,0,5,800,90,895
2001,Ecuador,ECU,United Kingdom of Great Britain and Northern Ireland,GBR,10,10,390,100,510
2001,Eritrea,ERI,United Kingdom of Great Britain and Northern Ireland,GBR,120,235,840,100,1295
2001,Ethiopia,ETH,United Kingdom of Great Britain and Northern Ireland,GBR,85,235,750,85,1155
2001,Gambia,GMB,United Kingdom of Great Britain and Northern Ireland,GBR,5,20,50,15,90
2001,Ghana,GHA,United Kingdom of Great Britain and Northern Ireland,GBR,45,45,215,105,410
2001,Cote d'Ivoire,CIV,United Kingdom of Great Britain and Northern Ireland,GBR,15,20,365,80,480
2001,India,IND,United Kingdom of Great Britain and Northern Ireland,GBR,15,45,1590,1255,2905
2001,Iran (Islamic Rep. of),IRN,United Kingdom of Great Britain and Northern Ireland,GBR,555,295,4015,955,5820
2001,Iraq,IRQ,United Kingdom of Great Britain and Northern Ireland,GBR,815,1855,4680,1530,8880
2001,Jamaica,JAM,United Kingdom of Great Britain and Northern Ireland,GBR,5,15,315,145,480
2001,Kenya,KEN,United Kingdom of Great Britain and Northern Ireland,GBR,20,70,625,180,895
2001,Sri Lanka,LKA,United Kingdom of Great Britain and Northern Ireland,GBR,1415,525,7245,980,10165
2001,North Macedonia,MKD,United Kingdom of Great Britain and Northern Ireland,GBR,5,140,340,140,625
2001,Nepal,NPL,United Kingdom of Great Britain and Northern Ireland,GBR,25,15,770,190,1000
2001,Nigeria,NGA,United Kingdom of Great Britain and Northern Ireland,GBR,25,130,745,355,1255
2001,Pakistan,PAK,United Kingdom of Great Britain and Northern Ireland,GBR,220,130,2685,1255,4290
2001,Poland,POL,United Kingdom of Great Britain and Northern Ireland,GBR,0,10,650,140,800
2001,Romania,ROU,United Kingdom of Great Britain and Northern Ireland,GBR,0,70,880,1200,2150
2001,Russian Federation,RUS,United Kingdom of Great Britain and Northern Ireland,GBR,75,145,2370,1110,3700
2001,Rwanda,RWA,United Kingdom of Great Britain and Northern Ireland,GBR,200,320,260,180,960
2001,Serbia and Kosovo: S/RES/1244 (1999),SRB,United Kingdom of Great Britain and Northern Ireland,GBR,365,2045,7325,2005,11740
2001,Sierra Leone,SLE,United Kingdom of Great Britain and Northern Ireland,GBR,165,1405,685,430,2685
2001,Somalia,SOM,United Kingdom of Great Britain and Northern Ireland,GBR,2845,1960,2145,1350,8300
2001,Sudan,SDN,United Kingdom of Great Britain and Northern Ireland,GBR,120,50,520,75,765
2001,United Rep. of Tanzania,TZA,United Kingdom of Great Britain and Northern Ireland,GBR,5,20,90,20,135
2001,Turkey,TUR,United Kingdom of Great Britain and Northern Ireland,GBR,195,275,6270,925,7665
2001,Uganda,UGA,United Kingdom of Great Britain and Northern Ireland,GBR,50,90,805,135,1080
2001,Ukraine,UKR,United Kingdom of Great Britain and Northern Ireland,GBR,10,25,825,290,1150
2001,Zimbabwe,ZWE,United Kingdom of Great Britain and Northern Ireland,GBR,115,45,1750,200,2110
2001,Unknown ,,United Kingdom of Great Britain and Northern Ireland,GBR,490,600,3925,1410,6425
2001,Afghanistan,AFG,Malta,MLT,5,0,0,0,5
2001,Algeria,DZA,Malta,MLT,0,0,5,0,5
2001,Egypt,EGY,Malta,MLT,5,0,0,0,5
2001,Palestinian,PSE,Malta,MLT,0,5,5,0,10
2001,India,IND,Malta,MLT,0,0,5,0,5
2001,Iraq,IRQ,Malta,MLT,5,0,5,0,10
2001,Libya,LBY,Malta,MLT,10,0,0,0,10
2001,Sri Lanka,LKA,Malta,MLT,5,0,0,0,5
2001,Morocco,MAR,Malta,MLT,0,5,0,0,5
2001,Sierra Leone,SLE,Malta,MLT,10,0,0,0,10
2001,Sudan,SDN,Malta,MLT,0,5,0,0,5
2001,Turkey,TUR,Malta,MLT,0,5,0,0,5
2002,North Macedonia,MKD,Albania,ALB,0,0,0,25,25
2002,Serbia and Kosovo: S/RES/1244 (1999),SRB,Albania,ALB,0,0,5,24,29
2002,Turkey,TUR,Albania,ALB,5,0,5,60,70
2002,Dem. Rep. of the Congo,COD,Burundi,BDI,12,0,0,0,12
2002,Afghanistan,AFG,Czechia,CZE,15,0,10,81,106
2002,Algeria,DZA,Czechia,CZE,0,0,25,54,79
2002,Armenia,ARM,Czechia,CZE,5,0,134,596,735
2002,Azerbaijan,AZE,Czechia,CZE,5,0,5,61,71
2002,Belarus,BLR,Czechia,CZE,26,0,105,203,334
2002,Bulgaria,BGR,Czechia,CZE,0,0,116,86,202
2002,China,CHN,Czechia,CZE,0,0,170,136,306
2002,Georgia,GEO,Czechia,CZE,0,0,73,991,1064
2002,Guinea,GIN,Czechia,CZE,0,0,0,10,10
2002,Cote d'Ivoire,CIV,Czechia,CZE,0,0,0,18,18
2002,India,IND,Czechia,CZE,0,0,182,232,414
2002,Iran (Islamic Rep. of),IRN,Czechia,CZE,0,0,0,5,5
2002,Iraq,IRQ,Czechia,CZE,10,0,27,209,246
2002,Kazakhstan,KAZ,Czechia,CZE,0,0,72,49,121
2002,Kyrgyzstan,KGZ,Czechia,CZE,0,0,39,17,56
2002,Sri Lanka,LKA,Czechia,CZE,0,0,5,14,19
2002,Lithuania,LTU,Czechia,CZE,0,0,11,10,21
2002,North Macedonia,MKD,Czechia,CZE,0,0,23,28,51
2002,Rep. of Moldova,MDA,Czechia,CZE,0,0,587,1087,1674
2002,Mongolia,MNG,Czechia,CZE,0,0,64,66,130
2002,Nigeria,NGA,Czechia,CZE,0,0,0,26,26
2002,Pakistan,PAK,Czechia,CZE,0,0,5,14,19
2002,Romania,ROU,Czechia,CZE,0,0,112,375,487
2002,Russian Federation,RUS,Czechia,CZE,28,0,128,466,622
2002,Serbia and Kosovo: S/RES/1244 (1999),SRB,Czechia,CZE,0,0,42,43,85
2002,Senegal,SEN,Czechia,CZE,0,0,0,5,5
2002,Somalia,SOM,Czechia,CZE,0,0,0,5,5
2002,Viet Nam,VNM,Czechia,CZE,0,0,731,542,1273
2002,Slovakia,SVK,Czechia,CZE,0,0,633,93,726
2002,Syrian Arab Rep.,SYR,Czechia,CZE,5,0,0,17,22
2002,Turkey,TUR,Czechia,CZE,0,0,0,36,36
2002,Ukraine,UKR,Czechia,CZE,0,0,1749,1390,3139
2002,Uzbekistan,UZB,Czechia,CZE,0,0,15,22,37
2002,Stateless,XXA,Czechia,CZE,0,0,52,54,106
2002,Unknown ,,Czechia,CZE,5,0,32,42,79
2002,Afghanistan,AFG,United Kingdom of Great Britain and Northern Ireland,GBR,115,4765,2360,935,8175
2002,Albania,ALB,United Kingdom of Great Britain and Northern Ireland,GBR,20,285,695,255,1255
2002,Algeria,DZA,United Kingdom of Great Britain and Northern Ireland,GBR,20,35,770,305,1130
2002,Angola,AGO,United Kingdom of Great Britain and Northern Ireland,GBR,65,700,420,155,1340
2002,Burundi,BDI,United Kingdom of Great Britain and Northern Ireland,GBR,115,230,270,75,690
2002,Bangladesh,BGD,United Kingdom of Great Britain and Northern Ireland,GBR,5,170,335,110,620
2002,China,CHN,United Kingdom of Great Britain and Northern Ireland,GBR,15,240,1850,1510,3615
2002,Cameroon,CMR,United Kingdom of Great Britain and Northern Ireland,GBR,40,45,395,45,525
2002,Congo,COG,United Kingdom of Great Britain and Northern Ireland,GBR,35,60,420,60,575
2002,Dem. Rep. of the Congo,COD,United Kingdom of Great Britain and Northern Ireland,GBR,155,305,1390,200,2050
2002,Colombia,COL,United Kingdom of Great Britain and Northern Ireland,GBR,45,20,345,70,480
2002,Czechia,CZE,United Kingdom of Great Britain and Northern Ireland,GBR,0,10,1060,160,1230
2002,Ecuador,ECU,United Kingdom of Great Britain and Northern Ireland,GBR,20,10,240,50,320
2002,Eritrea,ERI,United Kingdom of Great Britain and Northern Ireland,GBR,140,210,675,80,1105
2002,Ethiopia,ETH,United Kingdom of Great Britain and Northern Ireland,GBR,50,170,420,65,705
2002,Gambia,GMB,United Kingdom of Great Britain and Northern Ireland,GBR,0,5,55,55,115
2002,Ghana,GHA,United Kingdom of Great Britain and Northern Ireland,GBR,15,10,165,65,255
2002,Cote d'Ivoire,CIV,United Kingdom of Great Britain and Northern Ireland,GBR,10,15,170,30,225
2002,India,IND,United Kingdom of Great Britain and Northern Ireland,GBR,5,35,1125,690,1855
2002,Iran (Islamic Rep. of),IRN,United Kingdom of Great Britain and Northern Ireland,GBR,395,145,2140,280,2960
2002,Iraq,IRQ,United Kingdom of Great Britain and Northern Ireland,GBR,715,8195,1770,1230,11910
2002,Jamaica,JAM,United Kingdom of Great Britain and Northern Ireland,GBR,10,15,600,290,915
2002,Kenya,KEN,United Kingdom of Great Britain and Northern Ireland,GBR,15,45,260,40,360
2002,Sri Lanka,LKA,United Kingdom of Great Britain and Northern Ireland,GBR,340,275,3265,405,4285
2002,North Macedonia,MKD,United Kingdom of Great Britain and Northern Ireland,GBR,5,140,220,75,440
2002,Rep. of Moldova,MDA,United Kingdom of Great Britain and Northern Ireland,GBR,5,110,290,305,710
2002,Nigeria,NGA,United Kingdom of Great Britain and Northern Ireland,GBR,25,75,675,335,1110
2002,Pakistan,PAK,United Kingdom of Great Britain and Northern Ireland,GBR,135,75,1660,645,2515
2002,Poland,POL,United Kingdom of Great Britain and Northern Ireland,GBR,0,0,760,145,905
2002,Romania,ROU,United Kingdom of Great Britain and Northern Ireland,GBR,5,70,540,555,1170
2002,Russian Federation,RUS,United Kingdom of Great Britain and Northern Ireland,GBR,15,20,250,75,360
2002,Rwanda,RWA,United Kingdom of Great Britain and Northern Ireland,GBR,125,245,245,70,685
2002,Serbia and Kosovo: S/RES/1244 (1999),SRB,United Kingdom of Great Britain and Northern Ireland,GBR,225,825,1940,505,3495
2002,Sierra Leone,SLE,United Kingdom of Great Britain and Northern Ireland,GBR,55,185,895,365,1500
2002,Somalia,SOM,United Kingdom of Great Britain and Northern Ireland,GBR,2515,1405,2260,560,6740
2002,Viet Nam,VNM,United Kingdom of Great Britain and Northern Ireland,GBR,25,135,440,120,720
2002,Sudan,SDN,United Kingdom of Great Britain and Northern Ireland,GBR,70,40,405,50,565
2002,United Rep. of Tanzania,TZA,United Kingdom of Great Britain and Northern Ireland,GBR,5,5,30,5,45
2002,Turkey,TUR,United Kingdom of Great Britain and Northern Ireland,GBR,150,200,2805,340,3495
2002,Uganda,UGA,United Kingdom of Great Britain and Northern Ireland,GBR,35,120,445,65,665
2002,Ukraine,UKR,United Kingdom of Great Britain and Northern Ireland,GBR,0,10,255,45,310
2002,Zimbabwe,ZWE,United Kingdom of Great Britain and Northern Ireland,GBR,2240,110,2960,925,6235
2002,Unknown ,,United Kingdom of Great Britain and Northern Ireland,GBR,295,370,3430,1080,5175
2002,Afghanistan,AFG,Malta,MLT,0,0,0,5,5
2002,Algeria,DZA,Malta,MLT,0,0,5,0,5
2002,Bangladesh,BGD,Malta,MLT,0,0,13,0,13
2002,Chad,TCD,Malta,MLT,0,0,5,0,5
2002,Cameroon,CMR,Malta,MLT,0,0,5,0,5
2002,Dem. Rep. of the Congo,COD,Malta,MLT,5,0,5,0,10
2002,Eritrea,ERI,Malta,MLT,0,5,92,0,97
2002,Ethiopia,ETH,Malta,MLT,0,5,0,0,5
2002,Palestinian,PSE,Malta,MLT,0,0,5,0,5
2002,Ghana,GHA,Malta,MLT,0,0,5,0,5
2002,Iraq,IRQ,Malta,MLT,10,23,5,0,38
2002,Liberia,LBR,Malta,MLT,0,5,10,0,15
2002,Libya,LBY,Malta,MLT,0,0,5,0,5
2002,Mauritania,MRT,Malta,MLT,0,0,5,0,5
2002,Pakistan,PAK,Malta,MLT,0,0,5,0,5
2002,Sierra Leone,SLE,Malta,MLT,0,0,10,0,10
2002,Somalia,SOM,Malta,MLT,0,53,0,0,53
2002,Sudan,SDN,Malta,MLT,0,0,28,0,28
2002,Syrian Arab Rep.,SYR,Malta,MLT,0,5,0,0,5
2002,Turkey,TUR,Malta,MLT,0,5,10,0,15
2003,Ethiopia,ETH,Djibouti,DJI,16,0,200,0,216
2003,Somalia,SOM,Djibouti,DJI,1648,0,0,0,1648
2003,Dem. Rep. of the Congo,COD,Sudan,SDN,18,0,10,0,28
2003,Eritrea,ERI,Sudan,SDN,488,0,742,0,1230
2003,Ethiopia,ETH,Sudan,SDN,398,0,696,0,1094
2003,Somalia,SOM,Sudan,SDN,5,0,13,0,18
2003,Angola,AGO,Zambia,ZMB,0,0,0,73,73
2003,Burundi,BDI,Zambia,ZMB,23,0,16,182,221
2003,Dem. Rep. of the Congo,COD,Zambia,ZMB,55,0,35,264,354
2003,Rwanda,RWA,Zambia,ZMB,5,0,11,343,359
2003,Somalia,SOM,Zambia,ZMB,12,0,5,49,66
2003,Unknown ,,Zambia,ZMB,5,0,5,10,20
2004,Eritrea,ERI,Djibouti,DJI,5,0,54,5,64
2004,Ethiopia,ETH,Djibouti,DJI,72,0,1181,0,1253
2004,Somalia,SOM,Djibouti,DJI,0,0,329,0,329
2004,Sudan,SDN,Djibouti,DJI,0,0,5,0,5
2004,Burundi,BDI,Zambia,ZMB,15,0,10,30,55
2004,Dem. Rep. of the Congo,COD,Zambia,ZMB,39,0,43,172,254
2004,Rwanda,RWA,Zambia,ZMB,5,0,0,40,45
2004,Somalia,SOM,Zambia,ZMB,17,0,31,32,80
2004,Unknown ,,Zambia,ZMB,0,0,5,19,24
2005,Central African Rep.,CAF,Gabon,GAB,0,0,5,0,5
2005,Chad,TCD,Gabon,GAB,0,0,15,13,28
2005,Congo,COG,Gabon,GAB,0,0,19,28,47
2005,Dem. Rep. of the Congo,COD,Gabon,GAB,0,0,50,34,84
2005,Equatorial Guinea,GNQ,Gabon,GAB,0,0,5,0,5
2005,Cote d'Ivoire,CIV,Gabon,GAB,0,0,14,5,19
2005,Mauritania,MRT,Gabon,GAB,0,0,5,0,5
2005,Sudan,SDN,Gabon,GAB,0,0,5,0,5
2005,Togo,TGO,Gabon,GAB,0,0,10,0,10
2006,Cote d'Ivoire,CIV,Liberia,LBR,0,0,0,10,10
2006,Sierra Leone,SLE,Liberia,LBR,0,0,0,10,10
2006,Togo,TGO,Liberia,LBR,0,0,0,5,5
2008,Colombia,COL,Argentina,ARG,68,0,30,5,103
2008,Cuba,CUB,Argentina,ARG,10,0,18,0,28
2008,Dominican Rep.,DOM,Argentina,ARG,0,0,0,5,5
2008,Ghana,GHA,Argentina,ARG,5,0,5,0,10
2008,Guinea-Bissau,GNB,Argentina,ARG,0,0,5,0,5
2008,Haiti,HTI,Argentina,ARG,10,0,5,5,20
2008,India,IND,Argentina,ARG,0,0,5,0,5
2008,Peru,PER,Argentina,ARG,0,0,10,5,15
2008,Serbia and Kosovo: S/RES/1244 (1999),SRB,Argentina,ARG,0,0,5,0,5
2008,Senegal,SEN,Argentina,ARG,0,0,348,0,348
2008,Ukraine,UKR,Argentina,ARG,5,0,0,0,5
2008,Unknown ,,Argentina,ARG,0,0,0,109,109
2010,Afghanistan,AFG,Bulgaria,BGR,5,5,15,20,45
2010,Algeria,DZA,Bulgaria,BGR,0,0,13,40,53
2010,Egypt,EGY,Bulgaria,BGR,0,0,5,0,5
2010,Armenia,ARM,Bulgaria,BGR,0,0,53,0,53
2010,Bangladesh,BGD,Bulgaria,BGR,0,0,5,0,5
2010,China,CHN,Bulgaria,BGR,0,0,5,0,5
2010,Cameroon,CMR,Bulgaria,BGR,0,0,5,0,5
2010,Ethiopia,ETH,Bulgaria,BGR,5,0,0,0,5
2010,Georgia,GEO,Bulgaria,BGR,0,0,5,5,10
2010,Iran (Islamic Rep. of),IRN,Bulgaria,BGR,5,5,31,37,78
2010,Iraq,IRQ,Bulgaria,BGR,0,86,89,58,233
2010,Lebanon,LBN,Bulgaria,BGR,0,0,5,0,5
2010,Sri Lanka,LKA,Bulgaria,BGR,0,0,5,0,5
2010,Rep. of Moldova,MDA,Bulgaria,BGR,0,0,0,5,5
2010,Morocco,MAR,Bulgaria,BGR,0,0,5,13,18
2010,Myanmar,MMR,Bulgaria,BGR,0,0,0,10,10
2010,Nigeria,NGA,Bulgaria,BGR,0,0,11,0,11
2010,Pakistan,PAK,Bulgaria,BGR,0,0,0,5,5
2010,Russian Federation,RUS,Bulgaria,BGR,0,0,10,5,15
2010,Sudan,SDN,Bulgaria,BGR,0,5,10,0,15
2010,Syrian Arab Rep.,SYR,Bulgaria,BGR,0,5,19,10,34
2010,United Rep. of Tanzania,TZA,Bulgaria,BGR,0,0,5,0,5
2010,Tunisia,TUN,Bulgaria,BGR,0,0,0,5,5
2010,Turkey,TUR,Bulgaria,BGR,0,0,5,10,15
2010,Ukraine,UKR,Bulgaria,BGR,0,0,5,0,5
2010,Stateless,XXA,Bulgaria,BGR,5,5,60,52,122
2011,Afghanistan,AFG,Slovakia,SVK,0,47,10,20,77
2011,Algeria,DZA,Slovakia,SVK,0,0,0,5,5
2011,Armenia,ARM,Slovakia,SVK,0,0,0,10,10
2011,Bangladesh,BGD,Slovakia,SVK,0,0,0,5,5
2011,China,CHN,Slovakia,SVK,0,0,11,10,21
2011,Cuba,CUB,Slovakia,SVK,5,0,0,0,5
2011,Palestinian,PSE,Slovakia,SVK,0,0,5,0,5
2011,Georgia,GEO,Slovakia,SVK,0,0,5,57,62
2011,India,IND,Slovakia,SVK,0,0,5,22,27
2011,Iran (Islamic Rep. of),IRN,Slovakia,SVK,0,5,0,5,10
2011,Iraq,IRQ,Slovakia,SVK,0,0,5,5,10
2011,Rep. of Moldova,MDA,Slovakia,SVK,0,0,10,33,43
2011,Nigeria,NGA,Slovakia,SVK,0,0,0,5,5
2011,Pakistan,PAK,Slovakia,SVK,0,0,0,11,11
2011,Russian Federation,RUS,Slovakia,SVK,0,0,5,39,44
2011,Serbia and Kosovo: S/RES/1244 (1999),SRB,Slovakia,SVK,0,0,0,5,5
2011,Somalia,SOM,Slovakia,SVK,0,43,0,10,53
2011,Viet Nam,VNM,Slovakia,SVK,0,0,10,16,26
2011,Syrian Arab Rep.,SYR,Slovakia,SVK,0,0,0,5,5
2011,Turkey,TUR,Slovakia,SVK,0,0,5,11,16
2011,Ukraine,UKR,Slovakia,SVK,0,0,5,5,10
2011,Unknown ,,Slovakia,SVK,0,0,0,5,5
2012,Burundi,BDI,Mali,MLI,0,0,0,5,5
2012,Burkina Faso,BFA,Mali,MLI,0,0,0,5,5
2012,Central African Rep.,CAF,Mali,MLI,0,0,0,14,14
2012,Chad,TCD,Mali,MLI,0,0,0,15,15
2012,Cameroon,CMR,Mali,MLI,0,0,0,18,18
2012,Congo,COG,Mali,MLI,0,0,0,28,28
2012,Dem. Rep. of the Congo,COD,Mali,MLI,11,0,0,83,94
2012,Guinea,GIN,Mali,MLI,0,0,0,5,5
2012,Cote d'Ivoire,CIV,Mali,MLI,12,0,0,1868,1880
2012,Liberia,LBR,Mali,MLI,0,0,0,5,5
2012,Mauritania,MRT,Mali,MLI,0,0,0,132,132
2012,Nigeria,NGA,Mali,MLI,0,0,0,27,27
2012,Rwanda,RWA,Mali,MLI,0,0,0,20,20
2012,Togo,TGO,Mali,MLI,0,0,0,49,49
2013,Liberia,LBR,Guinea-Bissau,GNB,0,0,0,15,15
2013,Central African Rep.,CAF,Mali,MLI,15,0,0,0,15
2013,Dem. Rep. of the Congo,COD,Mali,MLI,40,0,0,0,40
2013,Cote d'Ivoire,CIV,Mali,MLI,5,0,0,5,10
2013,Burundi,BDI,Rwanda,RWA,0,5,0,0,5
2013,Dem. Rep. of the Congo,COD,Rwanda,RWA,14264,0,0,0,14264
2013,Burundi,BDI,Zimbabwe,ZWE,5,0,5,0,10
2013,Dem. Rep. of the Congo,COD,Zimbabwe,ZWE,334,0,51,82,467
2013,Ethiopia,ETH,Zimbabwe,ZWE,5,0,0,0,5
2013,Cote d'Ivoire,CIV,Zimbabwe,ZWE,0,0,5,0,5
2013,Mali,MLI,Zimbabwe,ZWE,5,0,0,0,5
2013,Rwanda,RWA,Zimbabwe,ZWE,10,0,10,5,25
2013,Somalia,SOM,Zimbabwe,ZWE,5,0,0,0,5
2014,Central African Rep.,CAF,Mali,MLI,855,0,0,0,855
2014,Dem. Rep. of the Congo,COD,Mali,MLI,20,0,0,0,20
2014,Liberia,LBR,Mali,MLI,0,0,0,5,5
2014,Pakistan,PAK,Mali,MLI,5,0,0,0,5
2014,Rwanda,RWA,Mali,MLI,5,0,0,0,5
2014,Syrian Arab Rep.,SYR,Mali,MLI,16,0,0,0,16
2014,Afghanistan,AFG,New Zealand,NZL,5,0,5,0,10
2014,Egypt,EGY,New Zealand,NZL,5,0,5,0,10
2014,Bangladesh,BGD,New Zealand,NZL,0,0,5,0,5
2014,Brazil,BRA,New Zealand,NZL,0,0,5,0,5
2014,China,CHN,New Zealand,NZL,10,0,20,0,30
2014,Czechia,CZE,New Zealand,NZL,0,0,5,0,5
2014,Fiji,FJI,New Zealand,NZL,0,0,15,0,15
2014,Palestinian,PSE,New Zealand,NZL,5,0,5,0,10
2014,Georgia,GEO,New Zealand,NZL,0,0,5,0,5
2014,India,IND,New Zealand,NZL,0,0,17,0,17
2014,Iran (Islamic Rep. of),IRN,New Zealand,NZL,5,0,5,0,10
2014,Iraq,IRQ,New Zealand,NZL,10,0,5,0,15
2014,Kiribati,KIR,New Zealand,NZL,0,0,5,0,5
2014,Sri Lanka,LKA,New Zealand,NZL,5,0,36,0,41
2014,Mexico,MEX,New Zealand,NZL,0,0,5,0,5
2014,Malaysia,MYS,New Zealand,NZL,0,0,5,0,5
2014,Nepal,NPL,New Zealand,NZL,0,0,5,0,5
2014,Pakistan,PAK,New Zealand,NZL,5,0,19,0,24
2014,Philippines,PHL,New Zealand,NZL,0,0,5,0,5
2014,Saudi Arabia,SAU,New Zealand,NZL,5,0,0,0,5
2014,Slovakia,SVK,New Zealand,NZL,0,0,5,0,5
2014,Syrian Arab Rep.,SYR,New Zealand,NZL,12,0,0,0,12
2014,Turkey,TUR,New Zealand,NZL,10,0,10,0,20
2014,Ukraine,UKR,New Zealand,NZL,0,0,5,0,5
2014,Zimbabwe,ZWE,New Zealand,NZL,0,0,5,0,5
2015,Central African Rep.,CAF,Mali,MLI,383,0,0,60,443
2015,Dem. Rep. of the Congo,COD,Mali,MLI,5,0,0,61,66
2015,Eritrea,ERI,Mali,MLI,5,0,0,0,5
2015,Gambia,GMB,Mali,MLI,0,0,0,5,5
2015,Cote d'Ivoire,CIV,Mali,MLI,0,0,0,84,84
2015,Sri Lanka,LKA,Mali,MLI,5,0,0,0,5
2015,Pakistan,PAK,Mali,MLI,16,0,0,0,16
2015,Rwanda,RWA,Mali,MLI,0,0,0,5,5
2015,Syrian Arab Rep.,SYR,Mali,MLI,58,0,0,0,58
2015,Bangladesh,BGD,New Zealand,NZL,0,0,10,0,10
2015,Brazil,BRA,New Zealand,NZL,0,0,5,0,5
2015,China,CHN,New Zealand,NZL,19,0,5,0,24
2015,Colombia,COL,New Zealand,NZL,12,0,0,0,12
2015,Fiji,FJI,New Zealand,NZL,10,0,24,0,34
2015,Hungary,HUN,New Zealand,NZL,5,0,0,0,5
2015,India,IND,New Zealand,NZL,0,0,17,0,17
2015,Iran (Islamic Rep. of),IRN,New Zealand,NZL,5,0,5,0,10
2015,Iraq,IRQ,New Zealand,NZL,5,0,5,0,10
2015,Jordan,JOR,New Zealand,NZL,0,0,5,0,5
2015,Dem. People's Rep. of Korea,PRK,New Zealand,NZL,0,0,5,0,5
2015,Kuwait,KWT,New Zealand,NZL,5,0,0,0,5
2015,Libya,LBY,New Zealand,NZL,13,0,0,0,13
2015,Sri Lanka,LKA,New Zealand,NZL,5,0,10,0,15
2015,Malaysia,MYS,New Zealand,NZL,0,0,5,0,5
2015,Pakistan,PAK,New Zealand,NZL,13,0,5,0,18
2015,South Africa,ZAF,New Zealand,NZL,0,0,10,0,10
2015,Russian Federation,RUS,New Zealand,NZL,0,0,5,0,5
2015,Viet Nam,VNM,New Zealand,NZL,5,0,0,0,5
2015,Sudan,SDN,New Zealand,NZL,0,0,5,0,5
2015,Syrian Arab Rep.,SYR,New Zealand,NZL,16,0,0,0,16
2015,Turkey,TUR,New Zealand,NZL,0,0,5,0,5
2015,Samoa,WSM,New Zealand,NZL,0,0,5,0,5
2015,Zimbabwe,ZWE,New Zealand,NZL,5,0,0,0,5
2017,Afghanistan,AFG,Finland,FIN,239,217,932,90,1478
2017,Albania,ALB,Finland,FIN,0,0,72,28,100
2017,Algeria,DZA,Finland,FIN,0,0,18,22,40
2017,Angola,AGO,Finland,FIN,0,5,5,10,20
2017,Egypt,EGY,Finland,FIN,0,0,5,0,5
2017,Azerbaijan,AZE,Finland,FIN,5,0,0,0,5
2017,Bangladesh,BGD,Finland,FIN,5,0,14,18,37
2017,Belarus,BLR,Finland,FIN,0,0,0,34,34
2017,Bulgaria,BGR,Finland,FIN,0,0,0,5,5
2017,China,CHN,Finland,FIN,0,0,0,10,10
2017,Cameroon,CMR,Finland,FIN,0,0,11,21,32
2017,Congo,COG,Finland,FIN,0,0,0,5,5
2017,Dem. Rep. of the Congo,COD,Finland,FIN,0,0,5,10,15
2017,Eritrea,ERI,Finland,FIN,222,0,0,5,227
2017,Estonia,EST,Finland,FIN,0,0,5,0,5
2017,Ethiopia,ETH,Finland,FIN,15,0,17,5,37
2017,Gambia,GMB,Finland,FIN,0,0,13,30,43
2017,Georgia,GEO,Finland,FIN,0,0,30,64,94
2017,Germany,DEU,Finland,FIN,0,0,0,5,5
2017,Ghana,GHA,Finland,FIN,0,0,5,12,17
2017,Guinea,GIN,Finland,FIN,0,0,0,5,5
2017,Honduras,HND,Finland,FIN,0,5,0,0,5
2017,Croatia,HRV,Finland,FIN,0,0,5,0,5
2017,Cote d'Ivoire,CIV,Finland,FIN,0,0,0,5,5
2017,India,IND,Finland,FIN,0,0,0,24,24
2017,Iran (Islamic Rep. of),IRN,Finland,FIN,102,5,173,29,309
2017,Iraq,IRQ,Finland,FIN,1034,228,2276,343,3881
2017,Jordan,JOR,Finland,FIN,0,0,5,0,5
2017,Kazakhstan,KAZ,Finland,FIN,0,0,0,5,5
2017,Kenya,KEN,Finland,FIN,0,0,5,0,5
2017,Kyrgyzstan,KGZ,Finland,FIN,0,0,0,5,5
2017,Liberia,LBR,Finland,FIN,0,0,0,5,5
2017,Libya,LBY,Finland,FIN,0,0,0,5,5
2017,Lebanon,LBN,Finland,FIN,0,0,5,0,5
2017,Sri Lanka,LKA,Finland,FIN,0,0,5,5,10
2017,North Macedonia,MKD,Finland,FIN,0,0,14,5,19
2017,Mexico,MEX,Finland,FIN,0,0,0,5,5
2017,Mali,MLI,Finland,FIN,0,0,0,5,5
2017,Morocco,MAR,Finland,FIN,0,0,15,42,57
2017,Myanmar,MMR,Finland,FIN,5,0,0,5,10
2017,Nepal,NPL,Finland,FIN,0,0,5,0,5
2017,Nigeria,NGA,Finland,FIN,0,0,65,58,123
2017,Pakistan,PAK,Finland,FIN,10,0,18,5,33
2017,Philippines,PHL,Finland,FIN,0,0,0,5,5
2017,Russian Federation,RUS,Finland,FIN,12,0,96,72,180
2017,Serbia and Kosovo: S/RES/1244 (1999),SRB,Finland,FIN,0,0,29,0,29
2017,Senegal,SEN,Finland,FIN,0,0,0,5,5
2017,Somalia,SOM,Finland,FIN,106,77,268,45,496
2017,Sudan,SDN,Finland,FIN,10,0,5,5,20
2017,Syrian Arab Rep.,SYR,Finland,FIN,601,93,5,34,733
2017,Tunisia,TUN,Finland,FIN,0,0,5,10,15
2017,Turkey,TUR,Finland,FIN,24,0,27,27,78
2017,United Arab Emirates,ARE,Finland,FIN,0,0,0,5,5
2017,Uganda,UGA,Finland,FIN,0,0,0,5,5
2017,Ukraine,UKR,Finland,FIN,0,0,21,27,48
2017,Venezuela (Bolivarian Republic of),VEN,Finland,FIN,0,0,5,0,5
2017,Yemen,YEM,Finland,FIN,0,43,0,5,48
2017,Stateless,XXA,Finland,FIN,90,17,35,5,147
2017,Unknown ,,Finland,FIN,11,5,29,10,55
2017,Colombia,COL,Venezuela (Bolivarian Republic of),VEN,15,0,80,10,105
2018,Afghanistan,AFG,Kazakhstan,KAZ,23,0,79,13,115
2018,China,CHN,Kazakhstan,KAZ,5,0,0,0,5
2018,Syrian Arab Rep.,SYR,Kazakhstan,KAZ,0,0,5,0,5
2019,Afghanistan,AFG,Finland,FIN,197,141,290,54,682
2019,Albania,ALB,Finland,FIN,0,0,21,0,21
2019,Algeria,DZA,Finland,FIN,0,0,5,12,17
2019,Angola,AGO,Finland,FIN,5,0,10,17,32
2019,Egypt,EGY,Finland,FIN,5,0,10,5,20
2019,Armenia,ARM,Finland,FIN,0,0,5,0,5
2019,Azerbaijan,AZE,Finland,FIN,15,0,0,10,25
2019,Bangladesh,BGD,Finland,FIN,5,0,10,5,20
2019,Belarus,BLR,Finland,FIN,0,0,0,13,13
2019,Brazil,BRA,Finland,FIN,0,0,5,0,5
2019,China,CHN,Finland,FIN,59,0,0,5,64
2019,Cameroon,CMR,Finland,FIN,13,0,29,18,60
2019,Dem. Rep. of the Congo,COD,Finland,FIN,5,0,12,5,22
2019,Colombia,COL,Finland,FIN,0,0,10,5,15
2019,Cuba,CUB,Finland,FIN,0,0,25,5,30
2019,Eritrea,ERI,Finland,FIN,12,0,0,0,12
2019,Ethiopia,ETH,Finland,FIN,0,0,23,0,23
2019,Gambia,GMB,Finland,FIN,0,0,13,20,33
2019,Georgia,GEO,Finland,FIN,0,0,36,15,51
2019,Ghana,GHA,Finland,FIN,0,0,10,5,15
2019,Guinea,GIN,Finland,FIN,5,0,0,0,5
2019,India,IND,Finland,FIN,0,0,5,0,5
2019,Iran (Islamic Rep. of),IRN,Finland,FIN,92,5,166,25,288
2019,Iraq,IRQ,Finland,FIN,496,116,519,104,1235
2019,Kazakhstan,KAZ,Finland,FIN,0,0,5,0,5
2019,Kenya,KEN,Finland,FIN,0,0,5,5,10
2019,Libya,LBY,Finland,FIN,0,0,0,5,5
2019,Sri Lanka,LKA,Finland,FIN,0,0,12,14,26
2019,Mexico,MEX,Finland,FIN,0,0,10,0,10
2019,Morocco,MAR,Finland,FIN,5,0,10,17,32
2019,Myanmar,MMR,Finland,FIN,5,0,0,0,5
2019,Nepal,NPL,Finland,FIN,0,0,0,5,5
2019,Nicaragua,NIC,Finland,FIN,30,0,5,0,35
2019,Nigeria,NGA,Finland,FIN,5,0,62,62,129
2019,Pakistan,PAK,Finland,FIN,5,0,20,12,37
2019,Russian Federation,RUS,Finland,FIN,160,0,461,48,669
2019,Rwanda,RWA,Finland,FIN,5,0,10,5,20
2019,Serbia and Kosovo: S/RES/1244 (1999),SRB,Finland,FIN,0,0,18,0,18
2019,Senegal,SEN,Finland,FIN,0,0,5,0,5
2019,Sierra Leone,SLE,Finland,FIN,0,0,5,5,10
2019,Somalia,SOM,Finland,FIN,134,44,73,20,271
2019,Sudan,SDN,Finland,FIN,5,0,5,5,15
2019,Syrian Arab Rep.,SYR,Finland,FIN,61,28,0,32,121
2019,Tajikistan,TJK,Finland,FIN,0,0,5,0,5
2019,Turkey,TUR,Finland,FIN,402,0,36,21,459
2019,Uganda,UGA,Finland,FIN,0,0,10,0,10
2019,Ukraine,UKR,Finland,FIN,5,0,30,13,48
2019,Uzbekistan,UZB,Finland,FIN,5,0,0,10,15
2019,Venezuela (Bolivarian Republic of),VEN,Finland,FIN,0,5,12,0,17
2019,Yemen,YEM,Finland,FIN,26,55,0,0,81
2019,Zimbabwe,ZWE,Finland,FIN,5,0,0,0,5
2019,Stateless,XXA,Finland,FIN,18,0,5,13,36
2019,Unknown ,,Finland,FIN,0,0,5,5,10
2000,Armenia,ARM,Argentina,ARG,10,0,10,0,20
2000,Bangladesh,BGD,Argentina,ARG,0,0,5,0,5
2000,Chile,CHL,Argentina,ARG,5,0,0,0,5
2000,Colombia,COL,Argentina,ARG,0,0,5,5,10
2000,Cuba,CUB,Argentina,ARG,0,0,5,5,10
2000,Kyrgyzstan,KGZ,Argentina,ARG,5,0,0,0,5
2000,Pakistan,PAK,Argentina,ARG,5,0,0,0,5
2000,Peru,PER,Argentina,ARG,45,0,54,22,121
2000,Russian Federation,RUS,Argentina,ARG,0,0,5,0,5
2000,Serbia and Kosovo: S/RES/1244 (1999),SRB,Argentina,ARG,5,0,0,0,5
2000,Senegal,SEN,Argentina,ARG,10,0,5,0,15
2000,Somalia,SOM,Argentina,ARG,0,0,0,5,5
2000,Unknown ,,Argentina,ARG,0,0,0,5,5
2000,Afghanistan,AFG,Belgium,BEL,46,0,22,0,68
2000,Albania,ALB,Belgium,BEL,18,0,11,5,34
2000,Algeria,DZA,Belgium,BEL,35,0,23,5,63
2000,Angola,AGO,Belgium,BEL,40,0,65,0,105
2000,Egypt,EGY,Belgium,BEL,0,0,5,0,5
2000,Armenia,ARM,Belgium,BEL,0,0,55,10,65
2000,Azerbaijan,AZE,Belgium,BEL,0,0,14,0,14
2000,Burundi,BDI,Belgium,BEL,108,0,200,5,313
2000,Bangladesh,BGD,Belgium,BEL,0,0,5,0,5
2000,Bhutan,BTN,Belgium,BEL,0,0,46,13,59
2000,Belarus,BLR,Belgium,BEL,0,0,30,0,30
2000,Bosnia and Herzegovina,BIH,Belgium,BEL,10,0,0,0,10
2000,Bulgaria,BGR,Belgium,BEL,0,0,12,0,12
2000,China,CHN,Belgium,BEL,5,0,5,0,10
2000,Cameroon,CMR,Belgium,BEL,5,0,100,0,105
2000,Congo,COG,Belgium,BEL,19,0,43,0,62
2000,Dem. Rep. of the Congo,COD,Belgium,BEL,199,0,605,21,825
2000,Colombia,COL,Belgium,BEL,13,0,25,5,43
2000,Czechia,CZE,Belgium,BEL,0,0,10,0,10
2000,Djibouti,DJI,Belgium,BEL,5,0,5,0,10
2000,Ecuador,ECU,Belgium,BEL,0,0,5,0,5
2000,Ethiopia,ETH,Belgium,BEL,10,0,5,0,15
2000,Georgia,GEO,Belgium,BEL,0,0,14,0,14
2000,Guinea,GIN,Belgium,BEL,0,0,155,0,155
2000,Cote d'Ivoire,CIV,Belgium,BEL,0,0,5,0,5
2000,India,IND,Belgium,BEL,0,0,17,5,22
2000,Iran (Islamic Rep. of),IRN,Belgium,BEL,10,0,11,5,26
2000,Iraq,IRQ,Belgium,BEL,89,0,37,0,126
2000,Israel,ISR,Belgium,BEL,5,0,5,0,10
2000,Kenya,KEN,Belgium,BEL,0,0,5,0,5
2000,Lebanon,LBN,Belgium,BEL,5,0,11,0,16
2000,Sri Lanka,LKA,Belgium,BEL,5,0,10,0,15
2000,Latvia,LVA,Belgium,BEL,0,0,5,0,5
2000,Mauritania,MRT,Belgium,BEL,0,0,40,0,40
2000,North Macedonia,MKD,Belgium,BEL,0,0,5,0,5
2000,Rep. of Moldova,MDA,Belgium,BEL,0,0,5,0,5
2000,Mongolia,MNG,Belgium,BEL,0,0,5,0,5
2000,Nepal,NPL,Belgium,BEL,0,0,0,5,5
2000,Nigeria,NGA,Belgium,BEL,0,0,5,0,5
2000,Pakistan,PAK,Belgium,BEL,10,0,33,5,48
2000,Peru,PER,Belgium,BEL,5,0,0,0,5
2000,Romania,ROU,Belgium,BEL,0,0,22,10,32
2000,Russian Federation,RUS,Belgium,BEL,0,0,5,0,5
2000,Rwanda,RWA,Belgium,BEL,398,0,286,5,689
2000,Serbia and Kosovo: S/RES/1244 (1999),SRB,Belgium,BEL,54,0,778,92,924
2000,Senegal,SEN,Belgium,BEL,0,0,5,0,5
2000,Sierra Leone,SLE,Belgium,BEL,10,0,134,0,144
2000,Somalia,SOM,Belgium,BEL,25,0,63,0,88
2000,Viet Nam,VNM,Belgium,BEL,5,0,0,5,10
2000,Sudan,SDN,Belgium,BEL,0,0,5,0,5
2000,Slovakia,SVK,Belgium,BEL,0,0,47,0,47
2000,Syrian Arab Rep.,SYR,Belgium,BEL,10,0,23,0,33
2000,Togo,TGO,Belgium,BEL,0,0,5,0,5
2000,Turkey,TUR,Belgium,BEL,51,0,80,10,141
2000,Ukraine,UKR,Belgium,BEL,0,0,23,0,23
2000,Unknown ,,Belgium,BEL,0,750,0,0,750
2000,Burundi,BDI,Benin,BEN,10,0,0,0,10
2000,Burkina Faso,BFA,Benin,BEN,5,0,0,0,5
2000,Central African Rep.,CAF,Benin,BEN,5,0,5,0,10
2000,Chad,TCD,Benin,BEN,102,0,150,0,252
2000,Cameroon,CMR,Benin,BEN,10,0,17,0,27
2000,Congo,COG,Benin,BEN,877,0,66,0,943
2000,Dem. Rep. of the Congo,COD,Benin,BEN,478,0,272,0,750
2000,Comoros,COM,Benin,BEN,0,0,0,5,5
2000,Ethiopia,ETH,Benin,BEN,5,0,0,0,5
2000,Guinea-Bissau,GNB,Benin,BEN,0,0,10,0,10
2000,Guinea,GIN,Benin,BEN,5,0,10,0,15
2000,Cote d'Ivoire,CIV,Benin,BEN,0,0,5,0,5
2000,Iraq,IRQ,Benin,BEN,5,0,0,0,5
2000,Nigeria,NGA,Benin,BEN,41,0,539,362,942
2000,Rwanda,RWA,Benin,BEN,85,0,11,0,96
2000,Sierra Leone,SLE,Benin,BEN,0,0,5,0,5
2000,Sudan,SDN,Benin,BEN,11,0,12,0,23
2000,Togo,TGO,Benin,BEN,239,0,817,0,1056
2000,Afghanistan,AFG,Belarus,BLR,0,171,10,207,388
2000,Armenia,ARM,Belarus,BLR,0,0,0,5,5
2000,Azerbaijan,AZE,Belarus,BLR,0,11,0,18,29
2000,Cameroon,CMR,Belarus,BLR,0,0,0,10,10
2000,Ethiopia,ETH,Belarus,BLR,0,0,5,0,5
2000,Georgia,GEO,Belarus,BLR,0,5,0,5,10
2000,India,IND,Belarus,BLR,0,0,0,5,5
2000,Iran (Islamic Rep. of),IRN,Belarus,BLR,0,5,0,0,5
2000,Iraq,IRQ,Belarus,BLR,0,0,0,5,5
2000,Kazakhstan,KAZ,Belarus,BLR,0,0,0,10,10
2000,Pakistan,PAK,Belarus,BLR,0,0,0,21,21
2000,Russian Federation,RUS,Belarus,BLR,0,0,0,49,49
2000,Tajikistan,TJK,Belarus,BLR,0,5,0,21,26
2000,Ukraine,UKR,Belarus,BLR,0,0,0,5,5
2000,Uzbekistan,UZB,Belarus,BLR,0,0,0,5,5
2000,Peru,PER,Bolivia (Plurinational State of),BOL,5,0,0,0,5
2000,Angola,AGO,Botswana,BWA,583,0,0,0,583
2000,Burundi,BDI,Botswana,BWA,0,0,19,0,19
2000,Dem. Rep. of the Congo,COD,Botswana,BWA,5,0,5,0,10
2000,Ethiopia,ETH,Botswana,BWA,5,0,5,0,10
2000,Kenya,KEN,Botswana,BWA,0,0,5,0,5
2000,Namibia,NAM,Botswana,BWA,1609,0,0,0,1609
2000,Rwanda,RWA,Botswana,BWA,10,0,5,0,15
2000,Somalia,SOM,Botswana,BWA,47,0,379,56,482
2000,Sudan,SDN,Botswana,BWA,5,0,5,0,10
2000,Uganda,UGA,Botswana,BWA,15,0,5,0,20
2000,Angola,AGO,Brazil,BRA,182,0,10,22,214
2000,Burundi,BDI,Brazil,BRA,5,0,0,0,5
2000,Bulgaria,BGR,Brazil,BRA,0,0,5,0,5
2000,China,CHN,Brazil,BRA,0,0,10,11,21
2000,Dem. Rep. of the Congo,COD,Brazil,BRA,16,0,0,5,21
2000,Colombia,COL,Brazil,BRA,12,0,22,5,39
2000,Cuba,CUB,Brazil,BRA,5,0,5,0,10
2000,Ecuador,ECU,Brazil,BRA,0,0,5,0,5
2000,Ethiopia,ETH,Brazil,BRA,5,0,0,0,5
2000,Guinea-Bissau,GNB,Brazil,BRA,0,0,5,0,5
2000,Iraq,IRQ,Brazil,BRA,5,0,5,0,10
2000,Liberia,LBR,Brazil,BRA,0,0,5,0,5
2000,Lebanon,LBN,Brazil,BRA,0,0,5,0,5
2000,Nigeria,NGA,Brazil,BRA,0,0,5,5,10
2000,Pakistan,PAK,Brazil,BRA,0,0,13,23,36
2000,Peru,PER,Brazil,BRA,0,0,5,0,5
2000,Romania,ROU,Brazil,BRA,0,0,163,17,180
2000,South Africa,ZAF,Brazil,BRA,0,0,5,0,5
2000,Russian Federation,RUS,Brazil,BRA,0,0,5,0,5
2000,Serbia and Kosovo: S/RES/1244 (1999),SRB,Brazil,BRA,0,0,13,0,13
2000,Sierra Leone,SLE,Brazil,BRA,59,0,0,13,72
2000,Somalia,SOM,Brazil,BRA,5,0,0,5,10
2000,Sudan,SDN,Brazil,BRA,10,0,0,0,10
2000,Afghanistan,AFG,Bulgaria,BGR,94,303,127,156,680
2000,Albania,ALB,Bulgaria,BGR,0,0,5,0,5
2000,Algeria,DZA,Bulgaria,BGR,0,0,20,28,48
2000,Angola,AGO,Bulgaria,BGR,0,5,0,0,5
2000,Armenia,ARM,Bulgaria,BGR,0,0,235,47,282
2000,Bangladesh,BGD,Bulgaria,BGR,0,0,0,79,79
2000,Bosnia and Herzegovina,BIH,Bulgaria,BGR,0,13,0,0,13
2000,Congo,COG,Bulgaria,BGR,0,10,0,0,10
2000,Ethiopia,ETH,Bulgaria,BGR,10,0,0,19,29
2000,Georgia,GEO,Bulgaria,BGR,0,0,0,5,5
2000,Ghana,GHA,Bulgaria,BGR,0,0,5,0,5
2000,India,IND,Bulgaria,BGR,0,0,0,5,5
2000,Iran (Islamic Rep. of),IRN,Bulgaria,BGR,34,5,0,53,92
2000,Iraq,IRQ,Bulgaria,BGR,31,33,42,208,314
2000,Kazakhstan,KAZ,Bulgaria,BGR,0,0,5,0,5
2000,Liberia,LBR,Bulgaria,BGR,0,5,12,5,22
2000,Lebanon,LBN,Bulgaria,BGR,5,0,0,0,5
2000,Nigeria,NGA,Bulgaria,BGR,0,0,10,5,15
2000,Pakistan,PAK,Bulgaria,BGR,0,0,0,32,32
2000,Russian Federation,RUS,Bulgaria,BGR,0,0,10,0,10
2000,Serbia and Kosovo: S/RES/1244 (1999),SRB,Bulgaria,BGR,0,10,5,10,25
2000,Sierra Leone,SLE,Bulgaria,BGR,0,11,0,10,21
2000,Syrian Arab Rep.,SYR,Bulgaria,BGR,10,0,0,11,21
2000,United Rep. of Tanzania,TZA,Bulgaria,BGR,0,0,10,0,10
2000,Turkey,TUR,Bulgaria,BGR,19,10,5,67,101
2000,Ukraine,UKR,Bulgaria,BGR,0,0,5,0,5
2000,Yemen,YEM,Bulgaria,BGR,0,0,5,0,5
2000,Stateless,XXA,Bulgaria,BGR,59,10,5,25,99
2000,Nigeria,NGA,Belize,BLZ,0,0,0,5,5
2000,El Salvador,SLV,Belize,BLZ,0,0,0,5,5
2000,Afghanistan,AFG,Canada,CAN,436,0,31,23,490
2000,Albania,ALB,Canada,CAN,336,0,107,49,492
2000,Algeria,DZA,Canada,CAN,135,0,257,55,447
2000,Angola,AGO,Canada,CAN,237,0,100,10,347
2000,Egypt,EGY,Canada,CAN,25,0,27,10,62
2000,Argentina,ARG,Canada,CAN,67,0,322,156,545
2000,Armenia,ARM,Canada,CAN,15,0,12,5,32
2000,Australia,AUS,Canada,CAN,5,0,0,0,5
2000,Austria,AUT,Canada,CAN,0,0,0,5,5
2000,Azerbaijan,AZE,Canada,CAN,33,0,16,5,54
2000,Barbados,BRB,Canada,CAN,0,0,5,5,10
2000,Burundi,BDI,Canada,CAN,69,0,15,10,94
2000,Belgium,BEL,Canada,CAN,0,0,5,5,10
2000,Bangladesh,BGD,Canada,CAN,106,0,178,62,346
2000,Burkina Faso,BFA,Canada,CAN,5,0,0,0,5
2000,Belarus,BLR,Canada,CAN,24,0,10,5,39
2000,Bolivia (Plurinational State of),BOL,Canada,CAN,13,0,10,5,28
2000,Brazil,BRA,Canada,CAN,5,0,24,11,40
2000,Bosnia and Herzegovina,BIH,Canada,CAN,16,0,5,0,21
2000,Bulgaria,BGR,Canada,CAN,95,0,65,26,186
2000,Cambodia,KHM,Canada,CAN,0,0,5,5,10
2000,Chad,TCD,Canada,CAN,50,0,22,5,77
2000,China,CHN,Canada,CAN,1029,0,850,381,2260
2000,Chile,CHL,Canada,CAN,25,0,67,13,105
2000,Cameroon,CMR,Canada,CAN,65,0,34,10,109
2000,Congo,COG,Canada,CAN,56,0,30,12,98
2000,Dem. Rep. of the Congo,COD,Canada,CAN,677,0,187,46,910
2000,Comoros,COM,Canada,CAN,5,0,0,0,5
2000,Colombia,COL,Canada,CAN,462,0,153,71,686
2000,Costa Rica,CRI,Canada,CAN,29,0,81,159,269
2000,Cuba,CUB,Canada,CAN,129,0,39,22,190
2000,Czechia,CZE,Canada,CAN,77,0,17,18,112
2000,Djibouti,DJI,Canada,CAN,67,0,31,13,111
2000,Dominica,DMA,Canada,CAN,5,0,5,5,15
2000,Dominican Rep.,DOM,Canada,CAN,0,0,16,18,34
2000,Ecuador,ECU,Canada,CAN,21,0,30,15,66
2000,Eritrea,ERI,Canada,CAN,56,0,10,5,71
2000,Estonia,EST,Canada,CAN,0,0,10,0,10
2000,Ethiopia,ETH,Canada,CAN,87,0,20,17,124
2000,Fiji,FJI,Canada,CAN,10,0,14,11,35
2000,France,FRA,Canada,CAN,0,0,5,0,5
2000,Palestinian,PSE,Canada,CAN,5,0,0,5,10
2000,Georgia,GEO,Canada,CAN,39,0,23,12,74
2000,Germany,DEU,Canada,CAN,0,0,5,0,5
2000,Ghana,GHA,Canada,CAN,35,0,70,38,143
2000,Greece,GRC,Canada,CAN,0,0,0,5,5
2000,Grenada,GRD,Canada,CAN,29,0,51,24,104
2000,Guatemala,GTM,Canada,CAN,35,0,123,52,210
2000,Guinea,GIN,Canada,CAN,149,0,45,16,210
2000,Guyana,GUY,Canada,CAN,0,0,77,29,106
2000,Haiti,HTI,Canada,CAN,71,0,204,61,336
2000,"China, Hong Kong SAR",HKG,Canada,CAN,0,0,5,0,5
2000,Honduras,HND,Canada,CAN,15,0,110,159,284
2000,Croatia,HRV,Canada,CAN,15,0,11,0,26
2000,Hungary,HUN,Canada,CAN,334,0,789,453,1576
2000,Cote d'Ivoire,CIV,Canada,CAN,17,0,24,5,46
2000,India,IND,Canada,CAN,376,0,680,277,1333
2000,Indonesia,IDN,Canada,CAN,27,0,22,5,54
2000,Iran (Islamic Rep. of),IRN,Canada,CAN,462,0,194,79,735
2000,Iraq,IRQ,Canada,CAN,210,0,60,43,313
2000,Israel,ISR,Canada,CAN,16,0,201,74,291
2000,Jamaica,JAM,Canada,CAN,13,0,75,35,123
2000,Jordan,JOR,Canada,CAN,5,0,26,5,36
2000,Japan,JPN,Canada,CAN,0,0,5,0,5
2000,Kazakhstan,KAZ,Canada,CAN,56,0,98,29,183
2000,Kenya,KEN,Canada,CAN,37,0,14,5,56
2000,Kyrgyzstan,KGZ,Canada,CAN,18,0,26,5,49
2000,Rep. of Korea,KOR,Canada,CAN,24,0,132,52,208
2000,Dem. People's Rep. of Korea,PRK,Canada,CAN,0,0,5,0,5
2000,Kuwait,KWT,Canada,CAN,98,0,5,5,108
2000,Liberia,LBR,Canada,CAN,5,0,5,5,15
2000,Libya,LBY,Canada,CAN,75,0,20,10,105
2000,Saint Lucia,LCA,Canada,CAN,5,0,10,5,20
2000,Lebanon,LBN,Canada,CAN,115,0,180,73,368
2000,Lesotho,LSO,Canada,CAN,0,0,11,0,11
2000,Sri Lanka,LKA,Canada,CAN,2098,0,463,147,2708
2000,Lithuania,LTU,Canada,CAN,5,0,5,5,15
2000,Latvia,LVA,Canada,CAN,11,0,17,5,33
2000,Mauritania,MRT,Canada,CAN,5,0,5,5,15
2000,North Macedonia,MKD,Canada,CAN,12,0,18,5,35
2000,Rep. of Moldova,MDA,Canada,CAN,16,0,26,5,47
2000,Mexico,MEX,Canada,CAN,322,0,547,349,1218
2000,Mali,MLI,Canada,CAN,10,0,5,0,15
2000,Malaysia,MYS,Canada,CAN,14,0,51,11,76
2000,Mongolia,MNG,Canada,CAN,0,0,5,5,10
2000,Morocco,MAR,Canada,CAN,10,0,23,0,33
2000,Myanmar,MMR,Canada,CAN,13,0,0,0,13
2000,Namibia,NAM,Canada,CAN,0,0,5,0,5
2000,Nepal,NPL,Canada,CAN,10,0,16,5,31
2000,Netherlands,NLD,Canada,CAN,0,0,5,0,5
2000,Nicaragua,NIC,Canada,CAN,10,0,29,10,49
2000,Nigeria,NGA,Canada,CAN,207,0,275,98,580
2000,New Zealand,NZL,Canada,CAN,0,0,5,0,5
2000,Oman,OMN,Canada,CAN,5,0,0,0,5
2000,Pakistan,PAK,Canada,CAN,1625,0,702,321,2648
2000,Panama,PAN,Canada,CAN,0,0,5,0,5
2000,Peru,PER,Canada,CAN,214,0,182,37,433
2000,Philippines,PHL,Canada,CAN,10,0,54,14,78
2000,Poland,POL,Canada,CAN,100,0,45,57,202
2000,Portugal,PRT,Canada,CAN,5,0,26,0,31
2000,Romania,ROU,Canada,CAN,118,0,220,86,424
2000,South Africa,ZAF,Canada,CAN,0,0,10,5,15
2000,Russian Federation,RUS,Canada,CAN,449,0,217,100,766
2000,Rwanda,RWA,Canada,CAN,146,0,21,5,172
2000,El Salvador,SLV,Canada,CAN,45,0,174,61,280
2000,Saudi Arabia,SAU,Canada,CAN,0,0,5,5,10
2000,Serbia and Kosovo: S/RES/1244 (1999),SRB,Canada,CAN,144,0,133,58,335
2000,Senegal,SEN,Canada,CAN,5,0,0,0,5
2000,Sierra Leone,SLE,Canada,CAN,33,0,20,10,63
2000,Somalia,SOM,Canada,CAN,454,0,31,96,581
2000,Spain,ESP,Canada,CAN,0,0,5,5,10
2000,Viet Nam,VNM,Canada,CAN,11,0,16,10,37
2000,Sudan,SDN,Canada,CAN,227,0,39,16,282
2000,Slovakia,SVK,Canada,CAN,10,0,30,5,45
2000,Slovenia,SVN,Canada,CAN,0,0,5,0,5
2000,Eswatini,SWZ,Canada,CAN,5,0,0,0,5
2000,Sweden,SWE,Canada,CAN,0,0,0,5,5
2000,Switzerland,CHE,Canada,CAN,0,0,5,0,5
2000,Syrian Arab Rep.,SYR,Canada,CAN,62,0,35,5,102
2000,United Rep. of Tanzania,TZA,Canada,CAN,62,0,26,5,93
2000,Thailand,THA,Canada,CAN,5,0,25,5,35
2000,Tajikistan,TJK,Canada,CAN,10,0,5,0,15
2000,Turkmenistan,TKM,Canada,CAN,5,0,0,0,5
2000,Togo,TGO,Canada,CAN,16,0,5,0,21
2000,Trinidad and Tobago,TTO,Canada,CAN,0,0,30,15,45
2000,Tunisia,TUN,Canada,CAN,30,0,32,10,72
2000,Turkey,TUR,Canada,CAN,355,0,102,54,511
2000,Uganda,UGA,Canada,CAN,12,0,17,0,29
2000,Ukraine,UKR,Canada,CAN,172,0,117,116,405
2000,Uruguay,URY,Canada,CAN,5,0,17,10,32
2000,United States of America,USA,Canada,CAN,5,0,23,25,53
2000,Uzbekistan,UZB,Canada,CAN,24,0,15,5,44
2000,Saint Vincent and the Grenadines,VCT,Canada,CAN,17,0,31,21,69
2000,Venezuela (Bolivarian Republic of),VEN,Canada,CAN,41,0,50,16,107
2000,Yemen,YEM,Canada,CAN,33,0,14,5,52
2000,Zambia,ZMB,Canada,CAN,5,0,0,0,5
2000,Zimbabwe,ZWE,Canada,CAN,16,0,15,0,31
2000,Dem. Rep. of the Congo,COD,Central African Rep.,CAF,50,9169,5,0,9224
2000,Colombia,COL,Chile,CHL,18,0,0,0,18
2000,Cuba,CUB,Chile,CHL,10,0,0,0,10
2000,Nigeria,NGA,Chile,CHL,5,0,0,0,5
2000,Peru,PER,Chile,CHL,5,0,0,0,5
2000,Serbia and Kosovo: S/RES/1244 (1999),SRB,Chile,CHL,5,0,0,0,5
2000,Afghanistan,AFG,Denmark,DNK,879,91,119,0,1089
2000,Albania,ALB,Denmark,DNK,0,0,26,0,26
2000,Algeria,DZA,Denmark,DNK,5,0,10,0,15
2000,Angola,AGO,Denmark,DNK,0,5,0,0,5
2000,Egypt,EGY,Denmark,DNK,0,0,5,0,5
2000,Armenia,ARM,Denmark,DNK,0,5,284,0,289
2000,Azerbaijan,AZE,Denmark,DNK,0,0,120,0,120
2000,Burundi,BDI,Denmark,DNK,10,21,0,0,31
2000,Bangladesh,BGD,Denmark,DNK,0,0,15,0,15
2000,Belarus,BLR,Denmark,DNK,0,0,28,0,28
2000,Bosnia and Herzegovina,BIH,Denmark,DNK,0,13,286,0,299
2000,Bulgaria,BGR,Denmark,DNK,0,0,10,0,10
2000,China,CHN,Denmark,DNK,5,0,23,0,28
2000,Cameroon,CMR,Denmark,DNK,0,0,14,0,14
2000,Dem. Rep. of the Congo,COD,Denmark,DNK,5,0,5,0,10
2000,Colombia,COL,Denmark,DNK,0,0,5,0,5
2000,Czechia,CZE,Denmark,DNK,0,0,34,0,34
2000,Eritrea,ERI,Denmark,DNK,0,5,0,0,5
2000,Estonia,EST,Denmark,DNK,0,0,10,0,10
2000,Ethiopia,ETH,Denmark,DNK,0,5,5,0,10
2000,Gambia,GMB,Denmark,DNK,0,0,15,0,15
2000,Palestinian,PSE,Denmark,DNK,103,5,73,0,181
2000,Georgia,GEO,Denmark,DNK,0,0,84,0,84
2000,Ghana,GHA,Denmark,DNK,0,0,5,0,5
2000,Guinea,GIN,Denmark,DNK,0,0,5,0,5
2000,Croatia,HRV,Denmark,DNK,0,0,12,0,12
2000,India,IND,Denmark,DNK,0,0,27,0,27
2000,Iran (Islamic Rep. of),IRN,Denmark,DNK,10,19,158,0,187
2000,Iraq,IRQ,Denmark,DNK,51,1461,86,0,1598
2000,Jordan,JOR,Denmark,DNK,5,0,0,0,5
2000,Kyrgyzstan,KGZ,Denmark,DNK,0,0,33,0,33
2000,Lebanon,LBN,Denmark,DNK,5,0,19,0,24
2000,Sri Lanka,LKA,Denmark,DNK,5,29,24,0,58
2000,Lithuania,LTU,Denmark,DNK,0,0,12,0,12
2000,Latvia,LVA,Denmark,DNK,0,0,13,0,13
2000,North Macedonia,MKD,Denmark,DNK,0,0,16,0,16
2000,Rep. of Moldova,MDA,Denmark,DNK,0,0,43,0,43
2000,Mongolia,MNG,Denmark,DNK,0,0,22,0,22
2000,Morocco,MAR,Denmark,DNK,0,0,10,0,10
2000,Myanmar,MMR,Denmark,DNK,5,0,0,0,5
2000,Nepal,NPL,Denmark,DNK,0,0,5,0,5
2000,Nigeria,NGA,Denmark,DNK,0,0,13,0,13
2000,Pakistan,PAK,Denmark,DNK,0,5,48,0,53
2000,Poland,POL,Denmark,DNK,0,0,232,0,232
2000,Romania,ROU,Denmark,DNK,0,0,38,0,38
2000,Russian Federation,RUS,Denmark,DNK,5,0,193,0,198
2000,Rwanda,RWA,Denmark,DNK,5,17,0,0,22
2000,Saudi Arabia,SAU,Denmark,DNK,0,0,5,0,5
2000,Serbia and Kosovo: S/RES/1244 (1999),SRB,Denmark,DNK,23,80,1153,0,1256
2000,Senegal,SEN,Denmark,DNK,0,0,5,0,5
2000,Sierra Leone,SLE,Denmark,DNK,0,0,5,0,5
2000,Somalia,SOM,Denmark,DNK,43,461,19,0,523
2000,Viet Nam,VNM,Denmark,DNK,10,0,12,0,22
2000,Sudan,SDN,Denmark,DNK,5,18,0,0,23
2000,Slovakia,SVK,Denmark,DNK,0,0,55,0,55
2000,Syrian Arab Rep.,SYR,Denmark,DNK,10,5,44,0,59
2000,Turkey,TUR,Denmark,DNK,5,0,21,0,26
2000,Ukraine,UKR,Denmark,DNK,0,0,47,0,47
2000,Stateless,XXA,Denmark,DNK,10,0,5,0,15
2000,Haiti,HTI,Dominican Rep.,DOM,13,0,5,5,23
2000,Serbia and Kosovo: S/RES/1244 (1999),SRB,Dominican Rep.,DOM,0,0,0,5,5
2000,Afghanistan,AFG,Ethiopia,ETH,5,0,0,0,5
2000,Dem. Rep. of the Congo,COD,Ethiopia,ETH,0,0,5,0,5
2000,Djibouti,DJI,Ethiopia,ETH,57,0,0,0,57
2000,Somalia,SOM,Ethiopia,ETH,5,0,0,1977,1982
2000,Afghanistan,AFG,Finland,FIN,0,44,0,0,44
2000,Albania,ALB,Finland,FIN,0,0,0,5,5
2000,Algeria,DZA,Finland,FIN,0,0,5,5,10
2000,Angola,AGO,Finland,FIN,0,5,0,0,5
2000,Bangladesh,BGD,Finland,FIN,0,0,5,0,5
2000,Belarus,BLR,Finland,FIN,0,5,0,5,10
2000,Bosnia and Herzegovina,BIH,Finland,FIN,0,10,0,5,15
2000,China,CHN,Finland,FIN,0,5,0,5,10
2000,Cameroon,CMR,Finland,FIN,0,0,17,0,17
2000,Congo,COG,Finland,FIN,0,5,0,0,5
2000,Czechia,CZE,Finland,FIN,0,0,13,26,39
2000,Estonia,EST,Finland,FIN,0,0,0,5,5
2000,Ethiopia,ETH,Finland,FIN,0,0,5,0,5
2000,Georgia,GEO,Finland,FIN,0,0,5,0,5
2000,Ghana,GHA,Finland,FIN,0,5,5,0,10
2000,Iran (Islamic Rep. of),IRN,Finland,FIN,0,13,5,11,29
2000,Iraq,IRQ,Finland,FIN,5,32,5,10,52
2000,Israel,ISR,Finland,FIN,0,5,0,0,5
2000,Kazakhstan,KAZ,Finland,FIN,0,0,0,5,5
2000,Lebanon,LBN,Finland,FIN,0,0,5,0,5
2000,Sri Lanka,LKA,Finland,FIN,0,5,5,5,15
2000,Lithuania,LTU,Finland,FIN,0,0,0,17,17
2000,Rep. of Moldova,MDA,Finland,FIN,0,0,5,0,5
2000,Pakistan,PAK,Finland,FIN,0,0,10,10,20
2000,Poland,POL,Finland,FIN,0,0,18,599,617
2000,Romania,ROU,Finland,FIN,0,0,0,10,10
2000,Russian Federation,RUS,Finland,FIN,0,5,20,43,68
2000,Serbia and Kosovo: S/RES/1244 (1999),SRB,Finland,FIN,0,158,48,16,222
2000,Somalia,SOM,Finland,FIN,0,99,20,10,129
2000,Sudan,SDN,Finland,FIN,0,0,5,0,5
2000,Slovakia,SVK,Finland,FIN,0,5,5,204,214
2000,Tajikistan,TJK,Finland,FIN,0,0,5,0,5
2000,Turkey,TUR,Finland,FIN,0,19,16,14,49
2000,Ukraine,UKR,Finland,FIN,0,5,0,10,15
2000,Stateless,XXA,Finland,FIN,0,15,42,5,62
2000,Unknown ,,Finland,FIN,0,0,5,0,5
2000,Afghanistan,AFG,France,FRA,156,0,48,0,204
2000,Albania,ALB,France,FRA,65,0,261,0,326
2000,Algeria,DZA,France,FRA,83,0,1662,0,1745
2000,Angola,AGO,France,FRA,115,0,248,0,363
2000,Egypt,EGY,France,FRA,0,0,5,0,5
2000,Armenia,ARM,France,FRA,60,0,222,0,282
2000,Azerbaijan,AZE,France,FRA,58,0,72,0,130
2000,Burundi,BDI,France,FRA,17,0,13,0,30
2000,Benin,BEN,France,FRA,0,0,13,0,13
2000,Bangladesh,BGD,France,FRA,142,0,899,0,1041
2000,Bhutan,BTN,France,FRA,5,0,5,0,10
2000,Belarus,BLR,France,FRA,16,0,72,0,88
2000,Bosnia and Herzegovina,BIH,France,FRA,123,0,136,0,259
2000,Bulgaria,BGR,France,FRA,5,0,80,0,85
2000,Cambodia,KHM,France,FRA,225,0,92,0,317
2000,Central African Rep.,CAF,France,FRA,17,0,49,0,66
2000,Chad,TCD,France,FRA,34,0,17,0,51
2000,China,CHN,France,FRA,27,0,4698,0,4725
2000,Chile,CHL,France,FRA,5,0,5,0,10
2000,Cameroon,CMR,France,FRA,10,0,47,0,57
2000,Congo,COG,France,FRA,95,0,395,0,490
2000,Dem. Rep. of the Congo,COD,France,FRA,353,0,502,0,855
2000,Comoros,COM,France,FRA,0,0,5,0,5
2000,Colombia,COL,France,FRA,19,0,99,0,118
2000,Cuba,CUB,France,FRA,5,0,18,0,23
2000,Cabo Verde,CPV,France,FRA,0,0,5,0,5
2000,Czechia,CZE,France,FRA,0,0,10,0,10
2000,Djibouti,DJI,France,FRA,5,0,5,0,10
2000,Ecuador,ECU,France,FRA,5,0,59,0,64
2000,Eritrea,ERI,France,FRA,5,0,0,0,5
2000,Ethiopia,ETH,France,FRA,19,0,10,0,29
2000,Gabon,GAB,France,FRA,0,0,5,0,5
2000,Gambia,GMB,France,FRA,5,0,0,0,5
2000,Palestinian,PSE,France,FRA,5,0,10,0,15
2000,Georgia,GEO,France,FRA,84,0,191,0,275
2000,Ghana,GHA,France,FRA,30,0,77,0,107
2000,Guinea-Bissau,GNB,France,FRA,60,0,61,0,121
2000,Guinea,GIN,France,FRA,21,0,68,0,89
2000,Haiti,HTI,France,FRA,82,0,1375,0,1457
2000,Croatia,HRV,France,FRA,5,0,15,0,20
2000,Cote d'Ivoire,CIV,France,FRA,5,0,39,0,44
2000,India,IND,France,FRA,42,0,472,0,514
2000,Iran (Islamic Rep. of),IRN,France,FRA,77,0,205,0,282
2000,Iraq,IRQ,France,FRA,139,0,158,0,297
2000,Israel,ISR,France,FRA,0,0,5,0,5
2000,Kazakhstan,KAZ,France,FRA,10,0,55,0,65
2000,Lao People's Dem. Rep.,LAO,France,FRA,71,0,17,0,88
2000,Liberia,LBR,France,FRA,10,0,10,0,20
2000,Libya,LBY,France,FRA,0,0,5,0,5
2000,Lebanon,LBN,France,FRA,10,0,40,0,50
2000,Sri Lanka,LKA,France,FRA,798,0,1048,0,1846
2000,Lithuania,LTU,France,FRA,0,0,16,0,16
2000,Latvia,LVA,France,FRA,5,0,13,0,18
2000,Mauritania,MRT,France,FRA,142,0,487,0,629
2000,North Macedonia,MKD,France,FRA,21,0,105,0,126
2000,Rep. of Moldova,MDA,France,FRA,21,0,961,0,982
2000,Mali,MLI,France,FRA,10,0,3064,0,3074
2000,Morocco,MAR,France,FRA,5,0,22,0,27
2000,Mauritius,MUS,France,FRA,0,0,16,0,16
2000,Myanmar,MMR,France,FRA,5,0,18,0,23
2000,Nepal,NPL,France,FRA,0,0,5,0,5
2000,Niger,NER,France,FRA,0,0,10,0,10
2000,Nigeria,NGA,France,FRA,11,0,208,0,219
2000,Pakistan,PAK,France,FRA,23,0,842,0,865
2000,Peru,PER,France,FRA,18,0,88,0,106
2000,Philippines,PHL,France,FRA,0,0,5,0,5
2000,Poland,POL,France,FRA,0,0,12,0,12
2000,Romania,ROU,France,FRA,5,0,358,0,363
2000,South Africa,ZAF,France,FRA,0,0,5,0,5
2000,Russian Federation,RUS,France,FRA,121,0,445,0,566
2000,Rwanda,RWA,France,FRA,291,0,62,0,353
2000,Serbia and Kosovo: S/RES/1244 (1999),SRB,France,FRA,405,0,1373,0,1778
2000,Senegal,SEN,France,FRA,5,0,56,0,61
2000,Sierra Leone,SLE,France,FRA,25,0,123,0,148
2000,Somalia,SOM,France,FRA,52,0,28,0,80
2000,Viet Nam,VNM,France,FRA,170,0,18,0,188
2000,Sudan,SDN,France,FRA,16,0,33,0,49
2000,Slovakia,SVK,France,FRA,13,0,20,0,33
2000,Syrian Arab Rep.,SYR,France,FRA,10,0,5,0,15
2000,Thailand,THA,France,FRA,0,0,5,0,5
2000,Tajikistan,TJK,France,FRA,5,0,13,0,18
2000,Togo,TGO,France,FRA,14,0,10,0,24
2000,Tunisia,TUN,France,FRA,21,0,20,0,41
2000,Turkey,TUR,France,FRA,523,0,2486,0,3009
2000,Ukraine,UKR,France,FRA,48,0,470,0,518
2000,Uzbekistan,UZB,France,FRA,5,0,10,0,15
2000,Venezuela (Bolivarian Republic of),VEN,France,FRA,0,0,5,0,5
2000,Stateless,XXA,France,FRA,68,0,45,0,113
2000,Unknown ,,France,FRA,10,0,16,0,26
2000,Bosnia and Herzegovina,BIH,Ghana,GHA,0,0,0,5,5
2000,Cameroon,CMR,Ghana,GHA,5,0,0,0,5
2000,Dem. Rep. of the Congo,COD,Ghana,GHA,5,0,0,0,5
2000,Liberia,LBR,Ghana,GHA,5,10,0,0,15
2000,Rwanda,RWA,Ghana,GHA,5,0,0,0,5
2000,Sierra Leone,SLE,Ghana,GHA,374,84,0,0,458
2000,Sudan,SDN,Ghana,GHA,5,0,0,0,5
2000,Togo,TGO,Ghana,GHA,36,14,13,0,63
2000,Afghanistan,AFG,Greece,GRC,69,0,89,0,158
2000,Albania,ALB,Greece,GRC,0,0,10,0,10
2000,Algeria,DZA,Greece,GRC,0,0,5,0,5
2000,Azerbaijan,AZE,Greece,GRC,0,0,13,0,13
2000,Burundi,BDI,Greece,GRC,5,0,5,0,10
2000,Bangladesh,BGD,Greece,GRC,5,0,31,0,36
2000,China,CHN,Greece,GRC,0,0,5,0,5
2000,Dem. Rep. of the Congo,COD,Greece,GRC,5,0,10,0,15
2000,Eritrea,ERI,Greece,GRC,0,0,5,0,5
2000,Ethiopia,ETH,Greece,GRC,0,0,5,0,5
2000,Palestinian,PSE,Greece,GRC,5,0,0,0,5
2000,Ghana,GHA,Greece,GRC,0,5,0,0,5
2000,India,IND,Greece,GRC,5,0,24,0,29
2000,Iran (Islamic Rep. of),IRN,Greece,GRC,31,41,26,0,98
2000,Iraq,IRQ,Greece,GRC,39,66,835,0,940
2000,Kazakhstan,KAZ,Greece,GRC,0,0,5,0,5
2000,Sri Lanka,LKA,Greece,GRC,0,5,12,0,17
2000,Myanmar,MMR,Greece,GRC,0,0,5,0,5
2000,Nigeria,NGA,Greece,GRC,5,0,5,0,10
2000,Pakistan,PAK,Greece,GRC,0,0,85,0,85
2000,Rwanda,RWA,Greece,GRC,0,0,5,0,5
2000,Serbia and Kosovo: S/RES/1244 (1999),SRB,Greece,GRC,0,5,0,0,5
2000,Sierra Leone,SLE,Greece,GRC,12,5,24,0,41
2000,Sudan,SDN,Greece,GRC,5,5,29,0,39
2000,Syrian Arab Rep.,SYR,Greece,GRC,0,5,0,0,5
2000,Turkey,TUR,Greece,GRC,30,23,333,0,386
2000,Burkina Faso,BFA,Guinea,GIN,5,0,0,0,5
2000,Chad,TCD,Guinea,GIN,12,0,0,0,12
2000,Dem. Rep. of the Congo,COD,Guinea,GIN,20,0,0,0,20
2000,Ghana,GHA,Guinea,GIN,5,0,0,0,5
2000,Liberia,LBR,Guinea,GIN,574,0,0,0,574
2000,Sierra Leone,SLE,Guinea,GIN,953,0,0,0,953
2000,Cuba,CUB,Honduras,HND,0,0,11,5,16
2000,Nigeria,NGA,Honduras,HND,0,0,0,5,5
2000,Peru,PER,Honduras,HND,0,0,0,5,5
2000,Armenia,ARM,Croatia,HRV,5,0,0,0,5
2000,India,IND,Croatia,HRV,0,0,0,5,5
2000,Serbia and Kosovo: S/RES/1244 (1999),SRB,Croatia,HRV,0,0,0,5,5
2000,Afghanistan,AFG,Hungary,HUN,82,176,389,1643,2290
2000,Algeria,DZA,Hungary,HUN,5,0,44,84,133
2000,Angola,AGO,Hungary,HUN,0,5,0,5,10
2000,Egypt,EGY,Hungary,HUN,0,0,16,11,27
2000,Armenia,ARM,Hungary,HUN,5,27,62,110,204
2000,Azerbaijan,AZE,Hungary,HUN,0,0,0,5,5
2000,Bangladesh,BGD,Hungary,HUN,0,0,1121,728,1849
2000,Bosnia and Herzegovina,BIH,Hungary,HUN,0,5,30,15,50
2000,Bulgaria,BGR,Hungary,HUN,0,0,0,5,5
2000,China,CHN,Hungary,HUN,0,0,58,136,194
2000,Cameroon,CMR,Hungary,HUN,10,5,32,14,61
2000,Dem. Rep. of the Congo,COD,Hungary,HUN,0,5,5,0,10
2000,Ethiopia,ETH,Hungary,HUN,5,0,5,5,15
2000,Palestinian,PSE,Hungary,HUN,0,0,16,17,33
2000,Georgia,GEO,Hungary,HUN,12,0,0,0,12
2000,Ghana,GHA,Hungary,HUN,0,0,13,20,33
2000,Guinea,GIN,Hungary,HUN,0,0,5,0,5
2000,Croatia,HRV,Hungary,HUN,0,0,0,5,5
2000,Cote d'Ivoire,CIV,Hungary,HUN,0,0,5,0,5
2000,India,IND,Hungary,HUN,0,0,42,195,237
2000,Iran (Islamic Rep. of),IRN,Hungary,HUN,0,5,28,36,69
2000,Iraq,IRQ,Hungary,HUN,37,47,247,425,756
2000,Jordan,JOR,Hungary,HUN,0,0,5,10,15
2000,Kazakhstan,KAZ,Hungary,HUN,0,0,0,5,5
2000,Liberia,LBR,Hungary,HUN,0,0,5,0,5
2000,Lebanon,LBN,Hungary,HUN,0,0,0,15,15
2000,Sri Lanka,LKA,Hungary,HUN,0,0,99,218,317
2000,North Macedonia,MKD,Hungary,HUN,0,0,0,5,5
2000,Rep. of Moldova,MDA,Hungary,HUN,0,0,17,18,35
2000,Mongolia,MNG,Hungary,HUN,0,0,0,5,5
2000,Morocco,MAR,Hungary,HUN,0,0,5,5,10
2000,Nepal,NPL,Hungary,HUN,0,0,5,0,5
2000,Nigeria,NGA,Hungary,HUN,5,0,57,57,119
2000,Pakistan,PAK,Hungary,HUN,0,0,64,208,272
2000,Philippines,PHL,Hungary,HUN,0,0,16,0,16
2000,Romania,ROU,Hungary,HUN,0,0,18,12,30
2000,Russian Federation,RUS,Hungary,HUN,5,5,19,13,42
2000,Serbia and Kosovo: S/RES/1244 (1999),SRB,Hungary,HUN,10,357,271,584,1222
2000,Senegal,SEN,Hungary,HUN,0,0,5,5,10
2000,Singapore,SGP,Hungary,HUN,0,0,5,0,5
2000,Sierra Leone,SLE,Hungary,HUN,0,11,42,112,165
2000,Somalia,SOM,Hungary,HUN,0,16,34,73,123
2000,Viet Nam,VNM,Hungary,HUN,0,0,26,28,54
2000,Sudan,SDN,Hungary,HUN,0,5,38,24,67
2000,Syrian Arab Rep.,SYR,Hungary,HUN,5,0,25,14,44
2000,Togo,TGO,Hungary,HUN,0,0,0,5,5
2000,Tunisia,TUN,Hungary,HUN,0,0,10,0,10
2000,Turkey,TUR,Hungary,HUN,0,0,53,58,111
2000,Ukraine,UKR,Hungary,HUN,5,0,32,10,47
2000,Albania,ALB,Iceland,ISL,0,0,5,0,5
2000,Ukraine,UKR,Iceland,ISL,0,0,12,0,12
2000,Burundi,BDI,Cote d'Ivoire,CIV,11,0,0,0,11
2000,Congo,COG,Cote d'Ivoire,CIV,113,0,5,0,118
2000,Dem. Rep. of the Congo,COD,Cote d'Ivoire,CIV,25,0,0,0,25
2000,Nigeria,NGA,Cote d'Ivoire,CIV,5,0,0,0,5
2000,Rwanda,RWA,Cote d'Ivoire,CIV,24,0,0,0,24
2000,Togo,TGO,Cote d'Ivoire,CIV,5,0,0,0,5
2000,Afghanistan,AFG,Ireland,IRL,5,0,5,0,10
2000,Albania,ALB,Ireland,IRL,0,0,30,5,35
2000,Algeria,DZA,Ireland,IRL,5,0,163,66,234
2000,Angola,AGO,Ireland,IRL,10,0,98,19,127
2000,Egypt,EGY,Ireland,IRL,5,0,10,0,15
2000,Armenia,ARM,Ireland,IRL,0,0,10,0,10
2000,Azerbaijan,AZE,Ireland,IRL,5,0,0,0,5
2000,Bahrain,BHR,Ireland,IRL,0,0,0,5,5
2000,Burundi,BDI,Ireland,IRL,0,0,5,0,5
2000,Belarus,BLR,Ireland,IRL,0,0,45,34,79
2000,Bulgaria,BGR,Ireland,IRL,0,0,96,14,110
2000,Central African Rep.,CAF,Ireland,IRL,0,0,10,0,10
2000,China,CHN,Ireland,IRL,0,0,5,5,10
2000,Cameroon,CMR,Ireland,IRL,0,0,19,0,19
2000,Congo,COG,Ireland,IRL,0,0,26,0,26
2000,Dem. Rep. of the Congo,COD,Ireland,IRL,34,0,175,52,261
2000,Czechia,CZE,Ireland,IRL,5,0,137,11,153
2000,Eritrea,ERI,Ireland,IRL,5,0,5,0,10
2000,Estonia,EST,Ireland,IRL,0,0,5,0,5
2000,Ethiopia,ETH,Ireland,IRL,0,0,5,0,5
2000,Palestinian,PSE,Ireland,IRL,5,0,0,0,5
2000,Georgia,GEO,Ireland,IRL,0,0,17,0,17
2000,Ghana,GHA,Ireland,IRL,0,0,18,5,23
2000,Croatia,HRV,Ireland,IRL,0,0,10,0,10
2000,Cote d'Ivoire,CIV,Ireland,IRL,0,0,18,0,18
2000,India,IND,Ireland,IRL,0,0,5,5,10
2000,Iran (Islamic Rep. of),IRN,Ireland,IRL,5,0,5,0,10
2000,Iraq,IRQ,Ireland,IRL,39,0,37,18,94
2000,Jordan,JOR,Ireland,IRL,0,0,5,0,5
2000,Kazakhstan,KAZ,Ireland,IRL,0,0,5,0,5
2000,Kenya,KEN,Ireland,IRL,5,0,19,5,29
2000,Liberia,LBR,Ireland,IRL,0,0,5,5,10
2000,Libya,LBY,Ireland,IRL,13,0,46,10,69
2000,Lebanon,LBN,Ireland,IRL,0,0,5,5,10
2000,Sri Lanka,LKA,Ireland,IRL,5,0,0,5,10
2000,Lithuania,LTU,Ireland,IRL,0,0,26,16,42
2000,Latvia,LVA,Ireland,IRL,0,0,26,5,31
2000,Rep. of Moldova,MDA,Ireland,IRL,0,0,176,92,268
2000,Morocco,MAR,Ireland,IRL,0,0,10,0,10
2000,Niger,NER,Ireland,IRL,0,0,5,0,5
2000,Nigeria,NGA,Ireland,IRL,5,0,1330,236,1571
2000,Pakistan,PAK,Ireland,IRL,0,0,43,5,48
2000,Poland,POL,Ireland,IRL,0,0,225,169,394
2000,Romania,ROU,Ireland,IRL,0,0,1231,499,1730
2000,South Africa,ZAF,Ireland,IRL,0,0,50,5,55
2000,Russian Federation,RUS,Ireland,IRL,5,0,97,28,130
2000,Rwanda,RWA,Ireland,IRL,0,0,16,5,21
2000,Serbia and Kosovo: S/RES/1244 (1999),SRB,Ireland,IRL,14,0,143,56,213
2000,Sierra Leone,SLE,Ireland,IRL,0,0,96,35,131
2000,Somalia,SOM,Ireland,IRL,14,0,76,23,113
2000,Sudan,SDN,Ireland,IRL,5,0,22,0,27
2000,Slovakia,SVK,Ireland,IRL,0,0,15,0,15
2000,Syrian Arab Rep.,SYR,Ireland,IRL,0,0,5,5,10
2000,United Rep. of Tanzania,TZA,Ireland,IRL,0,0,5,0,5
2000,Tajikistan,TJK,Ireland,IRL,0,0,5,0,5
2000,Togo,TGO,Ireland,IRL,5,0,11,5,21
2000,Turkey,TUR,Ireland,IRL,5,0,5,0,10
2000,Uganda,UGA,Ireland,IRL,0,0,5,0,5
2000,Ukraine,UKR,Ireland,IRL,5,0,95,33,133
2000,Uzbekistan,UZB,Ireland,IRL,0,0,5,0,5
2000,Zimbabwe,ZWE,Ireland,IRL,0,0,5,0,5
2000,Unknown ,,Ireland,IRL,0,0,0,2461,2461
2000,Afghanistan,AFG,Iran (Islamic Rep. of),IRN,82638,3925,147063,0,233626
2000,Afghanistan,AFG,Japan,JPN,5,12,5,5,27
2000,China,CHN,Japan,JPN,0,5,5,5,15
2000,Ethiopia,ETH,Japan,JPN,0,0,10,5,15
2000,Iran (Islamic Rep. of),IRN,Japan,JPN,5,0,10,5,20
2000,Iraq,IRQ,Japan,JPN,0,0,0,5,5
2000,Sri Lanka,LKA,Japan,JPN,0,0,5,5,10
2000,Myanmar,MMR,Japan,JPN,15,12,17,0,44
2000,Pakistan,PAK,Japan,JPN,0,0,65,11,76
2000,Sudan,SDN,Japan,JPN,0,5,11,0,16
2000,Turkey,TUR,Japan,JPN,0,0,5,5,10
2000,Unknown ,,Japan,JPN,0,10,0,0,10
2000,Afghanistan,AFG,Kazakhstan,KAZ,36,517,10,69,632
2000,Algeria,DZA,Kazakhstan,KAZ,5,0,0,0,5
2000,Afghanistan,AFG,Kyrgyzstan,KGZ,189,0,33,24,246
2000,China,CHN,Kyrgyzstan,KGZ,5,0,0,0,5
2000,Iran (Islamic Rep. of),IRN,Kyrgyzstan,KGZ,0,0,0,5,5
2000,Russian Federation,RUS,Kyrgyzstan,KGZ,0,0,0,93,93
2000,Tajikistan,TJK,Kyrgyzstan,KGZ,1526,0,110,5,1641
2000,Sierra Leone,SLE,Liberia,LBR,21,0,0,0,21
2000,Sudan,SDN,Liberia,LBR,5,0,0,0,5
2000,Afghanistan,AFG,Lithuania,LTU,0,0,10,51,61
2000,Bangladesh,BGD,Lithuania,LTU,0,0,0,5,5
2000,Palestinian,PSE,Lithuania,LTU,0,0,0,5,5
2000,Georgia,GEO,Lithuania,LTU,0,0,0,5,5
2000,India,IND,Lithuania,LTU,0,0,0,11,11
2000,Iran (Islamic Rep. of),IRN,Lithuania,LTU,0,0,10,0,10
2000,Iraq,IRQ,Lithuania,LTU,0,0,0,5,5
2000,Sri Lanka,LKA,Lithuania,LTU,0,0,0,10,10
2000,Pakistan,PAK,Lithuania,LTU,0,0,5,11,16
2000,Russian Federation,RUS,Lithuania,LTU,0,0,39,40,79
2000,Viet Nam,VNM,Lithuania,LTU,0,0,5,35,40
2000,Stateless,XXA,Lithuania,LTU,0,0,5,0,5
2000,Unknown ,,Luxembourg,LUX,17,42,1782,101,1942
2000,Chad,TCD,Mali,MLI,5,0,0,0,5
2000,Dem. Rep. of the Congo,COD,Mali,MLI,5,0,0,0,5
2000,Liberia,LBR,Mali,MLI,5,0,0,0,5
2000,Mauritania,MRT,Mali,MLI,5,0,5,0,10
2000,Rwanda,RWA,Mali,MLI,5,0,0,0,5
2000,Sierra Leone,SLE,Mali,MLI,131,0,5,0,136
2000,Unknown ,,Mali,MLI,0,0,5,0,5
2000,Dem. Rep. of the Congo,COD,Mozambique,MOZ,0,0,0,5,5
2000,Rwanda,RWA,Mozambique,MOZ,0,0,0,5,5
2000,Bhutan,BTN,Nepal,NPL,0,36,16,0,52
2000,China,CHN,Nepal,NPL,0,0,5,5,10
2000,Iraq,IRQ,Nepal,NPL,5,0,0,0,5
2000,Pakistan,PAK,Nepal,NPL,0,0,5,0,5
2000,Afghanistan,AFG,Netherlands,NLD,324,2345,205,2340,5214
2000,Albania,ALB,Netherlands,NLD,0,5,0,229,234
2000,Algeria,DZA,Netherlands,NLD,0,10,5,558,573
2000,Angola,AGO,Netherlands,NLD,10,530,21,1389,1950
2000,Egypt,EGY,Netherlands,NLD,0,0,0,34,34
2000,Armenia,ARM,Netherlands,NLD,0,40,10,1446,1496
2000,Azerbaijan,AZE,Netherlands,NLD,12,74,18,2713,2817
2000,Bahrain,BHR,Netherlands,NLD,0,0,0,5,5
2000,Burundi,BDI,Netherlands,NLD,13,144,0,157,314
2000,Benin,BEN,Netherlands,NLD,0,0,0,12,12
2000,Bangladesh,BGD,Netherlands,NLD,0,0,13,62,75
2000,Bhutan,BTN,Netherlands,NLD,0,0,0,5,5
2000,Burkina Faso,BFA,Netherlands,NLD,0,0,0,18,18
2000,Belarus,BLR,Netherlands,NLD,0,0,0,101,101
2000,Bosnia and Herzegovina,BIH,Netherlands,NLD,11,105,25,1872,2013
2000,Bulgaria,BGR,Netherlands,NLD,0,0,0,29,29
2000,Central African Rep.,CAF,Netherlands,NLD,0,0,0,5,5
2000,Chad,TCD,Netherlands,NLD,0,0,0,67,67
2000,China,CHN,Netherlands,NLD,0,403,11,909,1323
2000,Cameroon,CMR,Netherlands,NLD,0,5,5,176,186
2000,Congo,COG,Netherlands,NLD,10,67,31,737,845
2000,Dem. Rep. of the Congo,COD,Netherlands,NLD,11,50,5,501,567
2000,Comoros,COM,Netherlands,NLD,0,0,0,5,5
2000,Colombia,COL,Netherlands,NLD,5,0,0,28,33
2000,Cuba,CUB,Netherlands,NLD,0,0,0,25,25
2000,Czechia,CZE,Netherlands,NLD,0,0,0,239,239
2000,Ecuador,ECU,Netherlands,NLD,0,0,0,5,5
2000,Equatorial Guinea,GNQ,Netherlands,NLD,0,0,0,5,5
2000,Eritrea,ERI,Netherlands,NLD,0,16,0,291,307
2000,Ethiopia,ETH,Netherlands,NLD,0,28,5,228,261
2000,France,FRA,Netherlands,NLD,0,0,0,10,10
2000,Gambia,GMB,Netherlands,NLD,0,0,0,10,10
2000,Palestinian,PSE,Netherlands,NLD,0,0,0,20,20
2000,United Kingdom of Great Britain and Northern Ireland,GBR,Netherlands,NLD,0,0,0,5,5
2000,Georgia,GEO,Netherlands,NLD,0,24,10,329,363
2000,Germany,DEU,Netherlands,NLD,0,0,0,10,10
2000,Ghana,GHA,Netherlands,NLD,0,0,0,29,29
2000,Guinea-Bissau,GNB,Netherlands,NLD,0,5,0,5,10
2000,Guinea,GIN,Netherlands,NLD,0,167,5,629,801
2000,Haiti,HTI,Netherlands,NLD,0,0,0,5,5
2000,Honduras,HND,Netherlands,NLD,0,5,0,0,5
2000,Croatia,HRV,Netherlands,NLD,5,0,0,163,168
2000,Hungary,HUN,Netherlands,NLD,0,0,0,31,31
2000,Cote d'Ivoire,CIV,Netherlands,NLD,0,5,0,52,57
2000,India,IND,Netherlands,NLD,0,0,10,70,80
2000,Indonesia,IDN,Netherlands,NLD,0,0,0,54,54
2000,Iran (Islamic Rep. of),IRN,Netherlands,NLD,33,94,51,2535,2713
2000,Iraq,IRQ,Netherlands,NLD,58,105,67,4319,4549
2000,Israel,ISR,Netherlands,NLD,0,0,0,16,16
2000,Jordan,JOR,Netherlands,NLD,0,0,0,21,21
2000,Kazakhstan,KAZ,Netherlands,NLD,0,10,5,170,185
2000,Kenya,KEN,Netherlands,NLD,0,0,5,24,29
2000,Kyrgyzstan,KGZ,Netherlands,NLD,0,0,0,81,81
2000,Rep. of Korea,KOR,Netherlands,NLD,0,0,0,5,5
2000,Dem. People's Rep. of Korea,PRK,Netherlands,NLD,0,0,0,5,5
2000,Kuwait,KWT,Netherlands,NLD,0,0,0,10,10
2000,Liberia,LBR,Netherlands,NLD,0,20,0,199,219
2000,Libya,LBY,Netherlands,NLD,0,0,5,103,108
2000,Lebanon,LBN,Netherlands,NLD,0,5,0,128,133
2000,Sri Lanka,LKA,Netherlands,NLD,5,15,29,1186,1235
2000,Lithuania,LTU,Netherlands,NLD,0,0,0,14,14
2000,Latvia,LVA,Netherlands,NLD,0,0,0,10,10
2000,Mauritania,MRT,Netherlands,NLD,0,17,0,71,88
2000,North Macedonia,MKD,Netherlands,NLD,0,0,0,77,77
2000,Rep. of Moldova,MDA,Netherlands,NLD,0,0,0,31,31
2000,Mali,MLI,Netherlands,NLD,0,0,0,10,10
2000,Mongolia,MNG,Netherlands,NLD,0,0,0,284,284
2000,Morocco,MAR,Netherlands,NLD,0,0,0,42,42
2000,Myanmar,MMR,Netherlands,NLD,0,5,0,18,23
2000,Nepal,NPL,Netherlands,NLD,0,0,0,89,89
2000,Netherlands,NLD,Netherlands,NLD,0,0,0,12,12
2000,Niger,NER,Netherlands,NLD,0,21,0,64,85
2000,Nicaragua,NIC,Netherlands,NLD,0,0,0,5,5
2000,Nigeria,NGA,Netherlands,NLD,0,10,23,297,330
2000,Pakistan,PAK,Netherlands,NLD,5,5,5,160,175
2000,Peru,PER,Netherlands,NLD,0,0,0,5,5
2000,Poland,POL,Netherlands,NLD,0,0,0,58,58
2000,Qatar,QAT,Netherlands,NLD,0,0,0,5,5
2000,Romania,ROU,Netherlands,NLD,0,0,0,69,69
2000,South Africa,ZAF,Netherlands,NLD,0,0,0,10,10
2000,Russian Federation,RUS,Netherlands,NLD,5,39,10,1254,1308
2000,Rwanda,RWA,Netherlands,NLD,37,157,5,218,417
2000,Serbia and Kosovo: S/RES/1244 (1999),SRB,Netherlands,NLD,224,158,73,6221,6676
2000,Senegal,SEN,Netherlands,NLD,0,0,0,22,22
2000,Sierra Leone,SLE,Netherlands,NLD,0,246,17,1197,1460
2000,Somalia,SOM,Netherlands,NLD,5,589,20,2620,3234
2000,Viet Nam,VNM,Netherlands,NLD,0,0,0,54,54
2000,Sudan,SDN,Netherlands,NLD,34,293,28,1617,1972
2000,Suriname,SUR,Netherlands,NLD,0,0,0,5,5
2000,Slovakia,SVK,Netherlands,NLD,0,5,24,989,1018
2000,Slovenia,SVN,Netherlands,NLD,0,0,0,5,5
2000,Syrian Arab Rep.,SYR,Netherlands,NLD,43,23,27,1089,1182
2000,United Rep. of Tanzania,TZA,Netherlands,NLD,0,0,0,5,5
2000,Tajikistan,TJK,Netherlands,NLD,0,10,0,24,34
2000,Togo,TGO,Netherlands,NLD,0,24,5,237,266
2000,Tunisia,TUN,Netherlands,NLD,5,0,0,29,34
2000,Turkey,TUR,Netherlands,NLD,11,10,38,2597,2656
2000,Uganda,UGA,Netherlands,NLD,0,5,0,36,41
2000,Ukraine,UKR,Netherlands,NLD,0,5,0,286,291
2000,United States of America,USA,Netherlands,NLD,0,0,0,5,5
2000,Uzbekistan,UZB,Netherlands,NLD,0,10,0,134,144
2000,Yemen,YEM,Netherlands,NLD,0,5,0,66,71
2000,Zimbabwe,ZWE,Netherlands,NLD,0,0,0,12,12
2000,Stateless,XXA,Netherlands,NLD,5,24,28,879,936
2000,Unknown ,,Netherlands,NLD,5,15,5,368,393
2000,Cuba,CUB,Nicaragua,NIC,0,0,0,5,5
2000,Ghana,GHA,Nicaragua,NIC,0,0,0,5,5
2000,Nigeria,NGA,Nicaragua,NIC,0,0,0,5,5
2000,Somalia,SOM,Nicaragua,NIC,0,0,0,5,5
2000,Chad,TCD,Nigeria,NGA,0,0,5,0,5
2000,Cameroon,CMR,Nigeria,NGA,0,0,5,0,5
2000,Congo,COG,Nigeria,NGA,0,0,66,0,66
2000,Liberia,LBR,Nigeria,NGA,19,0,53,0,72
2000,Sierra Leone,SLE,Nigeria,NGA,299,0,13,0,312
2000,Sudan,SDN,Nigeria,NGA,5,0,5,0,10
2000,Unknown ,,Nigeria,NGA,5,0,31,0,36
2000,Afghanistan,AFG,Norway,NOR,16,104,519,17,656
2000,Albania,ALB,Norway,NOR,0,0,92,5,97
2000,Algeria,DZA,Norway,NOR,5,5,26,11,47
2000,Egypt,EGY,Norway,NOR,0,0,5,0,5
2000,Armenia,ARM,Norway,NOR,0,5,62,5,72
2000,Azerbaijan,AZE,Norway,NOR,0,5,33,0,38
2000,Burundi,BDI,Norway,NOR,0,0,5,0,5
2000,Bangladesh,BGD,Norway,NOR,0,0,19,0,19
2000,Belarus,BLR,Norway,NOR,0,5,63,20,88
2000,Bosnia and Herzegovina,BIH,Norway,NOR,0,32,171,31,234
2000,Bulgaria,BGR,Norway,NOR,0,0,0,5,5
2000,China,CHN,Norway,NOR,0,0,5,0,5
2000,Chile,CHL,Norway,NOR,0,0,5,0,5
2000,Cameroon,CMR,Norway,NOR,0,5,25,0,30
2000,Congo,COG,Norway,NOR,0,5,5,0,10
2000,Dem. Rep. of the Congo,COD,Norway,NOR,0,0,5,0,5
2000,Colombia,COL,Norway,NOR,0,52,10,15,77
2000,Czechia,CZE,Norway,NOR,0,0,18,5,23
2000,Eritrea,ERI,Norway,NOR,0,16,20,5,41
2000,Estonia,EST,Norway,NOR,0,0,13,0,13
2000,Ethiopia,ETH,Norway,NOR,0,37,50,10,97
2000,France,FRA,Norway,NOR,0,0,5,0,5
2000,Georgia,GEO,Norway,NOR,0,0,39,11,50
2000,Croatia,HRV,Norway,NOR,5,44,10,0,59
2000,Hungary,HUN,Norway,NOR,0,0,5,0,5
2000,India,IND,Norway,NOR,0,0,12,0,12
2000,Iran (Islamic Rep. of),IRN,Norway,NOR,19,33,244,28,324
2000,Iraq,IRQ,Norway,NOR,0,1358,110,2145,3613
2000,Israel,ISR,Norway,NOR,0,0,5,5,10
2000,Jordan,JOR,Norway,NOR,0,0,5,0,5
2000,Kazakhstan,KAZ,Norway,NOR,0,0,5,10,15
2000,Kenya,KEN,Norway,NOR,0,0,5,0,5
2000,Kyrgyzstan,KGZ,Norway,NOR,0,0,5,0,5
2000,Liberia,LBR,Norway,NOR,0,0,10,0,10
2000,Lebanon,LBN,Norway,NOR,0,0,35,5,40
2000,Sri Lanka,LKA,Norway,NOR,0,51,188,10,249
2000,Lithuania,LTU,Norway,NOR,0,0,95,36,131
2000,Latvia,LVA,Norway,NOR,0,0,41,10,51
2000,North Macedonia,MKD,Norway,NOR,0,0,19,0,19
2000,Rep. of Moldova,MDA,Norway,NOR,0,5,45,5,55
2000,Morocco,MAR,Norway,NOR,0,0,11,0,11
2000,Nepal,NPL,Norway,NOR,0,0,5,0,5
2000,Nicaragua,NIC,Norway,NOR,0,0,5,0,5
2000,Nigeria,NGA,Norway,NOR,0,0,10,0,10
2000,Pakistan,PAK,Norway,NOR,0,5,175,18,198
2000,Poland,POL,Norway,NOR,0,0,50,5,55
2000,Romania,ROU,Norway,NOR,0,0,296,55,351
2000,Russian Federation,RUS,Norway,NOR,5,10,179,75,269
2000,Rwanda,RWA,Norway,NOR,0,0,10,0,10
2000,Serbia and Kosovo: S/RES/1244 (1999),SRB,Norway,NOR,25,69,1150,176,1420
2000,Sierra Leone,SLE,Norway,NOR,0,5,23,0,28
2000,Somalia,SOM,Norway,NOR,0,954,173,61,1188
2000,Sudan,SDN,Norway,NOR,0,18,37,0,55
2000,Slovakia,SVK,Norway,NOR,10,5,290,72,377
2000,Slovenia,SVN,Norway,NOR,0,0,0,5,5
2000,Syrian Arab Rep.,SYR,Norway,NOR,0,5,49,5,59
2000,Tajikistan,TJK,Norway,NOR,5,0,5,0,10
2000,Tunisia,TUN,Norway,NOR,0,0,5,0,5
2000,Turkey,TUR,Norway,NOR,0,11,221,34,266
2000,Ukraine,UKR,Norway,NOR,0,0,37,5,42
2000,Stateless,XXA,Norway,NOR,0,5,124,10,139
2000,Unknown ,,New Zealand,NZL,235,0,2638,0,2873
2000,Colombia,COL,Panama,PAN,0,122,31,5,158
2000,Nigeria,NGA,Panama,PAN,0,0,0,5,5
2000,Sri Lanka,LKA,Philippines,PHL,5,0,0,0,5
2000,Afghanistan,AFG,Poland,POL,0,0,10,392,402
2000,Algeria,DZA,Poland,POL,0,0,10,10,20
2000,Armenia,ARM,Poland,POL,0,0,736,68,804
2000,Azerbaijan,AZE,Poland,POL,0,0,27,26,53
2000,Bangladesh,BGD,Poland,POL,0,0,5,5,10
2000,Belarus,BLR,Poland,POL,0,0,14,18,32
2000,Bosnia and Herzegovina,BIH,Poland,POL,0,0,0,5,5
2000,Bulgaria,BGR,Poland,POL,0,0,345,17,362
2000,Cameroon,CMR,Poland,POL,5,0,0,5,10
2000,Ethiopia,ETH,Poland,POL,5,0,0,0,5
2000,Georgia,GEO,Poland,POL,5,0,31,12,48
2000,India,IND,Poland,POL,0,0,10,17,27
2000,Iraq,IRQ,Poland,POL,0,0,5,30,35
2000,Kazakhstan,KAZ,Poland,POL,0,0,10,10,20
2000,Lebanon,LBN,Poland,POL,0,0,0,5,5
2000,Sri Lanka,LKA,Poland,POL,0,0,20,69,89
2000,Lithuania,LTU,Poland,POL,0,0,0,66,66
2000,Latvia,LVA,Poland,POL,0,0,0,10,10
2000,Rep. of Moldova,MDA,Poland,POL,0,0,5,10,15
2000,Mongolia,MNG,Poland,POL,0,0,112,5,117
2000,Nigeria,NGA,Poland,POL,0,0,0,5,5
2000,Pakistan,PAK,Poland,POL,0,0,5,38,43
2000,Romania,ROU,Poland,POL,0,0,933,10,943
2000,Russian Federation,RUS,Poland,POL,26,0,63,209,298
2000,Serbia and Kosovo: S/RES/1244 (1999),SRB,Poland,POL,0,0,17,76,93
2000,Somalia,SOM,Poland,POL,5,0,0,5,10
2000,Viet Nam,VNM,Poland,POL,0,0,101,10,111
2000,Slovakia,SVK,Poland,POL,0,0,5,0,5
2000,Syrian Arab Rep.,SYR,Poland,POL,0,0,0,5,5
2000,Tajikistan,TJK,Poland,POL,0,0,0,5,5
2000,Turkey,TUR,Poland,POL,0,0,0,11,11
2000,Ukraine,UKR,Poland,POL,0,0,36,13,49
2000,Stateless,XXA,Poland,POL,0,0,5,17,22
2000,Unknown ,,Poland,POL,0,0,0,5,5
2000,Angola,AGO,Portugal,PRT,0,5,5,10,20
2000,Armenia,ARM,Portugal,PRT,0,0,0,5,5
2000,Dem. Rep. of the Congo,COD,Portugal,PRT,0,0,0,12,12
2000,Gambia,GMB,Portugal,PRT,0,0,0,5,5
2000,Palestinian,PSE,Portugal,PRT,0,0,0,5,5
2000,Ghana,GHA,Portugal,PRT,0,0,0,5,5
2000,Guinea-Bissau,GNB,Portugal,PRT,5,0,0,5,10
2000,Guinea,GIN,Portugal,PRT,0,0,0,5,5
2000,Liberia,LBR,Portugal,PRT,0,0,0,5,5
2000,Nigeria,NGA,Portugal,PRT,0,0,0,16,16
2000,Pakistan,PAK,Portugal,PRT,0,0,0,5,5
2000,Russian Federation,RUS,Portugal,PRT,0,0,0,5,5
2000,Rwanda,RWA,Portugal,PRT,5,0,5,0,10
2000,Serbia and Kosovo: S/RES/1244 (1999),SRB,Portugal,PRT,0,0,0,5,5
2000,Sierra Leone,SLE,Portugal,PRT,0,34,16,55,105
2000,Slovakia,SVK,Portugal,PRT,0,0,0,5,5
2000,Afghanistan,AFG,Romania,ROU,27,35,191,0,253
2000,Algeria,DZA,Romania,ROU,0,0,10,0,10
2000,Egypt,EGY,Romania,ROU,0,0,13,5,18
2000,Bangladesh,BGD,Romania,ROU,0,0,276,0,276
2000,Cameroon,CMR,Romania,ROU,0,0,5,0,5
2000,Dem. Rep. of the Congo,COD,Romania,ROU,0,0,5,0,5
2000,Eritrea,ERI,Romania,ROU,0,0,5,0,5
2000,Palestinian,PSE,Romania,ROU,0,0,53,0,53
2000,Guinea,GIN,Romania,ROU,0,0,5,0,5
2000,India,IND,Romania,ROU,0,0,41,0,41
2000,Iran (Islamic Rep. of),IRN,Romania,ROU,0,15,43,10,68
2000,Iraq,IRQ,Romania,ROU,40,11,244,0,295
2000,Jordan,JOR,Romania,ROU,0,0,5,0,5
2000,Sri Lanka,LKA,Romania,ROU,0,0,10,0,10
2000,Morocco,MAR,Romania,ROU,0,0,5,0,5
2000,Nigeria,NGA,Romania,ROU,0,0,5,0,5
2000,Pakistan,PAK,Romania,ROU,0,0,173,13,186
2000,Rwanda,RWA,Romania,ROU,0,0,5,0,5
2000,Serbia and Kosovo: S/RES/1244 (1999),SRB,Romania,ROU,0,0,10,5,15
2000,Sierra Leone,SLE,Romania,ROU,5,0,19,0,24
2000,Somalia,SOM,Romania,ROU,0,19,22,0,41
2000,Sudan,SDN,Romania,ROU,5,0,65,5,75
2000,Syrian Arab Rep.,SYR,Romania,ROU,0,0,17,0,17
2000,Turkey,TUR,Romania,ROU,5,0,29,5,39
2000,Algeria,DZA,South Africa,ZAF,0,0,5,0,5
2000,Angola,AGO,South Africa,ZAF,0,81,5,0,86
2000,Burundi,BDI,South Africa,ZAF,0,126,0,0,126
2000,Bangladesh,BGD,South Africa,ZAF,0,0,193,0,193
2000,Bulgaria,BGR,South Africa,ZAF,0,0,10,0,10
2000,China,CHN,South Africa,ZAF,0,0,125,0,125
2000,Cameroon,CMR,South Africa,ZAF,0,0,231,0,231
2000,Congo,COG,South Africa,ZAF,0,36,0,0,36
2000,Dem. Rep. of the Congo,COD,South Africa,ZAF,0,199,17,0,216
2000,Comoros,COM,South Africa,ZAF,0,0,5,0,5
2000,Ethiopia,ETH,South Africa,ZAF,0,0,454,0,454
2000,Ghana,GHA,South Africa,ZAF,0,0,270,0,270
2000,Cote d'Ivoire,CIV,South Africa,ZAF,0,0,130,0,130
2000,India,IND,South Africa,ZAF,0,0,670,0,670
2000,Kenya,KEN,South Africa,ZAF,0,0,231,0,231
2000,Mali,MLI,South Africa,ZAF,0,0,274,0,274
2000,Nigeria,NGA,South Africa,ZAF,0,0,1102,0,1102
2000,Pakistan,PAK,South Africa,ZAF,0,0,309,0,309
2000,Rwanda,RWA,South Africa,ZAF,0,10,91,0,101
2000,Serbia and Kosovo: S/RES/1244 (1999),SRB,South Africa,ZAF,0,5,33,0,38
2000,Senegal,SEN,South Africa,ZAF,0,0,179,0,179
2000,Somalia,SOM,South Africa,ZAF,0,82,15,0,97
2000,Sudan,SDN,South Africa,ZAF,0,10,43,0,53
2000,United Rep. of Tanzania,TZA,South Africa,ZAF,0,0,328,0,328
2000,Uganda,UGA,South Africa,ZAF,0,0,28,0,28
2000,Zambia,ZMB,South Africa,ZAF,0,0,20,0,20
2000,Afghanistan,AFG,Russian Federation,RUS,160,0,1317,0,1477
2000,Angola,AGO,Russian Federation,RUS,0,0,5,0,5
2000,Azerbaijan,AZE,Russian Federation,RUS,33,0,10,0,43
2000,Dem. Rep. of the Congo,COD,Russian Federation,RUS,0,0,5,0,5
2000,Ethiopia,ETH,Russian Federation,RUS,0,0,5,0,5
2000,Georgia,GEO,Russian Federation,RUS,11,0,47,0,58
2000,Iraq,IRQ,Russian Federation,RUS,0,0,71,0,71
2000,Kazakhstan,KAZ,Russian Federation,RUS,30,0,21,0,51
2000,Kyrgyzstan,KGZ,Russian Federation,RUS,10,0,0,0,10
2000,Nigeria,NGA,Russian Federation,RUS,0,0,14,0,14
2000,Rwanda,RWA,Russian Federation,RUS,0,0,10,0,10
2000,Somalia,SOM,Russian Federation,RUS,0,0,11,0,11
2000,Tajikistan,TJK,Russian Federation,RUS,10,0,0,0,10
2000,Turkmenistan,TKM,Russian Federation,RUS,0,0,5,0,5
2000,Uzbekistan,UZB,Russian Federation,RUS,18,0,17,0,35
2000,Unknown ,,Russian Federation,RUS,0,0,78,0,78
2000,Burundi,BDI,Senegal,SEN,0,0,5,0,5
2000,Chad,TCD,Senegal,SEN,0,0,5,0,5
2000,Cameroon,CMR,Senegal,SEN,0,0,5,0,5
2000,Congo,COG,Senegal,SEN,0,0,12,0,12
2000,Dem. Rep. of the Congo,COD,Senegal,SEN,5,0,16,0,21
2000,Gambia,GMB,Senegal,SEN,5,0,0,0,5
2000,Guinea-Bissau,GNB,Senegal,SEN,0,0,5,530,535
2000,Liberia,LBR,Senegal,SEN,11,0,18,0,29
2000,Nigeria,NGA,Senegal,SEN,0,0,10,0,10
2000,Rwanda,RWA,Senegal,SEN,0,0,13,0,13
2000,Sierra Leone,SLE,Senegal,SEN,5,0,157,0,162
2000,Togo,TGO,Senegal,SEN,0,0,5,0,5
2000,Afghanistan,AFG,Spain,ESP,32,0,5,0,37
2000,Albania,ALB,Spain,ESP,0,10,0,5,15
2000,Algeria,DZA,Spain,ESP,14,29,234,220,497
2000,Angola,AGO,Spain,ESP,10,19,24,15,68
2000,Armenia,ARM,Spain,ESP,21,36,399,404,860
2000,Azerbaijan,AZE,Spain,ESP,0,5,24,31,60
2000,Burundi,BDI,Spain,ESP,0,0,5,0,5
2000,Bangladesh,BGD,Spain,ESP,0,0,5,90,95
2000,Belarus,BLR,Spain,ESP,10,0,0,25,35
2000,Bosnia and Herzegovina,BIH,Spain,ESP,0,0,0,90,90
2000,Bulgaria,BGR,Spain,ESP,0,0,0,5,5
2000,Central African Rep.,CAF,Spain,ESP,0,0,5,0,5
2000,China,CHN,Spain,ESP,0,0,0,5,5
2000,Cameroon,CMR,Spain,ESP,0,5,5,10,20
2000,Congo,COG,Spain,ESP,0,5,15,5,25
2000,Dem. Rep. of the Congo,COD,Spain,ESP,20,5,91,26,142
2000,Colombia,COL,Spain,ESP,115,70,159,317,661
2000,Cuba,CUB,Spain,ESP,16,0,100,589,705
2000,Czechia,CZE,Spain,ESP,0,0,0,17,17
2000,Ecuador,ECU,Spain,ESP,0,0,5,36,41
2000,Equatorial Guinea,GNQ,Spain,ESP,29,11,37,0,77
2000,Estonia,EST,Spain,ESP,0,0,0,5,5
2000,Ethiopia,ETH,Spain,ESP,5,0,5,0,10
2000,Georgia,GEO,Spain,ESP,5,5,100,121,231
2000,Ghana,GHA,Spain,ESP,0,0,0,52,52
2000,Guinea-Bissau,GNB,Spain,ESP,0,0,0,15,15
2000,Guinea,GIN,Spain,ESP,0,5,0,16,21
2000,Croatia,HRV,Spain,ESP,0,0,0,5,5
2000,Hungary,HUN,Spain,ESP,0,0,0,5,5
2000,Cote d'Ivoire,CIV,Spain,ESP,0,0,0,5,5
2000,India,IND,Spain,ESP,0,0,5,42,47
2000,Iran (Islamic Rep. of),IRN,Spain,ESP,5,5,10,40,60
2000,Iraq,IRQ,Spain,ESP,0,10,31,59,100
2000,Liberia,LBR,Spain,ESP,0,0,10,39,49
2000,Lebanon,LBN,Spain,ESP,0,0,0,5,5
2000,Sri Lanka,LKA,Spain,ESP,0,0,0,5,5
2000,Lithuania,LTU,Spain,ESP,0,0,0,5,5
2000,Latvia,LVA,Spain,ESP,0,0,0,5,5
2000,Mauritania,MRT,Spain,ESP,5,5,21,11,42
2000,Rep. of Moldova,MDA,Spain,ESP,5,0,5,55,65
2000,Mali,MLI,Spain,ESP,0,0,0,5,5
2000,Morocco,MAR,Spain,ESP,0,12,44,32,88
2000,Nigeria,NGA,Spain,ESP,0,0,31,650,681
2000,Pakistan,PAK,Spain,ESP,0,0,11,64,75
2000,Peru,PER,Spain,ESP,5,0,12,5,22
2000,Philippines,PHL,Spain,ESP,0,0,0,5,5
2000,Poland,POL,Spain,ESP,0,0,0,10,10
2000,Romania,ROU,Spain,ESP,0,0,11,466,477
2000,Russian Federation,RUS,Spain,ESP,48,56,68,200,372
2000,Rwanda,RWA,Spain,ESP,5,5,5,0,15
2000,El Salvador,SLV,Spain,ESP,0,0,0,11,11
2000,Serbia and Kosovo: S/RES/1244 (1999),SRB,Spain,ESP,5,13,129,143,290
2000,Senegal,SEN,Spain,ESP,0,0,5,10,15
2000,Sierra Leone,SLE,Spain,ESP,0,37,136,669,842
2000,Somalia,SOM,Spain,ESP,0,26,5,10,41
2000,Sudan,SDN,Spain,ESP,0,0,15,17,32
2000,Slovakia,SVK,Spain,ESP,0,0,0,5,5
2000,Syrian Arab Rep.,SYR,Spain,ESP,0,0,11,10,21
2000,Turkey,TUR,Spain,ESP,0,0,5,5,10
2000,Ukraine,UKR,Spain,ESP,10,10,23,214,257
2000,Uzbekistan,UZB,Spain,ESP,0,0,0,5,5
2000,Venezuela (Bolivarian Republic of),VEN,Spain,ESP,0,0,0,5,5
2000,Stateless,XXA,Spain,ESP,0,0,5,10,15
2000,Afghanistan,AFG,Slovakia,SVK,5,0,28,559,592
2000,Algeria,DZA,Slovakia,SVK,0,0,5,0,5
2000,Armenia,ARM,Slovakia,SVK,0,0,15,5,20
2000,Azerbaijan,AZE,Slovakia,SVK,0,0,5,0,5
2000,Bangladesh,BGD,Slovakia,SVK,0,0,5,52,57
2000,Ethiopia,ETH,Slovakia,SVK,0,0,0,5,5
2000,India,IND,Slovakia,SVK,0,0,10,399,409
2000,Iran (Islamic Rep. of),IRN,Slovakia,SVK,0,0,0,11,11
2000,Iraq,IRQ,Slovakia,SVK,0,0,5,98,103
2000,Sri Lanka,LKA,Slovakia,SVK,0,0,0,56,56
2000,Morocco,MAR,Slovakia,SVK,0,0,0,5,5
2000,Myanmar,MMR,Slovakia,SVK,0,0,0,5,5
2000,Nepal,NPL,Slovakia,SVK,0,0,0,5,5
2000,Pakistan,PAK,Slovakia,SVK,0,0,18,127,145
2000,Russian Federation,RUS,Slovakia,SVK,0,0,5,5,10
2000,Serbia and Kosovo: S/RES/1244 (1999),SRB,Slovakia,SVK,0,0,27,31,58
2000,Ukraine,UKR,Slovakia,SVK,0,0,5,0,5
2000,Afghanistan,AFG,Slovenia,SVN,0,0,0,11,11
2000,Algeria,DZA,Slovenia,SVN,0,0,10,0,10
2000,Armenia,ARM,Slovenia,SVN,0,0,0,40,40
2000,Bangladesh,BGD,Slovenia,SVN,0,0,13,31,44
2000,Belarus,BLR,Slovenia,SVN,0,0,5,0,5
2000,Bosnia and Herzegovina,BIH,Slovenia,SVN,0,0,0,18,18
2000,Cameroon,CMR,Slovenia,SVN,0,0,0,5,5
2000,Ghana,GHA,Slovenia,SVN,0,0,0,17,17
2000,Croatia,HRV,Slovenia,SVN,0,0,0,10,10
2000,India,IND,Slovenia,SVN,0,0,0,5,5
2000,Iran (Islamic Rep. of),IRN,Slovenia,SVN,0,0,62,228,290
2000,Iraq,IRQ,Slovenia,SVN,0,0,0,35,35
2000,Rep. of Moldova,MDA,Slovenia,SVN,0,0,0,16,16
2000,Malaysia,MYS,Slovenia,SVN,0,0,0,5,5
2000,Pakistan,PAK,Slovenia,SVN,0,0,0,24,24
2000,Russian Federation,RUS,Slovenia,SVN,0,0,0,5,5
2000,Serbia and Kosovo: S/RES/1244 (1999),SRB,Slovenia,SVN,0,5,33,272,310
2000,Sierra Leone,SLE,Slovenia,SVN,0,0,0,16,16
2000,Somalia,SOM,Slovenia,SVN,0,0,0,5,5
2000,Sudan,SDN,Slovenia,SVN,0,0,0,11,11
2000,Togo,TGO,Slovenia,SVN,0,0,0,5,5
2000,Turkey,TUR,Slovenia,SVN,0,0,0,108,108
2000,Unknown ,,Slovenia,SVN,0,5,0,0,5
2000,Afghanistan,AFG,Sweden,SWE,33,563,78,13,687
2000,Albania,ALB,Sweden,SWE,0,0,57,5,62
2000,Algeria,DZA,Sweden,SWE,0,0,47,5,52
2000,Egypt,EGY,Sweden,SWE,0,0,21,5,26
2000,Armenia,ARM,Sweden,SWE,0,19,171,10,200
2000,Azerbaijan,AZE,Sweden,SWE,0,0,34,0,34
2000,Bahrain,BHR,Sweden,SWE,10,0,5,0,15
2000,Burundi,BDI,Sweden,SWE,0,5,0,0,5
2000,Bangladesh,BGD,Sweden,SWE,0,5,47,5,57
2000,Belarus,BLR,Sweden,SWE,0,0,115,29,144
2000,Bolivia (Plurinational State of),BOL,Sweden,SWE,0,0,42,5,47
2000,Bosnia and Herzegovina,BIH,Sweden,SWE,124,78,1068,35,1305
2000,Bulgaria,BGR,Sweden,SWE,0,0,13,0,13
2000,China,CHN,Sweden,SWE,5,0,28,10,43
2000,Chile,CHL,Sweden,SWE,0,5,32,5,42
2000,Cameroon,CMR,Sweden,SWE,0,0,5,0,5
2000,Dem. Rep. of the Congo,COD,Sweden,SWE,0,19,30,0,49
2000,Colombia,COL,Sweden,SWE,5,5,34,0,44
2000,Cuba,CUB,Sweden,SWE,0,0,12,5,17
2000,Czechia,CZE,Sweden,SWE,0,0,24,0,24
2000,Ecuador,ECU,Sweden,SWE,0,0,90,15,105
2000,Eritrea,ERI,Sweden,SWE,0,25,41,0,66
2000,Estonia,EST,Sweden,SWE,0,0,17,0,17
2000,Ethiopia,ETH,Sweden,SWE,14,16,39,0,69
2000,Gambia,GMB,Sweden,SWE,0,0,10,5,15
2000,Georgia,GEO,Sweden,SWE,0,0,24,5,29
2000,Ghana,GHA,Sweden,SWE,0,0,5,0,5
2000,Guinea-Bissau,GNB,Sweden,SWE,0,0,5,0,5
2000,Greece,GRC,Sweden,SWE,0,0,5,0,5
2000,Guinea,GIN,Sweden,SWE,0,0,5,0,5
2000,Honduras,HND,Sweden,SWE,0,0,10,5,15
2000,Croatia,HRV,Sweden,SWE,0,5,62,5,72
2000,Hungary,HUN,Sweden,SWE,0,0,10,0,10
2000,India,IND,Sweden,SWE,0,0,31,5,36
2000,Iran (Islamic Rep. of),IRN,Sweden,SWE,10,40,473,99,622
2000,Iraq,IRQ,Sweden,SWE,95,3471,624,120,4310
2000,Israel,ISR,Sweden,SWE,0,0,5,5,10
2000,Jordan,JOR,Sweden,SWE,0,5,37,10,52
2000,Kazakhstan,KAZ,Sweden,SWE,0,0,106,5,111
2000,Kenya,KEN,Sweden,SWE,0,0,5,0,5
2000,Lao People's Dem. Rep.,LAO,Sweden,SWE,0,5,0,0,5
2000,Liberia,LBR,Sweden,SWE,0,0,5,0,5
2000,Libya,LBY,Sweden,SWE,0,0,5,0,5
2000,Lebanon,LBN,Sweden,SWE,0,15,83,10,108
2000,Sri Lanka,LKA,Sweden,SWE,0,0,59,42,101
2000,Lithuania,LTU,Sweden,SWE,0,0,122,5,127
2000,Latvia,LVA,Sweden,SWE,0,0,75,10,85
2000,North Macedonia,MKD,Sweden,SWE,0,5,20,5,30
2000,Rep. of Moldova,MDA,Sweden,SWE,0,0,17,5,22
2000,Mongolia,MNG,Sweden,SWE,0,0,5,5,10
2000,Morocco,MAR,Sweden,SWE,0,0,5,0,5
2000,Nigeria,NGA,Sweden,SWE,0,0,20,0,20
2000,Pakistan,PAK,Sweden,SWE,0,0,183,18,201
2000,Paraguay,PRY,Sweden,SWE,0,0,5,0,5
2000,Peru,PER,Sweden,SWE,0,10,42,0,52
2000,Poland,POL,Sweden,SWE,0,0,16,0,16
2000,Romania,ROU,Sweden,SWE,0,0,60,13,73
2000,Russian Federation,RUS,Sweden,SWE,5,23,462,63,553
2000,Rwanda,RWA,Sweden,SWE,0,15,5,0,20
2000,El Salvador,SLV,Sweden,SWE,0,0,11,0,11
2000,Serbia and Kosovo: S/RES/1244 (1999),SRB,Sweden,SWE,11,1763,3090,363,5227
2000,Sierra Leone,SLE,Sweden,SWE,0,5,12,0,17
2000,Somalia,SOM,Sweden,SWE,12,361,76,27,476
2000,Viet Nam,VNM,Sweden,SWE,0,5,5,0,10
2000,Sudan,SDN,Sweden,SWE,0,0,10,0,10
2000,Slovakia,SVK,Sweden,SWE,0,0,92,0,92
2000,Slovenia,SVN,Sweden,SWE,0,0,5,0,5
2000,Syrian Arab Rep.,SYR,Sweden,SWE,0,16,303,25,344
2000,United Rep. of Tanzania,TZA,Sweden,SWE,0,0,5,0,5
2000,Thailand,THA,Sweden,SWE,0,0,5,0,5
2000,Tajikistan,TJK,Sweden,SWE,0,5,15,0,20
2000,Tunisia,TUN,Sweden,SWE,0,0,10,0,10
2000,Turkey,TUR,Sweden,SWE,0,16,191,21,228
2000,Uganda,UGA,Sweden,SWE,0,5,5,0,10
2000,Ukraine,UKR,Sweden,SWE,0,0,68,5,73
2000,United States of America,USA,Sweden,SWE,0,5,5,0,10
2000,Uzbekistan,UZB,Sweden,SWE,0,0,26,0,26
2000,Yemen,YEM,Sweden,SWE,0,0,5,0,5
2000,Stateless,XXA,Sweden,SWE,0,52,313,18,383
2000,Unknown ,,Sweden,SWE,5,63,48,10,126
2000,Afghanistan,AFG,Switzerland,CHE,201,46,53,52,352
2000,Albania,ALB,Switzerland,CHE,0,27,37,387,451
2000,Algeria,DZA,Switzerland,CHE,18,12,267,218,515
2000,Angola,AGO,Switzerland,CHE,0,193,268,95,556
2000,Egypt,EGY,Switzerland,CHE,0,5,5,5,15
2000,Armenia,ARM,Switzerland,CHE,0,5,231,135,371
2000,Azerbaijan,AZE,Switzerland,CHE,0,5,15,33,53
2000,Burundi,BDI,Switzerland,CHE,5,5,11,5,26
2000,Bangladesh,BGD,Switzerland,CHE,0,5,92,51,148
2000,Burkina Faso,BFA,Switzerland,CHE,0,0,16,15,31
2000,Belarus,BLR,Switzerland,CHE,0,0,17,57,74
2000,Brazil,BRA,Switzerland,CHE,0,0,5,0,5
2000,Bosnia and Herzegovina,BIH,Switzerland,CHE,156,929,873,306,2264
2000,Bulgaria,BGR,Switzerland,CHE,0,5,30,44,79
2000,Cambodia,KHM,Switzerland,CHE,25,0,5,0,30
2000,Chad,TCD,Switzerland,CHE,5,0,0,0,5
2000,China,CHN,Switzerland,CHE,17,15,12,17,61
2000,Chile,CHL,Switzerland,CHE,0,0,5,0,5
2000,Cameroon,CMR,Switzerland,CHE,5,0,71,52,128
2000,Congo,COG,Switzerland,CHE,10,0,20,10,40
2000,Dem. Rep. of the Congo,COD,Switzerland,CHE,21,169,339,156,685
2000,Colombia,COL,Switzerland,CHE,49,5,197,16,267
2000,Cuba,CUB,Switzerland,CHE,12,0,24,5,41
2000,Czechia,CZE,Switzerland,CHE,0,0,10,10,20
2000,Ecuador,ECU,Switzerland,CHE,0,0,36,0,36
2000,Eritrea,ERI,Switzerland,CHE,0,334,41,10,385
2000,Estonia,EST,Switzerland,CHE,0,0,5,0,5
2000,Ethiopia,ETH,Switzerland,CHE,10,127,148,24,309
2000,France,FRA,Switzerland,CHE,0,0,0,5,5
2000,Gambia,GMB,Switzerland,CHE,0,0,0,21,21
2000,Georgia,GEO,Switzerland,CHE,0,0,151,96,247
2000,Germany,DEU,Switzerland,CHE,0,0,0,5,5
2000,Ghana,GHA,Switzerland,CHE,0,0,0,5,5
2000,Guinea-Bissau,GNB,Switzerland,CHE,0,0,18,111,129
2000,Guinea,GIN,Switzerland,CHE,5,0,56,353,414
2000,Haiti,HTI,Switzerland,CHE,0,5,0,0,5
2000,Croatia,HRV,Switzerland,CHE,0,64,65,17,146
2000,Cote d'Ivoire,CIV,Switzerland,CHE,0,0,31,46,77
2000,India,IND,Switzerland,CHE,0,11,29,110,150
2000,Iran (Islamic Rep. of),IRN,Switzerland,CHE,51,48,177,108,384
2000,Iraq,IRQ,Switzerland,CHE,312,162,1050,495,2019
2000,Israel,ISR,Switzerland,CHE,0,0,0,5,5
2000,Jordan,JOR,Switzerland,CHE,0,13,5,5,23
2000,Kazakhstan,KAZ,Switzerland,CHE,0,0,14,5,19
2000,Kenya,KEN,Switzerland,CHE,0,0,5,0,5
2000,Lao People's Dem. Rep.,LAO,Switzerland,CHE,5,0,0,0,5
2000,Liberia,LBR,Switzerland,CHE,0,5,5,22,32
2000,Libya,LBY,Switzerland,CHE,140,0,5,26,171
2000,Lebanon,LBN,Switzerland,CHE,0,10,30,71,111
2000,Sri Lanka,LKA,Switzerland,CHE,51,8452,7095,463,16061
2000,Lithuania,LTU,Switzerland,CHE,0,0,5,50,55
2000,Latvia,LVA,Switzerland,CHE,0,0,5,5,10
2000,Mauritania,MRT,Switzerland,CHE,0,0,0,56,56
2000,North Macedonia,MKD,Switzerland,CHE,0,18,46,49,113
2000,Rep. of Moldova,MDA,Switzerland,CHE,0,0,16,23,39
2000,Mali,MLI,Switzerland,CHE,0,0,28,56,84
2000,Mongolia,MNG,Switzerland,CHE,0,0,102,151,253
2000,Morocco,MAR,Switzerland,CHE,0,0,5,30,35
2000,Nepal,NPL,Switzerland,CHE,0,0,32,10,42
2000,Nigeria,NGA,Switzerland,CHE,0,5,85,123,213
2000,Pakistan,PAK,Switzerland,CHE,5,13,116,119,253
2000,Peru,PER,Switzerland,CHE,0,5,0,5,10
2000,Poland,POL,Switzerland,CHE,0,0,107,5,112
2000,Romania,ROU,Switzerland,CHE,0,5,10,63,78
2000,South Africa,ZAF,Switzerland,CHE,0,0,5,0,5
2000,Russian Federation,RUS,Switzerland,CHE,0,11,78,149,238
2000,Rwanda,RWA,Switzerland,CHE,24,5,24,14,67
2000,Serbia and Kosovo: S/RES/1244 (1999),SRB,Switzerland,CHE,220,5456,11090,5296,22062
2000,Senegal,SEN,Switzerland,CHE,0,0,5,18,23
2000,Sierra Leone,SLE,Switzerland,CHE,0,0,101,361,462
2000,Somalia,SOM,Switzerland,CHE,27,420,395,103,945
2000,Viet Nam,VNM,Switzerland,CHE,47,0,10,0,57
2000,Sudan,SDN,Switzerland,CHE,10,10,22,10,52
2000,Slovakia,SVK,Switzerland,CHE,0,0,5,10,15
2000,Slovenia,SVN,Switzerland,CHE,0,0,0,5,5
2000,Syrian Arab Rep.,SYR,Switzerland,CHE,11,29,62,85,187
2000,Tajikistan,TJK,Switzerland,CHE,0,0,5,5,10
2000,Togo,TGO,Switzerland,CHE,0,5,18,27,50
2000,Tunisia,TUN,Switzerland,CHE,92,0,19,52,163
2000,Turkey,TUR,Switzerland,CHE,505,271,526,349,1651
2000,Uganda,UGA,Switzerland,CHE,0,0,5,0,5
2000,Ukraine,UKR,Switzerland,CHE,0,0,47,56,103
2000,Uzbekistan,UZB,Switzerland,CHE,0,0,5,0,5
2000,Venezuela (Bolivarian Republic of),VEN,Switzerland,CHE,0,0,5,0,5
2000,Yemen,YEM,Switzerland,CHE,5,14,57,0,76
2000,Unknown ,,Switzerland,CHE,5,20,131,510,666
2000,Afghanistan,AFG,Tajikistan,TJK,112,0,0,1992,2104
2000,Iraq,IRQ,Tajikistan,TJK,0,0,5,0,5
2000,Burundi,BDI,Uganda,UGA,14,0,0,0,14
2000,Chad,TCD,Uganda,UGA,5,0,0,0,5
2000,Dem. Rep. of the Congo,COD,Uganda,UGA,120,0,5,0,125
2000,Eritrea,ERI,Uganda,UGA,11,0,0,0,11
2000,Ethiopia,ETH,Uganda,UGA,43,0,0,0,43
2000,Iraq,IRQ,Uganda,UGA,5,0,0,0,5
2000,Rwanda,RWA,Uganda,UGA,21,0,14,0,35
2000,Serbia and Kosovo: S/RES/1244 (1999),SRB,Uganda,UGA,5,0,0,0,5
2000,Somalia,SOM,Uganda,UGA,118,0,0,0,118
2000,Sudan,SDN,Uganda,UGA,25,0,10,0,35
2000,Afghanistan,AFG,Ukraine,UKR,275,0,412,0,687
2000,Angola,AGO,Ukraine,UKR,5,0,16,0,21
2000,Armenia,ARM,Ukraine,UKR,210,0,29,0,239
2000,Azerbaijan,AZE,Ukraine,UKR,73,0,28,0,101
2000,Bangladesh,BGD,Ukraine,UKR,0,0,42,0,42
2000,Burkina Faso,BFA,Ukraine,UKR,0,0,5,0,5
2000,Cameroon,CMR,Ukraine,UKR,0,0,10,0,10
2000,Congo,COG,Ukraine,UKR,16,0,5,0,21
2000,Ethiopia,ETH,Ukraine,UKR,5,0,0,0,5
2000,Palestinian,PSE,Ukraine,UKR,5,0,0,0,5
2000,Georgia,GEO,Ukraine,UKR,48,0,25,0,73
2000,Ghana,GHA,Ukraine,UKR,0,0,5,0,5
2000,India,IND,Ukraine,UKR,0,0,10,0,10
2000,Iran (Islamic Rep. of),IRN,Ukraine,UKR,0,0,13,0,13
2000,Iraq,IRQ,Ukraine,UKR,5,0,13,0,18
2000,Kazakhstan,KAZ,Ukraine,UKR,5,0,0,0,5
2000,Sri Lanka,LKA,Ukraine,UKR,0,0,16,0,16
2000,Nigeria,NGA,Ukraine,UKR,0,0,10,0,10
2000,Pakistan,PAK,Ukraine,UKR,0,0,53,0,53
2000,Russian Federation,RUS,Ukraine,UKR,208,0,374,0,582
2000,Sierra Leone,SLE,Ukraine,UKR,5,0,0,0,5
2000,Somalia,SOM,Ukraine,UKR,0,0,5,0,5
2000,Sudan,SDN,Ukraine,UKR,5,0,21,0,26
2000,Syrian Arab Rep.,SYR,Ukraine,UKR,12,0,10,0,22
2000,Tajikistan,TJK,Ukraine,UKR,5,0,12,0,17
2000,Uganda,UGA,Ukraine,UKR,0,0,5,0,5
2000,Colombia,COL,Venezuela (Bolivarian Republic of),VEN,14,0,0,10,24
2000,Uruguay,URY,Venezuela (Bolivarian Republic of),VEN,5,0,0,0,5
2000,Angola,AGO,Zambia,ZMB,5,0,5,0,10
2000,Burundi,BDI,Zambia,ZMB,41,0,12,41,94
2000,Dem. Rep. of the Congo,COD,Zambia,ZMB,139,0,24,0,163
2000,Rwanda,RWA,Zambia,ZMB,174,0,5,94,273
2000,Somalia,SOM,Zambia,ZMB,0,0,0,17,17
2000,Unknown ,,Zambia,ZMB,0,0,5,10,15
2000,Afghanistan,AFG,Zimbabwe,ZWE,5,0,0,0,5
2000,Angola,AGO,Zimbabwe,ZWE,27,0,5,0,32
2000,Burundi,BDI,Zimbabwe,ZWE,246,0,5,0,251
2000,Cameroon,CMR,Zimbabwe,ZWE,0,0,5,0,5
2000,Dem. Rep. of the Congo,COD,Zimbabwe,ZWE,1034,0,10,0,1044
2000,Eritrea,ERI,Zimbabwe,ZWE,10,0,0,0,10
2000,Ethiopia,ETH,Zimbabwe,ZWE,32,0,0,0,32
2000,Rwanda,RWA,Zimbabwe,ZWE,611,0,5,0,616
2000,Somalia,SOM,Zimbabwe,ZWE,5,0,0,0,5
2000,Sudan,SDN,Zimbabwe,ZWE,11,0,5,0,16
2000,Uganda,UGA,Zimbabwe,ZWE,5,0,0,0,5
2001,Albania,ALB,Argentina,ARG,0,0,0,5,5
2001,Armenia,ARM,Argentina,ARG,10,0,12,5,27
2001,Colombia,COL,Argentina,ARG,5,0,0,5,10
2001,Cuba,CUB,Argentina,ARG,0,0,5,5,10
2001,Iraq,IRQ,Argentina,ARG,5,0,0,0,5
2001,Nicaragua,NIC,Argentina,ARG,10,0,0,0,10
2001,Peru,PER,Argentina,ARG,17,0,38,41,96
2001,Romania,ROU,Argentina,ARG,0,0,34,0,34
2001,Russian Federation,RUS,Argentina,ARG,5,0,0,0,5
2001,Somalia,SOM,Argentina,ARG,0,0,0,5,5
2001,Afghanistan,AFG,Armenia,ARM,0,0,5,0,5
2001,Afghanistan,AFG,Belgium,BEL,95,0,30,0,125
2001,Albania,ALB,Belgium,BEL,22,0,72,0,94
2001,Algeria,DZA,Belgium,BEL,10,0,54,0,64
2001,Angola,AGO,Belgium,BEL,12,0,41,0,53
2001,Armenia,ARM,Belgium,BEL,0,0,45,0,45
2001,Azerbaijan,AZE,Belgium,BEL,0,0,10,0,10
2001,Burundi,BDI,Belgium,BEL,54,0,74,0,128
2001,Bangladesh,BGD,Belgium,BEL,0,0,10,0,10
2001,Bhutan,BTN,Belgium,BEL,0,0,26,0,26
2001,Belarus,BLR,Belgium,BEL,5,0,32,0,37
2001,Bosnia and Herzegovina,BIH,Belgium,BEL,30,0,32,0,62
2001,Bulgaria,BGR,Belgium,BEL,0,0,20,0,20
2001,China,CHN,Belgium,BEL,0,0,5,0,5
2001,Chile,CHL,Belgium,BEL,0,0,5,0,5
2001,Cameroon,CMR,Belgium,BEL,5,0,69,0,74
2001,Congo,COG,Belgium,BEL,5,0,13,0,18
2001,Dem. Rep. of the Congo,COD,Belgium,BEL,132,0,221,0,353
2001,Colombia,COL,Belgium,BEL,5,0,14,0,19
2001,Djibouti,DJI,Belgium,BEL,5,0,10,0,15
2001,Ethiopia,ETH,Belgium,BEL,5,0,12,0,17
2001,Palestinian,PSE,Belgium,BEL,0,0,5,0,5
2001,Georgia,GEO,Belgium,BEL,0,0,57,0,57
2001,Guinea,GIN,Belgium,BEL,5,0,56,0,61
2001,Croatia,HRV,Belgium,BEL,0,0,5,0,5
2001,Cote d'Ivoire,CIV,Belgium,BEL,0,0,10,0,10
2001,India,IND,Belgium,BEL,0,0,14,0,14
2001,Iran (Islamic Rep. of),IRN,Belgium,BEL,11,0,74,0,85
2001,Iraq,IRQ,Belgium,BEL,17,0,24,0,41
2001,Israel,ISR,Belgium,BEL,0,0,10,0,10
2001,Kazakhstan,KAZ,Belgium,BEL,0,0,48,0,48
2001,Kyrgyzstan,KGZ,Belgium,BEL,0,0,5,0,5
2001,Liberia,LBR,Belgium,BEL,5,0,0,0,5
2001,Lebanon,LBN,Belgium,BEL,0,0,10,0,10
2001,Sri Lanka,LKA,Belgium,BEL,0,0,5,0,5
2001,Mauritania,MRT,Belgium,BEL,5,0,48,0,53
2001,North Macedonia,MKD,Belgium,BEL,0,0,14,0,14
2001,Rep. of Moldova,MDA,Belgium,BEL,0,0,5,0,5
2001,Myanmar,MMR,Belgium,BEL,0,0,5,0,5
2001,Nepal,NPL,Belgium,BEL,0,0,11,0,11
2001,Niger,NER,Belgium,BEL,0,0,20,0,20
2001,Nigeria,NGA,Belgium,BEL,0,0,5,0,5
2001,Pakistan,PAK,Belgium,BEL,5,0,40,0,45
2001,Peru,PER,Belgium,BEL,0,0,10,0,10
2001,Romania,ROU,Belgium,BEL,5,0,53,0,58
2001,Russian Federation,RUS,Belgium,BEL,0,0,96,0,96
2001,Rwanda,RWA,Belgium,BEL,162,0,150,0,312
2001,Serbia and Kosovo: S/RES/1244 (1999),SRB,Belgium,BEL,198,0,583,0,781
2001,Senegal,SEN,Belgium,BEL,0,0,5,0,5
2001,Sierra Leone,SLE,Belgium,BEL,10,0,71,0,81
2001,Somalia,SOM,Belgium,BEL,42,0,73,0,115
2001,Sudan,SDN,Belgium,BEL,5,0,5,0,10
2001,Slovakia,SVK,Belgium,BEL,0,0,28,0,28
2001,Syrian Arab Rep.,SYR,Belgium,BEL,0,0,12,0,12
2001,Togo,TGO,Belgium,BEL,5,0,19,0,24
2001,Turkey,TUR,Belgium,BEL,11,0,57,0,68
2001,Ukraine,UKR,Belgium,BEL,0,0,19,0,19
2001,Uzbekistan,UZB,Belgium,BEL,0,0,18,0,18
2001,Burundi,BDI,Benin,BEN,5,0,0,5,10
2001,Burkina Faso,BFA,Benin,BEN,0,0,5,0,5
2001,Bosnia and Herzegovina,BIH,Benin,BEN,5,0,0,0,5
2001,Central African Rep.,CAF,Benin,BEN,27,0,5,0,32
2001,Chad,TCD,Benin,BEN,64,0,138,12,214
2001,Cameroon,CMR,Benin,BEN,0,0,28,0,28
2001,Congo,COG,Benin,BEN,50,0,78,10,138
2001,Dem. Rep. of the Congo,COD,Benin,BEN,104,0,327,18,449
2001,Equatorial Guinea,GNQ,Benin,BEN,0,0,5,0,5
2001,Ethiopia,ETH,Benin,BEN,5,0,0,0,5
2001,Guinea-Bissau,GNB,Benin,BEN,0,0,10,0,10
2001,Guinea,GIN,Benin,BEN,5,0,5,0,10
2001,Cote d'Ivoire,CIV,Benin,BEN,0,0,5,0,5
2001,Iraq,IRQ,Benin,BEN,0,0,5,0,5
2001,Liberia,LBR,Benin,BEN,0,0,5,0,5
2001,Nigeria,NGA,Benin,BEN,83,0,417,232,732
2001,Rwanda,RWA,Benin,BEN,74,0,20,5,99
2001,Sierra Leone,SLE,Benin,BEN,0,0,12,0,12
2001,Sudan,SDN,Benin,BEN,5,0,13,0,18
2001,Togo,TGO,Benin,BEN,197,0,709,109,1015
2001,Burundi,BDI,Burkina Faso,BFA,0,0,5,0,5
2001,Congo,COG,Burkina Faso,BFA,0,0,62,0,62
2001,Dem. Rep. of the Congo,COD,Burkina Faso,BFA,0,0,5,0,5
2001,Ghana,GHA,Burkina Faso,BFA,0,0,5,0,5
2001,Nigeria,NGA,Burkina Faso,BFA,0,0,5,0,5
2001,Rwanda,RWA,Burkina Faso,BFA,0,0,10,0,10
2001,Togo,TGO,Burkina Faso,BFA,0,0,43,0,43
2001,Afghanistan,AFG,Belarus,BLR,85,0,25,51,161
2001,Azerbaijan,AZE,Belarus,BLR,5,0,5,0,10
2001,Bulgaria,BGR,Belarus,BLR,0,0,5,0,5
2001,China,CHN,Belarus,BLR,0,0,5,0,5
2001,Cameroon,CMR,Belarus,BLR,0,0,5,5,10
2001,Ethiopia,ETH,Belarus,BLR,5,0,0,0,5
2001,Georgia,GEO,Belarus,BLR,25,0,0,5,30
2001,North Macedonia,MKD,Belarus,BLR,0,0,0,5,5
2001,Pakistan,PAK,Belarus,BLR,0,0,0,5,5
2001,Russian Federation,RUS,Belarus,BLR,0,0,0,5,5
2001,Tajikistan,TJK,Belarus,BLR,10,0,10,10,30
2001,Peru,PER,Bolivia (Plurinational State of),BOL,0,0,10,0,10
2001,Burundi,BDI,Botswana,BWA,5,0,5,0,10
2001,Dem. Rep. of the Congo,COD,Botswana,BWA,5,0,0,0,5
2001,Ethiopia,ETH,Botswana,BWA,5,0,5,0,10
2001,Kenya,KEN,Botswana,BWA,0,0,5,0,5
2001,Rwanda,RWA,Botswana,BWA,5,0,0,0,5
2001,Somalia,SOM,Botswana,BWA,5,0,22,0,27
2001,United Rep. of Tanzania,TZA,Botswana,BWA,0,0,10,0,10
2001,Uganda,UGA,Botswana,BWA,0,0,5,0,5
2001,Zimbabwe,ZWE,Botswana,BWA,5,0,0,0,5
2001,Angola,AGO,Brazil,BRA,60,72,102,0,234
2001,China,CHN,Brazil,BRA,0,0,10,0,10
2001,Dem. Rep. of the Congo,COD,Brazil,BRA,5,0,0,0,5
2001,Colombia,COL,Brazil,BRA,5,5,0,0,10
2001,Cuba,CUB,Brazil,BRA,0,0,12,0,12
2001,Iraq,IRQ,Brazil,BRA,0,0,5,0,5
2001,Nigeria,NGA,Brazil,BRA,0,0,10,0,10
2001,Pakistan,PAK,Brazil,BRA,0,0,0,15,15
2001,Peru,PER,Brazil,BRA,0,0,10,0,10
2001,Romania,ROU,Brazil,BRA,0,0,29,0,29
2001,Sierra Leone,SLE,Brazil,BRA,18,0,0,5,23
2001,Sudan,SDN,Brazil,BRA,5,0,0,0,5
2001,United Rep. of Tanzania,TZA,Brazil,BRA,5,0,0,0,5
2001,Unknown ,,Brazil,BRA,0,5,0,0,5
2001,Afghanistan,AFG,Bulgaria,BGR,102,692,90,0,884
2001,Algeria,DZA,Bulgaria,BGR,5,5,14,0,24
2001,Armenia,ARM,Bulgaria,BGR,0,5,401,5,411
2001,Bangladesh,BGD,Bulgaria,BGR,0,0,10,0,10
2001,Congo,COG,Bulgaria,BGR,5,0,0,0,5
2001,Eritrea,ERI,Bulgaria,BGR,0,5,0,0,5
2001,Ethiopia,ETH,Bulgaria,BGR,5,5,0,0,10
2001,Georgia,GEO,Bulgaria,BGR,0,0,12,0,12
2001,Ghana,GHA,Bulgaria,BGR,0,0,5,0,5
2001,Iran (Islamic Rep. of),IRN,Bulgaria,BGR,23,66,30,0,119
2001,Iraq,IRQ,Bulgaria,BGR,140,269,0,15,424
2001,Kazakhstan,KAZ,Bulgaria,BGR,0,0,5,0,5
2001,Liberia,LBR,Bulgaria,BGR,0,5,0,0,5
2001,Lebanon,LBN,Bulgaria,BGR,5,14,5,0,24
2001,"China, Macao SAR",MAC,Bulgaria,BGR,0,5,0,0,5
2001,Pakistan,PAK,Bulgaria,BGR,0,0,5,0,5
2001,Russian Federation,RUS,Bulgaria,BGR,0,0,17,5,22
2001,Serbia and Kosovo: S/RES/1244 (1999),SRB,Bulgaria,BGR,0,12,5,0,17
2001,Somalia,SOM,Bulgaria,BGR,5,11,5,0,21
2001,Sudan,SDN,Bulgaria,BGR,5,43,0,0,48
2001,Syrian Arab Rep.,SYR,Bulgaria,BGR,35,12,10,0,57
2001,Turkey,TUR,Bulgaria,BGR,12,14,5,0,31
2001,Stateless,XXA,Bulgaria,BGR,37,5,0,0,42
2001,Ethiopia,ETH,Belize,BLZ,0,0,0,5,5
2001,Nigeria,NGA,Belize,BLZ,0,0,0,25,25
2001,Syrian Arab Rep.,SYR,Belize,BLZ,0,0,0,15,15
2001,Afghanistan,AFG,Canada,CAN,305,0,10,43,358
2001,Albania,ALB,Canada,CAN,239,0,76,50,365
2001,Algeria,DZA,Canada,CAN,112,0,190,43,345
2001,Angola,AGO,Canada,CAN,186,0,218,20,424
2001,Egypt,EGY,Canada,CAN,25,0,39,19,83
2001,Argentina,ARG,Canada,CAN,59,0,1184,256,1499
2001,Armenia,ARM,Canada,CAN,17,0,5,5,27
2001,Azerbaijan,AZE,Canada,CAN,99,0,29,13,141
2001,Barbados,BRB,Canada,CAN,0,0,0,5,5
2001,Burundi,BDI,Canada,CAN,114,0,20,0,134
2001,Belgium,BEL,Canada,CAN,0,0,5,0,5
2001,Benin,BEN,Canada,CAN,5,0,0,0,5
2001,Bangladesh,BGD,Canada,CAN,155,0,120,49,324
2001,Burkina Faso,BFA,Canada,CAN,13,0,0,0,13
2001,Belarus,BLR,Canada,CAN,32,0,10,10,52
2001,Bolivia (Plurinational State of),BOL,Canada,CAN,10,0,21,5,36
2001,Brazil,BRA,Canada,CAN,5,0,12,11,28
2001,Bosnia and Herzegovina,BIH,Canada,CAN,5,0,5,5,15
2001,Bulgaria,BGR,Canada,CAN,113,0,63,31,207
2001,Cambodia,KHM,Canada,CAN,0,0,5,0,5
2001,Chad,TCD,Canada,CAN,34,0,15,10,59
2001,China,CHN,Canada,CAN,942,0,380,413,1735
2001,Chile,CHL,Canada,CAN,16,0,26,12,54
2001,Cameroon,CMR,Canada,CAN,40,0,23,10,73
2001,Congo,COG,Canada,CAN,57,0,24,5,86
2001,Dem. Rep. of the Congo,COD,Canada,CAN,569,0,177,55,801
2001,Colombia,COL,Canada,CAN,740,0,130,71,941
2001,Costa Rica,CRI,Canada,CAN,20,0,70,76,166
2001,Cuba,CUB,Canada,CAN,119,0,23,23,165
2001,Czechia,CZE,Canada,CAN,12,0,12,10,34
2001,Djibouti,DJI,Canada,CAN,39,0,14,10,63
2001,Dominica,DMA,Canada,CAN,0,0,5,5,10
2001,Dominican Rep.,DOM,Canada,CAN,0,0,10,23,33
2001,Ecuador,ECU,Canada,CAN,20,0,14,10,44
2001,Eritrea,ERI,Canada,CAN,61,0,5,5,71
2001,Estonia,EST,Canada,CAN,5,0,10,5,20
2001,Ethiopia,ETH,Canada,CAN,100,0,15,27,142
2001,Fiji,FJI,Canada,CAN,218,0,32,19,269
2001,France,FRA,Canada,CAN,5,0,0,10,15
2001,Gabon,GAB,Canada,CAN,0,0,5,5,10
2001,Palestinian,PSE,Canada,CAN,25,0,12,14,51
2001,United Kingdom of Great Britain and Northern Ireland,GBR,Canada,CAN,0,0,5,5,10
2001,Georgia,GEO,Canada,CAN,32,0,20,23,75
2001,Germany,DEU,Canada,CAN,0,0,5,5,10
2001,Ghana,GHA,Canada,CAN,41,0,51,55,147
2001,Guinea-Bissau,GNB,Canada,CAN,5,0,0,0,5
2001,Grenada,GRD,Canada,CAN,13,0,32,24,69
2001,Guatemala,GTM,Canada,CAN,32,0,80,36,148
2001,Guinea,GIN,Canada,CAN,150,0,36,17,203
2001,Guyana,GUY,Canada,CAN,5,0,70,38,113
2001,Haiti,HTI,Canada,CAN,101,0,137,40,278
2001,Honduras,HND,Canada,CAN,12,0,86,69,167
2001,Croatia,HRV,Canada,CAN,13,0,0,0,13
2001,Hungary,HUN,Canada,CAN,217,0,579,993,1789
2001,Cote d'Ivoire,CIV,Canada,CAN,39,0,19,12,70
2001,India,IND,Canada,CAN,379,0,556,377,1312
2001,Indonesia,IDN,Canada,CAN,22,0,5,5,32
2001,Iran (Islamic Rep. of),IRN,Canada,CAN,438,0,186,78,702
2001,Iraq,IRQ,Canada,CAN,151,0,68,23,242
2001,Israel,ISR,Canada,CAN,11,0,87,112,210
2001,Italy,ITA,Canada,CAN,0,0,11,5,16
2001,Jamaica,JAM,Canada,CAN,5,0,59,41,105
2001,Jordan,JOR,Canada,CAN,10,0,5,14,29
2001,Kazakhstan,KAZ,Canada,CAN,21,0,74,10,105
2001,Kenya,KEN,Canada,CAN,69,0,24,14,107
2001,Kyrgyzstan,KGZ,Canada,CAN,43,0,25,5,73
2001,Rep. of Korea,KOR,Canada,CAN,17,0,145,48,210
2001,Dem. People's Rep. of Korea,PRK,Canada,CAN,0,0,5,0,5
2001,Kuwait,KWT,Canada,CAN,43,0,0,5,48
2001,Liberia,LBR,Canada,CAN,10,0,5,0,15
2001,Libya,LBY,Canada,CAN,36,0,20,5,61
2001,Saint Lucia,LCA,Canada,CAN,0,0,11,5,16
2001,Lebanon,LBN,Canada,CAN,101,0,159,71,331
2001,Sri Lanka,LKA,Canada,CAN,1543,0,477,125,2145
2001,Lithuania,LTU,Canada,CAN,5,0,12,15,32
2001,Latvia,LVA,Canada,CAN,5,0,10,0,15
2001,Mauritania,MRT,Canada,CAN,10,0,10,0,20
2001,North Macedonia,MKD,Canada,CAN,5,0,5,5,15
2001,Rep. of Moldova,MDA,Canada,CAN,15,0,21,11,47
2001,Mexico,MEX,Canada,CAN,237,0,602,324,1163
2001,Mali,MLI,Canada,CAN,22,0,12,0,34
2001,Malaysia,MYS,Canada,CAN,52,0,65,20,137
2001,Mongolia,MNG,Canada,CAN,11,0,5,0,16
2001,Morocco,MAR,Canada,CAN,12,0,15,10,37
2001,Myanmar,MMR,Canada,CAN,10,0,5,0,15
2001,Nepal,NPL,Canada,CAN,15,0,5,0,20
2001,Netherlands,NLD,Canada,CAN,0,0,5,5,10
2001,Niger,NER,Canada,CAN,5,0,0,0,5
2001,Nicaragua,NIC,Canada,CAN,5,0,13,5,23
2001,Nigeria,NGA,Canada,CAN,199,0,298,109,606
2001,Pakistan,PAK,Canada,CAN,1740,0,613,346,2699
2001,Panama,PAN,Canada,CAN,0,0,5,5,10
2001,Peru,PER,Canada,CAN,152,0,156,50,358
2001,Philippines,PHL,Canada,CAN,15,0,66,10,91
2001,Poland,POL,Canada,CAN,133,0,58,39,230
2001,Portugal,PRT,Canada,CAN,0,0,31,23,54
2001,Qatar,QAT,Canada,CAN,0,0,5,5,10
2001,Romania,ROU,Canada,CAN,133,0,148,63,344
2001,South Africa,ZAF,Canada,CAN,0,0,24,5,29
2001,Russian Federation,RUS,Canada,CAN,247,0,171,52,470
2001,Rwanda,RWA,Canada,CAN,148,0,53,10,211
2001,El Salvador,SLV,Canada,CAN,42,0,152,61,255
2001,Saudi Arabia,SAU,Canada,CAN,10,0,5,11,26
2001,Serbia and Kosovo: S/RES/1244 (1999),SRB,Canada,CAN,37,0,50,24,111
2001,Senegal,SEN,Canada,CAN,10,0,5,5,20
2001,Sierra Leone,SLE,Canada,CAN,32,0,14,14,60
2001,Solomon Islands,SLB,Canada,CAN,5,0,0,0,5
2001,Somalia,SOM,Canada,CAN,516,0,42,61,619
2001,Spain,ESP,Canada,CAN,0,0,0,5,5
2001,Viet Nam,VNM,Canada,CAN,21,0,23,23,67
2001,Sudan,SDN,Canada,CAN,241,0,52,31,324
2001,Slovakia,SVK,Canada,CAN,5,0,12,5,22
2001,Syrian Arab Rep.,SYR,Canada,CAN,39,0,36,13,88
2001,United Rep. of Tanzania,TZA,Canada,CAN,148,0,23,10,181
2001,Thailand,THA,Canada,CAN,5,0,5,5,15
2001,Togo,TGO,Canada,CAN,21,0,10,5,36
2001,Trinidad and Tobago,TTO,Canada,CAN,5,0,22,33,60
2001,Tunisia,TUN,Canada,CAN,13,0,45,12,70
2001,Turkey,TUR,Canada,CAN,488,0,145,73,706
2001,Uganda,UGA,Canada,CAN,44,0,26,5,75
2001,Ukraine,UKR,Canada,CAN,130,0,112,110,352
2001,Uruguay,URY,Canada,CAN,10,0,70,38,118
2001,United States of America,USA,Canada,CAN,0,0,40,30,70
2001,Uzbekistan,UZB,Canada,CAN,14,0,10,0,24
2001,Saint Vincent and the Grenadines,VCT,Canada,CAN,39,0,29,14,82
2001,Venezuela (Bolivarian Republic of),VEN,Canada,CAN,43,0,38,21,102
2001,Yemen,YEM,Canada,CAN,34,0,20,5,59
2001,Zimbabwe,ZWE,Canada,CAN,121,0,85,51,257
2001,Central African Rep.,CAF,Chad,TCD,5,0,18,0,23
2001,Cameroon,CMR,Chad,TCD,10,0,5,0,15
2001,Dem. Rep. of the Congo,COD,Chad,TCD,113,0,47,0,160
2001,Rwanda,RWA,Chad,TCD,5,0,5,0,10
2001,Sudan,SDN,Chad,TCD,58,0,50,0,108
2001,Unknown ,,Chad,TCD,20,0,10,0,30
2001,Afghanistan,AFG,Chile,CHL,5,0,0,0,5
2001,Colombia,COL,Chile,CHL,23,5,5,5,38
2001,Cuba,CUB,Chile,CHL,0,0,0,5,5
2001,Iraq,IRQ,Chile,CHL,5,0,0,0,5
2001,North Macedonia,MKD,Chile,CHL,0,0,5,0,5
2001,Mongolia,MNG,Chile,CHL,0,0,0,5,5
2001,Nigeria,NGA,Chile,CHL,0,0,5,0,5
2001,Peru,PER,Chile,CHL,10,0,0,0,10
2001,Sweden,SWE,Chile,CHL,0,0,5,0,5
2001,Afghanistan,AFG,Denmark,DNK,1493,184,45,0,1722
2001,Albania,ALB,Denmark,DNK,0,0,33,0,33
2001,Algeria,DZA,Denmark,DNK,0,0,17,0,17
2001,Egypt,EGY,Denmark,DNK,0,0,5,0,5
2001,Armenia,ARM,Denmark,DNK,0,5,142,0,147
2001,Azerbaijan,AZE,Denmark,DNK,10,0,43,0,53
2001,Burundi,BDI,Denmark,DNK,0,11,0,0,11
2001,Bangladesh,BGD,Denmark,DNK,0,0,15,0,15
2001,Bhutan,BTN,Denmark,DNK,0,0,5,0,5
2001,Belarus,BLR,Denmark,DNK,0,0,39,0,39
2001,Bosnia and Herzegovina,BIH,Denmark,DNK,0,10,942,0,952
2001,Bulgaria,BGR,Denmark,DNK,0,0,17,0,17
2001,China,CHN,Denmark,DNK,0,0,42,0,42
2001,Cameroon,CMR,Denmark,DNK,0,0,14,0,14
2001,Dem. Rep. of the Congo,COD,Denmark,DNK,5,5,10,0,20
2001,Cuba,CUB,Denmark,DNK,0,0,5,0,5
2001,Czechia,CZE,Denmark,DNK,0,0,31,0,31
2001,Ecuador,ECU,Denmark,DNK,0,0,10,0,10
2001,Estonia,EST,Denmark,DNK,0,0,10,0,10
2001,Ethiopia,ETH,Denmark,DNK,5,0,5,0,10
2001,Gambia,GMB,Denmark,DNK,0,0,22,0,22
2001,Palestinian,PSE,Denmark,DNK,47,5,137,0,189
2001,Georgia,GEO,Denmark,DNK,0,0,78,0,78
2001,Ghana,GHA,Denmark,DNK,0,0,5,0,5
2001,Guatemala,GTM,Denmark,DNK,0,0,5,0,5
2001,Croatia,HRV,Denmark,DNK,0,0,13,0,13
2001,India,IND,Denmark,DNK,0,5,52,0,57
2001,Iran (Islamic Rep. of),IRN,Denmark,DNK,15,11,244,0,270
2001,Iraq,IRQ,Denmark,DNK,38,1850,254,0,2142
2001,Israel,ISR,Denmark,DNK,0,0,5,0,5
2001,Jordan,JOR,Denmark,DNK,5,0,10,0,15
2001,Kazakhstan,KAZ,Denmark,DNK,0,5,26,0,31
2001,Kyrgyzstan,KGZ,Denmark,DNK,0,0,5,0,5
2001,Libya,LBY,Denmark,DNK,0,0,5,0,5
2001,Lebanon,LBN,Denmark,DNK,5,5,43,0,53
2001,Sri Lanka,LKA,Denmark,DNK,5,17,37,0,59
2001,Lithuania,LTU,Denmark,DNK,0,0,17,0,17
2001,Latvia,LVA,Denmark,DNK,0,0,5,0,5
2001,North Macedonia,MKD,Denmark,DNK,0,0,18,0,18
2001,Rep. of Moldova,MDA,Denmark,DNK,0,0,23,0,23
2001,Mongolia,MNG,Denmark,DNK,0,0,34,0,34
2001,Morocco,MAR,Denmark,DNK,0,0,5,0,5
2001,Nepal,NPL,Denmark,DNK,0,0,5,0,5
2001,Nigeria,NGA,Denmark,DNK,0,0,11,0,11
2001,Pakistan,PAK,Denmark,DNK,5,5,58,0,68
2001,Peru,PER,Denmark,DNK,0,0,5,0,5
2001,Poland,POL,Denmark,DNK,0,0,10,0,10
2001,Romania,ROU,Denmark,DNK,0,0,18,0,18
2001,South Africa,ZAF,Denmark,DNK,0,0,5,0,5
2001,Russian Federation,RUS,Denmark,DNK,10,10,106,0,126
2001,Rwanda,RWA,Denmark,DNK,0,12,0,0,12
2001,Serbia and Kosovo: S/RES/1244 (1999),SRB,Denmark,DNK,20,148,1005,0,1173
2001,Sierra Leone,SLE,Denmark,DNK,0,0,12,0,12
2001,Somalia,SOM,Denmark,DNK,155,403,11,0,569
2001,Viet Nam,VNM,Denmark,DNK,15,0,24,0,39
2001,Slovakia,SVK,Denmark,DNK,0,0,254,0,254
2001,Sweden,SWE,Denmark,DNK,0,0,5,0,5
2001,Syrian Arab Rep.,SYR,Denmark,DNK,5,5,19,0,29
2001,Tunisia,TUN,Denmark,DNK,0,0,5,0,5
2001,Turkey,TUR,Denmark,DNK,5,5,43,0,53
2001,Ukraine,UKR,Denmark,DNK,0,0,53,0,53
2001,Uzbekistan,UZB,Denmark,DNK,0,5,0,0,5
2001,Stateless,XXA,Denmark,DNK,5,0,5,0,10
2001,Ethiopia,ETH,Djibouti,DJI,5,0,46,0,51
2001,Somalia,SOM,Djibouti,DJI,0,0,10,0,10
2001,Colombia,COL,Ecuador,ECU,380,0,605,0,985
2001,India,IND,Ecuador,ECU,0,0,5,0,5
2001,Iran (Islamic Rep. of),IRN,Ecuador,ECU,5,0,0,0,5
2001,Iraq,IRQ,Ecuador,ECU,10,0,27,0,37
2001,Sri Lanka,LKA,Ecuador,ECU,0,0,10,0,10
2001,Pakistan,PAK,Ecuador,ECU,10,0,5,0,15
2001,Spain,ESP,Ecuador,ECU,0,0,5,0,5
2001,Turkey,TUR,Ecuador,ECU,0,0,10,17,27
2001,Dem. Rep. of the Congo,COD,Ethiopia,ETH,0,0,0,17,17
2001,Yemen,YEM,Ethiopia,ETH,0,0,0,15,15
2001,Afghanistan,AFG,Finland,FIN,0,35,0,19,54
2001,Albania,ALB,Finland,FIN,0,5,5,0,10
2001,Algeria,DZA,Finland,FIN,0,5,15,10,30
2001,Angola,AGO,Finland,FIN,0,5,10,0,15
2001,Armenia,ARM,Finland,FIN,0,5,0,10,15
2001,Azerbaijan,AZE,Finland,FIN,0,11,0,0,11
2001,Bangladesh,BGD,Finland,FIN,0,14,45,5,64
2001,Belarus,BLR,Finland,FIN,0,5,20,21,46
2001,Bolivia (Plurinational State of),BOL,Finland,FIN,0,0,0,5,5
2001,Bosnia and Herzegovina,BIH,Finland,FIN,0,17,10,5,32
2001,Bulgaria,BGR,Finland,FIN,0,5,0,5,10
2001,Cambodia,KHM,Finland,FIN,0,5,0,5,10
2001,China,CHN,Finland,FIN,0,0,5,5,10
2001,Congo,COG,Finland,FIN,0,5,5,0,10
2001,Dem. Rep. of the Congo,COD,Finland,FIN,0,5,16,0,21
2001,Czechia,CZE,Finland,FIN,0,0,10,5,15
2001,Estonia,EST,Finland,FIN,0,0,5,5,10
2001,Ethiopia,ETH,Finland,FIN,0,0,15,0,15
2001,Georgia,GEO,Finland,FIN,0,0,5,0,5
2001,Hungary,HUN,Finland,FIN,0,5,0,0,5
2001,India,IND,Finland,FIN,0,0,5,5,10
2001,Iran (Islamic Rep. of),IRN,Finland,FIN,0,19,35,11,65
2001,Iraq,IRQ,Finland,FIN,0,76,12,23,111
2001,Israel,ISR,Finland,FIN,0,0,0,10,10
2001,Kazakhstan,KAZ,Finland,FIN,0,5,5,5,15
2001,Libya,LBY,Finland,FIN,0,5,0,0,5
2001,Sri Lanka,LKA,Finland,FIN,0,12,14,24,50
2001,Lithuania,LTU,Finland,FIN,0,0,45,10,55
2001,Rep. of Moldova,MDA,Finland,FIN,0,0,5,10,15
2001,Morocco,MAR,Finland,FIN,0,0,5,5,10
2001,Nigeria,NGA,Finland,FIN,0,0,0,5,5
2001,Pakistan,PAK,Finland,FIN,0,5,5,5,15
2001,Poland,POL,Finland,FIN,0,0,0,10,10
2001,Romania,ROU,Finland,FIN,0,0,0,36,36
2001,Russian Federation,RUS,Finland,FIN,0,10,35,253,298
2001,Rwanda,RWA,Finland,FIN,0,5,0,0,5
2001,Serbia and Kosovo: S/RES/1244 (1999),SRB,Finland,FIN,0,306,92,20,418
2001,Sierra Leone,SLE,Finland,FIN,0,5,0,0,5
2001,Somalia,SOM,Finland,FIN,0,89,0,11,100
2001,Slovakia,SVK,Finland,FIN,0,5,44,40,89
2001,Syrian Arab Rep.,SYR,Finland,FIN,0,5,5,0,10
2001,Tajikistan,TJK,Finland,FIN,0,5,0,0,5
2001,Turkey,TUR,Finland,FIN,0,87,59,12,158
2001,Ukraine,UKR,Finland,FIN,0,5,78,83,166
2001,Uzbekistan,UZB,Finland,FIN,0,12,5,0,17
2001,Stateless,XXA,Finland,FIN,0,5,10,0,15
2001,Afghanistan,AFG,France,FRA,184,0,95,0,279
2001,Albania,ALB,France,FRA,26,0,334,0,360
2001,Algeria,DZA,France,FRA,49,0,2232,0,2281
2001,Angola,AGO,France,FRA,133,0,331,0,464
2001,Armenia,ARM,France,FRA,16,0,383,0,399
2001,Azerbaijan,AZE,France,FRA,12,0,146,0,158
2001,Burundi,BDI,France,FRA,31,0,23,0,54
2001,Bangladesh,BGD,France,FRA,22,0,1134,0,1156
2001,Belarus,BLR,France,FRA,5,0,104,0,109
2001,Bosnia and Herzegovina,BIH,France,FRA,166,0,181,0,347
2001,Bulgaria,BGR,France,FRA,0,0,55,0,55
2001,Cambodia,KHM,France,FRA,128,0,108,0,236
2001,Central African Rep.,CAF,France,FRA,28,0,177,0,205
2001,Chad,TCD,France,FRA,49,0,68,0,117
2001,China,CHN,France,FRA,21,0,3281,0,3302
2001,Cameroon,CMR,France,FRA,15,0,99,0,114
2001,Congo,COG,France,FRA,189,0,640,0,829
2001,Dem. Rep. of the Congo,COD,France,FRA,602,0,2664,0,3266
2001,Colombia,COL,France,FRA,33,0,88,0,121
2001,Cuba,CUB,France,FRA,10,0,15,0,25
2001,Djibouti,DJI,France,FRA,10,0,10,0,20
2001,Ecuador,ECU,France,FRA,10,0,58,0,68
2001,Eritrea,ERI,France,FRA,10,0,5,0,15
2001,Ethiopia,ETH,France,FRA,45,0,15,0,60
2001,Georgia,GEO,France,FRA,36,0,525,0,561
2001,Ghana,GHA,France,FRA,36,0,145,0,181
2001,Guinea-Bissau,GNB,France,FRA,35,0,62,0,97
2001,Guinea,GIN,France,FRA,15,0,587,0,602
2001,Haiti,HTI,France,FRA,97,0,2849,0,2946
2001,Croatia,HRV,France,FRA,0,0,22,0,22
2001,Hungary,HUN,France,FRA,13,0,41,0,54
2001,Cote d'Ivoire,CIV,France,FRA,12,0,352,0,364
2001,India,IND,France,FRA,12,0,635,0,647
2001,Iran (Islamic Rep. of),IRN,France,FRA,61,0,174,0,235
2001,Iraq,IRQ,France,FRA,133,0,184,0,317
2001,Kazakhstan,KAZ,France,FRA,5,0,95,0,100
2001,Lao People's Dem. Rep.,LAO,France,FRA,42,0,5,0,47
2001,Liberia,LBR,France,FRA,5,0,31,0,36
2001,Lebanon,LBN,France,FRA,10,0,36,0,46
2001,Sri Lanka,LKA,France,FRA,956,0,1901,0,2857
2001,Mauritania,MRT,France,FRA,109,0,885,0,994
2001,Rep. of Moldova,MDA,France,FRA,5,0,798,0,803
2001,Mali,MLI,France,FRA,0,0,2921,0,2921
2001,Myanmar,MMR,France,FRA,5,0,30,0,35
2001,Nigeria,NGA,France,FRA,10,0,269,0,279
2001,Pakistan,PAK,France,FRA,19,0,619,0,638
2001,Peru,PER,France,FRA,14,0,67,0,81
2001,Romania,ROU,France,FRA,5,0,224,0,229
2001,Russian Federation,RUS,France,FRA,134,0,703,0,837
2001,Rwanda,RWA,France,FRA,287,0,89,0,376
2001,Serbia and Kosovo: S/RES/1244 (1999),SRB,France,FRA,320,0,2127,0,2447
2001,Senegal,SEN,France,FRA,5,0,688,0,693
2001,Sierra Leone,SLE,France,FRA,26,0,212,0,238
2001,Somalia,SOM,France,FRA,48,0,60,0,108
2001,Viet Nam,VNM,France,FRA,182,0,19,0,201
2001,Sudan,SDN,France,FRA,57,0,83,0,140
2001,Slovakia,SVK,France,FRA,5,0,74,0,79
2001,Syrian Arab Rep.,SYR,France,FRA,53,0,28,0,81
2001,Togo,TGO,France,FRA,10,0,39,0,49
2001,Tunisia,TUN,France,FRA,10,0,26,0,36
2001,Turkey,TUR,France,FRA,371,0,4134,0,4505
2001,Ukraine,UKR,France,FRA,12,0,787,0,799
2001,Uzbekistan,UZB,France,FRA,0,0,22,0,22
2001,Stateless,XXA,France,FRA,62,0,28,0,90
2001,Unknown ,,France,FRA,48,0,907,0,955
2001,Cuba,CUB,Ghana,GHA,0,0,5,0,5
2001,Sierra Leone,SLE,Ghana,GHA,102,0,0,0,102
2001,Senegal,SEN,Guinea-Bissau,GNB,7332,0,0,457,7789
2001,Sierra Leone,SLE,Guinea-Bissau,GNB,0,0,0,17,17
2001,Afghanistan,AFG,Greece,GRC,17,5,183,19,224
2001,Albania,ALB,Greece,GRC,0,0,5,5,10
2001,Algeria,DZA,Greece,GRC,0,0,10,5,15
2001,Azerbaijan,AZE,Greece,GRC,0,0,5,0,5
2001,Bangladesh,BGD,Greece,GRC,5,0,17,13,35
2001,Dem. Rep. of the Congo,COD,Greece,GRC,0,0,5,0,5
2001,Ethiopia,ETH,Greece,GRC,0,0,5,0,5
2001,Gambia,GMB,Greece,GRC,0,0,5,0,5
2001,Palestinian,PSE,Greece,GRC,0,0,13,0,13
2001,Ghana,GHA,Greece,GRC,0,0,10,0,10
2001,Guinea-Bissau,GNB,Greece,GRC,0,0,14,0,14
2001,India,IND,Greece,GRC,0,5,5,5,15
2001,Iran (Islamic Rep. of),IRN,Greece,GRC,13,23,59,5,100
2001,Iraq,IRQ,Greece,GRC,46,55,349,113,563
2001,Sri Lanka,LKA,Greece,GRC,5,5,16,0,26
2001,Morocco,MAR,Greece,GRC,0,0,135,0,135
2001,Nigeria,NGA,Greece,GRC,0,0,10,0,10
2001,Pakistan,PAK,Greece,GRC,0,0,19,5,24
2001,Romania,ROU,Greece,GRC,0,0,5,0,5
2001,Russian Federation,RUS,Greece,GRC,0,0,11,0,11
2001,Rwanda,RWA,Greece,GRC,0,0,5,0,5
2001,Serbia and Kosovo: S/RES/1244 (1999),SRB,Greece,GRC,0,0,5,5,10
2001,Sierra Leone,SLE,Greece,GRC,0,5,18,0,23
2001,Sudan,SDN,Greece,GRC,5,0,16,14,35
2001,Syrian Arab Rep.,SYR,Greece,GRC,0,10,0,5,15
2001,Turkey,TUR,Greece,GRC,48,20,108,106,282
2001,Ukraine,UKR,Greece,GRC,0,0,10,0,10
2001,Western Sahara,ESH,Greece,GRC,0,0,5,0,5
2001,Chad,TCD,Guinea,GIN,5,0,0,0,5
2001,Dem. Rep. of the Congo,COD,Guinea,GIN,5,0,0,0,5
2001,Ghana,GHA,Guinea,GIN,5,0,0,0,5
2001,Liberia,LBR,Guinea,GIN,559,0,5,0,564
2001,Sierra Leone,SLE,Guinea,GIN,609,0,5,0,614
2001,Cuba,CUB,Honduras,HND,5,0,10,0,15
2001,Guatemala,GTM,Honduras,HND,0,0,5,0,5
2001,Iran (Islamic Rep. of),IRN,Honduras,HND,5,0,0,0,5
2001,Sri Lanka,LKA,Honduras,HND,0,0,5,0,5
2001,Somalia,SOM,Honduras,HND,0,0,5,0,5
2001,Afghanistan,AFG,Croatia,HRV,0,0,5,0,5
2001,Iran (Islamic Rep. of),IRN,Croatia,HRV,0,0,29,0,29
2001,Iraq,IRQ,Croatia,HRV,0,0,5,0,5
2001,North Macedonia,MKD,Croatia,HRV,0,0,0,5,5
2001,Pakistan,PAK,Croatia,HRV,0,0,5,0,5
2001,Russian Federation,RUS,Croatia,HRV,0,0,5,0,5
2001,Serbia and Kosovo: S/RES/1244 (1999),SRB,Croatia,HRV,0,0,10,0,10
2001,Sierra Leone,SLE,Croatia,HRV,0,0,5,0,5
2001,Somalia,SOM,Croatia,HRV,0,0,5,0,5
2001,Afghanistan,AFG,Hungary,HUN,52,106,843,2635,3636
2001,Algeria,DZA,Hungary,HUN,10,0,42,32,84
2001,Angola,AGO,Hungary,HUN,0,0,10,10,20
2001,Egypt,EGY,Hungary,HUN,0,0,0,23,23
2001,Armenia,ARM,Hungary,HUN,11,0,21,23,55
2001,Azerbaijan,AZE,Hungary,HUN,0,0,5,0,5
2001,Bangladesh,BGD,Hungary,HUN,0,0,695,690,1385
2001,Bosnia and Herzegovina,BIH,Hungary,HUN,0,0,10,10,20
2001,China,CHN,Hungary,HUN,0,0,45,89,134
2001,Cameroon,CMR,Hungary,HUN,5,5,5,15,30
2001,Dem. Rep. of the Congo,COD,Hungary,HUN,0,5,10,5,20
2001,Eritrea,ERI,Hungary,HUN,0,0,5,10,15
2001,Ethiopia,ETH,Hungary,HUN,5,10,13,26,54
2001,Palestinian,PSE,Hungary,HUN,10,5,29,35,79
2001,Georgia,GEO,Hungary,HUN,5,0,10,19,34
2001,Ghana,GHA,Hungary,HUN,0,0,15,10,25
2001,Cote d'Ivoire,CIV,Hungary,HUN,0,0,5,0,5
2001,India,IND,Hungary,HUN,0,0,75,120,195
2001,Iran (Islamic Rep. of),IRN,Hungary,HUN,0,5,48,71,124
2001,Iraq,IRQ,Hungary,HUN,48,49,335,559,991
2001,Lebanon,LBN,Hungary,HUN,0,0,5,10,15
2001,Sri Lanka,LKA,Hungary,HUN,0,0,34,27,61
2001,North Macedonia,MKD,Hungary,HUN,0,0,37,63,100
2001,Rep. of Moldova,MDA,Hungary,HUN,0,0,10,10,20
2001,Mongolia,MNG,Hungary,HUN,0,0,10,5,15
2001,Morocco,MAR,Hungary,HUN,0,0,10,5,15
2001,Nepal,NPL,Hungary,HUN,0,0,5,0,5
2001,Nigeria,NGA,Hungary,HUN,0,5,32,39,76
2001,Pakistan,PAK,Hungary,HUN,0,0,66,71,137
2001,Romania,ROU,Hungary,HUN,10,0,72,5,87
2001,Russian Federation,RUS,Hungary,HUN,5,5,27,13,50
2001,Rwanda,RWA,Hungary,HUN,0,0,5,0,5
2001,Serbia and Kosovo: S/RES/1244 (1999),SRB,Hungary,HUN,0,65,103,71,239
2001,Senegal,SEN,Hungary,HUN,0,0,0,5,5
2001,Sierra Leone,SLE,Hungary,HUN,0,10,116,127,253
2001,Somalia,SOM,Hungary,HUN,5,13,54,194,266
2001,Viet Nam,VNM,Hungary,HUN,0,0,44,14,58
2001,Sudan,SDN,Hungary,HUN,0,5,59,28,92
2001,Syrian Arab Rep.,SYR,Hungary,HUN,0,0,11,12,23
2001,Tunisia,TUN,Hungary,HUN,0,0,0,5,5
2001,Turkey,TUR,Hungary,HUN,0,0,30,41,71
2001,Ukraine,UKR,Hungary,HUN,0,0,19,0,19
2001,Uzbekistan,UZB,Hungary,HUN,0,0,5,0,5
2001,Stateless,XXA,Hungary,HUN,0,0,10,0,10
2001,Afghanistan,AFG,Iceland,ISL,0,0,5,0,5
2001,Algeria,DZA,Iceland,ISL,0,0,0,5,5
2001,Iran (Islamic Rep. of),IRN,Iceland,ISL,0,0,0,5,5
2001,North Macedonia,MKD,Iceland,ISL,0,0,0,5,5
2001,Romania,ROU,Iceland,ISL,0,0,0,5,5
2001,Serbia and Kosovo: S/RES/1244 (1999),SRB,Iceland,ISL,0,0,5,0,5
2001,Afghanistan,AFG,Cote d'Ivoire,CIV,5,0,0,0,5
2001,Burundi,BDI,Cote d'Ivoire,CIV,5,0,5,0,10
2001,Congo,COG,Cote d'Ivoire,CIV,93,0,12,0,105
2001,Dem. Rep. of the Congo,COD,Cote d'Ivoire,CIV,53,0,37,0,90
2001,Liberia,LBR,Cote d'Ivoire,CIV,162,7523,0,0,7685
2001,Nigeria,NGA,Cote d'Ivoire,CIV,0,0,5,0,5
2001,Rwanda,RWA,Cote d'Ivoire,CIV,34,0,10,0,44
2001,Sierra Leone,SLE,Cote d'Ivoire,CIV,316,21,0,0,337
2001,Afghanistan,AFG,Ireland,IRL,0,0,5,10,15
2001,Albania,ALB,Ireland,IRL,5,0,27,61,93
2001,Algeria,DZA,Ireland,IRL,0,5,233,134,372
2001,Angola,AGO,Ireland,IRL,44,5,108,47,204
2001,Egypt,EGY,Ireland,IRL,5,0,0,13,18
2001,Armenia,ARM,Ireland,IRL,0,0,20,11,31
2001,Azerbaijan,AZE,Ireland,IRL,0,0,11,5,16
2001,Burundi,BDI,Ireland,IRL,5,0,12,5,22
2001,Belgium,BEL,Ireland,IRL,0,0,0,5,5
2001,Benin,BEN,Ireland,IRL,0,0,0,5,5
2001,Bangladesh,BGD,Ireland,IRL,0,0,5,0,5
2001,Burkina Faso,BFA,Ireland,IRL,0,0,0,5,5
2001,Belarus,BLR,Ireland,IRL,0,0,23,74,97
2001,Bosnia and Herzegovina,BIH,Ireland,IRL,0,0,5,0,5
2001,Bulgaria,BGR,Ireland,IRL,0,5,76,68,149
2001,China,CHN,Ireland,IRL,0,0,5,5,10
2001,Cameroon,CMR,Ireland,IRL,10,0,23,55,88
2001,Congo,COG,Ireland,IRL,14,0,5,13,32
2001,Dem. Rep. of the Congo,COD,Ireland,IRL,50,5,113,164,332
2001,Czechia,CZE,Ireland,IRL,11,0,112,130,253
2001,Eritrea,ERI,Ireland,IRL,5,0,0,0,5
2001,Estonia,EST,Ireland,IRL,0,0,10,23,33
2001,Ethiopia,ETH,Ireland,IRL,0,0,10,5,15
2001,Gabon,GAB,Ireland,IRL,0,0,5,0,5
2001,Gambia,GMB,Ireland,IRL,0,0,0,12,12
2001,Palestinian,PSE,Ireland,IRL,0,0,5,10,15
2001,Georgia,GEO,Ireland,IRL,5,0,26,29,60
2001,Ghana,GHA,Ireland,IRL,5,0,31,85,121
2001,Guinea,GIN,Ireland,IRL,0,0,5,5,10
2001,Croatia,HRV,Ireland,IRL,14,0,45,25,84
2001,Hungary,HUN,Ireland,IRL,0,0,0,14,14
2001,Cote d'Ivoire,CIV,Ireland,IRL,0,0,26,31,57
2001,India,IND,Ireland,IRL,0,0,0,16,16
2001,Iran (Islamic Rep. of),IRN,Ireland,IRL,5,0,5,5,15
2001,Iraq,IRQ,Ireland,IRL,35,0,29,23,87
2001,Jamaica,JAM,Ireland,IRL,0,0,0,5,5
2001,Kazakhstan,KAZ,Ireland,IRL,12,0,19,21,52
2001,Kenya,KEN,Ireland,IRL,5,0,16,39,60
2001,Kyrgyzstan,KGZ,Ireland,IRL,0,0,0,10,10
2001,Liberia,LBR,Ireland,IRL,0,0,5,10,15
2001,Libya,LBY,Ireland,IRL,5,0,12,20,37
2001,Lebanon,LBN,Ireland,IRL,0,0,5,5,10
2001,Sri Lanka,LKA,Ireland,IRL,0,0,5,28,33
2001,Lithuania,LTU,Ireland,IRL,0,0,24,168,192
2001,Latvia,LVA,Ireland,IRL,0,5,35,40,80
2001,North Macedonia,MKD,Ireland,IRL,0,0,0,17,17
2001,Rep. of Moldova,MDA,Ireland,IRL,0,0,206,285,491
2001,Mongolia,MNG,Ireland,IRL,0,0,0,5,5
2001,Morocco,MAR,Ireland,IRL,0,0,0,14,14
2001,Nigeria,NGA,Ireland,IRL,27,5,1268,2569,3869
2001,Pakistan,PAK,Ireland,IRL,5,0,25,43,73
2001,Philippines,PHL,Ireland,IRL,0,0,5,0,5
2001,Poland,POL,Ireland,IRL,0,0,109,220,329
2001,Romania,ROU,Ireland,IRL,5,17,1127,1602,2751
2001,South Africa,ZAF,Ireland,IRL,0,0,67,83,150
2001,Russian Federation,RUS,Ireland,IRL,12,0,167,192,371
2001,Rwanda,RWA,Ireland,IRL,5,0,5,13,23
2001,Serbia and Kosovo: S/RES/1244 (1999),SRB,Ireland,IRL,49,5,156,164,374
2001,Sierra Leone,SLE,Ireland,IRL,19,0,76,94,189
2001,Somalia,SOM,Ireland,IRL,34,0,40,89,163
2001,Sudan,SDN,Ireland,IRL,5,0,21,11,37
2001,Slovakia,SVK,Ireland,IRL,0,0,10,13,23
2001,Syrian Arab Rep.,SYR,Ireland,IRL,5,0,0,0,5
2001,United Rep. of Tanzania,TZA,Ireland,IRL,5,0,0,5,10
2001,Tajikistan,TJK,Ireland,IRL,0,0,0,5,5
2001,Togo,TGO,Ireland,IRL,11,0,5,17,33
2001,Turkey,TUR,Ireland,IRL,0,0,11,13,24
2001,Uganda,UGA,Ireland,IRL,5,0,5,5,15
2001,Ukraine,UKR,Ireland,IRL,0,0,92,247,339
2001,Uzbekistan,UZB,Ireland,IRL,0,0,5,14,19
2001,Zimbabwe,ZWE,Ireland,IRL,0,0,11,11,22
2001,Stateless,XXA,Ireland,IRL,0,0,0,16,16
2001,Afghanistan,AFG,Japan,JPN,0,11,31,5,47
2001,Bangladesh,BGD,Japan,JPN,0,0,5,0,5
2001,Ethiopia,ETH,Japan,JPN,0,5,5,0,10
2001,Iran (Islamic Rep. of),IRN,Japan,JPN,10,5,0,0,15
2001,Sri Lanka,LKA,Japan,JPN,0,0,5,0,5
2001,Myanmar,MMR,Japan,JPN,12,40,17,0,69
2001,Pakistan,PAK,Japan,JPN,0,5,31,10,46
2001,Sudan,SDN,Japan,JPN,0,0,5,0,5
2001,Turkey,TUR,Japan,JPN,0,0,164,11,175
2001,Stateless,XXA,Japan,JPN,0,0,5,0,5
2001,Unknown ,,Japan,JPN,0,0,10,0,10
2001,Afghanistan,AFG,Kazakhstan,KAZ,46,0,10,163,219
2001,Afghanistan,AFG,Kyrgyzstan,KGZ,159,0,67,47,273
2001,Russian Federation,RUS,Kyrgyzstan,KGZ,0,0,0,124,124
2001,Tajikistan,TJK,Kyrgyzstan,KGZ,0,191,27,0,218
2001,Dem. Rep. of the Congo,COD,Rep. of Korea,KOR,0,0,0,5,5
2001,Myanmar,MMR,Rep. of Korea,KOR,0,0,0,5,5
2001,Bosnia and Herzegovina,BIH,Liechtenstein,LIE,0,0,5,0,5
2001,North Macedonia,MKD,Liechtenstein,LIE,0,0,0,5,5
2001,Serbia and Kosovo: S/RES/1244 (1999),SRB,Liechtenstein,LIE,0,5,28,10,43
2001,Afghanistan,AFG,Lithuania,LTU,0,0,5,17,22
2001,Belarus,BLR,Lithuania,LTU,0,0,5,0,5
2001,Sri Lanka,LKA,Lithuania,LTU,0,0,0,5,5
2001,Russian Federation,RUS,Lithuania,LTU,0,0,125,68,193
2001,Unknown ,,Luxembourg,LUX,89,353,1531,73,2046
2001,Russian Federation,RUS,Latvia,LVA,0,0,11,0,11
2001,Bosnia and Herzegovina,BIH,North Macedonia,MKD,5,0,0,0,5
2001,Serbia and Kosovo: S/RES/1244 (1999),SRB,North Macedonia,MKD,25,0,64,41,130
2001,Uzbekistan,UZB,North Macedonia,MKD,0,0,5,0,5
2001,Congo,COG,Mali,MLI,5,0,0,0,5
2001,Sierra Leone,SLE,Mali,MLI,21,0,0,0,21
2001,Ethiopia,ETH,Mozambique,MOZ,0,0,0,5,5
2001,Rwanda,RWA,Mozambique,MOZ,0,0,0,5,5
2001,Sudan,SDN,Mozambique,MOZ,0,0,0,5,5
2001,Dem. Rep. of the Congo,COD,Namibia,NAM,5,0,0,0,5
2001,Bhutan,BTN,Nepal,NPL,0,10,11,0,21
2001,China,CHN,Nepal,NPL,5,0,5,0,10
2001,Iraq,IRQ,Nepal,NPL,0,0,5,5,10
2001,Afghanistan,AFG,Netherlands,NLD,79,2018,1003,1693,4793
2001,Albania,ALB,Netherlands,NLD,0,0,73,86,159
2001,Algeria,DZA,Netherlands,NLD,0,5,186,187,378
2001,Angola,AGO,Netherlands,NLD,0,215,952,611,1778
2001,Egypt,EGY,Netherlands,NLD,0,0,15,14,29
2001,Armenia,ARM,Netherlands,NLD,0,45,394,341,780
2001,Azerbaijan,AZE,Netherlands,NLD,5,63,550,453,1071
2001,Burundi,BDI,Netherlands,NLD,0,269,43,83,395
2001,Belgium,BEL,Netherlands,NLD,0,0,0,5,5
2001,Benin,BEN,Netherlands,NLD,0,5,37,11,53
2001,Bangladesh,BGD,Netherlands,NLD,0,0,39,29,68
2001,Burkina Faso,BFA,Netherlands,NLD,0,0,20,10,30
2001,Belarus,BLR,Netherlands,NLD,0,5,44,30,79
2001,Bosnia and Herzegovina,BIH,Netherlands,NLD,0,74,651,714,1439
2001,Bulgaria,BGR,Netherlands,NLD,0,0,17,10,27
2001,Cambodia,KHM,Netherlands,NLD,0,0,12,0,12
2001,Central African Rep.,CAF,Netherlands,NLD,0,0,0,5,5
2001,Chad,TCD,Netherlands,NLD,0,5,30,35,70
2001,China,CHN,Netherlands,NLD,0,59,524,388,971
2001,Cameroon,CMR,Netherlands,NLD,0,10,181,88,279
2001,Congo,COG,Netherlands,NLD,0,51,259,183,493
2001,Dem. Rep. of the Congo,COD,Netherlands,NLD,0,61,273,181,515
2001,Colombia,COL,Netherlands,NLD,0,10,15,17,42
2001,Cuba,CUB,Netherlands,NLD,0,0,5,5,10
2001,Czechia,CZE,Netherlands,NLD,0,0,58,72,130
2001,Denmark,DNK,Netherlands,NLD,0,0,0,5,5
2001,Djibouti,DJI,Netherlands,NLD,0,0,10,5,15
2001,Ecuador,ECU,Netherlands,NLD,0,0,0,5,5
2001,Eritrea,ERI,Netherlands,NLD,0,17,111,88,216
2001,Ethiopia,ETH,Netherlands,NLD,0,14,148,72,234
2001,France,FRA,Netherlands,NLD,0,0,0,5,5
2001,Gabon,GAB,Netherlands,NLD,0,0,5,0,5
2001,Gambia,GMB,Netherlands,NLD,0,0,11,5,16
2001,Palestinian,PSE,Netherlands,NLD,0,0,0,5,5
2001,Georgia,GEO,Netherlands,NLD,0,16,170,116,302
2001,Germany,DEU,Netherlands,NLD,0,0,0,5,5
2001,Ghana,GHA,Netherlands,NLD,0,0,5,17,22
2001,Guinea-Bissau,GNB,Netherlands,NLD,0,5,13,10,28
2001,Guinea,GIN,Netherlands,NLD,0,101,815,431,1347
2001,Croatia,HRV,Netherlands,NLD,0,5,39,66,110
2001,Hungary,HUN,Netherlands,NLD,0,0,37,45,82
2001,Cote d'Ivoire,CIV,Netherlands,NLD,0,5,65,28,98
2001,India,IND,Netherlands,NLD,0,0,36,44,80
2001,Indonesia,IDN,Netherlands,NLD,0,0,5,5,10
2001,Iran (Islamic Rep. of),IRN,Netherlands,NLD,10,77,1026,890,2003
2001,Iraq,IRQ,Netherlands,NLD,5,125,1322,905,2357
2001,Israel,ISR,Netherlands,NLD,0,0,14,5,19
2001,Italy,ITA,Netherlands,NLD,0,0,0,5,5
2001,Jordan,JOR,Netherlands,NLD,0,0,5,5,10
2001,Kazakhstan,KAZ,Netherlands,NLD,0,5,88,74,167
2001,Kenya,KEN,Netherlands,NLD,0,0,10,11,21
2001,Kyrgyzstan,KGZ,Netherlands,NLD,0,5,42,51,98
2001,Liberia,LBR,Netherlands,NLD,0,16,89,70,175
2001,Libya,LBY,Netherlands,NLD,0,0,28,34,62
2001,Lebanon,LBN,Netherlands,NLD,0,0,59,42,101
2001,Sri Lanka,LKA,Netherlands,NLD,0,25,329,435,789
2001,Lithuania,LTU,Netherlands,NLD,0,0,10,5,15
2001,Latvia,LVA,Netherlands,NLD,0,0,5,10,15
2001,Mauritania,MRT,Netherlands,NLD,0,10,67,34,111
2001,North Macedonia,MKD,Netherlands,NLD,0,0,75,67,142
2001,Rep. of Moldova,MDA,Netherlands,NLD,0,0,13,10,23
2001,Mali,MLI,Netherlands,NLD,0,0,5,5,10
2001,Mongolia,MNG,Netherlands,NLD,0,15,99,111,225
2001,Morocco,MAR,Netherlands,NLD,0,0,14,30,44
2001,Myanmar,MMR,Netherlands,NLD,0,5,15,5,25
2001,Nepal,NPL,Netherlands,NLD,0,0,11,18,29
2001,Netherlands,NLD,Netherlands,NLD,0,0,0,10,10
2001,Niger,NER,Netherlands,NLD,0,5,111,32,148
2001,Nigeria,NGA,Netherlands,NLD,0,5,214,115,334
2001,Pakistan,PAK,Netherlands,NLD,0,5,55,77,137
2001,Philippines,PHL,Netherlands,NLD,0,0,5,0,5
2001,Poland,POL,Netherlands,NLD,0,0,10,29,39
2001,Portugal,PRT,Netherlands,NLD,0,0,0,5,5
2001,Romania,ROU,Netherlands,NLD,0,0,16,24,40
2001,South Africa,ZAF,Netherlands,NLD,0,0,5,0,5
2001,Russian Federation,RUS,Netherlands,NLD,0,68,492,366,926
2001,Rwanda,RWA,Netherlands,NLD,5,73,130,92,300
2001,Serbia and Kosovo: S/RES/1244 (1999),SRB,Netherlands,NLD,108,102,989,1220,2419
2001,Senegal,SEN,Netherlands,NLD,0,0,5,5,10
2001,Sierra Leone,SLE,Netherlands,NLD,0,1006,470,615,2091
2001,Somalia,SOM,Netherlands,NLD,0,177,595,654,1426
2001,Viet Nam,VNM,Netherlands,NLD,0,5,20,22,47
2001,Sudan,SDN,Netherlands,NLD,5,176,516,432,1129
2001,Suriname,SUR,Netherlands,NLD,0,5,5,10,20
2001,Slovakia,SVK,Netherlands,NLD,0,0,162,182,344
2001,Slovenia,SVN,Netherlands,NLD,0,0,0,5,5
2001,Syrian Arab Rep.,SYR,Netherlands,NLD,10,57,354,338,759
2001,United Rep. of Tanzania,TZA,Netherlands,NLD,0,0,11,5,16
2001,Tajikistan,TJK,Netherlands,NLD,0,0,49,26,75
2001,Togo,TGO,Netherlands,NLD,0,19,294,127,440
2001,Tunisia,TUN,Netherlands,NLD,0,5,10,15,30
2001,Turkey,TUR,Netherlands,NLD,5,40,1017,761,1823
2001,Uganda,UGA,Netherlands,NLD,0,5,27,26,58
2001,Ukraine,UKR,Netherlands,NLD,0,10,99,116,225
2001,Uzbekistan,UZB,Netherlands,NLD,0,17,142,83,242
2001,Yemen,YEM,Netherlands,NLD,0,0,45,33,78
2001,Stateless,XXA,Netherlands,NLD,5,15,416,288,724
2001,Unknown ,,Netherlands,NLD,0,18,197,261,476
2001,Congo,COG,Nigeria,NGA,5,0,5,0,10
2001,Equatorial Guinea,GNQ,Nigeria,NGA,5,0,0,0,5
2001,Ethiopia,ETH,Nigeria,NGA,0,0,5,0,5
2001,Liberia,LBR,Nigeria,NGA,16,0,298,0,314
2001,Rwanda,RWA,Nigeria,NGA,0,0,5,0,5
2001,Sierra Leone,SLE,Nigeria,NGA,66,0,32,0,98
2001,Sudan,SDN,Nigeria,NGA,0,0,5,0,5
2001,Afghanistan,AFG,Norway,NOR,31,341,339,11,722
2001,Albania,ALB,Norway,NOR,0,13,27,12,52
2001,Algeria,DZA,Norway,NOR,0,22,70,34,126
2001,Angola,AGO,Norway,NOR,0,10,0,0,10
2001,Egypt,EGY,Norway,NOR,0,0,5,0,5
2001,Armenia,ARM,Norway,NOR,0,34,95,11,140
2001,Azerbaijan,AZE,Norway,NOR,0,20,32,10,62
2001,Burundi,BDI,Norway,NOR,0,10,40,0,50
2001,Bangladesh,BGD,Norway,NOR,0,11,12,5,28
2001,Belarus,BLR,Norway,NOR,0,28,129,45,202
2001,Bosnia and Herzegovina,BIH,Norway,NOR,5,41,397,46,489
2001,Bulgaria,BGR,Norway,NOR,0,0,537,251,788
2001,China,CHN,Norway,NOR,5,5,11,0,21
2001,Chile,CHL,Norway,NOR,0,0,5,0,5
2001,Cameroon,CMR,Norway,NOR,0,10,5,0,15
2001,Congo,COG,Norway,NOR,0,5,57,0,62
2001,Dem. Rep. of the Congo,COD,Norway,NOR,0,10,33,0,43
2001,Czechia,CZE,Norway,NOR,0,0,262,18,280
2001,Eritrea,ERI,Norway,NOR,0,52,37,0,89
2001,Estonia,EST,Norway,NOR,0,0,28,0,28
2001,Ethiopia,ETH,Norway,NOR,5,90,72,0,167
2001,Georgia,GEO,Norway,NOR,0,41,67,21,129
2001,Croatia,HRV,Norway,NOR,0,22,804,43,869
2001,India,IND,Norway,NOR,0,10,10,0,20
2001,Indonesia,IDN,Norway,NOR,0,0,5,0,5
2001,Iran (Islamic Rep. of),IRN,Norway,NOR,20,101,122,20,263
2001,Iraq,IRQ,Norway,NOR,10,252,138,93,493
2001,Israel,ISR,Norway,NOR,0,0,10,0,10
2001,Jordan,JOR,Norway,NOR,0,0,5,0,5
2001,Kazakhstan,KAZ,Norway,NOR,0,52,42,5,99
2001,Kenya,KEN,Norway,NOR,0,0,10,0,10
2001,Kyrgyzstan,KGZ,Norway,NOR,0,0,10,0,10
2001,Liberia,LBR,Norway,NOR,0,0,46,0,46
2001,Libya,LBY,Norway,NOR,0,0,10,5,15
2001,Lebanon,LBN,Norway,NOR,0,0,15,0,15
2001,Sri Lanka,LKA,Norway,NOR,0,111,205,5,321
2001,Lithuania,LTU,Norway,NOR,0,0,67,45,112
2001,Latvia,LVA,Norway,NOR,0,0,18,12,30
2001,North Macedonia,MKD,Norway,NOR,0,5,65,13,83
2001,Rep. of Moldova,MDA,Norway,NOR,0,20,41,5,66
2001,Mongolia,MNG,Norway,NOR,0,0,26,12,38
2001,Morocco,MAR,Norway,NOR,0,0,15,5,20
2001,Namibia,NAM,Norway,NOR,0,0,5,0,5
2001,Nepal,NPL,Norway,NOR,0,10,18,0,28
2001,Niger,NER,Norway,NOR,0,5,5,0,10
2001,Pakistan,PAK,Norway,NOR,10,155,116,26,307
2001,Peru,PER,Norway,NOR,0,0,5,0,5
2001,Poland,POL,Norway,NOR,0,0,20,0,20
2001,Romania,ROU,Norway,NOR,0,5,340,214,559
2001,Russian Federation,RUS,Norway,NOR,25,144,511,86,766
2001,Rwanda,RWA,Norway,NOR,0,0,34,0,34
2001,Serbia and Kosovo: S/RES/1244 (1999),SRB,Norway,NOR,167,1509,3144,139,4959
2001,Sierra Leone,SLE,Norway,NOR,0,28,16,5,49
2001,Somalia,SOM,Norway,NOR,5,643,81,48,777
2001,Sudan,SDN,Norway,NOR,0,27,26,0,53
2001,Slovakia,SVK,Norway,NOR,0,0,225,29,254
2001,Slovenia,SVN,Norway,NOR,0,0,5,0,5
2001,Syrian Arab Rep.,SYR,Norway,NOR,5,18,47,5,75
2001,Tajikistan,TJK,Norway,NOR,0,12,14,5,31
2001,Turkmenistan,TKM,Norway,NOR,0,5,0,0,5
2001,Tunisia,TUN,Norway,NOR,0,0,0,5,5
2001,Turkey,TUR,Norway,NOR,0,19,153,24,196
2001,Uganda,UGA,Norway,NOR,0,5,5,0,10
2001,Ukraine,UKR,Norway,NOR,0,59,152,22,233
2001,Uzbekistan,UZB,Norway,NOR,0,5,5,0,10
2001,Stateless,XXA,Norway,NOR,0,53,115,13,181
2001,Afghanistan,AFG,New Zealand,NZL,138,0,10,0,148
2001,Albania,ALB,New Zealand,NZL,0,0,5,0,5
2001,Algeria,DZA,New Zealand,NZL,5,0,20,0,25
2001,Egypt,EGY,New Zealand,NZL,0,0,5,0,5
2001,Austria,AUT,New Zealand,NZL,0,0,5,0,5
2001,Bangladesh,BGD,New Zealand,NZL,0,0,27,0,27
2001,Bolivia (Plurinational State of),BOL,New Zealand,NZL,0,0,10,0,10
2001,Bulgaria,BGR,New Zealand,NZL,0,0,10,0,10
2001,Cambodia,KHM,New Zealand,NZL,5,0,5,0,10
2001,China,CHN,New Zealand,NZL,14,0,144,0,158
2001,Chile,CHL,New Zealand,NZL,0,0,12,0,12
2001,Congo,COG,New Zealand,NZL,5,0,5,0,10
2001,Colombia,COL,New Zealand,NZL,5,0,5,0,10
2001,Czechia,CZE,New Zealand,NZL,0,0,42,0,42
2001,Ecuador,ECU,New Zealand,NZL,0,0,5,0,5
2001,Ethiopia,ETH,New Zealand,NZL,5,0,0,0,5
2001,Fiji,FJI,New Zealand,NZL,0,0,36,0,36
2001,Ghana,GHA,New Zealand,NZL,0,0,5,0,5
2001,India,IND,New Zealand,NZL,5,0,196,0,201
2001,Indonesia,IDN,New Zealand,NZL,0,0,40,0,40
2001,Iran (Islamic Rep. of),IRN,New Zealand,NZL,77,0,39,0,116
2001,Iraq,IRQ,New Zealand,NZL,26,0,10,0,36
2001,Israel,ISR,New Zealand,NZL,0,0,5,0,5
2001,Kuwait,KWT,New Zealand,NZL,25,0,0,0,25
2001,Lebanon,LBN,New Zealand,NZL,0,0,5,0,5
2001,Sri Lanka,LKA,New Zealand,NZL,96,0,45,0,141
2001,Lithuania,LTU,New Zealand,NZL,0,0,5,0,5
2001,Latvia,LVA,New Zealand,NZL,0,0,5,0,5
2001,North Macedonia,MKD,New Zealand,NZL,0,0,5,0,5
2001,Malaysia,MYS,New Zealand,NZL,5,0,20,0,25
2001,Mongolia,MNG,New Zealand,NZL,5,0,0,0,5
2001,Morocco,MAR,New Zealand,NZL,0,0,5,0,5
2001,Myanmar,MMR,New Zealand,NZL,5,0,0,0,5
2001,Nigeria,NGA,New Zealand,NZL,0,0,12,0,12
2001,Pakistan,PAK,New Zealand,NZL,0,0,23,0,23
2001,Philippines,PHL,New Zealand,NZL,0,0,18,0,18
2001,Romania,ROU,New Zealand,NZL,0,0,10,0,10
2001,South Africa,ZAF,New Zealand,NZL,0,0,10,0,10
2001,Russian Federation,RUS,New Zealand,NZL,0,0,5,0,5
2001,Serbia and Kosovo: S/RES/1244 (1999),SRB,New Zealand,NZL,0,0,5,0,5
2001,Sierra Leone,SLE,New Zealand,NZL,0,0,10,0,10
2001,Somalia,SOM,New Zealand,NZL,5,0,5,0,10
2001,Viet Nam,VNM,New Zealand,NZL,5,0,33,0,38
2001,Slovakia,SVK,New Zealand,NZL,0,0,5,0,5
2001,United Rep. of Tanzania,TZA,New Zealand,NZL,0,0,5,0,5
2001,Thailand,THA,New Zealand,NZL,0,0,442,0,442
2001,Tonga,TON,New Zealand,NZL,0,0,16,0,16
2001,Turkey,TUR,New Zealand,NZL,0,0,5,0,5
2001,Ukraine,UKR,New Zealand,NZL,0,0,10,0,10
2001,Zimbabwe,ZWE,New Zealand,NZL,0,0,58,0,58
2001,Unknown ,,New Zealand,NZL,10,0,624,0,634
2001,Albania,ALB,Panama,PAN,5,0,0,0,5
2001,Colombia,COL,Panama,PAN,53,0,40,10,103
2001,Russian Federation,RUS,Peru,PER,5,0,0,0,5
2001,Afghanistan,AFG,Poland,POL,13,0,117,300,430
2001,Algeria,DZA,Poland,POL,0,0,5,10,15
2001,Egypt,EGY,Poland,POL,0,0,5,0,5
2001,Armenia,ARM,Poland,POL,0,0,878,74,952
2001,Azerbaijan,AZE,Poland,POL,0,0,76,62,138
2001,Bangladesh,BGD,Poland,POL,0,0,10,10,20
2001,Belarus,BLR,Poland,POL,22,0,69,16,107
2001,Bulgaria,BGR,Poland,POL,0,0,187,11,198
2001,China,CHN,Poland,POL,0,0,15,5,20
2001,Cameroon,CMR,Poland,POL,0,0,0,5,5
2001,Dem. Rep. of the Congo,COD,Poland,POL,0,0,5,0,5
2001,Georgia,GEO,Poland,POL,0,0,53,41,94
2001,Ghana,GHA,Poland,POL,0,0,0,5,5
2001,India,IND,Poland,POL,0,0,25,10,35
2001,Iraq,IRQ,Poland,POL,0,0,10,106,116
2001,Jordan,JOR,Poland,POL,0,0,5,0,5
2001,Kazakhstan,KAZ,Poland,POL,0,0,19,11,30
2001,Kyrgyzstan,KGZ,Poland,POL,0,0,5,5,10
2001,Liberia,LBR,Poland,POL,0,0,0,5,5
2001,Lebanon,LBN,Poland,POL,0,0,0,5,5
2001,Sri Lanka,LKA,Poland,POL,0,0,5,29,34
2001,Lithuania,LTU,Poland,POL,0,0,5,5,10
2001,Rep. of Moldova,MDA,Poland,POL,0,0,190,58,248
2001,Mongolia,MNG,Poland,POL,0,0,302,28,330
2001,Morocco,MAR,Poland,POL,0,0,5,5,10
2001,Nigeria,NGA,Poland,POL,0,0,5,5,10
2001,Pakistan,PAK,Poland,POL,0,0,17,38,55
2001,Romania,ROU,Poland,POL,0,0,256,25,281
2001,Russian Federation,RUS,Poland,POL,206,0,211,801,1218
2001,Serbia and Kosovo: S/RES/1244 (1999),SRB,Poland,POL,5,0,5,30,40
2001,Senegal,SEN,Poland,POL,0,0,0,5,5
2001,Somalia,SOM,Poland,POL,10,0,0,16,26
2001,Viet Nam,VNM,Poland,POL,0,0,187,27,214
2001,Sudan,SDN,Poland,POL,5,0,5,0,10
2001,Syrian Arab Rep.,SYR,Poland,POL,0,0,10,5,15
2001,Turkey,TUR,Poland,POL,0,0,0,10,10
2001,Ukraine,UKR,Poland,POL,0,0,122,26,148
2001,Uzbekistan,UZB,Poland,POL,0,0,10,5,15
2001,Stateless,XXA,Poland,POL,0,0,12,0,12
2001,Afghanistan,AFG,Portugal,PRT,0,5,0,5,10
2001,Albania,ALB,Portugal,PRT,0,0,0,5,5
2001,Angola,AGO,Portugal,PRT,0,5,0,23,28
2001,Dem. Rep. of the Congo,COD,Portugal,PRT,0,0,0,10,10
2001,Cuba,CUB,Portugal,PRT,5,0,0,5,10
2001,Gambia,GMB,Portugal,PRT,0,0,0,13,13
2001,Guinea,GIN,Portugal,PRT,0,0,0,5,5
2001,Iran (Islamic Rep. of),IRN,Portugal,PRT,0,0,0,5,5
2001,Sri Lanka,LKA,Portugal,PRT,0,0,0,5,5
2001,North Macedonia,MKD,Portugal,PRT,0,0,0,5,5
2001,Nigeria,NGA,Portugal,PRT,0,0,0,5,5
2001,Pakistan,PAK,Portugal,PRT,0,0,0,5,5
2001,Russian Federation,RUS,Portugal,PRT,0,0,0,5,5
2001,Sierra Leone,SLE,Portugal,PRT,0,13,0,25,38
2001,Zimbabwe,ZWE,Portugal,PRT,0,5,0,0,5
2001,Afghanistan,AFG,Romania,ROU,10,5,769,5,789
2001,Algeria,DZA,Romania,ROU,0,0,16,0,16
2001,Egypt,EGY,Romania,ROU,0,0,10,0,10
2001,Bangladesh,BGD,Romania,ROU,0,0,33,0,33
2001,China,CHN,Romania,ROU,0,0,36,5,41
2001,Cameroon,CMR,Romania,ROU,0,0,5,0,5
2001,Congo,COG,Romania,ROU,10,0,16,0,26
2001,Djibouti,DJI,Romania,ROU,0,0,5,5,10
2001,Eritrea,ERI,Romania,ROU,0,0,5,0,5
2001,Palestinian,PSE,Romania,ROU,10,0,31,0,41
2001,India,IND,Romania,ROU,0,0,129,5,134
2001,Iran (Islamic Rep. of),IRN,Romania,ROU,14,0,84,5,103
2001,Iraq,IRQ,Romania,ROU,15,20,601,10,646
2001,Jordan,JOR,Romania,ROU,0,0,10,0,10
2001,Liberia,LBR,Romania,ROU,0,0,5,0,5
2001,Lebanon,LBN,Romania,ROU,0,0,10,0,10
2001,Sri Lanka,LKA,Romania,ROU,0,0,10,0,10
2001,Nigeria,NGA,Romania,ROU,0,0,5,0,5
2001,Pakistan,PAK,Romania,ROU,0,0,107,5,112
2001,Russian Federation,RUS,Romania,ROU,0,0,5,0,5
2001,Rwanda,RWA,Romania,ROU,0,0,5,0,5
2001,Serbia and Kosovo: S/RES/1244 (1999),SRB,Romania,ROU,5,0,22,10,37
2001,Sierra Leone,SLE,Romania,ROU,0,0,30,5,35
2001,Somalia,SOM,Romania,ROU,5,0,167,0,172
2001,Sudan,SDN,Romania,ROU,5,0,50,0,55
2001,Syrian Arab Rep.,SYR,Romania,ROU,0,0,15,0,15
2001,Turkey,TUR,Romania,ROU,5,0,35,5,45
2001,Unknown ,,Romania,ROU,0,0,5,0,5
2001,Afghanistan,AFG,South Africa,ZAF,5,0,0,0,5
2001,Algeria,DZA,South Africa,ZAF,0,0,82,11,93
2001,Angola,AGO,South Africa,ZAF,860,0,36,68,964
2001,Egypt,EGY,South Africa,ZAF,0,0,41,5,46
2001,Burundi,BDI,South Africa,ZAF,808,0,234,5,1047
2001,Benin,BEN,South Africa,ZAF,0,0,75,5,80
2001,Bangladesh,BGD,South Africa,ZAF,0,0,268,30,298
2001,Bosnia and Herzegovina,BIH,South Africa,ZAF,10,0,5,0,15
2001,Bulgaria,BGR,South Africa,ZAF,0,0,96,12,108
2001,China,CHN,South Africa,ZAF,0,0,229,64,293
2001,Cameroon,CMR,South Africa,ZAF,0,0,252,10,262
2001,Congo,COG,South Africa,ZAF,219,0,614,21,854
2001,Dem. Rep. of the Congo,COD,South Africa,ZAF,561,0,367,175,1103
2001,Comoros,COM,South Africa,ZAF,0,0,63,5,68
2001,Eritrea,ERI,South Africa,ZAF,0,0,212,30,242
2001,Ethiopia,ETH,South Africa,ZAF,5,0,1336,78,1419
2001,Ghana,GHA,South Africa,ZAF,5,0,323,18,346
2001,Cote d'Ivoire,CIV,South Africa,ZAF,0,0,190,20,210
2001,India,IND,South Africa,ZAF,0,0,1132,58,1190
2001,Iran (Islamic Rep. of),IRN,South Africa,ZAF,0,0,5,0,5
2001,Iraq,IRQ,South Africa,ZAF,0,0,12,5,17
2001,Kenya,KEN,South Africa,ZAF,0,0,288,5,293
2001,Liberia,LBR,South Africa,ZAF,45,0,54,5,104
2001,Sri Lanka,LKA,South Africa,ZAF,0,0,14,0,14
2001,Mali,MLI,South Africa,ZAF,0,0,22,5,27
2001,Mozambique,MOZ,South Africa,ZAF,0,0,0,5,5
2001,Nigeria,NGA,South Africa,ZAF,5,0,804,108,917
2001,Pakistan,PAK,South Africa,ZAF,5,0,1180,132,1317
2001,Rwanda,RWA,South Africa,ZAF,427,0,65,11,503
2001,Serbia and Kosovo: S/RES/1244 (1999),SRB,South Africa,ZAF,0,0,33,0,33
2001,Senegal,SEN,South Africa,ZAF,0,0,322,25,347
2001,Sierra Leone,SLE,South Africa,ZAF,41,0,147,10,198
2001,Somalia,SOM,South Africa,ZAF,530,0,64,54,648
2001,Sudan,SDN,South Africa,ZAF,50,0,61,5,116
2001,United Rep. of Tanzania,TZA,South Africa,ZAF,0,0,402,0,402
2001,Uganda,UGA,South Africa,ZAF,0,0,374,10,384
2001,Zambia,ZMB,South Africa,ZAF,5,0,38,0,43
2001,Zimbabwe,ZWE,South Africa,ZAF,5,0,5,0,10
2001,Unknown ,,South Africa,ZAF,0,0,225,311,536
2001,Afghanistan,AFG,Russian Federation,RUS,119,0,1132,0,1251
2001,Angola,AGO,Russian Federation,RUS,0,0,11,0,11
2001,Armenia,ARM,Russian Federation,RUS,0,0,11,0,11
2001,Azerbaijan,AZE,Russian Federation,RUS,0,0,18,0,18
2001,Cambodia,KHM,Russian Federation,RUS,0,0,5,0,5
2001,Dem. Rep. of the Congo,COD,Russian Federation,RUS,0,0,11,0,11
2001,Ethiopia,ETH,Russian Federation,RUS,0,0,10,0,10
2001,Georgia,GEO,Russian Federation,RUS,5,0,35,0,40
2001,Iraq,IRQ,Russian Federation,RUS,5,0,60,0,65
2001,Kazakhstan,KAZ,Russian Federation,RUS,0,0,45,0,45
2001,Kyrgyzstan,KGZ,Russian Federation,RUS,0,0,5,0,5
2001,Rep. of Moldova,MDA,Russian Federation,RUS,0,0,11,0,11
2001,Rwanda,RWA,Russian Federation,RUS,0,0,19,0,19
2001,Somalia,SOM,Russian Federation,RUS,0,0,5,0,5
2001,Sudan,SDN,Russian Federation,RUS,0,0,5,0,5
2001,Tajikistan,TJK,Russian Federation,RUS,0,0,23,0,23
2001,Turkmenistan,TKM,Russian Federation,RUS,0,0,10,0,10
2001,Ukraine,UKR,Russian Federation,RUS,0,0,5,0,5
2001,Uzbekistan,UZB,Russian Federation,RUS,0,0,27,0,27
2001,Unknown ,,Russian Federation,RUS,5,0,60,0,65
2001,Afghanistan,AFG,Serbia and Kosovo: S/RES/1244 (1999),SRB,13,0,5,5,23
2001,Bangladesh,BGD,Serbia and Kosovo: S/RES/1244 (1999),SRB,0,0,0,5,5
2001,Palestinian,PSE,Serbia and Kosovo: S/RES/1244 (1999),SRB,0,0,5,5,10
2001,Georgia,GEO,Serbia and Kosovo: S/RES/1244 (1999),SRB,0,0,5,5,10
2001,Iran (Islamic Rep. of),IRN,Serbia and Kosovo: S/RES/1244 (1999),SRB,0,0,0,5,5
2001,Iraq,IRQ,Serbia and Kosovo: S/RES/1244 (1999),SRB,5,0,17,5,27
2001,Pakistan,PAK,Serbia and Kosovo: S/RES/1244 (1999),SRB,0,0,0,5,5
2001,Romania,ROU,Serbia and Kosovo: S/RES/1244 (1999),SRB,0,0,5,0,5
2001,Russian Federation,RUS,Serbia and Kosovo: S/RES/1244 (1999),SRB,0,0,0,13,13
2001,Chad,TCD,Senegal,SEN,0,0,5,0,5
2001,Congo,COG,Senegal,SEN,0,0,5,0,5
2001,Dem. Rep. of the Congo,COD,Senegal,SEN,5,0,5,0,10
2001,Ethiopia,ETH,Senegal,SEN,0,0,5,0,5
2001,Guinea-Bissau,GNB,Senegal,SEN,0,0,5,0,5
2001,Liberia,LBR,Senegal,SEN,0,0,19,0,19
2001,Sri Lanka,LKA,Senegal,SEN,0,0,5,0,5
2001,Mauritania,MRT,Senegal,SEN,0,0,13,0,13
2001,Nigeria,NGA,Senegal,SEN,0,0,15,0,15
2001,Pakistan,PAK,Senegal,SEN,0,0,10,0,10
2001,Rwanda,RWA,Senegal,SEN,10,0,5,0,15
2001,Sierra Leone,SLE,Senegal,SEN,0,0,153,0,153
2001,Unknown ,,Senegal,SEN,0,0,5,0,5
2001,Afghanistan,AFG,Spain,ESP,15,0,28,5,48
2001,Albania,ALB,Spain,ESP,0,0,0,13,13
2001,Algeria,DZA,Spain,ESP,5,0,119,233,357
2001,Angola,AGO,Spain,ESP,0,12,45,13,70
2001,Egypt,EGY,Spain,ESP,0,0,0,5,5
2001,Argentina,ARG,Spain,ESP,0,0,0,10,10
2001,Armenia,ARM,Spain,ESP,28,10,272,195,505
2001,Azerbaijan,AZE,Spain,ESP,0,5,36,14,55
2001,Benin,BEN,Spain,ESP,0,0,0,5,5
2001,Bangladesh,BGD,Spain,ESP,0,0,5,24,29
2001,Belarus,BLR,Spain,ESP,0,0,0,12,12
2001,Bolivia (Plurinational State of),BOL,Spain,ESP,0,0,0,5,5
2001,Bosnia and Herzegovina,BIH,Spain,ESP,0,0,0,5,5
2001,Bulgaria,BGR,Spain,ESP,0,0,0,10,10
2001,China,CHN,Spain,ESP,0,0,5,10,15
2001,Cameroon,CMR,Spain,ESP,0,0,0,10,10
2001,Congo,COG,Spain,ESP,0,0,36,10,46
2001,Dem. Rep. of the Congo,COD,Spain,ESP,25,0,57,39,121
2001,Colombia,COL,Spain,ESP,76,91,475,817,1459
2001,Cuba,CUB,Spain,ESP,14,0,90,2192,2296
2001,Czechia,CZE,Spain,ESP,0,0,5,0,5
2001,Ecuador,ECU,Spain,ESP,0,0,5,17,22
2001,Equatorial Guinea,GNQ,Spain,ESP,22,5,25,15,67
2001,Eritrea,ERI,Spain,ESP,0,0,0,5,5
2001,Ethiopia,ETH,Spain,ESP,16,0,14,10,40
2001,Gambia,GMB,Spain,ESP,0,0,5,0,5
2001,Georgia,GEO,Spain,ESP,5,0,101,95,201
2001,Ghana,GHA,Spain,ESP,0,0,0,22,22
2001,Guinea-Bissau,GNB,Spain,ESP,0,0,15,5,20
2001,Guatemala,GTM,Spain,ESP,0,0,0,5,5
2001,Guinea,GIN,Spain,ESP,5,0,5,23,33
2001,Honduras,HND,Spain,ESP,5,0,0,0,5
2001,Croatia,HRV,Spain,ESP,0,0,5,5,10
2001,Cote d'Ivoire,CIV,Spain,ESP,0,0,10,11,21
2001,India,IND,Spain,ESP,0,0,10,25,35
2001,Iran (Islamic Rep. of),IRN,Spain,ESP,5,0,48,19,72
2001,Iraq,IRQ,Spain,ESP,0,22,47,47,116
2001,Kazakhstan,KAZ,Spain,ESP,0,0,0,5,5
2001,Kyrgyzstan,KGZ,Spain,ESP,0,0,0,5,5
2001,Liberia,LBR,Spain,ESP,0,5,14,34,53
2001,Lebanon,LBN,Spain,ESP,0,0,5,0,5
2001,Sri Lanka,LKA,Spain,ESP,0,0,0,21,21
2001,Lithuania,LTU,Spain,ESP,0,0,0,10,10
2001,Mauritania,MRT,Spain,ESP,0,0,0,5,5
2001,North Macedonia,MKD,Spain,ESP,0,0,0,14,14
2001,Rep. of Moldova,MDA,Spain,ESP,0,0,0,44,44
2001,Mali,MLI,Spain,ESP,0,0,0,5,5
2001,Mongolia,MNG,Spain,ESP,0,0,0,10,10
2001,Morocco,MAR,Spain,ESP,0,0,16,17,33
2001,Nepal,NPL,Spain,ESP,0,0,0,5,5
2001,Nigeria,NGA,Spain,ESP,0,0,15,1239,1254
2001,Pakistan,PAK,Spain,ESP,5,5,31,21,62
2001,Peru,PER,Spain,ESP,5,0,16,10,31
2001,Poland,POL,Spain,ESP,0,0,0,5,5
2001,Romania,ROU,Spain,ESP,0,0,5,320,325
2001,Russian Federation,RUS,Spain,ESP,50,35,102,221,408
2001,Rwanda,RWA,Spain,ESP,0,0,5,5,10
2001,Serbia and Kosovo: S/RES/1244 (1999),SRB,Spain,ESP,0,17,60,29,106
2001,Senegal,SEN,Spain,ESP,0,0,5,10,15
2001,Sierra Leone,SLE,Spain,ESP,0,30,110,596,736
2001,Somalia,SOM,Spain,ESP,0,5,51,5,61
2001,Sudan,SDN,Spain,ESP,0,0,5,13,18
2001,Slovakia,SVK,Spain,ESP,0,0,0,5,5
2001,Syrian Arab Rep.,SYR,Spain,ESP,5,0,32,10,47
2001,United Rep. of Tanzania,TZA,Spain,ESP,0,0,0,5,5
2001,Tajikistan,TJK,Spain,ESP,0,0,0,5,5
2001,Tunisia,TUN,Spain,ESP,10,0,0,0,10
2001,Turkey,TUR,Spain,ESP,0,0,30,23,53
2001,Ukraine,UKR,Spain,ESP,5,5,15,190,215
2001,Unknown ,,Spain,ESP,0,5,5,10,20
2001,Afghanistan,AFG,Slovakia,SVK,5,0,12,2820,2837
2001,Algeria,DZA,Slovakia,SVK,0,0,5,5,10
2001,Armenia,ARM,Slovakia,SVK,0,0,10,23,33
2001,Bangladesh,BGD,Slovakia,SVK,0,0,5,224,229
2001,Bhutan,BTN,Slovakia,SVK,0,0,0,5,5
2001,Belarus,BLR,Slovakia,SVK,0,0,0,5,5
2001,Bulgaria,BGR,Slovakia,SVK,0,0,10,0,10
2001,China,CHN,Slovakia,SVK,0,0,0,27,27
2001,Cameroon,CMR,Slovakia,SVK,0,0,0,5,5
2001,Czechia,CZE,Slovakia,SVK,0,0,5,0,5
2001,Ethiopia,ETH,Slovakia,SVK,0,0,0,13,13
2001,Georgia,GEO,Slovakia,SVK,0,0,0,10,10
2001,Ghana,GHA,Slovakia,SVK,0,0,0,5,5
2001,India,IND,Slovakia,SVK,0,0,30,759,789
2001,Iran (Islamic Rep. of),IRN,Slovakia,SVK,0,0,0,89,89
2001,Iraq,IRQ,Slovakia,SVK,0,0,11,623,634
2001,Sri Lanka,LKA,Slovakia,SVK,0,0,0,105,105
2001,North Macedonia,MKD,Slovakia,SVK,0,0,5,10,15
2001,Nepal,NPL,Slovakia,SVK,0,0,0,16,16
2001,Nigeria,NGA,Slovakia,SVK,0,0,0,11,11
2001,Pakistan,PAK,Slovakia,SVK,0,0,11,133,144
2001,Romania,ROU,Slovakia,SVK,0,0,5,5,10
2001,Russian Federation,RUS,Slovakia,SVK,5,0,0,14,19
2001,Serbia and Kosovo: S/RES/1244 (1999),SRB,Slovakia,SVK,0,0,12,10,22
2001,Senegal,SEN,Slovakia,SVK,0,0,0,5,5
2001,Sierra Leone,SLE,Slovakia,SVK,0,0,0,77,77
2001,Somalia,SOM,Slovakia,SVK,0,0,0,74,74
2001,Viet Nam,VNM,Slovakia,SVK,0,0,0,37,37
2001,Sudan,SDN,Slovakia,SVK,0,0,0,28,28
2001,Syrian Arab Rep.,SYR,Slovakia,SVK,0,0,0,5,5
2001,Tunisia,TUN,Slovakia,SVK,0,0,0,5,5
2001,Turkey,TUR,Slovakia,SVK,0,0,0,42,42
2001,Stateless,XXA,Slovakia,SVK,0,0,0,5,5
2001,Unknown ,,Slovakia,SVK,0,0,0,54,54
2001,Afghanistan,AFG,Slovenia,SVN,0,0,0,296,296
2001,Algeria,DZA,Slovenia,SVN,0,0,0,197,197
2001,Armenia,ARM,Slovenia,SVN,0,0,0,34,34
2001,Azerbaijan,AZE,Slovenia,SVN,0,0,0,5,5
2001,Bangladesh,BGD,Slovenia,SVN,0,0,0,252,252
2001,Belarus,BLR,Slovenia,SVN,0,5,0,0,5
2001,Bosnia and Herzegovina,BIH,Slovenia,SVN,0,5,5,43,53
2001,China,CHN,Slovenia,SVN,0,0,0,41,41
2001,Cameroon,CMR,Slovenia,SVN,0,0,0,5,5
2001,Dem. Rep. of the Congo,COD,Slovenia,SVN,0,0,0,5,5
2001,Palestinian,PSE,Slovenia,SVN,0,0,0,10,10
2001,Ghana,GHA,Slovenia,SVN,0,0,0,14,14
2001,Croatia,HRV,Slovenia,SVN,0,0,5,5,10
2001,India,IND,Slovenia,SVN,0,0,0,88,88
2001,Iran (Islamic Rep. of),IRN,Slovenia,SVN,0,0,12,5854,5866
2001,Iraq,IRQ,Slovenia,SVN,0,0,0,638,638
2001,Liberia,LBR,Slovenia,SVN,0,0,0,5,5
2001,Lebanon,LBN,Slovenia,SVN,0,0,0,5,5
2001,Sri Lanka,LKA,Slovenia,SVN,0,0,0,15,15
2001,North Macedonia,MKD,Slovenia,SVN,0,0,5,74,79
2001,Rep. of Moldova,MDA,Slovenia,SVN,0,0,0,40,40
2001,Morocco,MAR,Slovenia,SVN,0,0,0,5,5
2001,Pakistan,PAK,Slovenia,SVN,0,0,0,71,71
2001,Romania,ROU,Slovenia,SVN,0,0,0,48,48
2001,Russian Federation,RUS,Slovenia,SVN,0,0,0,33,33
2001,Serbia and Kosovo: S/RES/1244 (1999),SRB,Slovenia,SVN,0,10,42,521,573
2001,Sierra Leone,SLE,Slovenia,SVN,0,5,10,171,186
2001,Somalia,SOM,Slovenia,SVN,0,0,0,11,11
2001,Sudan,SDN,Slovenia,SVN,0,0,0,24,24
2001,Slovakia,SVK,Slovenia,SVN,0,0,10,0,10
2001,Togo,TGO,Slovenia,SVN,0,0,0,5,5
2001,Turkey,TUR,Slovenia,SVN,0,0,0,1392,1392
2001,Unknown ,,Slovenia,SVN,0,0,0,5,5
2001,Burundi,BDI,Eswatini,SWZ,5,0,0,0,5
2001,Bulgaria,BGR,Eswatini,SWZ,5,0,0,0,5
2001,Congo,COG,Eswatini,SWZ,5,0,0,0,5
2001,Ethiopia,ETH,Eswatini,SWZ,0,0,10,0,10
2001,Liberia,LBR,Eswatini,SWZ,0,0,28,0,28
2001,Sri Lanka,LKA,Eswatini,SWZ,0,0,22,0,22
2001,Rwanda,RWA,Eswatini,SWZ,10,0,0,0,10
2001,Sierra Leone,SLE,Eswatini,SWZ,0,0,28,0,28
2001,Somalia,SOM,Eswatini,SWZ,0,0,5,0,5
2001,Afghanistan,AFG,Sweden,SWE,12,262,37,38,349
2001,Albania,ALB,Sweden,SWE,0,10,66,5,81
2001,Algeria,DZA,Sweden,SWE,0,0,69,20,89
2001,Angola,AGO,Sweden,SWE,0,5,0,0,5
2001,Egypt,EGY,Sweden,SWE,0,5,17,21,43
2001,Argentina,ARG,Sweden,SWE,0,0,5,0,5
2001,Armenia,ARM,Sweden,SWE,0,21,102,18,141
2001,Azerbaijan,AZE,Sweden,SWE,5,0,39,5,49
2001,Burundi,BDI,Sweden,SWE,0,16,0,0,16
2001,Bangladesh,BGD,Sweden,SWE,0,5,80,10,95
2001,Belarus,BLR,Sweden,SWE,15,0,186,39,240
2001,Bolivia (Plurinational State of),BOL,Sweden,SWE,0,0,27,10,37
2001,Brazil,BRA,Sweden,SWE,0,0,5,0,5
2001,Bosnia and Herzegovina,BIH,Sweden,SWE,5,247,3843,286,4381
2001,Bulgaria,BGR,Sweden,SWE,0,0,265,101,366
2001,Canada,CAN,Sweden,SWE,0,0,5,0,5
2001,China,CHN,Sweden,SWE,0,0,38,11,49
2001,Chile,CHL,Sweden,SWE,0,5,35,0,40
2001,Cameroon,CMR,Sweden,SWE,0,0,5,0,5
2001,Congo,COG,Sweden,SWE,0,0,5,0,5
2001,Dem. Rep. of the Congo,COD,Sweden,SWE,0,21,44,0,65
2001,Colombia,COL,Sweden,SWE,0,14,47,15,76
2001,Cuba,CUB,Sweden,SWE,0,5,20,0,25
2001,Czechia,CZE,Sweden,SWE,0,0,43,5,48
2001,Ecuador,ECU,Sweden,SWE,0,0,94,14,108
2001,Eritrea,ERI,Sweden,SWE,0,13,118,5,136
2001,Estonia,EST,Sweden,SWE,0,0,15,0,15
2001,Ethiopia,ETH,Sweden,SWE,0,15,57,5,77
2001,Gambia,GMB,Sweden,SWE,0,0,10,0,10
2001,Georgia,GEO,Sweden,SWE,0,0,50,12,62
2001,Ghana,GHA,Sweden,SWE,0,0,13,0,13
2001,Guinea-Bissau,GNB,Sweden,SWE,0,0,5,0,5
2001,Guinea,GIN,Sweden,SWE,0,0,10,0,10
2001,Croatia,HRV,Sweden,SWE,0,12,154,21,187
2001,Hungary,HUN,Sweden,SWE,0,0,5,0,5
2001,India,IND,Sweden,SWE,0,0,47,5,52
2001,Iran (Islamic Rep. of),IRN,Sweden,SWE,26,64,592,84,766
2001,Iraq,IRQ,Sweden,SWE,60,2652,376,111,3199
2001,Israel,ISR,Sweden,SWE,0,0,10,5,15
2001,Jordan,JOR,Sweden,SWE,0,5,18,0,23
2001,Kazakhstan,KAZ,Sweden,SWE,0,17,76,11,104
2001,Kenya,KEN,Sweden,SWE,0,5,10,0,15
2001,Kyrgyzstan,KGZ,Sweden,SWE,0,0,15,0,15
2001,Rep. of Korea,KOR,Sweden,SWE,0,0,5,0,5
2001,Liberia,LBR,Sweden,SWE,0,0,5,0,5
2001,Libya,LBY,Sweden,SWE,0,0,19,14,33
2001,Lebanon,LBN,Sweden,SWE,0,14,112,31,157
2001,Sri Lanka,LKA,Sweden,SWE,0,5,60,32,97
2001,Lithuania,LTU,Sweden,SWE,0,0,64,23,87
2001,Latvia,LVA,Sweden,SWE,0,5,15,12,32
2001,North Macedonia,MKD,Sweden,SWE,0,5,79,5,89
2001,Rep. of Moldova,MDA,Sweden,SWE,0,0,21,5,26
2001,Mongolia,MNG,Sweden,SWE,0,0,69,11,80
2001,Morocco,MAR,Sweden,SWE,0,0,10,5,15
2001,Nigeria,NGA,Sweden,SWE,0,0,30,5,35
2001,Pakistan,PAK,Sweden,SWE,0,0,98,31,129
2001,Peru,PER,Sweden,SWE,0,14,70,11,95
2001,Poland,POL,Sweden,SWE,0,5,41,0,46
2001,Romania,ROU,Sweden,SWE,0,0,49,27,76
2001,Russian Federation,RUS,Sweden,SWE,0,13,477,65,555
2001,Rwanda,RWA,Sweden,SWE,0,5,0,5,10
2001,El Salvador,SLV,Sweden,SWE,0,0,130,10,140
2001,Serbia and Kosovo: S/RES/1244 (1999),SRB,Sweden,SWE,0,500,1445,231,2176
2001,Sierra Leone,SLE,Sweden,SWE,0,5,16,5,26
2001,Somalia,SOM,Sweden,SWE,5,183,33,34,255
2001,Viet Nam,VNM,Sweden,SWE,0,13,0,0,13
2001,Sudan,SDN,Sweden,SWE,0,5,5,5,15
2001,Slovakia,SVK,Sweden,SWE,0,0,240,41,281
2001,Sweden,SWE,Sweden,SWE,0,0,0,5,5
2001,Syrian Arab Rep.,SYR,Sweden,SWE,5,20,250,14,289
2001,United Rep. of Tanzania,TZA,Sweden,SWE,0,0,10,0,10
2001,Tajikistan,TJK,Sweden,SWE,0,5,5,0,10
2001,Tunisia,TUN,Sweden,SWE,0,0,5,5,10
2001,Turkey,TUR,Sweden,SWE,10,19,161,14,204
2001,Uganda,UGA,Sweden,SWE,0,0,10,0,10
2001,Ukraine,UKR,Sweden,SWE,10,10,124,25,169
2001,United States of America,USA,Sweden,SWE,0,0,5,5,10
2001,Uzbekistan,UZB,Sweden,SWE,0,0,32,0,32
2001,Venezuela (Bolivarian Republic of),VEN,Sweden,SWE,0,0,5,0,5
2001,Yemen,YEM,Sweden,SWE,0,5,0,0,5
2001,Stateless,XXA,Sweden,SWE,5,73,227,27,332
2001,Unknown ,,Sweden,SWE,0,10,35,5,50
2001,Afghanistan,AFG,Switzerland,CHE,226,130,136,71,563
2001,Albania,ALB,Switzerland,CHE,10,16,34,184,244
2001,Algeria,DZA,Switzerland,CHE,30,16,287,255,588
2001,Angola,AGO,Switzerland,CHE,5,270,318,86,679
2001,Egypt,EGY,Switzerland,CHE,5,0,5,5,15
2001,Argentina,ARG,Switzerland,CHE,0,0,0,5,5
2001,Armenia,ARM,Switzerland,CHE,0,19,174,135,328
2001,Azerbaijan,AZE,Switzerland,CHE,0,0,30,37,67
2001,Burundi,BDI,Switzerland,CHE,0,0,19,0,19
2001,Benin,BEN,Switzerland,CHE,0,0,5,5,10
2001,Bangladesh,BGD,Switzerland,CHE,0,5,100,63,168
2001,Burkina Faso,BFA,Switzerland,CHE,0,0,32,21,53
2001,Belarus,BLR,Switzerland,CHE,0,0,16,84,100
2001,Bosnia and Herzegovina,BIH,Switzerland,CHE,168,788,977,273,2206
2001,Bulgaria,BGR,Switzerland,CHE,0,0,76,95,171
2001,Cambodia,KHM,Switzerland,CHE,14,0,0,0,14
2001,Chad,TCD,Switzerland,CHE,5,0,5,0,10
2001,China,CHN,Switzerland,CHE,20,0,21,17,58
2001,Chile,CHL,Switzerland,CHE,0,0,0,5,5
2001,Cameroon,CMR,Switzerland,CHE,0,0,74,47,121
2001,Congo,COG,Switzerland,CHE,5,0,19,11,35
2001,Dem. Rep. of the Congo,COD,Switzerland,CHE,53,250,428,162,893
2001,Colombia,COL,Switzerland,CHE,19,13,46,11,89
2001,Cuba,CUB,Switzerland,CHE,0,0,11,5,16
2001,Czechia,CZE,Switzerland,CHE,0,0,24,17,41
2001,Ecuador,ECU,Switzerland,CHE,0,0,5,0,5
2001,Eritrea,ERI,Switzerland,CHE,5,27,167,17,216
2001,Ethiopia,ETH,Switzerland,CHE,5,37,294,19,355
2001,France,FRA,Switzerland,CHE,0,0,0,5,5
2001,Gambia,GMB,Switzerland,CHE,0,0,0,22,22
2001,Georgia,GEO,Switzerland,CHE,0,17,85,99,201
2001,Germany,DEU,Switzerland,CHE,0,0,0,5,5
2001,Ghana,GHA,Switzerland,CHE,0,0,0,11,11
2001,Guinea-Bissau,GNB,Switzerland,CHE,0,0,16,62,78
2001,Guinea,GIN,Switzerland,CHE,0,5,265,340,610
2001,Croatia,HRV,Switzerland,CHE,0,0,10,5,15
2001,Cote d'Ivoire,CIV,Switzerland,CHE,0,0,45,63,108
2001,India,IND,Switzerland,CHE,5,11,43,155,214
2001,Indonesia,IDN,Switzerland,CHE,0,0,0,5,5
2001,Iran (Islamic Rep. of),IRN,Switzerland,CHE,69,23,280,100,472
2001,Iraq,IRQ,Switzerland,CHE,351,258,773,363,1745
2001,Israel,ISR,Switzerland,CHE,0,0,5,13,18
2001,Jordan,JOR,Switzerland,CHE,5,0,5,13,23
2001,Kazakhstan,KAZ,Switzerland,CHE,0,0,5,12,17
2001,Kenya,KEN,Switzerland,CHE,0,0,5,5,10
2001,Kyrgyzstan,KGZ,Switzerland,CHE,0,0,5,0,5
2001,Liberia,LBR,Switzerland,CHE,0,0,10,29,39
2001,Libya,LBY,Switzerland,CHE,119,0,21,22,162
2001,Lebanon,LBN,Switzerland,CHE,0,0,20,85,105
2001,Sri Lanka,LKA,Switzerland,CHE,90,1456,1394,183,3123
2001,Lithuania,LTU,Switzerland,CHE,0,0,0,57,57
2001,Latvia,LVA,Switzerland,CHE,0,0,5,12,17
2001,Mauritania,MRT,Switzerland,CHE,0,0,17,49,66
2001,North Macedonia,MKD,Switzerland,CHE,0,0,34,173,207
2001,Rep. of Moldova,MDA,Switzerland,CHE,0,0,5,47,52
2001,Mali,MLI,Switzerland,CHE,0,0,28,69,97
2001,Mongolia,MNG,Switzerland,CHE,0,0,50,204,254
2001,Morocco,MAR,Switzerland,CHE,10,0,0,15,25
2001,Myanmar,MMR,Switzerland,CHE,0,0,0,5,5
2001,Nepal,NPL,Switzerland,CHE,0,0,5,35,40
2001,Nigeria,NGA,Switzerland,CHE,5,0,89,163,257
2001,Pakistan,PAK,Switzerland,CHE,5,23,123,125,276
2001,Poland,POL,Switzerland,CHE,0,0,33,11,44
2001,Romania,ROU,Switzerland,CHE,0,0,0,26,26
2001,South Africa,ZAF,Switzerland,CHE,0,0,5,0,5
2001,Russian Federation,RUS,Switzerland,CHE,0,16,79,209,304
2001,Rwanda,RWA,Switzerland,CHE,5,0,23,5,33
2001,El Salvador,SLV,Switzerland,CHE,0,0,0,5,5
2001,Serbia and Kosovo: S/RES/1244 (1999),SRB,Switzerland,CHE,266,4793,3845,1463,10367
2001,Senegal,SEN,Switzerland,CHE,0,0,5,10,15
2001,Sierra Leone,SLE,Switzerland,CHE,0,5,95,238,338
2001,Somalia,SOM,Switzerland,CHE,22,341,342,80,785
2001,Viet Nam,VNM,Switzerland,CHE,60,0,12,5,77
2001,Sudan,SDN,Switzerland,CHE,12,0,54,5,71
2001,Slovakia,SVK,Switzerland,CHE,0,0,12,10,22
2001,Slovenia,SVN,Switzerland,CHE,0,0,0,5,5
2001,Syrian Arab Rep.,SYR,Switzerland,CHE,13,23,65,46,147
2001,United Rep. of Tanzania,TZA,Switzerland,CHE,0,0,5,0,5
2001,Tajikistan,TJK,Switzerland,CHE,0,0,0,5,5
2001,Togo,TGO,Switzerland,CHE,5,0,52,31,88
2001,Tunisia,TUN,Switzerland,CHE,109,0,15,59,183
2001,Turkey,TUR,Switzerland,CHE,496,166,820,358,1840
2001,Uganda,UGA,Switzerland,CHE,5,0,5,5,15
2001,Ukraine,UKR,Switzerland,CHE,0,0,46,84,130
2001,United States of America,USA,Switzerland,CHE,0,0,0,5,5
2001,Uzbekistan,UZB,Switzerland,CHE,5,0,5,0,10
2001,Yemen,YEM,Switzerland,CHE,5,0,37,10,52
2001,Unknown ,,Switzerland,CHE,12,214,264,359,849
2001,Kenya,KEN,United Rep. of Tanzania,TZA,25,0,108,0,133
2001,Afghanistan,AFG,Tajikistan,TJK,0,0,0,577,577
2001,Burundi,BDI,Uganda,UGA,5,0,0,26,31
2001,Chad,TCD,Uganda,UGA,0,0,5,0,5
2001,Dem. Rep. of the Congo,COD,Uganda,UGA,2137,0,5,142,2284
2001,Eritrea,ERI,Uganda,UGA,0,0,0,10,10
2001,Ethiopia,ETH,Uganda,UGA,5,0,5,53,63
2001,Kenya,KEN,Uganda,UGA,0,0,0,10,10
2001,Liberia,LBR,Uganda,UGA,0,0,5,0,5
2001,Rwanda,RWA,Uganda,UGA,312,0,0,5,317
2001,Somalia,SOM,Uganda,UGA,48,0,0,20,68
2001,Sudan,SDN,Uganda,UGA,733,0,0,45,778
2001,Afghanistan,AFG,Ukraine,UKR,223,0,101,0,324
2001,Armenia,ARM,Ukraine,UKR,37,0,5,0,42
2001,Azerbaijan,AZE,Ukraine,UKR,72,0,10,5,87
2001,Bangladesh,BGD,Ukraine,UKR,0,0,5,0,5
2001,Congo,COG,Ukraine,UKR,5,0,0,0,5
2001,Palestinian,PSE,Ukraine,UKR,0,0,5,0,5
2001,Georgia,GEO,Ukraine,UKR,5,0,0,10,15
2001,Iran (Islamic Rep. of),IRN,Ukraine,UKR,10,0,0,0,10
2001,Iraq,IRQ,Ukraine,UKR,23,0,15,0,38
2001,Dem. People's Rep. of Korea,PRK,Ukraine,UKR,0,0,5,0,5
2001,Lebanon,LBN,Ukraine,UKR,0,0,5,0,5
2001,Sri Lanka,LKA,Ukraine,UKR,0,0,10,0,10
2001,Pakistan,PAK,Ukraine,UKR,0,0,5,0,5
2001,Russian Federation,RUS,Ukraine,UKR,41,0,134,16,191
2001,Rwanda,RWA,Ukraine,UKR,5,0,0,0,5
2001,Syrian Arab Rep.,SYR,Ukraine,UKR,14,0,5,0,19
2001,Tajikistan,TJK,Ukraine,UKR,5,0,0,0,5
2001,Uzbekistan,UZB,Ukraine,UKR,0,0,10,0,10
2001,Angola,AGO,Zambia,ZMB,10,0,0,0,10
2001,Burundi,BDI,Zambia,ZMB,92,0,5,0,97
2001,Dem. Rep. of the Congo,COD,Zambia,ZMB,190,0,14,22,226
2001,Rwanda,RWA,Zambia,ZMB,204,0,0,19,223
2001,Somalia,SOM,Zambia,ZMB,10,0,0,0,10
2001,Unknown ,,Zambia,ZMB,34,0,5,0,39
2001,Angola,AGO,Zimbabwe,ZWE,152,0,5,0,157
2001,Burundi,BDI,Zimbabwe,ZWE,446,0,5,0,451
2001,Bangladesh,BGD,Zimbabwe,ZWE,5,0,0,0,5
2001,Bosnia and Herzegovina,BIH,Zimbabwe,ZWE,5,0,0,0,5
2001,Cameroon,CMR,Zimbabwe,ZWE,10,0,0,0,10
2001,Congo,COG,Zimbabwe,ZWE,5,0,0,0,5
2001,Dem. Rep. of the Congo,COD,Zimbabwe,ZWE,2274,0,0,0,2274
2001,Eritrea,ERI,Zimbabwe,ZWE,24,0,0,0,24
2001,Ethiopia,ETH,Zimbabwe,ZWE,95,0,0,0,95
2001,Ghana,GHA,Zimbabwe,ZWE,5,0,0,0,5
2001,Kenya,KEN,Zimbabwe,ZWE,5,0,0,0,5
2001,Liberia,LBR,Zimbabwe,ZWE,41,0,0,0,41
2001,Pakistan,PAK,Zimbabwe,ZWE,5,0,0,0,5
2001,Rwanda,RWA,Zimbabwe,ZWE,1362,0,0,0,1362
2001,Serbia and Kosovo: S/RES/1244 (1999),SRB,Zimbabwe,ZWE,5,0,0,0,5
2001,Sierra Leone,SLE,Zimbabwe,ZWE,21,0,0,0,21
2001,Somalia,SOM,Zimbabwe,ZWE,28,0,0,0,28
2001,Sudan,SDN,Zimbabwe,ZWE,63,0,5,0,68
2001,United Rep. of Tanzania,TZA,Zimbabwe,ZWE,10,0,0,0,10
2001,Togo,TGO,Zimbabwe,ZWE,5,0,0,0,5
2001,Uganda,UGA,Zimbabwe,ZWE,18,0,0,0,18
2001,Zambia,ZMB,Zimbabwe,ZWE,0,0,5,0,5
2002,Dem. Rep. of the Congo,COD,Angola,AGO,5,0,36,0,41
2002,Rwanda,RWA,Angola,AGO,5,0,0,0,5
2002,Sierra Leone,SLE,Angola,AGO,0,0,5,0,5
2002,United Rep. of Tanzania,TZA,Angola,AGO,5,0,0,0,5
2002,Armenia,ARM,Argentina,ARG,0,0,21,0,21
2002,Cuba,CUB,Argentina,ARG,16,0,10,0,26
2002,Haiti,HTI,Argentina,ARG,0,0,0,5,5
2002,Iraq,IRQ,Argentina,ARG,0,0,5,0,5
2002,Pakistan,PAK,Argentina,ARG,5,0,0,0,5
2002,Peru,PER,Argentina,ARG,25,0,128,0,153
2002,Romania,ROU,Argentina,ARG,0,0,25,0,25
2002,Senegal,SEN,Argentina,ARG,0,0,5,0,5
2002,Sierra Leone,SLE,Argentina,ARG,10,0,0,0,10
2002,Turkey,TUR,Argentina,ARG,0,0,0,5,5
2002,Ukraine,UKR,Argentina,ARG,0,0,5,0,5
2002,Unknown ,,Argentina,ARG,5,0,0,0,5
2002,Iran (Islamic Rep. of),IRN,Armenia,ARM,5,0,0,0,5
2002,Iraq,IRQ,Armenia,ARM,5,0,0,0,5
2002,Afghanistan,AFG,Australia,AUS,189,0,111,0,300
2002,Albania,ALB,Australia,AUS,0,0,35,5,40
2002,Angola,AGO,Australia,AUS,0,0,5,0,5
2002,Egypt,EGY,Australia,AUS,14,0,49,0,63
2002,Argentina,ARG,Australia,AUS,0,0,31,0,31
2002,Armenia,ARM,Australia,AUS,0,0,5,0,5
2002,Austria,AUT,Australia,AUS,0,0,5,0,5
2002,Bangladesh,BGD,Australia,AUS,0,0,218,10,228
2002,Belarus,BLR,Australia,AUS,0,0,10,0,10
2002,Botswana,BWA,Australia,AUS,0,0,5,0,5
2002,Brazil,BRA,Australia,AUS,0,0,41,0,41
2002,Bosnia and Herzegovina,BIH,Australia,AUS,0,0,5,0,5
2002,Bulgaria,BGR,Australia,AUS,0,0,12,0,12
2002,Cambodia,KHM,Australia,AUS,0,0,25,0,25
2002,Canada,CAN,Australia,AUS,0,0,5,0,5
2002,China,CHN,Australia,AUS,14,0,1211,31,1256
2002,Chile,CHL,Australia,AUS,0,0,20,0,20
2002,Congo,COG,Australia,AUS,5,0,5,0,10
2002,Colombia,COL,Australia,AUS,18,0,35,5,58
2002,Cyprus,CYP,Australia,AUS,0,0,5,0,5
2002,Czechia,CZE,Australia,AUS,0,0,5,0,5
2002,Ecuador,ECU,Australia,AUS,0,0,10,0,10
2002,Ethiopia,ETH,Australia,AUS,0,0,12,0,12
2002,Fiji,FJI,Australia,AUS,5,0,415,12,432
2002,France,FRA,Australia,AUS,0,0,5,0,5
2002,Palestinian,PSE,Australia,AUS,26,0,11,0,37
2002,United Kingdom of Great Britain and Northern Ireland,GBR,Australia,AUS,0,0,21,0,21
2002,Ghana,GHA,Australia,AUS,0,0,24,0,24
2002,Greece,GRC,Australia,AUS,0,0,5,0,5
2002,"China, Hong Kong SAR",HKG,Australia,AUS,0,0,10,0,10
2002,Hungary,HUN,Australia,AUS,0,0,18,5,23
2002,India,IND,Australia,AUS,5,0,696,10,711
2002,Indonesia,IDN,Australia,AUS,0,0,1405,118,1523
2002,Iran (Islamic Rep. of),IRN,Australia,AUS,68,0,50,5,123
2002,Iraq,IRQ,Australia,AUS,721,0,60,5,786
2002,Israel,ISR,Australia,AUS,0,0,37,5,42
2002,Italy,ITA,Australia,AUS,0,0,5,0,5
2002,Jordan,JOR,Australia,AUS,0,0,16,0,16
2002,Kazakhstan,KAZ,Australia,AUS,0,0,5,0,5
2002,Kenya,KEN,Australia,AUS,0,0,19,0,19
2002,Rep. of Korea,KOR,Australia,AUS,0,0,393,5,398
2002,Lao People's Dem. Rep.,LAO,Australia,AUS,0,0,10,0,10
2002,Libya,LBY,Australia,AUS,0,0,5,0,5
2002,Lebanon,LBN,Australia,AUS,0,0,173,5,178
2002,Sri Lanka,LKA,Australia,AUS,60,0,311,10,381
2002,Lithuania,LTU,Australia,AUS,0,0,21,0,21
2002,Latvia,LVA,Australia,AUS,0,0,5,0,5
2002,North Macedonia,MKD,Australia,AUS,0,0,38,0,38
2002,Rep. of Moldova,MDA,Australia,AUS,0,0,11,0,11
2002,Malaysia,MYS,Australia,AUS,0,0,239,16,255
2002,Mongolia,MNG,Australia,AUS,0,0,83,0,83
2002,Myanmar,MMR,Australia,AUS,17,0,50,0,67
2002,Nepal,NPL,Australia,AUS,0,0,110,5,115
2002,Nigeria,NGA,Australia,AUS,5,0,17,5,27
2002,New Zealand,NZL,Australia,AUS,0,0,5,0,5
2002,Pakistan,PAK,Australia,AUS,0,0,117,5,122
2002,Peru,PER,Australia,AUS,0,0,47,0,47
2002,Philippines,PHL,Australia,AUS,0,0,86,0,86
2002,Papua New Guinea,PNG,Australia,AUS,0,0,11,0,11
2002,Poland,POL,Australia,AUS,0,0,28,0,28
2002,Portugal,PRT,Australia,AUS,0,0,16,0,16
2002,Romania,ROU,Australia,AUS,0,0,23,0,23
2002,South Africa,ZAF,Australia,AUS,0,0,21,0,21
2002,Russian Federation,RUS,Australia,AUS,10,0,75,5,90
2002,Rwanda,RWA,Australia,AUS,0,0,5,0,5
2002,Saudi Arabia,SAU,Australia,AUS,5,0,0,0,5
2002,Serbia and Kosovo: S/RES/1244 (1999),SRB,Australia,AUS,0,0,26,5,31
2002,Senegal,SEN,Australia,AUS,0,0,5,0,5
2002,Sierra Leone,SLE,Australia,AUS,0,0,5,0,5
2002,Solomon Islands,SLB,Australia,AUS,5,0,10,0,15
2002,Somalia,SOM,Australia,AUS,5,0,0,0,5
2002,Viet Nam,VNM,Australia,AUS,0,0,142,5,147
2002,Syrian Arab Rep.,SYR,Australia,AUS,5,0,12,0,17
2002,Thailand,THA,Australia,AUS,0,0,314,10,324
2002,Timor-Leste,TLS,Australia,AUS,0,0,229,14,243
2002,Tonga,TON,Australia,AUS,0,0,84,11,95
2002,Turkey,TUR,Australia,AUS,21,0,100,5,126
2002,Tuvalu,TUV,Australia,AUS,0,0,5,0,5
2002,Uganda,UGA,Australia,AUS,0,0,5,0,5
2002,Ukraine,UKR,Australia,AUS,0,0,74,0,74
2002,Uruguay,URY,Australia,AUS,0,0,51,5,56
2002,United States of America,USA,Australia,AUS,0,0,13,0,13
2002,Uzbekistan,UZB,Australia,AUS,0,0,10,0,10
2002,Samoa,WSM,Australia,AUS,0,0,5,0,5
2002,Zambia,ZMB,Australia,AUS,0,0,5,0,5
2002,Zimbabwe,ZWE,Australia,AUS,5,0,21,5,31
2002,Stateless,XXA,Australia,AUS,5,0,22,5,32
2002,Unknown ,,Australia,AUS,5,0,34,0,39
2002,Afghanistan,AFG,Belgium,BEL,5,0,0,85,90
2002,Albania,ALB,Belgium,BEL,49,0,74,22,145
2002,Algeria,DZA,Belgium,BEL,33,0,530,88,651
2002,Angola,AGO,Belgium,BEL,5,0,28,12,45
2002,Armenia,ARM,Belgium,BEL,0,0,51,5,56
2002,Azerbaijan,AZE,Belgium,BEL,0,0,12,0,12
2002,Burundi,BDI,Belgium,BEL,46,0,61,14,121
2002,Bangladesh,BGD,Belgium,BEL,0,0,5,5,10
2002,Bhutan,BTN,Belgium,BEL,0,0,0,5,5
2002,Belarus,BLR,Belgium,BEL,11,0,52,10,73
2002,Bosnia and Herzegovina,BIH,Belgium,BEL,14,0,17,5,36
2002,Bulgaria,BGR,Belgium,BEL,0,0,24,5,29
2002,Chad,TCD,Belgium,BEL,0,0,5,0,5
2002,China,CHN,Belgium,BEL,0,0,5,5,10
2002,Cameroon,CMR,Belgium,BEL,5,0,56,5,66
2002,Congo,COG,Belgium,BEL,0,0,10,5,15
2002,Dem. Rep. of the Congo,COD,Belgium,BEL,105,0,323,122,550
2002,Colombia,COL,Belgium,BEL,0,0,13,5,18
2002,Czechia,CZE,Belgium,BEL,0,0,10,5,15
2002,Djibouti,DJI,Belgium,BEL,10,0,10,10,30
2002,Ethiopia,ETH,Belgium,BEL,10,0,5,5,20
2002,Palestinian,PSE,Belgium,BEL,5,0,10,10,25
2002,Georgia,GEO,Belgium,BEL,5,0,113,19,137
2002,Guinea,GIN,Belgium,BEL,0,0,307,32,339
2002,Cote d'Ivoire,CIV,Belgium,BEL,0,0,5,5,10
2002,India,IND,Belgium,BEL,0,0,5,13,18
2002,Iran (Islamic Rep. of),IRN,Belgium,BEL,16,0,212,46,274
2002,Iraq,IRQ,Belgium,BEL,77,0,68,26,171
2002,Israel,ISR,Belgium,BEL,0,0,0,5,5
2002,Kazakhstan,KAZ,Belgium,BEL,10,0,63,0,73
2002,Kyrgyzstan,KGZ,Belgium,BEL,5,0,13,0,18
2002,Liberia,LBR,Belgium,BEL,5,0,5,0,10
2002,Libya,LBY,Belgium,BEL,0,0,5,0,5
2002,Lebanon,LBN,Belgium,BEL,5,0,23,0,28
2002,Sri Lanka,LKA,Belgium,BEL,0,0,5,5,10
2002,Mauritania,MRT,Belgium,BEL,5,0,17,5,27
2002,North Macedonia,MKD,Belgium,BEL,13,0,32,13,58
2002,Rep. of Moldova,MDA,Belgium,BEL,5,0,10,0,15
2002,Myanmar,MMR,Belgium,BEL,0,0,5,0,5
2002,Nepal,NPL,Belgium,BEL,0,0,197,14,211
2002,Niger,NER,Belgium,BEL,0,0,33,0,33
2002,Nigeria,NGA,Belgium,BEL,0,0,5,0,5
2002,Pakistan,PAK,Belgium,BEL,5,0,19,10,34
2002,Peru,PER,Belgium,BEL,0,0,0,5,5
2002,Romania,ROU,Belgium,BEL,0,0,25,10,35
2002,Russian Federation,RUS,Belgium,BEL,12,0,124,62,198
2002,Rwanda,RWA,Belgium,BEL,269,0,147,47,463
2002,Serbia and Kosovo: S/RES/1244 (1999),SRB,Belgium,BEL,341,0,261,120,722
2002,Sierra Leone,SLE,Belgium,BEL,5,0,32,12,49
2002,Somalia,SOM,Belgium,BEL,33,0,10,5,48
2002,Slovakia,SVK,Belgium,BEL,0,0,11,0,11
2002,Syrian Arab Rep.,SYR,Belgium,BEL,0,0,28,0,28
2002,Togo,TGO,Belgium,BEL,0,0,22,10,32
2002,Turkey,TUR,Belgium,BEL,36,0,269,87,392
2002,Ukraine,UKR,Belgium,BEL,0,0,24,10,34
2002,Uzbekistan,UZB,Belgium,BEL,12,0,23,0,35
2002,Burundi,BDI,Benin,BEN,5,0,0,5,10
2002,Central African Rep.,CAF,Benin,BEN,19,0,17,5,41
2002,Chad,TCD,Benin,BEN,21,0,23,10,54
2002,Congo,COG,Benin,BEN,25,0,18,5,48
2002,Dem. Rep. of the Congo,COD,Benin,BEN,68,0,60,18,146
2002,Cote d'Ivoire,CIV,Benin,BEN,17,0,0,0,17
2002,Iraq,IRQ,Benin,BEN,5,0,0,0,5
2002,Liberia,LBR,Benin,BEN,5,0,0,0,5
2002,Nigeria,NGA,Benin,BEN,15,0,50,62,127
2002,Rwanda,RWA,Benin,BEN,27,0,10,10,47
2002,Sudan,SDN,Benin,BEN,15,0,5,0,20
2002,Togo,TGO,Benin,BEN,30,0,62,15,107
2002,Afghanistan,AFG,Belarus,BLR,40,0,41,29,110
2002,Armenia,ARM,Belarus,BLR,0,0,0,5,5
2002,Azerbaijan,AZE,Belarus,BLR,5,0,0,10,15
2002,Georgia,GEO,Belarus,BLR,10,0,0,5,15
2002,Iraq,IRQ,Belarus,BLR,0,0,5,5,10
2002,Sri Lanka,LKA,Belarus,BLR,0,0,0,5,5
2002,Nigeria,NGA,Belarus,BLR,0,0,0,5,5
2002,Tajikistan,TJK,Belarus,BLR,0,0,0,5,5
2002,Uzbekistan,UZB,Belarus,BLR,0,0,0,5,5
2002,Iraq,IRQ,Bolivia (Plurinational State of),BOL,5,0,0,0,5
2002,Peru,PER,Bolivia (Plurinational State of),BOL,0,0,0,5,5
2002,Burundi,BDI,Botswana,BWA,14,0,5,0,19
2002,Dem. Rep. of the Congo,COD,Botswana,BWA,27,0,5,0,32
2002,Ethiopia,ETH,Botswana,BWA,0,0,5,0,5
2002,Kenya,KEN,Botswana,BWA,5,0,0,0,5
2002,Rwanda,RWA,Botswana,BWA,10,0,0,0,10
2002,Somalia,SOM,Botswana,BWA,68,0,28,0,96
2002,Sudan,SDN,Botswana,BWA,10,0,5,0,15
2002,United Rep. of Tanzania,TZA,Botswana,BWA,0,0,0,14,14
2002,Uganda,UGA,Botswana,BWA,0,0,10,0,10
2002,Zimbabwe,ZWE,Botswana,BWA,20,0,5,0,25
2002,Afghanistan,AFG,Brazil,BRA,23,0,5,0,28
2002,Angola,AGO,Brazil,BRA,116,0,90,0,206
2002,Dem. Rep. of the Congo,COD,Brazil,BRA,10,0,11,0,21
2002,Colombia,COL,Brazil,BRA,36,0,15,0,51
2002,Cuba,CUB,Brazil,BRA,5,0,13,0,18
2002,Georgia,GEO,Brazil,BRA,5,0,0,0,5
2002,Guinea-Bissau,GNB,Brazil,BRA,0,0,10,5,15
2002,Iran (Islamic Rep. of),IRN,Brazil,BRA,5,0,0,0,5
2002,Iraq,IRQ,Brazil,BRA,0,0,5,0,5
2002,Mexico,MEX,Brazil,BRA,0,0,5,0,5
2002,Nigeria,NGA,Brazil,BRA,0,0,13,5,18
2002,Pakistan,PAK,Brazil,BRA,0,0,0,13,13
2002,Peru,PER,Brazil,BRA,0,0,5,5,10
2002,Romania,ROU,Brazil,BRA,0,0,462,0,462
2002,Sierra Leone,SLE,Brazil,BRA,5,0,41,17,63
2002,United Rep. of Tanzania,TZA,Brazil,BRA,0,0,0,5,5
2002,Afghanistan,AFG,Bulgaria,BGR,18,195,46,871,1130
2002,Algeria,DZA,Bulgaria,BGR,0,0,5,0,5
2002,Armenia,ARM,Bulgaria,BGR,0,0,427,10,437
2002,Bangladesh,BGD,Bulgaria,BGR,0,5,10,10,25
2002,Dem. Rep. of the Congo,COD,Bulgaria,BGR,0,5,0,13,18
2002,Ethiopia,ETH,Bulgaria,BGR,0,0,15,5,20
2002,Georgia,GEO,Bulgaria,BGR,0,0,10,5,15
2002,Ghana,GHA,Bulgaria,BGR,0,0,0,5,5
2002,Iran (Islamic Rep. of),IRN,Bulgaria,BGR,0,23,76,75,174
2002,Iraq,IRQ,Bulgaria,BGR,39,293,30,583,945
2002,Lebanon,LBN,Bulgaria,BGR,0,0,5,0,5
2002,Rep. of Moldova,MDA,Bulgaria,BGR,0,0,5,0,5
2002,Nigeria,NGA,Bulgaria,BGR,0,0,58,102,160
2002,Pakistan,PAK,Bulgaria,BGR,0,0,5,5,10
2002,Russian Federation,RUS,Bulgaria,BGR,0,0,13,0,13
2002,Sierra Leone,SLE,Bulgaria,BGR,0,0,10,5,15
2002,Somalia,SOM,Bulgaria,BGR,0,15,0,13,28
2002,Sudan,SDN,Bulgaria,BGR,10,84,5,56,155
2002,United Rep. of Tanzania,TZA,Bulgaria,BGR,0,0,5,0,5
2002,Turkey,TUR,Bulgaria,BGR,0,19,16,25,60
2002,Ukraine,UKR,Bulgaria,BGR,0,0,5,0,5
2002,Uzbekistan,UZB,Bulgaria,BGR,0,0,5,0,5
2002,Stateless,XXA,Bulgaria,BGR,0,0,14,5,19
2002,Afghanistan,AFG,Canada,CAN,217,0,45,36,298
2002,Albania,ALB,Canada,CAN,174,0,186,71,431
2002,Algeria,DZA,Canada,CAN,108,0,231,48,387
2002,Angola,AGO,Canada,CAN,166,0,137,21,324
2002,Egypt,EGY,Canada,CAN,53,0,42,14,109
2002,Argentina,ARG,Canada,CAN,31,0,794,186,1011
2002,Armenia,ARM,Canada,CAN,16,0,25,10,51
2002,Austria,AUT,Canada,CAN,0,0,5,0,5
2002,Azerbaijan,AZE,Canada,CAN,94,0,53,5,152
2002,Barbados,BRB,Canada,CAN,0,0,0,5,5
2002,Burundi,BDI,Canada,CAN,252,0,35,11,298
2002,Benin,BEN,Canada,CAN,5,0,5,0,10
2002,Bangladesh,BGD,Canada,CAN,145,0,123,29,297
2002,Burkina Faso,BFA,Canada,CAN,5,0,0,5,10
2002,Belarus,BLR,Canada,CAN,44,0,16,14,74
2002,Bolivia (Plurinational State of),BOL,Canada,CAN,14,0,13,5,32
2002,Brazil,BRA,Canada,CAN,5,0,40,41,86
2002,Bosnia and Herzegovina,BIH,Canada,CAN,10,0,10,5,25
2002,Bulgaria,BGR,Canada,CAN,112,0,32,25,169
2002,Cambodia,KHM,Canada,CAN,5,0,10,5,20
2002,Central African Rep.,CAF,Canada,CAN,5,0,5,0,10
2002,Chad,TCD,Canada,CAN,51,0,26,10,87
2002,China,CHN,Canada,CAN,1196,0,487,465,2148
2002,Chile,CHL,Canada,CAN,12,0,30,10,52
2002,Cameroon,CMR,Canada,CAN,74,0,41,5,120
2002,Congo,COG,Canada,CAN,55,0,37,5,97
2002,Dem. Rep. of the Congo,COD,Canada,CAN,489,0,237,60,786
2002,Colombia,COL,Canada,CAN,1084,0,199,124,1407
2002,Costa Rica,CRI,Canada,CAN,26,0,225,349,600
2002,Cuba,CUB,Canada,CAN,129,0,22,31,182
2002,Czechia,CZE,Canada,CAN,5,0,14,5,24
2002,Djibouti,DJI,Canada,CAN,32,0,37,5,74
2002,Dominica,DMA,Canada,CAN,10,0,5,5,20
2002,Dominican Rep.,DOM,Canada,CAN,5,0,17,74,96
2002,Ecuador,ECU,Canada,CAN,10,0,10,15,35
2002,Eritrea,ERI,Canada,CAN,70,0,10,10,90
2002,Estonia,EST,Canada,CAN,0,0,11,0,11
2002,Ethiopia,ETH,Canada,CAN,84,0,35,10,129
2002,Fiji,FJI,Canada,CAN,120,0,50,5,175
2002,France,FRA,Canada,CAN,0,0,5,5,10
2002,Gabon,GAB,Canada,CAN,5,0,10,0,15
2002,Palestinian,PSE,Canada,CAN,30,0,11,26,67
2002,Georgia,GEO,Canada,CAN,33,0,31,14,78
2002,Germany,DEU,Canada,CAN,0,0,0,10,10
2002,Ghana,GHA,Canada,CAN,25,0,75,43,143
2002,Greece,GRC,Canada,CAN,0,0,12,5,17
2002,Grenada,GRD,Canada,CAN,18,0,32,39,89
2002,Guatemala,GTM,Canada,CAN,24,0,84,39,147
2002,Guinea,GIN,Canada,CAN,171,0,108,27,306
2002,Guyana,GUY,Canada,CAN,24,0,57,52,133
2002,Haiti,HTI,Canada,CAN,69,0,136,14,219
2002,"China, Hong Kong SAR",HKG,Canada,CAN,0,0,5,0,5
2002,Honduras,HND,Canada,CAN,12,0,93,70,175
2002,Croatia,HRV,Canada,CAN,0,0,5,0,5
2002,Hungary,HUN,Canada,CAN,248,0,820,1163,2231
2002,Cote d'Ivoire,CIV,Canada,CAN,25,0,22,5,52
2002,India,IND,Canada,CAN,304,0,506,381,1191
2002,Indonesia,IDN,Canada,CAN,16,0,16,5,37
2002,Iran (Islamic Rep. of),IRN,Canada,CAN,374,0,195,75,644
2002,Iraq,IRQ,Canada,CAN,137,0,79,49,265
2002,Israel,ISR,Canada,CAN,55,0,211,103,369
2002,Italy,ITA,Canada,CAN,0,0,5,10,15
2002,Jamaica,JAM,Canada,CAN,10,0,42,44,96
2002,Jordan,JOR,Canada,CAN,14,0,30,13,57
2002,Kazakhstan,KAZ,Canada,CAN,23,0,42,18,83
2002,Kenya,KEN,Canada,CAN,96,0,42,12,150
2002,Kyrgyzstan,KGZ,Canada,CAN,23,0,16,0,39
2002,Rep. of Korea,KOR,Canada,CAN,19,0,111,73,203
2002,Kuwait,KWT,Canada,CAN,35,0,5,0,40
2002,Liberia,LBR,Canada,CAN,5,0,10,5,20
2002,Libya,LBY,Canada,CAN,36,0,41,5,82
2002,Saint Lucia,LCA,Canada,CAN,10,0,19,17,46
2002,Lebanon,LBN,Canada,CAN,95,0,182,69,346
2002,Lesotho,LSO,Canada,CAN,0,0,5,5,10
2002,Sri Lanka,LKA,Canada,CAN,1905,0,457,104,2466
2002,Lithuania,LTU,Canada,CAN,17,0,18,19,54
2002,Latvia,LVA,Canada,CAN,17,0,17,5,39
2002,Mauritania,MRT,Canada,CAN,26,0,13,5,44
2002,North Macedonia,MKD,Canada,CAN,5,0,11,5,21
2002,Rep. of Moldova,MDA,Canada,CAN,19,0,13,5,37
2002,Mexico,MEX,Canada,CAN,290,0,491,426,1207
2002,Mali,MLI,Canada,CAN,21,0,27,5,53
2002,Malaysia,MYS,Canada,CAN,36,0,72,28,136
2002,Malawi,MWI,Canada,CAN,5,0,0,5,10
2002,Mongolia,MNG,Canada,CAN,5,0,10,5,20
2002,Morocco,MAR,Canada,CAN,10,0,17,12,39
2002,Malta,MLT,Canada,CAN,0,0,0,5,5
2002,Mauritius,MUS,Canada,CAN,0,0,5,0,5
2002,Myanmar,MMR,Canada,CAN,10,0,0,5,15
2002,Namibia,NAM,Canada,CAN,0,0,5,0,5
2002,Nepal,NPL,Canada,CAN,49,0,18,5,72
2002,Netherlands,NLD,Canada,CAN,0,0,0,5,5
2002,Nicaragua,NIC,Canada,CAN,5,0,10,5,20
2002,Nigeria,NGA,Canada,CAN,172,0,228,96,496
2002,Pakistan,PAK,Canada,CAN,1238,0,788,252,2278
2002,Panama,PAN,Canada,CAN,0,0,11,0,11
2002,Peru,PER,Canada,CAN,148,0,249,72,469
2002,Philippines,PHL,Canada,CAN,12,0,116,24,152
2002,Poland,POL,Canada,CAN,75,0,88,61,224
2002,Portugal,PRT,Canada,CAN,0,0,28,31,59
2002,Romania,ROU,Canada,CAN,93,0,131,59,283
2002,South Africa,ZAF,Canada,CAN,5,0,18,10,33
2002,Russian Federation,RUS,Canada,CAN,219,0,118,67,404
2002,Rwanda,RWA,Canada,CAN,100,0,37,5,142
2002,El Salvador,SLV,Canada,CAN,82,0,166,57,305
2002,Saudi Arabia,SAU,Canada,CAN,13,0,12,10,35
2002,Serbia and Kosovo: S/RES/1244 (1999),SRB,Canada,CAN,33,0,50,14,97
2002,Senegal,SEN,Canada,CAN,10,0,10,5,25
2002,Singapore,SGP,Canada,CAN,0,0,5,0,5
2002,Sierra Leone,SLE,Canada,CAN,35,0,22,14,71
2002,Somalia,SOM,Canada,CAN,549,0,29,79,657
2002,Spain,ESP,Canada,CAN,0,0,5,0,5
2002,Viet Nam,VNM,Canada,CAN,18,0,28,29,75
2002,Sudan,SDN,Canada,CAN,244,0,57,29,330
2002,Slovakia,SVK,Canada,CAN,5,0,14,5,24
2002,Slovenia,SVN,Canada,CAN,0,0,5,0,5
2002,Sweden,SWE,Canada,CAN,0,0,0,5,5
2002,Syrian Arab Rep.,SYR,Canada,CAN,51,0,35,19,105
2002,United Rep. of Tanzania,TZA,Canada,CAN,102,0,33,12,147
2002,Thailand,THA,Canada,CAN,0,0,0,5,5
2002,Togo,TGO,Canada,CAN,25,0,11,5,41
2002,Trinidad and Tobago,TTO,Canada,CAN,10,0,22,23,55
2002,Tunisia,TUN,Canada,CAN,18,0,74,18,110
2002,Turkey,TUR,Canada,CAN,572,0,334,132,1038
2002,United Arab Emirates,ARE,Canada,CAN,0,0,5,5,10
2002,Uganda,UGA,Canada,CAN,35,0,5,5,45
2002,Ukraine,UKR,Canada,CAN,168,0,129,64,361
2002,Uruguay,URY,Canada,CAN,25,0,85,47,157
2002,United States of America,USA,Canada,CAN,0,0,29,54,83
2002,Uzbekistan,UZB,Canada,CAN,17,0,13,10,40
2002,Saint Vincent and the Grenadines,VCT,Canada,CAN,41,0,49,34,124
2002,Venezuela (Bolivarian Republic of),VEN,Canada,CAN,44,0,68,20,132
2002,Yemen,YEM,Canada,CAN,16,0,24,11,51
2002,Zambia,ZMB,Canada,CAN,0,0,5,0,5
2002,Zimbabwe,ZWE,Canada,CAN,1705,0,359,83,2147
2002,Dem. Rep. of the Congo,COD,Central African Rep.,CAF,50,0,0,0,50
2002,Central African Rep.,CAF,Chad,TCD,5,0,5,0,10
2002,Cameroon,CMR,Chad,TCD,5,0,0,0,5
2002,Dem. Rep. of the Congo,COD,Chad,TCD,22,0,25,0,47
2002,Rwanda,RWA,Chad,TCD,5,0,0,0,5
2002,Sudan,SDN,Chad,TCD,5,0,18,0,23
2002,Bangladesh,BGD,Chile,CHL,0,0,0,5,5
2002,Colombia,COL,Chile,CHL,30,0,0,10,40
2002,Iran (Islamic Rep. of),IRN,Chile,CHL,5,0,0,0,5
2002,Romania,ROU,Chile,CHL,0,0,10,19,29
2002,Rwanda,RWA,Chile,CHL,5,0,0,0,5
2002,Colombia,COL,Costa Rica,CRI,2299,2179,1876,436,6790
2002,Cuba,CUB,Costa Rica,CRI,38,45,36,0,119
2002,Peru,PER,Costa Rica,CRI,0,0,18,5,23
2002,Unknown ,,Costa Rica,CRI,16,11,47,10,84
2002,Afghanistan,AFG,Cyprus,CYP,0,0,5,0,5
2002,Bosnia and Herzegovina,BIH,Cyprus,CYP,0,0,5,0,5
2002,Palestinian,PSE,Cyprus,CYP,0,0,12,0,12
2002,Georgia,GEO,Cyprus,CYP,0,0,16,0,16
2002,India,IND,Cyprus,CYP,0,0,5,0,5
2002,Iran (Islamic Rep. of),IRN,Cyprus,CYP,0,0,33,0,33
2002,Iraq,IRQ,Cyprus,CYP,0,0,5,0,5
2002,Lebanon,LBN,Cyprus,CYP,0,0,5,0,5
2002,Rep. of Moldova,MDA,Cyprus,CYP,0,0,5,0,5
2002,Pakistan,PAK,Cyprus,CYP,0,0,27,0,27
2002,Russian Federation,RUS,Cyprus,CYP,0,0,10,0,10
2002,Serbia and Kosovo: S/RES/1244 (1999),SRB,Cyprus,CYP,0,0,5,0,5
2002,Turkey,TUR,Cyprus,CYP,0,0,5,0,5
2002,Ukraine,UKR,Cyprus,CYP,0,0,5,0,5
2002,Afghanistan,AFG,Denmark,DNK,632,136,948,0,1716
2002,Albania,ALB,Denmark,DNK,0,0,49,0,49
2002,Algeria,DZA,Denmark,DNK,0,0,19,0,19
2002,Angola,AGO,Denmark,DNK,0,5,0,0,5
2002,Egypt,EGY,Denmark,DNK,0,0,5,0,5
2002,Armenia,ARM,Denmark,DNK,0,0,26,0,26
2002,Azerbaijan,AZE,Denmark,DNK,0,0,49,0,49
2002,Burundi,BDI,Denmark,DNK,10,47,0,0,57
2002,Bangladesh,BGD,Denmark,DNK,0,0,10,0,10
2002,Belarus,BLR,Denmark,DNK,0,0,10,0,10
2002,Bosnia and Herzegovina,BIH,Denmark,DNK,5,5,686,0,696
2002,Bulgaria,BGR,Denmark,DNK,0,0,5,0,5
2002,Cambodia,KHM,Denmark,DNK,5,0,0,0,5
2002,Chad,TCD,Denmark,DNK,0,0,5,0,5
2002,China,CHN,Denmark,DNK,10,0,48,0,58
2002,Cameroon,CMR,Denmark,DNK,0,0,15,0,15
2002,Dem. Rep. of the Congo,COD,Denmark,DNK,19,10,36,0,65
2002,Colombia,COL,Denmark,DNK,0,0,5,0,5
2002,Czechia,CZE,Denmark,DNK,0,0,26,0,26
2002,Eritrea,ERI,Denmark,DNK,0,5,5,0,10
2002,Ethiopia,ETH,Denmark,DNK,5,5,42,0,52
2002,Gambia,GMB,Denmark,DNK,0,0,21,0,21
2002,Palestinian,PSE,Denmark,DNK,32,5,192,0,229
2002,Georgia,GEO,Denmark,DNK,0,5,22,0,27
2002,Guinea,GIN,Denmark,DNK,0,5,0,0,5
2002,Croatia,HRV,Denmark,DNK,0,0,43,0,43
2002,India,IND,Denmark,DNK,5,5,61,0,71
2002,Iran (Islamic Rep. of),IRN,Denmark,DNK,15,17,324,0,356
2002,Iraq,IRQ,Denmark,DNK,45,547,1707,0,2299
2002,Israel,ISR,Denmark,DNK,0,0,5,0,5
2002,Jordan,JOR,Denmark,DNK,0,0,13,0,13
2002,Kazakhstan,KAZ,Denmark,DNK,0,0,12,0,12
2002,Kenya,KEN,Denmark,DNK,0,0,10,0,10
2002,Dem. People's Rep. of Korea,PRK,Denmark,DNK,5,0,0,0,5
2002,Liberia,LBR,Denmark,DNK,0,0,5,0,5
2002,Libya,LBY,Denmark,DNK,0,0,20,0,20
2002,Lebanon,LBN,Denmark,DNK,5,0,55,0,60
2002,Sri Lanka,LKA,Denmark,DNK,5,23,31,0,59
2002,Lithuania,LTU,Denmark,DNK,0,0,5,0,5
2002,North Macedonia,MKD,Denmark,DNK,0,0,172,0,172
2002,Rep. of Moldova,MDA,Denmark,DNK,0,0,10,0,10
2002,Mongolia,MNG,Denmark,DNK,0,0,54,0,54
2002,Morocco,MAR,Denmark,DNK,0,0,5,0,5
2002,Myanmar,MMR,Denmark,DNK,10,0,0,0,10
2002,Nepal,NPL,Denmark,DNK,0,0,10,0,10
2002,Niger,NER,Denmark,DNK,0,0,5,0,5
2002,Nigeria,NGA,Denmark,DNK,0,0,24,0,24
2002,Pakistan,PAK,Denmark,DNK,0,0,73,0,73
2002,Peru,PER,Denmark,DNK,0,0,5,0,5
2002,Poland,POL,Denmark,DNK,0,0,14,0,14
2002,Romania,ROU,Denmark,DNK,0,0,10,0,10
2002,Russian Federation,RUS,Denmark,DNK,10,67,61,0,138
2002,Rwanda,RWA,Denmark,DNK,20,14,31,0,65
2002,Serbia and Kosovo: S/RES/1244 (1999),SRB,Denmark,DNK,19,45,1094,0,1158
2002,Senegal,SEN,Denmark,DNK,0,0,5,0,5
2002,Seychelles,SYC,Denmark,DNK,0,0,5,0,5
2002,Sierra Leone,SLE,Denmark,DNK,0,0,17,0,17
2002,Somalia,SOM,Denmark,DNK,210,408,56,0,674
2002,Viet Nam,VNM,Denmark,DNK,12,0,30,0,42
2002,Sudan,SDN,Denmark,DNK,20,15,5,0,40
2002,Slovakia,SVK,Denmark,DNK,0,0,20,0,20
2002,Syrian Arab Rep.,SYR,Denmark,DNK,12,14,59,0,85
2002,Tunisia,TUN,Denmark,DNK,5,0,5,0,10
2002,Turkey,TUR,Denmark,DNK,0,5,90,0,95
2002,Uganda,UGA,Denmark,DNK,0,0,5,0,5
2002,Ukraine,UKR,Denmark,DNK,0,0,28,0,28
2002,Uzbekistan,UZB,Denmark,DNK,5,0,11,0,16
2002,Yemen,YEM,Denmark,DNK,0,0,5,0,5
2002,Stateless,XXA,Denmark,DNK,17,0,17,0,34
2002,Colombia,COL,Ecuador,ECU,1568,0,1196,1568,4332
2002,Pakistan,PAK,Ecuador,ECU,0,0,0,5,5
2002,Turkey,TUR,Ecuador,ECU,0,0,0,10,10
2002,Armenia,ARM,Estonia,EST,0,0,5,0,5
2002,Pakistan,PAK,Estonia,EST,0,0,5,0,5
2002,Syrian Arab Rep.,SYR,Estonia,EST,0,0,5,0,5
2002,Uzbekistan,UZB,Estonia,EST,0,0,5,0,5
2002,Eritrea,ERI,Ethiopia,ETH,1066,0,0,0,1066
2002,Sudan,SDN,Ethiopia,ETH,6134,0,0,0,6134
2002,Afghanistan,AFG,Finland,FIN,0,20,5,11,36
2002,Albania,ALB,Finland,FIN,0,0,0,5,5
2002,Algeria,DZA,Finland,FIN,0,0,22,5,27
2002,Angola,AGO,Finland,FIN,0,23,5,0,28
2002,Azerbaijan,AZE,Finland,FIN,0,0,5,0,5
2002,Bangladesh,BGD,Finland,FIN,0,10,35,18,63
2002,Belarus,BLR,Finland,FIN,0,14,14,17,45
2002,Bolivia (Plurinational State of),BOL,Finland,FIN,0,13,5,0,18
2002,Bosnia and Herzegovina,BIH,Finland,FIN,0,16,102,22,140
2002,Bulgaria,BGR,Finland,FIN,0,0,65,99,164
2002,China,CHN,Finland,FIN,0,0,5,5,10
2002,Cameroon,CMR,Finland,FIN,0,5,10,15,30
2002,Congo,COG,Finland,FIN,0,0,10,0,10
2002,Dem. Rep. of the Congo,COD,Finland,FIN,0,12,26,5,43
2002,Colombia,COL,Finland,FIN,0,10,0,0,10
2002,Cuba,CUB,Finland,FIN,0,5,10,0,15
2002,Czechia,CZE,Finland,FIN,0,0,34,10,44
2002,Ethiopia,ETH,Finland,FIN,0,5,0,0,5
2002,Georgia,GEO,Finland,FIN,0,0,5,5,10
2002,Ghana,GHA,Finland,FIN,0,5,5,0,10
2002,India,IND,Finland,FIN,0,0,5,10,15
2002,Iran (Islamic Rep. of),IRN,Finland,FIN,5,21,41,10,77
2002,Iraq,IRQ,Finland,FIN,0,88,15,16,119
2002,Israel,ISR,Finland,FIN,0,0,5,5,10
2002,Jordan,JOR,Finland,FIN,0,0,5,5,10
2002,Kazakhstan,KAZ,Finland,FIN,0,10,0,14,24
2002,Sri Lanka,LKA,Finland,FIN,0,10,15,0,25
2002,Lithuania,LTU,Finland,FIN,0,0,10,11,21
2002,Latvia,LVA,Finland,FIN,0,0,5,5,10
2002,North Macedonia,MKD,Finland,FIN,0,0,5,14,19
2002,Rep. of Moldova,MDA,Finland,FIN,0,0,5,5,10
2002,Mongolia,MNG,Finland,FIN,0,0,5,5,10
2002,Morocco,MAR,Finland,FIN,0,0,10,0,10
2002,Nigeria,NGA,Finland,FIN,0,0,0,5,5
2002,New Zealand,NZL,Finland,FIN,0,0,0,5,5
2002,Pakistan,PAK,Finland,FIN,0,5,10,5,20
2002,Peru,PER,Finland,FIN,0,0,5,0,5
2002,Poland,POL,Finland,FIN,0,0,5,24,29
2002,Romania,ROU,Finland,FIN,0,0,10,584,594
2002,Russian Federation,RUS,Finland,FIN,0,98,24,439,561
2002,Rwanda,RWA,Finland,FIN,0,11,0,0,11
2002,Serbia and Kosovo: S/RES/1244 (1999),SRB,Finland,FIN,0,43,63,56,162
2002,Sierra Leone,SLE,Finland,FIN,0,5,5,5,15
2002,Somalia,SOM,Finland,FIN,0,58,5,5,68
2002,Viet Nam,VNM,Finland,FIN,0,0,5,0,5
2002,Slovakia,SVK,Finland,FIN,0,0,278,64,342
2002,Syrian Arab Rep.,SYR,Finland,FIN,5,5,5,0,15
2002,Turkmenistan,TKM,Finland,FIN,0,5,0,0,5
2002,Tunisia,TUN,Finland,FIN,0,0,5,0,5
2002,Turkey,TUR,Finland,FIN,0,57,108,40,205
2002,Ukraine,UKR,Finland,FIN,0,5,48,37,90
2002,Uzbekistan,UZB,Finland,FIN,0,0,5,33,38
2002,Stateless,XXA,Finland,FIN,0,5,5,14,24
2002,Unknown ,,Finland,FIN,0,0,5,5,10
2002,Afghanistan,AFG,France,FRA,89,0,175,0,264
2002,Albania,ALB,France,FRA,40,0,506,0,546
2002,Algeria,DZA,France,FRA,68,0,2568,0,2636
2002,Angola,AGO,France,FRA,184,0,819,0,1003
2002,Egypt,EGY,France,FRA,5,0,13,0,18
2002,Armenia,ARM,France,FRA,36,0,530,0,566
2002,Azerbaijan,AZE,France,FRA,32,0,225,0,257
2002,Burundi,BDI,France,FRA,27,0,44,0,71
2002,Bangladesh,BGD,France,FRA,32,0,613,0,645
2002,Burkina Faso,BFA,France,FRA,0,0,52,0,52
2002,Belarus,BLR,France,FRA,13,0,190,0,203
2002,Bosnia and Herzegovina,BIH,France,FRA,342,0,251,0,593
2002,Cambodia,KHM,France,FRA,69,0,114,0,183
2002,Central African Rep.,CAF,France,FRA,85,0,253,0,338
2002,Chad,TCD,France,FRA,75,0,102,0,177
2002,China,CHN,France,FRA,17,0,2558,0,2575
2002,Cameroon,CMR,France,FRA,46,0,497,0,543
2002,Congo,COG,France,FRA,433,0,2208,0,2641
2002,Dem. Rep. of the Congo,COD,France,FRA,1058,0,4603,0,5661
2002,Comoros,COM,France,FRA,5,0,73,0,78
2002,Colombia,COL,France,FRA,29,0,160,0,189
2002,Cuba,CUB,France,FRA,10,0,18,0,28
2002,Czechia,CZE,France,FRA,0,0,5,0,5
2002,Ecuador,ECU,France,FRA,5,0,67,0,72
2002,Estonia,EST,France,FRA,0,0,5,0,5
2002,Ethiopia,ETH,France,FRA,20,0,5,0,25
2002,Gabon,GAB,France,FRA,0,0,24,0,24
2002,Georgia,GEO,France,FRA,59,0,1053,0,1112
2002,Ghana,GHA,France,FRA,17,0,76,0,93
2002,Guinea-Bissau,GNB,France,FRA,40,0,152,0,192
2002,Guinea,GIN,France,FRA,58,0,879,0,937
2002,Guyana,GUY,France,FRA,0,0,23,0,23
2002,Haiti,HTI,France,FRA,180,0,2089,0,2269
2002,Croatia,HRV,France,FRA,12,0,15,0,27
2002,Cote d'Ivoire,CIV,France,FRA,70,0,534,0,604
2002,India,IND,France,FRA,10,0,364,0,374
2002,Iran (Islamic Rep. of),IRN,France,FRA,32,0,214,0,246
2002,Iraq,IRQ,France,FRA,67,0,142,0,209
2002,Israel,ISR,France,FRA,0,0,10,0,10
2002,Kazakhstan,KAZ,France,FRA,21,0,94,0,115
2002,Kyrgyzstan,KGZ,France,FRA,0,0,26,0,26
2002,Lao People's Dem. Rep.,LAO,France,FRA,22,0,5,0,27
2002,Lebanon,LBN,France,FRA,5,0,32,0,37
2002,Sri Lanka,LKA,France,FRA,630,0,2232,0,2862
2002,Mauritania,MRT,France,FRA,354,0,2556,0,2910
2002,Rep. of Moldova,MDA,France,FRA,10,0,774,0,784
2002,Mali,MLI,France,FRA,5,0,2607,0,2612
2002,Morocco,MAR,France,FRA,5,0,50,0,55
2002,Mauritius,MUS,France,FRA,0,0,16,0,16
2002,Myanmar,MMR,France,FRA,0,0,20,0,20
2002,Nepal,NPL,France,FRA,0,0,5,0,5
2002,Niger,NER,France,FRA,0,0,11,0,11
2002,Nigeria,NGA,France,FRA,23,0,850,0,873
2002,Pakistan,PAK,France,FRA,11,0,346,0,357
2002,Peru,PER,France,FRA,21,0,97,0,118
2002,Poland,POL,France,FRA,0,0,13,0,13
2002,South Africa,ZAF,France,FRA,0,0,5,0,5
2002,Russian Federation,RUS,France,FRA,484,0,1099,0,1583
2002,Rwanda,RWA,France,FRA,217,0,51,0,268
2002,Serbia and Kosovo: S/RES/1244 (1999),SRB,France,FRA,435,0,1663,0,2098
2002,Senegal,SEN,France,FRA,0,0,554,0,554
2002,Sierra Leone,SLE,France,FRA,73,0,911,0,984
2002,Somalia,SOM,France,FRA,38,0,55,0,93
2002,Viet Nam,VNM,France,FRA,79,0,19,0,98
2002,Sudan,SDN,France,FRA,13,0,55,0,68
2002,Slovakia,SVK,France,FRA,0,0,38,0,38
2002,Syrian Arab Rep.,SYR,France,FRA,20,0,23,0,43
2002,Thailand,THA,France,FRA,0,0,33,0,33
2002,Tajikistan,TJK,France,FRA,0,0,20,0,20
2002,Togo,TGO,France,FRA,56,0,175,0,231
2002,Tunisia,TUN,France,FRA,14,0,27,0,41
2002,Turkey,TUR,France,FRA,417,0,5579,0,5996
2002,Ukraine,UKR,France,FRA,12,0,608,0,620
2002,Uzbekistan,UZB,France,FRA,12,0,51,0,63
2002,Stateless,XXA,France,FRA,55,0,32,0,87
2002,Unknown ,,France,FRA,37,0,920,0,957
2002,Angola,AGO,Gabon,GAB,5,84,0,0,89
2002,Burundi,BDI,Gabon,GAB,5,17,0,0,22
2002,Benin,BEN,Gabon,GAB,0,0,0,5,5
2002,Central African Rep.,CAF,Gabon,GAB,0,0,14,0,14
2002,Chad,TCD,Gabon,GAB,12,895,94,5,1006
2002,Cameroon,CMR,Gabon,GAB,0,0,0,10,10
2002,Congo,COG,Gabon,GAB,5,0,15,5,25
2002,Dem. Rep. of the Congo,COD,Gabon,GAB,18,0,132,5,155
2002,Equatorial Guinea,GNQ,Gabon,GAB,5,0,10,0,15
2002,Liberia,LBR,Gabon,GAB,0,0,29,0,29
2002,Mauritania,MRT,Gabon,GAB,0,10,33,0,43
2002,Mali,MLI,Gabon,GAB,0,0,0,12,12
2002,Niger,NER,Gabon,GAB,0,0,0,5,5
2002,Nigeria,NGA,Gabon,GAB,0,0,25,0,25
2002,Rwanda,RWA,Gabon,GAB,18,0,5,0,23
2002,Sierra Leone,SLE,Gabon,GAB,0,0,5,0,5
2002,Sao Tome and Principe,STP,Gabon,GAB,0,15,0,0,15
2002,Togo,TGO,Gabon,GAB,0,10,0,0,10
2002,Sierra Leone,SLE,Ghana,GHA,69,0,0,0,69
2002,Sudan,SDN,Ghana,GHA,5,0,0,0,5
2002,Liberia,LBR,Guinea-Bissau,GNB,10,0,0,10,20
2002,Senegal,SEN,Guinea-Bissau,GNB,0,0,0,5,5
2002,Sierra Leone,SLE,Guinea-Bissau,GNB,5,0,17,318,340
2002,Afghanistan,AFG,Greece,GRC,0,5,2285,168,2458
2002,Albania,ALB,Greece,GRC,0,0,10,0,10
2002,Algeria,DZA,Greece,GRC,0,5,11,10,26
2002,Egypt,EGY,Greece,GRC,0,0,5,0,5
2002,Armenia,ARM,Greece,GRC,0,0,5,0,5
2002,Azerbaijan,AZE,Greece,GRC,0,5,0,0,5
2002,Burundi,BDI,Greece,GRC,0,0,11,0,11
2002,Bangladesh,BGD,Greece,GRC,0,0,35,0,35
2002,Belarus,BLR,Greece,GRC,0,0,10,0,10
2002,Central African Rep.,CAF,Greece,GRC,0,0,10,0,10
2002,China,CHN,Greece,GRC,0,5,56,5,66
2002,Cameroon,CMR,Greece,GRC,0,0,5,0,5
2002,Dem. Rep. of the Congo,COD,Greece,GRC,0,0,62,10,72
2002,Eritrea,ERI,Greece,GRC,0,0,43,0,43
2002,Ethiopia,ETH,Greece,GRC,0,0,62,5,67
2002,Palestinian,PSE,Greece,GRC,5,0,90,0,95
2002,Georgia,GEO,Greece,GRC,0,0,0,5,5
2002,Ghana,GHA,Greece,GRC,0,0,5,0,5
2002,India,IND,Greece,GRC,0,0,122,5,127
2002,Iran (Islamic Rep. of),IRN,Greece,GRC,0,5,480,60,545
2002,Iraq,IRQ,Greece,GRC,10,18,4113,270,4411
2002,Jordan,JOR,Greece,GRC,0,0,11,0,11
2002,Kyrgyzstan,KGZ,Greece,GRC,0,0,0,5,5
2002,Liberia,LBR,Greece,GRC,0,0,5,0,5
2002,Libya,LBY,Greece,GRC,0,0,10,0,10
2002,Sri Lanka,LKA,Greece,GRC,0,0,19,0,19
2002,Morocco,MAR,Greece,GRC,0,0,18,0,18
2002,Myanmar,MMR,Greece,GRC,0,0,10,0,10
2002,Nigeria,NGA,Greece,GRC,0,5,113,5,123
2002,Pakistan,PAK,Greece,GRC,0,5,363,5,373
2002,Romania,ROU,Greece,GRC,0,0,5,5,10
2002,Russian Federation,RUS,Greece,GRC,5,5,43,5,58
2002,Rwanda,RWA,Greece,GRC,0,0,17,0,17
2002,Serbia and Kosovo: S/RES/1244 (1999),SRB,Greece,GRC,5,0,13,0,18
2002,Senegal,SEN,Greece,GRC,0,0,5,0,5
2002,Sierra Leone,SLE,Greece,GRC,0,0,188,5,193
2002,Somalia,SOM,Greece,GRC,0,0,62,0,62
2002,Sudan,SDN,Greece,GRC,0,0,61,5,66
2002,Syrian Arab Rep.,SYR,Greece,GRC,0,0,12,0,12
2002,Turkey,TUR,Greece,GRC,5,5,880,184,1074
2002,Ukraine,UKR,Greece,GRC,0,0,5,0,5
2002,Uzbekistan,UZB,Greece,GRC,0,0,10,5,15
2002,Unknown ,,Greece,GRC,0,0,10,0,10
2002,Dem. Rep. of the Congo,COD,Guinea,GIN,5,0,5,0,10
2002,Liberia,LBR,Guinea,GIN,751,0,94,30,875
2002,Nigeria,NGA,Guinea,GIN,5,0,0,0,5
2002,Sierra Leone,SLE,Guinea,GIN,1264,0,112,89,1465
2002,Colombia,COL,Honduras,HND,0,0,5,5,10
2002,Cuba,CUB,Honduras,HND,5,0,43,11,59
2002,Peru,PER,Honduras,HND,5,0,0,0,5
2002,Afghanistan,AFG,Croatia,HRV,0,0,5,5,10
2002,Algeria,DZA,Croatia,HRV,0,0,0,10,10
2002,China,CHN,Croatia,HRV,0,0,5,0,5
2002,Palestinian,PSE,Croatia,HRV,0,0,5,0,5
2002,Iran (Islamic Rep. of),IRN,Croatia,HRV,0,0,5,19,24
2002,Iraq,IRQ,Croatia,HRV,0,0,0,16,16
2002,Sri Lanka,LKA,Croatia,HRV,0,0,0,5,5
2002,Nigeria,NGA,Croatia,HRV,0,0,0,5,5
2002,Pakistan,PAK,Croatia,HRV,0,0,0,13,13
2002,Russian Federation,RUS,Croatia,HRV,0,0,5,5,10
2002,Serbia and Kosovo: S/RES/1244 (1999),SRB,Croatia,HRV,0,0,0,10,10
2002,Sierra Leone,SLE,Croatia,HRV,0,0,0,5,5
2002,Ukraine,UKR,Croatia,HRV,0,0,0,5,5
2002,Afghanistan,AFG,Hungary,HUN,10,731,266,2194,3201
2002,Albania,ALB,Hungary,HUN,0,0,0,5,5
2002,Algeria,DZA,Hungary,HUN,0,0,16,16,32
2002,Angola,AGO,Hungary,HUN,0,5,5,0,10
2002,Egypt,EGY,Hungary,HUN,0,0,5,0,5
2002,Armenia,ARM,Hungary,HUN,5,0,10,5,20
2002,Bangladesh,BGD,Hungary,HUN,0,0,195,442,637
2002,China,CHN,Hungary,HUN,0,0,61,10,71
2002,Cameroon,CMR,Hungary,HUN,5,5,0,5,15
2002,Ethiopia,ETH,Hungary,HUN,0,0,0,11,11
2002,Palestinian,PSE,Hungary,HUN,5,5,28,19,57
2002,Georgia,GEO,Hungary,HUN,0,0,30,34,64
2002,Ghana,GHA,Hungary,HUN,0,0,10,15,25
2002,India,IND,Hungary,HUN,0,0,15,95,110
2002,Iran (Islamic Rep. of),IRN,Hungary,HUN,5,21,28,107,161
2002,Iraq,IRQ,Hungary,HUN,46,399,102,1385,1932
2002,Sri Lanka,LKA,Hungary,HUN,0,0,0,5,5
2002,North Macedonia,MKD,Hungary,HUN,0,0,23,5,28
2002,Rep. of Moldova,MDA,Hungary,HUN,0,0,10,5,15
2002,Mongolia,MNG,Hungary,HUN,0,0,5,0,5
2002,Nigeria,NGA,Hungary,HUN,5,23,55,76,159
2002,Pakistan,PAK,Hungary,HUN,0,5,16,51,72
2002,Romania,ROU,Hungary,HUN,0,0,13,5,18
2002,Russian Federation,RUS,Hungary,HUN,5,10,14,5,34
2002,Serbia and Kosovo: S/RES/1244 (1999),SRB,Hungary,HUN,10,0,44,54,108
2002,Sierra Leone,SLE,Hungary,HUN,0,5,30,77,112
2002,Somalia,SOM,Hungary,HUN,0,33,5,220,258
2002,Viet Nam,VNM,Hungary,HUN,0,0,156,24,180
2002,Sudan,SDN,Hungary,HUN,0,48,5,44,97
2002,Slovakia,SVK,Hungary,HUN,0,0,10,0,10
2002,Syrian Arab Rep.,SYR,Hungary,HUN,0,0,5,5,10
2002,Tunisia,TUN,Hungary,HUN,0,0,5,5,10
2002,Turkey,TUR,Hungary,HUN,5,5,62,121,193
2002,Ukraine,UKR,Hungary,HUN,5,0,10,10,25
2002,Uzbekistan,UZB,Hungary,HUN,0,0,5,0,5
2002,Unknown ,,Hungary,HUN,0,0,5,0,5
2002,Albania,ALB,Iceland,ISL,0,0,5,10,15
2002,Belarus,BLR,Iceland,ISL,0,0,0,5,5
2002,Bulgaria,BGR,Iceland,ISL,0,0,0,5,5
2002,Georgia,GEO,Iceland,ISL,0,0,5,0,5
2002,Iran (Islamic Rep. of),IRN,Iceland,ISL,0,0,5,0,5
2002,Mongolia,MNG,Iceland,ISL,0,0,0,5,5
2002,Romania,ROU,Iceland,ISL,0,0,10,23,33
2002,Russian Federation,RUS,Iceland,ISL,0,0,13,0,13
2002,Slovakia,SVK,Iceland,ISL,0,0,5,0,5
2002,Ukraine,UKR,Iceland,ISL,0,0,5,0,5
2002,Uzbekistan,UZB,Iceland,ISL,0,0,0,5,5
2002,Afghanistan,AFG,Ireland,IRL,0,0,5,18,23
2002,Albania,ALB,Ireland,IRL,14,0,98,82,194
2002,Algeria,DZA,Ireland,IRL,5,13,131,69,218
2002,Angola,AGO,Ireland,IRL,51,0,140,16,207
2002,Egypt,EGY,Ireland,IRL,5,0,20,29,54
2002,Armenia,ARM,Ireland,IRL,5,0,5,13,23
2002,Azerbaijan,AZE,Ireland,IRL,0,0,5,10,15
2002,Burundi,BDI,Ireland,IRL,0,0,14,5,19
2002,Benin,BEN,Ireland,IRL,0,0,0,10,10
2002,Bangladesh,BGD,Ireland,IRL,0,0,5,5,10
2002,Bhutan,BTN,Ireland,IRL,5,0,0,0,5
2002,Belarus,BLR,Ireland,IRL,5,0,39,61,105
2002,Bosnia and Herzegovina,BIH,Ireland,IRL,0,0,10,0,10
2002,Bulgaria,BGR,Ireland,IRL,0,0,43,65,108
2002,China,CHN,Ireland,IRL,5,0,15,37,57
2002,Cameroon,CMR,Ireland,IRL,31,0,103,94,228
2002,Congo,COG,Ireland,IRL,11,0,11,5,27
2002,Dem. Rep. of the Congo,COD,Ireland,IRL,125,0,213,76,414
2002,Cuba,CUB,Ireland,IRL,0,0,5,0,5
2002,Czechia,CZE,Ireland,IRL,10,0,141,137,288
2002,Estonia,EST,Ireland,IRL,0,0,52,56,108
2002,Ethiopia,ETH,Ireland,IRL,5,0,5,0,10
2002,Gambia,GMB,Ireland,IRL,0,0,18,26,44
2002,Palestinian,PSE,Ireland,IRL,19,0,15,11,45
2002,Georgia,GEO,Ireland,IRL,10,0,95,57,162
2002,Ghana,GHA,Ireland,IRL,5,0,91,202,298
2002,Guinea,GIN,Ireland,IRL,5,0,0,5,10
2002,Croatia,HRV,Ireland,IRL,29,0,243,59,331
2002,Hungary,HUN,Ireland,IRL,0,0,5,10,15
2002,Cote d'Ivoire,CIV,Ireland,IRL,10,0,42,36,88
2002,India,IND,Ireland,IRL,0,0,0,45,45
2002,Iran (Islamic Rep. of),IRN,Ireland,IRL,10,0,13,10,33
2002,Iraq,IRQ,Ireland,IRL,43,0,34,14,91
2002,Israel,ISR,Ireland,IRL,0,0,49,20,69
2002,Jamaica,JAM,Ireland,IRL,0,0,5,14,19
2002,Kazakhstan,KAZ,Ireland,IRL,5,0,73,22,100
2002,Kenya,KEN,Ireland,IRL,11,0,32,47,90
2002,Kyrgyzstan,KGZ,Ireland,IRL,0,0,5,11,16
2002,Liberia,LBR,Ireland,IRL,10,0,16,10,36
2002,Libya,LBY,Ireland,IRL,10,0,35,13,58
2002,Lebanon,LBN,Ireland,IRL,0,0,15,16,31
2002,Lesotho,LSO,Ireland,IRL,0,0,5,0,5
2002,Sri Lanka,LKA,Ireland,IRL,5,0,5,12,22
2002,Lithuania,LTU,Ireland,IRL,0,0,97,274,371
2002,Latvia,LVA,Ireland,IRL,0,0,31,42,73
2002,North Macedonia,MKD,Ireland,IRL,0,0,17,20,37
2002,Rep. of Moldova,MDA,Ireland,IRL,5,0,318,436,759
2002,Malaysia,MYS,Ireland,IRL,0,0,5,5,10
2002,Malawi,MWI,Ireland,IRL,0,0,5,5,10
2002,Mongolia,MNG,Ireland,IRL,0,0,0,5,5
2002,Morocco,MAR,Ireland,IRL,0,0,5,10,15
2002,Niger,NER,Ireland,IRL,0,0,5,0,5
2002,Nigeria,NGA,Ireland,IRL,33,5,1585,3618,5241
2002,Pakistan,PAK,Ireland,IRL,36,0,60,84,180
2002,Poland,POL,Ireland,IRL,0,0,224,211,435
2002,Romania,ROU,Ireland,IRL,5,37,592,1314,1948
2002,South Africa,ZAF,Ireland,IRL,5,0,155,114,274
2002,Russian Federation,RUS,Ireland,IRL,28,5,183,162,378
2002,Rwanda,RWA,Ireland,IRL,15,0,14,5,34
2002,Serbia and Kosovo: S/RES/1244 (1999),SRB,Ireland,IRL,36,5,134,67,242
2002,Sierra Leone,SLE,Ireland,IRL,12,0,158,55,225
2002,Somalia,SOM,Ireland,IRL,35,0,45,15,95
2002,Sudan,SDN,Ireland,IRL,11,0,23,12,46
2002,Slovakia,SVK,Ireland,IRL,10,0,14,57,81
2002,Switzerland,CHE,Ireland,IRL,5,0,0,0,5
2002,Syrian Arab Rep.,SYR,Ireland,IRL,5,0,5,0,10
2002,United Rep. of Tanzania,TZA,Ireland,IRL,0,0,0,5,5
2002,Togo,TGO,Ireland,IRL,17,0,12,10,39
2002,Tunisia,TUN,Ireland,IRL,0,0,5,0,5
2002,Turkey,TUR,Ireland,IRL,0,0,13,5,18
2002,Uganda,UGA,Ireland,IRL,5,0,12,5,22
2002,Ukraine,UKR,Ireland,IRL,5,0,165,293,463
2002,Uzbekistan,UZB,Ireland,IRL,5,0,38,17,60
2002,Zambia,ZMB,Ireland,IRL,0,0,5,0,5
2002,Zimbabwe,ZWE,Ireland,IRL,159,0,149,36,344
2002,Stateless,XXA,Ireland,IRL,5,0,23,41,69
2002,Unknown ,,Ireland,IRL,0,40,0,0,40
2002,Dem. Rep. of the Congo,COD,Israel,ISR,5,0,0,11,16
2002,Eritrea,ERI,Israel,ISR,5,0,0,11,16
2002,Ethiopia,ETH,Israel,ISR,52,0,62,26,140
2002,Ghana,GHA,Israel,ISR,0,0,5,0,5
2002,India,IND,Israel,ISR,0,0,0,5,5
2002,Iran (Islamic Rep. of),IRN,Israel,ISR,0,0,0,5,5
2002,Liberia,LBR,Israel,ISR,0,0,5,0,5
2002,Lebanon,LBN,Israel,ISR,0,0,0,5,5
2002,Nigeria,NGA,Israel,ISR,0,0,5,5,10
2002,Sierra Leone,SLE,Israel,ISR,0,26,0,22,48
2002,Turkey,TUR,Israel,ISR,0,0,5,0,5
2002,Afghanistan,AFG,Japan,JPN,5,0,39,5,49
2002,Bangladesh,BGD,Japan,JPN,0,0,10,0,10
2002,China,CHN,Japan,JPN,0,5,5,5,15
2002,Cameroon,CMR,Japan,JPN,0,0,5,0,5
2002,India,IND,Japan,JPN,0,0,5,0,5
2002,Iran (Islamic Rep. of),IRN,Japan,JPN,0,5,13,0,18
2002,Iraq,IRQ,Japan,JPN,0,0,5,0,5
2002,Sri Lanka,LKA,Japan,JPN,0,0,0,5,5
2002,Myanmar,MMR,Japan,JPN,0,14,5,0,19
2002,Nigeria,NGA,Japan,JPN,0,0,5,5,10
2002,Pakistan,PAK,Japan,JPN,0,0,36,5,41
2002,Viet Nam,VNM,Japan,JPN,0,0,5,0,5
2002,Sudan,SDN,Japan,JPN,0,0,5,0,5
2002,Turkey,TUR,Japan,JPN,0,0,28,5,33
2002,Unknown ,,Japan,JPN,0,5,5,5,15
2002,Afghanistan,AFG,Kazakhstan,KAZ,38,0,10,5,53
2002,Iraq,IRQ,Kazakhstan,KAZ,0,0,5,0,5
2002,Afghanistan,AFG,Kyrgyzstan,KGZ,81,0,0,0,81
2002,China,CHN,Kyrgyzstan,KGZ,5,0,0,0,5
2002,Tajikistan,TJK,Kyrgyzstan,KGZ,127,0,0,0,127
2002,China,CHN,Rep. of Korea,KOR,0,0,0,5,5
2002,Dem. Rep. of the Congo,COD,Rep. of Korea,KOR,0,0,0,5,5
2002,Iran (Islamic Rep. of),IRN,Rep. of Korea,KOR,0,0,5,0,5
2002,Iraq,IRQ,Rep. of Korea,KOR,0,5,0,0,5
2002,Pakistan,PAK,Rep. of Korea,KOR,0,0,0,5,5
2002,Somalia,SOM,Rep. of Korea,KOR,0,0,5,0,5
2002,Nigeria,NGA,Liberia,LBR,0,5,0,0,5
2002,Armenia,ARM,Liechtenstein,LIE,0,10,0,0,10
2002,Bosnia and Herzegovina,BIH,Liechtenstein,LIE,0,0,0,5,5
2002,North Macedonia,MKD,Liechtenstein,LIE,0,0,5,39,44
2002,Serbia and Kosovo: S/RES/1244 (1999),SRB,Liechtenstein,LIE,0,14,5,66,85
2002,Ukraine,UKR,Liechtenstein,LIE,0,0,0,5,5
2002,Afghanistan,AFG,Lithuania,LTU,0,5,10,15,30
2002,Russian Federation,RUS,Lithuania,LTU,0,74,5,36,115
2002,Belarus,BLR,Latvia,LVA,0,5,0,0,5
2002,Russian Federation,RUS,Latvia,LVA,0,0,5,0,5
2002,Slovakia,SVK,Latvia,LVA,0,0,10,0,10
2002,Ukraine,UKR,Latvia,LVA,0,0,5,0,5
2002,Albania,ALB,Mexico,MEX,5,0,5,0,10
2002,Bangladesh,BGD,Mexico,MEX,0,0,5,5,10
2002,China,CHN,Mexico,MEX,0,0,5,0,5
2002,Dem. Rep. of the Congo,COD,Mexico,MEX,5,0,0,0,5
2002,Colombia,COL,Mexico,MEX,18,0,18,10,46
2002,Cuba,CUB,Mexico,MEX,0,0,27,11,38
2002,Guatemala,GTM,Mexico,MEX,5,0,0,0,5
2002,Honduras,HND,Mexico,MEX,5,0,0,0,5
2002,Iraq,IRQ,Mexico,MEX,0,0,0,10,10
2002,Sri Lanka,LKA,Mexico,MEX,0,0,5,0,5
2002,Nigeria,NGA,Mexico,MEX,5,0,5,0,10
2002,Serbia and Kosovo: S/RES/1244 (1999),SRB,Mexico,MEX,5,0,0,0,5
2002,Ukraine,UKR,Mexico,MEX,0,0,5,0,5
2002,Cameroon,CMR,Mali,MLI,0,0,5,0,5
2002,Congo,COG,Mali,MLI,5,0,0,0,5
2002,Dem. Rep. of the Congo,COD,Mali,MLI,5,0,0,0,5
2002,Liberia,LBR,Mali,MLI,14,0,10,0,24
2002,Mauritania,MRT,Mali,MLI,5,0,10,0,15
2002,Nigeria,NGA,Mali,MLI,0,0,5,0,5
2002,Rwanda,RWA,Mali,MLI,0,0,12,0,12
2002,Sierra Leone,SLE,Mali,MLI,36,0,0,0,36
2002,Togo,TGO,Mali,MLI,5,0,5,0,10
2002,Unknown ,,Mali,MLI,0,0,0,88,88
2002,Burundi,BDI,Malawi,MWI,125,0,0,0,125
2002,Dem. Rep. of the Congo,COD,Malawi,MWI,185,0,0,0,185
2002,Rwanda,RWA,Malawi,MWI,335,0,0,0,335
2002,Sierra Leone,SLE,Malawi,MWI,0,0,0,5,5
2002,Somalia,SOM,Malawi,MWI,20,0,0,0,20
2002,Burundi,BDI,Namibia,NAM,11,0,0,171,182
2002,Cameroon,CMR,Namibia,NAM,0,0,0,5,5
2002,Congo,COG,Namibia,NAM,10,0,0,87,97
2002,Dem. Rep. of the Congo,COD,Namibia,NAM,28,0,0,649,677
2002,Liberia,LBR,Namibia,NAM,0,0,5,37,42
2002,Rwanda,RWA,Namibia,NAM,0,0,0,33,33
2002,Sierra Leone,SLE,Namibia,NAM,0,0,0,5,5
2002,Somalia,SOM,Namibia,NAM,0,0,0,5,5
2002,Sudan,SDN,Namibia,NAM,0,0,0,5,5
2002,United Rep. of Tanzania,TZA,Namibia,NAM,0,0,0,5,5
2002,China,CHN,Nepal,NPL,5,0,5,0,10
2002,Afghanistan,AFG,Netherlands,NLD,11,139,884,560,1594
2002,Albania,ALB,Netherlands,NLD,0,0,92,44,136
2002,Algeria,DZA,Netherlands,NLD,0,5,215,65,285
2002,Angola,AGO,Netherlands,NLD,5,689,4637,285,5616
2002,Egypt,EGY,Netherlands,NLD,0,0,25,5,30
2002,Armenia,ARM,Netherlands,NLD,0,36,516,30,582
2002,Azerbaijan,AZE,Netherlands,NLD,5,52,620,51,728
2002,Burundi,BDI,Netherlands,NLD,5,275,151,61,492
2002,Benin,BEN,Netherlands,NLD,0,0,115,5,120
2002,Bangladesh,BGD,Netherlands,NLD,0,0,43,5,48
2002,Burkina Faso,BFA,Netherlands,NLD,0,0,30,0,30
2002,Belarus,BLR,Netherlands,NLD,5,5,124,27,161
2002,Bosnia and Herzegovina,BIH,Netherlands,NLD,0,22,332,71,425
2002,Bulgaria,BGR,Netherlands,NLD,0,0,25,13,38
2002,Chad,TCD,Netherlands,NLD,0,0,19,0,19
2002,China,CHN,Netherlands,NLD,0,10,1239,180,1429
2002,Cameroon,CMR,Netherlands,NLD,10,16,353,28,407
2002,Congo,COG,Netherlands,NLD,5,52,489,56,602
2002,Dem. Rep. of the Congo,COD,Netherlands,NLD,0,57,660,57,774
2002,Colombia,COL,Netherlands,NLD,0,5,21,10,36
2002,Cuba,CUB,Netherlands,NLD,0,0,10,5,15
2002,Czechia,CZE,Netherlands,NLD,0,0,25,37,62
2002,Eritrea,ERI,Netherlands,NLD,0,21,259,20,300
2002,Ethiopia,ETH,Netherlands,NLD,5,10,244,22,281
2002,Gabon,GAB,Netherlands,NLD,0,0,5,0,5
2002,Gambia,GMB,Netherlands,NLD,0,0,16,0,16
2002,United Kingdom of Great Britain and Northern Ireland,GBR,Netherlands,NLD,0,0,5,0,5
2002,Georgia,GEO,Netherlands,NLD,0,10,315,31,356
2002,Germany,DEU,Netherlands,NLD,0,0,5,0,5
2002,Ghana,GHA,Netherlands,NLD,0,0,23,10,33
2002,Guinea-Bissau,GNB,Netherlands,NLD,0,0,41,5,46
2002,Greece,GRC,Netherlands,NLD,0,0,0,5,5
2002,Guinea,GIN,Netherlands,NLD,5,184,1490,84,1763
2002,Croatia,HRV,Netherlands,NLD,0,0,40,19,59
2002,Hungary,HUN,Netherlands,NLD,0,0,50,25,75
2002,Cote d'Ivoire,CIV,Netherlands,NLD,0,5,159,5,169
2002,India,IND,Netherlands,NLD,0,0,134,83,217
2002,Indonesia,IDN,Netherlands,NLD,0,0,10,0,10
2002,Iran (Islamic Rep. of),IRN,Netherlands,NLD,30,66,1091,146,1333
2002,Iraq,IRQ,Netherlands,NLD,13,131,1199,248,1591
2002,Israel,ISR,Netherlands,NLD,0,0,23,10,33
2002,Jordan,JOR,Netherlands,NLD,0,0,29,11,40
2002,Kazakhstan,KAZ,Netherlands,NLD,0,5,75,10,90
2002,Kenya,KEN,Netherlands,NLD,0,0,31,0,31
2002,Kyrgyzstan,KGZ,Netherlands,NLD,0,5,71,10,86
2002,Dem. People's Rep. of Korea,PRK,Netherlands,NLD,0,0,5,0,5
2002,Liberia,LBR,Netherlands,NLD,5,15,261,34,315
2002,Libya,LBY,Netherlands,NLD,0,0,41,17,58
2002,Lebanon,LBN,Netherlands,NLD,0,5,77,14,96
2002,Sri Lanka,LKA,Netherlands,NLD,5,51,398,90,544
2002,Lithuania,LTU,Netherlands,NLD,0,0,10,5,15
2002,Latvia,LVA,Netherlands,NLD,0,0,5,5,10
2002,Mauritania,MRT,Netherlands,NLD,0,0,71,10,81
2002,North Macedonia,MKD,Netherlands,NLD,0,0,107,22,129
2002,Rep. of Moldova,MDA,Netherlands,NLD,0,0,22,10,32
2002,Mali,MLI,Netherlands,NLD,0,0,21,0,21
2002,Mongolia,MNG,Netherlands,NLD,0,5,276,53,334
2002,Morocco,MAR,Netherlands,NLD,0,0,21,10,31
2002,Myanmar,MMR,Netherlands,NLD,5,5,29,5,44
2002,Nepal,NPL,Netherlands,NLD,0,0,39,0,39
2002,Netherlands,NLD,Netherlands,NLD,0,0,5,5,10
2002,Niger,NER,Netherlands,NLD,0,10,245,14,269
2002,Nigeria,NGA,Netherlands,NLD,0,0,583,73,656
2002,Pakistan,PAK,Netherlands,NLD,0,0,104,15,119
2002,Peru,PER,Netherlands,NLD,0,0,10,5,15
2002,Poland,POL,Netherlands,NLD,0,0,5,11,16
2002,Romania,ROU,Netherlands,NLD,0,0,37,26,63
2002,South Africa,ZAF,Netherlands,NLD,0,0,5,5,10
2002,Russian Federation,RUS,Netherlands,NLD,0,59,572,100,731
2002,Rwanda,RWA,Netherlands,NLD,5,26,207,29,267
2002,Serbia and Kosovo: S/RES/1244 (1999),SRB,Netherlands,NLD,0,39,631,176,846
2002,Senegal,SEN,Netherlands,NLD,0,0,15,5,20
2002,Sierra Leone,SLE,Netherlands,NLD,0,949,1574,246,2769
2002,Somalia,SOM,Netherlands,NLD,5,128,1156,189,1478
2002,Viet Nam,VNM,Netherlands,NLD,0,0,80,5,85
2002,Sudan,SDN,Netherlands,NLD,10,88,832,100,1030
2002,Suriname,SUR,Netherlands,NLD,0,0,5,5,10
2002,Slovakia,SVK,Netherlands,NLD,0,0,126,104,230
2002,Syrian Arab Rep.,SYR,Netherlands,NLD,19,47,455,56,577
2002,United Rep. of Tanzania,TZA,Netherlands,NLD,0,5,13,0,18
2002,Tajikistan,TJK,Netherlands,NLD,0,0,12,5,17
2002,Togo,TGO,Netherlands,NLD,5,16,569,45,635
2002,Tunisia,TUN,Netherlands,NLD,0,0,5,5,10
2002,Turkey,TUR,Netherlands,NLD,10,44,767,178,999
2002,Uganda,UGA,Netherlands,NLD,0,5,55,5,65
2002,Ukraine,UKR,Netherlands,NLD,0,5,164,37,206
2002,Uzbekistan,UZB,Netherlands,NLD,10,0,93,14,117
2002,Yemen,YEM,Netherlands,NLD,0,0,41,5,46
2002,Zimbabwe,ZWE,Netherlands,NLD,0,0,5,5,10
2002,Stateless,XXA,Netherlands,NLD,11,20,501,81,613
2002,Unknown ,,Netherlands,NLD,5,19,245,52,321
2002,Central African Rep.,CAF,Nigeria,NGA,0,0,5,0,5
2002,Chad,TCD,Nigeria,NGA,0,0,12,0,12
2002,Cameroon,CMR,Nigeria,NGA,5,0,0,0,5
2002,Dem. Rep. of the Congo,COD,Nigeria,NGA,11,0,5,0,16
2002,Ethiopia,ETH,Nigeria,NGA,0,0,5,0,5
2002,Liberia,LBR,Nigeria,NGA,304,0,326,0,630
2002,Rwanda,RWA,Nigeria,NGA,5,0,5,0,10
2002,Sierra Leone,SLE,Nigeria,NGA,48,0,64,0,112
2002,Somalia,SOM,Nigeria,NGA,10,0,0,0,10
2002,Sudan,SDN,Nigeria,NGA,10,0,5,0,15
2002,Afghanistan,AFG,Norway,NOR,16,285,320,217,838
2002,Albania,ALB,Norway,NOR,0,5,242,88,335
2002,Algeria,DZA,Norway,NOR,0,5,168,263,436
2002,Angola,AGO,Norway,NOR,0,5,0,5,10
2002,Egypt,EGY,Norway,NOR,0,5,5,5,15
2002,Argentina,ARG,Norway,NOR,0,0,16,0,16
2002,Armenia,ARM,Norway,NOR,0,5,115,47,167
2002,Azerbaijan,AZE,Norway,NOR,0,5,113,60,178
2002,Burundi,BDI,Norway,NOR,5,17,5,5,32
2002,Bangladesh,BGD,Norway,NOR,0,0,14,0,14
2002,Bhutan,BTN,Norway,NOR,0,0,12,0,12
2002,Belarus,BLR,Norway,NOR,0,0,246,159,405
2002,Bolivia (Plurinational State of),BOL,Norway,NOR,0,0,0,5,5
2002,Brazil,BRA,Norway,NOR,0,0,5,0,5
2002,Bosnia and Herzegovina,BIH,Norway,NOR,0,61,579,470,1110
2002,Bulgaria,BGR,Norway,NOR,0,5,361,149,515
2002,Cambodia,KHM,Norway,NOR,0,5,25,12,42
2002,China,CHN,Norway,NOR,5,5,15,10,35
2002,Chile,CHL,Norway,NOR,0,0,5,5,10
2002,Congo,COG,Norway,NOR,0,5,10,5,20
2002,Dem. Rep. of the Congo,COD,Norway,NOR,5,5,5,5,20
2002,Colombia,COL,Norway,NOR,0,5,14,5,24
2002,Czechia,CZE,Norway,NOR,0,0,230,11,241
2002,Eritrea,ERI,Norway,NOR,5,25,84,10,124
2002,Estonia,EST,Norway,NOR,0,0,24,5,29
2002,Ethiopia,ETH,Norway,NOR,14,53,123,21,211
2002,Gambia,GMB,Norway,NOR,0,0,0,5,5
2002,Georgia,GEO,Norway,NOR,0,5,156,103,264
2002,Guinea,GIN,Norway,NOR,0,0,5,0,5
2002,Croatia,HRV,Norway,NOR,0,20,346,42,408
2002,Hungary,HUN,Norway,NOR,0,0,26,10,36
2002,India,IND,Norway,NOR,0,0,10,5,15
2002,Iran (Islamic Rep. of),IRN,Norway,NOR,40,47,216,131,434
2002,Iraq,IRQ,Norway,NOR,35,585,198,321,1139
2002,Israel,ISR,Norway,NOR,0,0,35,5,40
2002,Jordan,JOR,Norway,NOR,0,0,0,5,5
2002,Kazakhstan,KAZ,Norway,NOR,0,5,107,32,144
2002,Kenya,KEN,Norway,NOR,0,0,10,0,10
2002,Kyrgyzstan,KGZ,Norway,NOR,0,0,92,50,142
2002,Liberia,LBR,Norway,NOR,0,5,5,5,15
2002,Libya,LBY,Norway,NOR,5,29,5,30,69
2002,Lebanon,LBN,Norway,NOR,0,5,13,14,32
2002,Sri Lanka,LKA,Norway,NOR,0,37,128,35,200
2002,Lithuania,LTU,Norway,NOR,0,0,49,24,73
2002,Latvia,LVA,Norway,NOR,0,0,48,25,73
2002,"China, Macao SAR",MAC,Norway,NOR,0,10,254,86,350
2002,Rep. of Moldova,MDA,Norway,NOR,0,0,70,25,95
2002,Mongolia,MNG,Norway,NOR,0,0,479,143,622
2002,Morocco,MAR,Norway,NOR,0,0,5,17,22
2002,Myanmar,MMR,Norway,NOR,0,5,0,5,10
2002,Nepal,NPL,Norway,NOR,0,0,78,20,98
2002,Niger,NER,Norway,NOR,0,5,32,13,50
2002,Nigeria,NGA,Norway,NOR,0,0,5,5,10
2002,Pakistan,PAK,Norway,NOR,11,15,151,24,201
2002,Peru,PER,Norway,NOR,0,0,5,0,5
2002,Poland,POL,Norway,NOR,0,0,50,11,61
2002,Romania,ROU,Norway,NOR,0,5,248,39,292
2002,Russian Federation,RUS,Norway,NOR,69,161,663,630,1523
2002,Rwanda,RWA,Norway,NOR,5,5,10,5,25
2002,El Salvador,SLV,Norway,NOR,0,0,0,5,5
2002,Serbia and Kosovo: S/RES/1244 (1999),SRB,Norway,NOR,88,413,1010,844,2355
2002,Sierra Leone,SLE,Norway,NOR,0,5,45,10,60
2002,Somalia,SOM,Norway,NOR,18,968,136,176,1298
2002,Viet Nam,VNM,Norway,NOR,0,0,0,21,21
2002,Sudan,SDN,Norway,NOR,0,10,35,10,55
2002,Slovakia,SVK,Norway,NOR,0,0,297,47,344
2002,Slovenia,SVN,Norway,NOR,0,0,5,0,5
2002,Syrian Arab Rep.,SYR,Norway,NOR,0,10,25,21,56
2002,Tajikistan,TJK,Norway,NOR,0,0,21,5,26
2002,Tunisia,TUN,Norway,NOR,0,0,0,10,10
2002,Turkey,TUR,Norway,NOR,0,5,137,68,210
2002,Ukraine,UKR,Norway,NOR,0,5,951,710,1666
2002,Uzbekistan,UZB,Norway,NOR,0,5,93,69,167
2002,Stateless,XXA,Norway,NOR,5,81,55,72,213
2002,Afghanistan,AFG,New Zealand,NZL,22,0,26,0,48
2002,Albania,ALB,New Zealand,NZL,0,0,10,0,10
2002,Algeria,DZA,New Zealand,NZL,5,0,10,0,15
2002,Egypt,EGY,New Zealand,NZL,0,0,5,0,5
2002,Argentina,ARG,New Zealand,NZL,0,0,10,0,10
2002,Bangladesh,BGD,New Zealand,NZL,0,0,43,0,43
2002,Bolivia (Plurinational State of),BOL,New Zealand,NZL,0,0,5,0,5
2002,Bulgaria,BGR,New Zealand,NZL,0,0,11,0,11
2002,Cambodia,KHM,New Zealand,NZL,0,0,5,0,5
2002,China,CHN,New Zealand,NZL,15,0,55,0,70
2002,Chile,CHL,New Zealand,NZL,0,0,29,0,29
2002,Dem. Rep. of the Congo,COD,New Zealand,NZL,0,0,31,0,31
2002,Colombia,COL,New Zealand,NZL,16,0,15,0,31
2002,Czechia,CZE,New Zealand,NZL,5,0,119,0,124
2002,Ethiopia,ETH,New Zealand,NZL,5,0,5,0,10
2002,Fiji,FJI,New Zealand,NZL,0,0,32,0,32
2002,Palestinian,PSE,New Zealand,NZL,0,0,5,0,5
2002,Ghana,GHA,New Zealand,NZL,0,0,5,0,5
2002,Croatia,HRV,New Zealand,NZL,0,0,5,0,5
2002,Hungary,HUN,New Zealand,NZL,0,0,29,0,29
2002,India,IND,New Zealand,NZL,0,0,118,0,118
2002,Indonesia,IDN,New Zealand,NZL,0,0,22,0,22
2002,Iran (Islamic Rep. of),IRN,New Zealand,NZL,146,0,80,0,226
2002,Iraq,IRQ,New Zealand,NZL,66,0,24,0,90
2002,Israel,ISR,New Zealand,NZL,0,0,5,0,5
2002,Jordan,JOR,New Zealand,NZL,0,0,18,0,18
2002,Rep. of Korea,KOR,New Zealand,NZL,0,0,15,0,15
2002,Kuwait,KWT,New Zealand,NZL,22,0,5,0,27
2002,Lao People's Dem. Rep.,LAO,New Zealand,NZL,5,0,5,0,10
2002,Liberia,LBR,New Zealand,NZL,5,0,5,0,10
2002,Lebanon,LBN,New Zealand,NZL,5,0,5,0,10
2002,Sri Lanka,LKA,New Zealand,NZL,52,0,101,0,153
2002,Lithuania,LTU,New Zealand,NZL,0,0,5,0,5
2002,Latvia,LVA,New Zealand,NZL,0,0,5,0,5
2002,Madagascar,MDG,New Zealand,NZL,5,0,0,0,5
2002,North Macedonia,MKD,New Zealand,NZL,0,0,5,0,5
2002,Mali,MLI,New Zealand,NZL,0,0,5,0,5
2002,Malaysia,MYS,New Zealand,NZL,0,0,22,0,22
2002,Myanmar,MMR,New Zealand,NZL,5,0,5,0,10
2002,Nepal,NPL,New Zealand,NZL,0,0,30,0,30
2002,Nigeria,NGA,New Zealand,NZL,0,0,21,0,21
2002,Oman,OMN,New Zealand,NZL,0,0,5,0,5
2002,Pakistan,PAK,New Zealand,NZL,0,0,53,0,53
2002,Peru,PER,New Zealand,NZL,0,0,5,0,5
2002,Philippines,PHL,New Zealand,NZL,0,0,5,0,5
2002,Romania,ROU,New Zealand,NZL,0,0,5,0,5
2002,South Africa,ZAF,New Zealand,NZL,0,0,18,0,18
2002,Russian Federation,RUS,New Zealand,NZL,0,0,5,0,5
2002,Saudi Arabia,SAU,New Zealand,NZL,0,0,5,0,5
2002,Serbia and Kosovo: S/RES/1244 (1999),SRB,New Zealand,NZL,0,0,12,0,12
2002,Sierra Leone,SLE,New Zealand,NZL,0,0,10,0,10
2002,Somalia,SOM,New Zealand,NZL,17,0,5,0,22
2002,Viet Nam,VNM,New Zealand,NZL,5,0,10,0,15
2002,Sudan,SDN,New Zealand,NZL,5,0,5,0,10
2002,Slovakia,SVK,New Zealand,NZL,0,0,5,0,5
2002,Syrian Arab Rep.,SYR,New Zealand,NZL,5,0,5,0,10
2002,Thailand,THA,New Zealand,NZL,0,0,391,0,391
2002,Tonga,TON,New Zealand,NZL,0,0,29,0,29
2002,Turkey,TUR,New Zealand,NZL,5,0,11,0,16
2002,Uganda,UGA,New Zealand,NZL,0,0,5,0,5
2002,Ukraine,UKR,New Zealand,NZL,0,0,5,0,5
2002,Uzbekistan,UZB,New Zealand,NZL,0,0,5,0,5
2002,Zimbabwe,ZWE,New Zealand,NZL,20,0,74,0,94
2002,Colombia,COL,Panama,PAN,54,0,28,5,87
2002,Cuba,CUB,Panama,PAN,5,0,0,0,5
2002,Colombia,COL,Peru,PER,5,0,5,0,10
2002,Cuba,CUB,Peru,PER,5,0,0,0,5
2002,Palestinian,PSE,Philippines,PHL,5,0,0,0,5
2002,Iran (Islamic Rep. of),IRN,Philippines,PHL,5,0,0,0,5
2002,Dem. People's Rep. of Korea,PRK,Philippines,PHL,0,0,0,73,73
2002,Liberia,LBR,Philippines,PHL,0,0,0,5,5
2002,Afghanistan,AFG,Poland,POL,0,0,714,5,719
2002,Algeria,DZA,Poland,POL,0,0,19,0,19
2002,Armenia,ARM,Poland,POL,0,0,531,10,541
2002,Azerbaijan,AZE,Poland,POL,0,0,84,10,94
2002,Bangladesh,BGD,Poland,POL,0,0,12,0,12
2002,Belarus,BLR,Poland,POL,10,0,67,5,82
2002,Bulgaria,BGR,Poland,POL,0,0,26,0,26
2002,China,CHN,Poland,POL,0,0,39,0,39
2002,Cameroon,CMR,Poland,POL,0,0,5,0,5
2002,Congo,COG,Poland,POL,5,0,5,0,10
2002,Dem. Rep. of the Congo,COD,Poland,POL,0,0,5,0,5
2002,Cuba,CUB,Poland,POL,0,0,0,5,5
2002,Eritrea,ERI,Poland,POL,0,0,5,0,5
2002,Palestinian,PSE,Poland,POL,0,0,5,0,5
2002,Georgia,GEO,Poland,POL,0,0,87,11,98
2002,Guinea-Bissau,GNB,Poland,POL,0,0,5,0,5
2002,Guinea,GIN,Poland,POL,0,0,5,0,5
2002,India,IND,Poland,POL,0,0,186,0,186
2002,Iran (Islamic Rep. of),IRN,Poland,POL,0,0,5,0,5
2002,Iraq,IRQ,Poland,POL,0,0,55,0,55
2002,Kazakhstan,KAZ,Poland,POL,0,0,14,0,14
2002,Liberia,LBR,Poland,POL,5,0,0,0,5
2002,Lebanon,LBN,Poland,POL,0,0,5,0,5
2002,Sri Lanka,LKA,Poland,POL,5,0,42,0,47
2002,Latvia,LVA,Poland,POL,0,0,5,0,5
2002,North Macedonia,MKD,Poland,POL,0,0,10,0,10
2002,Rep. of Moldova,MDA,Poland,POL,0,0,198,24,222
2002,Mongolia,MNG,Poland,POL,0,0,177,0,177
2002,Morocco,MAR,Poland,POL,0,0,5,0,5
2002,Nigeria,NGA,Poland,POL,0,0,34,0,34
2002,Pakistan,PAK,Poland,POL,0,0,55,0,55
2002,Romania,ROU,Poland,POL,0,0,48,0,48
2002,Russian Federation,RUS,Poland,POL,206,0,1888,384,2478
2002,Senegal,SEN,Poland,POL,0,0,5,0,5
2002,Somalia,SOM,Poland,POL,5,0,5,0,10
2002,Viet Nam,VNM,Poland,POL,0,0,105,5,110
2002,Sudan,SDN,Poland,POL,0,0,11,0,11
2002,Slovakia,SVK,Poland,POL,0,0,0,5,5
2002,Syrian Arab Rep.,SYR,Poland,POL,0,0,12,0,12
2002,Tajikistan,TJK,Poland,POL,0,0,5,0,5
2002,Turkey,TUR,Poland,POL,0,0,10,0,10
2002,Ukraine,UKR,Poland,POL,0,0,131,5,136
2002,Uzbekistan,UZB,Poland,POL,0,0,13,0,13
2002,Stateless,XXA,Poland,POL,0,0,14,0,14
2002,Unknown ,,Poland,POL,0,0,5,0,5
2002,Afghanistan,AFG,Portugal,PRT,0,0,5,14,19
2002,Angola,AGO,Portugal,PRT,0,0,27,0,27
2002,Belarus,BLR,Portugal,PRT,0,5,0,0,5
2002,Dem. Rep. of the Congo,COD,Portugal,PRT,0,0,5,0,5
2002,Cuba,CUB,Portugal,PRT,5,0,5,0,10
2002,Guinea-Bissau,GNB,Portugal,PRT,0,0,5,0,5
2002,Iran (Islamic Rep. of),IRN,Portugal,PRT,0,0,5,0,5
2002,Kazakhstan,KAZ,Portugal,PRT,5,0,5,0,10
2002,Sri Lanka,LKA,Portugal,PRT,0,0,5,0,5
2002,Mongolia,MNG,Portugal,PRT,0,5,0,0,5
2002,Poland,POL,Portugal,PRT,0,0,10,0,10
2002,Romania,ROU,Portugal,PRT,0,0,5,0,5
2002,Russian Federation,RUS,Portugal,PRT,0,0,5,0,5
2002,Serbia and Kosovo: S/RES/1244 (1999),SRB,Portugal,PRT,0,0,0,5,5
2002,Sierra Leone,SLE,Portugal,PRT,0,5,32,0,37
2002,Zimbabwe,ZWE,Portugal,PRT,0,0,5,0,5
2002,Afghanistan,AFG,Romania,ROU,0,0,39,0,39
2002,Egypt,EGY,Romania,ROU,0,0,5,0,5
2002,Bangladesh,BGD,Romania,ROU,0,0,72,0,72
2002,Bosnia and Herzegovina,BIH,Romania,ROU,0,0,5,0,5
2002,China,CHN,Romania,ROU,0,0,89,5,94
2002,Cameroon,CMR,Romania,ROU,0,0,5,0,5
2002,Congo,COG,Romania,ROU,0,0,10,0,10
2002,Eritrea,ERI,Romania,ROU,0,0,5,0,5
2002,Palestinian,PSE,Romania,ROU,0,0,24,0,24
2002,Georgia,GEO,Romania,ROU,0,0,5,5,10
2002,India,IND,Romania,ROU,0,0,149,10,159
2002,Iran (Islamic Rep. of),IRN,Romania,ROU,0,0,33,5,38
2002,Iraq,IRQ,Romania,ROU,19,5,301,5,330
2002,Jordan,JOR,Romania,ROU,0,0,10,0,10
2002,Lebanon,LBN,Romania,ROU,0,0,5,5,10
2002,Sri Lanka,LKA,Romania,ROU,0,0,0,5,5
2002,Rep. of Moldova,MDA,Romania,ROU,0,0,5,0,5
2002,Nigeria,NGA,Romania,ROU,0,0,10,0,10
2002,Pakistan,PAK,Romania,ROU,0,0,28,5,33
2002,Russian Federation,RUS,Romania,ROU,0,0,5,0,5
2002,Serbia and Kosovo: S/RES/1244 (1999),SRB,Romania,ROU,5,0,0,0,5
2002,Sierra Leone,SLE,Romania,ROU,0,0,5,0,5
2002,Somalia,SOM,Romania,ROU,5,0,30,0,35
2002,Sudan,SDN,Romania,ROU,0,0,44,0,44
2002,Syrian Arab Rep.,SYR,Romania,ROU,0,0,24,5,29
2002,Turkey,TUR,Romania,ROU,0,0,29,10,39
2002,Afghanistan,AFG,South Africa,ZAF,5,0,0,0,5
2002,Angola,AGO,South Africa,ZAF,542,0,14,0,556
2002,Egypt,EGY,South Africa,ZAF,0,0,10,5,15
2002,Burundi,BDI,South Africa,ZAF,280,0,14,39,333
2002,Bangladesh,BGD,South Africa,ZAF,0,0,5,18,23
2002,Bulgaria,BGR,South Africa,ZAF,0,0,0,5,5
2002,China,CHN,South Africa,ZAF,0,0,0,13,13
2002,Cameroon,CMR,South Africa,ZAF,27,0,11,15,53
2002,Congo,COG,South Africa,ZAF,116,0,12,17,145
2002,Dem. Rep. of the Congo,COD,South Africa,ZAF,2261,0,69,40,2370
2002,Eritrea,ERI,South Africa,ZAF,0,0,5,5,10
2002,Ethiopia,ETH,South Africa,ZAF,15,0,35,67,117
2002,Ghana,GHA,South Africa,ZAF,0,0,12,44,56
2002,Cote d'Ivoire,CIV,South Africa,ZAF,5,0,5,0,10
2002,India,IND,South Africa,ZAF,0,0,5,25,30
2002,Iraq,IRQ,South Africa,ZAF,5,0,0,0,5
2002,Kenya,KEN,South Africa,ZAF,10,0,42,38,90
2002,Kyrgyzstan,KGZ,South Africa,ZAF,11,0,0,0,11
2002,Liberia,LBR,South Africa,ZAF,29,0,5,5,39
2002,Sri Lanka,LKA,South Africa,ZAF,5,0,0,0,5
2002,Mali,MLI,South Africa,ZAF,0,0,0,11,11
2002,Malawi,MWI,South Africa,ZAF,0,0,32,11,43
2002,Nigeria,NGA,South Africa,ZAF,13,0,39,69,121
2002,Pakistan,PAK,South Africa,ZAF,17,0,59,93,169
2002,Rwanda,RWA,South Africa,ZAF,176,0,10,0,186
2002,Serbia and Kosovo: S/RES/1244 (1999),SRB,South Africa,ZAF,0,0,0,5,5
2002,Senegal,SEN,South Africa,ZAF,5,0,5,5,15
2002,Sierra Leone,SLE,South Africa,ZAF,11,0,10,0,21
2002,Somalia,SOM,South Africa,ZAF,1186,0,75,28,1289
2002,Sudan,SDN,South Africa,ZAF,32,0,0,0,32
2002,United Rep. of Tanzania,TZA,South Africa,ZAF,5,0,19,68,92
2002,Uganda,UGA,South Africa,ZAF,26,0,41,38,105
2002,Zambia,ZMB,South Africa,ZAF,5,0,5,5,15
2002,Zimbabwe,ZWE,South Africa,ZAF,0,0,5,0,5
2002,Unknown ,,South Africa,ZAF,0,0,1134,705,1839
2002,Afghanistan,AFG,Russian Federation,RUS,44,0,702,0,746
2002,Angola,AGO,Russian Federation,RUS,0,0,5,0,5
2002,Dem. Rep. of the Congo,COD,Russian Federation,RUS,0,0,5,0,5
2002,Ethiopia,ETH,Russian Federation,RUS,0,0,5,0,5
2002,United Kingdom of Great Britain and Northern Ireland,GBR,Russian Federation,RUS,0,0,10,0,10
2002,Georgia,GEO,Russian Federation,RUS,5,0,21,0,26
2002,Iraq,IRQ,Russian Federation,RUS,0,0,48,0,48
2002,Kazakhstan,KAZ,Russian Federation,RUS,0,0,15,0,15
2002,Kyrgyzstan,KGZ,Russian Federation,RUS,0,0,5,0,5
2002,Rep. of Moldova,MDA,Russian Federation,RUS,0,0,19,0,19
2002,Somalia,SOM,Russian Federation,RUS,0,0,5,0,5
2002,Sudan,SDN,Russian Federation,RUS,0,0,5,0,5
2002,Tajikistan,TJK,Russian Federation,RUS,0,0,12,0,12
2002,Turkmenistan,TKM,Russian Federation,RUS,0,0,5,0,5
2002,Uzbekistan,UZB,Russian Federation,RUS,0,0,35,0,35
2002,Unknown ,,Russian Federation,RUS,0,0,51,0,51
2002,Colombia,COL,El Salvador,SLV,5,0,0,0,5
2002,Benin,BEN,Senegal,SEN,0,0,0,5,5
2002,Central African Rep.,CAF,Senegal,SEN,5,0,15,5,25
2002,Chad,TCD,Senegal,SEN,0,0,5,0,5
2002,Congo,COG,Senegal,SEN,0,0,10,0,10
2002,Dem. Rep. of the Congo,COD,Senegal,SEN,0,0,19,0,19
2002,Gambia,GMB,Senegal,SEN,0,0,5,0,5
2002,Guinea-Bissau,GNB,Senegal,SEN,0,0,5,529,534
2002,Guinea,GIN,Senegal,SEN,0,0,5,0,5
2002,India,IND,Senegal,SEN,0,0,0,10,10
2002,Liberia,LBR,Senegal,SEN,13,0,24,0,37
2002,Mauritania,MRT,Senegal,SEN,0,0,0,297,297
2002,Mali,MLI,Senegal,SEN,0,0,0,5,5
2002,Nigeria,NGA,Senegal,SEN,0,0,23,78,101
2002,Pakistan,PAK,Senegal,SEN,0,0,0,5,5
2002,Rwanda,RWA,Senegal,SEN,0,0,30,0,30
2002,Sierra Leone,SLE,Senegal,SEN,5,0,84,0,89
2002,Somalia,SOM,Senegal,SEN,0,0,5,0,5
2002,Sudan,SDN,Senegal,SEN,0,0,0,5,5
2002,Togo,TGO,Senegal,SEN,0,0,5,0,5
2002,Afghanistan,AFG,Spain,ESP,0,0,28,10,38
2002,Albania,ALB,Spain,ESP,0,0,10,21,31
2002,Algeria,DZA,Spain,ESP,0,10,25,260,295
2002,Angola,AGO,Spain,ESP,0,0,44,63,107
2002,Argentina,ARG,Spain,ESP,0,0,0,10,10
2002,Armenia,ARM,Spain,ESP,5,11,36,40,92
2002,Azerbaijan,AZE,Spain,ESP,5,0,10,5,20
2002,Burundi,BDI,Spain,ESP,0,0,5,0,5
2002,Benin,BEN,Spain,ESP,0,0,0,5,5
2002,Bangladesh,BGD,Spain,ESP,0,0,5,10,15
2002,Belarus,BLR,Spain,ESP,0,0,0,11,11
2002,Bolivia (Plurinational State of),BOL,Spain,ESP,0,0,0,5,5
2002,Bosnia and Herzegovina,BIH,Spain,ESP,0,0,17,16,33
2002,China,CHN,Spain,ESP,0,0,5,5,10
2002,Cameroon,CMR,Spain,ESP,0,0,5,16,21
2002,Congo,COG,Spain,ESP,0,0,15,13,28
2002,Dem. Rep. of the Congo,COD,Spain,ESP,10,0,71,126,207
2002,Colombia,COL,Spain,ESP,41,5,306,742,1094
2002,Cuba,CUB,Spain,ESP,11,0,57,1132,1200
2002,Czechia,CZE,Spain,ESP,0,0,5,5,10
2002,Ecuador,ECU,Spain,ESP,0,0,5,38,43
2002,Equatorial Guinea,GNQ,Spain,ESP,17,10,26,10,63
2002,Ethiopia,ETH,Spain,ESP,10,0,39,10,59
2002,Gambia,GMB,Spain,ESP,0,0,0,5,5
2002,Georgia,GEO,Spain,ESP,0,0,19,48,67
2002,Ghana,GHA,Spain,ESP,0,0,0,30,30
2002,Guinea-Bissau,GNB,Spain,ESP,0,0,0,5,5
2002,Guatemala,GTM,Spain,ESP,0,0,5,0,5
2002,Guinea,GIN,Spain,ESP,0,0,10,26,36
2002,Haiti,HTI,Spain,ESP,5,0,0,0,5
2002,Cote d'Ivoire,CIV,Spain,ESP,0,0,0,16,16
2002,India,IND,Spain,ESP,0,0,5,5,10
2002,Iran (Islamic Rep. of),IRN,Spain,ESP,5,0,14,5,24
2002,Iraq,IRQ,Spain,ESP,0,5,32,37,74
2002,Kazakhstan,KAZ,Spain,ESP,0,0,38,0,38
2002,Liberia,LBR,Spain,ESP,0,0,5,21,26
2002,Lebanon,LBN,Spain,ESP,0,0,0,11,11
2002,Sri Lanka,LKA,Spain,ESP,0,0,0,10,10
2002,Lithuania,LTU,Spain,ESP,0,0,5,0,5
2002,Latvia,LVA,Spain,ESP,5,0,5,5,15
2002,Mauritania,MRT,Spain,ESP,0,0,0,10,10
2002,North Macedonia,MKD,Spain,ESP,0,0,0,15,15
2002,Rep. of Moldova,MDA,Spain,ESP,5,0,30,14,49
2002,Mali,MLI,Spain,ESP,0,0,0,21,21
2002,Morocco,MAR,Spain,ESP,0,0,5,30,35
2002,Myanmar,MMR,Spain,ESP,0,0,5,0,5
2002,Niger,NER,Spain,ESP,0,0,0,5,5
2002,Nigeria,NGA,Spain,ESP,0,5,73,1224,1302
2002,Pakistan,PAK,Spain,ESP,0,0,5,15,20
2002,Peru,PER,Spain,ESP,0,0,5,10,15
2002,Romania,ROU,Spain,ESP,0,0,5,168,173
2002,Russian Federation,RUS,Spain,ESP,23,19,111,101,254
2002,Rwanda,RWA,Spain,ESP,0,0,10,5,15
2002,Serbia and Kosovo: S/RES/1244 (1999),SRB,Spain,ESP,5,5,21,22,53
2002,Senegal,SEN,Spain,ESP,0,0,0,5,5
2002,Sierra Leone,SLE,Spain,ESP,0,0,77,290,367
2002,Somalia,SOM,Spain,ESP,0,0,18,5,23
2002,Sudan,SDN,Spain,ESP,0,0,5,49,54
2002,Slovakia,SVK,Spain,ESP,0,0,5,0,5
2002,Syrian Arab Rep.,SYR,Spain,ESP,0,0,0,5,5
2002,Togo,TGO,Spain,ESP,0,0,5,5,10
2002,Tunisia,TUN,Spain,ESP,5,0,0,5,10
2002,Turkey,TUR,Spain,ESP,0,0,10,15,25
2002,Ukraine,UKR,Spain,ESP,5,0,150,71,226
2002,Uzbekistan,UZB,Spain,ESP,0,0,0,5,5
2002,Stateless,XXA,Spain,ESP,0,0,0,31,31
2002,Afghanistan,AFG,Slovakia,SVK,5,0,31,2681,2717
2002,Algeria,DZA,Slovakia,SVK,0,0,0,30,30
2002,Angola,AGO,Slovakia,SVK,0,0,5,0,5
2002,Egypt,EGY,Slovakia,SVK,0,0,0,5,5
2002,Armenia,ARM,Slovakia,SVK,0,0,5,13,18
2002,Azerbaijan,AZE,Slovakia,SVK,0,0,0,5,5
2002,Bangladesh,BGD,Slovakia,SVK,0,0,46,483,529
2002,Belarus,BLR,Slovakia,SVK,0,0,0,5,5
2002,China,CHN,Slovakia,SVK,0,0,5,861,866
2002,Cameroon,CMR,Slovakia,SVK,0,0,0,5,5
2002,Congo,COG,Slovakia,SVK,0,0,0,5,5
2002,Eritrea,ERI,Slovakia,SVK,0,0,0,5,5
2002,Ethiopia,ETH,Slovakia,SVK,0,0,0,10,10
2002,Georgia,GEO,Slovakia,SVK,0,0,5,36,41
2002,Ghana,GHA,Slovakia,SVK,0,0,0,16,16
2002,India,IND,Slovakia,SVK,0,0,42,1105,1147
2002,Iran (Islamic Rep. of),IRN,Slovakia,SVK,0,0,0,82,82
2002,Iraq,IRQ,Slovakia,SVK,0,0,12,1228,1240
2002,Sri Lanka,LKA,Slovakia,SVK,0,0,5,59,64
2002,North Macedonia,MKD,Slovakia,SVK,0,0,5,11,16
2002,Rep. of Moldova,MDA,Slovakia,SVK,0,0,17,197,214
2002,Morocco,MAR,Slovakia,SVK,0,0,0,5,5
2002,Nepal,NPL,Slovakia,SVK,0,0,0,64,64
2002,Nigeria,NGA,Slovakia,SVK,0,0,0,57,57
2002,Pakistan,PAK,Slovakia,SVK,0,0,11,145,156
2002,Russian Federation,RUS,Slovakia,SVK,0,0,56,270,326
2002,Serbia and Kosovo: S/RES/1244 (1999),SRB,Slovakia,SVK,5,0,12,17,34
2002,Senegal,SEN,Slovakia,SVK,0,0,10,0,10
2002,Sierra Leone,SLE,Slovakia,SVK,0,0,5,88,93
2002,Somalia,SOM,Slovakia,SVK,0,0,0,220,220
2002,Viet Nam,VNM,Slovakia,SVK,0,0,0,145,145
2002,Sudan,SDN,Slovakia,SVK,0,0,0,49,49
2002,Syrian Arab Rep.,SYR,Slovakia,SVK,0,0,0,17,17
2002,Turkey,TUR,Slovakia,SVK,0,0,0,34,34
2002,Ukraine,UKR,Slovakia,SVK,0,0,10,12,22
2002,Uzbekistan,UZB,Slovakia,SVK,5,0,0,5,10
2002,Stateless,XXA,Slovakia,SVK,0,0,0,5,5
2002,Unknown ,,Slovakia,SVK,0,0,0,51,51
2002,Afghanistan,AFG,Slovenia,SVN,0,0,5,12,17
2002,Algeria,DZA,Slovenia,SVN,0,0,10,59,69
2002,Armenia,ARM,Slovenia,SVN,0,0,5,0,5
2002,Bangladesh,BGD,Slovenia,SVN,0,0,0,10,10
2002,Bosnia and Herzegovina,BIH,Slovenia,SVN,0,0,5,15,20
2002,Bulgaria,BGR,Slovenia,SVN,0,0,0,5,5
2002,China,CHN,Slovenia,SVN,0,0,5,5,10
2002,Georgia,GEO,Slovenia,SVN,0,0,0,10,10
2002,India,IND,Slovenia,SVN,0,0,0,5,5
2002,Iran (Islamic Rep. of),IRN,Slovenia,SVN,0,0,48,95,143
2002,Iraq,IRQ,Slovenia,SVN,0,0,28,94,122
2002,North Macedonia,MKD,Slovenia,SVN,0,0,25,15,40
2002,Rep. of Moldova,MDA,Slovenia,SVN,0,0,5,10,15
2002,Morocco,MAR,Slovenia,SVN,0,0,0,5,5
2002,Nigeria,NGA,Slovenia,SVN,0,0,0,10,10
2002,Pakistan,PAK,Slovenia,SVN,0,0,5,22,27
2002,Russian Federation,RUS,Slovenia,SVN,0,0,0,17,17
2002,Serbia and Kosovo: S/RES/1244 (1999),SRB,Slovenia,SVN,0,0,43,72,115
2002,Sierra Leone,SLE,Slovenia,SVN,0,0,5,14,19
2002,Somalia,SOM,Slovenia,SVN,0,0,0,10,10
2002,Sudan,SDN,Slovenia,SVN,0,0,5,0,5
2002,Tunisia,TUN,Slovenia,SVN,0,0,0,5,5
2002,Turkey,TUR,Slovenia,SVN,0,0,0,104,104
2002,Ukraine,UKR,Slovenia,SVN,0,0,0,5,5
2002,Afghanistan,AFG,Sweden,SWE,5,338,109,24,476
2002,Albania,ALB,Sweden,SWE,0,11,161,23,195
2002,Algeria,DZA,Sweden,SWE,0,5,142,48,195
2002,Angola,AGO,Sweden,SWE,0,22,5,0,27
2002,Egypt,EGY,Sweden,SWE,0,10,86,5,101
2002,Argentina,ARG,Sweden,SWE,0,0,10,0,10
2002,Armenia,ARM,Sweden,SWE,0,24,202,30,256
2002,Azerbaijan,AZE,Sweden,SWE,5,12,153,25,195
2002,Burundi,BDI,Sweden,SWE,0,79,0,0,79
2002,Bangladesh,BGD,Sweden,SWE,0,15,172,10,197
2002,Belarus,BLR,Sweden,SWE,0,0,239,103,342
2002,Bolivia (Plurinational State of),BOL,Sweden,SWE,0,0,101,12,113
2002,Brazil,BRA,Sweden,SWE,0,0,5,0,5
2002,Bosnia and Herzegovina,BIH,Sweden,SWE,0,108,3077,408,3593
2002,Bulgaria,BGR,Sweden,SWE,0,0,623,68,691
2002,Cambodia,KHM,Sweden,SWE,0,0,12,0,12
2002,China,CHN,Sweden,SWE,5,0,38,5,48
2002,Chile,CHL,Sweden,SWE,0,0,13,10,23
2002,Cameroon,CMR,Sweden,SWE,5,0,0,0,5
2002,Congo,COG,Sweden,SWE,0,5,5,0,10
2002,Dem. Rep. of the Congo,COD,Sweden,SWE,5,15,52,0,72
2002,Colombia,COL,Sweden,SWE,5,10,42,12,69
2002,Cuba,CUB,Sweden,SWE,0,5,22,5,32
2002,Czechia,CZE,Sweden,SWE,0,0,146,29,175
2002,Ecuador,ECU,Sweden,SWE,0,5,149,11,165
2002,Eritrea,ERI,Sweden,SWE,5,21,110,5,141
2002,Estonia,EST,Sweden,SWE,0,0,10,5,15
2002,Ethiopia,ETH,Sweden,SWE,0,0,83,5,88
2002,Gambia,GMB,Sweden,SWE,0,0,21,5,26
2002,Georgia,GEO,Sweden,SWE,0,0,176,55,231
2002,Germany,DEU,Sweden,SWE,0,0,5,0,5
2002,Ghana,GHA,Sweden,SWE,0,0,5,5,10
2002,Guinea,GIN,Sweden,SWE,0,0,56,5,61
2002,Honduras,HND,Sweden,SWE,0,0,5,0,5
2002,Croatia,HRV,Sweden,SWE,0,12,444,73,529
2002,Hungary,HUN,Sweden,SWE,0,0,14,0,14
2002,Cote d'Ivoire,CIV,Sweden,SWE,5,0,10,0,15
2002,India,IND,Sweden,SWE,0,0,41,5,46
2002,Iran (Islamic Rep. of),IRN,Sweden,SWE,44,68,631,88,831
2002,Iraq,IRQ,Sweden,SWE,93,2959,1698,296,5046
2002,Israel,ISR,Sweden,SWE,0,0,55,5,60
2002,Jordan,JOR,Sweden,SWE,0,0,59,5,64
2002,Kenya,KEN,Sweden,SWE,0,0,5,0,5
2002,Kyrgyzstan,KGZ,Sweden,SWE,0,22,156,17,195
2002,Liberia,LBR,Sweden,SWE,0,5,5,5,15
2002,Libya,LBY,Sweden,SWE,0,5,109,41,155
2002,Lebanon,LBN,Sweden,SWE,0,5,160,35,200
2002,Sri Lanka,LKA,Sweden,SWE,0,0,31,10,41
2002,Lithuania,LTU,Sweden,SWE,0,5,78,16,99
2002,Latvia,LVA,Sweden,SWE,0,0,20,0,20
2002,Mauritania,MRT,Sweden,SWE,0,0,5,0,5
2002,North Macedonia,MKD,Sweden,SWE,0,10,456,41,507
2002,Rep. of Moldova,MDA,Sweden,SWE,0,0,245,49,294
2002,Mongolia,MNG,Sweden,SWE,0,0,351,58,409
2002,Morocco,MAR,Sweden,SWE,0,5,26,5,36
2002,Nepal,NPL,Sweden,SWE,0,0,5,0,5
2002,Niger,NER,Sweden,SWE,0,0,5,0,5
2002,Nigeria,NGA,Sweden,SWE,0,0,42,10,52
2002,Pakistan,PAK,Sweden,SWE,0,5,61,11,77
2002,Peru,PER,Sweden,SWE,0,5,91,10,106
2002,Philippines,PHL,Sweden,SWE,0,5,10,0,15
2002,Poland,POL,Sweden,SWE,0,5,32,0,37
2002,Romania,ROU,Sweden,SWE,0,0,287,154,441
2002,Russian Federation,RUS,Sweden,SWE,5,64,718,145,932
2002,Rwanda,RWA,Sweden,SWE,0,10,0,0,10
2002,El Salvador,SLV,Sweden,SWE,0,0,445,54,499
2002,Serbia and Kosovo: S/RES/1244 (1999),SRB,Sweden,SWE,49,447,3388,593,4477
2002,Sierra Leone,SLE,Sweden,SWE,0,5,24,0,29
2002,Somalia,SOM,Sweden,SWE,5,276,56,30,367
2002,Viet Nam,VNM,Sweden,SWE,0,10,12,12,34
2002,Sudan,SDN,Sweden,SWE,0,5,10,0,15
2002,Slovakia,SVK,Sweden,SWE,0,0,592,167,759
2002,Syrian Arab Rep.,SYR,Sweden,SWE,5,53,429,37,524
2002,United Rep. of Tanzania,TZA,Sweden,SWE,0,0,5,0,5
2002,Thailand,THA,Sweden,SWE,0,0,5,0,5
2002,Tajikistan,TJK,Sweden,SWE,0,0,10,0,10
2002,Turkmenistan,TKM,Sweden,SWE,0,0,10,5,15
2002,Togo,TGO,Sweden,SWE,0,0,5,0,5
2002,Tunisia,TUN,Sweden,SWE,5,5,28,10,48
2002,Turkey,TUR,Sweden,SWE,0,32,401,45,478
2002,Uganda,UGA,Sweden,SWE,0,0,13,0,13
2002,Ukraine,UKR,Sweden,SWE,0,5,440,68,513
2002,United States of America,USA,Sweden,SWE,0,0,5,0,5
2002,Uzbekistan,UZB,Sweden,SWE,5,12,351,48,416
2002,Venezuela (Bolivarian Republic of),VEN,Sweden,SWE,0,0,10,0,10
2002,Yemen,YEM,Sweden,SWE,0,5,10,0,15
2002,Zambia,ZMB,Sweden,SWE,0,0,5,0,5
2002,Zimbabwe,ZWE,Sweden,SWE,0,0,5,0,5
2002,Stateless,XXA,Sweden,SWE,5,122,291,68,486
2002,Unknown ,,Sweden,SWE,0,11,35,5,51
2002,Afghanistan,AFG,Switzerland,CHE,41,13,155,79,288
2002,Albania,ALB,Switzerland,CHE,0,16,35,132,183
2002,Algeria,DZA,Switzerland,CHE,15,19,651,350,1035
2002,Angola,AGO,Switzerland,CHE,0,329,564,95,988
2002,Egypt,EGY,Switzerland,CHE,0,0,5,5,10
2002,Armenia,ARM,Switzerland,CHE,5,23,221,271,520
2002,Azerbaijan,AZE,Switzerland,CHE,0,0,39,53,92
2002,Burundi,BDI,Switzerland,CHE,5,21,22,10,58
2002,Belgium,BEL,Switzerland,CHE,0,0,0,5,5
2002,Benin,BEN,Switzerland,CHE,0,0,59,32,91
2002,Bangladesh,BGD,Switzerland,CHE,0,11,131,119,261
2002,Burkina Faso,BFA,Switzerland,CHE,0,5,44,23,72
2002,Belarus,BLR,Switzerland,CHE,0,0,51,159,210
2002,Bosnia and Herzegovina,BIH,Switzerland,CHE,155,647,778,261,1841
2002,Bulgaria,BGR,Switzerland,CHE,0,0,137,666,803
2002,Cambodia,KHM,Switzerland,CHE,14,0,5,0,19
2002,Chad,TCD,Switzerland,CHE,0,0,14,10,24
2002,China,CHN,Switzerland,CHE,15,0,19,30,64
2002,Cameroon,CMR,Switzerland,CHE,5,5,210,130,350
2002,Congo,COG,Switzerland,CHE,5,0,40,16,61
2002,Dem. Rep. of the Congo,COD,Switzerland,CHE,33,204,577,124,938
2002,Colombia,COL,Switzerland,CHE,12,10,36,17,75
2002,Cuba,CUB,Switzerland,CHE,0,0,5,5,10
2002,Czechia,CZE,Switzerland,CHE,0,0,64,30,94
2002,Ecuador,ECU,Switzerland,CHE,0,0,0,5,5
2002,Eritrea,ERI,Switzerland,CHE,0,20,80,17,117
2002,Estonia,EST,Switzerland,CHE,0,0,0,5,5
2002,Ethiopia,ETH,Switzerland,CHE,5,36,285,36,362
2002,France,FRA,Switzerland,CHE,0,0,10,5,15
2002,Gabon,GAB,Switzerland,CHE,0,0,10,5,15
2002,Gambia,GMB,Switzerland,CHE,0,0,5,24,29
2002,Georgia,GEO,Switzerland,CHE,0,19,297,244,560
2002,Germany,DEU,Switzerland,CHE,0,0,0,5,5
2002,Ghana,GHA,Switzerland,CHE,0,0,5,34,39
2002,Guinea-Bissau,GNB,Switzerland,CHE,0,0,19,52,71
2002,Guinea,GIN,Switzerland,CHE,0,0,435,350,785
2002,Croatia,HRV,Switzerland,CHE,0,0,25,22,47
2002,Hungary,HUN,Switzerland,CHE,0,0,5,0,5
2002,Cote d'Ivoire,CIV,Switzerland,CHE,0,0,57,62,119
2002,India,IND,Switzerland,CHE,0,0,63,97,160
2002,Iran (Islamic Rep. of),IRN,Switzerland,CHE,29,17,271,60,377
2002,Iraq,IRQ,Switzerland,CHE,352,377,697,359,1785
2002,Israel,ISR,Switzerland,CHE,0,0,5,12,17
2002,Jordan,JOR,Switzerland,CHE,0,0,0,5,5
2002,Kazakhstan,KAZ,Switzerland,CHE,5,0,28,22,55
2002,Kenya,KEN,Switzerland,CHE,0,0,14,10,24
2002,Kyrgyzstan,KGZ,Switzerland,CHE,0,0,10,10,20
2002,Liberia,LBR,Switzerland,CHE,0,0,44,50,94
2002,Libya,LBY,Switzerland,CHE,30,0,31,27,88
2002,Lebanon,LBN,Switzerland,CHE,0,5,30,107,142
2002,Sri Lanka,LKA,Switzerland,CHE,90,235,418,132,875
2002,Lithuania,LTU,Switzerland,CHE,0,0,5,96,101
2002,Latvia,LVA,Switzerland,CHE,0,0,5,11,16
2002,Mauritania,MRT,Switzerland,CHE,0,0,23,70,93
2002,North Macedonia,MKD,Switzerland,CHE,5,15,867,414,1301
2002,Rep. of Moldova,MDA,Switzerland,CHE,0,0,20,122,142
2002,Mali,MLI,Switzerland,CHE,0,0,103,58,161
2002,Mongolia,MNG,Switzerland,CHE,0,5,20,203,228
2002,Morocco,MAR,Switzerland,CHE,0,0,5,32,37
2002,Nepal,NPL,Switzerland,CHE,0,0,0,41,41
2002,Niger,NER,Switzerland,CHE,0,0,40,264,304
2002,Nigeria,NGA,Switzerland,CHE,0,5,654,10,669
2002,Pakistan,PAK,Switzerland,CHE,0,14,113,116,243
2002,Peru,PER,Switzerland,CHE,0,0,5,0,5
2002,Poland,POL,Switzerland,CHE,0,0,5,23,28
2002,Romania,ROU,Switzerland,CHE,0,0,17,933,950
2002,South Africa,ZAF,Switzerland,CHE,0,0,10,0,10
2002,Russian Federation,RUS,Switzerland,CHE,0,23,170,233,426
2002,Rwanda,RWA,Switzerland,CHE,31,10,13,5,59
2002,Serbia and Kosovo: S/RES/1244 (1999),SRB,Switzerland,CHE,169,1610,2238,1539,5556
2002,Senegal,SEN,Switzerland,CHE,0,0,5,18,23
2002,Sierra Leone,SLE,Switzerland,CHE,0,5,298,173,476
2002,Somalia,SOM,Switzerland,CHE,24,257,258,56,595
2002,Viet Nam,VNM,Switzerland,CHE,49,5,19,10,83
2002,Sudan,SDN,Switzerland,CHE,0,0,33,13,46
2002,Slovakia,SVK,Switzerland,CHE,0,0,49,20,69
2002,Slovenia,SVN,Switzerland,CHE,0,0,0,19,19
2002,Syrian Arab Rep.,SYR,Switzerland,CHE,27,26,67,63,183
2002,United Rep. of Tanzania,TZA,Switzerland,CHE,0,5,5,5,15
2002,Tajikistan,TJK,Switzerland,CHE,0,0,0,5,5
2002,Togo,TGO,Switzerland,CHE,13,0,101,40,154
2002,Tunisia,TUN,Switzerland,CHE,88,0,42,56,186
2002,Turkey,TUR,Switzerland,CHE,460,146,915,381,1902
2002,Uganda,UGA,Switzerland,CHE,0,0,12,5,17
2002,Ukraine,UKR,Switzerland,CHE,5,0,54,130,189
2002,Uzbekistan,UZB,Switzerland,CHE,0,0,10,10,20
2002,Yemen,YEM,Switzerland,CHE,11,0,54,0,65
2002,Zimbabwe,ZWE,Switzerland,CHE,0,0,5,5,10
2002,Stateless,XXA,Switzerland,CHE,0,0,5,0,5
2002,Unknown ,,Switzerland,CHE,10,14,544,379,947
2002,Rwanda,RWA,United Rep. of Tanzania,TZA,21207,0,0,0,21207
2002,Afghanistan,AFG,Tajikistan,TJK,0,0,0,174,174
2002,Burundi,BDI,Uganda,UGA,100,0,0,33,133
2002,Dem. Rep. of the Congo,COD,Uganda,UGA,1288,0,39,178,1505
2002,Eritrea,ERI,Uganda,UGA,0,0,0,10,10
2002,Ethiopia,ETH,Uganda,UGA,51,0,10,26,87
2002,Kenya,KEN,Uganda,UGA,10,0,0,0,10
2002,Liberia,LBR,Uganda,UGA,0,0,5,0,5
2002,Pakistan,PAK,Uganda,UGA,0,0,0,5,5
2002,Rwanda,RWA,Uganda,UGA,114,0,33,104,251
2002,Somalia,SOM,Uganda,UGA,80,0,5,39,124
2002,Sudan,SDN,Uganda,UGA,144,0,0,24,168
2002,Unknown ,,Ukraine,UKR,0,0,329,0,329
2002,Angola,AGO,Zambia,ZMB,5,0,0,0,5
2002,Burundi,BDI,Zambia,ZMB,18,0,10,182,210
2002,Dem. Rep. of the Congo,COD,Zambia,ZMB,52,0,33,0,85
2002,Rwanda,RWA,Zambia,ZMB,61,0,10,0,71
2002,Somalia,SOM,Zambia,ZMB,5,0,0,0,5
2002,Unknown ,,Zambia,ZMB,5,0,5,0,10
2002,Angola,AGO,Zimbabwe,ZWE,5,0,0,0,5
2002,Burundi,BDI,Zimbabwe,ZWE,57,0,0,0,57
2002,Dem. Rep. of the Congo,COD,Zimbabwe,ZWE,513,0,33,0,546
2002,Eritrea,ERI,Zimbabwe,ZWE,5,0,0,0,5
2002,Ethiopia,ETH,Zimbabwe,ZWE,5,0,0,0,5
2002,Rwanda,RWA,Zimbabwe,ZWE,124,0,5,0,129
2002,Sudan,SDN,Zimbabwe,ZWE,10,0,0,0,10
2003,India,IND,Albania,ALB,0,0,0,5,5
2003,Iraq,IRQ,Albania,ALB,0,5,0,0,5
2003,Serbia and Kosovo: S/RES/1244 (1999),SRB,Albania,ALB,5,0,10,13,28
2003,Turkey,TUR,Albania,ALB,0,0,5,5,10
2003,Dem. Rep. of the Congo,COD,Angola,AGO,5,0,32,0,37
2003,Cote d'Ivoire,CIV,Angola,AGO,0,0,5,0,5
2003,Liberia,LBR,Angola,AGO,5,0,5,0,10
2003,Sierra Leone,SLE,Angola,AGO,0,0,10,0,10
2003,Albania,ALB,Argentina,ARG,0,0,5,5,10
2003,Armenia,ARM,Argentina,ARG,13,0,45,10,68
2003,Bangladesh,BGD,Argentina,ARG,0,0,5,5,10
2003,Colombia,COL,Argentina,ARG,0,0,0,10,10
2003,Cuba,CUB,Argentina,ARG,10,0,5,36,51
2003,Ghana,GHA,Argentina,ARG,0,0,0,5,5
2003,Haiti,HTI,Argentina,ARG,0,0,0,10,10
2003,India,IND,Argentina,ARG,5,0,0,5,10
2003,Sri Lanka,LKA,Argentina,ARG,0,0,0,5,5
2003,Nigeria,NGA,Argentina,ARG,5,0,0,5,10
2003,Peru,PER,Argentina,ARG,18,0,145,105,268
2003,Romania,ROU,Argentina,ARG,0,0,0,28,28
2003,Russian Federation,RUS,Argentina,ARG,5,0,10,5,20
2003,Senegal,SEN,Argentina,ARG,5,0,5,10,20
2003,Sierra Leone,SLE,Argentina,ARG,16,0,0,5,21
2003,Ukraine,UKR,Argentina,ARG,0,0,0,10,10
2003,Unknown ,,Argentina,ARG,0,0,0,5,5
2003,Iraq,IRQ,Armenia,ARM,0,28,10,0,38
2003,Afghanistan,AFG,Australia,AUS,20,0,10,0,30
2003,Albania,ALB,Australia,AUS,0,0,32,5,37
2003,Algeria,DZA,Australia,AUS,0,0,5,0,5
2003,Egypt,EGY,Australia,AUS,5,0,53,0,58
2003,Argentina,ARG,Australia,AUS,0,0,13,0,13
2003,Armenia,ARM,Australia,AUS,0,0,5,0,5
2003,Bahrain,BHR,Australia,AUS,0,0,5,0,5
2003,Burundi,BDI,Australia,AUS,0,0,5,0,5
2003,Bangladesh,BGD,Australia,AUS,0,0,116,5,121
2003,Belarus,BLR,Australia,AUS,0,0,5,0,5
2003,Brazil,BRA,Australia,AUS,0,0,26,0,26
2003,Bulgaria,BGR,Australia,AUS,0,0,5,0,5
2003,Cambodia,KHM,Australia,AUS,0,0,13,0,13
2003,China,CHN,Australia,AUS,17,0,833,28,878
2003,Chile,CHL,Australia,AUS,0,0,5,0,5
2003,Congo,COG,Australia,AUS,0,0,5,0,5
2003,Colombia,COL,Australia,AUS,5,0,17,0,22
2003,Cyprus,CYP,Australia,AUS,0,0,5,0,5
2003,Ecuador,ECU,Australia,AUS,0,0,5,0,5
2003,Ethiopia,ETH,Australia,AUS,5,0,5,0,10
2003,Fiji,FJI,Australia,AUS,0,0,161,10,171
2003,Palestinian,PSE,Australia,AUS,5,0,5,0,10
2003,Germany,DEU,Australia,AUS,0,0,5,0,5
2003,Ghana,GHA,Australia,AUS,0,0,10,0,10
2003,Greece,GRC,Australia,AUS,0,0,5,0,5
2003,Guyana,GUY,Australia,AUS,0,0,5,0,5
2003,"China, Hong Kong SAR",HKG,Australia,AUS,0,0,13,0,13
2003,India,IND,Australia,AUS,0,0,637,5,642
2003,Indonesia,IDN,Australia,AUS,5,0,848,84,937
2003,Iran (Islamic Rep. of),IRN,Australia,AUS,29,0,42,12,83
2003,Iraq,IRQ,Australia,AUS,104,0,5,10,119
2003,Israel,ISR,Australia,AUS,0,0,20,5,25
2003,Italy,ITA,Australia,AUS,0,0,5,0,5
2003,Jordan,JOR,Australia,AUS,0,0,15,0,15
2003,Japan,JPN,Australia,AUS,0,0,5,0,5
2003,Kenya,KEN,Australia,AUS,0,0,20,0,20
2003,Rep. of Korea,KOR,Australia,AUS,0,0,222,15,237
2003,Lao People's Dem. Rep.,LAO,Australia,AUS,0,0,5,0,5
2003,Libya,LBY,Australia,AUS,0,0,5,0,5
2003,Lebanon,LBN,Australia,AUS,0,0,92,5,97
2003,Sri Lanka,LKA,Australia,AUS,18,0,135,10,163
2003,Lithuania,LTU,Australia,AUS,0,0,18,0,18
2003,North Macedonia,MKD,Australia,AUS,0,0,11,0,11
2003,Malaysia,MYS,Australia,AUS,0,0,184,10,194
2003,Mongolia,MNG,Australia,AUS,0,0,13,0,13
2003,Morocco,MAR,Australia,AUS,0,0,5,0,5
2003,Myanmar,MMR,Australia,AUS,5,0,13,10,28
2003,Nepal,NPL,Australia,AUS,0,0,46,0,46
2003,Nigeria,NGA,Australia,AUS,0,0,36,0,36
2003,Norway,NOR,Australia,AUS,0,0,0,5,5
2003,Oman,OMN,Australia,AUS,0,0,5,0,5
2003,Pakistan,PAK,Australia,AUS,5,0,54,0,59
2003,Peru,PER,Australia,AUS,0,0,5,0,5
2003,Philippines,PHL,Australia,AUS,0,0,46,5,51
2003,Papua New Guinea,PNG,Australia,AUS,0,0,5,0,5
2003,Poland,POL,Australia,AUS,0,0,15,0,15
2003,Portugal,PRT,Australia,AUS,0,0,12,5,17
2003,Romania,ROU,Australia,AUS,0,0,11,0,11
2003,South Africa,ZAF,Australia,AUS,5,0,12,0,17
2003,Russian Federation,RUS,Australia,AUS,0,0,35,0,35
2003,El Salvador,SLV,Australia,AUS,0,0,5,0,5
2003,Serbia and Kosovo: S/RES/1244 (1999),SRB,Australia,AUS,0,0,24,0,24
2003,Singapore,SGP,Australia,AUS,0,0,5,0,5
2003,Solomon Islands,SLB,Australia,AUS,0,0,12,0,12
2003,Viet Nam,VNM,Australia,AUS,0,0,100,0,100
2003,Sudan,SDN,Australia,AUS,0,0,10,0,10
2003,Syrian Arab Rep.,SYR,Australia,AUS,0,0,14,0,14
2003,United Rep. of Tanzania,TZA,Australia,AUS,0,0,5,0,5
2003,Thailand,THA,Australia,AUS,0,0,180,5,185
2003,Timor-Leste,TLS,Australia,AUS,0,0,177,19,196
2003,Tonga,TON,Australia,AUS,0,0,60,10,70
2003,Turkey,TUR,Australia,AUS,0,0,43,5,48
2003,Uganda,UGA,Australia,AUS,0,0,5,0,5
2003,Ukraine,UKR,Australia,AUS,0,0,23,0,23
2003,Uruguay,URY,Australia,AUS,0,0,11,5,16
2003,United States of America,USA,Australia,AUS,0,0,5,0,5
2003,Uzbekistan,UZB,Australia,AUS,0,0,5,0,5
2003,Venezuela (Bolivarian Republic of),VEN,Australia,AUS,0,0,5,0,5
2003,Zambia,ZMB,Australia,AUS,0,0,5,0,5
2003,Zimbabwe,ZWE,Australia,AUS,11,0,39,10,60
2003,Stateless,XXA,Australia,AUS,5,0,18,5,28
2003,Dem. Rep. of the Congo,COD,Burundi,BDI,17,0,0,0,17
2003,Afghanistan,AFG,Belgium,BEL,234,0,590,92,916
2003,Albania,ALB,Belgium,BEL,26,0,94,42,162
2003,Algeria,DZA,Belgium,BEL,19,0,201,35,255
2003,Angola,AGO,Belgium,BEL,5,0,45,14,64
2003,Armenia,ARM,Belgium,BEL,5,0,39,5,49
2003,Azerbaijan,AZE,Belgium,BEL,0,0,10,5,15
2003,Burundi,BDI,Belgium,BEL,38,0,26,0,64
2003,Bangladesh,BGD,Belgium,BEL,0,0,21,10,31
2003,Bhutan,BTN,Belgium,BEL,0,0,11,10,21
2003,Bosnia and Herzegovina,BIH,Belgium,BEL,25,0,46,13,84
2003,Bulgaria,BGR,Belgium,BEL,0,0,40,10,50
2003,Central African Rep.,CAF,Belgium,BEL,5,0,0,0,5
2003,China,CHN,Belgium,BEL,10,0,5,0,15
2003,Cameroon,CMR,Belgium,BEL,5,0,59,5,69
2003,Congo,COG,Belgium,BEL,5,0,0,5,10
2003,Dem. Rep. of the Congo,COD,Belgium,BEL,124,0,614,112,850
2003,Colombia,COL,Belgium,BEL,0,0,35,10,45
2003,Cuba,CUB,Belgium,BEL,0,0,5,0,5
2003,Djibouti,DJI,Belgium,BEL,5,0,0,10,15
2003,Ecuador,ECU,Belgium,BEL,0,0,5,0,5
2003,Ethiopia,ETH,Belgium,BEL,5,0,0,0,5
2003,Palestinian,PSE,Belgium,BEL,0,0,22,5,27
2003,Georgia,GEO,Belgium,BEL,16,0,162,30,208
2003,Ghana,GHA,Belgium,BEL,0,0,0,5,5
2003,Guinea-Bissau,GNB,Belgium,BEL,0,0,0,5,5
2003,Guinea,GIN,Belgium,BEL,5,0,65,5,75
2003,Croatia,HRV,Belgium,BEL,5,0,0,5,10
2003,Cote d'Ivoire,CIV,Belgium,BEL,5,0,5,0,10
2003,India,IND,Belgium,BEL,0,0,5,5,10
2003,Iran (Islamic Rep. of),IRN,Belgium,BEL,14,0,206,30,250
2003,Iraq,IRQ,Belgium,BEL,16,0,26,28,70
2003,Kazakhstan,KAZ,Belgium,BEL,5,0,54,5,64
2003,Kenya,KEN,Belgium,BEL,0,0,0,5,5
2003,Kyrgyzstan,KGZ,Belgium,BEL,5,0,22,0,27
2003,Liberia,LBR,Belgium,BEL,0,0,0,10,10
2003,Lebanon,LBN,Belgium,BEL,0,0,29,20,49
2003,Sri Lanka,LKA,Belgium,BEL,0,0,10,38,48
2003,Mauritania,MRT,Belgium,BEL,5,0,13,11,29
2003,North Macedonia,MKD,Belgium,BEL,5,0,19,5,29
2003,Rep. of Moldova,MDA,Belgium,BEL,0,0,55,17,72
2003,Mongolia,MNG,Belgium,BEL,0,0,11,0,11
2003,Morocco,MAR,Belgium,BEL,0,0,5,5,10
2003,Myanmar,MMR,Belgium,BEL,0,0,5,0,5
2003,Nepal,NPL,Belgium,BEL,0,0,30,5,35
2003,Niger,NER,Belgium,BEL,0,0,14,5,19
2003,Nigeria,NGA,Belgium,BEL,0,0,5,5,10
2003,Pakistan,PAK,Belgium,BEL,0,0,5,10,15
2003,Peru,PER,Belgium,BEL,0,0,0,5,5
2003,Romania,ROU,Belgium,BEL,0,0,16,19,35
2003,Russian Federation,RUS,Belgium,BEL,86,0,363,67,516
2003,Rwanda,RWA,Belgium,BEL,231,0,86,19,336
2003,Serbia and Kosovo: S/RES/1244 (1999),SRB,Belgium,BEL,228,0,231,102,561
2003,Sierra Leone,SLE,Belgium,BEL,0,0,5,10,15
2003,Somalia,SOM,Belgium,BEL,10,0,0,16,26
2003,Viet Nam,VNM,Belgium,BEL,0,0,0,5,5
2003,Sudan,SDN,Belgium,BEL,0,0,45,0,45
2003,Slovakia,SVK,Belgium,BEL,5,0,0,0,5
2003,Syrian Arab Rep.,SYR,Belgium,BEL,5,0,186,17,208
2003,Tajikistan,TJK,Belgium,BEL,0,0,5,0,5
2003,Togo,TGO,Belgium,BEL,5,0,135,15,155
2003,Turkey,TUR,Belgium,BEL,24,0,216,20,260
2003,Ukraine,UKR,Belgium,BEL,0,0,47,19,66
2003,Uzbekistan,UZB,Belgium,BEL,5,0,24,0,29
2003,Burkina Faso,BFA,Benin,BEN,0,0,5,0,5
2003,Central African Rep.,CAF,Benin,BEN,10,0,12,0,22
2003,Chad,TCD,Benin,BEN,11,0,14,0,25
2003,Congo,COG,Benin,BEN,10,0,20,0,30
2003,Dem. Rep. of the Congo,COD,Benin,BEN,27,0,72,0,99
2003,Cote d'Ivoire,CIV,Benin,BEN,61,0,55,0,116
2003,Liberia,LBR,Benin,BEN,5,0,5,0,10
2003,Niger,NER,Benin,BEN,0,0,5,0,5
2003,Nigeria,NGA,Benin,BEN,10,0,19,0,29
2003,Rwanda,RWA,Benin,BEN,24,0,15,0,39
2003,Sierra Leone,SLE,Benin,BEN,0,0,5,0,5
2003,Sudan,SDN,Benin,BEN,0,0,48,0,48
2003,Togo,TGO,Benin,BEN,21,0,260,0,281
2003,Burundi,BDI,Burkina Faso,BFA,10,0,0,0,10
2003,Chad,TCD,Burkina Faso,BFA,0,0,5,0,5
2003,Congo,COG,Burkina Faso,BFA,15,0,0,0,15
2003,Togo,TGO,Burkina Faso,BFA,0,0,10,0,10
2003,Afghanistan,AFG,Belarus,BLR,21,0,21,20,62
2003,Armenia,ARM,Belarus,BLR,0,0,0,5,5
2003,Azerbaijan,AZE,Belarus,BLR,5,0,0,0,5
2003,Palestinian,PSE,Belarus,BLR,5,0,5,0,10
2003,Georgia,GEO,Belarus,BLR,30,0,10,5,45
2003,Iraq,IRQ,Belarus,BLR,0,0,0,5,5
2003,Rep. of Moldova,MDA,Belarus,BLR,0,0,5,0,5
2003,Colombia,COL,Bolivia (Plurinational State of),BOL,0,0,10,0,10
2003,Sri Lanka,LKA,Bolivia (Plurinational State of),BOL,0,0,5,0,5
2003,Kenya,KEN,Botswana,BWA,0,0,0,5,5
2003,Angola,AGO,Brazil,BRA,0,0,112,5,117
2003,Burundi,BDI,Brazil,BRA,12,0,0,0,12
2003,Bangladesh,BGD,Brazil,BRA,0,0,5,0,5
2003,China,CHN,Brazil,BRA,0,0,0,5,5
2003,Dem. Rep. of the Congo,COD,Brazil,BRA,5,0,5,5,15
2003,Colombia,COL,Brazil,BRA,27,0,27,5,59
2003,Cuba,CUB,Brazil,BRA,5,0,27,0,32
2003,Palestinian,PSE,Brazil,BRA,5,0,0,0,5
2003,Ghana,GHA,Brazil,BRA,0,0,5,0,5
2003,Guinea-Bissau,GNB,Brazil,BRA,0,0,20,10,30
2003,Iran (Islamic Rep. of),IRN,Brazil,BRA,0,0,5,0,5
2003,Iraq,IRQ,Brazil,BRA,0,0,5,5,10
2003,Liberia,LBR,Brazil,BRA,13,0,5,5,23
2003,Sri Lanka,LKA,Brazil,BRA,0,0,5,0,5
2003,Morocco,MAR,Brazil,BRA,0,0,5,0,5
2003,Nigeria,NGA,Brazil,BRA,0,0,5,0,5
2003,Paraguay,PRY,Brazil,BRA,5,0,0,0,5
2003,Peru,PER,Brazil,BRA,0,0,5,5,10
2003,Romania,ROU,Brazil,BRA,0,0,5,0,5
2003,South Africa,ZAF,Brazil,BRA,0,0,5,0,5
2003,Senegal,SEN,Brazil,BRA,0,0,5,0,5
2003,Sierra Leone,SLE,Brazil,BRA,0,0,18,0,18
2003,United Rep. of Tanzania,TZA,Brazil,BRA,0,0,5,0,5
2003,Unknown ,,Brazil,BRA,0,0,0,5,5
2003,Afghanistan,AFG,Bulgaria,BGR,5,99,291,155,550
2003,Algeria,DZA,Bulgaria,BGR,0,0,152,0,152
2003,Egypt,EGY,Bulgaria,BGR,0,0,5,0,5
2003,Armenia,ARM,Bulgaria,BGR,0,0,203,0,203
2003,China,CHN,Bulgaria,BGR,0,0,5,0,5
2003,Dem. Rep. of the Congo,COD,Bulgaria,BGR,0,0,5,0,5
2003,India,IND,Bulgaria,BGR,0,0,5,13,18
2003,Iran (Islamic Rep. of),IRN,Bulgaria,BGR,0,21,84,11,116
2003,Iraq,IRQ,Bulgaria,BGR,5,226,30,251,512
2003,Liberia,LBR,Bulgaria,BGR,0,0,5,0,5
2003,Lebanon,LBN,Bulgaria,BGR,0,0,5,0,5
2003,Sri Lanka,LKA,Bulgaria,BGR,0,0,5,0,5
2003,Rep. of Moldova,MDA,Bulgaria,BGR,0,0,5,0,5
2003,Nigeria,NGA,Bulgaria,BGR,0,0,75,21,96
2003,Pakistan,PAK,Bulgaria,BGR,0,0,11,5,16
2003,Russian Federation,RUS,Bulgaria,BGR,0,5,0,0,5
2003,Sierra Leone,SLE,Bulgaria,BGR,0,0,5,0,5
2003,Somalia,SOM,Bulgaria,BGR,0,22,0,29,51
2003,Syrian Arab Rep.,SYR,Bulgaria,BGR,0,5,5,0,10
2003,United Rep. of Tanzania,TZA,Bulgaria,BGR,0,0,5,0,5
2003,Tunisia,TUN,Bulgaria,BGR,0,0,5,0,5
2003,Turkey,TUR,Bulgaria,BGR,5,0,42,11,58
2003,Stateless,XXA,Bulgaria,BGR,0,5,41,5,51
2003,Nigeria,NGA,Belize,BLZ,0,0,0,5,5
2003,Afghanistan,AFG,Canada,CAN,202,0,22,29,253
2003,Albania,ALB,Canada,CAN,243,0,417,89,749
2003,Algeria,DZA,Canada,CAN,88,0,155,12,255
2003,Angola,AGO,Canada,CAN,233,0,149,22,404
2003,Antigua and Barbuda,ATG,Canada,CAN,0,0,22,5,27
2003,Egypt,EGY,Canada,CAN,90,0,58,13,161
2003,Argentina,ARG,Canada,CAN,114,0,658,113,885
2003,Armenia,ARM,Canada,CAN,15,0,10,0,25
2003,Azerbaijan,AZE,Canada,CAN,103,0,45,0,148
2003,Barbados,BRB,Canada,CAN,5,0,31,19,55
2003,Burundi,BDI,Canada,CAN,258,0,46,10,314
2003,Benin,BEN,Canada,CAN,5,0,5,0,10
2003,Bangladesh,BGD,Canada,CAN,301,0,166,37,504
2003,Burkina Faso,BFA,Canada,CAN,37,0,11,0,48
2003,Belarus,BLR,Canada,CAN,34,0,13,5,52
2003,Bolivia (Plurinational State of),BOL,Canada,CAN,20,0,24,5,49
2003,Botswana,BWA,Canada,CAN,5,0,0,0,5
2003,Brazil,BRA,Canada,CAN,14,0,77,93,184
2003,Bosnia and Herzegovina,BIH,Canada,CAN,5,0,5,5,15
2003,Bulgaria,BGR,Canada,CAN,110,0,48,30,188
2003,Belize,BLZ,Canada,CAN,0,0,5,0,5
2003,Cambodia,KHM,Canada,CAN,20,0,19,5,44
2003,Central African Rep.,CAF,Canada,CAN,19,0,10,5,34
2003,Chad,TCD,Canada,CAN,79,0,37,5,121
2003,China,CHN,Canada,CAN,1339,0,507,366,2212
2003,Chile,CHL,Canada,CAN,5,0,76,23,104
2003,Cameroon,CMR,Canada,CAN,60,0,37,10,107
2003,Congo,COG,Canada,CAN,46,0,35,5,86
2003,Dem. Rep. of the Congo,COD,Canada,CAN,577,0,384,65,1026
2003,Colombia,COL,Canada,CAN,1960,0,302,150,2412
2003,Costa Rica,CRI,Canada,CAN,38,0,1385,679,2102
2003,Cuba,CUB,Canada,CAN,149,0,39,34,222
2003,Czechia,CZE,Canada,CAN,5,0,18,10,33
2003,Denmark,DNK,Canada,CAN,0,0,5,5,10
2003,Djibouti,DJI,Canada,CAN,17,0,46,5,68
2003,Dominica,DMA,Canada,CAN,10,0,22,10,42
2003,Dominican Rep.,DOM,Canada,CAN,12,0,33,69,114
2003,Ecuador,ECU,Canada,CAN,28,0,17,32,77
2003,Eritrea,ERI,Canada,CAN,114,0,16,12,142
2003,Estonia,EST,Canada,CAN,5,0,10,5,20
2003,Ethiopia,ETH,Canada,CAN,205,0,37,20,262
2003,Fiji,FJI,Canada,CAN,17,0,33,11,61
2003,France,FRA,Canada,CAN,0,0,14,11,25
2003,Gabon,GAB,Canada,CAN,18,0,10,0,28
2003,Gambia,GMB,Canada,CAN,5,0,5,0,10
2003,Palestinian,PSE,Canada,CAN,129,0,23,21,173
2003,United Kingdom of Great Britain and Northern Ireland,GBR,Canada,CAN,0,0,16,5,21
2003,Georgia,GEO,Canada,CAN,39,0,25,5,69
2003,Germany,DEU,Canada,CAN,0,0,13,13,26
2003,Ghana,GHA,Canada,CAN,35,0,135,42,212
2003,Guinea-Bissau,GNB,Canada,CAN,5,0,0,0,5
2003,Greece,GRC,Canada,CAN,0,0,10,5,15
2003,Grenada,GRD,Canada,CAN,82,0,198,68,348
2003,Guatemala,GTM,Canada,CAN,63,0,87,41,191
2003,Guinea,GIN,Canada,CAN,161,0,83,5,249
2003,Guyana,GUY,Canada,CAN,113,0,452,109,674
2003,Haiti,HTI,Canada,CAN,148,0,135,13,296
2003,"China, Hong Kong SAR",HKG,Canada,CAN,0,0,0,5,5
2003,Honduras,HND,Canada,CAN,25,0,159,81,265
2003,Croatia,HRV,Canada,CAN,5,0,5,5,15
2003,Hungary,HUN,Canada,CAN,173,0,1392,490,2055
2003,Cote d'Ivoire,CIV,Canada,CAN,49,0,33,17,99
2003,India,IND,Canada,CAN,392,0,694,282,1368
2003,Indonesia,IDN,Canada,CAN,12,0,41,12,65
2003,Iran (Islamic Rep. of),IRN,Canada,CAN,312,0,153,52,517
2003,Iraq,IRQ,Canada,CAN,185,0,97,35,317
2003,Israel,ISR,Canada,CAN,163,0,343,129,635
2003,Italy,ITA,Canada,CAN,0,0,10,5,15
2003,Jamaica,JAM,Canada,CAN,60,0,214,72,346
2003,Jordan,JOR,Canada,CAN,29,0,34,14,77
2003,Japan,JPN,Canada,CAN,0,0,5,0,5
2003,Kazakhstan,KAZ,Canada,CAN,25,0,24,10,59
2003,Kenya,KEN,Canada,CAN,106,0,51,12,169
2003,Kyrgyzstan,KGZ,Canada,CAN,10,0,5,0,15
2003,Rep. of Korea,KOR,Canada,CAN,79,0,127,103,309
2003,Dem. People's Rep. of Korea,PRK,Canada,CAN,0,0,0,5,5
2003,Kuwait,KWT,Canada,CAN,20,0,5,5,30
2003,Lao People's Dem. Rep.,LAO,Canada,CAN,0,0,5,0,5
2003,Liberia,LBR,Canada,CAN,10,0,5,0,15
2003,Libya,LBY,Canada,CAN,30,0,21,5,56
2003,Saint Lucia,LCA,Canada,CAN,59,0,160,73,292
2003,Lebanon,LBN,Canada,CAN,189,0,248,58,495
2003,Sri Lanka,LKA,Canada,CAN,1749,0,543,104,2396
2003,Lithuania,LTU,Canada,CAN,24,0,26,13,63
2003,Latvia,LVA,Canada,CAN,10,0,10,10,30
2003,Mauritania,MRT,Canada,CAN,50,0,15,0,65
2003,North Macedonia,MKD,Canada,CAN,10,0,42,11,63
2003,Rep. of Moldova,MDA,Canada,CAN,15,0,29,5,49
2003,Mexico,MEX,Canada,CAN,597,0,960,665,2222
2003,Mali,MLI,Canada,CAN,16,0,49,5,70
2003,Malaysia,MYS,Canada,CAN,46,0,163,50,259
2003,Mongolia,MNG,Canada,CAN,12,0,10,5,27
2003,Morocco,MAR,Canada,CAN,10,0,35,15,60
2003,Malta,MLT,Canada,CAN,0,0,5,0,5
2003,Myanmar,MMR,Canada,CAN,24,0,10,0,34
2003,Namibia,NAM,Canada,CAN,5,0,5,0,10
2003,Nepal,NPL,Canada,CAN,31,0,22,5,58
2003,Netherlands,NLD,Canada,CAN,0,0,5,5,10
2003,Niger,NER,Canada,CAN,10,0,10,5,25
2003,Nicaragua,NIC,Canada,CAN,5,0,39,16,60
2003,Nigeria,NGA,Canada,CAN,394,0,321,121,836
2003,Pakistan,PAK,Canada,CAN,1608,0,1751,605,3964
2003,Panama,PAN,Canada,CAN,5,0,16,10,31
2003,Paraguay,PRY,Canada,CAN,5,0,5,10,20
2003,Peru,PER,Canada,CAN,371,0,455,96,922
2003,Philippines,PHL,Canada,CAN,27,0,297,41,365
2003,Poland,POL,Canada,CAN,58,0,131,74,263
2003,Portugal,PRT,Canada,CAN,0,0,481,79,560
2003,Romania,ROU,Canada,CAN,80,0,140,65,285
2003,South Africa,ZAF,Canada,CAN,5,0,12,0,17
2003,Russian Federation,RUS,Canada,CAN,178,0,123,73,374
2003,Rwanda,RWA,Canada,CAN,119,0,41,5,165
2003,El Salvador,SLV,Canada,CAN,93,0,155,40,288
2003,Saudi Arabia,SAU,Canada,CAN,40,0,5,5,50
2003,Serbia and Kosovo: S/RES/1244 (1999),SRB,Canada,CAN,41,0,91,38,170
2003,Senegal,SEN,Canada,CAN,19,0,10,0,29
2003,Seychelles,SYC,Canada,CAN,0,0,10,0,10
2003,Singapore,SGP,Canada,CAN,5,0,10,0,15
2003,Sierra Leone,SLE,Canada,CAN,28,0,31,5,64
2003,Somalia,SOM,Canada,CAN,445,0,59,84,588
2003,Viet Nam,VNM,Canada,CAN,29,0,31,17,77
2003,Saint Kitts and Nevis,KNA,Canada,CAN,0,0,0,5,5
2003,Sudan,SDN,Canada,CAN,203,0,31,37,271
2003,Slovakia,SVK,Canada,CAN,0,0,10,10,20
2003,Slovenia,SVN,Canada,CAN,0,0,0,5,5
2003,Switzerland,CHE,Canada,CAN,0,0,5,0,5
2003,Syrian Arab Rep.,SYR,Canada,CAN,48,0,62,10,120
2003,United Rep. of Tanzania,TZA,Canada,CAN,65,0,83,11,159
2003,Thailand,THA,Canada,CAN,0,0,5,0,5
2003,Tajikistan,TJK,Canada,CAN,5,0,0,0,5
2003,Turkmenistan,TKM,Canada,CAN,5,0,0,0,5
2003,Togo,TGO,Canada,CAN,39,0,21,0,60
2003,Trinidad and Tobago,TTO,Canada,CAN,13,0,175,56,244
2003,Tunisia,TUN,Canada,CAN,23,0,51,10,84
2003,Turkey,TUR,Canada,CAN,738,0,379,115,1232
2003,United Arab Emirates,ARE,Canada,CAN,11,0,0,0,11
2003,Uganda,UGA,Canada,CAN,89,0,18,10,117
2003,Ukraine,UKR,Canada,CAN,145,0,155,64,364
2003,Uruguay,URY,Canada,CAN,25,0,89,69,183
2003,United States of America,USA,Canada,CAN,0,0,86,87,173
2003,Uzbekistan,UZB,Canada,CAN,23,0,14,5,42
2003,Saint Vincent and the Grenadines,VCT,Canada,CAN,128,0,263,103,494
2003,Venezuela (Bolivarian Republic of),VEN,Canada,CAN,82,0,132,52,266
2003,Yemen,YEM,Canada,CAN,44,0,43,0,87
2003,Zambia,ZMB,Canada,CAN,10,0,5,0,15
2003,Zimbabwe,ZWE,Canada,CAN,507,0,123,19,649
2003,Unknown ,,Canada,CAN,5,0,5,5,15
2003,Chad,TCD,Central African Rep.,CAF,0,0,0,182,182
2003,Congo,COG,Central African Rep.,CAF,0,0,0,36,36
2003,Dem. Rep. of the Congo,COD,Central African Rep.,CAF,192,403,5,1029,1629
2003,Sudan,SDN,Central African Rep.,CAF,0,0,0,519,519
2003,Unknown ,,Central African Rep.,CAF,0,0,0,23,23
2003,Cambodia,KHM,Chad,TCD,5,0,5,0,10
2003,Central African Rep.,CAF,Chad,TCD,0,18,11,0,29
2003,Congo,COG,Chad,TCD,0,5,0,0,5
2003,Dem. Rep. of the Congo,COD,Chad,TCD,0,35,16,0,51
2003,Cote d'Ivoire,CIV,Chad,TCD,0,0,10,0,10
2003,Liberia,LBR,Chad,TCD,0,14,21,0,35
2003,Rwanda,RWA,Chad,TCD,0,0,5,0,5
2003,Sudan,SDN,Chad,TCD,0,10,5,0,15
2003,Afghanistan,AFG,Chile,CHL,12,0,0,0,12
2003,Colombia,COL,Chile,CHL,21,0,0,0,21
2003,Cuba,CUB,Chile,CHL,0,0,0,5,5
2003,Rwanda,RWA,Chile,CHL,5,0,0,0,5
2003,Iran (Islamic Rep. of),IRN,Colombia,COL,0,0,5,0,5
2003,Venezuela (Bolivarian Republic of),VEN,Colombia,COL,5,0,0,0,5
2003,Colombia,COL,Costa Rica,CRI,773,887,327,24,2011
2003,Cuba,CUB,Costa Rica,CRI,42,42,21,0,105
2003,Peru,PER,Costa Rica,CRI,0,0,5,5,10
2003,Unknown ,,Costa Rica,CRI,48,46,25,5,124
2003,Palestinian,PSE,Cyprus,CYP,0,0,28,26,54
2003,Georgia,GEO,Cyprus,CYP,0,0,18,0,18
2003,Iran (Islamic Rep. of),IRN,Cyprus,CYP,0,0,82,31,113
2003,Israel,ISR,Cyprus,CYP,0,0,5,0,5
2003,Kazakhstan,KAZ,Cyprus,CYP,0,0,5,0,5
2003,Kyrgyzstan,KGZ,Cyprus,CYP,0,0,0,5,5
2003,Lebanon,LBN,Cyprus,CYP,0,0,5,0,5
2003,Pakistan,PAK,Cyprus,CYP,0,0,31,24,55
2003,Russian Federation,RUS,Cyprus,CYP,0,0,28,5,33
2003,Serbia and Kosovo: S/RES/1244 (1999),SRB,Cyprus,CYP,0,0,0,5,5
2003,Turkey,TUR,Cyprus,CYP,0,0,48,32,80
2003,Ukraine,UKR,Cyprus,CYP,0,0,5,0,5
2003,Afghanistan,AFG,Czechia,CZE,14,0,25,14,53
2003,Algeria,DZA,Czechia,CZE,0,0,42,54,96
2003,Angola,AGO,Czechia,CZE,0,0,13,0,13
2003,Armenia,ARM,Czechia,CZE,26,0,242,37,305
2003,Azerbaijan,AZE,Czechia,CZE,0,0,0,24,24
2003,Belarus,BLR,Czechia,CZE,20,0,213,131,364
2003,Bosnia and Herzegovina,BIH,Czechia,CZE,0,0,5,5,10
2003,Bulgaria,BGR,Czechia,CZE,0,0,85,19,104
2003,China,CHN,Czechia,CZE,0,0,606,390,996
2003,Georgia,GEO,Czechia,CZE,10,0,203,319,532
2003,Ghana,GHA,Czechia,CZE,0,0,5,10,15
2003,Guinea,GIN,Czechia,CZE,0,0,0,10,10
2003,Cote d'Ivoire,CIV,Czechia,CZE,0,0,21,16,37
2003,India,IND,Czechia,CZE,0,0,139,119,258
2003,Iran (Islamic Rep. of),IRN,Czechia,CZE,5,0,0,5,10
2003,Iraq,IRQ,Czechia,CZE,5,0,25,83,113
2003,Kazakhstan,KAZ,Czechia,CZE,10,0,110,12,132
2003,Kyrgyzstan,KGZ,Czechia,CZE,5,0,52,41,98
2003,Sri Lanka,LKA,Czechia,CZE,0,0,5,33,38
2003,Lithuania,LTU,Czechia,CZE,0,0,21,5,26
2003,North Macedonia,MKD,Czechia,CZE,0,0,20,10,30
2003,Rep. of Moldova,MDA,Czechia,CZE,0,0,352,364,716
2003,Mongolia,MNG,Czechia,CZE,0,0,98,36,134
2003,Nigeria,NGA,Czechia,CZE,0,0,10,33,43
2003,Pakistan,PAK,Czechia,CZE,5,0,5,11,21
2003,Romania,ROU,Czechia,CZE,0,0,82,55,137
2003,Russian Federation,RUS,Czechia,CZE,62,0,1096,2796,3954
2003,Serbia and Kosovo: S/RES/1244 (1999),SRB,Czechia,CZE,5,0,10,15,30
2003,Senegal,SEN,Czechia,CZE,0,0,5,5,10
2003,Somalia,SOM,Czechia,CZE,0,0,10,16,26
2003,Viet Nam,VNM,Czechia,CZE,5,0,755,230,990
2003,Slovakia,SVK,Czechia,CZE,0,0,1008,215,1223
2003,Syrian Arab Rep.,SYR,Czechia,CZE,5,0,0,5,10
2003,Turkey,TUR,Czechia,CZE,0,0,5,11,16
2003,Ukraine,UKR,Czechia,CZE,5,0,2357,417,2779
2003,Uzbekistan,UZB,Czechia,CZE,0,0,74,53,127
2003,Stateless,XXA,Czechia,CZE,0,0,39,67,106
2003,Unknown ,,Czechia,CZE,5,0,99,69,173
2003,Afghanistan,AFG,Denmark,DNK,326,41,757,0,1124
2003,Albania,ALB,Denmark,DNK,0,0,27,0,27
2003,Algeria,DZA,Denmark,DNK,0,0,13,0,13
2003,Angola,AGO,Denmark,DNK,0,5,0,0,5
2003,Egypt,EGY,Denmark,DNK,0,0,5,0,5
2003,Armenia,ARM,Denmark,DNK,0,0,10,0,10
2003,Azerbaijan,AZE,Denmark,DNK,0,0,10,0,10
2003,Burundi,BDI,Denmark,DNK,0,12,20,0,32
2003,Bangladesh,BGD,Denmark,DNK,0,0,5,0,5
2003,Belarus,BLR,Denmark,DNK,5,5,5,0,15
2003,Bosnia and Herzegovina,BIH,Denmark,DNK,5,0,103,0,108
2003,Bulgaria,BGR,Denmark,DNK,0,0,101,0,101
2003,China,CHN,Denmark,DNK,5,0,30,0,35
2003,Cameroon,CMR,Denmark,DNK,0,0,5,0,5
2003,Dem. Rep. of the Congo,COD,Denmark,DNK,5,0,11,0,16
2003,Czechia,CZE,Denmark,DNK,0,0,11,0,11
2003,Ecuador,ECU,Denmark,DNK,0,0,11,0,11
2003,Estonia,EST,Denmark,DNK,0,0,5,0,5
2003,Ethiopia,ETH,Denmark,DNK,0,0,5,0,5
2003,Gambia,GMB,Denmark,DNK,0,0,5,0,5
2003,Palestinian,PSE,Denmark,DNK,14,5,111,0,130
2003,Georgia,GEO,Denmark,DNK,0,0,14,0,14
2003,Ghana,GHA,Denmark,DNK,0,0,10,0,10
2003,Guinea,GIN,Denmark,DNK,0,0,10,0,10
2003,Croatia,HRV,Denmark,DNK,0,0,5,0,5
2003,Cote d'Ivoire,CIV,Denmark,DNK,0,0,5,0,5
2003,India,IND,Denmark,DNK,0,0,54,0,54
2003,Iran (Islamic Rep. of),IRN,Denmark,DNK,18,22,118,0,158
2003,Iraq,IRQ,Denmark,DNK,14,40,185,0,239
2003,Jordan,JOR,Denmark,DNK,0,0,10,0,10
2003,Kenya,KEN,Denmark,DNK,5,0,0,0,5
2003,Liberia,LBR,Denmark,DNK,0,0,5,0,5
2003,Libya,LBY,Denmark,DNK,0,0,19,0,19
2003,Lebanon,LBN,Denmark,DNK,5,0,32,0,37
2003,Sri Lanka,LKA,Denmark,DNK,0,5,15,0,20
2003,Lithuania,LTU,Denmark,DNK,0,0,10,0,10
2003,Latvia,LVA,Denmark,DNK,0,0,5,0,5
2003,North Macedonia,MKD,Denmark,DNK,0,0,49,0,49
2003,Rep. of Moldova,MDA,Denmark,DNK,0,0,5,0,5
2003,Morocco,MAR,Denmark,DNK,0,0,13,0,13
2003,Nepal,NPL,Denmark,DNK,0,0,5,0,5
2003,Nigeria,NGA,Denmark,DNK,0,0,30,0,30
2003,Pakistan,PAK,Denmark,DNK,0,0,22,0,22
2003,Poland,POL,Denmark,DNK,0,0,10,0,10
2003,Romania,ROU,Denmark,DNK,0,0,14,0,14
2003,Russian Federation,RUS,Denmark,DNK,10,43,61,0,114
2003,Rwanda,RWA,Denmark,DNK,10,0,10,0,20
2003,Serbia and Kosovo: S/RES/1244 (1999),SRB,Denmark,DNK,10,5,388,0,403
2003,Somalia,SOM,Denmark,DNK,26,77,156,0,259
2003,Viet Nam,VNM,Denmark,DNK,10,0,18,0,28
2003,Sudan,SDN,Denmark,DNK,10,5,14,0,29
2003,Slovakia,SVK,Denmark,DNK,0,0,11,0,11
2003,Syrian Arab Rep.,SYR,Denmark,DNK,5,0,30,0,35
2003,Turkey,TUR,Denmark,DNK,5,0,36,0,41
2003,Uganda,UGA,Denmark,DNK,0,0,5,0,5
2003,Ukraine,UKR,Denmark,DNK,0,0,11,0,11
2003,Uzbekistan,UZB,Denmark,DNK,0,0,5,0,5
2003,Yemen,YEM,Denmark,DNK,0,0,5,0,5
2003,Stateless,XXA,Denmark,DNK,15,5,16,0,36
2003,Colombia,COL,Ecuador,ECU,3282,0,4356,3842,11480
2003,Cuba,CUB,Ecuador,ECU,5,0,0,0,5
2003,Haiti,HTI,Ecuador,ECU,5,0,5,0,10
2003,Iraq,IRQ,Ecuador,ECU,5,0,5,0,10
2003,Peru,PER,Ecuador,ECU,0,0,13,0,13
2003,Venezuela (Bolivarian Republic of),VEN,Ecuador,ECU,0,0,5,0,5
2003,Azerbaijan,AZE,Estonia,EST,0,0,5,0,5
2003,Georgia,GEO,Estonia,EST,0,0,5,0,5
2003,Turkey,TUR,Estonia,EST,0,0,5,0,5
2003,Burundi,BDI,Ethiopia,ETH,5,0,0,0,5
2003,Dem. Rep. of the Congo,COD,Ethiopia,ETH,15,0,12,0,27
2003,Eritrea,ERI,Ethiopia,ETH,1580,0,0,0,1580
2003,Afghanistan,AFG,Finland,FIN,0,17,15,5,37
2003,Albania,ALB,Finland,FIN,0,5,19,21,45
2003,Algeria,DZA,Finland,FIN,0,10,34,19,63
2003,Angola,AGO,Finland,FIN,0,23,21,0,44
2003,Armenia,ARM,Finland,FIN,0,0,10,5,15
2003,Azerbaijan,AZE,Finland,FIN,0,10,29,5,44
2003,Bangladesh,BGD,Finland,FIN,0,5,61,5,71
2003,Belarus,BLR,Finland,FIN,0,10,31,21,62
2003,Bosnia and Herzegovina,BIH,Finland,FIN,0,28,105,124,257
2003,Bulgaria,BGR,Finland,FIN,0,0,10,392,402
2003,China,CHN,Finland,FIN,0,0,0,5,5
2003,Cameroon,CMR,Finland,FIN,0,5,5,0,10
2003,Congo,COG,Finland,FIN,0,5,5,0,10
2003,Dem. Rep. of the Congo,COD,Finland,FIN,0,19,26,5,50
2003,Cuba,CUB,Finland,FIN,0,0,5,0,5
2003,Czechia,CZE,Finland,FIN,0,0,23,15,38
2003,Ethiopia,ETH,Finland,FIN,0,5,5,0,10
2003,Georgia,GEO,Finland,FIN,0,0,5,0,5
2003,Ghana,GHA,Finland,FIN,0,0,0,10,10
2003,Guinea,GIN,Finland,FIN,0,0,5,0,5
2003,Croatia,HRV,Finland,FIN,0,0,17,105,122
2003,Hungary,HUN,Finland,FIN,0,0,5,0,5
2003,Cote d'Ivoire,CIV,Finland,FIN,0,0,5,0,5
2003,India,IND,Finland,FIN,0,0,5,0,5
2003,Iran (Islamic Rep. of),IRN,Finland,FIN,5,36,34,5,80
2003,Iraq,IRQ,Finland,FIN,0,21,32,15,68
2003,Jordan,JOR,Finland,FIN,0,0,5,0,5
2003,Kazakhstan,KAZ,Finland,FIN,0,0,10,0,10
2003,Libya,LBY,Finland,FIN,0,5,0,5,10
2003,Sri Lanka,LKA,Finland,FIN,0,5,5,5,15
2003,Lithuania,LTU,Finland,FIN,0,0,12,0,12
2003,Latvia,LVA,Finland,FIN,0,0,5,10,15
2003,North Macedonia,MKD,Finland,FIN,0,5,12,5,22
2003,Mongolia,MNG,Finland,FIN,0,0,5,0,5
2003,Morocco,MAR,Finland,FIN,0,5,0,5,10
2003,Myanmar,MMR,Finland,FIN,0,5,5,21,31
2003,Nigeria,NGA,Finland,FIN,0,5,24,10,39
2003,Pakistan,PAK,Finland,FIN,0,0,10,0,10
2003,Peru,PER,Finland,FIN,0,5,0,0,5
2003,Poland,POL,Finland,FIN,0,0,13,0,13
2003,Romania,ROU,Finland,FIN,0,0,10,106,116
2003,Russian Federation,RUS,Finland,FIN,0,14,10,238,262
2003,Rwanda,RWA,Finland,FIN,0,5,0,0,5
2003,Serbia and Kosovo: S/RES/1244 (1999),SRB,Finland,FIN,0,64,195,268,527
2003,Senegal,SEN,Finland,FIN,0,0,0,5,5
2003,Sierra Leone,SLE,Finland,FIN,0,0,11,0,11
2003,Somalia,SOM,Finland,FIN,0,75,5,14,94
2003,Slovakia,SVK,Finland,FIN,0,0,77,35,112
2003,Syrian Arab Rep.,SYR,Finland,FIN,0,11,11,5,27
2003,Togo,TGO,Finland,FIN,0,5,5,0,10
2003,Turkey,TUR,Finland,FIN,0,55,121,84,260
2003,Ukraine,UKR,Finland,FIN,0,5,48,43,96
2003,Uzbekistan,UZB,Finland,FIN,0,0,10,5,15
2003,Stateless,XXA,Finland,FIN,0,11,11,10,32
2003,Unknown ,,Finland,FIN,0,5,20,12,37
2003,Afghanistan,AFG,France,FRA,66,0,284,0,350
2003,Albania,ALB,France,FRA,21,0,553,0,574
2003,Algeria,DZA,France,FRA,115,0,2715,0,2830
2003,Angola,AGO,France,FRA,169,0,2191,0,2360
2003,Egypt,EGY,France,FRA,10,0,21,0,31
2003,Argentina,ARG,France,FRA,0,0,11,0,11
2003,Armenia,ARM,France,FRA,63,0,1081,0,1144
2003,Azerbaijan,AZE,France,FRA,117,0,421,0,538
2003,Burundi,BDI,France,FRA,22,0,45,0,67
2003,Benin,BEN,France,FRA,0,0,25,0,25
2003,Bangladesh,BGD,France,FRA,36,0,702,0,738
2003,Burkina Faso,BFA,France,FRA,0,0,34,0,34
2003,Belarus,BLR,France,FRA,42,0,313,0,355
2003,Brazil,BRA,France,FRA,0,0,13,0,13
2003,Bosnia and Herzegovina,BIH,France,FRA,354,0,413,0,767
2003,Cambodia,KHM,France,FRA,10,0,90,0,100
2003,Central African Rep.,CAF,France,FRA,90,0,653,0,743
2003,Chad,TCD,France,FRA,163,0,476,0,639
2003,China,CHN,France,FRA,32,0,3421,0,3453
2003,Cameroon,CMR,France,FRA,61,0,902,0,963
2003,Congo,COG,France,FRA,382,0,2991,0,3373
2003,Dem. Rep. of the Congo,COD,France,FRA,845,0,7315,0,8160
2003,Comoros,COM,France,FRA,10,0,86,0,96
2003,Colombia,COL,France,FRA,33,0,84,0,117
2003,Cuba,CUB,France,FRA,10,0,18,0,28
2003,Djibouti,DJI,France,FRA,10,0,29,0,39
2003,Eritrea,ERI,France,FRA,5,0,20,0,25
2003,Ethiopia,ETH,France,FRA,37,0,32,0,69
2003,Gabon,GAB,France,FRA,0,0,21,0,21
2003,Gambia,GMB,France,FRA,0,0,20,0,20
2003,Georgia,GEO,France,FRA,90,0,1928,0,2018
2003,Guinea-Bissau,GNB,France,FRA,36,0,170,0,206
2003,Guinea,GIN,France,FRA,42,0,995,0,1037
2003,Guyana,GUY,France,FRA,0,0,73,0,73
2003,Haiti,HTI,France,FRA,174,0,1297,0,1471
2003,Cote d'Ivoire,CIV,France,FRA,218,0,1179,0,1397
2003,India,IND,France,FRA,5,0,454,0,459
2003,Iran (Islamic Rep. of),IRN,France,FRA,24,0,121,0,145
2003,Iraq,IRQ,France,FRA,28,0,531,0,559
2003,Israel,ISR,France,FRA,0,0,5,0,5
2003,Kazakhstan,KAZ,France,FRA,11,0,221,0,232
2003,Kyrgyzstan,KGZ,France,FRA,5,0,92,0,97
2003,Liberia,LBR,France,FRA,12,0,130,0,142
2003,Libya,LBY,France,FRA,0,0,11,0,11
2003,Lebanon,LBN,France,FRA,5,0,23,0,28
2003,Sri Lanka,LKA,France,FRA,303,0,1860,0,2163
2003,Lithuania,LTU,France,FRA,0,0,20,0,20
2003,Madagascar,MDG,France,FRA,29,0,346,0,375
2003,Mauritania,MRT,France,FRA,506,0,4073,0,4579
2003,North Macedonia,MKD,France,FRA,5,0,330,0,335
2003,Rep. of Moldova,MDA,France,FRA,5,0,1692,0,1697
2003,Mali,MLI,France,FRA,5,0,1223,0,1228
2003,Mongolia,MNG,France,FRA,0,0,241,0,241
2003,Mauritius,MUS,France,FRA,0,0,16,0,16
2003,Myanmar,MMR,France,FRA,11,0,11,0,22
2003,Nepal,NPL,France,FRA,5,0,10,0,15
2003,Niger,NER,France,FRA,0,0,33,0,33
2003,Nigeria,NGA,France,FRA,11,0,1374,0,1385
2003,Pakistan,PAK,France,FRA,12,0,440,0,452
2003,Peru,PER,France,FRA,5,0,56,0,61
2003,Poland,POL,France,FRA,0,0,5,0,5
2003,Russian Federation,RUS,France,FRA,828,0,1448,0,2276
2003,Rwanda,RWA,France,FRA,216,0,123,0,339
2003,Serbia and Kosovo: S/RES/1244 (1999),SRB,France,FRA,396,0,1579,0,1975
2003,Senegal,SEN,France,FRA,11,0,358,0,369
2003,Sierra Leone,SLE,France,FRA,51,0,914,0,965
2003,Somalia,SOM,France,FRA,30,0,124,0,154
2003,Viet Nam,VNM,France,FRA,16,0,46,0,62
2003,Sudan,SDN,France,FRA,44,0,192,0,236
2003,Slovakia,SVK,France,FRA,0,0,70,0,70
2003,Syrian Arab Rep.,SYR,France,FRA,5,0,35,0,40
2003,Thailand,THA,France,FRA,0,0,39,0,39
2003,Togo,TGO,France,FRA,57,0,314,0,371
2003,Tunisia,TUN,France,FRA,14,0,21,0,35
2003,Turkey,TUR,France,FRA,489,0,9079,0,9568
2003,Ukraine,UKR,France,FRA,24,0,795,0,819
2003,Uzbekistan,UZB,France,FRA,5,0,131,0,136
2003,Stateless,XXA,France,FRA,53,0,58,0,111
2003,Unknown ,,France,FRA,43,0,551,0,594
2003,Angola,AGO,Gabon,GAB,5,0,10,0,15
2003,Burundi,BDI,Gabon,GAB,5,5,0,0,10
2003,Cambodia,KHM,Gabon,GAB,0,0,0,10,10
2003,Central African Rep.,CAF,Gabon,GAB,0,10,0,0,10
2003,Chad,TCD,Gabon,GAB,5,396,92,0,493
2003,Cameroon,CMR,Gabon,GAB,0,0,5,0,5
2003,Congo,COG,Gabon,GAB,30,1095,121,0,1246
2003,Dem. Rep. of the Congo,COD,Gabon,GAB,16,21,259,0,296
2003,Equatorial Guinea,GNQ,Gabon,GAB,0,16,0,0,16
2003,Cote d'Ivoire,CIV,Gabon,GAB,0,0,5,0,5
2003,Liberia,LBR,Gabon,GAB,0,5,5,0,10
2003,Mauritania,MRT,Gabon,GAB,0,0,5,17,22
2003,Nigeria,NGA,Gabon,GAB,0,0,0,17,17
2003,Rwanda,RWA,Gabon,GAB,0,15,5,0,20
2003,Sierra Leone,SLE,Gabon,GAB,0,5,5,0,10
2003,Togo,TGO,Gabon,GAB,5,0,0,0,5
2003,Liberia,LBR,Gambia,GMB,71,0,0,0,71
2003,Afghanistan,AFG,United Kingdom of Great Britain and Northern Ireland,GBR,84,601,3266,661,4612
2003,Albania,ALB,United Kingdom of Great Britain and Northern Ireland,GBR,5,198,614,190,1007
2003,Algeria,DZA,United Kingdom of Great Britain and Northern Ireland,GBR,5,36,725,185,951
2003,Angola,AGO,United Kingdom of Great Britain and Northern Ireland,GBR,36,474,849,136,1495
2003,Egypt,EGY,United Kingdom of Great Britain and Northern Ireland,GBR,5,10,72,10,97
2003,Armenia,ARM,United Kingdom of Great Britain and Northern Ireland,GBR,5,5,63,0,73
2003,Azerbaijan,AZE,United Kingdom of Great Britain and Northern Ireland,GBR,10,5,232,12,259
2003,Bahrain,BHR,United Kingdom of Great Britain and Northern Ireland,GBR,0,0,5,0,5
2003,Burundi,BDI,United Kingdom of Great Britain and Northern Ireland,GBR,130,276,436,79,921
2003,Benin,BEN,United Kingdom of Great Britain and Northern Ireland,GBR,0,0,10,0,10
2003,Bangladesh,BGD,United Kingdom of Great Britain and Northern Ireland,GBR,5,334,483,117,939
2003,Bhutan,BTN,United Kingdom of Great Britain and Northern Ireland,GBR,10,0,46,13,69
2003,Burkina Faso,BFA,United Kingdom of Great Britain and Northern Ireland,GBR,0,0,5,0,5
2003,Belarus,BLR,United Kingdom of Great Britain and Northern Ireland,GBR,5,5,131,74,215
2003,Bolivia (Plurinational State of),BOL,United Kingdom of Great Britain and Northern Ireland,GBR,5,5,135,22,167
2003,Botswana,BWA,United Kingdom of Great Britain and Northern Ireland,GBR,0,0,18,0,18
2003,Brazil,BRA,United Kingdom of Great Britain and Northern Ireland,GBR,0,0,15,10,25
2003,Bosnia and Herzegovina,BIH,United Kingdom of Great Britain and Northern Ireland,GBR,0,0,83,34,117
2003,Bulgaria,BGR,United Kingdom of Great Britain and Northern Ireland,GBR,0,0,38,12,50
2003,Central African Rep.,CAF,United Kingdom of Great Britain and Northern Ireland,GBR,0,0,10,5,15
2003,Chad,TCD,United Kingdom of Great Britain and Northern Ireland,GBR,5,5,30,0,40
2003,China,CHN,United Kingdom of Great Britain and Northern Ireland,GBR,26,153,1864,1883,3926
2003,Chile,CHL,United Kingdom of Great Britain and Northern Ireland,GBR,0,0,16,0,16
2003,Cameroon,CMR,United Kingdom of Great Britain and Northern Ireland,GBR,21,43,523,43,630
2003,Congo,COG,United Kingdom of Great Britain and Northern Ireland,GBR,46,41,367,56,510
2003,Dem. Rep. of the Congo,COD,United Kingdom of Great Britain and Northern Ireland,GBR,126,226,1979,172,2503
2003,Comoros,COM,United Kingdom of Great Britain and Northern Ireland,GBR,0,0,5,0,5
2003,Colombia,COL,United Kingdom of Great Britain and Northern Ireland,GBR,18,5,377,54,454
2003,Cuba,CUB,United Kingdom of Great Britain and Northern Ireland,GBR,0,0,15,5,20
2003,Cyprus,CYP,United Kingdom of Great Britain and Northern Ireland,GBR,0,0,93,10,103
2003,Czechia,CZE,United Kingdom of Great Britain and Northern Ireland,GBR,0,0,179,50,229
2003,Ecuador,ECU,United Kingdom of Great Britain and Northern Ireland,GBR,5,13,314,49,381
2003,Equatorial Guinea,GNQ,United Kingdom of Great Britain and Northern Ireland,GBR,5,0,0,0,5
2003,Eritrea,ERI,United Kingdom of Great Britain and Northern Ireland,GBR,76,178,954,66,1274
2003,Estonia,EST,United Kingdom of Great Britain and Northern Ireland,GBR,0,0,29,12,41
2003,Ethiopia,ETH,United Kingdom of Great Britain and Northern Ireland,GBR,15,136,606,49,806
2003,Fiji,FJI,United Kingdom of Great Britain and Northern Ireland,GBR,0,0,5,0,5
2003,Gambia,GMB,United Kingdom of Great Britain and Northern Ireland,GBR,0,10,81,29,120
2003,Palestinian,PSE,United Kingdom of Great Britain and Northern Ireland,GBR,13,39,1388,198,1638
2003,Georgia,GEO,United Kingdom of Great Britain and Northern Ireland,GBR,11,5,198,56,270
2003,Ghana,GHA,United Kingdom of Great Britain and Northern Ireland,GBR,13,15,272,82,382
2003,Guinea-Bissau,GNB,United Kingdom of Great Britain and Northern Ireland,GBR,0,0,19,0,19
2003,Guatemala,GTM,United Kingdom of Great Britain and Northern Ireland,GBR,0,0,5,0,5
2003,Guinea,GIN,United Kingdom of Great Britain and Northern Ireland,GBR,11,38,154,26,229
2003,Guyana,GUY,United Kingdom of Great Britain and Northern Ireland,GBR,0,0,17,0,17
2003,Honduras,HND,United Kingdom of Great Britain and Northern Ireland,GBR,0,0,5,0,5
2003,Croatia,HRV,United Kingdom of Great Britain and Northern Ireland,GBR,0,0,122,21,143
2003,Hungary,HUN,United Kingdom of Great Britain and Northern Ireland,GBR,0,0,16,5,21
2003,Cote d'Ivoire,CIV,United Kingdom of Great Britain and Northern Ireland,GBR,26,28,450,77,581
2003,India,IND,United Kingdom of Great Britain and Northern Ireland,GBR,11,33,1434,996,2474
2003,Indonesia,IDN,United Kingdom of Great Britain and Northern Ireland,GBR,0,0,15,18,33
2003,Iran (Islamic Rep. of),IRN,United Kingdom of Great Britain and Northern Ireland,GBR,146,128,3190,464,3928
2003,Iraq,IRQ,United Kingdom of Great Britain and Northern Ireland,GBR,86,2326,3861,1017,7290
2003,Israel,ISR,United Kingdom of Great Britain and Northern Ireland,GBR,0,0,83,10,93
2003,Jamaica,JAM,United Kingdom of Great Britain and Northern Ireland,GBR,0,15,1067,225,1307
2003,Jordan,JOR,United Kingdom of Great Britain and Northern Ireland,GBR,0,0,38,0,38
2003,Kazakhstan,KAZ,United Kingdom of Great Britain and Northern Ireland,GBR,0,0,21,5,26
2003,Kenya,KEN,United Kingdom of Great Britain and Northern Ireland,GBR,19,46,271,49,385
2003,Kyrgyzstan,KGZ,United Kingdom of Great Britain and Northern Ireland,GBR,5,0,26,10,41
2003,Kuwait,KWT,United Kingdom of Great Britain and Northern Ireland,GBR,12,0,53,5,70
2003,Liberia,LBR,United Kingdom of Great Britain and Northern Ireland,GBR,15,99,542,145,801
2003,Libya,LBY,United Kingdom of Great Britain and Northern Ireland,GBR,32,17,243,33,325
2003,Lebanon,LBN,United Kingdom of Great Britain and Northern Ireland,GBR,10,16,347,28,401
2003,Sri Lanka,LKA,United Kingdom of Great Britain and Northern Ireland,GBR,27,100,1394,193,1714
2003,Lithuania,LTU,United Kingdom of Great Britain and Northern Ireland,GBR,0,5,147,45,197
2003,Latvia,LVA,United Kingdom of Great Britain and Northern Ireland,GBR,0,0,83,22,105
2003,North Macedonia,MKD,United Kingdom of Great Britain and Northern Ireland,GBR,0,32,68,30,130
2003,Rep. of Moldova,MDA,United Kingdom of Great Britain and Northern Ireland,GBR,0,62,260,209,531
2003,Mali,MLI,United Kingdom of Great Britain and Northern Ireland,GBR,0,0,5,0,5
2003,Malaysia,MYS,United Kingdom of Great Britain and Northern Ireland,GBR,0,0,22,12,34
2003,Malawi,MWI,United Kingdom of Great Britain and Northern Ireland,GBR,0,5,143,28,176
2003,Mongolia,MNG,United Kingdom of Great Britain and Northern Ireland,GBR,5,5,172,90,272
2003,Morocco,MAR,United Kingdom of Great Britain and Northern Ireland,GBR,0,5,23,10,38
2003,Mozambique,MOZ,United Kingdom of Great Britain and Northern Ireland,GBR,0,0,5,0,5
2003,Mauritius,MUS,United Kingdom of Great Britain and Northern Ireland,GBR,0,0,12,0,12
2003,Myanmar,MMR,United Kingdom of Great Britain and Northern Ireland,GBR,34,10,106,15,165
2003,Nepal,NPL,United Kingdom of Great Britain and Northern Ireland,GBR,0,5,261,37,303
2003,Niger,NER,United Kingdom of Great Britain and Northern Ireland,GBR,0,0,5,5,10
2003,Nigeria,NGA,United Kingdom of Great Britain and Northern Ireland,GBR,16,61,847,302,1226
2003,Oman,OMN,United Kingdom of Great Britain and Northern Ireland,GBR,0,0,5,0,5
2003,Pakistan,PAK,United Kingdom of Great Britain and Northern Ireland,GBR,167,73,2775,571,3586
2003,Paraguay,PRY,United Kingdom of Great Britain and Northern Ireland,GBR,0,0,0,5,5
2003,Peru,PER,United Kingdom of Great Britain and Northern Ireland,GBR,0,0,5,0,5
2003,Philippines,PHL,United Kingdom of Great Britain and Northern Ireland,GBR,0,0,14,5,19
2003,Poland,POL,United Kingdom of Great Britain and Northern Ireland,GBR,5,12,206,57,280
2003,Romania,ROU,United Kingdom of Great Britain and Northern Ireland,GBR,0,49,692,450,1191
2003,South Africa,ZAF,United Kingdom of Great Britain and Northern Ireland,GBR,0,5,265,41,311
2003,Russian Federation,RUS,United Kingdom of Great Britain and Northern Ireland,GBR,26,14,368,116,524
2003,Rwanda,RWA,United Kingdom of Great Britain and Northern Ireland,GBR,34,70,419,44,567
2003,Serbia and Kosovo: S/RES/1244 (1999),SRB,United Kingdom of Great Britain and Northern Ireland,GBR,42,349,2146,408,2945
2003,Senegal,SEN,United Kingdom of Great Britain and Northern Ireland,GBR,0,0,30,5,35
2003,Seychelles,SYC,United Kingdom of Great Britain and Northern Ireland,GBR,0,0,10,0,10
2003,Sierra Leone,SLE,United Kingdom of Great Britain and Northern Ireland,GBR,17,72,545,130,764
2003,Somalia,SOM,United Kingdom of Great Britain and Northern Ireland,GBR,2469,633,4843,749,8694
2003,Viet Nam,VNM,United Kingdom of Great Britain and Northern Ireland,GBR,12,198,670,355,1235
2003,Sudan,SDN,United Kingdom of Great Britain and Northern Ireland,GBR,139,24,604,138,905
2003,Slovakia,SVK,United Kingdom of Great Britain and Northern Ireland,GBR,0,0,28,20,48
2003,Slovenia,SVN,United Kingdom of Great Britain and Northern Ireland,GBR,0,0,5,0,5
2003,Eswatini,SWZ,United Kingdom of Great Britain and Northern Ireland,GBR,0,0,5,0,5
2003,Syrian Arab Rep.,SYR,United Kingdom of Great Britain and Northern Ireland,GBR,15,0,142,18,175
2003,United Rep. of Tanzania,TZA,United Kingdom of Great Britain and Northern Ireland,GBR,5,10,51,11,77
2003,Thailand,THA,United Kingdom of Great Britain and Northern Ireland,GBR,0,0,5,0,5
2003,Tajikistan,TJK,United Kingdom of Great Britain and Northern Ireland,GBR,0,0,5,0,5
2003,Turkmenistan,TKM,United Kingdom of Great Britain and Northern Ireland,GBR,5,0,17,0,22
2003,Togo,TGO,United Kingdom of Great Britain and Northern Ireland,GBR,13,10,78,16,117
2003,Trinidad and Tobago,TTO,United Kingdom of Great Britain and Northern Ireland,GBR,0,0,12,5,17
2003,Tunisia,TUN,United Kingdom of Great Britain and Northern Ireland,GBR,5,0,5,5,15
2003,Turkey,TUR,United Kingdom of Great Britain and Northern Ireland,GBR,129,146,3547,327,4149
2003,United Arab Emirates,ARE,United Kingdom of Great Britain and Northern Ireland,GBR,0,0,10,0,10
2003,Uganda,UGA,United Kingdom of Great Britain and Northern Ireland,GBR,31,169,596,97,893
2003,Ukraine,UKR,United Kingdom of Great Britain and Northern Ireland,GBR,0,10,319,89,418
2003,Uzbekistan,UZB,United Kingdom of Great Britain and Northern Ireland,GBR,0,0,16,10,26
2003,Venezuela (Bolivarian Republic of),VEN,United Kingdom of Great Britain and Northern Ireland,GBR,0,0,19,5,24
2003,Yemen,YEM,United Kingdom of Great Britain and Northern Ireland,GBR,12,18,138,30,198
2003,Zambia,ZMB,United Kingdom of Great Britain and Northern Ireland,GBR,10,0,12,5,27
2003,Zimbabwe,ZWE,United Kingdom of Great Britain and Northern Ireland,GBR,1070,36,3431,500,5037
2003,Stateless,XXA,United Kingdom of Great Britain and Northern Ireland,GBR,24,34,233,66,357
2003,Unknown ,,United Kingdom of Great Britain and Northern Ireland,GBR,0,0,15,12,27
2003,Chad,TCD,Ghana,GHA,0,0,0,5,5
2003,Dem. Rep. of the Congo,COD,Ghana,GHA,0,0,0,28,28
2003,Cote d'Ivoire,CIV,Ghana,GHA,0,0,0,3733,3733
2003,Liberia,LBR,Ghana,GHA,11525,0,0,0,11525
2003,Nigeria,NGA,Ghana,GHA,0,0,0,5,5
2003,Sierra Leone,SLE,Ghana,GHA,0,0,0,715,715
2003,Somalia,SOM,Ghana,GHA,0,0,0,5,5
2003,Sudan,SDN,Ghana,GHA,5,0,0,0,5
2003,Liberia,LBR,Guinea-Bissau,GNB,12,0,0,0,12
2003,Sierra Leone,SLE,Guinea-Bissau,GNB,5,0,21,0,26
2003,Unknown ,,Guinea-Bissau,GNB,10,0,0,0,10
2003,Afghanistan,AFG,Greece,GRC,0,0,524,5,529
2003,Albania,ALB,Greece,GRC,0,0,12,0,12
2003,Algeria,DZA,Greece,GRC,0,0,5,0,5
2003,Egypt,EGY,Greece,GRC,0,0,5,0,5
2003,Armenia,ARM,Greece,GRC,0,0,5,0,5
2003,Burundi,BDI,Greece,GRC,0,0,10,0,10
2003,Bangladesh,BGD,Greece,GRC,0,0,62,0,62
2003,Belarus,BLR,Greece,GRC,0,0,5,5,10
2003,Bosnia and Herzegovina,BIH,Greece,GRC,0,0,0,5,5
2003,China,CHN,Greece,GRC,0,0,26,0,26
2003,Dem. Rep. of the Congo,COD,Greece,GRC,0,0,17,5,22
2003,Eritrea,ERI,Greece,GRC,0,0,5,0,5
2003,Ethiopia,ETH,Greece,GRC,0,0,60,0,60
2003,Palestinian,PSE,Greece,GRC,0,0,91,0,91
2003,Georgia,GEO,Greece,GRC,0,0,22,0,22
2003,Ghana,GHA,Greece,GRC,0,0,5,0,5
2003,Cote d'Ivoire,CIV,Greece,GRC,0,0,5,0,5
2003,India,IND,Greece,GRC,0,0,72,0,72
2003,Iran (Islamic Rep. of),IRN,Greece,GRC,0,5,434,5,444
2003,Iraq,IRQ,Greece,GRC,0,16,1909,14,1939
2003,Liberia,LBR,Greece,GRC,0,0,11,0,11
2003,Lebanon,LBN,Greece,GRC,0,0,5,0,5
2003,Sri Lanka,LKA,Greece,GRC,0,0,36,0,36
2003,Rep. of Moldova,MDA,Greece,GRC,0,0,5,5,10
2003,Myanmar,MMR,Greece,GRC,0,0,136,0,136
2003,Nigeria,NGA,Greece,GRC,0,0,209,10,219
2003,Pakistan,PAK,Greece,GRC,0,0,285,5,290
2003,Russian Federation,RUS,Greece,GRC,0,0,30,15,45
2003,Rwanda,RWA,Greece,GRC,0,0,29,0,29
2003,Sierra Leone,SLE,Greece,GRC,0,0,55,0,55
2003,Somalia,SOM,Greece,GRC,0,0,90,0,90
2003,Sudan,SDN,Greece,GRC,0,0,128,0,128
2003,Syrian Arab Rep.,SYR,Greece,GRC,0,0,11,0,11
2003,Turkey,TUR,Greece,GRC,0,0,165,45,210
2003,Ukraine,UKR,Greece,GRC,0,0,5,0,5
2003,Uzbekistan,UZB,Greece,GRC,0,0,34,5,39
2003,Colombia,COL,Guatemala,GTM,0,0,0,5,5
2003,Nicaragua,NIC,Guatemala,GTM,0,0,5,0,5
2003,Dem. Rep. of the Congo,COD,Guinea,GIN,5,0,5,0,10
2003,Cuba,CUB,Guinea,GIN,10,0,0,0,10
2003,Cote d'Ivoire,CIV,Guinea,GIN,224,0,35,0,259
2003,Liberia,LBR,Guinea,GIN,417,0,72,0,489
2003,Nigeria,NGA,Guinea,GIN,5,0,0,0,5
2003,Sierra Leone,SLE,Guinea,GIN,1863,0,132,0,1995
2003,Colombia,COL,Honduras,HND,0,0,5,0,5
2003,Cuba,CUB,Honduras,HND,0,0,41,24,65
2003,Ethiopia,ETH,Honduras,HND,5,0,0,0,5
2003,Bosnia and Herzegovina,BIH,Croatia,HRV,0,0,0,5,5
2003,Palestinian,PSE,Croatia,HRV,0,0,0,10,10
2003,Iraq,IRQ,Croatia,HRV,0,0,0,5,5
2003,Liberia,LBR,Croatia,HRV,0,0,0,14,14
2003,Nigeria,NGA,Croatia,HRV,0,0,5,5,10
2003,Serbia and Kosovo: S/RES/1244 (1999),SRB,Croatia,HRV,0,0,0,10,10
2003,Afghanistan,AFG,Hungary,HUN,28,359,26,266,679
2003,Algeria,DZA,Hungary,HUN,0,13,35,23,71
2003,Angola,AGO,Hungary,HUN,5,0,0,0,5
2003,Egypt,EGY,Hungary,HUN,0,0,5,16,21
2003,Armenia,ARM,Hungary,HUN,10,5,21,17,53
2003,Azerbaijan,AZE,Hungary,HUN,0,0,10,0,10
2003,Bangladesh,BGD,Hungary,HUN,0,0,32,23,55
2003,Belarus,BLR,Hungary,HUN,0,0,5,0,5
2003,China,CHN,Hungary,HUN,0,0,70,12,82
2003,Cameroon,CMR,Hungary,HUN,0,0,0,5,5
2003,Dem. Rep. of the Congo,COD,Hungary,HUN,0,0,0,5,5
2003,Palestinian,PSE,Hungary,HUN,0,5,5,19,29
2003,Georgia,GEO,Hungary,HUN,14,17,68,131,230
2003,Ghana,GHA,Hungary,HUN,0,0,0,5,5
2003,India,IND,Hungary,HUN,0,0,37,34,71
2003,Iran (Islamic Rep. of),IRN,Hungary,HUN,10,47,43,84,184
2003,Iraq,IRQ,Hungary,HUN,33,208,77,364,682
2003,Liberia,LBR,Hungary,HUN,0,0,10,11,21
2003,Libya,LBY,Hungary,HUN,0,0,5,0,5
2003,Sri Lanka,LKA,Hungary,HUN,0,5,0,5,10
2003,North Macedonia,MKD,Hungary,HUN,0,0,10,5,15
2003,Rep. of Moldova,MDA,Hungary,HUN,0,0,10,10,20
2003,Mongolia,MNG,Hungary,HUN,0,0,5,0,5
2003,Nigeria,NGA,Hungary,HUN,0,5,45,16,66
2003,Pakistan,PAK,Hungary,HUN,0,0,21,28,49
2003,Poland,POL,Hungary,HUN,0,0,5,0,5
2003,Romania,ROU,Hungary,HUN,5,0,11,0,16
2003,Russian Federation,RUS,Hungary,HUN,10,43,18,30,101
2003,Serbia and Kosovo: S/RES/1244 (1999),SRB,Hungary,HUN,19,0,71,33,123
2003,Senegal,SEN,Hungary,HUN,0,0,5,12,17
2003,Sierra Leone,SLE,Hungary,HUN,0,0,5,5,10
2003,Somalia,SOM,Hungary,HUN,0,24,5,110,139
2003,Viet Nam,VNM,Hungary,HUN,0,0,44,10,54
2003,Sudan,SDN,Hungary,HUN,10,12,10,31,63
2003,Slovakia,SVK,Hungary,HUN,0,0,5,5,10
2003,Syrian Arab Rep.,SYR,Hungary,HUN,0,5,5,5,15
2003,Tunisia,TUN,Hungary,HUN,0,0,0,5,5
2003,Turkey,TUR,Hungary,HUN,10,5,21,87,123
2003,Ukraine,UKR,Hungary,HUN,5,0,5,5,15
2003,Uzbekistan,UZB,Hungary,HUN,5,0,0,0,5
2003,Stateless,XXA,Hungary,HUN,10,0,0,10,20
2003,Unknown ,,Hungary,HUN,5,0,14,0,19
2003,Albania,ALB,Iceland,ISL,0,0,10,5,15
2003,Belarus,BLR,Iceland,ISL,0,0,5,0,5
2003,China,CHN,Iceland,ISL,0,0,0,5,5
2003,Mongolia,MNG,Iceland,ISL,0,0,5,0,5
2003,Poland,POL,Iceland,ISL,0,0,0,5,5
2003,Romania,ROU,Iceland,ISL,0,0,20,5,25
2003,Russian Federation,RUS,Iceland,ISL,0,0,5,0,5
2003,Slovakia,SVK,Iceland,ISL,0,5,0,0,5
2003,Afghanistan,AFG,Ireland,IRL,0,0,0,10,10
2003,Albania,ALB,Ireland,IRL,11,0,86,24,121
2003,Algeria,DZA,Ireland,IRL,0,0,60,19,79
2003,Angola,AGO,Ireland,IRL,26,0,89,0,115
2003,Armenia,ARM,Ireland,IRL,0,0,5,0,5
2003,Burundi,BDI,Ireland,IRL,5,0,5,5,15
2003,Benin,BEN,Ireland,IRL,0,0,5,0,5
2003,Bangladesh,BGD,Ireland,IRL,0,0,5,5,10
2003,Belarus,BLR,Ireland,IRL,0,0,21,39,60
2003,Bosnia and Herzegovina,BIH,Ireland,IRL,5,0,5,0,10
2003,Bulgaria,BGR,Ireland,IRL,0,0,27,12,39
2003,China,CHN,Ireland,IRL,14,0,25,81,120
2003,Cameroon,CMR,Ireland,IRL,5,0,99,0,104
2003,Congo,COG,Ireland,IRL,0,0,5,0,5
2003,Dem. Rep. of the Congo,COD,Ireland,IRL,12,0,157,17,186
2003,Czechia,CZE,Ireland,IRL,0,0,202,41,243
2003,Eritrea,ERI,Ireland,IRL,5,0,0,0,5
2003,Estonia,EST,Ireland,IRL,0,0,35,5,40
2003,Gambia,GMB,Ireland,IRL,0,0,5,5,10
2003,Palestinian,PSE,Ireland,IRL,10,0,10,11,31
2003,United Kingdom of Great Britain and Northern Ireland,GBR,Ireland,IRL,10,0,0,0,10
2003,Georgia,GEO,Ireland,IRL,5,0,57,5,67
2003,Ghana,GHA,Ireland,IRL,0,0,187,35,222
2003,Guinea,GIN,Ireland,IRL,5,0,5,5,15
2003,Croatia,HRV,Ireland,IRL,10,0,145,13,168
2003,Hungary,HUN,Ireland,IRL,5,0,5,5,15
2003,Cote d'Ivoire,CIV,Ireland,IRL,5,0,43,5,53
2003,India,IND,Ireland,IRL,0,0,5,20,25
2003,Iran (Islamic Rep. of),IRN,Ireland,IRL,10,0,10,10,30
2003,Iraq,IRQ,Ireland,IRL,11,0,10,13,34
2003,Israel,ISR,Ireland,IRL,0,0,53,5,58
2003,Jamaica,JAM,Ireland,IRL,0,0,12,0,12
2003,Jordan,JOR,Ireland,IRL,0,0,5,0,5
2003,Kazakhstan,KAZ,Ireland,IRL,0,0,38,0,38
2003,Kenya,KEN,Ireland,IRL,0,0,60,5,65
2003,Kyrgyzstan,KGZ,Ireland,IRL,0,0,5,0,5
2003,Liberia,LBR,Ireland,IRL,5,0,36,10,51
2003,Libya,LBY,Ireland,IRL,0,0,5,5,10
2003,Lebanon,LBN,Ireland,IRL,0,0,5,10,15
2003,Sri Lanka,LKA,Ireland,IRL,0,0,0,5,5
2003,Lithuania,LTU,Ireland,IRL,0,0,127,42,169
2003,Latvia,LVA,Ireland,IRL,0,0,20,18,38
2003,North Macedonia,MKD,Ireland,IRL,0,0,10,0,10
2003,Rep. of Moldova,MDA,Ireland,IRL,12,0,227,370,609
2003,Malawi,MWI,Ireland,IRL,0,0,5,5,10
2003,Mongolia,MNG,Ireland,IRL,0,0,5,5,10
2003,Morocco,MAR,Ireland,IRL,0,0,10,0,10
2003,Niger,NER,Ireland,IRL,0,0,5,0,5
2003,Nigeria,NGA,Ireland,IRL,21,0,1789,395,2205
2003,Pakistan,PAK,Ireland,IRL,17,0,49,32,98
2003,Philippines,PHL,Ireland,IRL,0,0,5,0,5
2003,Poland,POL,Ireland,IRL,0,0,128,34,162
2003,Romania,ROU,Ireland,IRL,5,0,801,792,1598
2003,South Africa,ZAF,Ireland,IRL,5,0,112,21,138
2003,Russian Federation,RUS,Ireland,IRL,5,0,89,35,129
2003,Rwanda,RWA,Ireland,IRL,0,0,5,5,10
2003,Serbia and Kosovo: S/RES/1244 (1999),SRB,Ireland,IRL,5,0,65,34,104
2003,Sierra Leone,SLE,Ireland,IRL,0,0,43,26,69
2003,Somalia,SOM,Ireland,IRL,24,0,31,12,67
2003,Sudan,SDN,Ireland,IRL,16,0,31,5,52
2003,Slovakia,SVK,Ireland,IRL,0,0,21,5,26
2003,Eswatini,SWZ,Ireland,IRL,0,0,5,0,5
2003,Syrian Arab Rep.,SYR,Ireland,IRL,5,0,5,5,15
2003,Togo,TGO,Ireland,IRL,5,0,51,0,56
2003,Turkey,TUR,Ireland,IRL,0,0,11,5,16
2003,Uganda,UGA,Ireland,IRL,5,0,10,0,15
2003,Ukraine,UKR,Ireland,IRL,10,0,118,68,196
2003,Uzbekistan,UZB,Ireland,IRL,0,0,5,0,5
2003,Zimbabwe,ZWE,Ireland,IRL,47,0,94,10,151
2003,Stateless,XXA,Ireland,IRL,0,0,22,13,35
2003,Afghanistan,AFG,Japan,JPN,0,0,5,0,5
2003,Bangladesh,BGD,Japan,JPN,0,0,10,0,10
2003,China,CHN,Japan,JPN,0,0,32,0,32
2003,Cameroon,CMR,Japan,JPN,0,0,18,5,23
2003,Colombia,COL,Japan,JPN,0,0,5,0,5
2003,Gambia,GMB,Japan,JPN,0,0,5,0,5
2003,Guinea,GIN,Japan,JPN,0,0,5,0,5
2003,Cote d'Ivoire,CIV,Japan,JPN,0,0,5,0,5
2003,India,IND,Japan,JPN,0,0,10,0,10
2003,Iran (Islamic Rep. of),IRN,Japan,JPN,0,0,20,5,25
2003,Sri Lanka,LKA,Japan,JPN,0,0,5,0,5
2003,Myanmar,MMR,Japan,JPN,5,0,73,0,78
2003,Nigeria,NGA,Japan,JPN,0,0,5,0,5
2003,Pakistan,PAK,Japan,JPN,0,0,21,0,21
2003,Turkey,TUR,Japan,JPN,0,0,65,5,70
2003,Afghanistan,AFG,Kazakhstan,KAZ,16,0,21,0,37
2003,Afghanistan,AFG,Kyrgyzstan,KGZ,20,0,49,0,69
2003,China,CHN,Kyrgyzstan,KGZ,5,5,0,0,10
2003,Ethiopia,ETH,Kyrgyzstan,KGZ,0,0,13,0,13
2003,Russian Federation,RUS,Kyrgyzstan,KGZ,0,0,0,138,138
2003,Cameroon,CMR,Rep. of Korea,KOR,5,0,0,0,5
2003,Myanmar,MMR,Rep. of Korea,KOR,5,0,0,0,5
2003,Bosnia and Herzegovina,BIH,Liechtenstein,LIE,0,0,5,0,5
2003,Bulgaria,BGR,Liechtenstein,LIE,0,0,0,5,5
2003,North Macedonia,MKD,Liechtenstein,LIE,0,0,40,16,56
2003,Russian Federation,RUS,Liechtenstein,LIE,0,0,5,5,10
2003,Serbia and Kosovo: S/RES/1244 (1999),SRB,Liechtenstein,LIE,0,12,28,11,51
2003,Ukraine,UKR,Liechtenstein,LIE,0,0,5,0,5
2003,Afghanistan,AFG,Lithuania,LTU,0,5,0,22,27
2003,India,IND,Lithuania,LTU,0,0,5,0,5
2003,Iraq,IRQ,Lithuania,LTU,0,0,0,5,5
2003,Pakistan,PAK,Lithuania,LTU,0,0,5,0,5
2003,Russian Federation,RUS,Lithuania,LTU,0,23,10,193,226
2003,Turkey,TUR,Lithuania,LTU,0,0,11,0,11
2003,Stateless,XXA,Lithuania,LTU,0,0,0,5,5
2003,Unknown ,,Luxembourg,LUX,62,149,690,306,1207
2003,Georgia,GEO,Latvia,LVA,0,0,5,0,5
2003,Russian Federation,RUS,Latvia,LVA,0,5,0,0,5
2003,Serbia and Kosovo: S/RES/1244 (1999),SRB,North Macedonia,MKD,0,0,50,10,60
2003,Afghanistan,AFG,Rep. of Moldova,MDA,0,0,0,5,5
2003,Georgia,GEO,Rep. of Moldova,MDA,0,0,0,5,5
2003,Russian Federation,RUS,Rep. of Moldova,MDA,0,0,0,10,10
2003,Tajikistan,TJK,Rep. of Moldova,MDA,0,0,0,10,10
2003,Albania,ALB,Mexico,MEX,0,0,5,5,10
2003,Armenia,ARM,Mexico,MEX,0,0,0,5,5
2003,Bangladesh,BGD,Mexico,MEX,0,0,5,5,10
2003,China,CHN,Mexico,MEX,0,0,5,0,5
2003,Dem. Rep. of the Congo,COD,Mexico,MEX,5,0,0,0,5
2003,Colombia,COL,Mexico,MEX,13,0,20,16,49
2003,Cuba,CUB,Mexico,MEX,0,0,5,10,15
2003,Ethiopia,ETH,Mexico,MEX,5,0,5,0,10
2003,Guatemala,GTM,Mexico,MEX,0,0,47,5,52
2003,Honduras,HND,Mexico,MEX,10,0,11,12,33
2003,Cote d'Ivoire,CIV,Mexico,MEX,5,0,0,0,5
2003,Iraq,IRQ,Mexico,MEX,0,0,0,5,5
2003,Nigeria,NGA,Mexico,MEX,0,0,10,0,10
2003,El Salvador,SLV,Mexico,MEX,0,0,5,0,5
2003,United States of America,USA,Mexico,MEX,0,0,5,0,5
2003,Burundi,BDI,Mali,MLI,5,0,0,0,5
2003,Dem. Rep. of the Congo,COD,Mali,MLI,0,0,5,0,5
2003,Cote d'Ivoire,CIV,Mali,MLI,405,0,0,0,405
2003,Liberia,LBR,Mali,MLI,15,0,0,0,15
2003,Mauritania,MRT,Mali,MLI,27,0,0,0,27
2003,Rwanda,RWA,Mali,MLI,5,0,0,0,5
2003,Sierra Leone,SLE,Mali,MLI,15,0,5,0,20
2003,Togo,TGO,Mali,MLI,5,0,0,0,5
2003,Unknown ,,Mali,MLI,5,0,0,0,5
2003,Burundi,BDI,Malawi,MWI,263,0,0,615,878
2003,Dem. Rep. of the Congo,COD,Malawi,MWI,389,0,5,377,771
2003,Rwanda,RWA,Malawi,MWI,705,0,5,1052,1762
2003,Somalia,SOM,Malawi,MWI,41,0,0,14,55
2003,Sudan,SDN,Malawi,MWI,0,0,0,5,5
2003,Unknown ,,Malawi,MWI,5,0,0,5,10
2003,Burundi,BDI,Mozambique,MOZ,33,0,0,10,43
2003,Dem. Rep. of the Congo,COD,Mozambique,MOZ,75,0,0,25,100
2003,Rwanda,RWA,Mozambique,MOZ,5,0,0,5,10
2003,Algeria,DZA,Malta,MLT,0,0,5,0,5
2003,Chad,TCD,Malta,MLT,0,0,5,0,5
2003,Dem. Rep. of the Congo,COD,Malta,MLT,18,44,5,0,67
2003,Eritrea,ERI,Malta,MLT,15,10,14,0,39
2003,Ethiopia,ETH,Malta,MLT,5,10,30,0,45
2003,Palestinian,PSE,Malta,MLT,0,0,10,0,10
2003,Guinea,GIN,Malta,MLT,0,0,5,0,5
2003,Cote d'Ivoire,CIV,Malta,MLT,0,17,25,0,42
2003,Iraq,IRQ,Malta,MLT,0,5,5,10,20
2003,Liberia,LBR,Malta,MLT,0,0,65,0,65
2003,Libya,LBY,Malta,MLT,0,0,0,5,5
2003,North Macedonia,MKD,Malta,MLT,0,0,10,0,10
2003,Mali,MLI,Malta,MLT,0,0,5,0,5
2003,Somalia,SOM,Malta,MLT,5,163,5,0,173
2003,Sudan,SDN,Malta,MLT,0,20,5,0,25
2003,Turkey,TUR,Malta,MLT,0,0,10,0,10
2003,Burundi,BDI,Namibia,NAM,13,0,0,5,18
2003,Congo,COG,Namibia,NAM,5,0,0,0,5
2003,Dem. Rep. of the Congo,COD,Namibia,NAM,18,0,0,33,51
2003,Oman,OMN,Namibia,NAM,0,0,0,5,5
2003,Rwanda,RWA,Namibia,NAM,0,0,0,5,5
2003,Sierra Leone,SLE,Namibia,NAM,0,0,0,5,5
2003,Sudan,SDN,Namibia,NAM,0,0,0,5,5
2003,United Rep. of Tanzania,TZA,Namibia,NAM,0,0,0,5,5
2003,Afghanistan,AFG,Netherlands,NLD,93,504,2458,280,3335
2003,Albania,ALB,Netherlands,NLD,0,0,30,14,44
2003,Algeria,DZA,Netherlands,NLD,0,0,85,35,120
2003,Angola,AGO,Netherlands,NLD,10,186,936,132,1264
2003,Egypt,EGY,Netherlands,NLD,0,0,29,5,34
2003,Armenia,ARM,Netherlands,NLD,10,55,318,40,423
2003,Azerbaijan,AZE,Netherlands,NLD,21,88,383,62,554
2003,Burundi,BDI,Netherlands,NLD,0,239,126,39,404
2003,Belgium,BEL,Netherlands,NLD,0,0,0,5,5
2003,Benin,BEN,Netherlands,NLD,0,5,59,0,64
2003,Bangladesh,BGD,Netherlands,NLD,0,0,18,5,23
2003,Bhutan,BTN,Netherlands,NLD,0,0,5,0,5
2003,Burkina Faso,BFA,Netherlands,NLD,0,0,5,0,5
2003,Belarus,BLR,Netherlands,NLD,5,5,66,12,88
2003,Bosnia and Herzegovina,BIH,Netherlands,NLD,0,28,171,22,221
2003,Bulgaria,BGR,Netherlands,NLD,0,0,11,5,16
2003,Chad,TCD,Netherlands,NLD,0,5,5,0,10
2003,China,CHN,Netherlands,NLD,5,13,373,65,456
2003,Cameroon,CMR,Netherlands,NLD,5,12,137,10,164
2003,Congo,COG,Netherlands,NLD,10,50,180,22,262
2003,Dem. Rep. of the Congo,COD,Netherlands,NLD,5,43,294,37,379
2003,Colombia,COL,Netherlands,NLD,5,5,15,13,38
2003,Cuba,CUB,Netherlands,NLD,0,0,10,5,15
2003,Czechia,CZE,Netherlands,NLD,0,0,21,5,26
2003,Ecuador,ECU,Netherlands,NLD,0,0,5,0,5
2003,Eritrea,ERI,Netherlands,NLD,5,21,95,14,135
2003,Ethiopia,ETH,Netherlands,NLD,0,20,137,10,167
2003,France,FRA,Netherlands,NLD,0,0,5,5,10
2003,Gambia,GMB,Netherlands,NLD,0,0,5,0,5
2003,Palestinian,PSE,Netherlands,NLD,0,0,5,0,5
2003,Georgia,GEO,Netherlands,NLD,0,16,143,13,172
2003,Ghana,GHA,Netherlands,NLD,0,0,33,5,38
2003,Guinea-Bissau,GNB,Netherlands,NLD,0,0,11,5,16
2003,Guinea,GIN,Netherlands,NLD,5,50,373,26,454
2003,Croatia,HRV,Netherlands,NLD,0,0,13,5,18
2003,Hungary,HUN,Netherlands,NLD,0,0,11,0,11
2003,Cote d'Ivoire,CIV,Netherlands,NLD,10,30,224,21,285
2003,India,IND,Netherlands,NLD,0,0,128,32,160
2003,Indonesia,IDN,Netherlands,NLD,0,5,5,0,10
2003,Iran (Islamic Rep. of),IRN,Netherlands,NLD,45,125,523,99,792
2003,Iraq,IRQ,Netherlands,NLD,10,1579,523,463,2575
2003,Israel,ISR,Netherlands,NLD,0,0,5,5,10
2003,Jordan,JOR,Netherlands,NLD,0,0,10,0,10
2003,Japan,JPN,Netherlands,NLD,0,0,5,0,5
2003,Kazakhstan,KAZ,Netherlands,NLD,0,5,40,10,55
2003,Kenya,KEN,Netherlands,NLD,0,0,10,0,10
2003,Kyrgyzstan,KGZ,Netherlands,NLD,0,0,29,0,29
2003,Dem. People's Rep. of Korea,PRK,Netherlands,NLD,0,5,0,0,5
2003,Liberia,LBR,Netherlands,NLD,10,19,274,39,342
2003,Libya,LBY,Netherlands,NLD,5,5,52,10,72
2003,Lebanon,LBN,Netherlands,NLD,0,5,41,5,51
2003,Sri Lanka,LKA,Netherlands,NLD,0,19,126,23,168
2003,Lithuania,LTU,Netherlands,NLD,0,0,5,0,5
2003,Latvia,LVA,Netherlands,NLD,0,0,5,0,5
2003,Mauritania,MRT,Netherlands,NLD,0,5,32,5,42
2003,North Macedonia,MKD,Netherlands,NLD,5,0,32,10,47
2003,Rep. of Moldova,MDA,Netherlands,NLD,0,0,22,5,27
2003,Mali,MLI,Netherlands,NLD,0,0,5,0,5
2003,Mongolia,MNG,Netherlands,NLD,0,5,224,28,257
2003,Morocco,MAR,Netherlands,NLD,0,0,29,11,40
2003,Myanmar,MMR,Netherlands,NLD,0,0,22,5,27
2003,Nepal,NPL,Netherlands,NLD,0,0,59,5,64
2003,Netherlands,NLD,Netherlands,NLD,0,0,0,5,5
2003,Niger,NER,Netherlands,NLD,0,10,138,5,153
2003,Nicaragua,NIC,Netherlands,NLD,0,0,5,0,5
2003,Nigeria,NGA,Netherlands,NLD,0,10,406,51,467
2003,Pakistan,PAK,Netherlands,NLD,0,10,64,10,84
2003,Peru,PER,Netherlands,NLD,0,0,5,0,5
2003,Poland,POL,Netherlands,NLD,0,0,10,5,15
2003,Portugal,PRT,Netherlands,NLD,0,0,5,0,5
2003,Romania,ROU,Netherlands,NLD,0,5,27,10,42
2003,Russian Federation,RUS,Netherlands,NLD,17,91,303,71,482
2003,Rwanda,RWA,Netherlands,NLD,5,24,106,23,158
2003,Saudi Arabia,SAU,Netherlands,NLD,0,0,5,0,5
2003,Serbia and Kosovo: S/RES/1244 (1999),SRB,Netherlands,NLD,0,86,385,77,548
2003,Senegal,SEN,Netherlands,NLD,0,0,5,0,5
2003,Sierra Leone,SLE,Netherlands,NLD,0,177,1138,99,1414
2003,Somalia,SOM,Netherlands,NLD,13,142,461,99,715
2003,Viet Nam,VNM,Netherlands,NLD,0,0,58,0,58
2003,Sudan,SDN,Netherlands,NLD,5,96,398,49,548
2003,Suriname,SUR,Netherlands,NLD,0,0,5,0,5
2003,Slovakia,SVK,Netherlands,NLD,0,5,112,33,150
2003,Syrian Arab Rep.,SYR,Netherlands,NLD,22,63,277,39,401
2003,United Rep. of Tanzania,TZA,Netherlands,NLD,0,0,5,5,10
2003,Tajikistan,TJK,Netherlands,NLD,0,0,24,5,29
2003,Togo,TGO,Netherlands,NLD,0,14,189,10,213
2003,Tunisia,TUN,Netherlands,NLD,0,0,10,0,10
2003,Turkey,TUR,Netherlands,NLD,19,46,379,92,536
2003,Uganda,UGA,Netherlands,NLD,0,0,21,5,26
2003,Ukraine,UKR,Netherlands,NLD,0,5,78,26,109
2003,United States of America,USA,Netherlands,NLD,0,0,5,0,5
2003,Uzbekistan,UZB,Netherlands,NLD,5,13,53,10,81
2003,Venezuela (Bolivarian Republic of),VEN,Netherlands,NLD,0,0,0,5,5
2003,Yemen,YEM,Netherlands,NLD,0,5,22,0,27
2003,Zimbabwe,ZWE,Netherlands,NLD,0,0,10,0,10
2003,Stateless,XXA,Netherlands,NLD,5,28,291,50,374
2003,Unknown ,,Netherlands,NLD,17,220,555,108,900
2003,Colombia,COL,Nicaragua,NIC,0,0,0,5,5
2003,Cuba,CUB,Nicaragua,NIC,0,0,0,5,5
2003,Congo,COG,Nigeria,NGA,5,0,0,0,5
2003,Dem. Rep. of the Congo,COD,Nigeria,NGA,57,0,5,0,62
2003,Ethiopia,ETH,Nigeria,NGA,5,0,0,0,5
2003,Liberia,LBR,Nigeria,NGA,1887,0,0,0,1887
2003,Sierra Leone,SLE,Nigeria,NGA,0,0,5,0,5
2003,Sudan,SDN,Nigeria,NGA,27,0,5,0,32
2003,Afghanistan,AFG,Norway,NOR,81,873,412,256,1622
2003,Albania,ALB,Norway,NOR,0,0,247,71,318
2003,Algeria,DZA,Norway,NOR,0,10,243,128,381
2003,Angola,AGO,Norway,NOR,0,20,10,11,41
2003,Egypt,EGY,Norway,NOR,0,0,5,5,10
2003,Armenia,ARM,Norway,NOR,0,0,80,34,114
2003,Azerbaijan,AZE,Norway,NOR,0,0,103,48,151
2003,Burundi,BDI,Norway,NOR,17,56,5,0,78
2003,Benin,BEN,Norway,NOR,0,0,5,5,10
2003,Bangladesh,BGD,Norway,NOR,0,0,53,12,65
2003,Belarus,BLR,Norway,NOR,0,5,269,133,407
2003,Bosnia and Herzegovina,BIH,Norway,NOR,0,10,372,556,938
2003,Bulgaria,BGR,Norway,NOR,0,0,84,29,113
2003,China,CHN,Norway,NOR,34,19,44,21,118
2003,Cameroon,CMR,Norway,NOR,0,5,70,10,85
2003,Congo,COG,Norway,NOR,5,5,14,5,29
2003,Dem. Rep. of the Congo,COD,Norway,NOR,0,0,16,5,21
2003,Colombia,COL,Norway,NOR,0,5,5,0,10
2003,Czechia,CZE,Norway,NOR,0,0,117,11,128
2003,Eritrea,ERI,Norway,NOR,0,33,253,20,306
2003,Estonia,EST,Norway,NOR,0,0,5,0,5
2003,Ethiopia,ETH,Norway,NOR,46,35,340,28,449
2003,United Kingdom of Great Britain and Northern Ireland,GBR,Norway,NOR,0,0,5,0,5
2003,Georgia,GEO,Norway,NOR,0,0,207,85,292
2003,Guatemala,GTM,Norway,NOR,0,0,5,0,5
2003,Guinea,GIN,Norway,NOR,0,0,21,10,31
2003,Croatia,HRV,Norway,NOR,0,0,54,5,59
2003,Hungary,HUN,Norway,NOR,0,0,5,0,5
2003,Cote d'Ivoire,CIV,Norway,NOR,0,0,5,5,10
2003,India,IND,Norway,NOR,0,0,39,0,39
2003,Indonesia,IDN,Norway,NOR,0,0,0,5,5
2003,Iran (Islamic Rep. of),IRN,Norway,NOR,92,22,341,90,545
2003,Iraq,IRQ,Norway,NOR,10,137,68,234,449
2003,Israel,ISR,Norway,NOR,0,0,68,10,78
2003,Jordan,JOR,Norway,NOR,0,0,21,10,31
2003,Kazakhstan,KAZ,Norway,NOR,0,0,53,41,94
2003,Kenya,KEN,Norway,NOR,0,0,5,0,5
2003,Kyrgyzstan,KGZ,Norway,NOR,0,0,63,30,93
2003,Liberia,LBR,Norway,NOR,0,5,38,0,43
2003,Libya,LBY,Norway,NOR,5,13,145,49,212
2003,Lebanon,LBN,Norway,NOR,0,0,14,21,35
2003,Sri Lanka,LKA,Norway,NOR,0,32,57,13,102
2003,Lithuania,LTU,Norway,NOR,0,0,22,10,32
2003,Latvia,LVA,Norway,NOR,0,0,10,0,10
2003,Mauritania,MRT,Norway,NOR,0,0,0,5,5
2003,North Macedonia,MKD,Norway,NOR,0,0,192,131,323
2003,Rep. of Moldova,MDA,Norway,NOR,0,0,88,23,111
2003,Mali,MLI,Norway,NOR,0,0,5,0,5
2003,Malawi,MWI,Norway,NOR,5,0,0,0,5
2003,Mongolia,MNG,Norway,NOR,0,5,127,37,169
2003,Morocco,MAR,Norway,NOR,0,0,11,5,16
2003,Myanmar,MMR,Norway,NOR,0,10,0,0,10
2003,Nepal,NPL,Norway,NOR,0,0,80,10,90
2003,Niger,NER,Norway,NOR,0,5,80,5,90
2003,Nigeria,NGA,Norway,NOR,0,0,128,47,175
2003,Pakistan,PAK,Norway,NOR,0,5,167,18,190
2003,Poland,POL,Norway,NOR,0,0,33,5,38
2003,Romania,ROU,Norway,NOR,0,0,182,42,224
2003,Russian Federation,RUS,Norway,NOR,139,580,550,379,1648
2003,Rwanda,RWA,Norway,NOR,5,10,63,0,78
2003,El Salvador,SLV,Norway,NOR,0,5,0,5,10
2003,Serbia and Kosovo: S/RES/1244 (1999),SRB,Norway,NOR,54,62,1868,947,2931
2003,Senegal,SEN,Norway,NOR,0,0,5,0,5
2003,Sierra Leone,SLE,Norway,NOR,0,0,17,5,22
2003,Somalia,SOM,Norway,NOR,5,891,89,231,1216
2003,Spain,ESP,Norway,NOR,0,0,0,5,5
2003,Viet Nam,VNM,Norway,NOR,0,0,54,12,66
2003,Sudan,SDN,Norway,NOR,0,5,54,12,71
2003,Slovakia,SVK,Norway,NOR,0,0,74,14,88
2003,Slovenia,SVN,Norway,NOR,0,0,5,0,5
2003,Tajikistan,TJK,Norway,NOR,0,0,29,0,29
2003,Turkmenistan,TKM,Norway,NOR,0,0,5,5,10
2003,Togo,TGO,Norway,NOR,0,0,13,5,18
2003,Tunisia,TUN,Norway,NOR,0,0,5,5,10
2003,Turkey,TUR,Norway,NOR,0,16,218,75,309
2003,Uganda,UGA,Norway,NOR,0,0,10,0,10
2003,Ukraine,UKR,Norway,NOR,0,0,91,43,134
2003,Uzbekistan,UZB,Norway,NOR,0,0,116,65,181
2003,Western Sahara,ESH,Norway,NOR,0,0,0,5,5
2003,Yemen,YEM,Norway,NOR,0,5,10,5,20
2003,Stateless,XXA,Norway,NOR,49,58,244,87,438
2003,Afghanistan,AFG,New Zealand,NZL,0,0,5,0,5
2003,Albania,ALB,New Zealand,NZL,0,0,5,0,5
2003,Algeria,DZA,New Zealand,NZL,5,0,10,0,15
2003,Egypt,EGY,New Zealand,NZL,0,0,5,0,5
2003,Bangladesh,BGD,New Zealand,NZL,0,0,29,0,29
2003,Bulgaria,BGR,New Zealand,NZL,0,0,5,0,5
2003,China,CHN,New Zealand,NZL,5,0,51,0,56
2003,Chile,CHL,New Zealand,NZL,5,0,14,0,19
2003,Dem. Rep. of the Congo,COD,New Zealand,NZL,0,0,10,0,10
2003,Colombia,COL,New Zealand,NZL,0,0,5,0,5
2003,Czechia,CZE,New Zealand,NZL,0,0,10,0,10
2003,Eritrea,ERI,New Zealand,NZL,0,0,5,0,5
2003,Ethiopia,ETH,New Zealand,NZL,5,0,0,0,5
2003,Fiji,FJI,New Zealand,NZL,0,0,12,0,12
2003,Hungary,HUN,New Zealand,NZL,0,0,67,0,67
2003,India,IND,New Zealand,NZL,0,0,100,0,100
2003,Indonesia,IDN,New Zealand,NZL,0,0,5,0,5
2003,Iran (Islamic Rep. of),IRN,New Zealand,NZL,52,0,55,0,107
2003,Iraq,IRQ,New Zealand,NZL,10,0,39,0,49
2003,Israel,ISR,New Zealand,NZL,0,0,10,0,10
2003,Kuwait,KWT,New Zealand,NZL,0,0,5,0,5
2003,Sri Lanka,LKA,New Zealand,NZL,10,0,25,0,35
2003,Malaysia,MYS,New Zealand,NZL,0,0,39,0,39
2003,Morocco,MAR,New Zealand,NZL,0,0,5,0,5
2003,Myanmar,MMR,New Zealand,NZL,0,0,5,0,5
2003,Nigeria,NGA,New Zealand,NZL,0,0,14,0,14
2003,Pakistan,PAK,New Zealand,NZL,0,0,18,0,18
2003,Peru,PER,New Zealand,NZL,0,0,5,0,5
2003,South Africa,ZAF,New Zealand,NZL,0,0,5,0,5
2003,Russian Federation,RUS,New Zealand,NZL,0,0,5,0,5
2003,Saudi Arabia,SAU,New Zealand,NZL,0,0,5,0,5
2003,Solomon Islands,SLB,New Zealand,NZL,0,0,5,0,5
2003,Somalia,SOM,New Zealand,NZL,13,0,5,0,18
2003,Viet Nam,VNM,New Zealand,NZL,0,0,5,0,5
2003,Thailand,THA,New Zealand,NZL,0,0,130,0,130
2003,Turkey,TUR,New Zealand,NZL,0,0,5,0,5
2003,United States of America,USA,New Zealand,NZL,0,0,5,0,5
2003,Zimbabwe,ZWE,New Zealand,NZL,48,0,55,0,103
2003,Colombia,COL,Panama,PAN,0,0,0,5,5
2003,Argentina,ARG,Peru,PER,0,0,0,5,5
2003,Colombia,COL,Peru,PER,19,0,0,53,72
2003,Cuba,CUB,Peru,PER,0,0,0,5,5
2003,Palestinian,PSE,Peru,PER,5,0,0,0,5
2003,Iraq,IRQ,Peru,PER,5,0,0,0,5
2003,Congo,COG,Philippines,PHL,5,0,0,0,5
2003,Sri Lanka,LKA,Philippines,PHL,5,0,0,5,10
2003,Turkey,TUR,Philippines,PHL,0,0,5,0,5
2003,Lebanon,LBN,Papua New Guinea,PNG,0,0,5,0,5
2003,Afghanistan,AFG,Poland,POL,5,0,410,5,420
2003,Algeria,DZA,Poland,POL,0,0,10,0,10
2003,Egypt,EGY,Poland,POL,0,0,5,0,5
2003,Armenia,ARM,Poland,POL,0,0,114,5,119
2003,Azerbaijan,AZE,Poland,POL,0,0,10,5,15
2003,Belarus,BLR,Poland,POL,14,0,27,12,53
2003,Bosnia and Herzegovina,BIH,Poland,POL,0,0,0,15,15
2003,Bulgaria,BGR,Poland,POL,0,0,10,5,15
2003,China,CHN,Poland,POL,0,0,14,0,14
2003,Czechia,CZE,Poland,POL,0,0,5,0,5
2003,Ethiopia,ETH,Poland,POL,0,0,5,0,5
2003,Palestinian,PSE,Poland,POL,0,0,5,0,5
2003,Georgia,GEO,Poland,POL,5,0,27,0,32
2003,India,IND,Poland,POL,0,0,215,0,215
2003,Iran (Islamic Rep. of),IRN,Poland,POL,0,0,11,0,11
2003,Iraq,IRQ,Poland,POL,0,0,145,0,145
2003,Jordan,JOR,Poland,POL,0,0,5,0,5
2003,Kyrgyzstan,KGZ,Poland,POL,0,0,5,5,10
2003,Lebanon,LBN,Poland,POL,0,0,5,0,5
2003,Sri Lanka,LKA,Poland,POL,0,0,35,0,35
2003,Latvia,LVA,Poland,POL,0,0,0,5,5
2003,Rep. of Moldova,MDA,Poland,POL,0,0,24,0,24
2003,Mongolia,MNG,Poland,POL,0,0,23,0,23
2003,Nigeria,NGA,Poland,POL,0,0,18,0,18
2003,Pakistan,PAK,Poland,POL,0,0,126,5,131
2003,Romania,ROU,Poland,POL,0,0,5,0,5
2003,Russian Federation,RUS,Poland,POL,185,20,1706,4520,6431
2003,Sierra Leone,SLE,Poland,POL,0,0,5,0,5
2003,Somalia,SOM,Poland,POL,0,0,5,0,5
2003,Viet Nam,VNM,Poland,POL,0,0,20,0,20
2003,Slovenia,SVN,Poland,POL,0,0,5,0,5
2003,Turkey,TUR,Poland,POL,0,0,18,0,18
2003,Ukraine,UKR,Poland,POL,0,0,50,18,68
2003,Uzbekistan,UZB,Poland,POL,0,0,0,5,5
2003,Stateless,XXA,Poland,POL,0,0,5,0,5
2003,Albania,ALB,Portugal,PRT,0,0,0,5,5
2003,Angola,AGO,Portugal,PRT,0,0,0,15,15
2003,Bulgaria,BGR,Portugal,PRT,0,0,0,5,5
2003,Dem. Rep. of the Congo,COD,Portugal,PRT,0,0,0,5,5
2003,Colombia,COL,Portugal,PRT,0,5,0,0,5
2003,Georgia,GEO,Portugal,PRT,0,0,0,5,5
2003,Liberia,LBR,Portugal,PRT,0,0,0,5,5
2003,Sri Lanka,LKA,Portugal,PRT,0,0,5,5,10
2003,Romania,ROU,Portugal,PRT,0,0,0,5,5
2003,Sierra Leone,SLE,Portugal,PRT,0,0,0,5,5
2003,Ukraine,UKR,Portugal,PRT,0,0,0,5,5
2003,Afghanistan,AFG,Romania,ROU,0,0,15,0,15
2003,Algeria,DZA,Romania,ROU,0,0,5,0,5
2003,China,CHN,Romania,ROU,0,0,122,16,138
2003,Cameroon,CMR,Romania,ROU,0,0,5,0,5
2003,Congo,COG,Romania,ROU,5,0,5,0,10
2003,Palestinian,PSE,Romania,ROU,0,0,10,0,10
2003,India,IND,Romania,ROU,0,0,140,0,140
2003,Iran (Islamic Rep. of),IRN,Romania,ROU,0,5,27,5,37
2003,Iraq,IRQ,Romania,ROU,22,20,163,16,221
2003,Jordan,JOR,Romania,ROU,0,0,5,5,10
2003,Liberia,LBR,Romania,ROU,0,0,5,0,5
2003,Lebanon,LBN,Romania,ROU,0,0,0,5,5
2003,Pakistan,PAK,Romania,ROU,0,0,18,0,18
2003,South Africa,ZAF,Romania,ROU,0,0,5,5,10
2003,Russian Federation,RUS,Romania,ROU,0,0,5,0,5
2003,Serbia and Kosovo: S/RES/1244 (1999),SRB,Romania,ROU,0,0,5,0,5
2003,Somalia,SOM,Romania,ROU,5,0,45,0,50
2003,Sudan,SDN,Romania,ROU,0,0,11,0,11
2003,Syrian Arab Rep.,SYR,Romania,ROU,0,0,10,0,10
2003,Turkey,TUR,Romania,ROU,0,0,26,5,31
2003,Stateless,XXA,Romania,ROU,0,0,10,0,10
2003,Angola,AGO,South Africa,ZAF,491,0,26,0,517
2003,Egypt,EGY,South Africa,ZAF,0,0,5,0,5
2003,Burundi,BDI,South Africa,ZAF,275,0,12,0,287
2003,Cameroon,CMR,South Africa,ZAF,5,0,10,0,15
2003,Congo,COG,South Africa,ZAF,126,0,10,0,136
2003,Dem. Rep. of the Congo,COD,South Africa,ZAF,1668,0,83,0,1751
2003,Ethiopia,ETH,South Africa,ZAF,11,0,25,0,36
2003,Ghana,GHA,South Africa,ZAF,0,0,15,0,15
2003,India,IND,South Africa,ZAF,0,0,5,0,5
2003,Kenya,KEN,South Africa,ZAF,0,0,36,0,36
2003,Kyrgyzstan,KGZ,South Africa,ZAF,5,0,0,0,5
2003,Liberia,LBR,South Africa,ZAF,19,0,0,0,19
2003,Malawi,MWI,South Africa,ZAF,0,0,23,0,23
2003,Nigeria,NGA,South Africa,ZAF,0,0,32,0,32
2003,Pakistan,PAK,South Africa,ZAF,0,0,46,0,46
2003,Rwanda,RWA,South Africa,ZAF,221,0,11,0,232
2003,Senegal,SEN,South Africa,ZAF,0,0,5,0,5
2003,Sierra Leone,SLE,South Africa,ZAF,0,0,5,0,5
2003,Somalia,SOM,South Africa,ZAF,389,0,59,0,448
2003,Sudan,SDN,South Africa,ZAF,25,0,0,0,25
2003,United Rep. of Tanzania,TZA,South Africa,ZAF,0,0,11,0,11
2003,Uganda,UGA,South Africa,ZAF,5,0,19,0,24
2003,Zambia,ZMB,South Africa,ZAF,5,0,0,0,5
2003,Zimbabwe,ZWE,South Africa,ZAF,10,0,16,0,26
2003,Unknown ,,South Africa,ZAF,15,0,545,0,560
2003,Afghanistan,AFG,Russian Federation,RUS,28,0,779,0,807
2003,Angola,AGO,Russian Federation,RUS,0,0,10,0,10
2003,Armenia,ARM,Russian Federation,RUS,0,0,5,0,5
2003,Azerbaijan,AZE,Russian Federation,RUS,0,0,36,0,36
2003,Ethiopia,ETH,Russian Federation,RUS,0,0,5,0,5
2003,Georgia,GEO,Russian Federation,RUS,5,0,39,0,44
2003,Iraq,IRQ,Russian Federation,RUS,0,0,14,0,14
2003,Kazakhstan,KAZ,Russian Federation,RUS,0,0,24,0,24
2003,Rep. of Moldova,MDA,Russian Federation,RUS,0,0,10,0,10
2003,Sierra Leone,SLE,Russian Federation,RUS,0,0,5,0,5
2003,Somalia,SOM,Russian Federation,RUS,0,0,5,0,5
2003,Tajikistan,TJK,Russian Federation,RUS,5,0,11,0,16
2003,Turkmenistan,TKM,Russian Federation,RUS,0,0,22,0,22
2003,Ukraine,UKR,Russian Federation,RUS,0,0,5,0,5
2003,Uzbekistan,UZB,Russian Federation,RUS,5,0,33,0,38
2003,Unknown ,,Russian Federation,RUS,5,0,15,0,20
2003,Bangladesh,BGD,El Salvador,SLV,0,0,5,0,5
2003,Colombia,COL,El Salvador,SLV,5,0,0,5,10
2003,Guatemala,GTM,El Salvador,SLV,0,0,5,0,5
2003,Central African Rep.,CAF,Senegal,SEN,0,0,10,0,10
2003,Chad,TCD,Senegal,SEN,0,0,5,0,5
2003,Cameroon,CMR,Senegal,SEN,0,0,5,0,5
2003,Congo,COG,Senegal,SEN,0,0,13,0,13
2003,Dem. Rep. of the Congo,COD,Senegal,SEN,0,0,33,0,33
2003,Guinea,GIN,Senegal,SEN,0,0,5,0,5
2003,Cote d'Ivoire,CIV,Senegal,SEN,5,0,11,0,16
2003,Liberia,LBR,Senegal,SEN,14,0,10,0,24
2003,Sri Lanka,LKA,Senegal,SEN,0,0,13,0,13
2003,Mauritania,MRT,Senegal,SEN,0,0,104,0,104
2003,Nigeria,NGA,Senegal,SEN,0,0,5,0,5
2003,Rwanda,RWA,Senegal,SEN,5,0,17,0,22
2003,Sierra Leone,SLE,Senegal,SEN,0,0,24,0,24
2003,Togo,TGO,Senegal,SEN,0,0,5,0,5
2003,Afghanistan,AFG,Spain,ESP,0,5,10,10,25
2003,Albania,ALB,Spain,ESP,0,0,0,10,10
2003,Algeria,DZA,Spain,ESP,0,5,26,695,726
2003,Angola,AGO,Spain,ESP,0,5,26,18,49
2003,Argentina,ARG,Spain,ESP,0,0,0,14,14
2003,Armenia,ARM,Spain,ESP,15,0,43,43,101
2003,Azerbaijan,AZE,Spain,ESP,0,0,5,0,5
2003,Burundi,BDI,Spain,ESP,0,0,5,5,10
2003,Benin,BEN,Spain,ESP,0,0,0,5,5
2003,Bangladesh,BGD,Spain,ESP,0,0,10,18,28
2003,Burkina Faso,BFA,Spain,ESP,0,0,0,5,5
2003,Belarus,BLR,Spain,ESP,10,0,17,10,37
2003,Bosnia and Herzegovina,BIH,Spain,ESP,0,0,5,0,5
2003,Bulgaria,BGR,Spain,ESP,0,0,0,10,10
2003,China,CHN,Spain,ESP,0,0,5,5,10
2003,Cameroon,CMR,Spain,ESP,0,0,10,115,125
2003,Congo,COG,Spain,ESP,0,0,27,19,46
2003,Dem. Rep. of the Congo,COD,Spain,ESP,10,0,47,134,191
2003,Colombia,COL,Spain,ESP,76,64,1293,310,1743
2003,Cuba,CUB,Spain,ESP,19,5,191,61,276
2003,Ecuador,ECU,Spain,ESP,0,0,5,20,25
2003,Equatorial Guinea,GNQ,Spain,ESP,13,5,41,0,59
2003,Eritrea,ERI,Spain,ESP,0,0,10,0,10
2003,Estonia,EST,Spain,ESP,0,0,0,5,5
2003,Ethiopia,ETH,Spain,ESP,5,0,34,10,49
2003,Gambia,GMB,Spain,ESP,0,0,5,35,40
2003,Georgia,GEO,Spain,ESP,10,0,17,41,68
2003,Ghana,GHA,Spain,ESP,0,0,0,54,54
2003,Guinea-Bissau,GNB,Spain,ESP,0,0,0,34,34
2003,Guatemala,GTM,Spain,ESP,0,0,5,0,5
2003,Guinea,GIN,Spain,ESP,0,0,22,109,131
2003,Cote d'Ivoire,CIV,Spain,ESP,0,0,27,77,104
2003,India,IND,Spain,ESP,0,0,0,44,44
2003,Iran (Islamic Rep. of),IRN,Spain,ESP,0,0,11,10,21
2003,Iraq,IRQ,Spain,ESP,5,0,17,50,72
2003,Liberia,LBR,Spain,ESP,0,0,10,124,134
2003,Sri Lanka,LKA,Spain,ESP,0,0,15,5,20
2003,Mauritania,MRT,Spain,ESP,0,0,5,16,21
2003,Rep. of Moldova,MDA,Spain,ESP,0,0,10,14,24
2003,Mali,MLI,Spain,ESP,0,0,5,33,38
2003,Mongolia,MNG,Spain,ESP,0,0,0,10,10
2003,Morocco,MAR,Spain,ESP,0,0,15,23,38
2003,Nepal,NPL,Spain,ESP,0,0,5,11,16
2003,Niger,NER,Spain,ESP,0,0,0,10,10
2003,Nigeria,NGA,Spain,ESP,5,0,62,1726,1793
2003,Pakistan,PAK,Spain,ESP,0,5,5,12,22
2003,Peru,PER,Spain,ESP,0,0,5,5,10
2003,Romania,ROU,Spain,ESP,0,0,5,49,54
2003,South Africa,ZAF,Spain,ESP,0,0,0,5,5
2003,Russian Federation,RUS,Spain,ESP,41,27,61,60,189
2003,El Salvador,SLV,Spain,ESP,0,0,5,0,5
2003,Serbia and Kosovo: S/RES/1244 (1999),SRB,Spain,ESP,5,0,0,5,10
2003,Senegal,SEN,Spain,ESP,0,0,5,5,10
2003,Sierra Leone,SLE,Spain,ESP,0,0,39,133,172
2003,Somalia,SOM,Spain,ESP,0,0,59,58,117
2003,Sudan,SDN,Spain,ESP,0,0,10,10,20
2003,Syrian Arab Rep.,SYR,Spain,ESP,0,0,5,0,5
2003,Togo,TGO,Spain,ESP,0,0,5,10,15
2003,Tunisia,TUN,Spain,ESP,0,0,17,10,27
2003,Turkey,TUR,Spain,ESP,0,0,34,10,44
2003,Ukraine,UKR,Spain,ESP,5,0,25,27,57
2003,Venezuela (Bolivarian Republic of),VEN,Spain,ESP,0,0,0,11,11
2003,Zimbabwe,ZWE,Spain,ESP,0,0,0,5,5
2003,Stateless,XXA,Spain,ESP,0,10,13,27,50
2003,Unknown ,,Spain,ESP,0,0,0,10,10
2003,Afghanistan,AFG,Slovakia,SVK,0,0,19,690,709
2003,Algeria,DZA,Slovakia,SVK,0,0,0,11,11
2003,Angola,AGO,Slovakia,SVK,0,0,5,0,5
2003,Armenia,ARM,Slovakia,SVK,0,0,5,400,405
2003,Azerbaijan,AZE,Slovakia,SVK,0,0,0,36,36
2003,Bangladesh,BGD,Slovakia,SVK,0,0,68,974,1042
2003,Belarus,BLR,Slovakia,SVK,0,0,0,15,15
2003,Bulgaria,BGR,Slovakia,SVK,0,0,5,0,5
2003,China,CHN,Slovakia,SVK,0,0,35,1556,1591
2003,Congo,COG,Slovakia,SVK,0,0,5,0,5
2003,Cuba,CUB,Slovakia,SVK,0,0,0,5,5
2003,Czechia,CZE,Slovakia,SVK,0,0,5,0,5
2003,Georgia,GEO,Slovakia,SVK,0,0,10,338,348
2003,Ghana,GHA,Slovakia,SVK,0,0,0,5,5
2003,Cote d'Ivoire,CIV,Slovakia,SVK,0,0,0,5,5
2003,India,IND,Slovakia,SVK,0,0,88,1671,1759
2003,Iran (Islamic Rep. of),IRN,Slovakia,SVK,0,0,10,151,161
2003,Iraq,IRQ,Slovakia,SVK,0,0,0,657,657
2003,Israel,ISR,Slovakia,SVK,0,0,0,34,34
2003,Kazakhstan,KAZ,Slovakia,SVK,0,0,0,5,5
2003,Liberia,LBR,Slovakia,SVK,0,0,0,10,10
2003,Lebanon,LBN,Slovakia,SVK,0,0,0,29,29
2003,Sri Lanka,LKA,Slovakia,SVK,0,0,10,82,92
2003,North Macedonia,MKD,Slovakia,SVK,0,0,10,5,15
2003,Rep. of Moldova,MDA,Slovakia,SVK,0,0,12,473,485
2003,Nepal,NPL,Slovakia,SVK,0,0,0,11,11
2003,Nigeria,NGA,Slovakia,SVK,0,0,5,16,21
2003,Pakistan,PAK,Slovakia,SVK,0,0,22,235,257
2003,Romania,ROU,Slovakia,SVK,0,0,0,5,5
2003,Russian Federation,RUS,Slovakia,SVK,0,0,43,1869,1912
2003,Serbia and Kosovo: S/RES/1244 (1999),SRB,Slovakia,SVK,0,0,20,30,50
2003,Senegal,SEN,Slovakia,SVK,0,0,0,10,10
2003,Somalia,SOM,Slovakia,SVK,0,0,0,130,130
2003,Viet Nam,VNM,Slovakia,SVK,0,0,14,97,111
2003,Sudan,SDN,Slovakia,SVK,0,0,0,11,11
2003,Slovakia,SVK,Slovakia,SVK,0,0,5,0,5
2003,Syrian Arab Rep.,SYR,Slovakia,SVK,0,0,0,34,34
2003,Turkmenistan,TKM,Slovakia,SVK,0,0,0,5,5
2003,Togo,TGO,Slovakia,SVK,0,0,5,0,5
2003,Turkey,TUR,Slovakia,SVK,0,0,0,40,40
2003,Ukraine,UKR,Slovakia,SVK,0,0,10,28,38
2003,Uzbekistan,UZB,Slovakia,SVK,0,0,0,5,5
2003,Stateless,XXA,Slovakia,SVK,0,0,0,94,94
2003,Albania,ALB,Slovenia,SVN,0,0,0,13,13
2003,Algeria,DZA,Slovenia,SVN,0,0,5,65,70
2003,Egypt,EGY,Slovenia,SVN,0,0,0,33,33
2003,Bangladesh,BGD,Slovenia,SVN,0,0,0,11,11
2003,Bosnia and Herzegovina,BIH,Slovenia,SVN,5,5,28,25,63
2003,China,CHN,Slovenia,SVN,0,0,5,0,5
2003,Cuba,CUB,Slovenia,SVN,0,0,0,14,14
2003,Palestinian,PSE,Slovenia,SVN,0,0,0,17,17
2003,Georgia,GEO,Slovenia,SVN,0,0,19,43,62
2003,Croatia,HRV,Slovenia,SVN,0,0,5,5,10
2003,India,IND,Slovenia,SVN,0,0,0,10,10
2003,Iran (Islamic Rep. of),IRN,Slovenia,SVN,5,0,0,87,92
2003,Iraq,IRQ,Slovenia,SVN,5,0,0,199,204
2003,North Macedonia,MKD,Slovenia,SVN,0,0,19,51,70
2003,Rep. of Moldova,MDA,Slovenia,SVN,0,0,5,28,33
2003,Pakistan,PAK,Slovenia,SVN,0,0,0,31,31
2003,Romania,ROU,Slovenia,SVN,0,0,5,0,5
2003,Russian Federation,RUS,Slovenia,SVN,5,0,0,10,15
2003,Serbia and Kosovo: S/RES/1244 (1999),SRB,Slovenia,SVN,0,16,61,112,189
2003,Sierra Leone,SLE,Slovenia,SVN,0,0,5,5,10
2003,Turkey,TUR,Slovenia,SVN,0,0,0,187,187
2003,Ukraine,UKR,Slovenia,SVN,0,0,5,10,15
2003,Afghanistan,AFG,Sweden,SWE,21,250,258,36,565
2003,Albania,ALB,Sweden,SWE,0,5,247,48,300
2003,Algeria,DZA,Sweden,SWE,5,0,286,61,352
2003,Angola,AGO,Sweden,SWE,0,10,29,0,39
2003,Egypt,EGY,Sweden,SWE,0,0,118,10,128
2003,Argentina,ARG,Sweden,SWE,0,0,10,0,10
2003,Armenia,ARM,Sweden,SWE,0,20,192,29,241
2003,Azerbaijan,AZE,Sweden,SWE,12,16,645,47,720
2003,Burundi,BDI,Sweden,SWE,0,151,5,5,161
2003,Benin,BEN,Sweden,SWE,0,0,0,5,5
2003,Bangladesh,BGD,Sweden,SWE,0,5,119,11,135
2003,Belarus,BLR,Sweden,SWE,5,0,639,142,786
2003,Bolivia (Plurinational State of),BOL,Sweden,SWE,0,0,293,30,323
2003,Brazil,BRA,Sweden,SWE,0,0,16,0,16
2003,Bosnia and Herzegovina,BIH,Sweden,SWE,5,64,1739,157,1965
2003,Bulgaria,BGR,Sweden,SWE,0,0,640,196,836
2003,Chad,TCD,Sweden,SWE,0,5,0,0,5
2003,China,CHN,Sweden,SWE,0,5,55,13,73
2003,Chile,CHL,Sweden,SWE,0,0,232,17,249
2003,Cameroon,CMR,Sweden,SWE,0,0,14,0,14
2003,Congo,COG,Sweden,SWE,0,0,11,0,11
2003,Dem. Rep. of the Congo,COD,Sweden,SWE,0,10,58,5,73
2003,Colombia,COL,Sweden,SWE,0,5,52,11,68
2003,Cuba,CUB,Sweden,SWE,0,0,15,5,20
2003,Czechia,CZE,Sweden,SWE,0,0,73,36,109
2003,Ecuador,ECU,Sweden,SWE,0,5,201,21,227
2003,Eritrea,ERI,Sweden,SWE,0,23,231,19,273
2003,Estonia,EST,Sweden,SWE,0,0,15,5,20
2003,Ethiopia,ETH,Sweden,SWE,0,0,55,5,60
2003,Gambia,GMB,Sweden,SWE,0,0,5,0,5
2003,Georgia,GEO,Sweden,SWE,0,10,427,114,551
2003,Germany,DEU,Sweden,SWE,0,0,5,0,5
2003,Ghana,GHA,Sweden,SWE,0,0,5,0,5
2003,Guinea-Bissau,GNB,Sweden,SWE,0,0,5,0,5
2003,Guatemala,GTM,Sweden,SWE,5,0,5,0,10
2003,Guinea,GIN,Sweden,SWE,0,0,21,0,21
2003,Honduras,HND,Sweden,SWE,0,0,10,0,10
2003,Croatia,HRV,Sweden,SWE,0,5,200,30,235
2003,Hungary,HUN,Sweden,SWE,0,0,16,5,21
2003,Cote d'Ivoire,CIV,Sweden,SWE,0,0,21,5,26
2003,India,IND,Sweden,SWE,0,0,59,14,73
2003,Iran (Islamic Rep. of),IRN,Sweden,SWE,30,41,669,95,835
2003,Iraq,IRQ,Sweden,SWE,19,1097,792,438,2346
2003,Israel,ISR,Sweden,SWE,0,0,46,5,51
2003,Jordan,JOR,Sweden,SWE,0,13,59,16,88
2003,Kazakhstan,KAZ,Sweden,SWE,0,5,135,23,163
2003,Kenya,KEN,Sweden,SWE,0,0,5,0,5
2003,Kyrgyzstan,KGZ,Sweden,SWE,5,0,0,0,5
2003,Kiribati,KIR,Sweden,SWE,0,10,198,25,233
2003,Lao People's Dem. Rep.,LAO,Sweden,SWE,0,5,0,0,5
2003,Liberia,LBR,Sweden,SWE,5,5,37,5,52
2003,Libya,LBY,Sweden,SWE,0,5,421,91,517
2003,Lebanon,LBN,Sweden,SWE,0,10,343,44,397
2003,Sri Lanka,LKA,Sweden,SWE,0,0,15,5,20
2003,Lithuania,LTU,Sweden,SWE,0,0,35,13,48
2003,Latvia,LVA,Sweden,SWE,0,0,39,5,44
2003,Mauritania,MRT,Sweden,SWE,0,0,5,0,5
2003,North Macedonia,MKD,Sweden,SWE,0,5,534,107,646
2003,Rep. of Moldova,MDA,Sweden,SWE,0,5,178,21,204
2003,Mali,MLI,Sweden,SWE,0,0,5,0,5
2003,Malaysia,MYS,Sweden,SWE,0,0,5,0,5
2003,Mongolia,MNG,Sweden,SWE,0,0,306,69,375
2003,Morocco,MAR,Sweden,SWE,0,5,35,15,55
2003,Myanmar,MMR,Sweden,SWE,0,0,5,0,5
2003,Nepal,NPL,Sweden,SWE,0,0,10,0,10
2003,Netherlands,NLD,Sweden,SWE,0,0,0,5,5
2003,Niger,NER,Sweden,SWE,0,0,5,0,5
2003,Nicaragua,NIC,Sweden,SWE,0,0,5,0,5
2003,Nigeria,NGA,Sweden,SWE,0,0,205,53,258
2003,Pakistan,PAK,Sweden,SWE,0,0,56,10,66
2003,Paraguay,PRY,Sweden,SWE,0,0,10,0,10
2003,Peru,PER,Sweden,SWE,0,5,89,12,106
2003,Philippines,PHL,Sweden,SWE,0,0,5,0,5
2003,Poland,POL,Sweden,SWE,0,0,19,0,19
2003,Romania,ROU,Sweden,SWE,0,0,429,105,534
2003,Russian Federation,RUS,Sweden,SWE,19,64,1104,281,1468
2003,Rwanda,RWA,Sweden,SWE,0,0,11,5,16
2003,El Salvador,SLV,Sweden,SWE,0,0,44,0,44
2003,Saudi Arabia,SAU,Sweden,SWE,0,0,5,0,5
2003,Serbia and Kosovo: S/RES/1244 (1999),SRB,Sweden,SWE,201,276,5473,679,6629
2003,Sierra Leone,SLE,Sweden,SWE,0,0,70,10,80
2003,Somalia,SOM,Sweden,SWE,24,449,505,81,1059
2003,Viet Nam,VNM,Sweden,SWE,0,5,58,10,73
2003,Sudan,SDN,Sweden,SWE,0,0,22,5,27
2003,Slovakia,SVK,Sweden,SWE,0,0,332,58,390
2003,Slovenia,SVN,Sweden,SWE,0,0,10,0,10
2003,Sweden,SWE,Sweden,SWE,0,0,0,5,5
2003,Syrian Arab Rep.,SYR,Sweden,SWE,25,22,699,36,782
2003,United Rep. of Tanzania,TZA,Sweden,SWE,0,0,5,5,10
2003,Tajikistan,TJK,Sweden,SWE,0,0,58,5,63
2003,Turkmenistan,TKM,Sweden,SWE,0,10,19,5,34
2003,Togo,TGO,Sweden,SWE,0,0,5,0,5
2003,Tunisia,TUN,Sweden,SWE,0,0,93,10,103
2003,Turkey,TUR,Sweden,SWE,19,28,809,53,909
2003,Uganda,UGA,Sweden,SWE,0,0,26,0,26
2003,Ukraine,UKR,Sweden,SWE,5,0,485,111,601
2003,Uruguay,URY,Sweden,SWE,0,0,5,0,5
2003,United States of America,USA,Sweden,SWE,0,0,18,0,18
2003,Uzbekistan,UZB,Sweden,SWE,5,13,434,49,501
2003,Venezuela (Bolivarian Republic of),VEN,Sweden,SWE,0,0,10,0,10
2003,Yemen,YEM,Sweden,SWE,0,0,34,0,34
2003,Zimbabwe,ZWE,Sweden,SWE,0,0,10,0,10
2003,Stateless,XXA,Sweden,SWE,5,401,462,84,952
2003,Unknown ,,Sweden,SWE,0,0,16,10,26
2003,Afghanistan,AFG,Switzerland,CHE,78,256,608,58,1000
2003,Albania,ALB,Switzerland,CHE,0,10,36,105,151
2003,Algeria,DZA,Switzerland,CHE,29,12,490,595,1126
2003,Angola,AGO,Switzerland,CHE,5,331,642,80,1058
2003,Egypt,EGY,Switzerland,CHE,5,0,5,11,21
2003,Armenia,ARM,Switzerland,CHE,0,19,247,275,541
2003,Azerbaijan,AZE,Switzerland,CHE,5,0,46,54,105
2003,Burundi,BDI,Switzerland,CHE,5,0,32,16,53
2003,Benin,BEN,Switzerland,CHE,0,0,37,32,69
2003,Bangladesh,BGD,Switzerland,CHE,0,5,491,87,583
2003,Burkina Faso,BFA,Switzerland,CHE,5,0,21,25,51
2003,Belarus,BLR,Switzerland,CHE,0,0,140,206,346
2003,Bolivia (Plurinational State of),BOL,Switzerland,CHE,0,0,24,5,29
2003,Brazil,BRA,Switzerland,CHE,0,0,5,0,5
2003,Bosnia and Herzegovina,BIH,Switzerland,CHE,112,339,1082,395,1928
2003,Bulgaria,BGR,Switzerland,CHE,0,0,47,276,323
2003,Cambodia,KHM,Switzerland,CHE,5,0,0,0,5
2003,Canada,CAN,Switzerland,CHE,0,0,0,5,5
2003,Central African Rep.,CAF,Switzerland,CHE,0,0,5,0,5
2003,Chad,TCD,Switzerland,CHE,0,0,18,5,23
2003,China,CHN,Switzerland,CHE,25,0,55,62,142
2003,Cameroon,CMR,Switzerland,CHE,0,0,231,114,345
2003,Congo,COG,Switzerland,CHE,12,0,30,5,47
2003,Dem. Rep. of the Congo,COD,Switzerland,CHE,35,213,524,141,913
2003,Colombia,COL,Switzerland,CHE,36,5,24,10,75
2003,Cuba,CUB,Switzerland,CHE,0,0,10,5,15
2003,Ecuador,ECU,Switzerland,CHE,0,0,5,0,5
2003,Eritrea,ERI,Switzerland,CHE,0,28,170,83,281
2003,Estonia,EST,Switzerland,CHE,0,0,0,10,10
2003,Ethiopia,ETH,Switzerland,CHE,16,40,266,93,415
2003,France,FRA,Switzerland,CHE,0,0,5,10,15
2003,Gabon,GAB,Switzerland,CHE,0,0,10,0,10
2003,Gambia,GMB,Switzerland,CHE,10,0,0,12,22
2003,Georgia,GEO,Switzerland,CHE,5,5,433,524,967
2003,Germany,DEU,Switzerland,CHE,0,0,0,5,5
2003,Ghana,GHA,Switzerland,CHE,0,0,5,15,20
2003,Guinea-Bissau,GNB,Switzerland,CHE,5,0,15,65,85
2003,Guinea,GIN,Switzerland,CHE,11,12,315,419,757
2003,Croatia,HRV,Switzerland,CHE,0,0,22,11,33
2003,Hungary,HUN,Switzerland,CHE,0,0,0,10,10
2003,Cote d'Ivoire,CIV,Switzerland,CHE,5,0,147,75,227
2003,India,IND,Switzerland,CHE,5,5,38,207,255
2003,Iran (Islamic Rep. of),IRN,Switzerland,CHE,21,10,314,85,430
2003,Iraq,IRQ,Switzerland,CHE,176,103,220,428,927
2003,Israel,ISR,Switzerland,CHE,0,0,5,10,15
2003,Italy,ITA,Switzerland,CHE,0,0,0,5,5
2003,Jordan,JOR,Switzerland,CHE,5,0,5,10,20
2003,Kazakhstan,KAZ,Switzerland,CHE,0,0,13,15,28
2003,Kenya,KEN,Switzerland,CHE,0,0,15,0,15
2003,Kyrgyzstan,KGZ,Switzerland,CHE,0,0,10,5,15
2003,Liberia,LBR,Switzerland,CHE,0,0,24,73,97
2003,Libya,LBY,Switzerland,CHE,32,0,67,41,140
2003,Lebanon,LBN,Switzerland,CHE,0,5,54,94,153
2003,Sri Lanka,LKA,Switzerland,CHE,50,160,393,133,736
2003,Lithuania,LTU,Switzerland,CHE,0,0,5,109,114
2003,Latvia,LVA,Switzerland,CHE,0,0,5,16,21
2003,Mauritania,MRT,Switzerland,CHE,0,0,5,37,42
2003,North Macedonia,MKD,Switzerland,CHE,0,0,572,266,838
2003,Rep. of Moldova,MDA,Switzerland,CHE,0,0,54,154,208
2003,Mali,MLI,Switzerland,CHE,0,0,33,70,103
2003,Mongolia,MNG,Switzerland,CHE,0,0,12,337,349
2003,Morocco,MAR,Switzerland,CHE,0,0,12,31,43
2003,Mozambique,MOZ,Switzerland,CHE,0,0,5,0,5
2003,Nepal,NPL,Switzerland,CHE,0,0,5,39,44
2003,Niger,NER,Switzerland,CHE,0,0,20,14,34
2003,Nigeria,NGA,Switzerland,CHE,0,0,425,305,730
2003,Pakistan,PAK,Switzerland,CHE,5,38,192,131,366
2003,Poland,POL,Switzerland,CHE,0,0,30,22,52
2003,Romania,ROU,Switzerland,CHE,0,0,33,222,255
2003,South Africa,ZAF,Switzerland,CHE,0,0,5,0,5
2003,Russian Federation,RUS,Switzerland,CHE,12,17,254,281,564
2003,Rwanda,RWA,Switzerland,CHE,14,0,11,10,35
2003,Serbia and Kosovo: S/RES/1244 (1999),SRB,Switzerland,CHE,112,995,2203,1407,4717
2003,Senegal,SEN,Switzerland,CHE,0,0,5,18,23
2003,Sierra Leone,SLE,Switzerland,CHE,0,11,115,99,225
2003,Somalia,SOM,Switzerland,CHE,19,383,419,77,898
2003,Viet Nam,VNM,Switzerland,CHE,36,0,22,10,68
2003,Sudan,SDN,Switzerland,CHE,0,0,69,30,99
2003,Suriname,SUR,Switzerland,CHE,0,0,0,5,5
2003,Slovakia,SVK,Switzerland,CHE,0,0,21,183,204
2003,Slovenia,SVN,Switzerland,CHE,0,0,0,5,5
2003,Switzerland,CHE,Switzerland,CHE,0,0,5,0,5
2003,Syrian Arab Rep.,SYR,Switzerland,CHE,10,22,182,98,312
2003,Tajikistan,TJK,Switzerland,CHE,0,0,0,5,5
2003,Turkmenistan,TKM,Switzerland,CHE,0,0,0,5,5
2003,Togo,TGO,Switzerland,CHE,21,0,198,30,249
2003,Tunisia,TUN,Switzerland,CHE,85,0,51,60,196
2003,Turkey,TUR,Switzerland,CHE,571,86,1472,418,2547
2003,Uganda,UGA,Switzerland,CHE,0,0,5,10,15
2003,Ukraine,UKR,Switzerland,CHE,5,0,165,124,294
2003,United States of America,USA,Switzerland,CHE,0,0,5,5,10
2003,Uzbekistan,UZB,Switzerland,CHE,0,0,21,11,32
2003,Western Sahara,ESH,Switzerland,CHE,0,0,5,0,5
2003,Yemen,YEM,Switzerland,CHE,23,0,91,18,132
2003,Zimbabwe,ZWE,Switzerland,CHE,0,0,13,10,23
2003,Stateless,XXA,Switzerland,CHE,0,0,39,113,152
2003,Unknown ,,Switzerland,CHE,5,209,534,1012,1760
2003,Rwanda,RWA,United Rep. of Tanzania,TZA,149,0,27,0,176
2003,Afghanistan,AFG,Tajikistan,TJK,109,0,56,0,165
2003,Burundi,BDI,Uganda,UGA,74,0,11,106,191
2003,Dem. Rep. of the Congo,COD,Uganda,UGA,1563,0,41,156,1760
2003,Eritrea,ERI,Uganda,UGA,5,0,0,5,10
2003,Ethiopia,ETH,Uganda,UGA,22,0,12,18,52
2003,Kenya,KEN,Uganda,UGA,5,0,0,0,5
2003,Liberia,LBR,Uganda,UGA,12,0,0,0,12
2003,Sri Lanka,LKA,Uganda,UGA,0,0,0,5,5
2003,Pakistan,PAK,Uganda,UGA,0,0,5,0,5
2003,Rwanda,RWA,Uganda,UGA,156,0,28,48,232
2003,Somalia,SOM,Uganda,UGA,33,0,11,16,60
2003,Sudan,SDN,Uganda,UGA,156,0,0,28,184
2003,Afghanistan,AFG,Ukraine,UKR,36,0,259,48,343
2003,Angola,AGO,Ukraine,UKR,0,0,10,5,15
2003,Armenia,ARM,Ukraine,UKR,0,0,42,0,42
2003,Azerbaijan,AZE,Ukraine,UKR,0,0,5,0,5
2003,Bangladesh,BGD,Ukraine,UKR,0,0,106,0,106
2003,China,CHN,Ukraine,UKR,0,0,54,0,54
2003,Cameroon,CMR,Ukraine,UKR,0,0,5,0,5
2003,Congo,COG,Ukraine,UKR,0,0,5,0,5
2003,Ethiopia,ETH,Ukraine,UKR,0,0,15,0,15
2003,Palestinian,PSE,Ukraine,UKR,0,0,20,0,20
2003,Georgia,GEO,Ukraine,UKR,0,0,19,0,19
2003,India,IND,Ukraine,UKR,0,0,96,0,96
2003,Iran (Islamic Rep. of),IRN,Ukraine,UKR,0,0,56,0,56
2003,Iraq,IRQ,Ukraine,UKR,0,0,150,0,150
2003,Liberia,LBR,Ukraine,UKR,0,0,10,0,10
2003,Lebanon,LBN,Ukraine,UKR,0,0,18,0,18
2003,Sri Lanka,LKA,Ukraine,UKR,0,0,56,0,56
2003,Nigeria,NGA,Ukraine,UKR,0,0,37,0,37
2003,Pakistan,PAK,Ukraine,UKR,0,0,35,0,35
2003,Russian Federation,RUS,Ukraine,UKR,5,0,87,5,97
2003,Somalia,SOM,Ukraine,UKR,10,0,59,0,69
2003,Viet Nam,VNM,Ukraine,UKR,0,0,13,0,13
2003,Sudan,SDN,Ukraine,UKR,0,0,10,0,10
2003,Syrian Arab Rep.,SYR,Ukraine,UKR,0,0,41,0,41
2003,Tajikistan,TJK,Ukraine,UKR,0,0,5,5,10
2003,Uganda,UGA,Ukraine,UKR,0,0,5,0,5
2003,Colombia,COL,Venezuela (Bolivarian Republic of),VEN,0,0,0,83,83
2003,Angola,AGO,Zimbabwe,ZWE,415,0,0,0,415
2003,Burundi,BDI,Zimbabwe,ZWE,679,0,0,0,679
2003,Dem. Rep. of the Congo,COD,Zimbabwe,ZWE,1159,0,5,0,1164
2003,Eritrea,ERI,Zimbabwe,ZWE,0,0,5,0,5
2003,Ethiopia,ETH,Zimbabwe,ZWE,29,0,0,0,29
2003,Cote d'Ivoire,CIV,Zimbabwe,ZWE,5,0,0,0,5
2003,Liberia,LBR,Zimbabwe,ZWE,76,0,0,0,76
2003,Mauritius,MUS,Zimbabwe,ZWE,0,0,23,0,23
2003,Pakistan,PAK,Zimbabwe,ZWE,5,0,0,0,5
2003,Rwanda,RWA,Zimbabwe,ZWE,782,0,5,0,787
2003,Sierra Leone,SLE,Zimbabwe,ZWE,5,0,0,0,5
2003,Somalia,SOM,Zimbabwe,ZWE,87,0,0,0,87
2003,Sudan,SDN,Zimbabwe,ZWE,20,0,0,0,20
2003,United Rep. of Tanzania,TZA,Zimbabwe,ZWE,5,0,0,0,5
2003,Uganda,UGA,Zimbabwe,ZWE,14,0,0,0,14
2004,North Macedonia,MKD,Albania,ALB,0,0,0,5,5
2004,Malaysia,MYS,Albania,ALB,0,0,0,5,5
2004,Serbia and Kosovo: S/RES/1244 (1999),SRB,Albania,ALB,23,10,12,10,55
2004,Albania,ALB,Argentina,ARG,5,0,0,0,5
2004,Armenia,ARM,Argentina,ARG,32,0,5,0,37
2004,Colombia,COL,Argentina,ARG,13,0,5,0,18
2004,Cuba,CUB,Argentina,ARG,34,0,18,5,57
2004,Ghana,GHA,Argentina,ARG,0,0,5,0,5
2004,Guinea,GIN,Argentina,ARG,5,0,0,0,5
2004,Haiti,HTI,Argentina,ARG,10,0,0,0,10
2004,India,IND,Argentina,ARG,5,0,0,0,5
2004,Kazakhstan,KAZ,Argentina,ARG,5,0,0,0,5
2004,Liberia,LBR,Argentina,ARG,5,0,0,0,5
2004,Sri Lanka,LKA,Argentina,ARG,5,0,0,0,5
2004,Nigeria,NGA,Argentina,ARG,5,0,5,5,15
2004,Peru,PER,Argentina,ARG,43,5,167,27,242
2004,Russian Federation,RUS,Argentina,ARG,14,0,5,0,19
2004,Senegal,SEN,Argentina,ARG,22,0,14,0,36
2004,Sierra Leone,SLE,Argentina,ARG,23,0,0,0,23
2004,Ukraine,UKR,Argentina,ARG,5,5,0,5,15
2004,United States of America,USA,Argentina,ARG,0,0,5,0,5
2004,Georgia,GEO,Armenia,ARM,0,0,0,5,5
2004,Iran (Islamic Rep. of),IRN,Armenia,ARM,0,0,5,5,10
2004,Iraq,IRQ,Armenia,ARM,0,93,0,36,129
2004,Syrian Arab Rep.,SYR,Armenia,ARM,0,0,0,5,5
2004,Afghanistan,AFG,Australia,AUS,100,0,5,0,105
2004,China,CHN,Australia,AUS,17,0,683,10,710
2004,Iran (Islamic Rep. of),IRN,Australia,AUS,46,0,28,5,79
2004,Iraq,IRQ,Australia,AUS,50,0,25,5,80
2004,Pakistan,PAK,Australia,AUS,11,0,48,0,59
2004,Serbia and Kosovo: S/RES/1244 (1999),SRB,Australia,AUS,54,0,70,0,124
2004,Unknown ,,Australia,AUS,68,0,1862,65,1995
2004,Afghanistan,AFG,Azerbaijan,AZE,0,0,41,0,41
2004,Iran (Islamic Rep. of),IRN,Azerbaijan,AZE,14,0,20,0,34
2004,Pakistan,PAK,Azerbaijan,AZE,0,0,10,0,10
2004,Turkmenistan,TKM,Azerbaijan,AZE,5,0,0,0,5
2004,Dem. Rep. of the Congo,COD,Burundi,BDI,1521,0,490,0,2011
2004,Afghanistan,AFG,Belgium,BEL,24,0,39,5,68
2004,Albania,ALB,Belgium,BEL,37,0,95,37,169
2004,Algeria,DZA,Belgium,BEL,10,0,58,11,79
2004,Angola,AGO,Belgium,BEL,5,0,46,20,71
2004,Armenia,ARM,Belgium,BEL,12,0,56,19,87
2004,Azerbaijan,AZE,Belgium,BEL,23,0,30,5,58
2004,Burundi,BDI,Belgium,BEL,33,0,46,13,92
2004,Bangladesh,BGD,Belgium,BEL,0,0,20,10,30
2004,Bhutan,BTN,Belgium,BEL,0,0,14,21,35
2004,Burkina Faso,BFA,Belgium,BEL,0,0,5,0,5
2004,Belarus,BLR,Belgium,BEL,37,0,49,15,101
2004,Bosnia and Herzegovina,BIH,Belgium,BEL,37,0,23,20,80
2004,Bulgaria,BGR,Belgium,BEL,0,0,10,0,10
2004,Cambodia,KHM,Belgium,BEL,0,0,0,5,5
2004,Central African Rep.,CAF,Belgium,BEL,0,0,5,0,5
2004,China,CHN,Belgium,BEL,30,0,211,16,257
2004,Chile,CHL,Belgium,BEL,0,0,5,0,5
2004,Cameroon,CMR,Belgium,BEL,12,0,199,24,235
2004,Congo,COG,Belgium,BEL,10,0,5,10,25
2004,Dem. Rep. of the Congo,COD,Belgium,BEL,99,0,555,127,781
2004,Colombia,COL,Belgium,BEL,20,0,48,15,83
2004,Cuba,CUB,Belgium,BEL,0,0,5,5,10
2004,Djibouti,DJI,Belgium,BEL,25,0,13,0,38
2004,Ecuador,ECU,Belgium,BEL,0,0,10,0,10
2004,Ethiopia,ETH,Belgium,BEL,5,0,0,10,15
2004,Palestinian,PSE,Belgium,BEL,0,0,34,5,39
2004,Georgia,GEO,Belgium,BEL,5,0,112,18,135
2004,Ghana,GHA,Belgium,BEL,0,0,0,5,5
2004,Guinea-Bissau,GNB,Belgium,BEL,10,0,0,0,10
2004,Guatemala,GTM,Belgium,BEL,5,0,0,0,5
2004,Guinea,GIN,Belgium,BEL,10,0,38,5,53
2004,Haiti,HTI,Belgium,BEL,0,0,0,5,5
2004,Croatia,HRV,Belgium,BEL,5,0,0,5,10
2004,Cote d'Ivoire,CIV,Belgium,BEL,10,0,11,23,44
2004,India,IND,Belgium,BEL,0,0,10,12,22
2004,Iran (Islamic Rep. of),IRN,Belgium,BEL,57,0,565,53,675
2004,Iraq,IRQ,Belgium,BEL,67,0,34,36,137
2004,Israel,ISR,Belgium,BEL,0,0,11,10,21
2004,Jordan,JOR,Belgium,BEL,5,0,0,0,5
2004,Kazakhstan,KAZ,Belgium,BEL,5,0,71,16,92
2004,Kyrgyzstan,KGZ,Belgium,BEL,11,0,58,5,74
2004,Liberia,LBR,Belgium,BEL,0,0,0,10,10
2004,Libya,LBY,Belgium,BEL,0,0,5,0,5
2004,Lebanon,LBN,Belgium,BEL,0,0,48,17,65
2004,Sri Lanka,LKA,Belgium,BEL,0,0,65,100,165
2004,Latvia,LVA,Belgium,BEL,0,0,5,0,5
2004,Mauritania,MRT,Belgium,BEL,14,0,47,13,74
2004,North Macedonia,MKD,Belgium,BEL,5,0,11,5,21
2004,Rep. of Moldova,MDA,Belgium,BEL,5,0,14,5,24
2004,Mali,MLI,Belgium,BEL,0,0,0,5,5
2004,Mongolia,MNG,Belgium,BEL,0,0,5,0,5
2004,Morocco,MAR,Belgium,BEL,0,0,10,5,15
2004,Myanmar,MMR,Belgium,BEL,5,0,10,0,15
2004,Nepal,NPL,Belgium,BEL,0,0,132,23,155
2004,Niger,NER,Belgium,BEL,5,0,20,5,30
2004,Nigeria,NGA,Belgium,BEL,0,0,0,5,5
2004,Pakistan,PAK,Belgium,BEL,14,0,185,35,234
2004,Peru,PER,Belgium,BEL,0,0,5,5,10
2004,Romania,ROU,Belgium,BEL,0,0,11,13,24
2004,Russian Federation,RUS,Belgium,BEL,774,0,1067,125,1966
2004,Rwanda,RWA,Belgium,BEL,510,0,182,58,750
2004,El Salvador,SLV,Belgium,BEL,0,0,5,0,5
2004,Serbia and Kosovo: S/RES/1244 (1999),SRB,Belgium,BEL,187,0,216,147,550
2004,Sierra Leone,SLE,Belgium,BEL,0,0,18,35,53
2004,Somalia,SOM,Belgium,BEL,15,0,13,20,48
2004,Viet Nam,VNM,Belgium,BEL,0,0,0,5,5
2004,Sudan,SDN,Belgium,BEL,5,0,31,5,41
2004,Syrian Arab Rep.,SYR,Belgium,BEL,55,0,147,21,223
2004,Tajikistan,TJK,Belgium,BEL,0,0,5,0,5
2004,Turkmenistan,TKM,Belgium,BEL,0,0,5,0,5
2004,Togo,TGO,Belgium,BEL,0,0,123,16,139
2004,Turkey,TUR,Belgium,BEL,22,0,218,38,278
2004,Ukraine,UKR,Belgium,BEL,11,0,42,10,63
2004,Uzbekistan,UZB,Belgium,BEL,13,0,72,0,85
2004,Yemen,YEM,Belgium,BEL,5,0,5,0,10
2004,Stateless,XXA,Belgium,BEL,0,0,5,5,10
2004,Algeria,DZA,Benin,BEN,0,0,0,5,5
2004,Central African Rep.,CAF,Benin,BEN,5,0,5,0,10
2004,Chad,TCD,Benin,BEN,5,0,12,0,17
2004,Congo,COG,Benin,BEN,0,0,26,10,36
2004,Dem. Rep. of the Congo,COD,Benin,BEN,17,0,24,10,51
2004,Guinea,GIN,Benin,BEN,0,0,5,0,5
2004,Cote d'Ivoire,CIV,Benin,BEN,18,0,16,5,39
2004,Liberia,LBR,Benin,BEN,0,0,5,32,37
2004,Nigeria,NGA,Benin,BEN,5,0,55,23,83
2004,Rwanda,RWA,Benin,BEN,5,0,5,0,10
2004,Sierra Leone,SLE,Benin,BEN,0,0,10,0,10
2004,Togo,TGO,Benin,BEN,24,0,28,5,57
2004,Chad,TCD,Burkina Faso,BFA,0,0,5,0,5
2004,Cameroon,CMR,Burkina Faso,BFA,0,0,5,0,5
2004,Congo,COG,Burkina Faso,BFA,5,0,5,0,10
2004,Dem. Rep. of the Congo,COD,Burkina Faso,BFA,11,0,5,0,16
2004,Nigeria,NGA,Burkina Faso,BFA,0,0,5,0,5
2004,Rwanda,RWA,Burkina Faso,BFA,0,0,5,0,5
2004,Togo,TGO,Burkina Faso,BFA,0,0,12,0,12
2004,Afghanistan,AFG,Belarus,BLR,17,49,16,118,200
2004,Armenia,ARM,Belarus,BLR,0,0,0,11,11
2004,Azerbaijan,AZE,Belarus,BLR,0,0,0,24,24
2004,Cameroon,CMR,Belarus,BLR,0,0,0,10,10
2004,Congo,COG,Belarus,BLR,0,0,0,5,5
2004,Palestinian,PSE,Belarus,BLR,0,0,0,5,5
2004,Georgia,GEO,Belarus,BLR,5,5,5,37,52
2004,Guinea,GIN,Belarus,BLR,0,0,0,5,5
2004,Iran (Islamic Rep. of),IRN,Belarus,BLR,0,0,5,0,5
2004,Iraq,IRQ,Belarus,BLR,0,5,0,5,10
2004,Rep. of Moldova,MDA,Belarus,BLR,0,0,0,5,5
2004,Pakistan,PAK,Belarus,BLR,0,0,5,18,23
2004,Serbia and Kosovo: S/RES/1244 (1999),SRB,Belarus,BLR,0,0,0,19,19
2004,Syrian Arab Rep.,SYR,Belarus,BLR,0,0,0,5,5
2004,Tajikistan,TJK,Belarus,BLR,0,0,0,21,21
2004,Turkmenistan,TKM,Belarus,BLR,0,0,0,5,5
2004,Ukraine,UKR,Belarus,BLR,0,0,0,5,5
2004,Colombia,COL,Bolivia (Plurinational State of),BOL,0,0,0,5,5
2004,Angola,AGO,Botswana,BWA,5,0,0,0,5
2004,Burundi,BDI,Botswana,BWA,21,0,0,0,21
2004,Dem. Rep. of the Congo,COD,Botswana,BWA,13,0,0,0,13
2004,Namibia,NAM,Botswana,BWA,5,0,0,0,5
2004,Rwanda,RWA,Botswana,BWA,10,0,0,0,10
2004,Somalia,SOM,Botswana,BWA,14,0,0,0,14
2004,Angola,AGO,Brazil,BRA,10,0,35,0,45
2004,Burundi,BDI,Brazil,BRA,5,0,0,5,10
2004,China,CHN,Brazil,BRA,0,0,0,5,5
2004,Cameroon,CMR,Brazil,BRA,0,0,5,0,5
2004,Dem. Rep. of the Congo,COD,Brazil,BRA,5,0,13,5,23
2004,Colombia,COL,Brazil,BRA,43,0,14,5,62
2004,Cuba,CUB,Brazil,BRA,0,0,18,16,34
2004,Ghana,GHA,Brazil,BRA,0,0,5,0,5
2004,Guinea-Bissau,GNB,Brazil,BRA,0,0,5,10,15
2004,Guinea,GIN,Brazil,BRA,0,0,10,5,15
2004,Cote d'Ivoire,CIV,Brazil,BRA,5,0,0,0,5
2004,Iran (Islamic Rep. of),IRN,Brazil,BRA,0,0,0,5,5
2004,Iraq,IRQ,Brazil,BRA,10,0,0,0,10
2004,Liberia,LBR,Brazil,BRA,15,0,5,12,32
2004,Nigeria,NGA,Brazil,BRA,0,0,12,5,17
2004,Paraguay,PRY,Brazil,BRA,5,0,0,0,5
2004,Romania,ROU,Brazil,BRA,0,0,5,132,137
2004,Senegal,SEN,Brazil,BRA,0,0,5,0,5
2004,Sierra Leone,SLE,Brazil,BRA,0,0,10,0,10
2004,United Rep. of Tanzania,TZA,Brazil,BRA,0,0,15,5,20
2004,Togo,TGO,Brazil,BRA,0,0,5,0,5
2004,Unknown ,,Brazil,BRA,0,0,5,0,5
2004,Afghanistan,AFG,Bulgaria,BGR,0,78,79,174,331
2004,Albania,ALB,Bulgaria,BGR,5,0,0,0,5
2004,Algeria,DZA,Bulgaria,BGR,0,0,33,15,48
2004,Armenia,ARM,Bulgaria,BGR,0,5,43,5,53
2004,Bangladesh,BGD,Bulgaria,BGR,0,0,33,5,38
2004,Bosnia and Herzegovina,BIH,Bulgaria,BGR,0,0,5,0,5
2004,Cuba,CUB,Bulgaria,BGR,0,5,0,0,5
2004,Ghana,GHA,Bulgaria,BGR,0,0,5,0,5
2004,India,IND,Bulgaria,BGR,0,0,12,5,17
2004,Iran (Islamic Rep. of),IRN,Bulgaria,BGR,0,10,18,25,53
2004,Iraq,IRQ,Bulgaria,BGR,0,85,0,27,112
2004,Liberia,LBR,Bulgaria,BGR,0,0,0,5,5
2004,Lebanon,LBN,Bulgaria,BGR,0,0,5,0,5
2004,Mauritania,MRT,Bulgaria,BGR,0,0,5,0,5
2004,Nigeria,NGA,Bulgaria,BGR,0,10,30,41,81
2004,Pakistan,PAK,Bulgaria,BGR,0,0,0,5,5
2004,Russian Federation,RUS,Bulgaria,BGR,0,5,5,0,10
2004,Somalia,SOM,Bulgaria,BGR,0,37,11,5,53
2004,Sudan,SDN,Bulgaria,BGR,0,5,0,0,5
2004,Syrian Arab Rep.,SYR,Bulgaria,BGR,5,5,5,5,20
2004,Turkey,TUR,Bulgaria,BGR,0,0,5,10,15
2004,Stateless,XXA,Bulgaria,BGR,0,10,22,32,64
2004,Liberia,LBR,Belize,BLZ,0,0,0,5,5
2004,Zimbabwe,ZWE,Belize,BLZ,0,0,0,5,5
2004,Afghanistan,AFG,Canada,CAN,100,0,34,26,160
2004,Albania,ALB,Canada,CAN,291,0,352,80,723
2004,Algeria,DZA,Canada,CAN,29,0,70,10,109
2004,Angola,AGO,Canada,CAN,152,0,94,20,266
2004,Antigua and Barbuda,ATG,Canada,CAN,5,0,18,0,23
2004,Egypt,EGY,Canada,CAN,114,0,126,34,274
2004,Argentina,ARG,Canada,CAN,24,0,322,19,365
2004,Armenia,ARM,Canada,CAN,12,0,5,10,27
2004,Australia,AUS,Canada,CAN,0,0,0,5,5
2004,Austria,AUT,Canada,CAN,0,0,5,0,5
2004,Azerbaijan,AZE,Canada,CAN,108,0,11,10,129
2004,Barbados,BRB,Canada,CAN,10,0,31,0,41
2004,Burundi,BDI,Canada,CAN,126,0,23,5,154
2004,Benin,BEN,Canada,CAN,14,0,5,0,19
2004,Bangladesh,BGD,Canada,CAN,297,0,234,37,568
2004,Burkina Faso,BFA,Canada,CAN,13,0,14,0,27
2004,Belarus,BLR,Canada,CAN,25,0,13,5,43
2004,Bolivia (Plurinational State of),BOL,Canada,CAN,25,0,17,11,53
2004,Botswana,BWA,Canada,CAN,5,0,5,0,10
2004,Brazil,BRA,Canada,CAN,58,0,532,129,719
2004,Bosnia and Herzegovina,BIH,Canada,CAN,18,0,13,5,36
2004,Bulgaria,BGR,Canada,CAN,164,0,35,22,221
2004,Belize,BLZ,Canada,CAN,0,0,5,0,5
2004,Cambodia,KHM,Canada,CAN,26,0,22,0,48
2004,Central African Rep.,CAF,Canada,CAN,10,0,5,0,15
2004,Chad,TCD,Canada,CAN,52,0,48,0,100
2004,China,CHN,Canada,CAN,1258,0,669,476,2403
2004,Chile,CHL,Canada,CAN,21,0,93,39,153
2004,Cameroon,CMR,Canada,CAN,78,0,39,5,122
2004,Congo,COG,Canada,CAN,22,0,23,5,50
2004,Dem. Rep. of the Congo,COD,Canada,CAN,322,0,199,43,564
2004,Comoros,COM,Canada,CAN,5,0,0,0,5
2004,Colombia,COL,Canada,CAN,2628,0,414,217,3259
2004,Costa Rica,CRI,Canada,CAN,63,0,1380,366,1809
2004,Cuba,CUB,Canada,CAN,122,0,39,25,186
2004,Cyprus,CYP,Canada,CAN,0,0,5,0,5
2004,Czechia,CZE,Canada,CAN,5,0,24,10,39
2004,Djibouti,DJI,Canada,CAN,20,0,14,19,53
2004,Dominica,DMA,Canada,CAN,5,0,21,5,31
2004,Dominican Rep.,DOM,Canada,CAN,10,0,20,69,99
2004,Ecuador,ECU,Canada,CAN,25,0,40,31,96
2004,Equatorial Guinea,GNQ,Canada,CAN,5,0,0,0,5
2004,Eritrea,ERI,Canada,CAN,149,0,5,10,164
2004,Estonia,EST,Canada,CAN,5,0,10,0,15
2004,Ethiopia,ETH,Canada,CAN,287,0,71,16,374
2004,Fiji,FJI,Canada,CAN,11,0,23,0,34
2004,France,FRA,Canada,CAN,0,0,19,0,19
2004,Gabon,GAB,Canada,CAN,5,0,5,0,10
2004,Gambia,GMB,Canada,CAN,10,0,5,0,15
2004,Palestinian,PSE,Canada,CAN,100,0,37,5,142
2004,Georgia,GEO,Canada,CAN,28,0,26,5,59
2004,Germany,DEU,Canada,CAN,0,0,16,5,21
2004,Ghana,GHA,Canada,CAN,59,0,143,26,228
2004,Greece,GRC,Canada,CAN,0,0,5,0,5
2004,Grenada,GRD,Canada,CAN,21,0,249,32,302
2004,Guatemala,GTM,Canada,CAN,51,0,144,30,225
2004,Guinea,GIN,Canada,CAN,97,0,49,17,163
2004,Guyana,GUY,Canada,CAN,198,0,568,66,832
2004,Haiti,HTI,Canada,CAN,118,0,75,12,205
2004,"China, Hong Kong SAR",HKG,Canada,CAN,0,0,0,5,5
2004,Honduras,HND,Canada,CAN,45,0,130,71,246
2004,Croatia,HRV,Canada,CAN,5,0,5,5,15
2004,Hungary,HUN,Canada,CAN,65,0,399,127,591
2004,Cote d'Ivoire,CIV,Canada,CAN,54,0,36,5,95
2004,India,IND,Canada,CAN,330,0,626,285,1241
2004,Indonesia,IDN,Canada,CAN,83,0,114,16,213
2004,Ireland,IRL,Canada,CAN,0,0,5,0,5
2004,Iran (Islamic Rep. of),IRN,Canada,CAN,254,0,120,41,415
2004,Iraq,IRQ,Canada,CAN,184,0,55,12,251
2004,Israel,ISR,Canada,CAN,134,0,366,92,592
2004,Italy,ITA,Canada,CAN,0,0,11,5,16
2004,Jamaica,JAM,Canada,CAN,47,0,282,47,376
2004,Jordan,JOR,Canada,CAN,76,0,95,17,188
2004,Kazakhstan,KAZ,Canada,CAN,20,0,10,0,30
2004,Kenya,KEN,Canada,CAN,136,0,99,10,245
2004,Kyrgyzstan,KGZ,Canada,CAN,5,0,10,0,15
2004,Rep. of Korea,KOR,Canada,CAN,46,0,273,72,391
2004,Kuwait,KWT,Canada,CAN,12,0,0,5,17
2004,Liberia,LBR,Canada,CAN,19,0,14,0,33
2004,Libya,LBY,Canada,CAN,25,0,20,10,55
2004,Saint Lucia,LCA,Canada,CAN,51,0,217,27,295
2004,Lebanon,LBN,Canada,CAN,200,0,278,42,520
2004,Sri Lanka,LKA,Canada,CAN,931,0,471,42,1444
2004,Lithuania,LTU,Canada,CAN,24,0,28,11,63
2004,Latvia,LVA,Canada,CAN,10,0,10,0,20
2004,Madagascar,MDG,Canada,CAN,5,0,0,5,10
2004,Mauritania,MRT,Canada,CAN,40,0,15,0,55
2004,North Macedonia,MKD,Canada,CAN,10,0,39,15,64
2004,Rep. of Moldova,MDA,Canada,CAN,21,0,18,0,39
2004,Mexico,MEX,Canada,CAN,665,0,1331,688,2684
2004,Mali,MLI,Canada,CAN,10,0,10,5,25
2004,Malaysia,MYS,Canada,CAN,31,0,109,26,166
2004,Malawi,MWI,Canada,CAN,10,0,0,0,10
2004,Mongolia,MNG,Canada,CAN,11,0,0,0,11
2004,Morocco,MAR,Canada,CAN,34,0,23,5,62
2004,Mozambique,MOZ,Canada,CAN,5,0,0,0,5
2004,Mauritius,MUS,Canada,CAN,0,0,0,5,5
2004,Myanmar,MMR,Canada,CAN,22,0,0,5,27
2004,Namibia,NAM,Canada,CAN,5,0,0,5,10
2004,Nepal,NPL,Canada,CAN,56,0,10,5,71
2004,Netherlands,NLD,Canada,CAN,0,0,10,0,10
2004,Niger,NER,Canada,CAN,10,0,0,0,10
2004,Nicaragua,NIC,Canada,CAN,11,0,68,10,89
2004,Nigeria,NGA,Canada,CAN,509,0,440,71,1020
2004,Pakistan,PAK,Canada,CAN,1354,0,2136,361,3851
2004,Panama,PAN,Canada,CAN,5,0,23,10,38
2004,Paraguay,PRY,Canada,CAN,5,0,0,5,10
2004,Peru,PER,Canada,CAN,382,0,455,89,926
2004,Philippines,PHL,Canada,CAN,31,0,669,65,765
2004,Poland,POL,Canada,CAN,64,0,218,64,346
2004,Portugal,PRT,Canada,CAN,0,0,373,67,440
2004,Qatar,QAT,Canada,CAN,0,0,10,0,10
2004,Romania,ROU,Canada,CAN,109,0,165,47,321
2004,South Africa,ZAF,Canada,CAN,5,0,11,0,16
2004,Russian Federation,RUS,Canada,CAN,145,0,86,42,273
2004,Rwanda,RWA,Canada,CAN,98,0,26,5,129
2004,El Salvador,SLV,Canada,CAN,63,0,197,46,306
2004,Saudi Arabia,SAU,Canada,CAN,11,0,5,5,21
2004,Senegal,SEN,Canada,CAN,24,0,11,0,35
2004,Singapore,SGP,Canada,CAN,5,0,5,0,10
2004,Sierra Leone,SLE,Canada,CAN,24,0,11,5,40
2004,Somalia,SOM,Canada,CAN,282,0,18,56,356
2004,Spain,ESP,Canada,CAN,0,0,10,11,21
2004,Viet Nam,VNM,Canada,CAN,14,0,29,10,53
2004,Saint Kitts and Nevis,KNA,Canada,CAN,0,0,5,0,5
2004,Sudan,SDN,Canada,CAN,81,0,30,5,116
2004,Slovakia,SVK,Canada,CAN,5,0,48,20,73
2004,Slovenia,SVN,Canada,CAN,5,0,0,0,5
2004,Eswatini,SWZ,Canada,CAN,5,0,0,0,5
2004,Sweden,SWE,Canada,CAN,0,0,18,0,18
2004,Syrian Arab Rep.,SYR,Canada,CAN,89,0,62,5,156
2004,United Rep. of Tanzania,TZA,Canada,CAN,32,0,71,18,121
2004,Thailand,THA,Canada,CAN,5,0,5,0,10
2004,Tajikistan,TJK,Canada,CAN,5,0,0,0,5
2004,Togo,TGO,Canada,CAN,22,0,5,0,27
2004,Trinidad and Tobago,TTO,Canada,CAN,29,0,220,32,281
2004,Tunisia,TUN,Canada,CAN,34,0,28,5,67
2004,Turkey,TUR,Canada,CAN,637,0,311,68,1016
2004,United Arab Emirates,ARE,Canada,CAN,10,0,5,0,15
2004,Uganda,UGA,Canada,CAN,116,0,27,10,153
2004,Ukraine,UKR,Canada,CAN,144,0,93,36,273
2004,Uruguay,URY,Canada,CAN,24,0,344,61,429
2004,United States of America,USA,Canada,CAN,5,0,162,132,299
2004,Uzbekistan,UZB,Canada,CAN,25,0,13,5,43
2004,Saint Vincent and the Grenadines,VCT,Canada,CAN,113,0,353,66,532
2004,Venezuela (Bolivarian Republic of),VEN,Canada,CAN,192,0,517,50,759
2004,Yemen,YEM,Canada,CAN,35,0,29,0,64
2004,Zambia,ZMB,Canada,CAN,13,0,5,0,18
2004,Zimbabwe,ZWE,Canada,CAN,70,0,29,5,104
2004,Unknown ,,Canada,CAN,73,0,95,42,210
2004,Angola,AGO,Central African Rep.,CAF,5,0,0,0,5
2004,Chad,TCD,Central African Rep.,CAF,26,0,10,0,36
2004,Congo,COG,Central African Rep.,CAF,33,0,0,0,33
2004,Dem. Rep. of the Congo,COD,Central African Rep.,CAF,512,22,25,20,579
2004,Liberia,LBR,Central African Rep.,CAF,11,0,5,5,21
2004,Rwanda,RWA,Central African Rep.,CAF,14,0,0,0,14
2004,Sudan,SDN,Central African Rep.,CAF,285,0,0,0,285
2004,Unknown ,,Central African Rep.,CAF,5,0,0,49,54
2004,Colombia,COL,Chile,CHL,64,0,61,0,125
2004,Peru,PER,Chile,CHL,5,0,0,0,5
2004,Russian Federation,RUS,Chile,CHL,5,0,0,0,5
2004,Cuba,CUB,Colombia,COL,5,0,0,0,5
2004,Peru,PER,Colombia,COL,0,0,5,0,5
2004,Uzbekistan,UZB,Colombia,COL,5,0,0,0,5
2004,Afghanistan,AFG,Cyprus,CYP,0,0,5,0,5
2004,Algeria,DZA,Cyprus,CYP,0,0,0,5,5
2004,Egypt,EGY,Cyprus,CYP,0,0,10,5,15
2004,Armenia,ARM,Cyprus,CYP,0,0,5,0,5
2004,Bangladesh,BGD,Cyprus,CYP,0,0,1048,1372,2420
2004,Belarus,BLR,Cyprus,CYP,0,0,5,0,5
2004,China,CHN,Cyprus,CYP,0,0,0,10,10
2004,Dem. Rep. of the Congo,COD,Cyprus,CYP,0,0,5,0,5
2004,Palestinian,PSE,Cyprus,CYP,0,13,100,171,284
2004,Georgia,GEO,Cyprus,CYP,0,0,64,91,155
2004,Cote d'Ivoire,CIV,Cyprus,CYP,0,0,0,5,5
2004,India,IND,Cyprus,CYP,0,0,37,15,52
2004,Iran (Islamic Rep. of),IRN,Cyprus,CYP,5,20,428,217,670
2004,Iraq,IRQ,Cyprus,CYP,0,0,0,10,10
2004,Jordan,JOR,Cyprus,CYP,0,0,0,5,5
2004,Lebanon,LBN,Cyprus,CYP,5,0,26,25,56
2004,Sri Lanka,LKA,Cyprus,CYP,0,0,5,0,5
2004,Rep. of Moldova,MDA,Cyprus,CYP,0,0,10,5,15
2004,Morocco,MAR,Cyprus,CYP,0,0,0,5,5
2004,Nigeria,NGA,Cyprus,CYP,0,0,10,0,10
2004,Pakistan,PAK,Cyprus,CYP,0,0,410,353,763
2004,Russian Federation,RUS,Cyprus,CYP,0,5,203,95,303
2004,Syrian Arab Rep.,SYR,Cyprus,CYP,10,0,27,35,72
2004,Turkey,TUR,Cyprus,CYP,5,0,223,53,281
2004,Ukraine,UKR,Cyprus,CYP,0,5,108,59,172
2004,Uzbekistan,UZB,Cyprus,CYP,0,0,5,0,5
2004,Afghanistan,AFG,Czechia,CZE,5,0,14,5,24
2004,Algeria,DZA,Czechia,CZE,0,0,61,20,81
2004,Angola,AGO,Czechia,CZE,0,0,5,0,5
2004,Armenia,ARM,Czechia,CZE,10,0,69,25,104
2004,Azerbaijan,AZE,Czechia,CZE,0,0,16,5,21
2004,Belarus,BLR,Czechia,CZE,29,0,244,76,349
2004,Bosnia and Herzegovina,BIH,Czechia,CZE,0,0,5,0,5
2004,Bulgaria,BGR,Czechia,CZE,0,0,63,0,63
2004,China,CHN,Czechia,CZE,0,0,309,77,386
2004,Georgia,GEO,Czechia,CZE,5,0,251,87,343
2004,Ghana,GHA,Czechia,CZE,0,0,5,0,5
2004,Guinea,GIN,Czechia,CZE,0,0,5,0,5
2004,Cote d'Ivoire,CIV,Czechia,CZE,0,0,21,5,26
2004,India,IND,Czechia,CZE,0,0,47,17,64
2004,Iran (Islamic Rep. of),IRN,Czechia,CZE,5,0,0,0,5
2004,Iraq,IRQ,Czechia,CZE,5,0,10,44,59
2004,Kazakhstan,KAZ,Czechia,CZE,10,0,50,5,65
2004,Kyrgyzstan,KGZ,Czechia,CZE,5,0,110,35,150
2004,Sri Lanka,LKA,Czechia,CZE,0,0,0,5,5
2004,Lithuania,LTU,Czechia,CZE,0,0,11,5,16
2004,North Macedonia,MKD,Czechia,CZE,0,0,15,0,15
2004,Rep. of Moldova,MDA,Czechia,CZE,0,0,143,28,171
2004,Mongolia,MNG,Czechia,CZE,0,0,108,0,108
2004,Nigeria,NGA,Czechia,CZE,0,0,50,5,55
2004,Pakistan,PAK,Czechia,CZE,0,0,13,0,13
2004,Romania,ROU,Czechia,CZE,0,0,25,5,30
2004,Russian Federation,RUS,Czechia,CZE,45,0,357,2444,2846
2004,Serbia and Kosovo: S/RES/1244 (1999),SRB,Czechia,CZE,0,0,0,10,10
2004,Senegal,SEN,Czechia,CZE,0,0,10,0,10
2004,Viet Nam,VNM,Czechia,CZE,5,0,415,78,498
2004,Slovakia,SVK,Czechia,CZE,0,0,115,60,175
2004,Syrian Arab Rep.,SYR,Czechia,CZE,0,0,0,5,5
2004,Turkey,TUR,Czechia,CZE,0,0,21,10,31
2004,Ukraine,UKR,Czechia,CZE,5,0,1879,78,1962
2004,Uzbekistan,UZB,Czechia,CZE,0,0,42,5,47
2004,Stateless,XXA,Czechia,CZE,0,0,45,19,64
2004,Unknown ,,Czechia,CZE,5,0,140,22,167
2004,Afghanistan,AFG,Denmark,DNK,33,5,190,0,228
2004,Albania,ALB,Denmark,DNK,0,0,25,0,25
2004,Algeria,DZA,Denmark,DNK,0,0,10,0,10
2004,Armenia,ARM,Denmark,DNK,0,0,5,0,5
2004,Azerbaijan,AZE,Denmark,DNK,0,5,13,0,18
2004,Burundi,BDI,Denmark,DNK,5,10,18,0,33
2004,Bangladesh,BGD,Denmark,DNK,0,0,23,0,23
2004,Belarus,BLR,Denmark,DNK,5,0,10,0,15
2004,Brazil,BRA,Denmark,DNK,0,0,5,0,5
2004,Bosnia and Herzegovina,BIH,Denmark,DNK,0,0,55,0,55
2004,Bulgaria,BGR,Denmark,DNK,0,0,33,0,33
2004,China,CHN,Denmark,DNK,5,0,17,0,22
2004,Dem. Rep. of the Congo,COD,Denmark,DNK,5,0,10,0,15
2004,Ecuador,ECU,Denmark,DNK,0,0,10,0,10
2004,Eritrea,ERI,Denmark,DNK,5,0,5,0,10
2004,Ethiopia,ETH,Denmark,DNK,5,0,0,0,5
2004,Palestinian,PSE,Denmark,DNK,10,0,72,0,82
2004,Georgia,GEO,Denmark,DNK,0,0,11,0,11
2004,Ghana,GHA,Denmark,DNK,0,0,5,0,5
2004,Guinea,GIN,Denmark,DNK,0,0,5,0,5
2004,Croatia,HRV,Denmark,DNK,0,0,17,0,17
2004,Hungary,HUN,Denmark,DNK,0,0,10,0,10
2004,Cote d'Ivoire,CIV,Denmark,DNK,0,0,5,0,5
2004,India,IND,Denmark,DNK,0,0,12,0,12
2004,Iran (Islamic Rep. of),IRN,Denmark,DNK,5,11,80,0,96
2004,Iraq,IRQ,Denmark,DNK,0,5,523,0,528
2004,Liberia,LBR,Denmark,DNK,0,0,5,0,5
2004,Libya,LBY,Denmark,DNK,0,5,0,0,5
2004,Lebanon,LBN,Denmark,DNK,0,0,5,0,5
2004,Sri Lanka,LKA,Denmark,DNK,0,0,5,0,5
2004,Lithuania,LTU,Denmark,DNK,0,0,14,0,14
2004,Latvia,LVA,Denmark,DNK,0,0,5,0,5
2004,North Macedonia,MKD,Denmark,DNK,0,0,44,0,44
2004,Rep. of Moldova,MDA,Denmark,DNK,0,0,5,0,5
2004,Morocco,MAR,Denmark,DNK,0,0,10,0,10
2004,Myanmar,MMR,Denmark,DNK,0,0,5,0,5
2004,Nepal,NPL,Denmark,DNK,0,0,5,0,5
2004,Nigeria,NGA,Denmark,DNK,0,0,43,0,43
2004,Pakistan,PAK,Denmark,DNK,0,0,20,0,20
2004,Poland,POL,Denmark,DNK,0,0,5,0,5
2004,Romania,ROU,Denmark,DNK,0,0,15,0,15
2004,Russian Federation,RUS,Denmark,DNK,14,50,71,0,135
2004,Rwanda,RWA,Denmark,DNK,5,0,5,0,10
2004,Serbia and Kosovo: S/RES/1244 (1999),SRB,Denmark,DNK,0,0,301,0,301
2004,Sierra Leone,SLE,Denmark,DNK,0,0,5,0,5
2004,Somalia,SOM,Denmark,DNK,0,11,86,0,97
2004,Viet Nam,VNM,Denmark,DNK,0,0,5,0,5
2004,Sudan,SDN,Denmark,DNK,5,0,5,0,10
2004,Slovakia,SVK,Denmark,DNK,0,0,17,0,17
2004,Syrian Arab Rep.,SYR,Denmark,DNK,5,0,26,0,31
2004,Tunisia,TUN,Denmark,DNK,0,0,5,0,5
2004,Turkey,TUR,Denmark,DNK,0,0,34,0,34
2004,Ukraine,UKR,Denmark,DNK,0,0,5,0,5
2004,Stateless,XXA,Denmark,DNK,5,0,10,0,15
2004,Colombia,COL,Ecuador,ECU,2465,0,4207,1927,8599
2004,Cuba,CUB,Ecuador,ECU,10,0,0,0,10
2004,Haiti,HTI,Ecuador,ECU,10,0,5,0,15
2004,Morocco,MAR,Ecuador,ECU,5,0,0,0,5
2004,Peru,PER,Ecuador,ECU,16,0,100,0,116
2004,Turkey,TUR,Estonia,EST,0,0,5,5,10
2004,Afghanistan,AFG,France,FRA,43,0,181,0,224
2004,Albania,ALB,France,FRA,28,0,542,0,570
2004,Algeria,DZA,France,FRA,155,0,3982,0,4137
2004,Angola,AGO,France,FRA,128,0,1382,0,1510
2004,Egypt,EGY,France,FRA,5,0,21,0,26
2004,Armenia,ARM,France,FRA,26,0,1313,0,1339
2004,Azerbaijan,AZE,France,FRA,64,0,565,0,629
2004,Burundi,BDI,France,FRA,20,0,44,0,64
2004,Bangladesh,BGD,France,FRA,40,0,1534,0,1574
2004,Burkina Faso,BFA,France,FRA,5,0,30,0,35
2004,Belarus,BLR,France,FRA,27,0,235,0,262
2004,Brazil,BRA,France,FRA,0,0,16,0,16
2004,Bosnia and Herzegovina,BIH,France,FRA,981,0,548,0,1529
2004,Cambodia,KHM,France,FRA,5,0,101,0,106
2004,Central African Rep.,CAF,France,FRA,52,0,291,0,343
2004,Chad,TCD,France,FRA,30,0,238,0,268
2004,China,CHN,France,FRA,26,0,6108,0,6134
2004,Cameroon,CMR,France,FRA,35,0,888,0,923
2004,Congo,COG,France,FRA,200,0,1744,0,1944
2004,Dem. Rep. of the Congo,COD,France,FRA,388,0,4928,0,5316
2004,Colombia,COL,France,FRA,25,0,107,0,132
2004,Cuba,CUB,France,FRA,11,0,22,0,33
2004,Cabo Verde,CPV,France,FRA,0,0,12,0,12
2004,Djibouti,DJI,France,FRA,5,0,21,0,26
2004,Dominican Rep.,DOM,France,FRA,0,0,26,0,26
2004,Eritrea,ERI,France,FRA,5,0,21,0,26
2004,Ethiopia,ETH,France,FRA,21,0,41,0,62
2004,Gambia,GMB,France,FRA,0,0,66,0,66
2004,Palestinian,PSE,France,FRA,5,0,64,0,69
2004,Georgia,GEO,France,FRA,46,0,1857,0,1903
2004,Ghana,GHA,France,FRA,0,0,95,0,95
2004,Guinea-Bissau,GNB,France,FRA,38,0,122,0,160
2004,Guinea,GIN,France,FRA,79,0,1090,0,1169
2004,Haiti,HTI,France,FRA,215,0,2815,0,3030
2004,Cote d'Ivoire,CIV,France,FRA,219,0,968,0,1187
2004,India,IND,France,FRA,5,0,1192,0,1197
2004,Iran (Islamic Rep. of),IRN,France,FRA,41,0,118,0,159
2004,Iraq,IRQ,France,FRA,31,0,178,0,209
2004,Israel,ISR,France,FRA,0,0,10,0,10
2004,Kazakhstan,KAZ,France,FRA,5,0,140,0,145
2004,Kyrgyzstan,KGZ,France,FRA,5,0,82,0,87
2004,Liberia,LBR,France,FRA,12,0,404,0,416
2004,Lebanon,LBN,France,FRA,5,0,38,0,43
2004,Sri Lanka,LKA,France,FRA,320,0,2903,0,3223
2004,Madagascar,MDG,France,FRA,31,0,327,0,358
2004,Mauritania,MRT,France,FRA,184,0,2516,0,2700
2004,North Macedonia,MKD,France,FRA,0,0,230,0,230
2004,Rep. of Moldova,MDA,France,FRA,20,0,2188,0,2208
2004,Mali,MLI,France,FRA,5,0,915,0,920
2004,Mongolia,MNG,France,FRA,0,0,612,0,612
2004,Mauritius,MUS,France,FRA,0,0,17,0,17
2004,Myanmar,MMR,France,FRA,5,0,30,0,35
2004,Niger,NER,France,FRA,5,0,27,0,32
2004,Nigeria,NGA,France,FRA,34,0,1654,0,1688
2004,Pakistan,PAK,France,FRA,12,0,1354,0,1366
2004,Peru,PER,France,FRA,5,0,51,0,56
2004,Romania,ROU,France,FRA,0,0,702,0,702
2004,Russian Federation,RUS,France,FRA,1136,0,1718,0,2854
2004,Rwanda,RWA,France,FRA,174,0,170,0,344
2004,Serbia and Kosovo: S/RES/1244 (1999),SRB,France,FRA,563,0,2074,0,2637
2004,Senegal,SEN,France,FRA,5,0,232,0,237
2004,Sierra Leone,SLE,France,FRA,27,0,319,0,346
2004,Somalia,SOM,France,FRA,26,0,125,0,151
2004,Sudan,SDN,France,FRA,116,0,311,0,427
2004,Slovakia,SVK,France,FRA,0,0,38,0,38
2004,Syrian Arab Rep.,SYR,France,FRA,12,0,40,0,52
2004,Thailand,THA,France,FRA,0,0,35,0,35
2004,Tajikistan,TJK,France,FRA,5,0,16,0,21
2004,Togo,TGO,France,FRA,56,0,365,0,421
2004,Tunisia,TUN,France,FRA,12,0,38,0,50
2004,Turkey,TUR,France,FRA,424,0,7002,0,7426
2004,Uganda,UGA,France,FRA,0,0,5,0,5
2004,Ukraine,UKR,France,FRA,19,0,839,0,858
2004,United States of America,USA,France,FRA,0,0,5,0,5
2004,Uzbekistan,UZB,France,FRA,5,0,74,0,79
2004,Stateless,XXA,France,FRA,71,0,126,0,197
2004,Unknown ,,France,FRA,51,0,522,0,573
2004,Angola,AGO,Gabon,GAB,0,0,5,0,5
2004,Central African Rep.,CAF,Gabon,GAB,0,0,13,0,13
2004,Chad,TCD,Gabon,GAB,0,0,40,0,40
2004,Congo,COG,Gabon,GAB,10,0,141,0,151
2004,Dem. Rep. of the Congo,COD,Gabon,GAB,10,0,136,0,146
2004,Equatorial Guinea,GNQ,Gabon,GAB,0,0,5,0,5
2004,Cote d'Ivoire,CIV,Gabon,GAB,0,0,5,0,5
2004,Mauritania,MRT,Gabon,GAB,0,0,10,0,10
2004,Mali,MLI,Gabon,GAB,0,0,10,0,10
2004,Sudan,SDN,Gabon,GAB,0,0,5,0,5
2004,Afghanistan,AFG,United Kingdom of Great Britain and Northern Ireland,GBR,46,455,2116,387,3004
2004,Albania,ALB,United Kingdom of Great Britain and Northern Ireland,GBR,0,111,400,83,594
2004,Algeria,DZA,United Kingdom of Great Britain and Northern Ireland,GBR,12,33,589,156,790
2004,Angola,AGO,United Kingdom of Great Britain and Northern Ireland,GBR,10,108,648,63,829
2004,Egypt,EGY,United Kingdom of Great Britain and Northern Ireland,GBR,0,5,102,19,126
2004,Armenia,ARM,United Kingdom of Great Britain and Northern Ireland,GBR,0,0,67,5,72
2004,Azerbaijan,AZE,United Kingdom of Great Britain and Northern Ireland,GBR,10,0,101,14,125
2004,Burundi,BDI,United Kingdom of Great Britain and Northern Ireland,GBR,26,120,280,27,453
2004,Benin,BEN,United Kingdom of Great Britain and Northern Ireland,GBR,0,0,5,0,5
2004,Bangladesh,BGD,United Kingdom of Great Britain and Northern Ireland,GBR,0,277,306,45,628
2004,Bhutan,BTN,United Kingdom of Great Britain and Northern Ireland,GBR,10,0,44,25,79
2004,Burkina Faso,BFA,United Kingdom of Great Britain and Northern Ireland,GBR,0,0,12,0,12
2004,Belarus,BLR,United Kingdom of Great Britain and Northern Ireland,GBR,0,0,112,84,196
2004,Bolivia (Plurinational State of),BOL,United Kingdom of Great Britain and Northern Ireland,GBR,5,0,16,0,21
2004,Botswana,BWA,United Kingdom of Great Britain and Northern Ireland,GBR,0,0,10,0,10
2004,Brazil,BRA,United Kingdom of Great Britain and Northern Ireland,GBR,0,0,36,0,36
2004,Bosnia and Herzegovina,BIH,United Kingdom of Great Britain and Northern Ireland,GBR,0,0,36,10,46
2004,Bulgaria,BGR,United Kingdom of Great Britain and Northern Ireland,GBR,0,0,16,5,21
2004,Chad,TCD,United Kingdom of Great Britain and Northern Ireland,GBR,0,5,24,5,34
2004,China,CHN,United Kingdom of Great Britain and Northern Ireland,GBR,13,83,1867,703,2666
2004,Chile,CHL,United Kingdom of Great Britain and Northern Ireland,GBR,0,0,10,0,10
2004,Cameroon,CMR,United Kingdom of Great Britain and Northern Ireland,GBR,22,51,336,25,434
2004,Congo,COG,United Kingdom of Great Britain and Northern Ireland,GBR,16,24,246,15,301
2004,Dem. Rep. of the Congo,COD,United Kingdom of Great Britain and Northern Ireland,GBR,65,190,1796,206,2257
2004,Colombia,COL,United Kingdom of Great Britain and Northern Ireland,GBR,12,0,158,25,195
2004,Cuba,CUB,United Kingdom of Great Britain and Northern Ireland,GBR,0,0,18,5,23
2004,Cyprus,CYP,United Kingdom of Great Britain and Northern Ireland,GBR,0,0,32,0,32
2004,Czechia,CZE,United Kingdom of Great Britain and Northern Ireland,GBR,0,0,95,15,110
2004,Djibouti,DJI,United Kingdom of Great Britain and Northern Ireland,GBR,0,0,10,0,10
2004,Ecuador,ECU,United Kingdom of Great Britain and Northern Ireland,GBR,0,5,71,5,81
2004,Equatorial Guinea,GNQ,United Kingdom of Great Britain and Northern Ireland,GBR,0,0,5,0,5
2004,Eritrea,ERI,United Kingdom of Great Britain and Northern Ireland,GBR,85,189,707,145,1126
2004,Estonia,EST,United Kingdom of Great Britain and Northern Ireland,GBR,0,0,13,0,13
2004,Ethiopia,ETH,United Kingdom of Great Britain and Northern Ireland,GBR,14,132,516,50,712
2004,Gabon,GAB,United Kingdom of Great Britain and Northern Ireland,GBR,0,0,5,0,5
2004,Gambia,GMB,United Kingdom of Great Britain and Northern Ireland,GBR,0,0,115,16,131
2004,Palestinian,PSE,United Kingdom of Great Britain and Northern Ireland,GBR,26,25,525,120,696
2004,Georgia,GEO,United Kingdom of Great Britain and Northern Ireland,GBR,10,10,170,32,222
2004,Ghana,GHA,United Kingdom of Great Britain and Northern Ireland,GBR,10,5,305,48,368
2004,Guinea-Bissau,GNB,United Kingdom of Great Britain and Northern Ireland,GBR,0,0,23,0,23
2004,Guinea,GIN,United Kingdom of Great Britain and Northern Ireland,GBR,5,50,267,22,344
2004,Guyana,GUY,United Kingdom of Great Britain and Northern Ireland,GBR,5,0,10,0,15
2004,Croatia,HRV,United Kingdom of Great Britain and Northern Ireland,GBR,0,0,40,0,40
2004,Hungary,HUN,United Kingdom of Great Britain and Northern Ireland,GBR,0,0,5,0,5
2004,Cote d'Ivoire,CIV,United Kingdom of Great Britain and Northern Ireland,GBR,5,16,270,22,313
2004,India,IND,United Kingdom of Great Britain and Northern Ireland,GBR,5,16,1146,455,1622
2004,Indonesia,IDN,United Kingdom of Great Britain and Northern Ireland,GBR,5,0,20,10,35
2004,Iran (Islamic Rep. of),IRN,United Kingdom of Great Britain and Northern Ireland,GBR,97,240,3605,611,4553
2004,Iraq,IRQ,United Kingdom of Great Britain and Northern Ireland,GBR,11,191,4122,773,5097
2004,Israel,ISR,United Kingdom of Great Britain and Northern Ireland,GBR,0,0,68,10,78
2004,Jamaica,JAM,United Kingdom of Great Britain and Northern Ireland,GBR,0,15,543,30,588
2004,Jordan,JOR,United Kingdom of Great Britain and Northern Ireland,GBR,0,0,16,0,16
2004,Kazakhstan,KAZ,United Kingdom of Great Britain and Northern Ireland,GBR,0,0,5,0,5
2004,Kenya,KEN,United Kingdom of Great Britain and Northern Ireland,GBR,10,32,198,25,265
2004,Kyrgyzstan,KGZ,United Kingdom of Great Britain and Northern Ireland,GBR,5,0,19,5,29
2004,Dem. People's Rep. of Korea,PRK,United Kingdom of Great Britain and Northern Ireland,GBR,5,11,36,13,65
2004,Kuwait,KWT,United Kingdom of Great Britain and Northern Ireland,GBR,0,0,41,5,46
2004,Liberia,LBR,United Kingdom of Great Britain and Northern Ireland,GBR,5,64,378,95,542
2004,Libya,LBY,United Kingdom of Great Britain and Northern Ireland,GBR,26,5,175,33,239
2004,Lebanon,LBN,United Kingdom of Great Britain and Northern Ireland,GBR,0,5,181,21,207
2004,Sri Lanka,LKA,United Kingdom of Great Britain and Northern Ireland,GBR,10,88,663,74,835
2004,Lithuania,LTU,United Kingdom of Great Britain and Northern Ireland,GBR,0,0,53,13,66
2004,Latvia,LVA,United Kingdom of Great Britain and Northern Ireland,GBR,0,0,25,0,25
2004,Mauritania,MRT,United Kingdom of Great Britain and Northern Ireland,GBR,5,0,11,0,16
2004,North Macedonia,MKD,United Kingdom of Great Britain and Northern Ireland,GBR,0,13,27,5,45
2004,Rep. of Moldova,MDA,United Kingdom of Great Britain and Northern Ireland,GBR,0,35,106,77,218
2004,Mali,MLI,United Kingdom of Great Britain and Northern Ireland,GBR,0,0,10,0,10
2004,Malaysia,MYS,United Kingdom of Great Britain and Northern Ireland,GBR,0,0,10,0,10
2004,Malawi,MWI,United Kingdom of Great Britain and Northern Ireland,GBR,0,5,167,18,190
2004,Mongolia,MNG,United Kingdom of Great Britain and Northern Ireland,GBR,10,5,158,33,206
2004,Morocco,MAR,United Kingdom of Great Britain and Northern Ireland,GBR,0,5,25,10,40
2004,Mozambique,MOZ,United Kingdom of Great Britain and Northern Ireland,GBR,0,0,5,0,5
2004,Mauritius,MUS,United Kingdom of Great Britain and Northern Ireland,GBR,5,0,25,5,35
2004,Myanmar,MMR,United Kingdom of Great Britain and Northern Ireland,GBR,18,0,82,5,105
2004,Nepal,NPL,United Kingdom of Great Britain and Northern Ireland,GBR,5,5,180,35,225
2004,Niger,NER,United Kingdom of Great Britain and Northern Ireland,GBR,0,0,5,0,5
2004,Nicaragua,NIC,United Kingdom of Great Britain and Northern Ireland,GBR,0,0,5,0,5
2004,Nigeria,NGA,United Kingdom of Great Britain and Northern Ireland,GBR,5,46,971,163,1185
2004,Pakistan,PAK,United Kingdom of Great Britain and Northern Ireland,GBR,125,108,2949,227,3409
2004,Peru,PER,United Kingdom of Great Britain and Northern Ireland,GBR,0,0,13,0,13
2004,Philippines,PHL,United Kingdom of Great Britain and Northern Ireland,GBR,0,0,22,5,27
2004,Poland,POL,United Kingdom of Great Britain and Northern Ireland,GBR,0,0,88,10,98
2004,Qatar,QAT,United Kingdom of Great Britain and Northern Ireland,GBR,0,0,5,0,5
2004,Romania,ROU,United Kingdom of Great Britain and Northern Ireland,GBR,0,85,298,111,494
2004,South Africa,ZAF,United Kingdom of Great Britain and Northern Ireland,GBR,0,0,305,13,318
2004,Russian Federation,RUS,United Kingdom of Great Britain and Northern Ireland,GBR,40,5,275,58,378
2004,Rwanda,RWA,United Kingdom of Great Britain and Northern Ireland,GBR,20,26,190,21,257
2004,El Salvador,SLV,United Kingdom of Great Britain and Northern Ireland,GBR,5,0,5,0,10
2004,Serbia and Kosovo: S/RES/1244 (1999),SRB,United Kingdom of Great Britain and Northern Ireland,GBR,23,165,1022,181,1391
2004,Senegal,SEN,United Kingdom of Great Britain and Northern Ireland,GBR,0,0,19,10,29
2004,Seychelles,SYC,United Kingdom of Great Britain and Northern Ireland,GBR,0,0,11,0,11
2004,Sierra Leone,SLE,United Kingdom of Great Britain and Northern Ireland,GBR,10,50,303,55,418
2004,Somalia,SOM,United Kingdom of Great Britain and Northern Ireland,GBR,652,482,2710,483,4327
2004,Viet Nam,VNM,United Kingdom of Great Britain and Northern Ireland,GBR,5,220,440,267,932
2004,Sudan,SDN,United Kingdom of Great Britain and Northern Ireland,GBR,130,49,1094,336,1609
2004,Slovakia,SVK,United Kingdom of Great Britain and Northern Ireland,GBR,0,0,24,0,24
2004,Eswatini,SWZ,United Kingdom of Great Britain and Northern Ireland,GBR,0,0,5,0,5
2004,Syrian Arab Rep.,SYR,United Kingdom of Great Britain and Northern Ireland,GBR,19,16,273,50,358
2004,United Rep. of Tanzania,TZA,United Kingdom of Great Britain and Northern Ireland,GBR,5,5,18,0,28
2004,Thailand,THA,United Kingdom of Great Britain and Northern Ireland,GBR,5,0,10,0,15
2004,Tajikistan,TJK,United Kingdom of Great Britain and Northern Ireland,GBR,0,0,5,0,5
2004,Turkmenistan,TKM,United Kingdom of Great Britain and Northern Ireland,GBR,10,0,10,0,20
2004,Togo,TGO,United Kingdom of Great Britain and Northern Ireland,GBR,5,5,97,13,120
2004,Trinidad and Tobago,TTO,United Kingdom of Great Britain and Northern Ireland,GBR,0,0,5,5,10
2004,Tunisia,TUN,United Kingdom of Great Britain and Northern Ireland,GBR,0,0,21,5,26
2004,Turkey,TUR,United Kingdom of Great Britain and Northern Ireland,GBR,121,99,2295,265,2780
2004,Uganda,UGA,United Kingdom of Great Britain and Northern Ireland,GBR,31,112,391,29,563
2004,Ukraine,UKR,United Kingdom of Great Britain and Northern Ireland,GBR,5,10,155,17,187
2004,Uzbekistan,UZB,United Kingdom of Great Britain and Northern Ireland,GBR,0,0,25,5,30
2004,Venezuela (Bolivarian Republic of),VEN,United Kingdom of Great Britain and Northern Ireland,GBR,0,5,5,0,10
2004,Yemen,YEM,United Kingdom of Great Britain and Northern Ireland,GBR,5,22,143,12,182
2004,Zambia,ZMB,United Kingdom of Great Britain and Northern Ireland,GBR,5,0,21,10,36
2004,Zimbabwe,ZWE,United Kingdom of Great Britain and Northern Ireland,GBR,303,31,2686,188,3208
2004,Stateless,XXA,United Kingdom of Great Britain and Northern Ireland,GBR,0,0,98,18,116
2004,Unknown ,,United Kingdom of Great Britain and Northern Ireland,GBR,0,0,34,12,46
2004,Iran (Islamic Rep. of),IRN,Georgia,GEO,0,0,5,0,5
2004,Cote d'Ivoire,CIV,Guinea-Bissau,GNB,15,0,0,0,15
2004,Afghanistan,AFG,Greece,GRC,0,5,215,54,274
2004,Albania,ALB,Greece,GRC,0,0,16,0,16
2004,Algeria,DZA,Greece,GRC,0,0,15,5,20
2004,Egypt,EGY,Greece,GRC,0,0,86,0,86
2004,Armenia,ARM,Greece,GRC,0,0,22,0,22
2004,Burundi,BDI,Greece,GRC,0,0,10,0,10
2004,Bangladesh,BGD,Greece,GRC,0,0,192,5,197
2004,Belarus,BLR,Greece,GRC,0,0,22,0,22
2004,Bulgaria,BGR,Greece,GRC,0,0,32,0,32
2004,Central African Rep.,CAF,Greece,GRC,0,10,0,0,10
2004,China,CHN,Greece,GRC,0,0,79,22,101
2004,Cameroon,CMR,Greece,GRC,0,0,5,0,5
2004,Dem. Rep. of the Congo,COD,Greece,GRC,0,0,11,5,16
2004,Eritrea,ERI,Greece,GRC,0,0,12,5,17
2004,Ethiopia,ETH,Greece,GRC,0,0,23,5,28
2004,Gambia,GMB,Greece,GRC,0,0,5,0,5
2004,Palestinian,PSE,Greece,GRC,0,0,153,45,198
2004,Georgia,GEO,Greece,GRC,0,0,222,24,246
2004,Ghana,GHA,Greece,GRC,0,0,5,0,5
2004,Cote d'Ivoire,CIV,Greece,GRC,0,0,40,5,45
2004,India,IND,Greece,GRC,0,0,21,0,21
2004,Indonesia,IDN,Greece,GRC,0,0,5,0,5
2004,Iran (Islamic Rep. of),IRN,Greece,GRC,5,0,237,54,296
2004,Iraq,IRQ,Greece,GRC,0,0,785,165,950
2004,Kazakhstan,KAZ,Greece,GRC,0,0,5,0,5
2004,Liberia,LBR,Greece,GRC,0,0,5,0,5
2004,Libya,LBY,Greece,GRC,0,0,10,0,10
2004,Lebanon,LBN,Greece,GRC,0,0,5,0,5
2004,Sri Lanka,LKA,Greece,GRC,0,0,14,0,14
2004,Mauritania,MRT,Greece,GRC,0,0,14,0,14
2004,North Macedonia,MKD,Greece,GRC,0,0,5,0,5
2004,Rep. of Moldova,MDA,Greece,GRC,0,0,54,5,59
2004,Morocco,MAR,Greece,GRC,0,0,10,0,10
2004,Myanmar,MMR,Greece,GRC,0,0,219,5,224
2004,Nigeria,NGA,Greece,GRC,0,0,188,41,229
2004,Pakistan,PAK,Greece,GRC,0,0,325,13,338
2004,Philippines,PHL,Greece,GRC,0,0,5,0,5
2004,Romania,ROU,Greece,GRC,0,0,38,0,38
2004,Russian Federation,RUS,Greece,GRC,0,0,108,21,129
2004,Rwanda,RWA,Greece,GRC,0,0,15,0,15
2004,Serbia and Kosovo: S/RES/1244 (1999),SRB,Greece,GRC,0,0,0,5,5
2004,Sierra Leone,SLE,Greece,GRC,0,0,26,0,26
2004,Somalia,SOM,Greece,GRC,0,0,118,57,175
2004,Sudan,SDN,Greece,GRC,0,0,65,31,96
2004,Syrian Arab Rep.,SYR,Greece,GRC,0,0,26,0,26
2004,Turkey,TUR,Greece,GRC,0,5,120,12,137
2004,Ukraine,UKR,Greece,GRC,5,0,78,5,88
2004,Uzbekistan,UZB,Greece,GRC,0,0,10,5,15
2004,Unknown ,,Greece,GRC,0,0,35,5,40
2004,Colombia,COL,Guatemala,GTM,0,0,0,5,5
2004,Cuba,CUB,Guatemala,GTM,0,0,0,5,5
2004,Dem. Rep. of the Congo,COD,Guinea,GIN,5,0,5,0,10
2004,Cote d'Ivoire,CIV,Guinea,GIN,94,0,26,0,120
2004,Liberia,LBR,Guinea,GIN,143,0,27,0,170
2004,Sierra Leone,SLE,Guinea,GIN,133,0,24,0,157
2004,Togo,TGO,Guinea,GIN,12,0,0,0,12
2004,Colombia,COL,Honduras,HND,0,0,0,5,5
2004,Cuba,CUB,Honduras,HND,0,0,15,34,49
2004,Eritrea,ERI,Honduras,HND,0,0,0,5,5
2004,Ethiopia,ETH,Honduras,HND,0,0,0,10,10
2004,Haiti,HTI,Honduras,HND,0,0,0,5,5
2004,Algeria,DZA,Croatia,HRV,0,0,12,0,12
2004,Egypt,EGY,Croatia,HRV,0,0,5,0,5
2004,Bangladesh,BGD,Croatia,HRV,0,0,0,5,5
2004,Cuba,CUB,Croatia,HRV,0,0,5,0,5
2004,Cote d'Ivoire,CIV,Croatia,HRV,0,0,5,0,5
2004,India,IND,Croatia,HRV,0,0,10,5,15
2004,Iraq,IRQ,Croatia,HRV,0,0,5,0,5
2004,Sri Lanka,LKA,Croatia,HRV,0,0,5,0,5
2004,North Macedonia,MKD,Croatia,HRV,0,0,0,10,10
2004,Pakistan,PAK,Croatia,HRV,0,0,10,0,10
2004,Russian Federation,RUS,Croatia,HRV,0,0,5,0,5
2004,Serbia and Kosovo: S/RES/1244 (1999),SRB,Croatia,HRV,0,0,16,0,16
2004,Turkey,TUR,Croatia,HRV,0,0,22,11,33
2004,Afghanistan,AFG,Hungary,HUN,19,39,5,13,76
2004,Algeria,DZA,Hungary,HUN,0,0,51,20,71
2004,Armenia,ARM,Hungary,HUN,5,5,12,10,32
2004,Bangladesh,BGD,Hungary,HUN,0,0,16,5,21
2004,Belarus,BLR,Hungary,HUN,0,0,0,5,5
2004,China,CHN,Hungary,HUN,0,0,45,10,55
2004,Cameroon,CMR,Hungary,HUN,0,5,5,0,10
2004,Congo,COG,Hungary,HUN,0,0,5,0,5
2004,Dem. Rep. of the Congo,COD,Hungary,HUN,0,0,5,0,5
2004,Cuba,CUB,Hungary,HUN,0,5,0,0,5
2004,Ethiopia,ETH,Hungary,HUN,0,5,0,0,5
2004,Gambia,GMB,Hungary,HUN,0,0,5,5,10
2004,Palestinian,PSE,Hungary,HUN,10,5,15,26,56
2004,Georgia,GEO,Hungary,HUN,0,10,78,147,235
2004,India,IND,Hungary,HUN,0,0,23,10,33
2004,Iran (Islamic Rep. of),IRN,Hungary,HUN,20,5,27,12,64
2004,Iraq,IRQ,Hungary,HUN,19,33,10,12,74
2004,Liberia,LBR,Hungary,HUN,0,0,5,0,5
2004,North Macedonia,MKD,Hungary,HUN,0,0,5,5,10
2004,Rep. of Moldova,MDA,Hungary,HUN,0,0,24,25,49
2004,Mongolia,MNG,Hungary,HUN,0,0,10,0,10
2004,Nepal,NPL,Hungary,HUN,5,0,16,5,26
2004,Nigeria,NGA,Hungary,HUN,5,5,56,17,83
2004,Pakistan,PAK,Hungary,HUN,5,0,21,25,51
2004,Romania,ROU,Hungary,HUN,0,0,14,10,24
2004,Russian Federation,RUS,Hungary,HUN,0,5,22,21,48
2004,Serbia and Kosovo: S/RES/1244 (1999),SRB,Hungary,HUN,23,13,66,48,150
2004,Senegal,SEN,Hungary,HUN,0,0,5,0,5
2004,Sierra Leone,SLE,Hungary,HUN,0,0,0,5,5
2004,Somalia,SOM,Hungary,HUN,5,5,0,5,15
2004,Viet Nam,VNM,Hungary,HUN,0,0,99,0,99
2004,Sudan,SDN,Hungary,HUN,0,0,0,5,5
2004,Slovakia,SVK,Hungary,HUN,0,0,11,0,11
2004,Syrian Arab Rep.,SYR,Hungary,HUN,0,5,5,0,10
2004,Tunisia,TUN,Hungary,HUN,0,0,5,0,5
2004,Turkey,TUR,Hungary,HUN,10,10,60,47,127
2004,Ukraine,UKR,Hungary,HUN,0,10,18,13,41
2004,Stateless,XXA,Hungary,HUN,5,0,5,10,20
2004,Unknown ,,Hungary,HUN,11,0,0,0,11
2004,Albania,ALB,Iceland,ISL,0,0,5,0,5
2004,Bulgaria,BGR,Iceland,ISL,0,0,5,0,5
2004,Palestinian,PSE,Iceland,ISL,0,0,0,5,5
2004,Iraq,IRQ,Iceland,ISL,0,0,0,5,5
2004,Sri Lanka,LKA,Iceland,ISL,0,0,5,5,10
2004,Nigeria,NGA,Iceland,ISL,0,0,5,5,10
2004,Serbia and Kosovo: S/RES/1244 (1999),SRB,Iceland,ISL,0,0,5,0,5
2004,Afghanistan,AFG,Ireland,IRL,16,0,16,5,37
2004,Albania,ALB,Ireland,IRL,5,0,123,34,162
2004,Algeria,DZA,Ireland,IRL,0,0,49,19,68
2004,Angola,AGO,Ireland,IRL,10,0,39,5,54
2004,Egypt,EGY,Ireland,IRL,0,0,15,5,20
2004,Armenia,ARM,Ireland,IRL,5,0,5,0,10
2004,Azerbaijan,AZE,Ireland,IRL,5,0,5,0,10
2004,Burundi,BDI,Ireland,IRL,5,0,30,5,40
2004,Benin,BEN,Ireland,IRL,0,0,5,0,5
2004,Belarus,BLR,Ireland,IRL,5,0,22,5,32
2004,Brazil,BRA,Ireland,IRL,0,0,10,5,15
2004,Bosnia and Herzegovina,BIH,Ireland,IRL,0,0,10,0,10
2004,Bulgaria,BGR,Ireland,IRL,0,0,5,5,10
2004,China,CHN,Ireland,IRL,23,0,69,142,234
2004,Cameroon,CMR,Ireland,IRL,11,0,81,10,102
2004,Congo,COG,Ireland,IRL,0,0,11,0,11
2004,Dem. Rep. of the Congo,COD,Ireland,IRL,0,0,199,14,213
2004,Cuba,CUB,Ireland,IRL,0,0,5,0,5
2004,Czechia,CZE,Ireland,IRL,5,0,49,5,59
2004,Eritrea,ERI,Ireland,IRL,0,0,18,0,18
2004,Estonia,EST,Ireland,IRL,0,0,5,5,10
2004,Ethiopia,ETH,Ireland,IRL,5,0,10,0,15
2004,Gambia,GMB,Ireland,IRL,0,0,10,0,10
2004,Palestinian,PSE,Ireland,IRL,12,0,10,10,32
2004,United Kingdom of Great Britain and Northern Ireland,GBR,Ireland,IRL,0,0,5,0,5
2004,Georgia,GEO,Ireland,IRL,5,0,99,26,130
2004,Ghana,GHA,Ireland,IRL,0,0,92,13,105
2004,Guinea,GIN,Ireland,IRL,5,0,10,5,20
2004,Croatia,HRV,Ireland,IRL,5,0,128,21,154
2004,Cote d'Ivoire,CIV,Ireland,IRL,0,0,39,5,44
2004,India,IND,Ireland,IRL,0,0,5,10,15
2004,Iran (Islamic Rep. of),IRN,Ireland,IRL,20,0,19,5,44
2004,Iraq,IRQ,Ireland,IRL,34,0,64,93,191
2004,Israel,ISR,Ireland,IRL,0,0,22,0,22
2004,Jamaica,JAM,Ireland,IRL,0,0,10,0,10
2004,Kazakhstan,KAZ,Ireland,IRL,0,0,11,5,16
2004,Kenya,KEN,Ireland,IRL,10,0,35,10,55
2004,Kyrgyzstan,KGZ,Ireland,IRL,5,0,5,0,10
2004,Liberia,LBR,Ireland,IRL,10,0,73,16,99
2004,Libya,LBY,Ireland,IRL,0,0,5,5,10
2004,Lebanon,LBN,Ireland,IRL,0,0,5,5,10
2004,Lesotho,LSO,Ireland,IRL,0,0,5,0,5
2004,Sri Lanka,LKA,Ireland,IRL,5,0,0,0,5
2004,Lithuania,LTU,Ireland,IRL,0,0,10,12,22
2004,Latvia,LVA,Ireland,IRL,0,0,5,5,10
2004,North Macedonia,MKD,Ireland,IRL,0,0,5,0,5
2004,Rep. of Moldova,MDA,Ireland,IRL,5,0,86,34,125
2004,Malawi,MWI,Ireland,IRL,0,0,5,0,5
2004,Mongolia,MNG,Ireland,IRL,0,0,0,5,5
2004,Morocco,MAR,Ireland,IRL,0,0,5,0,5
2004,Mozambique,MOZ,Ireland,IRL,0,0,5,0,5
2004,Nepal,NPL,Ireland,IRL,0,0,5,0,5
2004,Nigeria,NGA,Ireland,IRL,18,0,2605,642,3265
2004,Pakistan,PAK,Ireland,IRL,5,0,62,5,72
2004,Poland,POL,Ireland,IRL,0,0,24,27,51
2004,Romania,ROU,Ireland,IRL,5,0,216,138,359
2004,South Africa,ZAF,Ireland,IRL,0,0,67,20,87
2004,Russian Federation,RUS,Ireland,IRL,14,0,52,26,92
2004,Rwanda,RWA,Ireland,IRL,0,0,15,5,20
2004,Serbia and Kosovo: S/RES/1244 (1999),SRB,Ireland,IRL,5,0,67,27,99
2004,Sierra Leone,SLE,Ireland,IRL,0,0,16,10,26
2004,Somalia,SOM,Ireland,IRL,82,0,78,20,180
2004,Sudan,SDN,Ireland,IRL,34,0,11,11,56
2004,Slovakia,SVK,Ireland,IRL,0,0,5,5,10
2004,Syrian Arab Rep.,SYR,Ireland,IRL,5,0,5,5,15
2004,Turkmenistan,TKM,Ireland,IRL,0,0,0,5,5
2004,Togo,TGO,Ireland,IRL,0,0,37,0,37
2004,Tunisia,TUN,Ireland,IRL,0,0,5,0,5
2004,Turkey,TUR,Ireland,IRL,0,0,11,10,21
2004,Uganda,UGA,Ireland,IRL,0,0,18,5,23
2004,Ukraine,UKR,Ireland,IRL,14,0,62,15,91
2004,Zimbabwe,ZWE,Ireland,IRL,18,0,40,10,68
2004,Stateless,XXA,Ireland,IRL,5,0,19,10,34
2004,Burundi,BDI,Israel,ISR,0,0,0,5,5
2004,Cameroon,CMR,Israel,ISR,0,0,0,10,10
2004,Dem. Rep. of the Congo,COD,Israel,ISR,0,10,0,10,20
2004,Colombia,COL,Israel,ISR,0,0,5,11,16
2004,Eritrea,ERI,Israel,ISR,0,0,0,5,5
2004,Ethiopia,ETH,Israel,ISR,0,0,0,257,257
2004,Ghana,GHA,Israel,ISR,0,0,0,31,31
2004,Guinea,GIN,Israel,ISR,0,0,0,5,5
2004,Cote d'Ivoire,CIV,Israel,ISR,0,35,0,39,74
2004,Kenya,KEN,Israel,ISR,0,0,0,10,10
2004,Liberia,LBR,Israel,ISR,0,11,0,50,61
2004,Sri Lanka,LKA,Israel,ISR,0,0,0,13,13
2004,Mali,MLI,Israel,ISR,0,0,0,5,5
2004,Myanmar,MMR,Israel,ISR,0,0,0,5,5
2004,Nepal,NPL,Israel,ISR,0,0,0,5,5
2004,Nigeria,NGA,Israel,ISR,0,0,0,81,81
2004,Philippines,PHL,Israel,ISR,0,0,0,5,5
2004,Sierra Leone,SLE,Israel,ISR,0,0,0,18,18
2004,Sudan,SDN,Israel,ISR,0,0,0,12,12
2004,Eswatini,SWZ,Israel,ISR,0,0,0,5,5
2004,United Rep. of Tanzania,TZA,Israel,ISR,0,0,0,5,5
2004,Togo,TGO,Israel,ISR,0,0,0,19,19
2004,Turkey,TUR,Israel,ISR,0,0,0,19,19
2004,Zimbabwe,ZWE,Israel,ISR,0,0,0,10,10
2004,Unknown ,,Israel,ISR,0,0,0,23,23
2004,Bangladesh,BGD,Japan,JPN,0,0,5,5,10
2004,China,CHN,Japan,JPN,0,0,10,0,10
2004,Cameroon,CMR,Japan,JPN,0,0,5,0,5
2004,Dem. Rep. of the Congo,COD,Japan,JPN,0,0,5,0,5
2004,Colombia,COL,Japan,JPN,0,0,5,0,5
2004,Guinea,GIN,Japan,JPN,0,0,5,0,5
2004,India,IND,Japan,JPN,0,0,12,0,12
2004,Iran (Islamic Rep. of),IRN,Japan,JPN,0,0,13,5,18
2004,Sri Lanka,LKA,Japan,JPN,0,0,5,0,5
2004,Myanmar,MMR,Japan,JPN,10,0,46,0,56
2004,Pakistan,PAK,Japan,JPN,0,0,10,0,10
2004,Philippines,PHL,Japan,JPN,0,0,5,5,10
2004,Russian Federation,RUS,Japan,JPN,0,0,5,0,5
2004,Viet Nam,VNM,Japan,JPN,0,0,5,0,5
2004,Turkey,TUR,Japan,JPN,0,0,135,13,148
2004,Unknown ,,Japan,JPN,0,10,12,0,22
2004,Afghanistan,AFG,Kazakhstan,KAZ,69,0,27,0,96
2004,Afghanistan,AFG,Kyrgyzstan,KGZ,36,0,19,21,76
2004,India,IND,Kyrgyzstan,KGZ,5,0,0,0,5
2004,Iran (Islamic Rep. of),IRN,Kyrgyzstan,KGZ,5,0,0,0,5
2004,Iraq,IRQ,Kyrgyzstan,KGZ,5,0,0,0,5
2004,Sri Lanka,LKA,Kyrgyzstan,KGZ,0,0,0,5,5
2004,Russian Federation,RUS,Kyrgyzstan,KGZ,0,0,0,166,166
2004,Syrian Arab Rep.,SYR,Kyrgyzstan,KGZ,5,0,12,0,17
2004,Tajikistan,TJK,Kyrgyzstan,KGZ,23,0,0,0,23
2004,Belarus,BLR,Liechtenstein,LIE,0,0,5,10,15
2004,Bosnia and Herzegovina,BIH,Liechtenstein,LIE,0,0,0,5,5
2004,Germany,DEU,Liechtenstein,LIE,0,0,0,5,5
2004,Kazakhstan,KAZ,Liechtenstein,LIE,0,0,0,5,5
2004,North Macedonia,MKD,Liechtenstein,LIE,0,0,0,13,13
2004,Russian Federation,RUS,Liechtenstein,LIE,0,0,10,11,21
2004,Serbia and Kosovo: S/RES/1244 (1999),SRB,Liechtenstein,LIE,0,0,0,15,15
2004,Ukraine,UKR,Liechtenstein,LIE,0,0,5,0,5
2004,Afghanistan,AFG,Lithuania,LTU,0,5,0,13,18
2004,Egypt,EGY,Lithuania,LTU,0,0,5,10,15
2004,Palestinian,PSE,Lithuania,LTU,0,0,5,0,5
2004,India,IND,Lithuania,LTU,0,0,0,21,21
2004,Pakistan,PAK,Lithuania,LTU,0,0,5,24,29
2004,Russian Federation,RUS,Lithuania,LTU,12,52,11,18,93
2004,Stateless,XXA,Lithuania,LTU,0,0,5,0,5
2004,Unknown ,,Luxembourg,LUX,82,307,873,635,1897
2004,Serbia and Kosovo: S/RES/1244 (1999),SRB,North Macedonia,MKD,10,956,5,184,1155
2004,Armenia,ARM,Rep. of Moldova,MDA,5,0,0,0,5
2004,Palestinian,PSE,Rep. of Moldova,MDA,0,0,5,0,5
2004,Iraq,IRQ,Rep. of Moldova,MDA,0,0,5,0,5
2004,Russian Federation,RUS,Rep. of Moldova,MDA,0,0,5,23,28
2004,Turkey,TUR,Rep. of Moldova,MDA,0,0,0,5,5
2004,Bangladesh,BGD,Mexico,MEX,0,0,5,0,5
2004,Colombia,COL,Mexico,MEX,5,5,22,10,42
2004,Cuba,CUB,Mexico,MEX,0,0,5,17,22
2004,Eritrea,ERI,Mexico,MEX,12,0,0,0,12
2004,Ethiopia,ETH,Mexico,MEX,24,0,5,5,34
2004,Guatemala,GTM,Mexico,MEX,0,0,10,5,15
2004,Guinea,GIN,Mexico,MEX,0,0,5,0,5
2004,Haiti,HTI,Mexico,MEX,0,0,0,5,5
2004,Honduras,HND,Mexico,MEX,5,0,36,20,61
2004,India,IND,Mexico,MEX,0,0,5,0,5
2004,Liberia,LBR,Mexico,MEX,0,0,10,0,10
2004,Sri Lanka,LKA,Mexico,MEX,5,0,10,0,15
2004,Nicaragua,NIC,Mexico,MEX,0,0,5,5,10
2004,Peru,PER,Mexico,MEX,0,0,5,5,10
2004,El Salvador,SLV,Mexico,MEX,5,0,22,10,37
2004,Somalia,SOM,Mexico,MEX,11,0,0,0,11
2004,Ukraine,UKR,Mexico,MEX,0,0,5,0,5
2004,Venezuela (Bolivarian Republic of),VEN,Mexico,MEX,0,0,0,5,5
2004,Burundi,BDI,Mali,MLI,5,0,0,0,5
2004,Congo,COG,Mali,MLI,5,0,0,0,5
2004,Dem. Rep. of the Congo,COD,Mali,MLI,17,0,0,0,17
2004,Cote d'Ivoire,CIV,Mali,MLI,743,0,0,0,743
2004,Liberia,LBR,Mali,MLI,49,0,0,0,49
2004,Mauritania,MRT,Mali,MLI,37,0,0,0,37
2004,Rwanda,RWA,Mali,MLI,5,0,0,0,5
2004,Burundi,BDI,Malawi,MWI,310,0,0,2045,2355
2004,Dem. Rep. of the Congo,COD,Malawi,MWI,317,0,5,1123,1445
2004,Rwanda,RWA,Malawi,MWI,847,0,0,5390,6237
2004,Somalia,SOM,Malawi,MWI,5,0,0,100,105
2004,Sudan,SDN,Malawi,MWI,0,0,0,5,5
2004,Algeria,DZA,Malta,MLT,0,0,10,0,10
2004,Egypt,EGY,Malta,MLT,5,0,0,5,10
2004,Bangladesh,BGD,Malta,MLT,0,0,5,0,5
2004,Dem. Rep. of the Congo,COD,Malta,MLT,0,5,41,0,46
2004,Eritrea,ERI,Malta,MLT,5,51,5,0,61
2004,Ethiopia,ETH,Malta,MLT,5,0,13,0,18
2004,Palestinian,PSE,Malta,MLT,0,0,33,0,33
2004,Cote d'Ivoire,CIV,Malta,MLT,0,0,21,0,21
2004,India,IND,Malta,MLT,0,0,10,0,10
2004,Iran (Islamic Rep. of),IRN,Malta,MLT,5,0,0,0,5
2004,Iraq,IRQ,Malta,MLT,5,5,10,0,20
2004,Kyrgyzstan,KGZ,Malta,MLT,0,0,5,0,5
2004,Liberia,LBR,Malta,MLT,0,0,5,0,5
2004,Libya,LBY,Malta,MLT,0,0,5,0,5
2004,Sri Lanka,LKA,Malta,MLT,15,0,0,0,15
2004,Morocco,MAR,Malta,MLT,10,0,0,0,10
2004,Nigeria,NGA,Malta,MLT,0,0,13,0,13
2004,Pakistan,PAK,Malta,MLT,0,0,16,0,16
2004,Russian Federation,RUS,Malta,MLT,0,0,5,0,5
2004,Sierra Leone,SLE,Malta,MLT,5,0,0,0,5
2004,Somalia,SOM,Malta,MLT,0,465,5,0,470
2004,Sudan,SDN,Malta,MLT,0,16,18,0,34
2004,Tunisia,TUN,Malta,MLT,0,0,5,0,5
2004,Turkey,TUR,Malta,MLT,0,0,26,5,31
2004,Unknown ,,Malta,MLT,0,11,0,0,11
2004,Afghanistan,AFG,Netherlands,NLD,64,393,565,184,1206
2004,Albania,ALB,Netherlands,NLD,0,5,56,14,75
2004,Algeria,DZA,Netherlands,NLD,0,0,68,24,92
2004,Angola,AGO,Netherlands,NLD,5,108,325,123,561
2004,Egypt,EGY,Netherlands,NLD,0,0,16,5,21
2004,Armenia,ARM,Netherlands,NLD,5,37,253,74,369
2004,Azerbaijan,AZE,Netherlands,NLD,22,77,323,103,525
2004,Burundi,BDI,Netherlands,NLD,14,271,116,35,436
2004,Benin,BEN,Netherlands,NLD,0,0,16,0,16
2004,Bangladesh,BGD,Netherlands,NLD,0,5,22,0,27
2004,Bhutan,BTN,Netherlands,NLD,0,0,0,5,5
2004,Burkina Faso,BFA,Netherlands,NLD,0,0,5,0,5
2004,Belarus,BLR,Netherlands,NLD,0,5,34,10,49
2004,Bosnia and Herzegovina,BIH,Netherlands,NLD,0,30,95,12,137
2004,Bulgaria,BGR,Netherlands,NLD,0,0,5,0,5
2004,Chad,TCD,Netherlands,NLD,0,0,0,5,5
2004,China,CHN,Netherlands,NLD,13,20,229,114,376
2004,Cameroon,CMR,Netherlands,NLD,10,13,77,25,125
2004,Congo,COG,Netherlands,NLD,5,33,76,23,137
2004,Dem. Rep. of the Congo,COD,Netherlands,NLD,0,64,128,54,246
2004,Colombia,COL,Netherlands,NLD,5,5,123,24,157
2004,Cuba,CUB,Netherlands,NLD,0,0,10,0,10
2004,Czechia,CZE,Netherlands,NLD,0,0,16,0,16
2004,Eritrea,ERI,Netherlands,NLD,10,59,74,14,157
2004,Ethiopia,ETH,Netherlands,NLD,5,42,55,22,124
2004,France,FRA,Netherlands,NLD,0,0,5,0,5
2004,Gabon,GAB,Netherlands,NLD,0,0,5,0,5
2004,Gambia,GMB,Netherlands,NLD,0,0,14,0,14
2004,Georgia,GEO,Netherlands,NLD,5,16,66,22,109
2004,Ghana,GHA,Netherlands,NLD,0,0,15,10,25
2004,Guinea-Bissau,GNB,Netherlands,NLD,0,0,5,0,5
2004,Guinea,GIN,Netherlands,NLD,5,46,154,49,254
2004,Croatia,HRV,Netherlands,NLD,0,0,13,5,18
2004,Hungary,HUN,Netherlands,NLD,0,0,0,10,10
2004,Cote d'Ivoire,CIV,Netherlands,NLD,10,10,85,17,122
2004,India,IND,Netherlands,NLD,0,0,124,55,179
2004,Indonesia,IDN,Netherlands,NLD,0,0,5,0,5
2004,Iran (Islamic Rep. of),IRN,Netherlands,NLD,72,137,415,94,718
2004,Iraq,IRQ,Netherlands,NLD,13,1244,703,512,2472
2004,Kazakhstan,KAZ,Netherlands,NLD,0,5,22,0,27
2004,Kenya,KEN,Netherlands,NLD,0,0,5,0,5
2004,Kyrgyzstan,KGZ,Netherlands,NLD,0,0,10,0,10
2004,Dem. People's Rep. of Korea,PRK,Netherlands,NLD,0,0,5,0,5
2004,Liberia,LBR,Netherlands,NLD,0,20,143,63,226
2004,Libya,LBY,Netherlands,NLD,0,5,45,11,61
2004,Lebanon,LBN,Netherlands,NLD,0,5,25,5,35
2004,Sri Lanka,LKA,Netherlands,NLD,0,28,76,17,121
2004,Lithuania,LTU,Netherlands,NLD,0,0,5,0,5
2004,Latvia,LVA,Netherlands,NLD,0,5,0,0,5
2004,Mauritania,MRT,Netherlands,NLD,0,0,13,10,23
2004,North Macedonia,MKD,Netherlands,NLD,0,0,27,10,37
2004,Rep. of Moldova,MDA,Netherlands,NLD,0,0,33,5,38
2004,Mali,MLI,Netherlands,NLD,0,0,5,0,5
2004,Mongolia,MNG,Netherlands,NLD,0,0,79,18,97
2004,Morocco,MAR,Netherlands,NLD,0,0,23,5,28
2004,Myanmar,MMR,Netherlands,NLD,0,5,14,0,19
2004,Nepal,NPL,Netherlands,NLD,5,0,55,17,77
2004,Netherlands,NLD,Netherlands,NLD,0,0,0,12,12
2004,Niger,NER,Netherlands,NLD,0,5,19,13,37
2004,Nigeria,NGA,Netherlands,NLD,0,10,239,65,314
2004,Pakistan,PAK,Netherlands,NLD,5,5,48,11,69
2004,Poland,POL,Netherlands,NLD,0,0,5,5,10
2004,Romania,ROU,Netherlands,NLD,0,0,19,5,24
2004,South Africa,ZAF,Netherlands,NLD,0,0,5,0,5
2004,Russian Federation,RUS,Netherlands,NLD,21,81,197,55,354
2004,Rwanda,RWA,Netherlands,NLD,10,35,44,19,108
2004,Saudi Arabia,SAU,Netherlands,NLD,0,5,0,0,5
2004,Serbia and Kosovo: S/RES/1244 (1999),SRB,Netherlands,NLD,5,76,427,99,607
2004,Sierra Leone,SLE,Netherlands,NLD,0,77,288,92,457
2004,Somalia,SOM,Netherlands,NLD,36,377,323,125,861
2004,Viet Nam,VNM,Netherlands,NLD,0,0,23,5,28
2004,Sudan,SDN,Netherlands,NLD,14,108,196,60,378
2004,Slovakia,SVK,Netherlands,NLD,0,0,18,23,41
2004,Syrian Arab Rep.,SYR,Netherlands,NLD,30,101,171,48,350
2004,United Rep. of Tanzania,TZA,Netherlands,NLD,0,0,10,0,10
2004,Tajikistan,TJK,Netherlands,NLD,5,12,10,5,32
2004,Togo,TGO,Netherlands,NLD,5,25,60,23,113
2004,Tunisia,TUN,Netherlands,NLD,5,5,5,5,20
2004,Turkey,TUR,Netherlands,NLD,12,49,278,98,437
2004,Uganda,UGA,Netherlands,NLD,0,5,25,10,40
2004,Ukraine,UKR,Netherlands,NLD,0,10,27,5,42
2004,Uzbekistan,UZB,Netherlands,NLD,0,5,35,5,45
2004,Yemen,YEM,Netherlands,NLD,0,0,10,5,15
2004,Zimbabwe,ZWE,Netherlands,NLD,0,0,10,0,10
2004,Stateless,XXA,Netherlands,NLD,14,42,219,55,330
2004,Unknown ,,Netherlands,NLD,33,309,560,254,1156
2004,Cameroon,CMR,Nigeria,NGA,47,0,0,0,47
2004,Congo,COG,Nigeria,NGA,5,0,0,0,5
2004,Dem. Rep. of the Congo,COD,Nigeria,NGA,32,0,0,0,32
2004,Cote d'Ivoire,CIV,Nigeria,NGA,5,0,5,0,10
2004,Liberia,LBR,Nigeria,NGA,142,0,5,0,147
2004,Sudan,SDN,Nigeria,NGA,5,0,0,0,5
2004,Afghanistan,AFG,Norway,NOR,25,358,739,20,1142
2004,Albania,ALB,Norway,NOR,0,5,79,10,94
2004,Algeria,DZA,Norway,NOR,5,5,101,37,148
2004,Angola,AGO,Norway,NOR,5,67,38,12,122
2004,Egypt,EGY,Norway,NOR,0,0,5,5,10
2004,Armenia,ARM,Norway,NOR,0,0,23,5,28
2004,Azerbaijan,AZE,Norway,NOR,0,0,80,5,85
2004,Burundi,BDI,Norway,NOR,11,54,27,0,92
2004,Benin,BEN,Norway,NOR,0,0,5,0,5
2004,Bangladesh,BGD,Norway,NOR,0,0,15,5,20
2004,Bhutan,BTN,Norway,NOR,0,5,10,0,15
2004,Belarus,BLR,Norway,NOR,0,5,51,16,72
2004,Bosnia and Herzegovina,BIH,Norway,NOR,0,5,68,52,125
2004,Bulgaria,BGR,Norway,NOR,0,0,23,5,28
2004,China,CHN,Norway,NOR,23,17,35,0,75
2004,Chile,CHL,Norway,NOR,0,0,5,0,5
2004,Cameroon,CMR,Norway,NOR,0,0,64,5,69
2004,Congo,COG,Norway,NOR,0,13,5,0,18
2004,Dem. Rep. of the Congo,COD,Norway,NOR,5,25,30,10,70
2004,Colombia,COL,Norway,NOR,0,5,0,0,5
2004,Cabo Verde,CPV,Norway,NOR,0,0,5,0,5
2004,Czechia,CZE,Norway,NOR,0,0,28,0,28
2004,Ecuador,ECU,Norway,NOR,0,5,0,0,5
2004,Eritrea,ERI,Norway,NOR,13,21,10,5,49
2004,Estonia,EST,Norway,NOR,0,0,5,0,5
2004,Ethiopia,ETH,Norway,NOR,27,25,97,5,154
2004,Georgia,GEO,Norway,NOR,0,0,43,5,48
2004,Ghana,GHA,Norway,NOR,0,0,10,5,15
2004,Guinea,GIN,Norway,NOR,0,5,60,5,70
2004,Croatia,HRV,Norway,NOR,0,0,23,0,23
2004,Hungary,HUN,Norway,NOR,0,0,12,0,12
2004,Cote d'Ivoire,CIV,Norway,NOR,0,0,18,0,18
2004,India,IND,Norway,NOR,0,0,5,5,10
2004,Iran (Islamic Rep. of),IRN,Norway,NOR,72,20,285,20,397
2004,Iraq,IRQ,Norway,NOR,27,434,364,92,917
2004,Israel,ISR,Norway,NOR,0,0,18,0,18
2004,Jordan,JOR,Norway,NOR,0,0,10,5,15
2004,Kazakhstan,KAZ,Norway,NOR,0,5,20,0,25
2004,Kenya,KEN,Norway,NOR,0,0,5,0,5
2004,Kyrgyzstan,KGZ,Norway,NOR,5,5,27,0,37
2004,Kuwait,KWT,Norway,NOR,0,0,5,0,5
2004,Liberia,LBR,Norway,NOR,0,21,29,5,55
2004,Libya,LBY,Norway,NOR,5,5,164,20,194
2004,Lebanon,LBN,Norway,NOR,0,5,29,5,39
2004,Sri Lanka,LKA,Norway,NOR,0,17,20,5,42
2004,Lithuania,LTU,Norway,NOR,0,0,15,5,20
2004,Latvia,LVA,Norway,NOR,0,0,5,0,5
2004,Mauritania,MRT,Norway,NOR,0,0,5,5,10
2004,North Macedonia,MKD,Norway,NOR,0,0,39,10,49
2004,Rep. of Moldova,MDA,Norway,NOR,0,0,25,5,30
2004,Mongolia,MNG,Norway,NOR,0,0,16,5,21
2004,Morocco,MAR,Norway,NOR,0,5,16,0,21
2004,Mozambique,MOZ,Norway,NOR,0,0,5,0,5
2004,Myanmar,MMR,Norway,NOR,0,0,5,0,5
2004,Nepal,NPL,Norway,NOR,5,0,47,0,52
2004,Niger,NER,Norway,NOR,0,0,15,5,20
2004,Nigeria,NGA,Norway,NOR,0,5,217,19,241
2004,Pakistan,PAK,Norway,NOR,5,11,45,10,71
2004,Poland,POL,Norway,NOR,0,0,5,0,5
2004,Romania,ROU,Norway,NOR,0,0,23,5,28
2004,Russian Federation,RUS,Norway,NOR,85,918,298,29,1330
2004,Rwanda,RWA,Norway,NOR,10,14,24,0,48
2004,Serbia and Kosovo: S/RES/1244 (1999),SRB,Norway,NOR,46,19,456,44,565
2004,Senegal,SEN,Norway,NOR,0,0,5,0,5
2004,Sierra Leone,SLE,Norway,NOR,0,5,27,5,37
2004,Somalia,SOM,Norway,NOR,24,801,513,49,1387
2004,Viet Nam,VNM,Norway,NOR,0,0,25,0,25
2004,Sudan,SDN,Norway,NOR,5,14,33,10,62
2004,Suriname,SUR,Norway,NOR,0,0,5,0,5
2004,Slovakia,SVK,Norway,NOR,0,0,10,5,15
2004,Syrian Arab Rep.,SYR,Norway,NOR,5,10,50,10,75
2004,Tajikistan,TJK,Norway,NOR,0,0,12,0,12
2004,Togo,TGO,Norway,NOR,0,0,14,0,14
2004,Turkey,TUR,Norway,NOR,0,16,95,19,130
2004,Uganda,UGA,Norway,NOR,0,0,10,0,10
2004,Ukraine,UKR,Norway,NOR,0,0,28,0,28
2004,Uzbekistan,UZB,Norway,NOR,0,5,30,10,45
2004,Western Sahara,ESH,Norway,NOR,0,0,10,5,15
2004,Yemen,YEM,Norway,NOR,0,0,5,5,10
2004,Zimbabwe,ZWE,Norway,NOR,0,5,0,0,5
2004,Stateless,XXA,Norway,NOR,41,63,184,47,335
2004,Albania,ALB,New Zealand,NZL,0,0,5,0,5
2004,Bangladesh,BGD,New Zealand,NZL,0,0,33,0,33
2004,Brazil,BRA,New Zealand,NZL,0,0,11,0,11
2004,China,CHN,New Zealand,NZL,5,0,46,0,51
2004,Chile,CHL,New Zealand,NZL,0,0,20,0,20
2004,Dem. Rep. of the Congo,COD,New Zealand,NZL,0,0,5,0,5
2004,Czechia,CZE,New Zealand,NZL,0,0,14,0,14
2004,Ethiopia,ETH,New Zealand,NZL,5,0,5,0,10
2004,Fiji,FJI,New Zealand,NZL,0,0,16,0,16
2004,Hungary,HUN,New Zealand,NZL,0,0,19,0,19
2004,India,IND,New Zealand,NZL,0,0,78,0,78
2004,Iran (Islamic Rep. of),IRN,New Zealand,NZL,38,0,83,0,121
2004,Iraq,IRQ,New Zealand,NZL,0,0,14,0,14
2004,Israel,ISR,New Zealand,NZL,0,0,10,0,10
2004,Jordan,JOR,New Zealand,NZL,0,0,5,0,5
2004,Kyrgyzstan,KGZ,New Zealand,NZL,0,0,5,0,5
2004,Libya,LBY,New Zealand,NZL,5,0,0,0,5
2004,Lebanon,LBN,New Zealand,NZL,0,0,5,0,5
2004,Sri Lanka,LKA,New Zealand,NZL,0,0,26,0,26
2004,Malaysia,MYS,New Zealand,NZL,0,0,21,0,21
2004,Mongolia,MNG,New Zealand,NZL,0,0,5,0,5
2004,Myanmar,MMR,New Zealand,NZL,5,0,5,0,10
2004,Nepal,NPL,New Zealand,NZL,0,0,10,0,10
2004,Nigeria,NGA,New Zealand,NZL,0,0,10,0,10
2004,Pakistan,PAK,New Zealand,NZL,0,0,10,0,10
2004,South Africa,ZAF,New Zealand,NZL,0,0,17,0,17
2004,Saudi Arabia,SAU,New Zealand,NZL,0,0,10,0,10
2004,Somalia,SOM,New Zealand,NZL,5,0,5,0,10
2004,Viet Nam,VNM,New Zealand,NZL,0,0,10,0,10
2004,Syrian Arab Rep.,SYR,New Zealand,NZL,5,0,5,0,10
2004,Thailand,THA,New Zealand,NZL,0,0,36,0,36
2004,Ukraine,UKR,New Zealand,NZL,0,0,5,0,5
2004,Zimbabwe,ZWE,New Zealand,NZL,10,0,23,0,33
2004,Colombia,COL,Panama,PAN,42,0,87,37,166
2004,Cuba,CUB,Panama,PAN,5,0,5,5,15
2004,Colombia,COL,Peru,PER,48,0,5,0,53
2004,Cuba,CUB,Peru,PER,16,0,0,5,21
2004,Palestinian,PSE,Peru,PER,5,0,0,0,5
2004,Iraq,IRQ,Peru,PER,0,0,0,5,5
2004,Rwanda,RWA,Philippines,PHL,0,0,0,5,5
2004,Indonesia,IDN,Papua New Guinea,PNG,0,0,0,114,114
2004,Afghanistan,AFG,Poland,POL,0,23,121,5,149
2004,Algeria,DZA,Poland,POL,0,0,10,0,10
2004,Armenia,ARM,Poland,POL,0,5,37,0,42
2004,Azerbaijan,AZE,Poland,POL,0,0,10,0,10
2004,Bangladesh,BGD,Poland,POL,0,0,5,0,5
2004,Belarus,BLR,Poland,POL,13,5,86,17,121
2004,Bulgaria,BGR,Poland,POL,0,0,5,5,10
2004,China,CHN,Poland,POL,0,0,21,0,21
2004,Congo,COG,Poland,POL,0,0,5,0,5
2004,Dem. Rep. of the Congo,COD,Poland,POL,0,0,5,0,5
2004,Ethiopia,ETH,Poland,POL,0,0,5,0,5
2004,Palestinian,PSE,Poland,POL,0,0,10,0,10
2004,Georgia,GEO,Poland,POL,0,0,28,5,33
2004,Cote d'Ivoire,CIV,Poland,POL,0,0,5,0,5
2004,India,IND,Poland,POL,0,0,188,0,188
2004,Iran (Islamic Rep. of),IRN,Poland,POL,0,0,11,0,11
2004,Iraq,IRQ,Poland,POL,0,10,29,5,44
2004,Kazakhstan,KAZ,Poland,POL,0,0,13,10,23
2004,Kyrgyzstan,KGZ,Poland,POL,0,0,19,0,19
2004,Liberia,LBR,Poland,POL,0,0,5,0,5
2004,Lebanon,LBN,Poland,POL,0,0,0,5,5
2004,Sri Lanka,LKA,Poland,POL,0,0,13,5,18
2004,Rep. of Moldova,MDA,Poland,POL,0,0,11,5,16
2004,Mongolia,MNG,Poland,POL,0,0,10,0,10
2004,Nigeria,NGA,Poland,POL,0,5,5,0,10
2004,Pakistan,PAK,Poland,POL,5,5,228,5,243
2004,Romania,ROU,Poland,POL,0,0,5,5,10
2004,Russian Federation,RUS,Poland,POL,265,734,930,2678,4607
2004,Serbia and Kosovo: S/RES/1244 (1999),SRB,Poland,POL,0,0,0,5,5
2004,Somalia,SOM,Poland,POL,10,0,24,0,34
2004,Viet Nam,VNM,Poland,POL,0,0,21,0,21
2004,Slovakia,SVK,Poland,POL,0,0,5,0,5
2004,Syrian Arab Rep.,SYR,Poland,POL,0,0,5,0,5
2004,Turkmenistan,TKM,Poland,POL,0,0,5,0,5
2004,Turkey,TUR,Poland,POL,5,10,20,0,35
2004,Ukraine,UKR,Poland,POL,0,10,73,10,93
2004,Uzbekistan,UZB,Poland,POL,0,0,5,0,5
2004,Stateless,XXA,Poland,POL,5,5,12,0,22
2004,Armenia,ARM,Portugal,PRT,0,0,5,0,5
2004,Bulgaria,BGR,Portugal,PRT,0,0,5,0,5
2004,Cuba,CUB,Portugal,PRT,0,0,5,0,5
2004,Hungary,HUN,Portugal,PRT,0,0,5,0,5
2004,Liberia,LBR,Portugal,PRT,0,0,5,0,5
2004,Pakistan,PAK,Portugal,PRT,0,0,5,0,5
2004,Turkey,TUR,Portugal,PRT,0,0,5,0,5
2004,Angola,AGO,South Africa,ZAF,34,0,14,0,48
2004,Burundi,BDI,South Africa,ZAF,121,0,0,0,121
2004,Cameroon,CMR,South Africa,ZAF,10,0,0,0,10
2004,Congo,COG,South Africa,ZAF,59,0,5,0,64
2004,Dem. Rep. of the Congo,COD,South Africa,ZAF,660,0,42,0,702
2004,Ghana,GHA,South Africa,ZAF,0,0,5,0,5
2004,India,IND,South Africa,ZAF,0,0,5,0,5
2004,Kenya,KEN,South Africa,ZAF,0,0,20,0,20
2004,Malawi,MWI,South Africa,ZAF,0,0,17,0,17
2004,Mozambique,MOZ,South Africa,ZAF,0,0,5,0,5
2004,Nigeria,NGA,South Africa,ZAF,0,0,51,0,51
2004,Pakistan,PAK,South Africa,ZAF,0,0,29,0,29
2004,Rwanda,RWA,South Africa,ZAF,84,0,5,0,89
2004,Somalia,SOM,South Africa,ZAF,236,0,0,0,236
2004,Sudan,SDN,South Africa,ZAF,5,0,5,0,10
2004,United Rep. of Tanzania,TZA,South Africa,ZAF,5,0,41,0,46
2004,Uganda,UGA,South Africa,ZAF,13,0,5,0,18
2004,Zimbabwe,ZWE,South Africa,ZAF,24,0,69,0,93
2004,Unknown ,,South Africa,ZAF,0,0,5,0,5
2004,Afghanistan,AFG,Russian Federation,RUS,29,0,590,0,619
2004,Armenia,ARM,Russian Federation,RUS,0,0,5,0,5
2004,Azerbaijan,AZE,Russian Federation,RUS,0,0,11,0,11
2004,Burundi,BDI,Russian Federation,RUS,0,0,5,0,5
2004,Dem. Rep. of the Congo,COD,Russian Federation,RUS,0,0,13,0,13
2004,Ethiopia,ETH,Russian Federation,RUS,0,0,5,0,5
2004,Georgia,GEO,Russian Federation,RUS,0,0,16,0,16
2004,Iraq,IRQ,Russian Federation,RUS,5,0,15,0,20
2004,Kazakhstan,KAZ,Russian Federation,RUS,0,0,11,0,11
2004,Rwanda,RWA,Russian Federation,RUS,5,0,0,0,5
2004,Sierra Leone,SLE,Russian Federation,RUS,0,0,5,0,5
2004,Tajikistan,TJK,Russian Federation,RUS,0,0,23,0,23
2004,Turkmenistan,TKM,Russian Federation,RUS,0,0,5,0,5
2004,Ukraine,UKR,Russian Federation,RUS,0,0,5,0,5
2004,Uzbekistan,UZB,Russian Federation,RUS,0,0,59,0,59
2004,Unknown ,,Russian Federation,RUS,0,0,50,0,50
2004,Colombia,COL,El Salvador,SLV,0,0,0,5,5
2004,Burundi,BDI,Senegal,SEN,0,0,5,0,5
2004,Central African Rep.,CAF,Senegal,SEN,0,0,10,0,10
2004,Chad,TCD,Senegal,SEN,0,0,5,0,5
2004,Congo,COG,Senegal,SEN,0,0,13,0,13
2004,Dem. Rep. of the Congo,COD,Senegal,SEN,0,0,28,0,28
2004,Gambia,GMB,Senegal,SEN,5,0,0,0,5
2004,Guinea,GIN,Senegal,SEN,10,0,10,0,20
2004,Cote d'Ivoire,CIV,Senegal,SEN,50,0,16,0,66
2004,Liberia,LBR,Senegal,SEN,41,0,15,0,56
2004,Mauritania,MRT,Senegal,SEN,0,0,34,0,34
2004,Nigeria,NGA,Senegal,SEN,0,0,5,0,5
2004,Rwanda,RWA,Senegal,SEN,0,0,10,0,10
2004,Sierra Leone,SLE,Senegal,SEN,0,0,26,0,26
2004,Togo,TGO,Senegal,SEN,0,0,5,0,5
2004,Afghanistan,AFG,Spain,ESP,0,0,32,13,45
2004,Albania,ALB,Spain,ESP,0,0,0,5,5
2004,Algeria,DZA,Spain,ESP,0,0,31,850,881
2004,Angola,AGO,Spain,ESP,0,0,16,10,26
2004,Armenia,ARM,Spain,ESP,5,12,68,43,128
2004,Azerbaijan,AZE,Spain,ESP,0,0,0,5,5
2004,Burundi,BDI,Spain,ESP,0,0,0,5,5
2004,Benin,BEN,Spain,ESP,0,0,0,32,32
2004,Bangladesh,BGD,Spain,ESP,0,0,5,13,18
2004,Burkina Faso,BFA,Spain,ESP,0,0,0,5,5
2004,Belarus,BLR,Spain,ESP,10,0,10,14,34
2004,Bolivia (Plurinational State of),BOL,Spain,ESP,0,0,0,5,5
2004,Brazil,BRA,Spain,ESP,0,0,0,10,10
2004,Bosnia and Herzegovina,BIH,Spain,ESP,0,0,0,27,27
2004,Bulgaria,BGR,Spain,ESP,0,0,0,5,5
2004,Central African Rep.,CAF,Spain,ESP,0,0,0,17,17
2004,Chad,TCD,Spain,ESP,0,0,0,16,16
2004,China,CHN,Spain,ESP,0,0,10,10,20
2004,Cameroon,CMR,Spain,ESP,5,0,37,74,116
2004,Congo,COG,Spain,ESP,0,0,0,20,20
2004,Dem. Rep. of the Congo,COD,Spain,ESP,5,0,67,178,250
2004,Colombia,COL,Spain,ESP,57,66,670,353,1146
2004,Cuba,CUB,Spain,ESP,10,10,119,43,182
2004,Dominican Rep.,DOM,Spain,ESP,0,0,0,5,5
2004,Ecuador,ECU,Spain,ESP,0,0,0,13,13
2004,Equatorial Guinea,GNQ,Spain,ESP,11,0,22,5,38
2004,Eritrea,ERI,Spain,ESP,0,0,5,0,5
2004,Ethiopia,ETH,Spain,ESP,5,0,25,21,51
2004,Gabon,GAB,Spain,ESP,0,0,0,10,10
2004,Gambia,GMB,Spain,ESP,0,0,5,95,100
2004,Georgia,GEO,Spain,ESP,5,0,22,28,55
2004,Ghana,GHA,Spain,ESP,0,0,0,100,100
2004,Guinea-Bissau,GNB,Spain,ESP,0,0,5,121,126
2004,Guinea,GIN,Spain,ESP,0,0,13,263,276
2004,Haiti,HTI,Spain,ESP,0,0,0,5,5
2004,Cote d'Ivoire,CIV,Spain,ESP,0,5,60,131,196
2004,India,IND,Spain,ESP,0,0,0,18,18
2004,Indonesia,IDN,Spain,ESP,0,0,5,0,5
2004,Iran (Islamic Rep. of),IRN,Spain,ESP,5,0,10,16,31
2004,Iraq,IRQ,Spain,ESP,5,50,69,19,143
2004,Israel,ISR,Spain,ESP,0,0,0,5,5
2004,Jordan,JOR,Spain,ESP,0,0,0,5,5
2004,Kazakhstan,KAZ,Spain,ESP,0,0,0,5,5
2004,Kenya,KEN,Spain,ESP,0,0,0,5,5
2004,Kyrgyzstan,KGZ,Spain,ESP,0,0,0,5,5
2004,Liberia,LBR,Spain,ESP,0,5,11,104,120
2004,Libya,LBY,Spain,ESP,0,0,0,5,5
2004,Lebanon,LBN,Spain,ESP,0,0,0,11,11
2004,Sri Lanka,LKA,Spain,ESP,0,0,0,13,13
2004,Latvia,LVA,Spain,ESP,0,0,5,0,5
2004,Mauritania,MRT,Spain,ESP,0,0,5,34,39
2004,North Macedonia,MKD,Spain,ESP,0,0,0,25,25
2004,Rep. of Moldova,MDA,Spain,ESP,5,0,0,5,10
2004,Mali,MLI,Spain,ESP,0,0,0,279,279
2004,Morocco,MAR,Spain,ESP,0,0,5,19,24
2004,Nepal,NPL,Spain,ESP,0,0,0,5,5
2004,Niger,NER,Spain,ESP,0,0,0,26,26
2004,Nicaragua,NIC,Spain,ESP,0,0,5,0,5
2004,Nigeria,NGA,Spain,ESP,0,5,77,1190,1272
2004,Pakistan,PAK,Spain,ESP,0,10,10,10,30
2004,Peru,PER,Spain,ESP,0,0,0,5,5
2004,Romania,ROU,Spain,ESP,0,0,5,27,32
2004,Russian Federation,RUS,Spain,ESP,28,13,49,38,128
2004,Rwanda,RWA,Spain,ESP,0,0,0,5,5
2004,Senegal,SEN,Spain,ESP,0,0,5,32,37
2004,Sierra Leone,SLE,Spain,ESP,0,0,12,106,118
2004,Somalia,SOM,Spain,ESP,0,0,64,5,69
2004,Sudan,SDN,Spain,ESP,0,0,5,23,28
2004,Syrian Arab Rep.,SYR,Spain,ESP,0,5,0,13,18
2004,Togo,TGO,Spain,ESP,0,0,0,10,10
2004,Tunisia,TUN,Spain,ESP,0,0,0,5,5
2004,Turkey,TUR,Spain,ESP,0,0,10,11,21
2004,Uganda,UGA,Spain,ESP,0,0,0,5,5
2004,Ukraine,UKR,Spain,ESP,0,0,28,29,57
2004,Uzbekistan,UZB,Spain,ESP,0,0,5,10,15
2004,Venezuela (Bolivarian Republic of),VEN,Spain,ESP,0,0,10,17,27
2004,Zimbabwe,ZWE,Spain,ESP,0,0,0,20,20
2004,Stateless,XXA,Spain,ESP,0,0,17,17,34
2004,Afghanistan,AFG,Slovakia,SVK,0,0,59,449,508
2004,Algeria,DZA,Slovakia,SVK,0,0,0,11,11
2004,Armenia,ARM,Slovakia,SVK,0,0,22,278,300
2004,Azerbaijan,AZE,Slovakia,SVK,0,0,0,15,15
2004,Bangladesh,BGD,Slovakia,SVK,0,0,109,493,602
2004,Belarus,BLR,Slovakia,SVK,0,0,5,5,10
2004,Bulgaria,BGR,Slovakia,SVK,0,0,5,5,10
2004,China,CHN,Slovakia,SVK,0,0,154,1103,1257
2004,Cuba,CUB,Slovakia,SVK,0,0,5,0,5
2004,Gambia,GMB,Slovakia,SVK,0,0,0,5,5
2004,Palestinian,PSE,Slovakia,SVK,0,0,5,112,117
2004,Georgia,GEO,Slovakia,SVK,0,0,20,1108,1128
2004,India,IND,Slovakia,SVK,0,0,564,2803,3367
2004,Iran (Islamic Rep. of),IRN,Slovakia,SVK,5,0,5,65,75
2004,Iraq,IRQ,Slovakia,SVK,0,0,5,157,162
2004,Israel,ISR,Slovakia,SVK,0,0,0,48,48
2004,Kazakhstan,KAZ,Slovakia,SVK,0,0,0,5,5
2004,Kyrgyzstan,KGZ,Slovakia,SVK,0,0,10,0,10
2004,Liberia,LBR,Slovakia,SVK,0,0,0,5,5
2004,Lebanon,LBN,Slovakia,SVK,0,0,0,19,19
2004,Sri Lanka,LKA,Slovakia,SVK,0,0,5,66,71
2004,North Macedonia,MKD,Slovakia,SVK,0,0,14,5,19
2004,Rep. of Moldova,MDA,Slovakia,SVK,0,0,41,850,891
2004,Nepal,NPL,Slovakia,SVK,0,0,0,10,10
2004,Nigeria,NGA,Slovakia,SVK,0,0,0,5,5
2004,Pakistan,PAK,Slovakia,SVK,0,0,82,746,828
2004,Romania,ROU,Slovakia,SVK,0,0,0,5,5
2004,Russian Federation,RUS,Slovakia,SVK,5,0,295,2744,3044
2004,Serbia and Kosovo: S/RES/1244 (1999),SRB,Slovakia,SVK,0,0,31,28,59
2004,Senegal,SEN,Slovakia,SVK,0,0,5,13,18
2004,Somalia,SOM,Slovakia,SVK,0,0,0,11,11
2004,Viet Nam,VNM,Slovakia,SVK,0,0,24,130,154
2004,Sudan,SDN,Slovakia,SVK,0,0,0,5,5
2004,Syrian Arab Rep.,SYR,Slovakia,SVK,0,0,17,57,74
2004,Turkey,TUR,Slovakia,SVK,0,0,5,151,156
2004,Ukraine,UKR,Slovakia,SVK,0,0,22,38,60
2004,Uzbekistan,UZB,Slovakia,SVK,0,0,5,5,10
2004,Stateless,XXA,Slovakia,SVK,0,0,0,11,11
2004,Afghanistan,AFG,Slovenia,SVN,0,0,5,0,5
2004,Albania,ALB,Slovenia,SVN,0,0,31,154,185
2004,Algeria,DZA,Slovenia,SVN,0,0,0,23,23
2004,Bangladesh,BGD,Slovenia,SVN,0,0,0,10,10
2004,Bosnia and Herzegovina,BIH,Slovenia,SVN,0,0,34,39,73
2004,Cuba,CUB,Slovenia,SVN,0,0,0,5,5
2004,Palestinian,PSE,Slovenia,SVN,0,0,0,5,5
2004,Georgia,GEO,Slovenia,SVN,5,0,23,29,57
2004,India,IND,Slovenia,SVN,0,0,5,11,16
2004,Iran (Islamic Rep. of),IRN,Slovenia,SVN,5,0,5,5,15
2004,Iraq,IRQ,Slovenia,SVN,0,0,10,25,35
2004,Liberia,LBR,Slovenia,SVN,0,0,5,5,10
2004,Sri Lanka,LKA,Slovenia,SVN,0,0,0,12,12
2004,North Macedonia,MKD,Slovenia,SVN,0,5,32,43,80
2004,Rep. of Moldova,MDA,Slovenia,SVN,0,0,10,26,36
2004,Pakistan,PAK,Slovenia,SVN,0,0,10,5,15
2004,Romania,ROU,Slovenia,SVN,0,0,10,0,10
2004,Russian Federation,RUS,Slovenia,SVN,0,0,10,5,15
2004,Serbia and Kosovo: S/RES/1244 (1999),SRB,Slovenia,SVN,5,11,131,170,317
2004,Sierra Leone,SLE,Slovenia,SVN,0,5,0,0,5
2004,Turkey,TUR,Slovenia,SVN,0,0,20,160,180
2004,Dem. Rep. of the Congo,COD,Eswatini,SWZ,5,0,0,0,5
2004,Rwanda,RWA,Eswatini,SWZ,13,0,0,0,13
2004,Afghanistan,AFG,Sweden,SWE,16,134,820,82,1052
2004,Albania,ALB,Sweden,SWE,0,0,275,45,320
2004,Algeria,DZA,Sweden,SWE,0,0,278,75,353
2004,Angola,AGO,Sweden,SWE,0,10,100,5,115
2004,Egypt,EGY,Sweden,SWE,0,5,69,10,84
2004,Argentina,ARG,Sweden,SWE,0,0,5,0,5
2004,Armenia,ARM,Sweden,SWE,0,21,478,34,533
2004,Azerbaijan,AZE,Sweden,SWE,19,31,1305,98,1453
2004,Burundi,BDI,Sweden,SWE,0,242,23,5,270
2004,Benin,BEN,Sweden,SWE,0,0,12,0,12
2004,Bangladesh,BGD,Sweden,SWE,0,5,149,20,174
2004,Bhutan,BTN,Sweden,SWE,0,0,0,5,5
2004,Belarus,BLR,Sweden,SWE,5,5,734,132,876
2004,Bolivia (Plurinational State of),BOL,Sweden,SWE,0,0,342,32,374
2004,Brazil,BRA,Sweden,SWE,0,0,5,0,5
2004,Bosnia and Herzegovina,BIH,Sweden,SWE,10,33,873,67,983
2004,Bulgaria,BGR,Sweden,SWE,0,5,499,53,557
2004,Cambodia,KHM,Sweden,SWE,0,0,5,0,5
2004,Chad,TCD,Sweden,SWE,0,0,10,0,10
2004,China,CHN,Sweden,SWE,10,0,173,56,239
2004,Chile,CHL,Sweden,SWE,0,5,39,5,49
2004,Cameroon,CMR,Sweden,SWE,0,5,57,11,73
2004,Congo,COG,Sweden,SWE,0,5,14,5,24
2004,Dem. Rep. of the Congo,COD,Sweden,SWE,0,10,114,10,134
2004,Colombia,COL,Sweden,SWE,0,5,53,5,63
2004,Costa Rica,CRI,Sweden,SWE,0,0,5,0,5
2004,Cuba,CUB,Sweden,SWE,0,0,16,5,21
2004,Czechia,CZE,Sweden,SWE,0,0,5,10,15
2004,Ecuador,ECU,Sweden,SWE,0,0,63,13,76
2004,Eritrea,ERI,Sweden,SWE,16,65,382,17,480
2004,Estonia,EST,Sweden,SWE,0,0,10,0,10
2004,Ethiopia,ETH,Sweden,SWE,0,10,166,14,190
2004,Gabon,GAB,Sweden,SWE,0,0,5,0,5
2004,Gambia,GMB,Sweden,SWE,0,0,10,0,10
2004,Georgia,GEO,Sweden,SWE,0,0,500,106,606
2004,Ghana,GHA,Sweden,SWE,0,0,28,0,28
2004,Guinea-Bissau,GNB,Sweden,SWE,0,0,5,0,5
2004,Guatemala,GTM,Sweden,SWE,0,0,5,0,5
2004,Guinea,GIN,Sweden,SWE,0,0,52,5,57
2004,Honduras,HND,Sweden,SWE,0,0,5,0,5
2004,Croatia,HRV,Sweden,SWE,0,0,107,29,136
2004,Hungary,HUN,Sweden,SWE,0,0,10,5,15
2004,Cote d'Ivoire,CIV,Sweden,SWE,0,0,52,5,57
2004,India,IND,Sweden,SWE,0,0,88,21,109
2004,Iran (Islamic Rep. of),IRN,Sweden,SWE,29,26,744,99,898
2004,Iraq,IRQ,Sweden,SWE,5,243,4495,382,5125
2004,Israel,ISR,Sweden,SWE,0,0,45,14,59
2004,Jordan,JOR,Sweden,SWE,0,0,115,32,147
2004,Japan,JPN,Sweden,SWE,0,0,5,0,5
2004,Kazakhstan,KAZ,Sweden,SWE,0,45,252,33,330
2004,Kenya,KEN,Sweden,SWE,0,0,20,0,20
2004,Kyrgyzstan,KGZ,Sweden,SWE,0,17,223,17,257
2004,Kuwait,KWT,Sweden,SWE,0,0,0,5,5
2004,Lao People's Dem. Rep.,LAO,Sweden,SWE,0,0,5,0,5
2004,Liberia,LBR,Sweden,SWE,0,0,76,10,86
2004,Libya,LBY,Sweden,SWE,0,5,357,84,446
2004,Lebanon,LBN,Sweden,SWE,0,5,368,45,418
2004,Sri Lanka,LKA,Sweden,SWE,0,0,15,5,20
2004,Lithuania,LTU,Sweden,SWE,0,0,10,12,22
2004,Latvia,LVA,Sweden,SWE,0,0,45,5,50
2004,Mauritania,MRT,Sweden,SWE,0,0,5,5,10
2004,North Macedonia,MKD,Sweden,SWE,0,0,389,65,454
2004,Rep. of Moldova,MDA,Sweden,SWE,0,5,93,35,133
2004,Malaysia,MYS,Sweden,SWE,0,0,5,0,5
2004,Mongolia,MNG,Sweden,SWE,0,0,329,38,367
2004,Morocco,MAR,Sweden,SWE,0,0,33,15,48
2004,Myanmar,MMR,Sweden,SWE,0,5,11,5,21
2004,Nepal,NPL,Sweden,SWE,0,0,32,5,37
2004,Niger,NER,Sweden,SWE,0,0,14,0,14
2004,Nicaragua,NIC,Sweden,SWE,0,0,5,0,5
2004,Nigeria,NGA,Sweden,SWE,0,0,519,66,585
2004,Pakistan,PAK,Sweden,SWE,0,0,94,23,117
2004,Peru,PER,Sweden,SWE,0,0,68,11,79
2004,Poland,POL,Sweden,SWE,0,0,10,0,10
2004,Romania,ROU,Sweden,SWE,0,0,188,35,223
2004,Russian Federation,RUS,Sweden,SWE,15,95,1204,288,1602
2004,Rwanda,RWA,Sweden,SWE,0,5,33,5,43
2004,El Salvador,SLV,Sweden,SWE,0,0,10,0,10
2004,Saudi Arabia,SAU,Sweden,SWE,0,0,22,5,27
2004,Serbia and Kosovo: S/RES/1244 (1999),SRB,Sweden,SWE,151,175,4064,569,4959
2004,Senegal,SEN,Sweden,SWE,0,0,5,0,5
2004,Sierra Leone,SLE,Sweden,SWE,0,0,86,10,96
2004,Somalia,SOM,Sweden,SWE,58,541,2017,144,2760
2004,Viet Nam,VNM,Sweden,SWE,0,5,101,27,133
2004,Sudan,SDN,Sweden,SWE,0,17,63,11,91
2004,Slovakia,SVK,Sweden,SWE,0,0,93,42,135
2004,Sweden,SWE,Sweden,SWE,0,0,0,5,5
2004,Syrian Arab Rep.,SYR,Sweden,SWE,5,16,523,50,594
2004,United Rep. of Tanzania,TZA,Sweden,SWE,0,0,16,5,21
2004,Thailand,THA,Sweden,SWE,0,0,5,0,5
2004,Tajikistan,TJK,Sweden,SWE,0,0,52,5,57
2004,Turkmenistan,TKM,Sweden,SWE,5,5,52,5,67
2004,Togo,TGO,Sweden,SWE,0,0,21,5,26
2004,Tunisia,TUN,Sweden,SWE,0,0,62,15,77
2004,Turkey,TUR,Sweden,SWE,5,21,568,62,656
2004,Uganda,UGA,Sweden,SWE,0,0,25,0,25
2004,Ukraine,UKR,Sweden,SWE,0,10,313,56,379
2004,United States of America,USA,Sweden,SWE,0,0,11,0,11
2004,Uzbekistan,UZB,Sweden,SWE,5,49,438,39,531
2004,Venezuela (Bolivarian Republic of),VEN,Sweden,SWE,0,0,13,0,13
2004,Yemen,YEM,Sweden,SWE,0,5,51,5,61
2004,Zimbabwe,ZWE,Sweden,SWE,0,0,5,0,5
2004,Stateless,XXA,Sweden,SWE,10,378,1281,253,1922
2004,Unknown ,,Sweden,SWE,0,18,221,21,260
2004,Afghanistan,AFG,Switzerland,CHE,60,205,106,41,412
2004,Albania,ALB,Switzerland,CHE,10,5,22,61,98
2004,Algeria,DZA,Switzerland,CHE,10,51,249,330,640
2004,Angola,AGO,Switzerland,CHE,0,391,345,50,786
2004,Egypt,EGY,Switzerland,CHE,0,0,10,12,22
2004,Armenia,ARM,Switzerland,CHE,0,37,265,118,420
2004,Azerbaijan,AZE,Switzerland,CHE,19,5,62,22,108
2004,Burundi,BDI,Switzerland,CHE,5,27,34,10,76
2004,Belgium,BEL,Switzerland,CHE,0,0,0,5,5
2004,Benin,BEN,Switzerland,CHE,0,0,12,14,26
2004,Bangladesh,BGD,Switzerland,CHE,0,13,184,46,243
2004,Burkina Faso,BFA,Switzerland,CHE,0,0,17,21,38
2004,Belarus,BLR,Switzerland,CHE,0,0,149,78,227
2004,Brazil,BRA,Switzerland,CHE,0,0,0,5,5
2004,Bosnia and Herzegovina,BIH,Switzerland,CHE,97,559,273,118,1047
2004,Bulgaria,BGR,Switzerland,CHE,0,0,244,370,614
2004,Cambodia,KHM,Switzerland,CHE,14,0,0,0,14
2004,Central African Rep.,CAF,Switzerland,CHE,0,0,5,0,5
2004,Chad,TCD,Switzerland,CHE,10,0,5,5,20
2004,China,CHN,Switzerland,CHE,43,85,168,37,333
2004,Cameroon,CMR,Switzerland,CHE,10,11,173,67,261
2004,Congo,COG,Switzerland,CHE,5,5,32,12,54
2004,Dem. Rep. of the Congo,COD,Switzerland,CHE,16,235,335,99,685
2004,Colombia,COL,Switzerland,CHE,14,10,5,5,34
2004,Cuba,CUB,Switzerland,CHE,5,0,5,5,15
2004,Czechia,CZE,Switzerland,CHE,0,0,0,10,10
2004,Dominican Rep.,DOM,Switzerland,CHE,0,5,0,0,5
2004,Equatorial Guinea,GNQ,Switzerland,CHE,0,0,5,0,5
2004,Eritrea,ERI,Switzerland,CHE,5,41,218,48,312
2004,Ethiopia,ETH,Switzerland,CHE,14,37,242,55,348
2004,France,FRA,Switzerland,CHE,0,0,0,5,5
2004,Gabon,GAB,Switzerland,CHE,0,0,5,5,10
2004,Gambia,GMB,Switzerland,CHE,0,0,0,12,12
2004,Georgia,GEO,Switzerland,CHE,5,10,441,364,820
2004,Germany,DEU,Switzerland,CHE,0,0,0,5,5
2004,Ghana,GHA,Switzerland,CHE,0,0,5,10,15
2004,Guinea-Bissau,GNB,Switzerland,CHE,0,0,10,44,54
2004,Guinea,GIN,Switzerland,CHE,5,11,216,261,493
2004,Croatia,HRV,Switzerland,CHE,0,5,10,11,26
2004,Hungary,HUN,Switzerland,CHE,0,0,0,11,11
2004,Cote d'Ivoire,CIV,Switzerland,CHE,14,13,101,91,219
2004,India,IND,Switzerland,CHE,5,5,28,53,91
2004,Iran (Islamic Rep. of),IRN,Switzerland,CHE,43,75,260,76,454
2004,Iraq,IRQ,Switzerland,CHE,175,147,366,431,1119
2004,Israel,ISR,Switzerland,CHE,0,0,0,12,12
2004,Jordan,JOR,Switzerland,CHE,0,0,5,5,10
2004,Kazakhstan,KAZ,Switzerland,CHE,0,5,43,10,58
2004,Kenya,KEN,Switzerland,CHE,0,0,11,0,11
2004,Kyrgyzstan,KGZ,Switzerland,CHE,0,0,15,12,27
2004,Lao People's Dem. Rep.,LAO,Switzerland,CHE,0,5,0,0,5
2004,Liberia,LBR,Switzerland,CHE,5,5,13,50,73
2004,Libya,LBY,Switzerland,CHE,33,0,42,33,108
2004,Lebanon,LBN,Switzerland,CHE,0,0,15,57,72
2004,Sri Lanka,LKA,Switzerland,CHE,55,148,182,84,469
2004,Lithuania,LTU,Switzerland,CHE,0,0,5,35,40
2004,Latvia,LVA,Switzerland,CHE,0,0,0,11,11
2004,Madagascar,MDG,Switzerland,CHE,0,0,11,0,11
2004,Mauritania,MRT,Switzerland,CHE,0,0,10,20,30
2004,North Macedonia,MKD,Switzerland,CHE,0,38,108,134,280
2004,Rep. of Moldova,MDA,Switzerland,CHE,0,0,75,94,169
2004,Mali,MLI,Switzerland,CHE,0,0,66,57,123
2004,Mongolia,MNG,Switzerland,CHE,0,5,69,80,154
2004,Morocco,MAR,Switzerland,CHE,0,0,5,29,34
2004,Mozambique,MOZ,Switzerland,CHE,0,5,0,0,5
2004,Myanmar,MMR,Switzerland,CHE,0,0,5,0,5
2004,Nepal,NPL,Switzerland,CHE,0,0,22,12,34
2004,Niger,NER,Switzerland,CHE,0,0,17,10,27
2004,Nigeria,NGA,Switzerland,CHE,0,11,272,249,532
2004,Pakistan,PAK,Switzerland,CHE,0,23,298,100,421
2004,Poland,POL,Switzerland,CHE,0,0,5,5,10
2004,Romania,ROU,Switzerland,CHE,0,5,35,182,222
2004,South Africa,ZAF,Switzerland,CHE,0,0,5,5,10
2004,Russian Federation,RUS,Switzerland,CHE,37,81,394,261,773
2004,Rwanda,RWA,Switzerland,CHE,23,5,15,5,48
2004,Serbia and Kosovo: S/RES/1244 (1999),SRB,Switzerland,CHE,85,1134,1383,848,3450
2004,Senegal,SEN,Switzerland,CHE,0,0,5,14,19
2004,Sierra Leone,SLE,Switzerland,CHE,5,5,33,65,108
2004,Somalia,SOM,Switzerland,CHE,10,510,472,68,1060
2004,Viet Nam,VNM,Switzerland,CHE,35,5,16,0,56
2004,Sudan,SDN,Switzerland,CHE,5,5,69,47,126
2004,Suriname,SUR,Switzerland,CHE,0,0,5,0,5
2004,Slovakia,SVK,Switzerland,CHE,0,0,14,68,82
2004,Slovenia,SVN,Switzerland,CHE,0,0,0,5,5
2004,Syrian Arab Rep.,SYR,Switzerland,CHE,11,20,89,84,204
2004,United Rep. of Tanzania,TZA,Switzerland,CHE,0,0,5,0,5
2004,Tajikistan,TJK,Switzerland,CHE,0,0,5,0,5
2004,Turkmenistan,TKM,Switzerland,CHE,0,0,0,5,5
2004,Togo,TGO,Switzerland,CHE,69,5,118,31,223
2004,Tunisia,TUN,Switzerland,CHE,73,0,22,37,132
2004,Turkey,TUR,Switzerland,CHE,496,144,938,314,1892
2004,Uganda,UGA,Switzerland,CHE,0,0,10,5,15
2004,Ukraine,UKR,Switzerland,CHE,0,5,95,49,149
2004,United States of America,USA,Switzerland,CHE,0,0,0,5,5
2004,Uzbekistan,UZB,Switzerland,CHE,0,0,33,23,56
2004,Western Sahara,ESH,Switzerland,CHE,0,0,5,5,10
2004,Yemen,YEM,Switzerland,CHE,5,5,43,5,58
2004,Zimbabwe,ZWE,Switzerland,CHE,0,0,5,16,21
2004,Stateless,XXA,Switzerland,CHE,11,22,348,1219,1600
2004,Unknown ,,Switzerland,CHE,0,0,5,10,15
2004,Rwanda,RWA,United Rep. of Tanzania,TZA,183,0,0,0,183
2004,Burundi,BDI,Uganda,UGA,128,0,0,10,138
2004,Chad,TCD,Uganda,UGA,0,0,0,5,5
2004,Dem. Rep. of the Congo,COD,Uganda,UGA,1702,0,0,48,1750
2004,Eritrea,ERI,Uganda,UGA,0,0,5,0,5
2004,Ethiopia,ETH,Uganda,UGA,53,0,55,36,144
2004,Pakistan,PAK,Uganda,UGA,5,0,0,0,5
2004,Rwanda,RWA,Uganda,UGA,147,0,11,23,181
2004,Somalia,SOM,Uganda,UGA,243,0,51,65,359
2004,Sudan,SDN,Uganda,UGA,116,0,0,29,145
2004,Afghanistan,AFG,Ukraine,UKR,49,0,25,183,257
2004,Algeria,DZA,Ukraine,UKR,0,0,0,5,5
2004,Angola,AGO,Ukraine,UKR,0,0,5,23,28
2004,Armenia,ARM,Ukraine,UKR,0,0,14,16,30
2004,Azerbaijan,AZE,Ukraine,UKR,5,0,0,15,20
2004,Bangladesh,BGD,Ukraine,UKR,0,0,0,123,123
2004,China,CHN,Ukraine,UKR,0,0,0,12,12
2004,Congo,COG,Ukraine,UKR,0,0,0,5,5
2004,Dem. Rep. of the Congo,COD,Ukraine,UKR,0,0,0,18,18
2004,Cuba,CUB,Ukraine,UKR,0,0,0,5,5
2004,Ethiopia,ETH,Ukraine,UKR,0,0,0,25,25
2004,Palestinian,PSE,Ukraine,UKR,0,0,10,36,46
2004,Georgia,GEO,Ukraine,UKR,0,0,11,13,24
2004,Ghana,GHA,Ukraine,UKR,0,0,0,5,5
2004,Guinea-Bissau,GNB,Ukraine,UKR,0,0,0,5,5
2004,India,IND,Ukraine,UKR,0,0,0,82,82
2004,Iran (Islamic Rep. of),IRN,Ukraine,UKR,0,0,5,45,50
2004,Iraq,IRQ,Ukraine,UKR,5,0,43,30,78
2004,Jordan,JOR,Ukraine,UKR,0,0,0,5,5
2004,Kyrgyzstan,KGZ,Ukraine,UKR,0,0,0,5,5
2004,Liberia,LBR,Ukraine,UKR,0,0,0,10,10
2004,Lebanon,LBN,Ukraine,UKR,0,0,0,5,5
2004,Sri Lanka,LKA,Ukraine,UKR,0,0,0,19,19
2004,Nigeria,NGA,Ukraine,UKR,0,0,0,32,32
2004,Pakistan,PAK,Ukraine,UKR,0,0,0,142,142
2004,Russian Federation,RUS,Ukraine,UKR,5,0,10,100,115
2004,Sierra Leone,SLE,Ukraine,UKR,0,0,0,5,5
2004,Somalia,SOM,Ukraine,UKR,5,0,5,21,31
2004,Sudan,SDN,Ukraine,UKR,0,0,10,5,15
2004,Syrian Arab Rep.,SYR,Ukraine,UKR,5,0,5,14,24
2004,Tajikistan,TJK,Ukraine,UKR,0,0,0,10,10
2004,Uganda,UGA,Ukraine,UKR,0,0,0,5,5
2004,Uzbekistan,UZB,Ukraine,UKR,0,0,0,5,5
2004,Stateless,XXA,Ukraine,UKR,5,0,0,0,5
2004,Colombia,COL,Venezuela (Bolivarian Republic of),VEN,206,0,188,241,635
2004,Guyana,GUY,Venezuela (Bolivarian Republic of),VEN,5,0,0,0,5
2004,Liberia,LBR,Venezuela (Bolivarian Republic of),VEN,5,0,0,0,5
2004,Burundi,BDI,Zimbabwe,ZWE,350,0,0,0,350
2004,Dem. Rep. of the Congo,COD,Zimbabwe,ZWE,413,0,0,0,413
2004,Rwanda,RWA,Zimbabwe,ZWE,197,0,0,0,197
2005,Serbia and Kosovo: S/RES/1244 (1999),SRB,Albania,ALB,10,0,5,5,20
2005,Cameroon,CMR,Algeria,DZA,0,0,5,0,5
2005,Congo,COG,Algeria,DZA,0,0,5,0,5
2005,Dem. Rep. of the Congo,COD,Algeria,DZA,0,0,21,0,21
2005,Cote d'Ivoire,CIV,Algeria,DZA,0,0,10,0,10
2005,Liberia,LBR,Algeria,DZA,0,0,17,0,17
2005,Albania,ALB,Argentina,ARG,5,0,0,0,5
2005,Armenia,ARM,Argentina,ARG,25,0,5,11,41
2005,Bangladesh,BGD,Argentina,ARG,0,0,0,13,13
2005,Dem. Rep. of the Congo,COD,Argentina,ARG,5,0,0,5,10
2005,Colombia,COL,Argentina,ARG,13,0,5,10,28
2005,Cuba,CUB,Argentina,ARG,29,0,5,32,66
2005,Ecuador,ECU,Argentina,ARG,0,0,0,5,5
2005,Haiti,HTI,Argentina,ARG,5,0,0,17,22
2005,India,IND,Argentina,ARG,5,0,0,5,10
2005,Kazakhstan,KAZ,Argentina,ARG,5,0,0,0,5
2005,Liberia,LBR,Argentina,ARG,5,0,0,0,5
2005,Nigeria,NGA,Argentina,ARG,0,0,0,10,10
2005,Pakistan,PAK,Argentina,ARG,5,0,0,0,5
2005,Peru,PER,Argentina,ARG,33,0,65,139,237
2005,Romania,ROU,Argentina,ARG,0,0,10,0,10
2005,Russian Federation,RUS,Argentina,ARG,5,0,0,0,5
2005,Senegal,SEN,Argentina,ARG,5,0,32,10,47
2005,Sierra Leone,SLE,Argentina,ARG,0,0,0,13,13
2005,Ukraine,UKR,Argentina,ARG,0,0,5,10,15
2005,Iran (Islamic Rep. of),IRN,Armenia,ARM,0,0,5,5,10
2005,Iraq,IRQ,Armenia,ARM,0,89,0,25,114
2005,Afghanistan,AFG,Australia,AUS,44,0,30,0,74
2005,Albania,ALB,Australia,AUS,0,0,5,0,5
2005,Algeria,DZA,Australia,AUS,0,0,5,0,5
2005,Egypt,EGY,Australia,AUS,11,0,65,0,76
2005,Bahrain,BHR,Australia,AUS,0,0,5,0,5
2005,Bangladesh,BGD,Australia,AUS,5,0,73,0,78
2005,Bhutan,BTN,Australia,AUS,0,0,5,0,5
2005,Brazil,BRA,Australia,AUS,0,0,14,0,14
2005,China,CHN,Australia,AUS,27,0,983,15,1025
2005,Chile,CHL,Australia,AUS,0,0,5,0,5
2005,Congo,COG,Australia,AUS,5,0,0,0,5
2005,Colombia,COL,Australia,AUS,10,0,10,0,20
2005,Eritrea,ERI,Australia,AUS,5,0,0,0,5
2005,Ethiopia,ETH,Australia,AUS,18,0,10,0,28
2005,Fiji,FJI,Australia,AUS,0,0,46,0,46
2005,Palestinian,PSE,Australia,AUS,11,0,5,0,16
2005,United Kingdom of Great Britain and Northern Ireland,GBR,Australia,AUS,0,0,10,0,10
2005,Germany,DEU,Australia,AUS,0,0,5,0,5
2005,Ghana,GHA,Australia,AUS,0,0,5,0,5
2005,Greece,GRC,Australia,AUS,0,0,5,0,5
2005,"China, Hong Kong SAR",HKG,Australia,AUS,0,0,13,0,13
2005,Croatia,HRV,Australia,AUS,0,0,5,0,5
2005,Hungary,HUN,Australia,AUS,0,0,5,0,5
2005,India,IND,Australia,AUS,0,0,189,0,189
2005,Indonesia,IDN,Australia,AUS,27,0,137,0,164
2005,Iran (Islamic Rep. of),IRN,Australia,AUS,76,0,28,0,104
2005,Iraq,IRQ,Australia,AUS,67,0,10,0,77
2005,Israel,ISR,Australia,AUS,5,0,12,0,17
2005,Italy,ITA,Australia,AUS,0,0,5,0,5
2005,Jordan,JOR,Australia,AUS,0,0,15,0,15
2005,Japan,JPN,Australia,AUS,0,0,10,0,10
2005,Kenya,KEN,Australia,AUS,0,0,5,0,5
2005,Kyrgyzstan,KGZ,Australia,AUS,0,0,5,0,5
2005,Rep. of Korea,KOR,Australia,AUS,0,0,82,0,82
2005,Dem. People's Rep. of Korea,PRK,Australia,AUS,0,0,5,0,5
2005,Liberia,LBR,Australia,AUS,0,0,5,0,5
2005,Lebanon,LBN,Australia,AUS,0,0,44,0,44
2005,Sri Lanka,LKA,Australia,AUS,130,0,163,5,298
2005,North Macedonia,MKD,Australia,AUS,0,0,5,0,5
2005,Rep. of Moldova,MDA,Australia,AUS,0,0,5,0,5
2005,Malaysia,MYS,Australia,AUS,0,0,154,10,164
2005,Mongolia,MNG,Australia,AUS,0,0,42,0,42
2005,Morocco,MAR,Australia,AUS,5,0,0,0,5
2005,Myanmar,MMR,Australia,AUS,18,0,26,0,44
2005,Nepal,NPL,Australia,AUS,5,0,61,0,66
2005,Nigeria,NGA,Australia,AUS,0,0,21,0,21
2005,Pakistan,PAK,Australia,AUS,20,0,80,0,100
2005,Peru,PER,Australia,AUS,0,0,5,0,5
2005,Philippines,PHL,Australia,AUS,0,0,65,0,65
2005,Papua New Guinea,PNG,Australia,AUS,5,0,11,0,16
2005,Poland,POL,Australia,AUS,0,0,5,0,5
2005,Romania,ROU,Australia,AUS,0,0,10,0,10
2005,South Africa,ZAF,Australia,AUS,0,0,5,0,5
2005,Russian Federation,RUS,Australia,AUS,0,0,29,0,29
2005,El Salvador,SLV,Australia,AUS,0,0,5,0,5
2005,Saudi Arabia,SAU,Australia,AUS,5,0,0,0,5
2005,Serbia and Kosovo: S/RES/1244 (1999),SRB,Australia,AUS,10,0,11,0,21
2005,Singapore,SGP,Australia,AUS,0,0,5,0,5
2005,Sierra Leone,SLE,Australia,AUS,0,0,5,0,5
2005,Somalia,SOM,Australia,AUS,5,0,0,0,5
2005,Viet Nam,VNM,Australia,AUS,0,0,27,0,27
2005,Sudan,SDN,Australia,AUS,5,0,10,0,15
2005,Syrian Arab Rep.,SYR,Australia,AUS,0,0,5,0,5
2005,Thailand,THA,Australia,AUS,0,0,60,5,65
2005,Tonga,TON,Australia,AUS,0,0,10,0,10
2005,Turkey,TUR,Australia,AUS,5,0,47,0,52
2005,Uganda,UGA,Australia,AUS,5,0,0,0,5
2005,Ukraine,UKR,Australia,AUS,0,0,5,0,5
2005,United States of America,USA,Australia,AUS,0,0,5,0,5
2005,Samoa,WSM,Australia,AUS,0,0,10,0,10
2005,Zambia,ZMB,Australia,AUS,0,0,10,0,10
2005,Zimbabwe,ZWE,Australia,AUS,12,0,17,0,29
2005,Stateless,XXA,Australia,AUS,5,0,5,0,10
2005,Afghanistan,AFG,Azerbaijan,AZE,0,0,285,5,290
2005,Iran (Islamic Rep. of),IRN,Azerbaijan,AZE,28,0,30,0,58
2005,Iraq,IRQ,Azerbaijan,AZE,0,0,24,0,24
2005,Kazakhstan,KAZ,Azerbaijan,AZE,0,0,5,0,5
2005,Nigeria,NGA,Azerbaijan,AZE,0,0,5,0,5
2005,Pakistan,PAK,Azerbaijan,AZE,0,0,31,0,31
2005,Russian Federation,RUS,Azerbaijan,AZE,0,0,5,0,5
2005,Syrian Arab Rep.,SYR,Azerbaijan,AZE,0,0,5,0,5
2005,Tajikistan,TJK,Azerbaijan,AZE,0,0,5,0,5
2005,Dem. Rep. of the Congo,COD,Burundi,BDI,763,0,28,0,791
2005,Afghanistan,AFG,Belgium,BEL,10,0,19,0,29
2005,Albania,ALB,Belgium,BEL,26,0,73,131,230
2005,Algeria,DZA,Belgium,BEL,0,0,39,5,44
2005,Angola,AGO,Belgium,BEL,18,0,181,40,239
2005,Egypt,EGY,Belgium,BEL,0,0,5,0,5
2005,Armenia,ARM,Belgium,BEL,10,0,0,125,135
2005,Azerbaijan,AZE,Belgium,BEL,12,0,60,28,100
2005,Burundi,BDI,Belgium,BEL,96,0,179,70,345
2005,Benin,BEN,Belgium,BEL,0,0,10,5,15
2005,Bangladesh,BGD,Belgium,BEL,0,0,17,5,22
2005,Bhutan,BTN,Belgium,BEL,0,0,18,42,60
2005,Burkina Faso,BFA,Belgium,BEL,0,0,5,5,10
2005,Belarus,BLR,Belgium,BEL,43,0,66,69,178
2005,Bosnia and Herzegovina,BIH,Belgium,BEL,10,0,15,26,51
2005,Bulgaria,BGR,Belgium,BEL,0,0,25,5,30
2005,Cambodia,KHM,Belgium,BEL,0,0,5,0,5
2005,Central African Rep.,CAF,Belgium,BEL,0,0,5,10,15
2005,Chad,TCD,Belgium,BEL,0,0,5,16,21
2005,China,CHN,Belgium,BEL,66,0,219,14,299
2005,Cameroon,CMR,Belgium,BEL,33,0,603,64,700
2005,Congo,COG,Belgium,BEL,5,0,22,22,49
2005,Dem. Rep. of the Congo,COD,Belgium,BEL,205,0,956,305,1466
2005,Colombia,COL,Belgium,BEL,12,0,11,5,28
2005,Cuba,CUB,Belgium,BEL,0,0,0,5,5
2005,Djibouti,DJI,Belgium,BEL,27,0,68,40,135
2005,Eritrea,ERI,Belgium,BEL,5,0,0,13,18
2005,Ethiopia,ETH,Belgium,BEL,23,0,22,18,63
2005,Gabon,GAB,Belgium,BEL,0,0,5,0,5
2005,Georgia,GEO,Belgium,BEL,0,0,43,30,73
2005,Guinea,GIN,Belgium,BEL,48,0,281,56,385
2005,Croatia,HRV,Belgium,BEL,0,0,0,5,5
2005,Cote d'Ivoire,CIV,Belgium,BEL,40,0,118,42,200
2005,India,IND,Belgium,BEL,0,0,5,5,10
2005,Iran (Islamic Rep. of),IRN,Belgium,BEL,112,0,462,135,709
2005,Iraq,IRQ,Belgium,BEL,63,0,407,199,669
2005,Israel,ISR,Belgium,BEL,5,0,34,13,52
2005,Jordan,JOR,Belgium,BEL,0,0,5,5,10
2005,Kazakhstan,KAZ,Belgium,BEL,5,0,16,56,77
2005,Kenya,KEN,Belgium,BEL,0,0,0,5,5
2005,Kyrgyzstan,KGZ,Belgium,BEL,13,0,11,46,70
2005,Dem. People's Rep. of Korea,PRK,Belgium,BEL,5,0,0,0,5
2005,Liberia,LBR,Belgium,BEL,0,0,5,5,10
2005,Libya,LBY,Belgium,BEL,0,0,10,0,10
2005,Lebanon,LBN,Belgium,BEL,5,0,66,20,91
2005,Sri Lanka,LKA,Belgium,BEL,0,0,5,10,15
2005,Latvia,LVA,Belgium,BEL,0,0,5,0,5
2005,Madagascar,MDG,Belgium,BEL,5,0,5,0,10
2005,Mauritania,MRT,Belgium,BEL,41,0,137,65,243
2005,North Macedonia,MKD,Belgium,BEL,5,0,27,5,37
2005,Rep. of Moldova,MDA,Belgium,BEL,0,0,5,5,10
2005,Morocco,MAR,Belgium,BEL,0,0,5,5,10
2005,Myanmar,MMR,Belgium,BEL,0,0,5,11,16
2005,Nepal,NPL,Belgium,BEL,14,0,326,50,390
2005,Niger,NER,Belgium,BEL,0,0,101,38,139
2005,Nigeria,NGA,Belgium,BEL,0,0,33,5,38
2005,Pakistan,PAK,Belgium,BEL,12,0,71,23,106
2005,Peru,PER,Belgium,BEL,0,0,0,5,5
2005,Romania,ROU,Belgium,BEL,10,0,10,0,20
2005,Russian Federation,RUS,Belgium,BEL,1256,0,488,225,1969
2005,Rwanda,RWA,Belgium,BEL,444,0,276,45,765
2005,Serbia and Kosovo: S/RES/1244 (1999),SRB,Belgium,BEL,166,0,185,362,713
2005,Senegal,SEN,Belgium,BEL,0,0,5,5,10
2005,Sierra Leone,SLE,Belgium,BEL,5,0,21,76,102
2005,Somalia,SOM,Belgium,BEL,22,0,37,57,116
2005,Viet Nam,VNM,Belgium,BEL,0,0,5,0,5
2005,Sudan,SDN,Belgium,BEL,31,0,69,26,126
2005,Slovakia,SVK,Belgium,BEL,0,0,5,0,5
2005,Syrian Arab Rep.,SYR,Belgium,BEL,26,0,73,37,136
2005,Tajikistan,TJK,Belgium,BEL,5,0,0,0,5
2005,Togo,TGO,Belgium,BEL,63,0,555,74,692
2005,Tunisia,TUN,Belgium,BEL,5,0,0,0,5
2005,Turkey,TUR,Belgium,BEL,21,0,193,40,254
2005,Uganda,UGA,Belgium,BEL,0,0,5,0,5
2005,Ukraine,UKR,Belgium,BEL,0,0,27,36,63
2005,Uzbekistan,UZB,Belgium,BEL,5,0,38,72,115
2005,Yemen,YEM,Belgium,BEL,0,0,5,0,5
2005,Stateless,XXA,Belgium,BEL,0,0,5,0,5
2005,Unknown ,,Belgium,BEL,14,0,55,19,88
2005,Angola,AGO,Benin,BEN,5,0,0,0,5
2005,Chad,TCD,Benin,BEN,5,0,0,0,5
2005,Congo,COG,Benin,BEN,5,0,0,0,5
2005,Dem. Rep. of the Congo,COD,Benin,BEN,21,0,5,0,26
2005,Cote d'Ivoire,CIV,Benin,BEN,5,0,5,0,10
2005,Nigeria,NGA,Benin,BEN,5,0,5,10,20
2005,Rwanda,RWA,Benin,BEN,0,0,0,5,5
2005,Togo,TGO,Benin,BEN,34,0,11,5,50
2005,Chad,TCD,Burkina Faso,BFA,5,0,5,0,10
2005,Congo,COG,Burkina Faso,BFA,12,0,13,0,25
2005,Dem. Rep. of the Congo,COD,Burkina Faso,BFA,5,0,5,0,10
2005,Togo,TGO,Burkina Faso,BFA,5,0,12,0,17
2005,Afghanistan,AFG,Belarus,BLR,10,5,66,15,96
2005,Armenia,ARM,Belarus,BLR,0,0,10,0,10
2005,Azerbaijan,AZE,Belarus,BLR,0,0,5,0,5
2005,Ethiopia,ETH,Belarus,BLR,0,0,10,0,10
2005,Georgia,GEO,Belarus,BLR,18,0,23,5,46
2005,Iraq,IRQ,Belarus,BLR,0,0,5,0,5
2005,Kyrgyzstan,KGZ,Belarus,BLR,0,0,0,5,5
2005,Sudan,SDN,Belarus,BLR,0,0,5,0,5
2005,Syrian Arab Rep.,SYR,Belarus,BLR,0,0,5,0,5
2005,Tajikistan,TJK,Belarus,BLR,5,0,5,5,15
2005,Turkmenistan,TKM,Belarus,BLR,0,0,5,0,5
2005,Colombia,COL,Bolivia (Plurinational State of),BOL,5,0,5,16,26
2005,Ecuador,ECU,Bolivia (Plurinational State of),BOL,0,0,0,5,5
2005,Angola,AGO,Botswana,BWA,0,0,0,386,386
2005,Burundi,BDI,Botswana,BWA,0,0,0,5,5
2005,Dem. Rep. of the Congo,COD,Botswana,BWA,10,0,0,77,87
2005,Eritrea,ERI,Botswana,BWA,0,0,0,5,5
2005,Ethiopia,ETH,Botswana,BWA,0,0,0,20,20
2005,Kenya,KEN,Botswana,BWA,0,0,0,5,5
2005,Namibia,NAM,Botswana,BWA,0,0,0,141,141
2005,Rwanda,RWA,Botswana,BWA,0,0,0,18,18
2005,Somalia,SOM,Botswana,BWA,0,0,0,172,172
2005,Sudan,SDN,Botswana,BWA,0,0,0,19,19
2005,Uganda,UGA,Botswana,BWA,0,0,0,47,47
2005,Zimbabwe,ZWE,Botswana,BWA,11,0,5,64,80
2005,Afghanistan,AFG,Bulgaria,BGR,0,22,143,255,420
2005,Algeria,DZA,Bulgaria,BGR,0,0,10,0,10
2005,Armenia,ARM,Bulgaria,BGR,5,0,45,36,86
2005,Bangladesh,BGD,Bulgaria,BGR,0,0,13,5,18
2005,China,CHN,Bulgaria,BGR,0,0,5,0,5
2005,Dem. Rep. of the Congo,COD,Bulgaria,BGR,0,0,5,5,10
2005,Cuba,CUB,Bulgaria,BGR,0,0,0,10,10
2005,India,IND,Bulgaria,BGR,0,0,40,36,76
2005,Iran (Islamic Rep. of),IRN,Bulgaria,BGR,0,5,11,15,31
2005,Iraq,IRQ,Bulgaria,BGR,0,24,0,24,48
2005,Kazakhstan,KAZ,Bulgaria,BGR,0,0,5,0,5
2005,Lebanon,LBN,Bulgaria,BGR,0,0,5,0,5
2005,Rep. of Moldova,MDA,Bulgaria,BGR,0,0,5,0,5
2005,Nigeria,NGA,Bulgaria,BGR,0,0,17,5,22
2005,Pakistan,PAK,Bulgaria,BGR,0,0,10,35,45
2005,Russian Federation,RUS,Bulgaria,BGR,0,0,10,5,15
2005,Somalia,SOM,Bulgaria,BGR,0,10,0,5,15
2005,Viet Nam,VNM,Bulgaria,BGR,0,0,0,5,5
2005,Syrian Arab Rep.,SYR,Bulgaria,BGR,0,5,10,5,20
2005,Turkey,TUR,Bulgaria,BGR,0,5,12,0,17
2005,Ukraine,UKR,Bulgaria,BGR,0,0,5,0,5
2005,Stateless,XXA,Bulgaria,BGR,0,0,31,19,50
2005,Cuba,CUB,Belize,BLZ,0,0,0,5,5
2005,Haiti,HTI,Belize,BLZ,0,0,0,12,12
2005,Afghanistan,AFG,Canada,CAN,138,0,27,22,187
2005,Albania,ALB,Canada,CAN,204,0,160,63,427
2005,Algeria,DZA,Canada,CAN,30,0,27,5,62
2005,Angola,AGO,Canada,CAN,19,0,25,5,49
2005,Antigua and Barbuda,ATG,Canada,CAN,5,0,5,0,10
2005,Egypt,EGY,Canada,CAN,68,0,73,12,153
2005,Argentina,ARG,Canada,CAN,10,0,52,17,79
2005,Armenia,ARM,Canada,CAN,25,0,12,5,42
2005,Australia,AUS,Canada,CAN,0,0,5,0,5
2005,Azerbaijan,AZE,Canada,CAN,80,0,5,0,85
2005,Barbados,BRB,Canada,CAN,0,0,14,0,14
2005,Burundi,BDI,Canada,CAN,150,0,40,5,195
2005,Benin,BEN,Canada,CAN,5,0,0,0,5
2005,Bangladesh,BGD,Canada,CAN,201,0,195,24,420
2005,Burkina Faso,BFA,Canada,CAN,5,0,5,0,10
2005,Belarus,BLR,Canada,CAN,24,0,5,5,34
2005,Bolivia (Plurinational State of),BOL,Canada,CAN,27,0,28,0,55
2005,Botswana,BWA,Canada,CAN,5,0,5,0,10
2005,Brazil,BRA,Canada,CAN,21,0,106,32,159
2005,Bosnia and Herzegovina,BIH,Canada,CAN,12,0,0,5,17
2005,Bulgaria,BGR,Canada,CAN,70,0,30,26,126
2005,Belize,BLZ,Canada,CAN,0,0,5,0,5
2005,Cambodia,KHM,Canada,CAN,17,0,12,0,29
2005,Chad,TCD,Canada,CAN,40,0,17,5,62
2005,China,CHN,Canada,CAN,837,0,682,234,1753
2005,Chile,CHL,Canada,CAN,20,0,77,16,113
2005,Cameroon,CMR,Canada,CAN,79,0,31,5,115
2005,Congo,COG,Canada,CAN,20,0,14,0,34
2005,Dem. Rep. of the Congo,COD,Canada,CAN,214,0,97,39,350
2005,Colombia,COL,Canada,CAN,2595,0,557,119,3271
2005,Costa Rica,CRI,Canada,CAN,57,0,211,64,332
2005,Cuba,CUB,Canada,CAN,115,0,22,29,166
2005,Czechia,CZE,Canada,CAN,0,0,5,10,15
2005,Djibouti,DJI,Canada,CAN,18,0,5,0,23
2005,Dominica,DMA,Canada,CAN,12,0,30,29,71
2005,Dominican Rep.,DOM,Canada,CAN,0,0,10,5,15
2005,Ecuador,ECU,Canada,CAN,38,0,109,24,171
2005,Equatorial Guinea,GNQ,Canada,CAN,5,0,0,0,5
2005,Eritrea,ERI,Canada,CAN,163,0,10,5,178
2005,Estonia,EST,Canada,CAN,5,0,0,0,5
2005,Ethiopia,ETH,Canada,CAN,174,0,46,10,230
2005,Fiji,FJI,Canada,CAN,10,0,13,0,23
2005,France,FRA,Canada,CAN,0,0,12,5,17
2005,Gabon,GAB,Canada,CAN,10,0,5,0,15
2005,Gambia,GMB,Canada,CAN,0,0,5,0,5
2005,Palestinian,PSE,Canada,CAN,62,0,23,13,98
2005,Georgia,GEO,Canada,CAN,42,0,10,5,57
2005,Germany,DEU,Canada,CAN,0,0,5,10,15
2005,Ghana,GHA,Canada,CAN,20,0,61,10,91
2005,Guinea-Bissau,GNB,Canada,CAN,5,0,5,0,10
2005,Greece,GRC,Canada,CAN,0,0,5,0,5
2005,Grenada,GRD,Canada,CAN,28,0,92,14,134
2005,Guatemala,GTM,Canada,CAN,86,0,132,32,250
2005,Guinea,GIN,Canada,CAN,88,0,35,5,128
2005,Guyana,GUY,Canada,CAN,67,0,260,43,370
2005,Haiti,HTI,Canada,CAN,107,0,68,10,185
2005,Honduras,HND,Canada,CAN,51,0,134,100,285
2005,Croatia,HRV,Canada,CAN,10,0,10,5,25
2005,Hungary,HUN,Canada,CAN,51,0,267,64,382
2005,Cote d'Ivoire,CIV,Canada,CAN,41,0,18,5,64
2005,India,IND,Canada,CAN,282,0,608,241,1131
2005,Indonesia,IDN,Canada,CAN,73,0,98,10,181
2005,Ireland,IRL,Canada,CAN,0,0,5,0,5
2005,Iran (Islamic Rep. of),IRN,Canada,CAN,280,0,53,38,371
2005,Iraq,IRQ,Canada,CAN,96,0,11,15,122
2005,Israel,ISR,Canada,CAN,151,0,269,71,491
2005,Italy,ITA,Canada,CAN,0,0,10,0,10
2005,Jamaica,JAM,Canada,CAN,32,0,98,20,150
2005,Jordan,JOR,Canada,CAN,50,0,35,16,101
2005,Japan,JPN,Canada,CAN,0,0,5,0,5
2005,Kazakhstan,KAZ,Canada,CAN,13,0,5,0,18
2005,Kenya,KEN,Canada,CAN,65,0,115,20,200
2005,Kyrgyzstan,KGZ,Canada,CAN,10,0,0,0,10
2005,Rep. of Korea,KOR,Canada,CAN,23,0,147,49,219
2005,Kuwait,KWT,Canada,CAN,17,0,5,0,22
2005,Liberia,LBR,Canada,CAN,14,0,18,0,32
2005,Libya,LBY,Canada,CAN,23,0,5,0,28
2005,Saint Lucia,LCA,Canada,CAN,40,0,115,13,168
2005,Lebanon,LBN,Canada,CAN,130,0,139,26,295
2005,Sri Lanka,LKA,Canada,CAN,500,0,215,36,751
2005,Lithuania,LTU,Canada,CAN,12,0,5,5,22
2005,Latvia,LVA,Canada,CAN,0,0,10,0,10
2005,Mauritania,MRT,Canada,CAN,45,0,24,5,74
2005,North Macedonia,MKD,Canada,CAN,19,0,19,5,43
2005,Rep. of Moldova,MDA,Canada,CAN,14,0,10,0,24
2005,Mexico,MEX,Canada,CAN,697,0,2286,696,3679
2005,Mali,MLI,Canada,CAN,10,0,10,0,20
2005,Malaysia,MYS,Canada,CAN,13,0,68,10,91
2005,Malawi,MWI,Canada,CAN,0,0,5,0,5
2005,Mongolia,MNG,Canada,CAN,13,0,0,0,13
2005,Morocco,MAR,Canada,CAN,17,0,13,5,35
2005,Mauritius,MUS,Canada,CAN,0,0,5,0,5
2005,Myanmar,MMR,Canada,CAN,38,0,0,0,38
2005,Namibia,NAM,Canada,CAN,5,0,5,0,10
2005,Nepal,NPL,Canada,CAN,69,0,5,5,79
2005,Netherlands,NLD,Canada,CAN,0,0,12,5,17
2005,Niger,NER,Canada,CAN,10,0,10,0,20
2005,Nicaragua,NIC,Canada,CAN,11,0,15,0,26
2005,Nigeria,NGA,Canada,CAN,332,0,409,65,806
2005,Norway,NOR,Canada,CAN,0,0,5,0,5
2005,Pakistan,PAK,Canada,CAN,695,0,842,207,1744
2005,Panama,PAN,Canada,CAN,5,0,15,0,20
2005,Paraguay,PRY,Canada,CAN,11,0,5,0,16
2005,Peru,PER,Canada,CAN,228,0,315,38,581
2005,Philippines,PHL,Canada,CAN,25,0,162,10,197
2005,Poland,POL,Canada,CAN,20,0,76,10,106
2005,Portugal,PRT,Canada,CAN,0,0,184,32,216
2005,Romania,ROU,Canada,CAN,84,0,57,19,160
2005,South Africa,ZAF,Canada,CAN,5,0,18,0,23
2005,Russian Federation,RUS,Canada,CAN,145,0,60,27,232
2005,Rwanda,RWA,Canada,CAN,91,0,22,0,113
2005,El Salvador,SLV,Canada,CAN,109,0,181,43,333
2005,Saudi Arabia,SAU,Canada,CAN,10,0,5,5,20
2005,Serbia and Kosovo: S/RES/1244 (1999),SRB,Canada,CAN,46,0,62,21,129
2005,Senegal,SEN,Canada,CAN,14,0,10,0,24
2005,Seychelles,SYC,Canada,CAN,5,0,5,0,10
2005,Singapore,SGP,Canada,CAN,0,0,5,0,5
2005,Sierra Leone,SLE,Canada,CAN,16,0,18,0,34
2005,Somalia,SOM,Canada,CAN,319,0,10,52,381
2005,Spain,ESP,Canada,CAN,0,0,5,0,5
2005,Viet Nam,VNM,Canada,CAN,12,0,33,13,58
2005,Sudan,SDN,Canada,CAN,48,0,13,5,66
2005,Suriname,SUR,Canada,CAN,0,0,5,5,10
2005,Slovakia,SVK,Canada,CAN,0,0,13,5,18
2005,Slovenia,SVN,Canada,CAN,0,0,0,5,5
2005,Eswatini,SWZ,Canada,CAN,0,0,5,0,5
2005,Syrian Arab Rep.,SYR,Canada,CAN,49,0,36,5,90
2005,United Rep. of Tanzania,TZA,Canada,CAN,13,0,16,5,34
2005,Thailand,THA,Canada,CAN,0,0,5,0,5
2005,Tajikistan,TJK,Canada,CAN,5,0,0,0,5
2005,Turkmenistan,TKM,Canada,CAN,5,0,0,0,5
2005,Togo,TGO,Canada,CAN,19,0,11,0,30
2005,Trinidad and Tobago,TTO,Canada,CAN,21,0,110,22,153
2005,Tunisia,TUN,Canada,CAN,31,0,11,5,47
2005,Turkey,TUR,Canada,CAN,174,0,90,40,304
2005,Uganda,UGA,Canada,CAN,39,0,26,0,65
2005,Ukraine,UKR,Canada,CAN,136,0,73,41,250
2005,Uruguay,URY,Canada,CAN,20,0,57,12,89
2005,United States of America,USA,Canada,CAN,0,0,135,96,231
2005,Uzbekistan,UZB,Canada,CAN,22,0,5,0,27
2005,Saint Vincent and the Grenadines,VCT,Canada,CAN,103,0,152,21,276
2005,Venezuela (Bolivarian Republic of),VEN,Canada,CAN,102,0,147,16,265
2005,Yemen,YEM,Canada,CAN,26,0,14,5,45
2005,Zambia,ZMB,Canada,CAN,0,0,5,5,10
2005,Zimbabwe,ZWE,Canada,CAN,100,0,23,5,128
2005,Stateless,XXA,Canada,CAN,0,0,0,5,5
2005,Unknown ,,Canada,CAN,5,0,10,5,20
2005,Angola,AGO,Central African Rep.,CAF,5,0,0,0,5
2005,Chad,TCD,Central African Rep.,CAF,75,0,12,0,87
2005,Congo,COG,Central African Rep.,CAF,14,0,0,0,14
2005,Dem. Rep. of the Congo,COD,Central African Rep.,CAF,419,0,41,5,465
2005,Cote d'Ivoire,CIV,Central African Rep.,CAF,14,0,0,5,19
2005,Liberia,LBR,Central African Rep.,CAF,5,0,5,13,23
2005,Mali,MLI,Central African Rep.,CAF,10,0,0,0,10
2005,Rwanda,RWA,Central African Rep.,CAF,22,0,0,0,22
2005,Sierra Leone,SLE,Central African Rep.,CAF,5,0,0,0,5
2005,Sudan,SDN,Central African Rep.,CAF,416,0,11,0,427
2005,Togo,TGO,Central African Rep.,CAF,5,0,0,0,5
2005,Colombia,COL,Chile,CHL,217,0,79,36,332
2005,Cuba,CUB,Chile,CHL,0,0,5,0,5
2005,Peru,PER,Chile,CHL,0,0,0,5,5
2005,Sierra Leone,SLE,Chile,CHL,0,0,5,0,5
2005,Cuba,CUB,Colombia,COL,24,0,10,0,34
2005,Ecuador,ECU,Colombia,COL,0,0,10,0,10
2005,Peru,PER,Colombia,COL,0,0,5,0,5
2005,Venezuela (Bolivarian Republic of),VEN,Colombia,COL,5,0,11,0,16
2005,Afghanistan,AFG,Cyprus,CYP,0,0,12,27,39
2005,Egypt,EGY,Cyprus,CYP,0,5,10,10,25
2005,Armenia,ARM,Cyprus,CYP,0,10,5,0,15
2005,Bangladesh,BGD,Cyprus,CYP,0,0,1327,383,1710
2005,Burkina Faso,BFA,Cyprus,CYP,0,0,5,0,5
2005,Belarus,BLR,Cyprus,CYP,0,0,5,5,10
2005,Bosnia and Herzegovina,BIH,Cyprus,CYP,0,0,5,0,5
2005,Bulgaria,BGR,Cyprus,CYP,0,0,0,12,12
2005,China,CHN,Cyprus,CYP,0,0,87,194,281
2005,Dem. Rep. of the Congo,COD,Cyprus,CYP,0,0,11,0,11
2005,Ethiopia,ETH,Cyprus,CYP,5,0,0,0,5
2005,Palestinian,PSE,Cyprus,CYP,0,25,11,42,78
2005,Georgia,GEO,Cyprus,CYP,0,5,354,187,546
2005,Cote d'Ivoire,CIV,Cyprus,CYP,0,0,12,0,12
2005,India,IND,Cyprus,CYP,0,0,141,185,326
2005,Iran (Islamic Rep. of),IRN,Cyprus,CYP,13,29,299,308,649
2005,Iraq,IRQ,Cyprus,CYP,10,0,0,59,69
2005,Jordan,JOR,Cyprus,CYP,0,0,0,13,13
2005,Kazakhstan,KAZ,Cyprus,CYP,0,0,5,0,5
2005,Lebanon,LBN,Cyprus,CYP,0,5,10,24,39
2005,Sri Lanka,LKA,Cyprus,CYP,0,0,207,398,605
2005,Rep. of Moldova,MDA,Cyprus,CYP,0,5,27,22,54
2005,Nepal,NPL,Cyprus,CYP,0,0,0,5,5
2005,Nigeria,NGA,Cyprus,CYP,0,0,11,0,11
2005,Pakistan,PAK,Cyprus,CYP,0,0,223,198,421
2005,Philippines,PHL,Cyprus,CYP,0,0,0,5,5
2005,Romania,ROU,Cyprus,CYP,0,0,0,10,10
2005,Russian Federation,RUS,Cyprus,CYP,5,5,82,46,138
2005,Serbia and Kosovo: S/RES/1244 (1999),SRB,Cyprus,CYP,0,5,0,0,5
2005,Syrian Arab Rep.,SYR,Cyprus,CYP,5,15,65,121,206
2005,Turkey,TUR,Cyprus,CYP,10,0,45,41,96
2005,Ukraine,UKR,Cyprus,CYP,0,10,146,186,342
2005,Uzbekistan,UZB,Cyprus,CYP,0,5,0,5,10
2005,Afghanistan,AFG,Czechia,CZE,5,0,5,10,20
2005,Algeria,DZA,Czechia,CZE,0,0,52,5,57
2005,Armenia,ARM,Czechia,CZE,19,0,47,14,80
2005,Azerbaijan,AZE,Czechia,CZE,0,0,0,5,5
2005,Belarus,BLR,Czechia,CZE,47,0,95,72,214
2005,Bosnia and Herzegovina,BIH,Czechia,CZE,0,0,0,5,5
2005,Bulgaria,BGR,Czechia,CZE,0,0,40,11,51
2005,China,CHN,Czechia,CZE,5,0,269,51,325
2005,Georgia,GEO,Czechia,CZE,5,0,39,14,58
2005,Ghana,GHA,Czechia,CZE,0,0,5,0,5
2005,Guinea,GIN,Czechia,CZE,5,0,5,0,10
2005,Cote d'Ivoire,CIV,Czechia,CZE,0,0,5,5,10
2005,India,IND,Czechia,CZE,0,0,221,56,277
2005,Iran (Islamic Rep. of),IRN,Czechia,CZE,5,0,0,5,10
2005,Iraq,IRQ,Czechia,CZE,0,0,5,35,40
2005,Kazakhstan,KAZ,Czechia,CZE,18,0,18,0,36
2005,Kyrgyzstan,KGZ,Czechia,CZE,5,0,41,27,73
2005,Sri Lanka,LKA,Czechia,CZE,0,0,5,0,5
2005,North Macedonia,MKD,Czechia,CZE,0,0,13,0,13
2005,Rep. of Moldova,MDA,Czechia,CZE,5,0,65,10,80
2005,Mongolia,MNG,Czechia,CZE,0,0,132,5,137
2005,Nigeria,NGA,Czechia,CZE,0,0,70,20,90
2005,Pakistan,PAK,Czechia,CZE,0,0,5,5,10
2005,Romania,ROU,Czechia,CZE,0,0,52,5,57
2005,Russian Federation,RUS,Czechia,CZE,69,0,153,167,389
2005,Serbia and Kosovo: S/RES/1244 (1999),SRB,Czechia,CZE,5,0,0,0,5
2005,Senegal,SEN,Czechia,CZE,0,0,5,0,5
2005,Somalia,SOM,Czechia,CZE,0,0,0,5,5
2005,Viet Nam,VNM,Czechia,CZE,0,0,192,34,226
2005,Slovakia,SVK,Czechia,CZE,0,0,0,730,730
2005,Syrian Arab Rep.,SYR,Czechia,CZE,0,0,10,0,10
2005,Turkey,TUR,Czechia,CZE,5,0,5,14,24
2005,Ukraine,UKR,Czechia,CZE,10,0,987,82,1079
2005,Uzbekistan,UZB,Czechia,CZE,17,0,0,18,35
2005,Stateless,XXA,Czechia,CZE,0,0,0,52,52
2005,Unknown ,,Czechia,CZE,25,0,91,5,121
2005,Afghanistan,AFG,Denmark,DNK,5,24,135,0,164
2005,Albania,ALB,Denmark,DNK,0,0,12,0,12
2005,Algeria,DZA,Denmark,DNK,0,0,5,0,5
2005,Azerbaijan,AZE,Denmark,DNK,0,0,10,0,10
2005,Burundi,BDI,Denmark,DNK,0,5,10,0,15
2005,Belgium,BEL,Denmark,DNK,0,0,5,0,5
2005,Bangladesh,BGD,Denmark,DNK,0,0,5,0,5
2005,Bosnia and Herzegovina,BIH,Denmark,DNK,0,0,22,0,22
2005,Bulgaria,BGR,Denmark,DNK,0,0,5,0,5
2005,China,CHN,Denmark,DNK,0,0,18,0,18
2005,Cameroon,CMR,Denmark,DNK,0,0,5,0,5
2005,Dem. Rep. of the Congo,COD,Denmark,DNK,0,5,5,0,10
2005,Ethiopia,ETH,Denmark,DNK,0,0,5,0,5
2005,Palestinian,PSE,Denmark,DNK,10,0,56,0,66
2005,Ghana,GHA,Denmark,DNK,0,0,5,0,5
2005,Guinea,GIN,Denmark,DNK,0,0,10,0,10
2005,Croatia,HRV,Denmark,DNK,0,0,5,0,5
2005,Cote d'Ivoire,CIV,Denmark,DNK,0,0,5,0,5
2005,India,IND,Denmark,DNK,0,0,14,0,14
2005,Iran (Islamic Rep. of),IRN,Denmark,DNK,14,14,61,0,89
2005,Iraq,IRQ,Denmark,DNK,0,5,119,0,124
2005,Kyrgyzstan,KGZ,Denmark,DNK,0,0,5,0,5
2005,Libya,LBY,Denmark,DNK,0,0,5,0,5
2005,Lebanon,LBN,Denmark,DNK,0,0,5,0,5
2005,Sri Lanka,LKA,Denmark,DNK,0,0,12,0,12
2005,Lithuania,LTU,Denmark,DNK,0,0,5,0,5
2005,Latvia,LVA,Denmark,DNK,0,0,5,0,5
2005,North Macedonia,MKD,Denmark,DNK,0,0,12,0,12
2005,Rep. of Moldova,MDA,Denmark,DNK,0,0,11,0,11
2005,Morocco,MAR,Denmark,DNK,0,0,5,0,5
2005,Myanmar,MMR,Denmark,DNK,5,0,0,0,5
2005,Nepal,NPL,Denmark,DNK,0,0,5,0,5
2005,Nigeria,NGA,Denmark,DNK,0,0,28,0,28
2005,Pakistan,PAK,Denmark,DNK,0,0,5,0,5
2005,Romania,ROU,Denmark,DNK,0,0,5,0,5
2005,Russian Federation,RUS,Denmark,DNK,5,64,14,0,83
2005,Rwanda,RWA,Denmark,DNK,0,0,5,0,5
2005,Serbia and Kosovo: S/RES/1244 (1999),SRB,Denmark,DNK,0,0,315,0,315
2005,Sierra Leone,SLE,Denmark,DNK,0,0,5,0,5
2005,Somalia,SOM,Denmark,DNK,0,0,42,0,42
2005,Viet Nam,VNM,Denmark,DNK,0,0,5,0,5
2005,Sudan,SDN,Denmark,DNK,0,5,10,0,15
2005,Syrian Arab Rep.,SYR,Denmark,DNK,21,0,20,0,41
2005,Togo,TGO,Denmark,DNK,0,0,5,0,5
2005,Tunisia,TUN,Denmark,DNK,0,0,5,0,5
2005,Turkey,TUR,Denmark,DNK,0,0,14,0,14
2005,Uganda,UGA,Denmark,DNK,0,0,5,0,5
2005,Ukraine,UKR,Denmark,DNK,0,0,5,0,5
2005,Uzbekistan,UZB,Denmark,DNK,0,0,5,0,5
2005,Stateless,XXA,Denmark,DNK,18,0,5,0,23
2005,Afghanistan,AFG,France,FRA,23,0,108,0,131
2005,Albania,ALB,France,FRA,22,0,389,0,411
2005,Algeria,DZA,France,FRA,86,0,1803,0,1889
2005,Angola,AGO,France,FRA,71,0,976,0,1047
2005,Egypt,EGY,France,FRA,0,0,19,0,19
2005,Armenia,ARM,France,FRA,29,0,1175,0,1204
2005,Azerbaijan,AZE,France,FRA,43,0,546,0,589
2005,Burundi,BDI,France,FRA,23,0,59,0,82
2005,Bangladesh,BGD,France,FRA,20,0,1091,0,1111
2005,Belarus,BLR,France,FRA,11,0,208,0,219
2005,Brazil,BRA,France,FRA,0,0,12,0,12
2005,Bosnia and Herzegovina,BIH,France,FRA,588,0,1910,0,2498
2005,Cambodia,KHM,France,FRA,5,0,83,0,88
2005,Central African Rep.,CAF,France,FRA,36,0,165,0,201
2005,Chad,TCD,France,FRA,37,0,188,0,225
2005,China,CHN,France,FRA,31,0,2904,0,2935
2005,Cameroon,CMR,France,FRA,34,0,433,0,467
2005,Congo,COG,France,FRA,138,0,1331,0,1469
2005,Dem. Rep. of the Congo,COD,France,FRA,265,0,3617,0,3882
2005,Comoros,COM,France,FRA,5,0,108,0,113
2005,Colombia,COL,France,FRA,20,0,39,0,59
2005,Cuba,CUB,France,FRA,13,0,13,0,26
2005,Cabo Verde,CPV,France,FRA,0,0,10,0,10
2005,Djibouti,DJI,France,FRA,0,0,13,0,13
2005,Dominican Rep.,DOM,France,FRA,0,0,97,0,97
2005,Eritrea,ERI,France,FRA,28,0,17,0,45
2005,Ethiopia,ETH,France,FRA,15,0,26,0,41
2005,Palestinian,PSE,France,FRA,0,0,60,0,60
2005,Georgia,GEO,France,FRA,17,0,1306,0,1323
2005,Guinea-Bissau,GNB,France,FRA,17,0,107,0,124
2005,Guinea,GIN,France,FRA,95,0,1122,0,1217
2005,Haiti,HTI,France,FRA,208,0,3447,0,3655
2005,Cote d'Ivoire,CIV,France,FRA,198,0,1027,0,1225
2005,India,IND,France,FRA,5,0,620,0,625
2005,Iran (Islamic Rep. of),IRN,France,FRA,18,0,67,0,85
2005,Iraq,IRQ,France,FRA,22,0,115,0,137
2005,Kazakhstan,KAZ,France,FRA,5,0,83,0,88
2005,Kenya,KEN,France,FRA,0,0,13,0,13
2005,Kyrgyzstan,KGZ,France,FRA,0,0,56,0,56
2005,Liberia,LBR,France,FRA,0,0,141,0,141
2005,Lebanon,LBN,France,FRA,5,0,17,0,22
2005,Sri Lanka,LKA,France,FRA,131,0,2558,0,2689
2005,Madagascar,MDG,France,FRA,31,0,253,0,284
2005,Mauritania,MRT,France,FRA,64,0,1501,0,1565
2005,North Macedonia,MKD,France,FRA,0,0,193,0,193
2005,Rep. of Moldova,MDA,France,FRA,13,0,2345,0,2358
2005,Mali,MLI,France,FRA,5,0,586,0,591
2005,Mongolia,MNG,France,FRA,10,0,514,0,524
2005,Morocco,MAR,France,FRA,0,0,47,0,47
2005,Myanmar,MMR,France,FRA,5,0,17,0,22
2005,Nepal,NPL,France,FRA,5,0,25,0,30
2005,Niger,NER,France,FRA,5,0,22,0,27
2005,Nigeria,NGA,France,FRA,20,0,1499,0,1519
2005,Pakistan,PAK,France,FRA,19,0,531,0,550
2005,Peru,PER,France,FRA,5,0,23,0,28
2005,Philippines,PHL,France,FRA,0,0,5,0,5
2005,Russian Federation,RUS,France,FRA,683,0,1568,0,2251
2005,Rwanda,RWA,France,FRA,188,0,213,0,401
2005,Serbia and Kosovo: S/RES/1244 (1999),SRB,France,FRA,333,0,2348,0,2681
2005,Senegal,SEN,France,FRA,0,0,122,0,122
2005,Sierra Leone,SLE,France,FRA,14,0,220,0,234
2005,Somalia,SOM,France,FRA,21,0,102,0,123
2005,Viet Nam,VNM,France,FRA,10,0,23,0,33
2005,Sudan,SDN,France,FRA,92,0,280,0,372
2005,Syrian Arab Rep.,SYR,France,FRA,5,0,33,0,38
2005,Thailand,THA,France,FRA,0,0,11,0,11
2005,Togo,TGO,France,FRA,41,0,293,0,334
2005,Tunisia,TUN,France,FRA,10,0,20,0,30
2005,Turkey,TUR,France,FRA,198,0,4796,0,4994
2005,Ukraine,UKR,France,FRA,5,0,565,0,570
2005,Uzbekistan,UZB,France,FRA,5,0,35,0,40
2005,Venezuela (Bolivarian Republic of),VEN,France,FRA,0,0,5,0,5
2005,Zimbabwe,ZWE,France,FRA,5,0,10,0,15
2005,Stateless,XXA,France,FRA,79,0,121,0,200
2005,Unknown ,,France,FRA,34,0,684,0,718
2005,Afghanistan,AFG,United Kingdom of Great Britain and Northern Ireland,GBR,44,499,916,272,1731
2005,Albania,ALB,United Kingdom of Great Britain and Northern Ireland,GBR,0,31,161,23,215
2005,Algeria,DZA,United Kingdom of Great Britain and Northern Ireland,GBR,10,28,264,58,360
2005,Angola,AGO,United Kingdom of Great Britain and Northern Ireland,GBR,10,43,203,26,282
2005,Egypt,EGY,United Kingdom of Great Britain and Northern Ireland,GBR,0,0,60,5,65
2005,Argentina,ARG,United Kingdom of Great Britain and Northern Ireland,GBR,0,0,5,0,5
2005,Armenia,ARM,United Kingdom of Great Britain and Northern Ireland,GBR,5,0,31,5,41
2005,Azerbaijan,AZE,United Kingdom of Great Britain and Northern Ireland,GBR,10,0,69,5,84
2005,Burundi,BDI,United Kingdom of Great Britain and Northern Ireland,GBR,13,33,117,10,173
2005,Benin,BEN,United Kingdom of Great Britain and Northern Ireland,GBR,0,0,10,0,10
2005,Bangladesh,BGD,United Kingdom of Great Britain and Northern Ireland,GBR,5,143,255,33,436
2005,Bhutan,BTN,United Kingdom of Great Britain and Northern Ireland,GBR,0,0,15,0,15
2005,Burkina Faso,BFA,United Kingdom of Great Britain and Northern Ireland,GBR,0,0,10,0,10
2005,Belarus,BLR,United Kingdom of Great Britain and Northern Ireland,GBR,10,0,70,5,85
2005,Bolivia (Plurinational State of),BOL,United Kingdom of Great Britain and Northern Ireland,GBR,0,5,24,0,29
2005,Botswana,BWA,United Kingdom of Great Britain and Northern Ireland,GBR,0,0,5,0,5
2005,Brazil,BRA,United Kingdom of Great Britain and Northern Ireland,GBR,0,0,5,5,10
2005,Bosnia and Herzegovina,BIH,United Kingdom of Great Britain and Northern Ireland,GBR,10,0,26,44,80
2005,Bulgaria,BGR,United Kingdom of Great Britain and Northern Ireland,GBR,0,5,5,0,10
2005,Chad,TCD,United Kingdom of Great Britain and Northern Ireland,GBR,5,5,10,0,20
2005,China,CHN,United Kingdom of Great Britain and Northern Ireland,GBR,12,77,1312,419,1820
2005,Cameroon,CMR,United Kingdom of Great Britain and Northern Ireland,GBR,26,34,238,25,323
2005,Congo,COG,United Kingdom of Great Britain and Northern Ireland,GBR,12,10,82,10,114
2005,Dem. Rep. of the Congo,COD,United Kingdom of Great Britain and Northern Ireland,GBR,94,160,1154,100,1508
2005,Colombia,COL,United Kingdom of Great Britain and Northern Ireland,GBR,10,0,83,5,98
2005,Cuba,CUB,United Kingdom of Great Britain and Northern Ireland,GBR,0,0,14,0,14
2005,Cyprus,CYP,United Kingdom of Great Britain and Northern Ireland,GBR,0,0,5,0,5
2005,Czechia,CZE,United Kingdom of Great Britain and Northern Ireland,GBR,0,0,5,0,5
2005,Ecuador,ECU,United Kingdom of Great Britain and Northern Ireland,GBR,0,0,32,0,32
2005,Equatorial Guinea,GNQ,United Kingdom of Great Britain and Northern Ireland,GBR,0,0,0,5,5
2005,Eritrea,ERI,United Kingdom of Great Britain and Northern Ireland,GBR,601,137,798,281,1817
2005,Ethiopia,ETH,United Kingdom of Great Britain and Northern Ireland,GBR,12,39,339,46,436
2005,Gambia,GMB,United Kingdom of Great Britain and Northern Ireland,GBR,0,5,81,15,101
2005,Palestinian,PSE,United Kingdom of Great Britain and Northern Ireland,GBR,5,24,388,112,529
2005,Georgia,GEO,United Kingdom of Great Britain and Northern Ireland,GBR,0,0,97,26,123
2005,Ghana,GHA,United Kingdom of Great Britain and Northern Ireland,GBR,5,14,186,17,222
2005,Guinea,GIN,United Kingdom of Great Britain and Northern Ireland,GBR,5,58,121,16,200
2005,Guyana,GUY,United Kingdom of Great Britain and Northern Ireland,GBR,0,0,5,0,5
2005,Haiti,HTI,United Kingdom of Great Britain and Northern Ireland,GBR,0,0,5,0,5
2005,Croatia,HRV,United Kingdom of Great Britain and Northern Ireland,GBR,5,0,27,0,32
2005,Hungary,HUN,United Kingdom of Great Britain and Northern Ireland,GBR,0,0,5,0,5
2005,Cote d'Ivoire,CIV,United Kingdom of Great Britain and Northern Ireland,GBR,23,19,170,19,231
2005,India,IND,United Kingdom of Great Britain and Northern Ireland,GBR,0,20,795,180,995
2005,Indonesia,IDN,United Kingdom of Great Britain and Northern Ireland,GBR,0,0,5,0,5
2005,Iran (Islamic Rep. of),IRN,United Kingdom of Great Britain and Northern Ireland,GBR,90,390,2846,393,3719
2005,Iraq,IRQ,United Kingdom of Great Britain and Northern Ireland,GBR,5,178,1583,306,2072
2005,Israel,ISR,United Kingdom of Great Britain and Northern Ireland,GBR,0,0,75,0,75
2005,Jamaica,JAM,United Kingdom of Great Britain and Northern Ireland,GBR,0,17,351,10,378
2005,Jordan,JOR,United Kingdom of Great Britain and Northern Ireland,GBR,0,0,10,0,10
2005,Kazakhstan,KAZ,United Kingdom of Great Britain and Northern Ireland,GBR,0,0,5,5,10
2005,Kenya,KEN,United Kingdom of Great Britain and Northern Ireland,GBR,0,13,100,12,125
2005,Kyrgyzstan,KGZ,United Kingdom of Great Britain and Northern Ireland,GBR,0,0,5,0,5
2005,Dem. People's Rep. of Korea,PRK,United Kingdom of Great Britain and Northern Ireland,GBR,5,12,12,5,34
2005,Kuwait,KWT,United Kingdom of Great Britain and Northern Ireland,GBR,17,0,20,5,42
2005,Liberia,LBR,United Kingdom of Great Britain and Northern Ireland,GBR,0,17,170,46,233
2005,Libya,LBY,United Kingdom of Great Britain and Northern Ireland,GBR,25,5,149,22,201
2005,Lebanon,LBN,United Kingdom of Great Britain and Northern Ireland,GBR,5,5,123,12,145
2005,Sri Lanka,LKA,United Kingdom of Great Britain and Northern Ireland,GBR,11,58,480,74,623
2005,Lithuania,LTU,United Kingdom of Great Britain and Northern Ireland,GBR,0,0,15,0,15
2005,Mauritania,MRT,United Kingdom of Great Britain and Northern Ireland,GBR,0,0,5,0,5
2005,North Macedonia,MKD,United Kingdom of Great Britain and Northern Ireland,GBR,0,0,12,0,12
2005,Rep. of Moldova,MDA,United Kingdom of Great Britain and Northern Ireland,GBR,0,17,66,30,113
2005,Maldives,MDV,United Kingdom of Great Britain and Northern Ireland,GBR,5,0,0,0,5
2005,Mali,MLI,United Kingdom of Great Britain and Northern Ireland,GBR,0,0,5,0,5
2005,Malaysia,MYS,United Kingdom of Great Britain and Northern Ireland,GBR,0,0,13,0,13
2005,Malawi,MWI,United Kingdom of Great Britain and Northern Ireland,GBR,0,0,121,5,126
2005,Mongolia,MNG,United Kingdom of Great Britain and Northern Ireland,GBR,0,0,113,21,134
2005,Morocco,MAR,United Kingdom of Great Britain and Northern Ireland,GBR,0,10,25,5,40
2005,Mozambique,MOZ,United Kingdom of Great Britain and Northern Ireland,GBR,0,0,5,0,5
2005,Mauritius,MUS,United Kingdom of Great Britain and Northern Ireland,GBR,0,5,10,0,15
2005,Myanmar,MMR,United Kingdom of Great Britain and Northern Ireland,GBR,24,5,38,0,67
2005,Nepal,NPL,United Kingdom of Great Britain and Northern Ireland,GBR,0,0,60,10,70
2005,Niger,NER,United Kingdom of Great Britain and Northern Ireland,GBR,0,0,5,0,5
2005,Nigeria,NGA,United Kingdom of Great Britain and Northern Ireland,GBR,0,73,879,130,1082
2005,Pakistan,PAK,United Kingdom of Great Britain and Northern Ireland,GBR,116,78,2046,141,2381
2005,Peru,PER,United Kingdom of Great Britain and Northern Ireland,GBR,0,0,5,5,10
2005,Philippines,PHL,United Kingdom of Great Britain and Northern Ireland,GBR,0,0,5,5,10
2005,Poland,POL,United Kingdom of Great Britain and Northern Ireland,GBR,0,0,16,0,16
2005,Qatar,QAT,United Kingdom of Great Britain and Northern Ireland,GBR,0,0,0,5,5
2005,Romania,ROU,United Kingdom of Great Britain and Northern Ireland,GBR,0,42,142,50,234
2005,South Africa,ZAF,United Kingdom of Great Britain and Northern Ireland,GBR,0,0,118,5,123
2005,Russian Federation,RUS,United Kingdom of Great Britain and Northern Ireland,GBR,33,0,146,25,204
2005,Rwanda,RWA,United Kingdom of Great Britain and Northern Ireland,GBR,0,5,41,10,56
2005,Serbia and Kosovo: S/RES/1244 (1999),SRB,United Kingdom of Great Britain and Northern Ireland,GBR,14,61,489,77,641
2005,Senegal,SEN,United Kingdom of Great Britain and Northern Ireland,GBR,0,0,16,0,16
2005,Seychelles,SYC,United Kingdom of Great Britain and Northern Ireland,GBR,0,0,10,0,10
2005,Singapore,SGP,United Kingdom of Great Britain and Northern Ireland,GBR,0,0,5,0,5
2005,Sierra Leone,SLE,United Kingdom of Great Britain and Northern Ireland,GBR,0,32,135,41,208
2005,Somalia,SOM,United Kingdom of Great Britain and Northern Ireland,GBR,840,205,1050,186,2281
2005,Viet Nam,VNM,United Kingdom of Great Britain and Northern Ireland,GBR,0,133,229,84,446
2005,Sudan,SDN,United Kingdom of Great Britain and Northern Ireland,GBR,86,29,746,222,1083
2005,Eswatini,SWZ,United Kingdom of Great Britain and Northern Ireland,GBR,0,0,5,0,5
2005,Syrian Arab Rep.,SYR,United Kingdom of Great Britain and Northern Ireland,GBR,15,29,324,64,432
2005,United Rep. of Tanzania,TZA,United Kingdom of Great Britain and Northern Ireland,GBR,0,0,34,0,34
2005,Thailand,THA,United Kingdom of Great Britain and Northern Ireland,GBR,0,0,5,0,5
2005,Turkmenistan,TKM,United Kingdom of Great Britain and Northern Ireland,GBR,5,0,10,0,15
2005,Togo,TGO,United Kingdom of Great Britain and Northern Ireland,GBR,0,5,53,5,63
2005,Trinidad and Tobago,TTO,United Kingdom of Great Britain and Northern Ireland,GBR,0,0,5,0,5
2005,Tunisia,TUN,United Kingdom of Great Britain and Northern Ireland,GBR,10,0,17,0,27
2005,Turkey,TUR,United Kingdom of Great Britain and Northern Ireland,GBR,41,67,957,104,1169
2005,Uganda,UGA,United Kingdom of Great Britain and Northern Ireland,GBR,24,21,207,10,262
2005,Ukraine,UKR,United Kingdom of Great Britain and Northern Ireland,GBR,0,0,67,5,72
2005,Uzbekistan,UZB,United Kingdom of Great Britain and Northern Ireland,GBR,5,0,11,0,16
2005,Venezuela (Bolivarian Republic of),VEN,United Kingdom of Great Britain and Northern Ireland,GBR,0,0,19,0,19
2005,Yemen,YEM,United Kingdom of Great Britain and Northern Ireland,GBR,5,11,57,10,83
2005,Zambia,ZMB,United Kingdom of Great Britain and Northern Ireland,GBR,0,0,20,0,20
2005,Zimbabwe,ZWE,United Kingdom of Great Britain and Northern Ireland,GBR,105,23,1122,81,1331
2005,Stateless,XXA,United Kingdom of Great Britain and Northern Ireland,GBR,39,0,83,11,133
2005,Unknown ,,United Kingdom of Great Britain and Northern Ireland,GBR,0,0,31,0,31
2005,Iran (Islamic Rep. of),IRN,Georgia,GEO,0,0,19,0,19
2005,Burkina Faso,BFA,Ghana,GHA,0,0,10,0,10
2005,Dem. Rep. of the Congo,COD,Ghana,GHA,5,0,10,0,15
2005,Rwanda,RWA,Ghana,GHA,5,0,0,0,5
2005,Sierra Leone,SLE,Ghana,GHA,15,0,351,0,366
2005,Sudan,SDN,Ghana,GHA,567,0,5,0,572
2005,Togo,TGO,Ghana,GHA,0,0,0,13595,13595
2005,Burundi,BDI,Guinea-Bissau,GNB,5,0,0,0,5
2005,Congo,COG,Guinea-Bissau,GNB,5,0,0,0,5
2005,Cote d'Ivoire,CIV,Guinea-Bissau,GNB,10,0,0,0,10
2005,Liberia,LBR,Guinea-Bissau,GNB,43,0,0,0,43
2005,Senegal,SEN,Guinea-Bissau,GNB,5,0,0,0,5
2005,Sierra Leone,SLE,Guinea-Bissau,GNB,26,0,68,0,94
2005,Afghanistan,AFG,Greece,GRC,5,5,311,125,446
2005,Albania,ALB,Greece,GRC,0,0,16,10,26
2005,Algeria,DZA,Greece,GRC,0,0,24,10,34
2005,Egypt,EGY,Greece,GRC,0,0,94,31,125
2005,Armenia,ARM,Greece,GRC,0,0,10,47,57
2005,Azerbaijan,AZE,Greece,GRC,0,0,10,5,15
2005,Burundi,BDI,Greece,GRC,0,0,10,12,22
2005,Bangladesh,BGD,Greece,GRC,0,0,275,192,467
2005,Belarus,BLR,Greece,GRC,0,0,14,92,106
2005,Bulgaria,BGR,Greece,GRC,0,0,10,147,157
2005,China,CHN,Greece,GRC,0,0,106,191,297
2005,Cameroon,CMR,Greece,GRC,0,0,5,0,5
2005,Dem. Rep. of the Congo,COD,Greece,GRC,5,0,28,5,38
2005,Eritrea,ERI,Greece,GRC,0,0,14,15,29
2005,Ethiopia,ETH,Greece,GRC,5,0,55,62,122
2005,Georgia,GEO,Greece,GRC,0,0,170,1755,1925
2005,Ghana,GHA,Greece,GRC,0,0,21,25,46
2005,Guinea,GIN,Greece,GRC,0,0,5,0,5
2005,Cote d'Ivoire,CIV,Greece,GRC,0,0,31,10,41
2005,India,IND,Greece,GRC,0,0,55,138,193
2005,Indonesia,IDN,Greece,GRC,0,0,0,16,16
2005,Iran (Islamic Rep. of),IRN,Greece,GRC,5,5,195,67,272
2005,Iraq,IRQ,Greece,GRC,0,0,1299,312,1611
2005,Kenya,KEN,Greece,GRC,0,0,5,0,5
2005,Liberia,LBR,Greece,GRC,0,0,10,5,15
2005,Lebanon,LBN,Greece,GRC,0,0,5,0,5
2005,Sri Lanka,LKA,Greece,GRC,0,0,46,68,114
2005,Mauritania,MRT,Greece,GRC,0,0,18,5,23
2005,Rep. of Moldova,MDA,Greece,GRC,0,0,16,156,172
2005,Morocco,MAR,Greece,GRC,0,0,10,5,15
2005,Myanmar,MMR,Greece,GRC,0,5,251,31,287
2005,Nigeria,NGA,Greece,GRC,0,5,431,150,586
2005,Pakistan,PAK,Greece,GRC,0,0,380,895,1275
2005,Philippines,PHL,Greece,GRC,0,0,10,31,41
2005,Romania,ROU,Greece,GRC,0,0,32,305,337
2005,Russian Federation,RUS,Greece,GRC,0,10,28,337,375
2005,Rwanda,RWA,Greece,GRC,0,0,16,5,21
2005,Senegal,SEN,Greece,GRC,0,0,0,5,5
2005,Sierra Leone,SLE,Greece,GRC,0,0,33,16,49
2005,Somalia,SOM,Greece,GRC,0,0,94,51,145
2005,Sudan,SDN,Greece,GRC,5,5,80,56,146
2005,Syrian Arab Rep.,SYR,Greece,GRC,0,0,38,18,56
2005,United Rep. of Tanzania,TZA,Greece,GRC,0,0,0,5,5
2005,Turkey,TUR,Greece,GRC,0,0,93,27,120
2005,Uganda,UGA,Greece,GRC,0,0,0,5,5
2005,Ukraine,UKR,Greece,GRC,0,0,16,254,270
2005,Uzbekistan,UZB,Greece,GRC,5,5,5,25,40
2005,Unknown ,,Greece,GRC,0,0,148,146,294
2005,Colombia,COL,Guatemala,GTM,0,0,0,5,5
2005,Cuba,CUB,Guatemala,GTM,5,0,0,13,18
2005,Dem. Rep. of the Congo,COD,Guinea,GIN,0,0,0,25,25
2005,Cuba,CUB,Guinea,GIN,0,0,0,5,5
2005,Ghana,GHA,Guinea,GIN,0,0,0,10,10
2005,Cote d'Ivoire,CIV,Guinea,GIN,107,0,16,1188,1311
2005,Liberia,LBR,Guinea,GIN,103,0,42,1236,1381
2005,Nigeria,NGA,Guinea,GIN,0,0,0,10,10
2005,Rwanda,RWA,Guinea,GIN,0,0,0,5,5
2005,Sierra Leone,SLE,Guinea,GIN,84,0,44,2073,2201
2005,Togo,TGO,Guinea,GIN,0,0,5,22,27
2005,Uganda,UGA,Guinea,GIN,5,0,0,0,5
2005,Colombia,COL,Honduras,HND,0,0,0,5,5
2005,Cuba,CUB,Honduras,HND,10,0,0,50,60
2005,Ethiopia,ETH,Honduras,HND,0,0,0,10,10
2005,Albania,ALB,Croatia,HRV,0,0,5,5,10
2005,Bangladesh,BGD,Croatia,HRV,0,0,13,26,39
2005,Bosnia and Herzegovina,BIH,Croatia,HRV,0,0,5,0,5
2005,Ethiopia,ETH,Croatia,HRV,0,0,5,0,5
2005,Palestinian,PSE,Croatia,HRV,0,0,5,0,5
2005,Georgia,GEO,Croatia,HRV,0,0,5,0,5
2005,India,IND,Croatia,HRV,0,0,0,19,19
2005,Sri Lanka,LKA,Croatia,HRV,0,0,0,5,5
2005,North Macedonia,MKD,Croatia,HRV,0,0,10,5,15
2005,Rep. of Moldova,MDA,Croatia,HRV,0,0,5,5,10
2005,Pakistan,PAK,Croatia,HRV,0,0,5,5,10
2005,Romania,ROU,Croatia,HRV,0,0,5,5,10
2005,Russian Federation,RUS,Croatia,HRV,0,0,10,0,10
2005,Serbia and Kosovo: S/RES/1244 (1999),SRB,Croatia,HRV,0,0,28,5,33
2005,Turkey,TUR,Croatia,HRV,0,0,5,0,5
2005,Uzbekistan,UZB,Croatia,HRV,0,0,5,0,5
2005,Unknown ,,Croatia,HRV,0,0,5,0,5
2005,Afghanistan,AFG,Hungary,HUN,5,10,0,0,15
2005,Algeria,DZA,Hungary,HUN,0,0,5,5,10
2005,Egypt,EGY,Hungary,HUN,0,0,5,0,5
2005,Armenia,ARM,Hungary,HUN,0,0,5,0,5
2005,Bangladesh,BGD,Hungary,HUN,0,0,15,83,98
2005,Belarus,BLR,Hungary,HUN,0,0,5,5,10
2005,China,CHN,Hungary,HUN,0,0,118,17,135
2005,Cameroon,CMR,Hungary,HUN,0,5,5,0,10
2005,Palestinian,PSE,Hungary,HUN,0,0,10,17,27
2005,Georgia,GEO,Hungary,HUN,5,5,25,129,164
2005,India,IND,Hungary,HUN,0,0,17,25,42
2005,Iran (Islamic Rep. of),IRN,Hungary,HUN,10,5,5,10,30
2005,Iraq,IRQ,Hungary,HUN,5,5,0,10,20
2005,Liberia,LBR,Hungary,HUN,0,0,10,0,10
2005,North Macedonia,MKD,Hungary,HUN,0,0,5,10,15
2005,Rep. of Moldova,MDA,Hungary,HUN,0,0,10,13,23
2005,Mongolia,MNG,Hungary,HUN,0,0,5,5,10
2005,Nepal,NPL,Hungary,HUN,0,5,0,0,5
2005,Nigeria,NGA,Hungary,HUN,5,5,48,16,74
2005,Pakistan,PAK,Hungary,HUN,12,11,16,12,51
2005,Romania,ROU,Hungary,HUN,0,0,16,10,26
2005,Russian Federation,RUS,Hungary,HUN,0,5,14,22,41
2005,Serbia and Kosovo: S/RES/1244 (1999),SRB,Hungary,HUN,5,18,82,126,231
2005,Sierra Leone,SLE,Hungary,HUN,0,0,5,0,5
2005,Somalia,SOM,Hungary,HUN,10,0,0,0,10
2005,Viet Nam,VNM,Hungary,HUN,0,0,256,11,267
2005,Sudan,SDN,Hungary,HUN,5,5,0,0,10
2005,Slovakia,SVK,Hungary,HUN,0,0,25,0,25
2005,Syrian Arab Rep.,SYR,Hungary,HUN,0,0,5,5,10
2005,Tunisia,TUN,Hungary,HUN,0,0,5,0,5
2005,Turkey,TUR,Hungary,HUN,5,5,19,36,65
2005,Ukraine,UKR,Hungary,HUN,0,0,5,26,31
2005,Stateless,XXA,Hungary,HUN,12,0,0,5,17
2005,Afghanistan,AFG,Iceland,ISL,0,0,5,0,5
2005,Albania,ALB,Iceland,ISL,0,0,5,0,5
2005,Algeria,DZA,Iceland,ISL,0,0,5,0,5
2005,Bulgaria,BGR,Iceland,ISL,0,0,5,0,5
2005,Georgia,GEO,Iceland,ISL,0,0,5,0,5
2005,Iran (Islamic Rep. of),IRN,Iceland,ISL,0,0,5,0,5
2005,Kazakhstan,KAZ,Iceland,ISL,0,0,5,0,5
2005,Rep. of Moldova,MDA,Iceland,ISL,0,0,5,0,5
2005,Romania,ROU,Iceland,ISL,0,0,22,0,22
2005,Russian Federation,RUS,Iceland,ISL,0,0,5,0,5
2005,Central African Rep.,CAF,Cote d'Ivoire,CIV,0,0,14,0,14
2005,Chad,TCD,Cote d'Ivoire,CIV,0,0,5,0,5
2005,Cameroon,CMR,Cote d'Ivoire,CIV,0,0,5,0,5
2005,Congo,COG,Cote d'Ivoire,CIV,23,0,57,0,80
2005,Dem. Rep. of the Congo,COD,Cote d'Ivoire,CIV,20,0,90,0,110
2005,Rwanda,RWA,Cote d'Ivoire,CIV,10,0,5,0,15
2005,Sierra Leone,SLE,Cote d'Ivoire,CIV,0,0,31,0,31
2005,Sudan,SDN,Cote d'Ivoire,CIV,0,0,5,0,5
2005,Togo,TGO,Cote d'Ivoire,CIV,5,0,31,0,36
2005,Afghanistan,AFG,Ireland,IRL,10,0,129,12,151
2005,Albania,ALB,Ireland,IRL,0,0,70,5,75
2005,Algeria,DZA,Ireland,IRL,0,0,45,15,60
2005,Angola,AGO,Ireland,IRL,10,0,90,0,100
2005,Egypt,EGY,Ireland,IRL,0,0,5,0,5
2005,Armenia,ARM,Ireland,IRL,5,0,11,0,16
2005,Azerbaijan,AZE,Ireland,IRL,0,0,12,0,12
2005,Burundi,BDI,Ireland,IRL,5,0,28,0,33
2005,Benin,BEN,Ireland,IRL,0,0,5,5,10
2005,Bangladesh,BGD,Ireland,IRL,5,0,21,0,26
2005,Bhutan,BTN,Ireland,IRL,0,0,5,0,5
2005,Belarus,BLR,Ireland,IRL,0,0,17,10,27
2005,Brazil,BRA,Ireland,IRL,0,0,5,5,10
2005,Chad,TCD,Ireland,IRL,5,0,0,0,5
2005,China,CHN,Ireland,IRL,18,0,40,40,98
2005,Cameroon,CMR,Ireland,IRL,5,0,84,5,94
2005,Congo,COG,Ireland,IRL,0,0,25,0,25
2005,Dem. Rep. of the Congo,COD,Ireland,IRL,5,0,214,15,234
2005,Czechia,CZE,Ireland,IRL,0,0,0,5,5
2005,Eritrea,ERI,Ireland,IRL,14,0,20,5,39
2005,Ethiopia,ETH,Ireland,IRL,10,0,23,0,33
2005,Gambia,GMB,Ireland,IRL,0,0,5,0,5
2005,Palestinian,PSE,Ireland,IRL,0,0,23,10,33
2005,United Kingdom of Great Britain and Northern Ireland,GBR,Ireland,IRL,0,0,0,5,5
2005,Georgia,GEO,Ireland,IRL,10,0,150,37,197
2005,Ghana,GHA,Ireland,IRL,0,0,69,5,74
2005,Guinea,GIN,Ireland,IRL,16,0,29,5,50
2005,Croatia,HRV,Ireland,IRL,5,0,113,12,130
2005,Cote d'Ivoire,CIV,Ireland,IRL,5,0,26,0,31
2005,India,IND,Ireland,IRL,0,0,10,5,15
2005,Iran (Islamic Rep. of),IRN,Ireland,IRL,19,0,69,23,111
2005,Iraq,IRQ,Ireland,IRL,10,0,34,10,54
2005,Israel,ISR,Ireland,IRL,5,0,0,5,10
2005,Jamaica,JAM,Ireland,IRL,0,0,5,5,10
2005,Kazakhstan,KAZ,Ireland,IRL,0,0,14,0,14
2005,Kenya,KEN,Ireland,IRL,10,0,66,5,81
2005,Kyrgyzstan,KGZ,Ireland,IRL,0,0,10,0,10
2005,Kuwait,KWT,Ireland,IRL,10,0,11,0,21
2005,Liberia,LBR,Ireland,IRL,0,0,48,5,53
2005,Libya,LBY,Ireland,IRL,0,0,5,5,10
2005,Lebanon,LBN,Ireland,IRL,0,0,5,0,5
2005,Sri Lanka,LKA,Ireland,IRL,5,0,5,0,10
2005,North Macedonia,MKD,Ireland,IRL,0,0,5,0,5
2005,Rep. of Moldova,MDA,Ireland,IRL,0,0,82,54,136
2005,Malawi,MWI,Ireland,IRL,0,0,5,0,5
2005,Mongolia,MNG,Ireland,IRL,0,0,5,0,5
2005,Morocco,MAR,Ireland,IRL,0,0,13,5,18
2005,Mauritius,MUS,Ireland,IRL,0,0,5,0,5
2005,Myanmar,MMR,Ireland,IRL,0,0,5,0,5
2005,Nepal,NPL,Ireland,IRL,0,0,17,0,17
2005,Niger,NER,Ireland,IRL,0,0,5,0,5
2005,Nigeria,NGA,Ireland,IRL,10,0,1290,173,1473
2005,Pakistan,PAK,Ireland,IRL,5,0,54,11,70
2005,Romania,ROU,Ireland,IRL,0,0,204,182,386
2005,South Africa,ZAF,Ireland,IRL,0,0,43,5,48
2005,Russian Federation,RUS,Ireland,IRL,5,0,67,15,87
2005,Rwanda,RWA,Ireland,IRL,21,0,13,0,34
2005,Serbia and Kosovo: S/RES/1244 (1999),SRB,Ireland,IRL,5,0,38,11,54
2005,Sierra Leone,SLE,Ireland,IRL,0,0,23,5,28
2005,Somalia,SOM,Ireland,IRL,86,0,188,24,298
2005,Sudan,SDN,Ireland,IRL,77,0,72,30,179
2005,Syrian Arab Rep.,SYR,Ireland,IRL,5,0,14,10,29
2005,Togo,TGO,Ireland,IRL,0,0,45,0,45
2005,Turkey,TUR,Ireland,IRL,0,0,10,0,10
2005,Uganda,UGA,Ireland,IRL,5,0,27,5,37
2005,Ukraine,UKR,Ireland,IRL,0,0,82,19,101
2005,Uzbekistan,UZB,Ireland,IRL,5,0,10,0,15
2005,Yemen,YEM,Ireland,IRL,0,0,5,0,5
2005,Zimbabwe,ZWE,Ireland,IRL,19,0,64,10,93
2005,Stateless,XXA,Ireland,IRL,10,0,5,0,15
2005,Bangladesh,BGD,Japan,JPN,0,0,28,5,33
2005,China,CHN,Japan,JPN,0,0,10,0,10
2005,Cameroon,CMR,Japan,JPN,0,0,5,0,5
2005,Guinea-Bissau,GNB,Japan,JPN,0,0,5,0,5
2005,India,IND,Japan,JPN,0,0,5,0,5
2005,Iran (Islamic Rep. of),IRN,Japan,JPN,0,0,5,5,10
2005,Sri Lanka,LKA,Japan,JPN,0,0,10,0,10
2005,Myanmar,MMR,Japan,JPN,27,14,118,10,169
2005,Nepal,NPL,Japan,JPN,0,0,5,0,5
2005,Pakistan,PAK,Japan,JPN,0,0,5,0,5
2005,Turkey,TUR,Japan,JPN,0,0,27,5,32
2005,Unknown ,,Japan,JPN,0,5,14,5,24
2005,Afghanistan,AFG,Kazakhstan,KAZ,73,0,5,0,78
2005,Afghanistan,AFG,Kyrgyzstan,KGZ,23,0,57,37,117
2005,Kazakhstan,KAZ,Kyrgyzstan,KGZ,0,0,5,0,5
2005,Russian Federation,RUS,Kyrgyzstan,KGZ,0,0,0,28,28
2005,Uzbekistan,UZB,Kyrgyzstan,KGZ,0,0,5,493,498
2005,Belarus,BLR,Liechtenstein,LIE,0,0,5,0,5
2005,Israel,ISR,Liechtenstein,LIE,0,0,5,0,5
2005,Kazakhstan,KAZ,Liechtenstein,LIE,0,0,5,0,5
2005,Mongolia,MNG,Liechtenstein,LIE,0,0,5,0,5
2005,Russian Federation,RUS,Liechtenstein,LIE,0,0,5,5,10
2005,Serbia and Kosovo: S/RES/1244 (1999),SRB,Liechtenstein,LIE,0,0,11,0,11
2005,Somalia,SOM,Liechtenstein,LIE,0,0,0,5,5
2005,Ukraine,UKR,Liechtenstein,LIE,0,0,5,0,5
2005,Georgia,GEO,Lithuania,LTU,0,0,0,5,5
2005,Iraq,IRQ,Lithuania,LTU,0,0,0,5,5
2005,Russian Federation,RUS,Lithuania,LTU,15,41,10,0,66
2005,Unknown ,,Luxembourg,LUX,97,574,517,294,1482
2005,Serbia and Kosovo: S/RES/1244 (1999),SRB,North Macedonia,MKD,10,313,130,126,579
2005,Bangladesh,BGD,Mexico,MEX,0,0,5,5,10
2005,Dem. Rep. of the Congo,COD,Mexico,MEX,0,0,5,0,5
2005,Colombia,COL,Mexico,MEX,11,0,10,18,39
2005,Cuba,CUB,Mexico,MEX,0,0,5,60,65
2005,Eritrea,ERI,Mexico,MEX,52,0,12,76,140
2005,Ethiopia,ETH,Mexico,MEX,17,0,10,92,119
2005,Guatemala,GTM,Mexico,MEX,5,0,23,5,33
2005,Guyana,GUY,Mexico,MEX,0,0,0,5,5
2005,Haiti,HTI,Mexico,MEX,13,0,11,0,24
2005,Honduras,HND,Mexico,MEX,0,0,48,17,65
2005,India,IND,Mexico,MEX,0,0,0,21,21
2005,Iraq,IRQ,Mexico,MEX,0,0,5,5,10
2005,Liberia,LBR,Mexico,MEX,0,0,5,0,5
2005,Sri Lanka,LKA,Mexico,MEX,0,0,0,10,10
2005,Myanmar,MMR,Mexico,MEX,5,0,0,0,5
2005,Nepal,NPL,Mexico,MEX,0,0,0,5,5
2005,Nicaragua,NIC,Mexico,MEX,0,0,10,5,15
2005,Romania,ROU,Mexico,MEX,0,0,0,5,5
2005,El Salvador,SLV,Mexico,MEX,0,0,27,12,39
2005,Somalia,SOM,Mexico,MEX,14,0,5,5,24
2005,Central African Rep.,CAF,Mali,MLI,0,0,5,0,5
2005,Congo,COG,Mali,MLI,0,0,10,0,10
2005,Dem. Rep. of the Congo,COD,Mali,MLI,10,0,25,0,35
2005,Cote d'Ivoire,CIV,Mali,MLI,12,0,110,0,122
2005,Liberia,LBR,Mali,MLI,0,0,18,0,18
2005,Mauritania,MRT,Mali,MLI,0,0,10,0,10
2005,Nigeria,NGA,Mali,MLI,0,0,10,0,10
2005,Togo,TGO,Mali,MLI,0,0,10,0,10
2005,Burundi,BDI,Malawi,MWI,397,0,0,16,413
2005,Dem. Rep. of the Congo,COD,Malawi,MWI,356,0,0,25,381
2005,Eritrea,ERI,Malawi,MWI,0,0,0,146,146
2005,Ethiopia,ETH,Malawi,MWI,0,0,0,362,362
2005,Rwanda,RWA,Malawi,MWI,0,0,0,24,24
2005,Somalia,SOM,Malawi,MWI,0,0,13,376,389
2005,Algeria,DZA,Malta,MLT,0,0,5,5,10
2005,Egypt,EGY,Malta,MLT,0,0,5,0,5
2005,Burkina Faso,BFA,Malta,MLT,0,0,10,0,10
2005,Chad,TCD,Malta,MLT,0,0,10,0,10
2005,Dem. Rep. of the Congo,COD,Malta,MLT,0,0,56,5,61
2005,Comoros,COM,Malta,MLT,0,0,0,5,5
2005,Eritrea,ERI,Malta,MLT,0,228,41,0,269
2005,Ethiopia,ETH,Malta,MLT,0,0,16,0,16
2005,Palestinian,PSE,Malta,MLT,15,0,36,11,62
2005,Ghana,GHA,Malta,MLT,0,0,14,0,14
2005,Cote d'Ivoire,CIV,Malta,MLT,0,0,87,0,87
2005,India,IND,Malta,MLT,0,0,5,0,5
2005,Iraq,IRQ,Malta,MLT,5,5,16,0,26
2005,Liberia,LBR,Malta,MLT,0,0,24,0,24
2005,Libya,LBY,Malta,MLT,0,0,10,0,10
2005,Nigeria,NGA,Malta,MLT,0,0,29,0,29
2005,Pakistan,PAK,Malta,MLT,0,0,16,5,21
2005,Russian Federation,RUS,Malta,MLT,0,0,0,5,5
2005,Serbia and Kosovo: S/RES/1244 (1999),SRB,Malta,MLT,0,0,5,0,5
2005,Somalia,SOM,Malta,MLT,0,223,16,5,244
2005,Sudan,SDN,Malta,MLT,0,21,148,5,174
2005,Syrian Arab Rep.,SYR,Malta,MLT,5,0,5,0,10
2005,Togo,TGO,Malta,MLT,0,0,5,0,5
2005,Turkey,TUR,Malta,MLT,0,0,10,5,15
2005,Burundi,BDI,Namibia,NAM,32,0,63,115,210
2005,Dem. Rep. of the Congo,COD,Namibia,NAM,287,0,89,360,736
2005,Ethiopia,ETH,Namibia,NAM,0,0,0,5,5
2005,Liberia,LBR,Namibia,NAM,0,0,13,22,35
2005,Rwanda,RWA,Namibia,NAM,5,0,160,38,203
2005,Sierra Leone,SLE,Namibia,NAM,0,0,5,0,5
2005,Somalia,SOM,Namibia,NAM,0,0,0,5,5
2005,Bhutan,BTN,Nepal,NPL,0,52,20,5,77
2005,Afghanistan,AFG,Netherlands,NLD,83,657,706,150,1596
2005,Albania,ALB,Netherlands,NLD,0,0,28,15,43
2005,Algeria,DZA,Netherlands,NLD,0,5,36,20,61
2005,Angola,AGO,Netherlands,NLD,5,153,309,109,576
2005,Egypt,EGY,Netherlands,NLD,0,5,25,5,35
2005,Armenia,ARM,Netherlands,NLD,35,173,200,47,455
2005,Azerbaijan,AZE,Netherlands,NLD,99,317,265,73,754
2005,Burundi,BDI,Netherlands,NLD,5,387,143,44,579
2005,Benin,BEN,Netherlands,NLD,0,0,14,5,19
2005,Bangladesh,BGD,Netherlands,NLD,0,0,25,5,30
2005,Bhutan,BTN,Netherlands,NLD,0,10,0,0,10
2005,Belarus,BLR,Netherlands,NLD,10,12,23,5,50
2005,Bosnia and Herzegovina,BIH,Netherlands,NLD,5,61,67,33,166
2005,Bulgaria,BGR,Netherlands,NLD,0,0,5,0,5
2005,Chad,TCD,Netherlands,NLD,0,5,0,5,10
2005,China,CHN,Netherlands,NLD,26,30,225,124,405
2005,Cameroon,CMR,Netherlands,NLD,13,23,61,11,108
2005,Congo,COG,Netherlands,NLD,10,105,96,25,236
2005,Dem. Rep. of the Congo,COD,Netherlands,NLD,25,129,114,36,304
2005,Colombia,COL,Netherlands,NLD,27,111,65,39,242
2005,Cuba,CUB,Netherlands,NLD,0,0,10,5,15
2005,Czechia,CZE,Netherlands,NLD,0,0,10,0,10
2005,Djibouti,DJI,Netherlands,NLD,0,5,5,0,10
2005,Ecuador,ECU,Netherlands,NLD,0,0,5,0,5
2005,Eritrea,ERI,Netherlands,NLD,11,145,105,39,300
2005,Ethiopia,ETH,Netherlands,NLD,5,33,53,15,106
2005,Gabon,GAB,Netherlands,NLD,0,5,0,0,5
2005,Gambia,GMB,Netherlands,NLD,0,0,18,0,18
2005,Palestinian,PSE,Netherlands,NLD,0,0,5,5,10
2005,Georgia,GEO,Netherlands,NLD,5,17,214,34,270
2005,Ghana,GHA,Netherlands,NLD,0,0,15,5,20
2005,Guinea-Bissau,GNB,Netherlands,NLD,0,0,5,0,5
2005,Guinea,GIN,Netherlands,NLD,5,50,128,37,220
2005,Croatia,HRV,Netherlands,NLD,0,5,12,0,17
2005,Hungary,HUN,Netherlands,NLD,0,0,5,0,5
2005,Cote d'Ivoire,CIV,Netherlands,NLD,0,36,23,13,72
2005,India,IND,Netherlands,NLD,0,0,102,87,189
2005,Indonesia,IDN,Netherlands,NLD,0,0,10,0,10
2005,Iran (Islamic Rep. of),IRN,Netherlands,NLD,72,220,416,96,804
2005,Iraq,IRQ,Netherlands,NLD,47,1852,865,502,3266
2005,Israel,ISR,Netherlands,NLD,0,0,10,10,20
2005,Kazakhstan,KAZ,Netherlands,NLD,5,17,22,5,49
2005,Kenya,KEN,Netherlands,NLD,0,0,5,0,5
2005,Kyrgyzstan,KGZ,Netherlands,NLD,10,12,20,5,47
2005,Dem. People's Rep. of Korea,PRK,Netherlands,NLD,0,0,5,0,5
2005,Liberia,LBR,Netherlands,NLD,12,140,258,49,459
2005,Libya,LBY,Netherlands,NLD,5,17,37,10,69
2005,Lebanon,LBN,Netherlands,NLD,0,5,14,10,29
2005,Sri Lanka,LKA,Netherlands,NLD,5,16,75,16,112
2005,Mauritania,MRT,Netherlands,NLD,0,5,5,5,15
2005,North Macedonia,MKD,Netherlands,NLD,0,0,21,0,21
2005,Rep. of Moldova,MDA,Netherlands,NLD,0,0,11,10,21
2005,Mali,MLI,Netherlands,NLD,0,0,5,0,5
2005,Mongolia,MNG,Netherlands,NLD,0,5,89,25,119
2005,Morocco,MAR,Netherlands,NLD,0,0,21,5,26
2005,Myanmar,MMR,Netherlands,NLD,0,5,21,0,26
2005,Nepal,NPL,Netherlands,NLD,15,12,127,35,189
2005,Niger,NER,Netherlands,NLD,0,5,24,5,34
2005,Nigeria,NGA,Netherlands,NLD,0,28,147,34,209
2005,Pakistan,PAK,Netherlands,NLD,15,15,58,10,98
2005,Philippines,PHL,Netherlands,NLD,5,5,5,5,20
2005,Poland,POL,Netherlands,NLD,0,0,5,0,5
2005,Romania,ROU,Netherlands,NLD,5,0,17,5,27
2005,Russian Federation,RUS,Netherlands,NLD,54,160,236,78,528
2005,Rwanda,RWA,Netherlands,NLD,30,75,33,15,153
2005,Saudi Arabia,SAU,Netherlands,NLD,0,10,0,0,10
2005,Serbia and Kosovo: S/RES/1244 (1999),SRB,Netherlands,NLD,10,74,267,71,422
2005,Sierra Leone,SLE,Netherlands,NLD,5,139,209,64,417
2005,Somalia,SOM,Netherlands,NLD,60,1221,328,157,1766
2005,Viet Nam,VNM,Netherlands,NLD,0,5,10,5,20
2005,Sudan,SDN,Netherlands,NLD,49,269,230,77,625
2005,Suriname,SUR,Netherlands,NLD,0,0,5,0,5
2005,Slovakia,SVK,Netherlands,NLD,0,0,20,14,34
2005,Syrian Arab Rep.,SYR,Netherlands,NLD,61,139,167,67,434
2005,United Rep. of Tanzania,TZA,Netherlands,NLD,0,0,5,0,5
2005,Tajikistan,TJK,Netherlands,NLD,0,5,11,0,16
2005,Togo,TGO,Netherlands,NLD,5,28,56,11,100
2005,Tunisia,TUN,Netherlands,NLD,5,10,10,0,25
2005,Turkey,TUR,Netherlands,NLD,17,99,238,94,448
2005,Uganda,UGA,Netherlands,NLD,0,13,17,5,35
2005,Ukraine,UKR,Netherlands,NLD,5,5,37,10,57
2005,United States of America,USA,Netherlands,NLD,0,0,5,5,10
2005,Uzbekistan,UZB,Netherlands,NLD,14,18,33,10,75
2005,Yemen,YEM,Netherlands,NLD,0,5,5,5,15
2005,Zimbabwe,ZWE,Netherlands,NLD,0,0,5,0,5
2005,Stateless,XXA,Netherlands,NLD,17,69,159,57,302
2005,Unknown ,,Netherlands,NLD,50,656,565,245,1516
2005,Dem. Rep. of the Congo,COD,Niger,NER,0,0,5,0,5
2005,Colombia,COL,Nicaragua,NIC,5,0,0,0,5
2005,Cuba,CUB,Nicaragua,NIC,5,0,0,0,5
2005,Cameroon,CMR,Nigeria,NGA,10,0,5,0,15
2005,Dem. Rep. of the Congo,COD,Nigeria,NGA,515,0,114,0,629
2005,Guinea-Bissau,GNB,Nigeria,NGA,5,0,0,0,5
2005,Guinea,GIN,Nigeria,NGA,12,0,0,0,12
2005,Cote d'Ivoire,CIV,Nigeria,NGA,24,0,0,0,24
2005,Liberia,LBR,Nigeria,NGA,609,0,16,300,925
2005,Sierra Leone,SLE,Nigeria,NGA,193,0,17,23,233
2005,Sudan,SDN,Nigeria,NGA,27,0,0,0,27
2005,Togo,TGO,Nigeria,NGA,5,0,5,0,10
2005,Afghanistan,AFG,Norway,NOR,16,347,343,153,859
2005,Albania,ALB,Norway,NOR,0,5,55,36,96
2005,Algeria,DZA,Norway,NOR,0,0,26,35,61
2005,Angola,AGO,Norway,NOR,0,16,23,5,44
2005,Egypt,EGY,Norway,NOR,0,0,13,5,18
2005,Armenia,ARM,Norway,NOR,0,0,0,11,11
2005,Azerbaijan,AZE,Norway,NOR,0,5,39,52,96
2005,Burundi,BDI,Norway,NOR,38,123,40,13,214
2005,Bangladesh,BGD,Norway,NOR,0,0,10,15,25
2005,Bhutan,BTN,Norway,NOR,0,0,5,5,10
2005,Belarus,BLR,Norway,NOR,0,0,20,17,37
2005,Bosnia and Herzegovina,BIH,Norway,NOR,0,0,38,44,82
2005,Bulgaria,BGR,Norway,NOR,0,0,21,5,26
2005,China,CHN,Norway,NOR,29,24,5,5,63
2005,Chile,CHL,Norway,NOR,0,0,5,0,5
2005,Cameroon,CMR,Norway,NOR,0,0,51,5,56
2005,Congo,COG,Norway,NOR,0,5,5,5,15
2005,Dem. Rep. of the Congo,COD,Norway,NOR,5,64,12,14,95
2005,Colombia,COL,Norway,NOR,0,5,0,0,5
2005,Cuba,CUB,Norway,NOR,0,0,5,0,5
2005,Eritrea,ERI,Norway,NOR,73,81,5,28,187
2005,Ethiopia,ETH,Norway,NOR,33,11,34,11,89
2005,Georgia,GEO,Norway,NOR,0,0,10,14,24
2005,Ghana,GHA,Norway,NOR,0,0,0,5,5
2005,Guinea,GIN,Norway,NOR,0,0,5,5,10
2005,Croatia,HRV,Norway,NOR,0,0,17,5,22
2005,Hungary,HUN,Norway,NOR,0,0,5,0,5
2005,Cote d'Ivoire,CIV,Norway,NOR,0,5,0,0,5
2005,India,IND,Norway,NOR,0,0,10,0,10
2005,Iran (Islamic Rep. of),IRN,Norway,NOR,39,20,227,99,385
2005,Iraq,IRQ,Norway,NOR,32,287,555,294,1168
2005,Israel,ISR,Norway,NOR,0,0,12,5,17
2005,Jordan,JOR,Norway,NOR,0,0,5,5,10
2005,Kazakhstan,KAZ,Norway,NOR,0,0,13,10,23
2005,Kyrgyzstan,KGZ,Norway,NOR,0,0,12,15,27
2005,Rep. of Korea,KOR,Norway,NOR,0,0,0,5,5
2005,Kuwait,KWT,Norway,NOR,0,0,0,5,5
2005,Liberia,LBR,Norway,NOR,0,15,28,14,57
2005,Libya,LBY,Norway,NOR,0,0,28,35,63
2005,Lebanon,LBN,Norway,NOR,0,10,15,12,37
2005,Sri Lanka,LKA,Norway,NOR,10,23,29,19,81
2005,Lithuania,LTU,Norway,NOR,0,0,5,0,5
2005,Latvia,LVA,Norway,NOR,0,0,5,0,5
2005,Madagascar,MDG,Norway,NOR,0,0,0,5,5
2005,North Macedonia,MKD,Norway,NOR,0,0,13,10,23
2005,Rep. of Moldova,MDA,Norway,NOR,0,0,10,10,20
2005,Mongolia,MNG,Norway,NOR,0,0,5,5,10
2005,Morocco,MAR,Norway,NOR,0,0,12,5,17
2005,Malta,MLT,Norway,NOR,0,0,0,5,5
2005,Myanmar,MMR,Norway,NOR,5,5,5,10,25
2005,Nepal,NPL,Norway,NOR,0,0,32,15,47
2005,Niger,NER,Norway,NOR,0,0,5,5,10
2005,Nigeria,NGA,Norway,NOR,0,5,81,52,138
2005,Pakistan,PAK,Norway,NOR,5,0,24,13,42
2005,Poland,POL,Norway,NOR,0,0,5,0,5
2005,Romania,ROU,Norway,NOR,0,0,11,0,11
2005,Russian Federation,RUS,Norway,NOR,28,409,136,191,764
2005,Rwanda,RWA,Norway,NOR,13,23,30,10,76
2005,Serbia and Kosovo: S/RES/1244 (1999),SRB,Norway,NOR,39,10,316,258,623
2005,Sierra Leone,SLE,Norway,NOR,0,0,10,14,24
2005,Somalia,SOM,Norway,NOR,98,331,208,138,775
2005,Viet Nam,VNM,Norway,NOR,0,0,5,12,17
2005,Sudan,SDN,Norway,NOR,12,5,22,11,50
2005,Syrian Arab Rep.,SYR,Norway,NOR,5,10,34,32,81
2005,United Rep. of Tanzania,TZA,Norway,NOR,0,0,5,0,5
2005,Tajikistan,TJK,Norway,NOR,0,0,5,0,5
2005,Togo,TGO,Norway,NOR,0,0,5,0,5
2005,Tunisia,TUN,Norway,NOR,0,0,5,0,5
2005,Turkey,TUR,Norway,NOR,5,5,47,53,110
2005,Uganda,UGA,Norway,NOR,5,0,5,0,10
2005,Ukraine,UKR,Norway,NOR,0,0,13,5,18
2005,Uzbekistan,UZB,Norway,NOR,5,0,16,19,40
2005,Western Sahara,ESH,Norway,NOR,0,0,14,5,19
2005,Yemen,YEM,Norway,NOR,5,0,5,0,10
2005,Stateless,XXA,Norway,NOR,52,45,98,100,295
2005,Bangladesh,BGD,New Zealand,NZL,0,0,26,0,26
2005,Bulgaria,BGR,New Zealand,NZL,0,0,5,0,5
2005,China,CHN,New Zealand,NZL,5,0,27,0,32
2005,Chile,CHL,New Zealand,NZL,0,0,25,0,25
2005,Dem. Rep. of the Congo,COD,New Zealand,NZL,0,0,5,0,5
2005,Czechia,CZE,New Zealand,NZL,5,0,22,0,27
2005,Ethiopia,ETH,New Zealand,NZL,0,0,5,0,5
2005,Fiji,FJI,New Zealand,NZL,0,0,11,0,11
2005,Hungary,HUN,New Zealand,NZL,0,0,5,0,5
2005,India,IND,New Zealand,NZL,0,0,46,0,46
2005,Iran (Islamic Rep. of),IRN,New Zealand,NZL,20,0,46,0,66
2005,Iraq,IRQ,New Zealand,NZL,10,0,14,0,24
2005,Israel,ISR,New Zealand,NZL,0,0,5,0,5
2005,Jordan,JOR,New Zealand,NZL,5,0,5,0,10
2005,Sri Lanka,LKA,New Zealand,NZL,5,0,12,0,17
2005,Malaysia,MYS,New Zealand,NZL,0,0,10,0,10
2005,Myanmar,MMR,New Zealand,NZL,5,0,5,0,10
2005,Nepal,NPL,New Zealand,NZL,0,0,13,0,13
2005,Nigeria,NGA,New Zealand,NZL,0,0,5,0,5
2005,Pakistan,PAK,New Zealand,NZL,0,0,10,0,10
2005,Peru,PER,New Zealand,NZL,0,0,5,0,5
2005,South Africa,ZAF,New Zealand,NZL,0,0,5,0,5
2005,Russian Federation,RUS,New Zealand,NZL,0,0,5,0,5
2005,El Salvador,SLV,New Zealand,NZL,0,0,5,0,5
2005,Singapore,SGP,New Zealand,NZL,0,0,5,0,5
2005,Somalia,SOM,New Zealand,NZL,5,0,5,0,10
2005,Viet Nam,VNM,New Zealand,NZL,0,0,5,0,5
2005,Sudan,SDN,New Zealand,NZL,0,0,5,0,5
2005,Syrian Arab Rep.,SYR,New Zealand,NZL,10,0,5,0,15
2005,Zimbabwe,ZWE,New Zealand,NZL,5,0,0,0,5
2005,Cuba,CUB,Paraguay,PRY,5,0,0,0,5
2005,Colombia,COL,Peru,PER,52,0,21,5,78
2005,Cuba,CUB,Peru,PER,26,0,0,0,26
2005,Iraq,IRQ,Peru,PER,0,0,0,5,5
2005,Afghanistan,AFG,Poland,POL,5,12,13,0,30
2005,Algeria,DZA,Poland,POL,0,0,5,0,5
2005,Egypt,EGY,Poland,POL,0,0,5,0,5
2005,Armenia,ARM,Poland,POL,0,5,22,14,41
2005,Azerbaijan,AZE,Poland,POL,0,5,5,0,10
2005,Belarus,BLR,Poland,POL,10,5,31,16,62
2005,Bosnia and Herzegovina,BIH,Poland,POL,0,0,0,10,10
2005,Bulgaria,BGR,Poland,POL,0,0,12,5,17
2005,China,CHN,Poland,POL,0,0,5,5,10
2005,Cameroon,CMR,Poland,POL,0,0,5,0,5
2005,Congo,COG,Poland,POL,0,5,5,0,10
2005,Palestinian,PSE,Poland,POL,0,0,0,5,5
2005,Georgia,GEO,Poland,POL,0,0,46,15,61
2005,Guinea,GIN,Poland,POL,0,0,10,0,10
2005,India,IND,Poland,POL,0,0,18,23,41
2005,Iran (Islamic Rep. of),IRN,Poland,POL,5,0,5,0,10
2005,Iraq,IRQ,Poland,POL,0,0,5,10,15
2005,Kazakhstan,KAZ,Poland,POL,0,0,24,18,42
2005,Kyrgyzstan,KGZ,Poland,POL,0,0,14,5,19
2005,Lebanon,LBN,Poland,POL,0,0,0,5,5
2005,Rep. of Moldova,MDA,Poland,POL,0,0,15,11,26
2005,Nepal,NPL,Poland,POL,0,0,5,0,5
2005,Nigeria,NGA,Poland,POL,0,0,10,0,10
2005,Pakistan,PAK,Poland,POL,0,0,61,32,93
2005,Romania,ROU,Poland,POL,0,0,5,0,5
2005,Russian Federation,RUS,Poland,POL,285,1767,1862,4158,8072
2005,Serbia and Kosovo: S/RES/1244 (1999),SRB,Poland,POL,0,0,0,18,18
2005,Somalia,SOM,Poland,POL,5,10,0,5,20
2005,Viet Nam,VNM,Poland,POL,0,0,16,0,16
2005,Syrian Arab Rep.,SYR,Poland,POL,0,0,5,0,5
2005,Togo,TGO,Poland,POL,0,0,5,0,5
2005,Turkey,TUR,Poland,POL,0,5,0,5,10
2005,Ukraine,UKR,Poland,POL,0,0,52,46,98
2005,Uzbekistan,UZB,Poland,POL,0,0,5,0,5
2005,Stateless,XXA,Poland,POL,0,0,10,5,15
2005,Angola,AGO,Portugal,PRT,0,0,5,0,5
2005,Dem. Rep. of the Congo,COD,Portugal,PRT,0,0,5,0,5
2005,Colombia,COL,Portugal,PRT,0,5,5,0,10
2005,India,IND,Portugal,PRT,0,0,5,0,5
2005,Turkey,TUR,Portugal,PRT,5,0,0,0,5
2005,Afghanistan,AFG,South Africa,ZAF,5,0,0,0,5
2005,Angola,AGO,South Africa,ZAF,11,0,14,32,57
2005,Egypt,EGY,South Africa,ZAF,0,0,5,0,5
2005,Burundi,BDI,South Africa,ZAF,129,0,60,25,214
2005,Bangladesh,BGD,South Africa,ZAF,0,0,35,0,35
2005,Cameroon,CMR,South Africa,ZAF,11,0,10,0,21
2005,Congo,COG,South Africa,ZAF,49,0,32,0,81
2005,Dem. Rep. of the Congo,COD,South Africa,ZAF,1149,0,263,68,1480
2005,Comoros,COM,South Africa,ZAF,0,0,10,0,10
2005,Eritrea,ERI,South Africa,ZAF,18,0,10,0,28
2005,Ethiopia,ETH,South Africa,ZAF,59,0,155,5,219
2005,Ghana,GHA,South Africa,ZAF,5,0,5,0,10
2005,Cote d'Ivoire,CIV,South Africa,ZAF,0,0,5,0,5
2005,India,IND,South Africa,ZAF,0,0,20,0,20
2005,Kenya,KEN,South Africa,ZAF,0,0,23,0,23
2005,Liberia,LBR,South Africa,ZAF,0,0,5,0,5
2005,Malawi,MWI,South Africa,ZAF,5,0,17,0,22
2005,Mozambique,MOZ,South Africa,ZAF,0,0,5,0,5
2005,Nigeria,NGA,South Africa,ZAF,5,0,47,0,52
2005,Pakistan,PAK,South Africa,ZAF,0,0,20,0,20
2005,Rwanda,RWA,South Africa,ZAF,36,0,10,33,79
2005,Somalia,SOM,South Africa,ZAF,447,0,122,17,586
2005,Sudan,SDN,South Africa,ZAF,5,0,0,10,15
2005,United Rep. of Tanzania,TZA,South Africa,ZAF,127,0,63,0,190
2005,Uganda,UGA,South Africa,ZAF,19,0,50,5,74
2005,Zimbabwe,ZWE,South Africa,ZAF,83,0,187,0,270
2005,Unknown ,,South Africa,ZAF,17,0,97,0,114
2005,Afghanistan,AFG,Russian Federation,RUS,11,0,691,0,702
2005,Angola,AGO,Russian Federation,RUS,0,0,5,0,5
2005,China,CHN,Russian Federation,RUS,0,0,5,0,5
2005,Congo,COG,Russian Federation,RUS,0,0,5,0,5
2005,Dem. Rep. of the Congo,COD,Russian Federation,RUS,0,0,5,0,5
2005,Cuba,CUB,Russian Federation,RUS,0,0,5,0,5
2005,Eritrea,ERI,Russian Federation,RUS,0,0,5,0,5
2005,Ethiopia,ETH,Russian Federation,RUS,0,0,16,0,16
2005,Georgia,GEO,Russian Federation,RUS,0,0,32,0,32
2005,Guinea,GIN,Russian Federation,RUS,0,0,5,0,5
2005,Iraq,IRQ,Russian Federation,RUS,5,0,14,0,19
2005,Kazakhstan,KAZ,Russian Federation,RUS,0,0,12,0,12
2005,Kyrgyzstan,KGZ,Russian Federation,RUS,0,0,10,0,10
2005,Nigeria,NGA,Russian Federation,RUS,0,0,5,0,5
2005,Rwanda,RWA,Russian Federation,RUS,5,0,0,0,5
2005,Somalia,SOM,Russian Federation,RUS,0,0,5,0,5
2005,Sudan,SDN,Russian Federation,RUS,0,0,5,0,5
2005,Tajikistan,TJK,Russian Federation,RUS,0,0,5,0,5
2005,Turkmenistan,TKM,Russian Federation,RUS,0,0,12,0,12
2005,Uzbekistan,UZB,Russian Federation,RUS,0,0,89,0,89
2005,Unknown ,,Russian Federation,RUS,0,0,10,0,10
2005,Burundi,BDI,Rwanda,RWA,10,0,0,0,10
2005,Dem. Rep. of the Congo,COD,Rwanda,RWA,12,0,0,0,12
2005,Uganda,UGA,Rwanda,RWA,5,0,0,0,5
2005,Burundi,BDI,Senegal,SEN,0,0,5,0,5
2005,Central African Rep.,CAF,Senegal,SEN,0,0,5,0,5
2005,Chad,TCD,Senegal,SEN,0,0,11,0,11
2005,Congo,COG,Senegal,SEN,0,0,5,0,5
2005,Dem. Rep. of the Congo,COD,Senegal,SEN,0,0,33,0,33
2005,Gambia,GMB,Senegal,SEN,10,0,0,0,10
2005,Guinea,GIN,Senegal,SEN,5,0,17,0,22
2005,Cote d'Ivoire,CIV,Senegal,SEN,15,0,45,0,60
2005,Liberia,LBR,Senegal,SEN,16,0,38,0,54
2005,Sri Lanka,LKA,Senegal,SEN,0,0,5,0,5
2005,Mauritania,MRT,Senegal,SEN,0,0,14,0,14
2005,Nigeria,NGA,Senegal,SEN,0,0,5,0,5
2005,Rwanda,RWA,Senegal,SEN,0,0,5,0,5
2005,Sierra Leone,SLE,Senegal,SEN,0,0,25,0,25
2005,Togo,TGO,Senegal,SEN,0,0,17,0,17
2005,Afghanistan,AFG,Slovakia,SVK,0,0,39,78,117
2005,Armenia,ARM,Slovakia,SVK,0,0,5,13,18
2005,Azerbaijan,AZE,Slovakia,SVK,0,0,0,5,5
2005,Bangladesh,BGD,Slovakia,SVK,0,0,71,213,284
2005,Belarus,BLR,Slovakia,SVK,0,0,5,10,15
2005,Bulgaria,BGR,Slovakia,SVK,0,0,0,5,5
2005,China,CHN,Slovakia,SVK,0,0,123,263,386
2005,Cameroon,CMR,Slovakia,SVK,0,0,0,5,5
2005,Cuba,CUB,Slovakia,SVK,0,0,0,5,5
2005,Palestinian,PSE,Slovakia,SVK,0,0,25,56,81
2005,Georgia,GEO,Slovakia,SVK,0,0,42,230,272
2005,India,IND,Slovakia,SVK,0,0,93,392,485
2005,Iran (Islamic Rep. of),IRN,Slovakia,SVK,0,0,10,0,10
2005,Iraq,IRQ,Slovakia,SVK,0,0,22,27,49
2005,Israel,ISR,Slovakia,SVK,0,0,5,5,10
2005,Liberia,LBR,Slovakia,SVK,0,0,0,5,5
2005,Sri Lanka,LKA,Slovakia,SVK,0,0,10,0,10
2005,North Macedonia,MKD,Slovakia,SVK,0,0,0,5,5
2005,Rep. of Moldova,MDA,Slovakia,SVK,0,0,28,322,350
2005,Nigeria,NGA,Slovakia,SVK,0,0,0,22,22
2005,Pakistan,PAK,Slovakia,SVK,0,0,58,164,222
2005,Russian Federation,RUS,Slovakia,SVK,0,0,120,918,1038
2005,Serbia and Kosovo: S/RES/1244 (1999),SRB,Slovakia,SVK,5,0,17,17,39
2005,Somalia,SOM,Slovakia,SVK,0,0,5,17,22
2005,Viet Nam,VNM,Slovakia,SVK,0,0,65,46,111
2005,Sudan,SDN,Slovakia,SVK,0,0,0,5,5
2005,Syrian Arab Rep.,SYR,Slovakia,SVK,0,0,14,16,30
2005,Turkey,TUR,Slovakia,SVK,0,0,5,40,45
2005,Ukraine,UKR,Slovakia,SVK,12,0,32,15,59
2005,Stateless,XXA,Slovakia,SVK,0,0,0,10,10
2005,Afghanistan,AFG,Slovenia,SVN,0,0,0,5,5
2005,Albania,ALB,Slovenia,SVN,0,0,18,141,159
2005,Bangladesh,BGD,Slovenia,SVN,0,0,35,133,168
2005,Bosnia and Herzegovina,BIH,Slovenia,SVN,0,0,205,117,322
2005,Gambia,GMB,Slovenia,SVN,0,0,10,0,10
2005,Palestinian,PSE,Slovenia,SVN,0,0,0,5,5
2005,Georgia,GEO,Slovenia,SVN,0,0,10,5,15
2005,Croatia,HRV,Slovenia,SVN,0,0,5,0,5
2005,India,IND,Slovenia,SVN,0,0,0,31,31
2005,Iran (Islamic Rep. of),IRN,Slovenia,SVN,0,0,0,5,5
2005,Iraq,IRQ,Slovenia,SVN,0,0,0,12,12
2005,Liberia,LBR,Slovenia,SVN,0,0,10,0,10
2005,Sri Lanka,LKA,Slovenia,SVN,0,0,0,5,5
2005,North Macedonia,MKD,Slovenia,SVN,0,0,23,62,85
2005,Rep. of Moldova,MDA,Slovenia,SVN,0,0,24,38,62
2005,Mongolia,MNG,Slovenia,SVN,0,0,0,5,5
2005,Pakistan,PAK,Slovenia,SVN,0,0,10,17,27
2005,Romania,ROU,Slovenia,SVN,0,0,5,10,15
2005,Russian Federation,RUS,Slovenia,SVN,0,0,5,11,16
2005,Serbia and Kosovo: S/RES/1244 (1999),SRB,Slovenia,SVN,10,10,302,377,699
2005,Tunisia,TUN,Slovenia,SVN,0,0,5,0,5
2005,Turkey,TUR,Slovenia,SVN,0,0,17,232,249
2005,Ukraine,UKR,Slovenia,SVN,0,0,0,5,5
2005,Uzbekistan,UZB,Slovenia,SVN,0,0,0,5,5
2005,Unknown ,,Slovenia,SVN,0,0,11,10,21
2005,Congo,COG,Eswatini,SWZ,0,0,0,13,13
2005,Dem. Rep. of the Congo,COD,Eswatini,SWZ,0,0,0,10,10
2005,Liberia,LBR,Eswatini,SWZ,0,0,0,10,10
2005,Sierra Leone,SLE,Eswatini,SWZ,0,0,0,5,5
2005,Somalia,SOM,Eswatini,SWZ,0,0,0,17,17
2005,Afghanistan,AFG,Sweden,SWE,0,121,565,57,743
2005,Albania,ALB,Sweden,SWE,0,5,146,19,170
2005,Algeria,DZA,Sweden,SWE,0,10,184,53,247
2005,Angola,AGO,Sweden,SWE,0,0,63,5,68
2005,Egypt,EGY,Sweden,SWE,0,0,63,5,68
2005,Armenia,ARM,Sweden,SWE,0,37,274,59,370
2005,Azerbaijan,AZE,Sweden,SWE,5,34,693,75,807
2005,Bahrain,BHR,Sweden,SWE,0,0,5,0,5
2005,Burundi,BDI,Sweden,SWE,0,401,43,5,449
2005,Belgium,BEL,Sweden,SWE,5,0,0,0,5
2005,Benin,BEN,Sweden,SWE,0,0,5,0,5
2005,Bangladesh,BGD,Sweden,SWE,0,5,118,19,142
2005,Burkina Faso,BFA,Sweden,SWE,0,0,10,0,10
2005,Belarus,BLR,Sweden,SWE,0,13,380,71,464
2005,Bolivia (Plurinational State of),BOL,Sweden,SWE,0,0,279,27,306
2005,Bosnia and Herzegovina,BIH,Sweden,SWE,0,20,334,43,397
2005,Bulgaria,BGR,Sweden,SWE,0,0,747,118,865
2005,Canada,CAN,Sweden,SWE,0,0,5,0,5
2005,China,CHN,Sweden,SWE,5,0,68,92,165
2005,Chile,CHL,Sweden,SWE,0,0,10,5,15
2005,Cameroon,CMR,Sweden,SWE,0,5,45,16,66
2005,Congo,COG,Sweden,SWE,0,5,10,5,20
2005,Dem. Rep. of the Congo,COD,Sweden,SWE,0,20,73,11,104
2005,Colombia,COL,Sweden,SWE,0,0,23,0,23
2005,Cuba,CUB,Sweden,SWE,0,5,15,5,25
2005,Czechia,CZE,Sweden,SWE,0,0,5,0,5
2005,Ecuador,ECU,Sweden,SWE,0,0,26,12,38
2005,Eritrea,ERI,Sweden,SWE,22,205,210,27,464
2005,Estonia,EST,Sweden,SWE,0,0,5,0,5
2005,Ethiopia,ETH,Sweden,SWE,0,17,115,10,142
2005,Gambia,GMB,Sweden,SWE,0,0,10,5,15
2005,Georgia,GEO,Sweden,SWE,0,5,197,40,242
2005,Ghana,GHA,Sweden,SWE,0,0,13,0,13
2005,Guinea,GIN,Sweden,SWE,0,0,47,5,52
2005,Honduras,HND,Sweden,SWE,0,0,10,0,10
2005,Croatia,HRV,Sweden,SWE,0,0,86,5,91
2005,Cote d'Ivoire,CIV,Sweden,SWE,0,0,45,5,50
2005,India,IND,Sweden,SWE,0,5,79,36,120
2005,Indonesia,IDN,Sweden,SWE,0,0,5,0,5
2005,Iran (Islamic Rep. of),IRN,Sweden,SWE,40,44,442,84,610
2005,Iraq,IRQ,Sweden,SWE,15,465,1597,214,2291
2005,Israel,ISR,Sweden,SWE,5,0,37,0,42
2005,Jordan,JOR,Sweden,SWE,0,11,111,15,137
2005,Kazakhstan,KAZ,Sweden,SWE,0,13,122,16,151
2005,Kenya,KEN,Sweden,SWE,0,5,25,0,30
2005,Kyrgyzstan,KGZ,Sweden,SWE,0,5,74,10,89
2005,Rep. of Korea,KOR,Sweden,SWE,5,0,0,0,5
2005,Dem. People's Rep. of Korea,PRK,Sweden,SWE,5,0,0,0,5
2005,Kuwait,KWT,Sweden,SWE,5,0,5,0,10
2005,Lao People's Dem. Rep.,LAO,Sweden,SWE,0,0,10,0,10
2005,Liberia,LBR,Sweden,SWE,0,5,29,15,49
2005,Libya,LBY,Sweden,SWE,0,11,415,77,503
2005,Lebanon,LBN,Sweden,SWE,0,16,237,53,306
2005,Sri Lanka,LKA,Sweden,SWE,0,0,13,5,18
2005,Lithuania,LTU,Sweden,SWE,0,0,10,10,20
2005,Latvia,LVA,Sweden,SWE,0,0,0,5,5
2005,Mauritania,MRT,Sweden,SWE,0,0,10,0,10
2005,North Macedonia,MKD,Sweden,SWE,0,5,136,29,170
2005,Rep. of Moldova,MDA,Sweden,SWE,0,0,67,34,101
2005,Mongolia,MNG,Sweden,SWE,0,0,253,18,271
2005,Morocco,MAR,Sweden,SWE,0,5,26,15,46
2005,Myanmar,MMR,Sweden,SWE,5,0,5,0,10
2005,Nepal,NPL,Sweden,SWE,0,0,34,0,34
2005,Niger,NER,Sweden,SWE,0,0,5,0,5
2005,Nigeria,NGA,Sweden,SWE,0,10,214,42,266
2005,Pakistan,PAK,Sweden,SWE,0,5,47,14,66
2005,Panama,PAN,Sweden,SWE,0,0,5,0,5
2005,Peru,PER,Sweden,SWE,0,5,26,5,36
2005,Philippines,PHL,Sweden,SWE,0,0,5,0,5
2005,Poland,POL,Sweden,SWE,0,0,0,5,5
2005,Romania,ROU,Sweden,SWE,0,0,88,36,124
2005,Russian Federation,RUS,Sweden,SWE,5,88,940,171,1204
2005,Rwanda,RWA,Sweden,SWE,0,0,26,0,26
2005,El Salvador,SLV,Sweden,SWE,0,0,12,0,12
2005,Serbia and Kosovo: S/RES/1244 (1999),SRB,Sweden,SWE,107,206,2534,378,3225
2005,Sierra Leone,SLE,Sweden,SWE,0,5,29,5,39
2005,Somalia,SOM,Sweden,SWE,87,336,819,89,1331
2005,Viet Nam,VNM,Sweden,SWE,0,0,41,13,54
2005,Sudan,SDN,Sweden,SWE,0,10,45,17,72
2005,Slovakia,SVK,Sweden,SWE,0,0,5,5,10
2005,Syrian Arab Rep.,SYR,Sweden,SWE,5,34,251,43,333
2005,United Rep. of Tanzania,TZA,Sweden,SWE,0,0,12,0,12
2005,Thailand,THA,Sweden,SWE,0,0,5,0,5
2005,Tajikistan,TJK,Sweden,SWE,0,0,44,5,49
2005,Turkmenistan,TKM,Sweden,SWE,0,0,26,10,36
2005,Togo,TGO,Sweden,SWE,0,0,10,0,10
2005,Tunisia,TUN,Sweden,SWE,0,5,48,11,64
2005,Turkey,TUR,Sweden,SWE,5,31,367,43,446
2005,Uganda,UGA,Sweden,SWE,0,5,14,5,24
2005,Ukraine,UKR,Sweden,SWE,0,0,113,31,144
2005,United States of America,USA,Sweden,SWE,0,0,5,0,5
2005,Uzbekistan,UZB,Sweden,SWE,0,67,91,32,190
2005,Venezuela (Bolivarian Republic of),VEN,Sweden,SWE,0,0,5,0,5
2005,Yemen,YEM,Sweden,SWE,0,0,35,5,40
2005,Zimbabwe,ZWE,Sweden,SWE,0,0,5,0,5
2005,Stateless,XXA,Sweden,SWE,5,167,1133,157,1462
2005,Unknown ,,Sweden,SWE,0,12,175,33,220
2005,Afghanistan,AFG,Switzerland,CHE,39,144,176,42,401
2005,Albania,ALB,Switzerland,CHE,0,5,17,31,53
2005,Algeria,DZA,Switzerland,CHE,26,18,79,142,265
2005,Angola,AGO,Switzerland,CHE,0,265,146,31,442
2005,Egypt,EGY,Switzerland,CHE,5,0,0,5,10
2005,Armenia,ARM,Switzerland,CHE,0,26,146,45,217
2005,Azerbaijan,AZE,Switzerland,CHE,10,0,35,24,69
2005,Burundi,BDI,Switzerland,CHE,5,16,16,5,42
2005,Benin,BEN,Switzerland,CHE,5,5,10,5,25
2005,Bangladesh,BGD,Switzerland,CHE,0,0,62,23,85
2005,Burkina Faso,BFA,Switzerland,CHE,0,0,5,0,5
2005,Belarus,BLR,Switzerland,CHE,0,5,57,44,106
2005,Bosnia and Herzegovina,BIH,Switzerland,CHE,44,310,140,112,606
2005,Bulgaria,BGR,Switzerland,CHE,0,0,199,319,518
2005,Cambodia,KHM,Switzerland,CHE,13,0,0,0,13
2005,Chad,TCD,Switzerland,CHE,0,0,5,0,5
2005,China,CHN,Switzerland,CHE,56,49,73,39,217
2005,Cameroon,CMR,Switzerland,CHE,5,10,115,55,185
2005,Congo,COG,Switzerland,CHE,0,10,11,0,21
2005,Dem. Rep. of the Congo,COD,Switzerland,CHE,22,262,242,60,586
2005,Colombia,COL,Switzerland,CHE,40,5,5,5,55
2005,Cuba,CUB,Switzerland,CHE,0,5,5,5,15
2005,Czechia,CZE,Switzerland,CHE,0,0,0,5,5
2005,Eritrea,ERI,Switzerland,CHE,12,69,150,20,251
2005,Ethiopia,ETH,Switzerland,CHE,10,54,97,21,182
2005,France,FRA,Switzerland,CHE,0,0,0,5,5
2005,Gabon,GAB,Switzerland,CHE,0,0,5,5,10
2005,Gambia,GMB,Switzerland,CHE,0,0,5,10,15
2005,Georgia,GEO,Switzerland,CHE,0,21,206,233,460
2005,Germany,DEU,Switzerland,CHE,0,0,0,10,10
2005,Ghana,GHA,Switzerland,CHE,0,0,0,5,5
2005,Guinea-Bissau,GNB,Switzerland,CHE,0,5,13,14,32
2005,Guinea,GIN,Switzerland,CHE,5,14,111,113,243
2005,Croatia,HRV,Switzerland,CHE,5,0,0,15,20
2005,Cote d'Ivoire,CIV,Switzerland,CHE,16,10,126,57,209
2005,India,IND,Switzerland,CHE,0,10,26,49,85
2005,Iran (Islamic Rep. of),IRN,Switzerland,CHE,53,161,275,43,532
2005,Iraq,IRQ,Switzerland,CHE,140,958,1247,290,2635
2005,Israel,ISR,Switzerland,CHE,0,0,0,10,10
2005,Jordan,JOR,Switzerland,CHE,0,0,0,10,10
2005,Kazakhstan,KAZ,Switzerland,CHE,0,5,11,0,16
2005,Kenya,KEN,Switzerland,CHE,5,0,5,0,10
2005,Kyrgyzstan,KGZ,Switzerland,CHE,0,0,5,0,5
2005,Lao People's Dem. Rep.,LAO,Switzerland,CHE,5,0,0,0,5
2005,Liberia,LBR,Switzerland,CHE,5,11,53,24,93
2005,Libya,LBY,Switzerland,CHE,33,0,18,10,61
2005,Lebanon,LBN,Switzerland,CHE,0,5,11,39,55
2005,Sri Lanka,LKA,Switzerland,CHE,58,116,131,64,369
2005,Lithuania,LTU,Switzerland,CHE,0,0,0,12,12
2005,Latvia,LVA,Switzerland,CHE,0,0,0,10,10
2005,Madagascar,MDG,Switzerland,CHE,0,0,5,0,5
2005,Mauritania,MRT,Switzerland,CHE,0,0,10,10,20
2005,North Macedonia,MKD,Switzerland,CHE,0,25,48,102,175
2005,Rep. of Moldova,MDA,Switzerland,CHE,0,5,24,46,75
2005,Maldives,MDV,Switzerland,CHE,5,0,0,0,5
2005,Mali,MLI,Switzerland,CHE,0,0,12,17,29
2005,Mongolia,MNG,Switzerland,CHE,0,5,37,39,81
2005,Morocco,MAR,Switzerland,CHE,5,0,5,19,29
2005,Myanmar,MMR,Switzerland,CHE,0,5,5,0,10
2005,Nepal,NPL,Switzerland,CHE,0,5,10,19,34
2005,Niger,NER,Switzerland,CHE,0,5,5,10,20
2005,Nigeria,NGA,Switzerland,CHE,5,18,141,111,275
2005,Pakistan,PAK,Switzerland,CHE,5,13,80,35,133
2005,Poland,POL,Switzerland,CHE,0,0,0,5,5
2005,Romania,ROU,Switzerland,CHE,0,0,25,66,91
2005,South Africa,ZAF,Switzerland,CHE,0,0,5,0,5
2005,Russian Federation,RUS,Switzerland,CHE,19,77,259,160,515
2005,Rwanda,RWA,Switzerland,CHE,22,5,5,5,37
2005,Serbia and Kosovo: S/RES/1244 (1999),SRB,Switzerland,CHE,78,792,800,593,2263
2005,Senegal,SEN,Switzerland,CHE,0,0,13,19,32
2005,Sierra Leone,SLE,Switzerland,CHE,0,5,24,22,51
2005,Somalia,SOM,Switzerland,CHE,19,517,431,42,1009
2005,Viet Nam,VNM,Switzerland,CHE,40,5,11,0,56
2005,Sudan,SDN,Switzerland,CHE,10,14,47,33,104
2005,Slovakia,SVK,Switzerland,CHE,0,0,5,0,5
2005,Syrian Arab Rep.,SYR,Switzerland,CHE,23,140,112,60,335
2005,United Rep. of Tanzania,TZA,Switzerland,CHE,0,0,10,5,15
2005,Tajikistan,TJK,Switzerland,CHE,0,0,5,0,5
2005,Turkmenistan,TKM,Switzerland,CHE,0,0,5,0,5
2005,Togo,TGO,Switzerland,CHE,116,0,43,15,174
2005,Tunisia,TUN,Switzerland,CHE,70,0,22,32,124
2005,Turkey,TUR,Switzerland,CHE,433,138,470,203,1244
2005,Uganda,UGA,Switzerland,CHE,0,0,5,5,10
2005,Ukraine,UKR,Switzerland,CHE,0,11,32,33,76
2005,United States of America,USA,Switzerland,CHE,0,0,0,5,5
2005,Uzbekistan,UZB,Switzerland,CHE,0,0,0,5,5
2005,Yemen,YEM,Switzerland,CHE,10,10,15,5,40
2005,Zimbabwe,ZWE,Switzerland,CHE,0,0,17,15,32
2005,Stateless,XXA,Switzerland,CHE,13,61,170,405,649
2005,Unknown ,,Switzerland,CHE,0,0,0,10,10
2005,Rwanda,RWA,United Rep. of Tanzania,TZA,0,0,5,0,5
2005,Myanmar,MMR,Thailand,THA,0,14619,17,0,14636
2005,Dem. Rep. of the Congo,COD,Togo,TGO,11,0,31,0,42
2005,Cote d'Ivoire,CIV,Togo,TGO,23,0,0,0,23
2005,Afghanistan,AFG,Ukraine,UKR,27,0,130,79,236
2005,Algeria,DZA,Ukraine,UKR,0,0,0,5,5
2005,Angola,AGO,Ukraine,UKR,0,0,11,5,16
2005,Armenia,ARM,Ukraine,UKR,0,0,15,12,27
2005,Azerbaijan,AZE,Ukraine,UKR,0,0,5,24,29
2005,Bangladesh,BGD,Ukraine,UKR,0,0,10,136,146
2005,Belarus,BLR,Ukraine,UKR,0,0,0,5,5
2005,Congo,COG,Ukraine,UKR,0,0,5,0,5
2005,Dem. Rep. of the Congo,COD,Ukraine,UKR,0,0,0,5,5
2005,Cuba,CUB,Ukraine,UKR,0,0,0,5,5
2005,Ethiopia,ETH,Ukraine,UKR,0,0,5,5,10
2005,Palestinian,PSE,Ukraine,UKR,0,0,33,72,105
2005,Georgia,GEO,Ukraine,UKR,0,0,0,16,16
2005,India,IND,Ukraine,UKR,0,0,5,310,315
2005,Iran (Islamic Rep. of),IRN,Ukraine,UKR,5,0,15,10,30
2005,Iraq,IRQ,Ukraine,UKR,5,0,28,90,123
2005,Kazakhstan,KAZ,Ukraine,UKR,0,0,0,10,10
2005,Lebanon,LBN,Ukraine,UKR,0,0,0,5,5
2005,Sri Lanka,LKA,Ukraine,UKR,0,0,5,5,10
2005,Rep. of Moldova,MDA,Ukraine,UKR,0,0,0,5,5
2005,Nigeria,NGA,Ukraine,UKR,0,0,5,5,10
2005,Pakistan,PAK,Ukraine,UKR,0,0,5,133,138
2005,Russian Federation,RUS,Ukraine,UKR,0,0,43,110,153
2005,Somalia,SOM,Ukraine,UKR,0,0,17,5,22
2005,Sudan,SDN,Ukraine,UKR,0,0,5,10,15
2005,Syrian Arab Rep.,SYR,Ukraine,UKR,0,0,13,12,25
2005,Tajikistan,TJK,Ukraine,UKR,0,0,0,5,5
2005,Uzbekistan,UZB,Ukraine,UKR,0,0,5,0,5
2005,Stateless,XXA,Ukraine,UKR,0,0,5,5,10
2005,Colombia,COL,Uruguay,URY,16,0,0,0,16
2005,Nigeria,NGA,Uruguay,URY,5,0,0,0,5
2005,Peru,PER,Uruguay,URY,5,0,0,0,5
2005,Colombia,COL,Venezuela (Bolivarian Republic of),VEN,195,0,240,0,435
2005,Haiti,HTI,Venezuela (Bolivarian Republic of),VEN,5,0,0,0,5
2005,Unknown ,,Zimbabwe,ZWE,0,0,0,1553,1553
2006,Armenia,ARM,Argentina,ARG,0,0,5,0,5
2006,Cameroon,CMR,Argentina,ARG,0,0,5,0,5
2006,Colombia,COL,Argentina,ARG,11,0,14,0,25
2006,Cuba,CUB,Argentina,ARG,5,0,10,0,15
2006,Ghana,GHA,Argentina,ARG,5,0,0,0,5
2006,Guinea,GIN,Argentina,ARG,5,0,0,0,5
2006,Liberia,LBR,Argentina,ARG,5,0,0,0,5
2006,Nigeria,NGA,Argentina,ARG,5,0,5,0,10
2006,Paraguay,PRY,Argentina,ARG,0,0,5,0,5
2006,Peru,PER,Argentina,ARG,14,0,63,5,82
2006,Russian Federation,RUS,Argentina,ARG,0,0,10,0,10
2006,Senegal,SEN,Argentina,ARG,0,0,118,0,118
2006,Iran (Islamic Rep. of),IRN,Armenia,ARM,0,0,5,0,5
2006,Iraq,IRQ,Armenia,ARM,0,237,0,5,242
2006,Israel,ISR,Armenia,ARM,0,5,0,55,60
2006,Lebanon,LBN,Armenia,ARM,0,14,0,267,281
2006,Syrian Arab Rep.,SYR,Armenia,ARM,0,0,5,0,5
2006,Afghanistan,AFG,Australia,AUS,5,0,0,0,5
2006,Albania,ALB,Australia,AUS,0,0,12,0,12
2006,Egypt,EGY,Australia,AUS,5,0,42,0,47
2006,Bahrain,BHR,Australia,AUS,0,0,16,0,16
2006,Bangladesh,BGD,Australia,AUS,14,0,43,0,57
2006,Brazil,BRA,Australia,AUS,0,0,5,0,5
2006,Bulgaria,BGR,Australia,AUS,0,0,5,0,5
2006,Cambodia,KHM,Australia,AUS,0,0,10,0,10
2006,China,CHN,Australia,AUS,87,0,949,12,1048
2006,Chile,CHL,Australia,AUS,0,0,5,0,5
2006,Cameroon,CMR,Australia,AUS,5,0,11,0,16
2006,Congo,COG,Australia,AUS,5,0,0,0,5
2006,Colombia,COL,Australia,AUS,5,0,10,0,15
2006,Eritrea,ERI,Australia,AUS,5,0,0,0,5
2006,Ethiopia,ETH,Australia,AUS,13,0,17,0,30
2006,Fiji,FJI,Australia,AUS,0,0,29,5,34
2006,France,FRA,Australia,AUS,5,0,0,0,5
2006,Palestinian,PSE,Australia,AUS,10,0,5,0,15
2006,United Kingdom of Great Britain and Northern Ireland,GBR,Australia,AUS,0,0,10,0,10
2006,Germany,DEU,Australia,AUS,0,0,5,0,5
2006,Ghana,GHA,Australia,AUS,0,0,10,0,10
2006,"China, Hong Kong SAR",HKG,Australia,AUS,0,0,14,0,14
2006,India,IND,Australia,AUS,0,0,310,5,315
2006,Indonesia,IDN,Australia,AUS,55,0,246,0,301
2006,Iran (Islamic Rep. of),IRN,Australia,AUS,45,0,19,0,64
2006,Iraq,IRQ,Australia,AUS,117,0,5,15,137
2006,Israel,ISR,Australia,AUS,5,0,16,0,21
2006,Jordan,JOR,Australia,AUS,0,0,5,0,5
2006,Japan,JPN,Australia,AUS,0,0,5,0,5
2006,Kenya,KEN,Australia,AUS,0,0,5,0,5
2006,Kyrgyzstan,KGZ,Australia,AUS,0,0,5,0,5
2006,Rep. of Korea,KOR,Australia,AUS,0,0,94,5,99
2006,Dem. People's Rep. of Korea,PRK,Australia,AUS,0,0,5,0,5
2006,Lebanon,LBN,Australia,AUS,5,0,52,5,62
2006,Sri Lanka,LKA,Australia,AUS,159,0,102,0,261
2006,Latvia,LVA,Australia,AUS,0,0,5,0,5
2006,North Macedonia,MKD,Australia,AUS,0,0,5,0,5
2006,Malaysia,MYS,Australia,AUS,0,0,111,5,116
2006,Mongolia,MNG,Australia,AUS,0,0,13,0,13
2006,Morocco,MAR,Australia,AUS,5,0,5,0,10
2006,Myanmar,MMR,Australia,AUS,10,0,12,0,22
2006,Nepal,NPL,Australia,AUS,5,0,37,0,42
2006,Nigeria,NGA,Australia,AUS,5,0,27,0,32
2006,Pakistan,PAK,Australia,AUS,39,0,57,0,96
2006,Philippines,PHL,Australia,AUS,0,0,72,0,72
2006,Papua New Guinea,PNG,Australia,AUS,0,0,19,0,19
2006,Portugal,PRT,Australia,AUS,0,0,0,10,10
2006,South Africa,ZAF,Australia,AUS,0,0,10,0,10
2006,Russian Federation,RUS,Australia,AUS,5,0,14,0,19
2006,Serbia and Kosovo: S/RES/1244 (1999),SRB,Australia,AUS,0,0,5,0,5
2006,Singapore,SGP,Australia,AUS,0,0,5,0,5
2006,Sierra Leone,SLE,Australia,AUS,15,0,0,0,15
2006,Solomon Islands,SLB,Australia,AUS,12,0,5,0,17
2006,Viet Nam,VNM,Australia,AUS,0,0,26,0,26
2006,Slovenia,SVN,Australia,AUS,0,0,5,0,5
2006,United Rep. of Tanzania,TZA,Australia,AUS,0,0,5,0,5
2006,Thailand,THA,Australia,AUS,0,0,38,0,38
2006,Timor-Leste,TLS,Australia,AUS,0,0,10,0,10
2006,Tonga,TON,Australia,AUS,0,0,5,0,5
2006,Turkey,TUR,Australia,AUS,5,0,17,0,22
2006,Uganda,UGA,Australia,AUS,0,0,5,0,5
2006,Ukraine,UKR,Australia,AUS,0,0,10,0,10
2006,Uruguay,URY,Australia,AUS,0,0,5,0,5
2006,Uzbekistan,UZB,Australia,AUS,0,0,5,0,5
2006,Zimbabwe,ZWE,Australia,AUS,24,0,11,0,35
2006,Stateless,XXA,Australia,AUS,5,0,5,0,10
2006,Afghanistan,AFG,Azerbaijan,AZE,5,0,112,26,143
2006,Algeria,DZA,Azerbaijan,AZE,0,0,5,0,5
2006,Palestinian,PSE,Azerbaijan,AZE,0,0,5,0,5
2006,Georgia,GEO,Azerbaijan,AZE,0,0,5,0,5
2006,India,IND,Azerbaijan,AZE,0,0,5,0,5
2006,Iran (Islamic Rep. of),IRN,Azerbaijan,AZE,24,0,53,12,89
2006,Iraq,IRQ,Azerbaijan,AZE,0,0,19,0,19
2006,Pakistan,PAK,Azerbaijan,AZE,0,0,33,0,33
2006,Syrian Arab Rep.,SYR,Azerbaijan,AZE,0,0,5,0,5
2006,Dem. Rep. of the Congo,COD,Burundi,BDI,825,0,805,3156,4786
2006,Afghanistan,AFG,Belgium,BEL,5,0,22,5,32
2006,Albania,ALB,Belgium,BEL,10,0,25,58,93
2006,Algeria,DZA,Belgium,BEL,5,0,29,5,39
2006,Angola,AGO,Belgium,BEL,15,0,150,12,177
2006,Egypt,EGY,Belgium,BEL,0,0,13,0,13
2006,Armenia,ARM,Belgium,BEL,11,0,154,39,204
2006,Azerbaijan,AZE,Belgium,BEL,5,0,32,19,56
2006,Burundi,BDI,Belgium,BEL,41,0,146,45,232
2006,Benin,BEN,Belgium,BEL,0,0,10,5,15
2006,Bangladesh,BGD,Belgium,BEL,0,0,10,5,15
2006,Bhutan,BTN,Belgium,BEL,0,0,5,13,18
2006,Burkina Faso,BFA,Belgium,BEL,5,0,10,10,25
2006,Belarus,BLR,Belgium,BEL,50,0,54,32,136
2006,Bosnia and Herzegovina,BIH,Belgium,BEL,10,0,10,10,30
2006,Bulgaria,BGR,Belgium,BEL,0,0,5,5,10
2006,Central African Rep.,CAF,Belgium,BEL,5,0,5,10,20
2006,Chad,TCD,Belgium,BEL,10,0,17,5,32
2006,China,CHN,Belgium,BEL,57,0,37,5,99
2006,Cameroon,CMR,Belgium,BEL,22,0,207,5,234
2006,Congo,COG,Belgium,BEL,16,0,37,24,77
2006,Dem. Rep. of the Congo,COD,Belgium,BEL,295,0,725,165,1185
2006,Colombia,COL,Belgium,BEL,5,0,10,0,15
2006,Czechia,CZE,Belgium,BEL,0,0,0,5,5
2006,Djibouti,DJI,Belgium,BEL,16,0,38,27,81
2006,Eritrea,ERI,Belgium,BEL,5,0,13,5,23
2006,Ethiopia,ETH,Belgium,BEL,10,0,37,16,63
2006,Gabon,GAB,Belgium,BEL,5,0,5,5,15
2006,Palestinian,PSE,Belgium,BEL,0,0,16,10,26
2006,Georgia,GEO,Belgium,BEL,0,0,34,10,44
2006,Guinea-Bissau,GNB,Belgium,BEL,0,0,5,0,5
2006,Guinea,GIN,Belgium,BEL,114,0,346,29,489
2006,Croatia,HRV,Belgium,BEL,5,0,0,5,10
2006,Cote d'Ivoire,CIV,Belgium,BEL,123,0,287,53,463
2006,India,IND,Belgium,BEL,0,0,5,5,10
2006,Iran (Islamic Rep. of),IRN,Belgium,BEL,46,0,143,73,262
2006,Iraq,IRQ,Belgium,BEL,42,5,316,156,519
2006,Israel,ISR,Belgium,BEL,0,0,13,10,23
2006,Jordan,JOR,Belgium,BEL,0,0,5,0,5
2006,Kazakhstan,KAZ,Belgium,BEL,5,0,10,19,34
2006,Kenya,KEN,Belgium,BEL,0,0,5,5,10
2006,Kyrgyzstan,KGZ,Belgium,BEL,0,0,21,10,31
2006,Liberia,LBR,Belgium,BEL,0,0,80,11,91
2006,Libya,LBY,Belgium,BEL,0,0,10,0,10
2006,Lebanon,LBN,Belgium,BEL,0,0,17,5,22
2006,Sri Lanka,LKA,Belgium,BEL,0,0,17,5,22
2006,Mauritania,MRT,Belgium,BEL,35,0,216,58,309
2006,North Macedonia,MKD,Belgium,BEL,0,0,15,10,25
2006,Mali,MLI,Belgium,BEL,0,0,5,5,10
2006,Malawi,MWI,Belgium,BEL,0,0,5,0,5
2006,Mongolia,MNG,Belgium,BEL,0,0,5,0,5
2006,Morocco,MAR,Belgium,BEL,0,0,5,5,10
2006,Montenegro,MNE,Belgium,BEL,0,0,5,10,15
2006,Myanmar,MMR,Belgium,BEL,5,0,5,5,15
2006,Nepal,NPL,Belgium,BEL,5,0,128,10,143
2006,Niger,NER,Belgium,BEL,10,0,107,26,143
2006,Nigeria,NGA,Belgium,BEL,5,0,20,5,30
2006,Pakistan,PAK,Belgium,BEL,0,0,60,10,70
2006,Romania,ROU,Belgium,BEL,0,0,5,0,5
2006,Russian Federation,RUS,Belgium,BEL,442,0,366,88,896
2006,Rwanda,RWA,Belgium,BEL,281,0,281,46,608
2006,Serbia and Kosovo: S/RES/1244 (1999),SRB,Belgium,BEL,87,0,104,168,359
2006,Senegal,SEN,Belgium,BEL,0,0,5,5,10
2006,Sierra Leone,SLE,Belgium,BEL,5,0,51,42,98
2006,Somalia,SOM,Belgium,BEL,22,0,34,17,73
2006,Viet Nam,VNM,Belgium,BEL,0,0,5,0,5
2006,Sudan,SDN,Belgium,BEL,5,0,34,5,44
2006,Slovakia,SVK,Belgium,BEL,0,0,5,11,16
2006,Syrian Arab Rep.,SYR,Belgium,BEL,5,0,57,14,76
2006,Togo,TGO,Belgium,BEL,19,0,143,5,167
2006,Turkey,TUR,Belgium,BEL,10,0,93,19,122
2006,Uganda,UGA,Belgium,BEL,5,0,19,5,29
2006,Ukraine,UKR,Belgium,BEL,0,0,15,17,32
2006,Uzbekistan,UZB,Belgium,BEL,5,0,22,30,57
2006,Zimbabwe,ZWE,Belgium,BEL,5,0,5,0,10
2006,Stateless,XXA,Belgium,BEL,0,0,5,0,5
2006,Unknown ,,Belgium,BEL,10,0,20,14,44
2006,Angola,AGO,Benin,BEN,0,0,0,5,5
2006,Burundi,BDI,Benin,BEN,5,0,0,0,5
2006,Burkina Faso,BFA,Benin,BEN,0,0,0,5,5
2006,Central African Rep.,CAF,Benin,BEN,0,0,5,20,25
2006,Chad,TCD,Benin,BEN,27,0,5,78,110
2006,Cameroon,CMR,Benin,BEN,5,0,10,38,53
2006,Congo,COG,Benin,BEN,10,0,40,51,101
2006,Dem. Rep. of the Congo,COD,Benin,BEN,40,0,222,262,524
2006,Guinea,GIN,Benin,BEN,5,0,0,0,5
2006,Cote d'Ivoire,CIV,Benin,BEN,53,0,26,164,243
2006,Liberia,LBR,Benin,BEN,0,0,0,46,46
2006,Nigeria,NGA,Benin,BEN,21,0,71,40,132
2006,Rwanda,RWA,Benin,BEN,5,0,0,0,5
2006,Sierra Leone,SLE,Benin,BEN,0,0,0,5,5
2006,Somalia,SOM,Benin,BEN,0,0,0,5,5
2006,Sudan,SDN,Benin,BEN,0,0,0,29,29
2006,Togo,TGO,Benin,BEN,53,0,53,22,128
2006,Benin,BEN,Burkina Faso,BFA,0,0,0,5,5
2006,Central African Rep.,CAF,Burkina Faso,BFA,0,0,0,5,5
2006,Guinea,GIN,Burkina Faso,BFA,0,0,0,10,10
2006,Cote d'Ivoire,CIV,Burkina Faso,BFA,0,0,0,52,52
2006,Iran (Islamic Rep. of),IRN,Burkina Faso,BFA,0,0,0,5,5
2006,Liberia,LBR,Burkina Faso,BFA,0,0,0,89,89
2006,Sierra Leone,SLE,Burkina Faso,BFA,0,0,0,10,10
2006,Togo,TGO,Burkina Faso,BFA,0,0,0,62,62
2006,Afghanistan,AFG,Belarus,BLR,0,10,40,10,60
2006,Armenia,ARM,Belarus,BLR,0,0,5,0,5
2006,Georgia,GEO,Belarus,BLR,5,0,10,0,15
2006,Iraq,IRQ,Belarus,BLR,0,0,10,0,10
2006,Israel,ISR,Belarus,BLR,0,0,5,0,5
2006,Poland,POL,Belarus,BLR,0,0,0,5,5
2006,Ukraine,UKR,Belarus,BLR,0,0,5,5,10
2006,Colombia,COL,Bolivia (Plurinational State of),BOL,25,0,0,5,30
2006,Peru,PER,Bolivia (Plurinational State of),BOL,5,0,0,0,5
2006,Burundi,BDI,Botswana,BWA,10,0,0,0,10
2006,Dem. Rep. of the Congo,COD,Botswana,BWA,5,0,0,0,5
2006,Namibia,NAM,Botswana,BWA,5,0,0,0,5
2006,Rwanda,RWA,Botswana,BWA,10,0,0,0,10
2006,Somalia,SOM,Botswana,BWA,10,0,0,0,10
2006,Zimbabwe,ZWE,Botswana,BWA,15,0,0,0,15
2006,Angola,AGO,Brazil,BRA,12,0,25,10,47
2006,Burundi,BDI,Brazil,BRA,5,0,5,0,10
2006,Cameroon,CMR,Brazil,BRA,0,0,10,0,10
2006,Dem. Rep. of the Congo,COD,Brazil,BRA,55,0,18,5,78
2006,Colombia,COL,Brazil,BRA,75,5,27,10,117
2006,Cuba,CUB,Brazil,BRA,5,0,53,5,63
2006,Ecuador,ECU,Brazil,BRA,0,0,5,0,5
2006,Eritrea,ERI,Brazil,BRA,5,0,0,0,5
2006,Ethiopia,ETH,Brazil,BRA,5,0,0,5,10
2006,Guinea-Bissau,GNB,Brazil,BRA,0,0,10,0,10
2006,Guinea,GIN,Brazil,BRA,0,0,5,0,5
2006,Iraq,IRQ,Brazil,BRA,22,0,0,0,22
2006,Liberia,LBR,Brazil,BRA,0,0,0,5,5
2006,Lebanon,LBN,Brazil,BRA,0,0,248,0,248
2006,Nigeria,NGA,Brazil,BRA,0,0,10,0,10
2006,Peru,PER,Brazil,BRA,0,0,18,5,23
2006,Romania,ROU,Brazil,BRA,0,0,5,52,57
2006,Sierra Leone,SLE,Brazil,BRA,0,0,5,0,5
2006,Somalia,SOM,Brazil,BRA,10,0,0,0,10
2006,Afghanistan,AFG,Bulgaria,BGR,5,34,123,126,288
2006,Algeria,DZA,Bulgaria,BGR,0,0,5,5,10
2006,Armenia,ARM,Bulgaria,BGR,0,5,12,33,50
2006,Bangladesh,BGD,Bulgaria,BGR,0,0,5,5,10
2006,China,CHN,Bulgaria,BGR,0,0,5,0,5
2006,Congo,COG,Bulgaria,BGR,0,0,0,5,5
2006,India,IND,Bulgaria,BGR,0,0,5,5,10
2006,Iran (Islamic Rep. of),IRN,Bulgaria,BGR,5,5,5,16,31
2006,Iraq,IRQ,Bulgaria,BGR,0,28,0,5,33
2006,Lebanon,LBN,Bulgaria,BGR,0,0,0,5,5
2006,Nepal,NPL,Bulgaria,BGR,0,0,0,5,5
2006,Nigeria,NGA,Bulgaria,BGR,0,0,14,10,24
2006,Pakistan,PAK,Bulgaria,BGR,0,0,0,13,13
2006,Russian Federation,RUS,Bulgaria,BGR,0,0,5,10,15
2006,Somalia,SOM,Bulgaria,BGR,0,5,0,0,5
2006,Viet Nam,VNM,Bulgaria,BGR,0,0,0,5,5
2006,Syrian Arab Rep.,SYR,Bulgaria,BGR,0,0,5,5,10
2006,United Rep. of Tanzania,TZA,Bulgaria,BGR,0,0,0,5,5
2006,Turkey,TUR,Bulgaria,BGR,0,0,5,5,10
2006,Ukraine,UKR,Bulgaria,BGR,0,0,5,0,5
2006,Stateless,XXA,Bulgaria,BGR,0,0,15,5,20
2006,Haiti,HTI,Belize,BLZ,0,0,0,14,14
2006,Afghanistan,AFG,Canada,CAN,162,0,12,24,198
2006,Albania,ALB,Canada,CAN,170,0,127,28,325
2006,Algeria,DZA,Canada,CAN,19,0,14,5,38
2006,Angola,AGO,Canada,CAN,10,0,11,5,26
2006,Antigua and Barbuda,ATG,Canada,CAN,0,0,5,0,5
2006,Egypt,EGY,Canada,CAN,36,0,35,5,76
2006,Argentina,ARG,Canada,CAN,5,0,39,5,49
2006,Armenia,ARM,Canada,CAN,13,0,12,0,25
2006,Azerbaijan,AZE,Canada,CAN,34,0,0,0,34
2006,Barbados,BRB,Canada,CAN,5,0,10,0,15
2006,Burundi,BDI,Canada,CAN,148,0,31,0,179
2006,Bangladesh,BGD,Canada,CAN,110,0,123,10,243
2006,Burkina Faso,BFA,Canada,CAN,5,0,0,0,5
2006,Belarus,BLR,Canada,CAN,22,0,0,5,27
2006,Bolivia (Plurinational State of),BOL,Canada,CAN,10,0,5,0,15
2006,Botswana,BWA,Canada,CAN,5,0,5,0,10
2006,Brazil,BRA,Canada,CAN,23,0,78,15,116
2006,Bosnia and Herzegovina,BIH,Canada,CAN,16,0,5,5,26
2006,Bulgaria,BGR,Canada,CAN,41,0,15,5,61
2006,Belize,BLZ,Canada,CAN,5,0,0,0,5
2006,Cambodia,KHM,Canada,CAN,10,0,14,0,24
2006,Central African Rep.,CAF,Canada,CAN,5,0,11,0,16
2006,Chad,TCD,Canada,CAN,33,0,15,0,48
2006,China,CHN,Canada,CAN,768,0,593,191,1552
2006,Chile,CHL,Canada,CAN,5,0,33,5,43
2006,Cameroon,CMR,Canada,CAN,46,0,30,5,81
2006,Congo,COG,Canada,CAN,10,0,10,0,20
2006,Dem. Rep. of the Congo,COD,Canada,CAN,203,0,108,11,322
2006,Colombia,COL,Canada,CAN,1084,0,239,87,1410
2006,Costa Rica,CRI,Canada,CAN,12,0,75,16,103
2006,Cuba,CUB,Canada,CAN,124,0,22,22,168
2006,Czechia,CZE,Canada,CAN,0,0,5,0,5
2006,Denmark,DNK,Canada,CAN,5,0,0,0,5
2006,Djibouti,DJI,Canada,CAN,5,0,0,0,5
2006,Dominica,DMA,Canada,CAN,5,0,0,0,5
2006,Dominican Rep.,DOM,Canada,CAN,16,0,30,23,69
2006,Ecuador,ECU,Canada,CAN,19,0,18,5,42
2006,Eritrea,ERI,Canada,CAN,116,0,15,0,131
2006,Ethiopia,ETH,Canada,CAN,130,0,44,10,184
2006,Fiji,FJI,Canada,CAN,21,0,10,5,36
2006,France,FRA,Canada,CAN,0,0,11,5,16
2006,Gabon,GAB,Canada,CAN,0,0,5,0,5
2006,Gambia,GMB,Canada,CAN,5,0,0,0,5
2006,Palestinian,PSE,Canada,CAN,24,0,10,11,45
2006,United Kingdom of Great Britain and Northern Ireland,GBR,Canada,CAN,0,0,10,0,10
2006,Georgia,GEO,Canada,CAN,35,0,15,5,55
2006,Germany,DEU,Canada,CAN,0,0,18,10,28
2006,Ghana,GHA,Canada,CAN,16,0,40,5,61
2006,Greece,GRC,Canada,CAN,5,0,5,5,15
2006,Grenada,GRD,Canada,CAN,21,0,81,10,112
2006,Guatemala,GTM,Canada,CAN,49,0,57,11,117
2006,Guinea,GIN,Canada,CAN,37,0,42,0,79
2006,Guyana,GUY,Canada,CAN,97,0,189,38,324
2006,Haiti,HTI,Canada,CAN,208,0,166,20,394
2006,"China, Hong Kong SAR",HKG,Canada,CAN,0,0,5,5,10
2006,Honduras,HND,Canada,CAN,42,0,59,51,152
2006,Croatia,HRV,Canada,CAN,17,0,5,0,22
2006,Hungary,HUN,Canada,CAN,67,0,41,18,126
2006,Cote d'Ivoire,CIV,Canada,CAN,29,0,26,0,55
2006,India,IND,Canada,CAN,236,0,262,183,681
2006,Indonesia,IDN,Canada,CAN,27,0,77,16,120
2006,Ireland,IRL,Canada,CAN,5,0,0,0,5
2006,Iran (Islamic Rep. of),IRN,Canada,CAN,228,0,45,26,299
2006,Iraq,IRQ,Canada,CAN,91,0,5,10,106
2006,Israel,ISR,Canada,CAN,45,0,148,57,250
2006,Italy,ITA,Canada,CAN,0,0,10,5,15
2006,Jamaica,JAM,Canada,CAN,47,0,115,15,177
2006,Jordan,JOR,Canada,CAN,34,0,20,5,59
2006,Kazakhstan,KAZ,Canada,CAN,10,0,5,0,15
2006,Kenya,KEN,Canada,CAN,35,0,29,5,69
2006,Kyrgyzstan,KGZ,Canada,CAN,5,0,0,0,5
2006,Rep. of Korea,KOR,Canada,CAN,40,0,120,33,193
2006,Kuwait,KWT,Canada,CAN,5,0,0,0,5
2006,Liberia,LBR,Canada,CAN,5,0,10,0,15
2006,Libya,LBY,Canada,CAN,23,0,5,0,28
2006,Saint Lucia,LCA,Canada,CAN,49,0,149,23,221
2006,Lebanon,LBN,Canada,CAN,78,0,55,38,171
2006,Sri Lanka,LKA,Canada,CAN,661,0,202,39,902
2006,Lithuania,LTU,Canada,CAN,5,0,0,0,5
2006,Latvia,LVA,Canada,CAN,5,0,0,0,5
2006,Mauritania,MRT,Canada,CAN,31,0,34,5,70
2006,North Macedonia,MKD,Canada,CAN,20,0,5,5,30
2006,Rep. of Moldova,MDA,Canada,CAN,15,0,11,0,26
2006,Mexico,MEX,Canada,CAN,931,0,1693,659,3283
2006,Malaysia,MYS,Canada,CAN,19,0,40,10,69
2006,Mongolia,MNG,Canada,CAN,12,0,5,0,17
2006,Morocco,MAR,Canada,CAN,15,0,17,0,32
2006,Myanmar,MMR,Canada,CAN,26,0,5,0,31
2006,Namibia,NAM,Canada,CAN,5,0,0,0,5
2006,Nepal,NPL,Canada,CAN,70,0,0,5,75
2006,Netherlands,NLD,Canada,CAN,10,0,13,0,23
2006,Niger,NER,Canada,CAN,10,0,0,0,10
2006,Nicaragua,NIC,Canada,CAN,5,0,16,5,26
2006,Nigeria,NGA,Canada,CAN,189,0,236,45,470
2006,Norway,NOR,Canada,CAN,0,0,0,10,10
2006,New Zealand,NZL,Canada,CAN,0,0,0,5,5
2006,Pakistan,PAK,Canada,CAN,431,0,455,60,946
2006,Panama,PAN,Canada,CAN,5,0,22,0,27
2006,Paraguay,PRY,Canada,CAN,0,0,5,0,5
2006,Peru,PER,Canada,CAN,52,0,108,19,179
2006,Philippines,PHL,Canada,CAN,15,0,97,5,117
2006,Poland,POL,Canada,CAN,10,0,39,5,54
2006,Portugal,PRT,Canada,CAN,5,0,79,10,94
2006,Romania,ROU,Canada,CAN,70,0,25,29,124
2006,South Africa,ZAF,Canada,CAN,0,0,5,5,10
2006,Russian Federation,RUS,Canada,CAN,115,0,37,24,176
2006,Rwanda,RWA,Canada,CAN,95,0,32,5,132
2006,El Salvador,SLV,Canada,CAN,56,0,108,5,169
2006,Saudi Arabia,SAU,Canada,CAN,11,0,5,0,16
2006,Serbia and Kosovo: S/RES/1244 (1999),SRB,Canada,CAN,40,0,30,11,81
2006,Senegal,SEN,Canada,CAN,11,0,10,0,21
2006,Singapore,SGP,Canada,CAN,5,0,5,0,10
2006,Sierra Leone,SLE,Canada,CAN,10,0,13,0,23
2006,Solomon Islands,SLB,Canada,CAN,10,0,0,0,10
2006,Somalia,SOM,Canada,CAN,95,0,20,22,137
2006,Spain,ESP,Canada,CAN,5,0,5,5,15
2006,Viet Nam,VNM,Canada,CAN,5,0,18,10,33
2006,Sudan,SDN,Canada,CAN,32,0,5,10,47
2006,Slovakia,SVK,Canada,CAN,0,0,12,0,12
2006,Syrian Arab Rep.,SYR,Canada,CAN,42,0,12,10,64
2006,United Rep. of Tanzania,TZA,Canada,CAN,10,0,5,0,15
2006,Thailand,THA,Canada,CAN,5,0,5,0,10
2006,Tajikistan,TJK,Canada,CAN,5,0,0,0,5
2006,Togo,TGO,Canada,CAN,12,0,19,0,31
2006,Trinidad and Tobago,TTO,Canada,CAN,45,0,116,33,194
2006,Tunisia,TUN,Canada,CAN,11,0,13,5,29
2006,Turkey,TUR,Canada,CAN,96,0,89,36,221
2006,Uganda,UGA,Canada,CAN,26,0,11,10,47
2006,Ukraine,UKR,Canada,CAN,124,0,81,34,239
2006,Uruguay,URY,Canada,CAN,5,0,12,0,17
2006,United States of America,USA,Canada,CAN,10,0,147,100,257
2006,Uzbekistan,UZB,Canada,CAN,27,0,0,0,27
2006,Saint Vincent and the Grenadines,VCT,Canada,CAN,147,0,224,39,410
2006,Venezuela (Bolivarian Republic of),VEN,Canada,CAN,34,0,53,5,92
2006,Yemen,YEM,Canada,CAN,11,0,15,0,26
2006,Zambia,ZMB,Canada,CAN,5,0,10,0,15
2006,Zimbabwe,ZWE,Canada,CAN,455,0,219,25,699
2006,Angola,AGO,Central African Rep.,CAF,13,0,0,0,13
2006,Chad,TCD,Central African Rep.,CAF,109,0,12,0,121
2006,Dem. Rep. of the Congo,COD,Central African Rep.,CAF,246,0,0,0,246
2006,Cote d'Ivoire,CIV,Central African Rep.,CAF,5,0,0,14,19
2006,Liberia,LBR,Central African Rep.,CAF,5,0,0,19,24
2006,Rwanda,RWA,Central African Rep.,CAF,17,0,0,0,17
2006,Sudan,SDN,Central African Rep.,CAF,70,0,0,0,70
2006,Colombia,COL,Chile,CHL,267,0,39,18,324
2006,Costa Rica,CRI,Chile,CHL,5,0,0,0,5
2006,Ecuador,ECU,Chile,CHL,5,0,0,0,5
2006,Haiti,HTI,Chile,CHL,5,0,0,0,5
2006,Cuba,CUB,Colombia,COL,0,0,15,0,15
2006,Guinea-Bissau,GNB,Colombia,COL,0,0,5,0,5
2006,Venezuela (Bolivarian Republic of),VEN,Colombia,COL,0,0,0,5,5
2006,Afghanistan,AFG,Cyprus,CYP,0,0,19,33,52
2006,Algeria,DZA,Cyprus,CYP,0,0,5,0,5
2006,Egypt,EGY,Cyprus,CYP,0,0,5,26,31
2006,Armenia,ARM,Cyprus,CYP,0,0,0,25,25
2006,Bangladesh,BGD,Cyprus,CYP,0,0,372,357,729
2006,Belarus,BLR,Cyprus,CYP,0,0,0,5,5
2006,China,CHN,Cyprus,CYP,0,0,38,228,266
2006,Cameroon,CMR,Cyprus,CYP,0,0,12,0,12
2006,Palestinian,PSE,Cyprus,CYP,5,44,14,124,187
2006,Georgia,GEO,Cyprus,CYP,0,32,250,344,626
2006,Ghana,GHA,Cyprus,CYP,0,0,5,5,10
2006,India,IND,Cyprus,CYP,0,0,68,196,264
2006,Iran (Islamic Rep. of),IRN,Cyprus,CYP,21,5,174,244,444
2006,Iraq,IRQ,Cyprus,CYP,0,48,11,50,109
2006,Jordan,JOR,Cyprus,CYP,0,0,0,16,16
2006,Kazakhstan,KAZ,Cyprus,CYP,0,0,5,25,30
2006,Kenya,KEN,Cyprus,CYP,0,0,0,5,5
2006,Lebanon,LBN,Cyprus,CYP,0,0,5,24,29
2006,Sri Lanka,LKA,Cyprus,CYP,0,0,276,346,622
2006,North Macedonia,MKD,Cyprus,CYP,0,0,0,5,5
2006,Rep. of Moldova,MDA,Cyprus,CYP,0,5,12,54,71
2006,Morocco,MAR,Cyprus,CYP,0,0,0,5,5
2006,Nepal,NPL,Cyprus,CYP,0,0,10,15,25
2006,Pakistan,PAK,Cyprus,CYP,0,0,203,458,661
2006,Philippines,PHL,Cyprus,CYP,0,0,0,5,5
2006,Romania,ROU,Cyprus,CYP,0,0,0,5,5
2006,Russian Federation,RUS,Cyprus,CYP,0,11,53,197,261
2006,Senegal,SEN,Cyprus,CYP,0,0,5,5,10
2006,Syrian Arab Rep.,SYR,Cyprus,CYP,5,5,127,257,394
2006,Tunisia,TUN,Cyprus,CYP,0,0,0,5,5
2006,Turkey,TUR,Cyprus,CYP,5,5,50,158,218
2006,Ukraine,UKR,Cyprus,CYP,0,0,45,386,431
2006,Uzbekistan,UZB,Cyprus,CYP,0,0,5,12,17
2006,Afghanistan,AFG,Czechia,CZE,5,0,0,0,5
2006,Algeria,DZA,Czechia,CZE,0,0,54,5,59
2006,Egypt,EGY,Czechia,CZE,0,0,396,0,396
2006,Armenia,ARM,Czechia,CZE,5,0,50,0,55
2006,Azerbaijan,AZE,Czechia,CZE,5,0,0,0,5
2006,Belarus,BLR,Czechia,CZE,66,0,13,98,177
2006,Bosnia and Herzegovina,BIH,Czechia,CZE,5,0,5,0,10
2006,Bulgaria,BGR,Czechia,CZE,0,0,13,0,13
2006,China,CHN,Czechia,CZE,0,0,112,19,131
2006,Cameroon,CMR,Czechia,CZE,0,0,13,0,13
2006,Dem. Rep. of the Congo,COD,Czechia,CZE,0,0,0,11,11
2006,Cuba,CUB,Czechia,CZE,0,0,0,11,11
2006,Georgia,GEO,Czechia,CZE,0,0,34,10,44
2006,Ghana,GHA,Czechia,CZE,0,0,10,0,10
2006,Guinea,GIN,Czechia,CZE,0,0,11,0,11
2006,India,IND,Czechia,CZE,0,0,80,42,122
2006,Iraq,IRQ,Czechia,CZE,5,0,10,39,54
2006,Kazakhstan,KAZ,Czechia,CZE,31,0,43,0,74
2006,Kyrgyzstan,KGZ,Czechia,CZE,5,0,52,0,57
2006,Sri Lanka,LKA,Czechia,CZE,0,0,12,5,17
2006,North Macedonia,MKD,Czechia,CZE,0,0,11,0,11
2006,Rep. of Moldova,MDA,Czechia,CZE,0,0,29,0,29
2006,Mongolia,MNG,Czechia,CZE,0,0,94,0,94
2006,Morocco,MAR,Czechia,CZE,0,0,5,0,5
2006,Nigeria,NGA,Czechia,CZE,0,0,68,0,68
2006,Pakistan,PAK,Czechia,CZE,5,0,32,10,47
2006,Romania,ROU,Czechia,CZE,0,0,16,0,16
2006,Russian Federation,RUS,Czechia,CZE,51,0,117,32,200
2006,Senegal,SEN,Czechia,CZE,0,0,10,0,10
2006,Sierra Leone,SLE,Czechia,CZE,0,0,10,0,10
2006,Somalia,SOM,Czechia,CZE,5,0,0,5,10
2006,Viet Nam,VNM,Czechia,CZE,0,0,122,18,140
2006,Syrian Arab Rep.,SYR,Czechia,CZE,5,0,5,10,20
2006,Tunisia,TUN,Czechia,CZE,0,0,5,5,10
2006,Turkey,TUR,Czechia,CZE,0,0,44,22,66
2006,Ukraine,UKR,Czechia,CZE,31,0,562,48,641
2006,Uzbekistan,UZB,Czechia,CZE,0,0,0,17,17
2006,Stateless,XXA,Czechia,CZE,23,0,70,12,105
2006,Unknown ,,Czechia,CZE,10,0,84,69,163
2006,Afghanistan,AFG,Denmark,DNK,0,13,84,0,97
2006,Albania,ALB,Denmark,DNK,0,0,0,5,5
2006,Algeria,DZA,Denmark,DNK,0,0,5,0,5
2006,Armenia,ARM,Denmark,DNK,0,0,11,0,11
2006,Azerbaijan,AZE,Denmark,DNK,0,0,10,0,10
2006,Burundi,BDI,Denmark,DNK,0,0,19,0,19
2006,Bangladesh,BGD,Denmark,DNK,0,0,5,0,5
2006,Burkina Faso,BFA,Denmark,DNK,0,0,5,0,5
2006,Bosnia and Herzegovina,BIH,Denmark,DNK,0,0,5,12,17
2006,Bulgaria,BGR,Denmark,DNK,0,0,0,10,10
2006,Dem. Rep. of the Congo,COD,Denmark,DNK,0,10,22,0,32
2006,Cabo Verde,CPV,Denmark,DNK,0,0,16,5,21
2006,Ethiopia,ETH,Denmark,DNK,0,0,10,0,10
2006,Palestinian,PSE,Denmark,DNK,14,0,18,15,47
2006,Georgia,GEO,Denmark,DNK,0,0,5,0,5
2006,Ghana,GHA,Denmark,DNK,0,0,0,5,5
2006,India,IND,Denmark,DNK,0,0,10,0,10
2006,Iran (Islamic Rep. of),IRN,Denmark,DNK,23,5,40,0,68
2006,Iraq,IRQ,Denmark,DNK,0,0,101,0,101
2006,Israel,ISR,Denmark,DNK,0,0,0,5,5
2006,Jordan,JOR,Denmark,DNK,0,0,5,0,5
2006,Libya,LBY,Denmark,DNK,0,0,10,0,10
2006,Lebanon,LBN,Denmark,DNK,5,0,5,5,15
2006,Sri Lanka,LKA,Denmark,DNK,0,0,17,5,22
2006,Latvia,LVA,Denmark,DNK,0,0,0,5,5
2006,North Macedonia,MKD,Denmark,DNK,0,0,0,10,10
2006,Morocco,MAR,Denmark,DNK,0,0,0,5,5
2006,Myanmar,MMR,Denmark,DNK,5,0,19,0,24
2006,Nigeria,NGA,Denmark,DNK,0,0,12,13,25
2006,Pakistan,PAK,Denmark,DNK,0,0,11,0,11
2006,Poland,POL,Denmark,DNK,0,0,0,5,5
2006,Romania,ROU,Denmark,DNK,0,0,0,5,5
2006,Russian Federation,RUS,Denmark,DNK,0,18,19,0,37
2006,Rwanda,RWA,Denmark,DNK,0,0,10,0,10
2006,Serbia and Kosovo: S/RES/1244 (1999),SRB,Denmark,DNK,0,0,56,82,138
2006,Somalia,SOM,Denmark,DNK,0,10,39,0,49
2006,Syrian Arab Rep.,SYR,Denmark,DNK,21,0,5,0,26
2006,Turkey,TUR,Denmark,DNK,0,0,10,11,21
2006,Stateless,XXA,Denmark,DNK,5,0,0,0,5
2006,Unknown ,,Denmark,DNK,28,5,0,0,33
2006,Afghanistan,AFG,Finland,FIN,0,132,51,5,188
2006,Albania,ALB,Finland,FIN,0,0,14,0,14
2006,Algeria,DZA,Finland,FIN,0,0,24,0,24
2006,Angola,AGO,Finland,FIN,0,10,23,0,33
2006,Egypt,EGY,Finland,FIN,0,0,5,0,5
2006,Armenia,ARM,Finland,FIN,0,0,28,5,33
2006,Azerbaijan,AZE,Finland,FIN,0,0,20,0,20
2006,Bangladesh,BGD,Finland,FIN,0,0,19,13,32
2006,Belarus,BLR,Finland,FIN,0,0,64,23,87
2006,Bosnia and Herzegovina,BIH,Finland,FIN,0,10,17,5,32
2006,Bulgaria,BGR,Finland,FIN,0,0,399,58,457
2006,China,CHN,Finland,FIN,0,5,0,5,10
2006,Cameroon,CMR,Finland,FIN,0,5,23,5,33
2006,Dem. Rep. of the Congo,COD,Finland,FIN,0,11,27,0,38
2006,Cuba,CUB,Finland,FIN,0,0,5,0,5
2006,Ethiopia,ETH,Finland,FIN,0,5,5,0,10
2006,Gambia,GMB,Finland,FIN,0,0,10,0,10
2006,Georgia,GEO,Finland,FIN,0,0,31,0,31
2006,Ghana,GHA,Finland,FIN,0,0,5,5,10
2006,Croatia,HRV,Finland,FIN,0,0,12,0,12
2006,India,IND,Finland,FIN,0,0,15,11,26
2006,Iran (Islamic Rep. of),IRN,Finland,FIN,0,25,38,10,73
2006,Iraq,IRQ,Finland,FIN,12,113,73,36,234
2006,Israel,ISR,Finland,FIN,0,0,5,5,10
2006,Kazakhstan,KAZ,Finland,FIN,0,0,0,5,5
2006,Kyrgyzstan,KGZ,Finland,FIN,0,0,12,0,12
2006,Liberia,LBR,Finland,FIN,0,0,5,0,5
2006,Libya,LBY,Finland,FIN,0,0,10,5,15
2006,Sri Lanka,LKA,Finland,FIN,0,0,15,0,15
2006,Latvia,LVA,Finland,FIN,0,0,0,5,5
2006,Mauritania,MRT,Finland,FIN,0,0,5,0,5
2006,North Macedonia,MKD,Finland,FIN,0,0,19,5,24
2006,Rep. of Moldova,MDA,Finland,FIN,0,0,10,5,15
2006,Mongolia,MNG,Finland,FIN,0,0,0,5,5
2006,Nepal,NPL,Finland,FIN,0,0,5,0,5
2006,Nigeria,NGA,Finland,FIN,0,5,61,10,76
2006,Pakistan,PAK,Finland,FIN,0,5,5,0,10
2006,Romania,ROU,Finland,FIN,0,0,10,10,20
2006,Russian Federation,RUS,Finland,FIN,20,25,89,21,155
2006,Rwanda,RWA,Finland,FIN,0,0,5,0,5
2006,Serbia and Kosovo: S/RES/1244 (1999),SRB,Finland,FIN,0,31,185,13,229
2006,Somalia,SOM,Finland,FIN,0,184,19,5,208
2006,Sudan,SDN,Finland,FIN,0,0,5,0,5
2006,Slovakia,SVK,Finland,FIN,0,0,5,0,5
2006,Syrian Arab Rep.,SYR,Finland,FIN,0,5,5,0,10
2006,Tunisia,TUN,Finland,FIN,0,0,5,0,5
2006,Turkey,TUR,Finland,FIN,0,12,37,0,49
2006,Ukraine,UKR,Finland,FIN,0,0,5,0,5
2006,United States of America,USA,Finland,FIN,0,0,5,0,5
2006,Uzbekistan,UZB,Finland,FIN,0,5,5,0,10
2006,Stateless,XXA,Finland,FIN,0,5,28,0,33
2006,Unknown ,,Finland,FIN,0,0,5,0,5
2006,Afghanistan,AFG,France,FRA,20,0,84,0,104
2006,Albania,ALB,France,FRA,11,10,387,0,408
2006,Algeria,DZA,France,FRA,34,18,1141,0,1193
2006,Angola,AGO,France,FRA,45,0,702,0,747
2006,Egypt,EGY,France,FRA,5,0,23,0,28
2006,Armenia,ARM,France,FRA,37,5,1293,0,1335
2006,Azerbaijan,AZE,France,FRA,47,0,500,0,547
2006,Burundi,BDI,France,FRA,5,0,18,0,23
2006,Bangladesh,BGD,France,FRA,25,0,1133,0,1158
2006,Belarus,BLR,France,FRA,0,0,163,0,163
2006,Brazil,BRA,France,FRA,5,5,10,0,20
2006,Bosnia and Herzegovina,BIH,France,FRA,31,5,457,0,493
2006,Central African Rep.,CAF,France,FRA,35,0,161,0,196
2006,Chad,TCD,France,FRA,17,0,169,0,186
2006,China,CHN,France,FRA,38,0,1226,0,1264
2006,Cameroon,CMR,France,FRA,22,0,267,0,289
2006,Congo,COG,France,FRA,98,0,910,0,1008
2006,Dem. Rep. of the Congo,COD,France,FRA,235,5,2663,0,2903
2006,Comoros,COM,France,FRA,5,0,95,0,100
2006,Colombia,COL,France,FRA,30,5,120,0,155
2006,Cuba,CUB,France,FRA,13,0,40,0,53
2006,Djibouti,DJI,France,FRA,5,0,10,0,15
2006,Dominican Rep.,DOM,France,FRA,0,0,74,0,74
2006,Eritrea,ERI,France,FRA,30,0,13,0,43
2006,Ethiopia,ETH,France,FRA,24,0,40,0,64
2006,Palestinian,PSE,France,FRA,0,5,47,0,52
2006,Georgia,GEO,France,FRA,34,5,537,0,576
2006,Ghana,GHA,France,FRA,0,0,44,0,44
2006,Guinea-Bissau,GNB,France,FRA,16,0,74,0,90
2006,Guinea,GIN,France,FRA,89,0,933,0,1022
2006,Haiti,HTI,France,FRA,232,63,3695,0,3990
2006,Cote d'Ivoire,CIV,France,FRA,115,0,959,0,1074
2006,India,IND,France,FRA,5,0,146,0,151
2006,Iran (Islamic Rep. of),IRN,France,FRA,30,0,97,0,127
2006,Iraq,IRQ,France,FRA,14,17,103,0,134
2006,Kazakhstan,KAZ,France,FRA,5,0,100,0,105
2006,Kenya,KEN,France,FRA,0,0,10,0,10
2006,Kyrgyzstan,KGZ,France,FRA,5,0,40,0,45
2006,Lao People's Dem. Rep.,LAO,France,FRA,5,0,5,0,10
2006,Liberia,LBR,France,FRA,5,0,42,0,47
2006,Sri Lanka,LKA,France,FRA,143,0,2658,0,2801
2006,Madagascar,MDG,France,FRA,13,0,128,0,141
2006,Mauritania,MRT,France,FRA,64,0,1041,0,1105
2006,North Macedonia,MKD,France,FRA,5,0,152,0,157
2006,Rep. of Moldova,MDA,France,FRA,5,0,643,0,648
2006,Mali,MLI,France,FRA,19,0,148,0,167
2006,Mongolia,MNG,France,FRA,5,0,125,0,130
2006,Morocco,MAR,France,FRA,5,0,37,0,42
2006,Myanmar,MMR,France,FRA,5,0,25,0,30
2006,Nepal,NPL,France,FRA,5,0,26,0,31
2006,Nigeria,NGA,France,FRA,10,0,647,0,657
2006,Pakistan,PAK,France,FRA,5,0,427,0,432
2006,Peru,PER,France,FRA,5,0,45,0,50
2006,Russian Federation,RUS,France,FRA,353,17,1727,0,2097
2006,Rwanda,RWA,France,FRA,142,0,131,0,273
2006,Serbia and Kosovo: S/RES/1244 (1999),SRB,France,FRA,78,0,2475,0,2553
2006,Senegal,SEN,France,FRA,0,0,57,0,57
2006,Sierra Leone,SLE,France,FRA,5,0,115,0,120
2006,Somalia,SOM,France,FRA,15,0,26,0,41
2006,Viet Nam,VNM,France,FRA,11,0,10,0,21
2006,Sudan,SDN,France,FRA,114,0,220,0,334
2006,Syrian Arab Rep.,SYR,France,FRA,5,0,22,0,27
2006,Togo,TGO,France,FRA,32,0,229,0,261
2006,Tunisia,TUN,France,FRA,13,0,23,0,36
2006,Turkey,TUR,France,FRA,206,0,4285,0,4491
2006,Ukraine,UKR,France,FRA,5,0,160,0,165
2006,Uzbekistan,UZB,France,FRA,0,0,43,0,43
2006,Stateless,XXA,France,FRA,75,0,144,0,219
2006,Unknown ,,France,FRA,33,0,489,0,522
2006,Cote d'Ivoire,CIV,Gambia,GMB,41,0,0,0,41
2006,Afghanistan,AFG,United Kingdom of Great Britain and Northern Ireland,GBR,62,775,1179,371,2387
2006,Albania,ALB,United Kingdom of Great Britain and Northern Ireland,GBR,0,38,107,13,158
2006,Algeria,DZA,United Kingdom of Great Britain and Northern Ireland,GBR,0,32,144,62,238
2006,Angola,AGO,United Kingdom of Great Britain and Northern Ireland,GBR,12,15,61,17,105
2006,Egypt,EGY,United Kingdom of Great Britain and Northern Ireland,GBR,5,0,16,5,26
2006,Armenia,ARM,United Kingdom of Great Britain and Northern Ireland,GBR,0,0,22,0,22
2006,Azerbaijan,AZE,United Kingdom of Great Britain and Northern Ireland,GBR,5,0,37,14,56
2006,Burundi,BDI,United Kingdom of Great Britain and Northern Ireland,GBR,5,5,29,13,52
2006,Benin,BEN,United Kingdom of Great Britain and Northern Ireland,GBR,0,5,5,0,10
2006,Bangladesh,BGD,United Kingdom of Great Britain and Northern Ireland,GBR,5,84,264,41,394
2006,Bhutan,BTN,United Kingdom of Great Britain and Northern Ireland,GBR,5,0,5,5,15
2006,Belarus,BLR,United Kingdom of Great Britain and Northern Ireland,GBR,12,0,61,0,73
2006,Bolivia (Plurinational State of),BOL,United Kingdom of Great Britain and Northern Ireland,GBR,0,5,10,0,15
2006,Botswana,BWA,United Kingdom of Great Britain and Northern Ireland,GBR,0,0,5,0,5
2006,Brazil,BRA,United Kingdom of Great Britain and Northern Ireland,GBR,0,0,5,0,5
2006,Bosnia and Herzegovina,BIH,United Kingdom of Great Britain and Northern Ireland,GBR,0,5,28,20,53
2006,Bulgaria,BGR,United Kingdom of Great Britain and Northern Ireland,GBR,0,0,5,0,5
2006,Central African Rep.,CAF,United Kingdom of Great Britain and Northern Ireland,GBR,0,0,5,0,5
2006,Chad,TCD,United Kingdom of Great Britain and Northern Ireland,GBR,0,0,10,5,15
2006,China,CHN,United Kingdom of Great Britain and Northern Ireland,GBR,16,114,954,708,1792
2006,Chile,CHL,United Kingdom of Great Britain and Northern Ireland,GBR,0,0,5,0,5
2006,Cameroon,CMR,United Kingdom of Great Britain and Northern Ireland,GBR,11,19,191,21,242
2006,Congo,COG,United Kingdom of Great Britain and Northern Ireland,GBR,0,10,35,0,45
2006,Dem. Rep. of the Congo,COD,United Kingdom of Great Britain and Northern Ireland,GBR,60,83,559,70,772
2006,Colombia,COL,United Kingdom of Great Britain and Northern Ireland,GBR,5,0,50,5,60
2006,Cuba,CUB,United Kingdom of Great Britain and Northern Ireland,GBR,0,0,15,0,15
2006,Czechia,CZE,United Kingdom of Great Britain and Northern Ireland,GBR,0,0,5,0,5
2006,Djibouti,DJI,United Kingdom of Great Britain and Northern Ireland,GBR,0,0,0,5,5
2006,Ecuador,ECU,United Kingdom of Great Britain and Northern Ireland,GBR,0,0,13,0,13
2006,Eritrea,ERI,United Kingdom of Great Britain and Northern Ireland,GBR,819,77,776,638,2310
2006,Ethiopia,ETH,United Kingdom of Great Britain and Northern Ireland,GBR,22,20,159,49,250
2006,Gambia,GMB,United Kingdom of Great Britain and Northern Ireland,GBR,10,5,110,5,130
2006,Palestinian,PSE,United Kingdom of Great Britain and Northern Ireland,GBR,0,5,203,72,280
2006,Georgia,GEO,United Kingdom of Great Britain and Northern Ireland,GBR,0,0,52,11,63
2006,Ghana,GHA,United Kingdom of Great Britain and Northern Ireland,GBR,0,5,92,5,102
2006,Grenada,GRD,United Kingdom of Great Britain and Northern Ireland,GBR,0,0,5,0,5
2006,Guinea,GIN,United Kingdom of Great Britain and Northern Ireland,GBR,0,39,79,14,132
2006,Guyana,GUY,United Kingdom of Great Britain and Northern Ireland,GBR,0,0,5,0,5
2006,Croatia,HRV,United Kingdom of Great Britain and Northern Ireland,GBR,0,0,16,5,21
2006,Cote d'Ivoire,CIV,United Kingdom of Great Britain and Northern Ireland,GBR,10,21,141,16,188
2006,India,IND,United Kingdom of Great Britain and Northern Ireland,GBR,0,18,521,82,621
2006,Indonesia,IDN,United Kingdom of Great Britain and Northern Ireland,GBR,0,0,5,0,5
2006,Iran (Islamic Rep. of),IRN,United Kingdom of Great Britain and Northern Ireland,GBR,106,272,1876,275,2529
2006,Iraq,IRQ,United Kingdom of Great Britain and Northern Ireland,GBR,44,63,746,120,973
2006,Israel,ISR,United Kingdom of Great Britain and Northern Ireland,GBR,0,0,20,0,20
2006,Jamaica,JAM,United Kingdom of Great Britain and Northern Ireland,GBR,0,10,187,10,207
2006,Jordan,JOR,United Kingdom of Great Britain and Northern Ireland,GBR,0,0,14,0,14
2006,Kazakhstan,KAZ,United Kingdom of Great Britain and Northern Ireland,GBR,0,0,5,0,5
2006,Kenya,KEN,United Kingdom of Great Britain and Northern Ireland,GBR,0,10,89,5,104
2006,Kyrgyzstan,KGZ,United Kingdom of Great Britain and Northern Ireland,GBR,0,0,5,0,5
2006,Dem. People's Rep. of Korea,PRK,United Kingdom of Great Britain and Northern Ireland,GBR,20,11,10,5,46
2006,Kuwait,KWT,United Kingdom of Great Britain and Northern Ireland,GBR,59,5,91,17,172
2006,Liberia,LBR,United Kingdom of Great Britain and Northern Ireland,GBR,0,5,41,5,51
2006,Libya,LBY,United Kingdom of Great Britain and Northern Ireland,GBR,12,5,103,14,134
2006,Lebanon,LBN,United Kingdom of Great Britain and Northern Ireland,GBR,0,11,166,15,192
2006,Sri Lanka,LKA,United Kingdom of Great Britain and Northern Ireland,GBR,5,59,401,39,504
2006,Rep. of Moldova,MDA,United Kingdom of Great Britain and Northern Ireland,GBR,0,10,32,17,59
2006,Mali,MLI,United Kingdom of Great Britain and Northern Ireland,GBR,0,0,10,0,10
2006,Malaysia,MYS,United Kingdom of Great Britain and Northern Ireland,GBR,0,0,11,0,11
2006,Malawi,MWI,United Kingdom of Great Britain and Northern Ireland,GBR,0,5,64,5,74
2006,Mongolia,MNG,United Kingdom of Great Britain and Northern Ireland,GBR,0,5,30,12,47
2006,Morocco,MAR,United Kingdom of Great Britain and Northern Ireland,GBR,0,0,15,11,26
2006,Mozambique,MOZ,United Kingdom of Great Britain and Northern Ireland,GBR,0,0,5,0,5
2006,Mauritius,MUS,United Kingdom of Great Britain and Northern Ireland,GBR,0,0,16,0,16
2006,Myanmar,MMR,United Kingdom of Great Britain and Northern Ireland,GBR,29,5,43,0,77
2006,Namibia,NAM,United Kingdom of Great Britain and Northern Ireland,GBR,0,0,10,0,10
2006,Nepal,NPL,United Kingdom of Great Britain and Northern Ireland,GBR,0,0,48,0,48
2006,Niger,NER,United Kingdom of Great Britain and Northern Ireland,GBR,0,0,0,5,5
2006,Nigeria,NGA,United Kingdom of Great Britain and Northern Ireland,GBR,5,59,656,84,804
2006,Pakistan,PAK,United Kingdom of Great Britain and Northern Ireland,GBR,134,76,1327,117,1654
2006,Peru,PER,United Kingdom of Great Britain and Northern Ireland,GBR,0,0,5,0,5
2006,Philippines,PHL,United Kingdom of Great Britain and Northern Ireland,GBR,0,0,5,0,5
2006,Poland,POL,United Kingdom of Great Britain and Northern Ireland,GBR,0,0,5,0,5
2006,Romania,ROU,United Kingdom of Great Britain and Northern Ireland,GBR,0,12,29,22,63
2006,South Africa,ZAF,United Kingdom of Great Britain and Northern Ireland,GBR,0,0,87,5,92
2006,Russian Federation,RUS,United Kingdom of Great Britain and Northern Ireland,GBR,22,0,105,14,141
2006,Rwanda,RWA,United Kingdom of Great Britain and Northern Ireland,GBR,0,0,14,5,19
2006,Serbia and Kosovo: S/RES/1244 (1999),SRB,United Kingdom of Great Britain and Northern Ireland,GBR,5,27,161,19,212
2006,Senegal,SEN,United Kingdom of Great Britain and Northern Ireland,GBR,0,0,13,0,13
2006,Sierra Leone,SLE,United Kingdom of Great Britain and Northern Ireland,GBR,0,21,84,17,122
2006,Somalia,SOM,United Kingdom of Great Britain and Northern Ireland,GBR,775,165,861,225,2026
2006,Viet Nam,VNM,United Kingdom of Great Britain and Northern Ireland,GBR,0,21,30,30,81
2006,Sudan,SDN,United Kingdom of Great Britain and Northern Ireland,GBR,35,40,430,142,647
2006,Eswatini,SWZ,United Kingdom of Great Britain and Northern Ireland,GBR,0,0,5,0,5
2006,Syrian Arab Rep.,SYR,United Kingdom of Great Britain and Northern Ireland,GBR,25,16,131,30,202
2006,United Rep. of Tanzania,TZA,United Kingdom of Great Britain and Northern Ireland,GBR,0,0,18,0,18
2006,Turkmenistan,TKM,United Kingdom of Great Britain and Northern Ireland,GBR,5,0,11,0,16
2006,Togo,TGO,United Kingdom of Great Britain and Northern Ireland,GBR,5,0,19,5,29
2006,Trinidad and Tobago,TTO,United Kingdom of Great Britain and Northern Ireland,GBR,0,0,5,0,5
2006,Tunisia,TUN,United Kingdom of Great Britain and Northern Ireland,GBR,0,0,14,5,19
2006,Turkey,TUR,United Kingdom of Great Britain and Northern Ireland,GBR,18,37,434,53,542
2006,Uganda,UGA,United Kingdom of Great Britain and Northern Ireland,GBR,5,17,134,10,166
2006,Ukraine,UKR,United Kingdom of Great Britain and Northern Ireland,GBR,0,5,34,5,44
2006,Uzbekistan,UZB,United Kingdom of Great Britain and Northern Ireland,GBR,10,0,16,0,26
2006,Venezuela (Bolivarian Republic of),VEN,United Kingdom of Great Britain and Northern Ireland,GBR,0,0,5,0,5
2006,Yemen,YEM,United Kingdom of Great Britain and Northern Ireland,GBR,5,5,55,5,70
2006,Zambia,ZMB,United Kingdom of Great Britain and Northern Ireland,GBR,0,0,19,0,19
2006,Zimbabwe,ZWE,United Kingdom of Great Britain and Northern Ireland,GBR,191,46,1901,82,2220
2006,Stateless,XXA,United Kingdom of Great Britain and Northern Ireland,GBR,36,0,28,16,80
2006,Unknown ,,United Kingdom of Great Britain and Northern Ireland,GBR,0,0,25,5,30
2006,Burkina Faso,BFA,Ghana,GHA,0,0,5,0,5
2006,Somalia,SOM,Ghana,GHA,0,0,0,5,5
2006,Congo,COG,Guinea-Bissau,GNB,5,0,0,0,5
2006,Cote d'Ivoire,CIV,Guinea-Bissau,GNB,22,0,0,0,22
2006,Liberia,LBR,Guinea-Bissau,GNB,49,0,0,0,49
2006,Senegal,SEN,Guinea-Bissau,GNB,134,0,0,0,134
2006,Sierra Leone,SLE,Guinea-Bissau,GNB,5,0,20,0,25
2006,Cuba,CUB,Guatemala,GTM,0,0,0,12,12
2006,Honduras,HND,Guatemala,GTM,0,0,0,12,12
2006,Congo,COG,Guinea,GIN,10,0,0,0,10
2006,Cote d'Ivoire,CIV,Guinea,GIN,233,0,86,0,319
2006,Liberia,LBR,Guinea,GIN,72,0,148,0,220
2006,Sierra Leone,SLE,Guinea,GIN,212,0,386,0,598
2006,Colombia,COL,Honduras,HND,0,0,0,10,10
2006,Cuba,CUB,Honduras,HND,0,0,25,26,51
2006,Eritrea,ERI,Honduras,HND,0,0,0,5,5
2006,Armenia,ARM,Croatia,HRV,0,0,5,0,5
2006,China,CHN,Croatia,HRV,0,0,5,0,5
2006,Palestinian,PSE,Croatia,HRV,0,0,27,0,27
2006,Iraq,IRQ,Croatia,HRV,0,0,5,0,5
2006,Pakistan,PAK,Croatia,HRV,0,0,10,0,10
2006,Russian Federation,RUS,Croatia,HRV,0,0,5,5,10
2006,Serbia and Kosovo: S/RES/1244 (1999),SRB,Croatia,HRV,0,0,18,0,18
2006,Stateless,XXA,Croatia,HRV,0,0,5,0,5
2006,Afghanistan,AFG,Hungary,HUN,5,12,0,0,17
2006,Albania,ALB,Hungary,HUN,0,0,0,5,5
2006,Algeria,DZA,Hungary,HUN,0,0,15,5,20
2006,Egypt,EGY,Hungary,HUN,0,5,10,14,29
2006,Armenia,ARM,Hungary,HUN,0,10,0,0,10
2006,Bangladesh,BGD,Hungary,HUN,0,0,5,5,10
2006,Belarus,BLR,Hungary,HUN,0,0,5,0,5
2006,China,CHN,Hungary,HUN,0,10,234,19,263
2006,Cuba,CUB,Hungary,HUN,0,5,0,0,5
2006,Ethiopia,ETH,Hungary,HUN,5,0,0,5,10
2006,Palestinian,PSE,Hungary,HUN,0,0,20,19,39
2006,Georgia,GEO,Hungary,HUN,0,0,25,112,137
2006,Ghana,GHA,Hungary,HUN,0,0,5,0,5
2006,India,IND,Hungary,HUN,0,0,18,0,18
2006,Iran (Islamic Rep. of),IRN,Hungary,HUN,5,5,10,0,20
2006,Iraq,IRQ,Hungary,HUN,15,11,0,27,53
2006,Kenya,KEN,Hungary,HUN,0,0,5,0,5
2006,North Macedonia,MKD,Hungary,HUN,0,0,5,10,15
2006,Rep. of Moldova,MDA,Hungary,HUN,0,0,10,23,33
2006,Mongolia,MNG,Hungary,HUN,0,0,20,11,31
2006,Nepal,NPL,Hungary,HUN,5,5,0,0,10
2006,Nigeria,NGA,Hungary,HUN,5,0,80,32,117
2006,Pakistan,PAK,Hungary,HUN,0,0,10,5,15
2006,Romania,ROU,Hungary,HUN,0,0,20,10,30
2006,Russian Federation,RUS,Hungary,HUN,5,0,19,40,64
2006,Serbia and Kosovo: S/RES/1244 (1999),SRB,Hungary,HUN,0,26,136,190,352
2006,Sierra Leone,SLE,Hungary,HUN,0,0,5,0,5
2006,Somalia,SOM,Hungary,HUN,29,0,0,10,39
2006,Viet Nam,VNM,Hungary,HUN,0,0,354,5,359
2006,Slovakia,SVK,Hungary,HUN,0,0,18,5,23
2006,Syrian Arab Rep.,SYR,Hungary,HUN,0,0,16,5,21
2006,Turkey,TUR,Hungary,HUN,5,5,28,5,43
2006,Ukraine,UKR,Hungary,HUN,0,0,13,17,30
2006,Unknown ,,Hungary,HUN,10,0,5,0,15
2006,Romania,ROU,Iceland,ISL,0,0,10,0,10
2006,Russian Federation,RUS,Iceland,ISL,0,0,5,0,5
2006,Afghanistan,AFG,Cote d'Ivoire,CIV,10,0,0,0,10
2006,Burundi,BDI,Cote d'Ivoire,CIV,0,0,5,0,5
2006,Central African Rep.,CAF,Cote d'Ivoire,CIV,0,0,23,0,23
2006,Chad,TCD,Cote d'Ivoire,CIV,0,0,5,0,5
2006,Cameroon,CMR,Cote d'Ivoire,CIV,0,0,5,0,5
2006,Congo,COG,Cote d'Ivoire,CIV,5,0,80,0,85
2006,Dem. Rep. of the Congo,COD,Cote d'Ivoire,CIV,29,0,161,0,190
2006,Rwanda,RWA,Cote d'Ivoire,CIV,5,0,5,0,10
2006,Sierra Leone,SLE,Cote d'Ivoire,CIV,0,0,11,0,11
2006,Togo,TGO,Cote d'Ivoire,CIV,5,0,70,0,75
2006,Afghanistan,AFG,Ireland,IRL,5,0,101,10,116
2006,Albania,ALB,Ireland,IRL,0,0,37,10,47
2006,Algeria,DZA,Ireland,IRL,0,0,47,10,57
2006,Angola,AGO,Ireland,IRL,0,0,35,0,35
2006,Egypt,EGY,Ireland,IRL,0,0,5,0,5
2006,Armenia,ARM,Ireland,IRL,0,0,5,0,5
2006,Azerbaijan,AZE,Ireland,IRL,5,0,5,0,10
2006,Burundi,BDI,Ireland,IRL,5,0,12,0,17
2006,Benin,BEN,Ireland,IRL,0,0,5,0,5
2006,Bangladesh,BGD,Ireland,IRL,5,0,5,0,10
2006,Bhutan,BTN,Ireland,IRL,5,0,10,0,15
2006,Belarus,BLR,Ireland,IRL,0,0,34,10,44
2006,Brazil,BRA,Ireland,IRL,0,0,5,10,15
2006,Chad,TCD,Ireland,IRL,0,0,5,0,5
2006,China,CHN,Ireland,IRL,5,0,46,75,126
2006,Cameroon,CMR,Ireland,IRL,0,0,63,5,68
2006,Congo,COG,Ireland,IRL,0,0,11,0,11
2006,Dem. Rep. of the Congo,COD,Ireland,IRL,14,0,100,5,119
2006,Eritrea,ERI,Ireland,IRL,5,0,22,0,27
2006,Ethiopia,ETH,Ireland,IRL,10,0,16,0,26
2006,Palestinian,PSE,Ireland,IRL,5,0,33,5,43
2006,Georgia,GEO,Ireland,IRL,0,0,176,10,186
2006,Ghana,GHA,Ireland,IRL,0,0,77,0,77
2006,Guinea,GIN,Ireland,IRL,5,0,26,0,31
2006,Guyana,GUY,Ireland,IRL,0,0,5,0,5
2006,Croatia,HRV,Ireland,IRL,0,0,15,0,15
2006,Cote d'Ivoire,CIV,Ireland,IRL,0,0,23,0,23
2006,India,IND,Ireland,IRL,0,0,12,0,12
2006,Iran (Islamic Rep. of),IRN,Ireland,IRL,12,0,157,27,196
2006,Iraq,IRQ,Ireland,IRL,65,0,63,10,138
2006,Israel,ISR,Ireland,IRL,0,0,48,0,48
2006,Kazakhstan,KAZ,Ireland,IRL,0,0,5,0,5
2006,Kenya,KEN,Ireland,IRL,5,0,39,5,49
2006,Kuwait,KWT,Ireland,IRL,13,0,23,0,36
2006,Liberia,LBR,Ireland,IRL,0,0,31,0,31
2006,Libya,LBY,Ireland,IRL,0,0,5,0,5
2006,Lebanon,LBN,Ireland,IRL,0,0,11,0,11
2006,Sri Lanka,LKA,Ireland,IRL,0,0,5,0,5
2006,North Macedonia,MKD,Ireland,IRL,0,0,5,0,5
2006,Rep. of Moldova,MDA,Ireland,IRL,5,0,58,29,92
2006,Malaysia,MYS,Ireland,IRL,0,0,5,0,5
2006,Malawi,MWI,Ireland,IRL,0,0,10,0,10
2006,Mongolia,MNG,Ireland,IRL,0,0,5,0,5
2006,Morocco,MAR,Ireland,IRL,0,0,10,0,10
2006,Nepal,NPL,Ireland,IRL,0,0,5,0,5
2006,Niger,NER,Ireland,IRL,5,0,5,0,10
2006,Nigeria,NGA,Ireland,IRL,10,0,991,79,1080
2006,Pakistan,PAK,Ireland,IRL,5,0,96,15,116
2006,Romania,ROU,Ireland,IRL,0,0,148,198,346
2006,South Africa,ZAF,Ireland,IRL,0,0,35,5,40
2006,Russian Federation,RUS,Ireland,IRL,5,0,44,15,64
2006,Rwanda,RWA,Ireland,IRL,0,0,13,0,13
2006,Serbia and Kosovo: S/RES/1244 (1999),SRB,Ireland,IRL,0,0,19,5,24
2006,Sierra Leone,SLE,Ireland,IRL,0,0,17,0,17
2006,Somalia,SOM,Ireland,IRL,60,0,129,13,202
2006,Viet Nam,VNM,Ireland,IRL,0,0,5,0,5
2006,Sudan,SDN,Ireland,IRL,109,0,163,13,285
2006,Syrian Arab Rep.,SYR,Ireland,IRL,0,0,12,5,17
2006,Togo,TGO,Ireland,IRL,5,0,15,0,20
2006,Turkey,TUR,Ireland,IRL,0,0,5,0,5
2006,Uganda,UGA,Ireland,IRL,5,0,20,0,25
2006,Ukraine,UKR,Ireland,IRL,0,0,34,5,39
2006,United States of America,USA,Ireland,IRL,0,0,5,0,5
2006,Zimbabwe,ZWE,Ireland,IRL,11,0,52,5,68
2006,Bangladesh,BGD,Japan,JPN,0,0,11,5,16
2006,China,CHN,Japan,JPN,0,11,0,0,11
2006,Ethiopia,ETH,Japan,JPN,0,0,0,5,5
2006,Iran (Islamic Rep. of),IRN,Japan,JPN,5,0,5,0,10
2006,Sri Lanka,LKA,Japan,JPN,0,0,5,0,5
2006,Myanmar,MMR,Japan,JPN,16,13,246,5,280
2006,Pakistan,PAK,Japan,JPN,0,0,5,0,5
2006,Turkey,TUR,Japan,JPN,0,0,76,15,91
2006,Unknown ,,Japan,JPN,0,0,10,5,15
2006,Afghanistan,AFG,Kazakhstan,KAZ,30,0,47,10,87
2006,Armenia,ARM,Liechtenstein,LIE,0,5,0,0,5
2006,Kazakhstan,KAZ,Liechtenstein,LIE,0,0,5,5,10
2006,Kyrgyzstan,KGZ,Liechtenstein,LIE,0,0,0,5,5
2006,North Macedonia,MKD,Liechtenstein,LIE,0,0,5,0,5
2006,Russian Federation,RUS,Liechtenstein,LIE,0,0,5,5,10
2006,Serbia and Kosovo: S/RES/1244 (1999),SRB,Liechtenstein,LIE,0,31,0,5,36
2006,Belarus,BLR,Lithuania,LTU,5,0,0,0,5
2006,Ghana,GHA,Lithuania,LTU,0,0,5,0,5
2006,Nigeria,NGA,Lithuania,LTU,0,0,10,0,10
2006,Russian Federation,RUS,Lithuania,LTU,10,76,0,0,86
2006,Albania,ALB,Luxembourg,LUX,5,0,0,0,5
2006,Bosnia and Herzegovina,BIH,Luxembourg,LUX,5,0,0,0,5
2006,Iran (Islamic Rep. of),IRN,Luxembourg,LUX,5,0,0,0,5
2006,Serbia and Kosovo: S/RES/1244 (1999),SRB,Luxembourg,LUX,12,0,0,0,12
2006,Unknown ,,Luxembourg,LUX,0,351,508,225,1084
2006,Serbia and Kosovo: S/RES/1244 (1999),SRB,North Macedonia,MKD,0,131,255,184,570
2006,Bangladesh,BGD,Mexico,MEX,0,0,0,5,5
2006,Brazil,BRA,Mexico,MEX,0,0,0,5,5
2006,China,CHN,Mexico,MEX,5,0,5,5,15
2006,Cameroon,CMR,Mexico,MEX,0,0,5,5,10
2006,Colombia,COL,Mexico,MEX,29,0,5,5,39
2006,Cuba,CUB,Mexico,MEX,0,0,17,68,85
2006,Eritrea,ERI,Mexico,MEX,0,0,0,54,54
2006,Ethiopia,ETH,Mexico,MEX,0,0,11,62,73
2006,Guatemala,GTM,Mexico,MEX,0,0,11,10,21
2006,Haiti,HTI,Mexico,MEX,13,0,5,5,23
2006,Honduras,HND,Mexico,MEX,0,0,10,10,20
2006,India,IND,Mexico,MEX,0,0,0,10,10
2006,Iraq,IRQ,Mexico,MEX,0,0,0,21,21
2006,Liberia,LBR,Mexico,MEX,0,0,5,0,5
2006,Lebanon,LBN,Mexico,MEX,0,0,0,5,5
2006,Sri Lanka,LKA,Mexico,MEX,0,0,0,12,12
2006,Rep. of Moldova,MDA,Mexico,MEX,0,0,5,0,5
2006,Myanmar,MMR,Mexico,MEX,10,0,0,0,10
2006,Nepal,NPL,Mexico,MEX,5,0,0,5,10
2006,El Salvador,SLV,Mexico,MEX,0,0,5,5,10
2006,Somalia,SOM,Mexico,MEX,10,0,0,10,20
2006,Turkey,TUR,Mexico,MEX,0,0,5,0,5
2006,Dem. Rep. of the Congo,COD,Mali,MLI,10,0,5,0,15
2006,Cote d'Ivoire,CIV,Mali,MLI,38,0,38,0,76
2006,Togo,TGO,Mali,MLI,0,0,5,0,5
2006,Burundi,BDI,Malawi,MWI,5,0,0,828,833
2006,Dem. Rep. of the Congo,COD,Malawi,MWI,5,0,0,430,435
2006,Eritrea,ERI,Malawi,MWI,0,0,0,282,282
2006,Ethiopia,ETH,Malawi,MWI,0,0,0,1098,1098
2006,Rwanda,RWA,Malawi,MWI,198,0,612,123,933
2006,Somalia,SOM,Malawi,MWI,0,0,0,861,861
2006,Sudan,SDN,Malawi,MWI,0,0,0,5,5
2006,Algeria,DZA,Malta,MLT,0,0,10,0,10
2006,Burkina Faso,BFA,Malta,MLT,0,0,10,0,10
2006,Chad,TCD,Malta,MLT,0,0,5,0,5
2006,Eritrea,ERI,Malta,MLT,10,251,110,0,371
2006,Ethiopia,ETH,Malta,MLT,5,0,102,0,107
2006,Palestinian,PSE,Malta,MLT,0,0,14,0,14
2006,Ghana,GHA,Malta,MLT,0,0,28,0,28
2006,Cote d'Ivoire,CIV,Malta,MLT,0,0,36,0,36
2006,Iraq,IRQ,Malta,MLT,0,0,10,0,10
2006,Liberia,LBR,Malta,MLT,0,0,15,0,15
2006,Mali,MLI,Malta,MLT,0,0,5,0,5
2006,Morocco,MAR,Malta,MLT,0,0,5,0,5
2006,Niger,NER,Malta,MLT,0,0,64,0,64
2006,Nigeria,NGA,Malta,MLT,0,0,37,0,37
2006,Sierra Leone,SLE,Malta,MLT,0,0,10,0,10
2006,Somalia,SOM,Malta,MLT,10,130,10,0,150
2006,Sudan,SDN,Malta,MLT,0,136,105,5,246
2006,Syrian Arab Rep.,SYR,Malta,MLT,5,0,5,0,10
2006,Togo,TGO,Malta,MLT,0,0,40,0,40
2006,Turkey,TUR,Malta,MLT,0,0,5,0,5
2006,Burundi,BDI,Namibia,NAM,17,0,0,0,17
2006,Dem. Rep. of the Congo,COD,Namibia,NAM,122,0,28,0,150
2006,Liberia,LBR,Namibia,NAM,0,0,5,0,5
2006,Rwanda,RWA,Namibia,NAM,5,0,11,0,16
2006,Sierra Leone,SLE,Namibia,NAM,0,0,11,0,11
2006,Bhutan,BTN,Nepal,NPL,0,25,0,0,25
2006,Afghanistan,AFG,Netherlands,NLD,19,347,448,119,933
2006,Albania,ALB,Netherlands,NLD,0,5,13,10,28
2006,Algeria,DZA,Netherlands,NLD,0,5,31,16,52
2006,Angola,AGO,Netherlands,NLD,0,35,183,34,252
2006,Egypt,EGY,Netherlands,NLD,0,0,10,0,10
2006,Armenia,ARM,Netherlands,NLD,5,33,181,30,249
2006,Azerbaijan,AZE,Netherlands,NLD,10,68,248,62,388
2006,Burundi,BDI,Netherlands,NLD,13,313,173,28,527
2006,Benin,BEN,Netherlands,NLD,0,0,5,0,5
2006,Bangladesh,BGD,Netherlands,NLD,5,0,17,0,22
2006,Bhutan,BTN,Netherlands,NLD,0,5,0,0,5
2006,Burkina Faso,BFA,Netherlands,NLD,0,0,10,0,10
2006,Belarus,BLR,Netherlands,NLD,5,5,41,10,61
2006,Brazil,BRA,Netherlands,NLD,0,0,5,0,5
2006,Bosnia and Herzegovina,BIH,Netherlands,NLD,0,5,89,16,110
2006,Bulgaria,BGR,Netherlands,NLD,0,0,10,0,10
2006,Chad,TCD,Netherlands,NLD,0,0,5,0,5
2006,China,CHN,Netherlands,NLD,33,39,181,83,336
2006,Cameroon,CMR,Netherlands,NLD,0,28,40,5,73
2006,Congo,COG,Netherlands,NLD,5,48,73,34,160
2006,Dem. Rep. of the Congo,COD,Netherlands,NLD,28,120,95,39,282
2006,Colombia,COL,Netherlands,NLD,0,55,103,65,223
2006,Cuba,CUB,Netherlands,NLD,0,0,19,5,24
2006,Ecuador,ECU,Netherlands,NLD,0,0,5,0,5
2006,Eritrea,ERI,Netherlands,NLD,12,131,41,21,205
2006,Ethiopia,ETH,Netherlands,NLD,15,90,76,19,200
2006,Gambia,GMB,Netherlands,NLD,0,0,10,0,10
2006,Palestinian,PSE,Netherlands,NLD,0,0,11,12,23
2006,Georgia,GEO,Netherlands,NLD,0,0,125,18,143
2006,Ghana,GHA,Netherlands,NLD,0,0,12,5,17
2006,Guinea,GIN,Netherlands,NLD,0,42,97,12,151
2006,Croatia,HRV,Netherlands,NLD,0,5,10,0,15
2006,Hungary,HUN,Netherlands,NLD,0,0,0,5,5
2006,Cote d'Ivoire,CIV,Netherlands,NLD,5,141,50,13,209
2006,India,IND,Netherlands,NLD,0,0,55,43,98
2006,Indonesia,IDN,Netherlands,NLD,0,21,5,0,26
2006,Iran (Islamic Rep. of),IRN,Netherlands,NLD,38,109,305,105,557
2006,Iraq,IRQ,Netherlands,NLD,27,365,1677,619,2688
2006,Israel,ISR,Netherlands,NLD,0,0,0,5,5
2006,Jordan,JOR,Netherlands,NLD,0,0,0,5,5
2006,Kazakhstan,KAZ,Netherlands,NLD,0,0,34,5,39
2006,Kenya,KEN,Netherlands,NLD,0,0,11,0,11
2006,Kyrgyzstan,KGZ,Netherlands,NLD,0,0,17,5,22
2006,Dem. People's Rep. of Korea,PRK,Netherlands,NLD,0,0,5,0,5
2006,Liberia,LBR,Netherlands,NLD,5,40,113,15,173
2006,Libya,LBY,Netherlands,NLD,0,5,16,10,31
2006,Lebanon,LBN,Netherlands,NLD,0,10,26,10,46
2006,Sri Lanka,LKA,Netherlands,NLD,5,12,79,31,127
2006,Mauritania,MRT,Netherlands,NLD,0,0,10,0,10
2006,North Macedonia,MKD,Netherlands,NLD,0,0,5,5,10
2006,Rep. of Moldova,MDA,Netherlands,NLD,0,0,12,0,12
2006,Mali,MLI,Netherlands,NLD,0,0,5,5,10
2006,Mongolia,MNG,Netherlands,NLD,0,0,113,18,131
2006,Morocco,MAR,Netherlands,NLD,0,5,11,10,26
2006,Myanmar,MMR,Netherlands,NLD,11,90,5,0,106
2006,Nepal,NPL,Netherlands,NLD,17,23,72,13,125
2006,Niger,NER,Netherlands,NLD,0,0,10,0,10
2006,Nigeria,NGA,Netherlands,NLD,0,19,161,74,254
2006,Pakistan,PAK,Netherlands,NLD,5,21,77,13,116
2006,Peru,PER,Netherlands,NLD,0,0,5,0,5
2006,Philippines,PHL,Netherlands,NLD,0,10,0,0,10
2006,Romania,ROU,Netherlands,NLD,0,5,10,5,20
2006,Russian Federation,RUS,Netherlands,NLD,5,71,185,32,293
2006,Rwanda,RWA,Netherlands,NLD,0,23,46,16,85
2006,Serbia and Kosovo: S/RES/1244 (1999),SRB,Netherlands,NLD,0,26,251,73,350
2006,Sierra Leone,SLE,Netherlands,NLD,0,81,142,32,255
2006,Somalia,SOM,Netherlands,NLD,25,872,331,81,1309
2006,Viet Nam,VNM,Netherlands,NLD,0,5,17,0,22
2006,Sudan,SDN,Netherlands,NLD,13,121,148,44,326
2006,Slovakia,SVK,Netherlands,NLD,0,0,13,0,13
2006,Syrian Arab Rep.,SYR,Netherlands,NLD,16,32,169,25,242
2006,United Rep. of Tanzania,TZA,Netherlands,NLD,0,0,13,0,13
2006,Tajikistan,TJK,Netherlands,NLD,0,0,0,5,5
2006,Turkmenistan,TKM,Netherlands,NLD,5,11,0,0,16
2006,Togo,TGO,Netherlands,NLD,0,14,23,5,42
2006,Tunisia,TUN,Netherlands,NLD,0,0,5,0,5
2006,Turkey,TUR,Netherlands,NLD,0,28,176,64,268
2006,Uganda,UGA,Netherlands,NLD,0,19,17,5,41
2006,Ukraine,UKR,Netherlands,NLD,0,5,39,5,49
2006,Uzbekistan,UZB,Netherlands,NLD,5,28,15,5,53
2006,Yemen,YEM,Netherlands,NLD,0,0,10,0,10
2006,Zimbabwe,ZWE,Netherlands,NLD,0,0,5,0,5
2006,Stateless,XXA,Netherlands,NLD,5,34,126,33,198
2006,Unknown ,,Netherlands,NLD,10,347,489,206,1052
2006,Central African Rep.,CAF,Niger,NER,0,0,5,0,5
2006,Dem. Rep. of the Congo,COD,Niger,NER,0,0,5,5,10
2006,Cote d'Ivoire,CIV,Niger,NER,5,0,0,0,5
2006,Liberia,LBR,Niger,NER,0,0,0,5,5
2006,Cuba,CUB,Nicaragua,NIC,5,0,0,20,25
2006,Viet Nam,VNM,Nicaragua,NIC,0,0,0,5,5
2006,Central African Rep.,CAF,Nigeria,NGA,0,0,0,5,5
2006,Chad,TCD,Nigeria,NGA,0,0,0,5,5
2006,Cameroon,CMR,Nigeria,NGA,0,0,0,5,5
2006,Cote d'Ivoire,CIV,Nigeria,NGA,0,0,0,13,13
2006,Liberia,LBR,Nigeria,NGA,0,0,0,106,106
2006,Sierra Leone,SLE,Nigeria,NGA,0,0,0,89,89
2006,Sudan,SDN,Nigeria,NGA,0,0,0,5,5
2006,Afghanistan,AFG,Norway,NOR,14,148,37,63,262
2006,Albania,ALB,Norway,NOR,5,0,30,13,48
2006,Algeria,DZA,Norway,NOR,0,0,13,24,37
2006,Angola,AGO,Norway,NOR,0,10,0,5,15
2006,Egypt,EGY,Norway,NOR,0,0,0,5,5
2006,Armenia,ARM,Norway,NOR,0,5,5,17,27
2006,Azerbaijan,AZE,Norway,NOR,0,0,38,15,53
2006,Burundi,BDI,Norway,NOR,0,27,5,16,48
2006,Bangladesh,BGD,Norway,NOR,0,0,0,13,13
2006,Belarus,BLR,Norway,NOR,0,0,5,26,31
2006,Bosnia and Herzegovina,BIH,Norway,NOR,0,0,25,25,50
2006,China,CHN,Norway,NOR,10,16,5,5,36
2006,Cameroon,CMR,Norway,NOR,0,0,5,5,10
2006,Congo,COG,Norway,NOR,0,0,5,0,5
2006,Dem. Rep. of the Congo,COD,Norway,NOR,5,21,5,5,36
2006,Cuba,CUB,Norway,NOR,0,0,5,0,5
2006,Czechia,CZE,Norway,NOR,0,0,5,0,5
2006,Eritrea,ERI,Norway,NOR,111,110,5,42,268
2006,Ethiopia,ETH,Norway,NOR,12,0,13,23,48
2006,Gambia,GMB,Norway,NOR,0,0,5,0,5
2006,Georgia,GEO,Norway,NOR,0,0,0,12,12
2006,Ghana,GHA,Norway,NOR,0,0,5,5,10
2006,Guinea,GIN,Norway,NOR,0,0,0,10,10
2006,Croatia,HRV,Norway,NOR,0,0,11,5,16
2006,Hungary,HUN,Norway,NOR,0,0,5,0,5
2006,Cote d'Ivoire,CIV,Norway,NOR,0,5,5,5,15
2006,India,IND,Norway,NOR,0,0,0,10,10
2006,Iran (Islamic Rep. of),IRN,Norway,NOR,5,15,81,46,147
2006,Iraq,IRQ,Norway,NOR,16,274,232,229,751
2006,Israel,ISR,Norway,NOR,0,0,11,0,11
2006,Kazakhstan,KAZ,Norway,NOR,0,0,5,5,10
2006,Kenya,KEN,Norway,NOR,0,0,10,0,10
2006,Kyrgyzstan,KGZ,Norway,NOR,0,0,10,0,10
2006,Dem. People's Rep. of Korea,PRK,Norway,NOR,0,0,0,10,10
2006,Liberia,LBR,Norway,NOR,0,5,5,5,15
2006,Libya,LBY,Norway,NOR,0,0,0,5,5
2006,Lebanon,LBN,Norway,NOR,0,0,5,11,16
2006,Sri Lanka,LKA,Norway,NOR,0,5,5,11,21
2006,Mauritania,MRT,Norway,NOR,0,0,5,0,5
2006,North Macedonia,MKD,Norway,NOR,0,0,15,10,25
2006,Rep. of Moldova,MDA,Norway,NOR,0,0,5,5,10
2006,Mongolia,MNG,Norway,NOR,0,0,12,5,17
2006,Morocco,MAR,Norway,NOR,0,0,10,12,22
2006,Nepal,NPL,Norway,NOR,0,0,69,23,92
2006,Niger,NER,Norway,NOR,0,0,0,5,5
2006,Nigeria,NGA,Norway,NOR,0,5,18,18,41
2006,Pakistan,PAK,Norway,NOR,0,0,5,10,15
2006,Romania,ROU,Norway,NOR,0,0,5,5,10
2006,Russian Federation,RUS,Norway,NOR,21,305,72,100,498
2006,Rwanda,RWA,Norway,NOR,10,21,5,5,41
2006,Serbia and Kosovo: S/RES/1244 (1999),SRB,Norway,NOR,30,10,228,106,374
2006,Sierra Leone,SLE,Norway,NOR,0,0,5,5,10
2006,Somalia,SOM,Norway,NOR,152,177,29,106,464
2006,Viet Nam,VNM,Norway,NOR,0,0,5,11,16
2006,Sudan,SDN,Norway,NOR,0,5,5,5,15
2006,Syrian Arab Rep.,SYR,Norway,NOR,0,5,27,30,62
2006,Togo,TGO,Norway,NOR,0,0,0,5,5
2006,Turkey,TUR,Norway,NOR,0,0,30,30,60
2006,Ukraine,UKR,Norway,NOR,0,0,5,18,23
2006,Uzbekistan,UZB,Norway,NOR,0,0,44,10,54
2006,Venezuela (Bolivarian Republic of),VEN,Norway,NOR,0,0,5,0,5
2006,Western Sahara,ESH,Norway,NOR,0,0,5,5,10
2006,Stateless,XXA,Norway,NOR,53,49,43,46,191
2006,Egypt,EGY,New Zealand,NZL,5,0,0,0,5
2006,Bangladesh,BGD,New Zealand,NZL,0,0,18,0,18
2006,Brazil,BRA,New Zealand,NZL,0,0,5,0,5
2006,Bulgaria,BGR,New Zealand,NZL,0,0,5,0,5
2006,China,CHN,New Zealand,NZL,10,0,10,0,20
2006,Chile,CHL,New Zealand,NZL,0,0,5,0,5
2006,Czechia,CZE,New Zealand,NZL,0,0,19,0,19
2006,Ethiopia,ETH,New Zealand,NZL,0,0,5,0,5
2006,Fiji,FJI,New Zealand,NZL,0,0,10,0,10
2006,Hungary,HUN,New Zealand,NZL,0,0,5,0,5
2006,India,IND,New Zealand,NZL,0,0,21,0,21
2006,Iran (Islamic Rep. of),IRN,New Zealand,NZL,10,0,25,0,35
2006,Iraq,IRQ,New Zealand,NZL,31,0,5,0,36
2006,Jordan,JOR,New Zealand,NZL,0,0,5,0,5
2006,Kyrgyzstan,KGZ,New Zealand,NZL,0,0,5,0,5
2006,Sri Lanka,LKA,New Zealand,NZL,0,0,20,0,20
2006,Myanmar,MMR,New Zealand,NZL,5,0,0,0,5
2006,Nepal,NPL,New Zealand,NZL,0,0,10,0,10
2006,Pakistan,PAK,New Zealand,NZL,0,0,10,0,10
2006,Romania,ROU,New Zealand,NZL,0,0,10,0,10
2006,South Africa,ZAF,New Zealand,NZL,0,0,5,0,5
2006,Saudi Arabia,SAU,New Zealand,NZL,0,0,5,0,5
2006,Somalia,SOM,New Zealand,NZL,5,0,5,0,10
2006,Slovakia,SVK,New Zealand,NZL,0,0,10,0,10
2006,Syrian Arab Rep.,SYR,New Zealand,NZL,0,0,5,0,5
2006,Zimbabwe,ZWE,New Zealand,NZL,5,0,5,0,10
2006,Colombia,COL,Panama,PAN,128,0,40,408,576
2006,Cuba,CUB,Panama,PAN,5,0,5,0,10
2006,Haiti,HTI,Panama,PAN,5,0,0,0,5
2006,Liberia,LBR,Panama,PAN,0,0,0,5,5
2006,Nigeria,NGA,Panama,PAN,0,0,0,5,5
2006,Romania,ROU,Panama,PAN,0,0,0,5,5
2006,Sierra Leone,SLE,Panama,PAN,0,0,0,5,5
2006,Cuba,CUB,Paraguay,PRY,14,0,0,5,19
2006,Colombia,COL,Peru,PER,40,0,12,22,74
2006,Cuba,CUB,Peru,PER,33,0,5,0,38
2006,Iraq,IRQ,Peru,PER,0,0,0,5,5
2006,Israel,ISR,Peru,PER,0,0,0,5,5
2006,Sierra Leone,SLE,Peru,PER,0,0,0,5,5
2006,Somalia,SOM,Peru,PER,0,0,0,5,5
2006,Burundi,BDI,Philippines,PHL,0,0,0,5,5
2006,Palestinian,PSE,Philippines,PHL,5,0,0,5,10
2006,Afghanistan,AFG,Poland,POL,0,5,5,15,25
2006,Algeria,DZA,Poland,POL,0,0,10,0,10
2006,Egypt,EGY,Poland,POL,0,0,5,5,10
2006,Armenia,ARM,Poland,POL,0,0,24,10,34
2006,Azerbaijan,AZE,Poland,POL,5,0,0,10,15
2006,Burundi,BDI,Poland,POL,0,0,5,0,5
2006,Bangladesh,BGD,Poland,POL,0,0,10,0,10
2006,Belarus,BLR,Poland,POL,18,5,31,25,79
2006,Cameroon,CMR,Poland,POL,0,0,5,5,10
2006,Dem. Rep. of the Congo,COD,Poland,POL,0,0,0,5,5
2006,Palestinian,PSE,Poland,POL,0,0,0,5,5
2006,Georgia,GEO,Poland,POL,0,0,15,27,42
2006,Guinea,GIN,Poland,POL,0,0,5,0,5
2006,India,IND,Poland,POL,0,0,10,10,20
2006,Iraq,IRQ,Poland,POL,0,10,0,10,20
2006,Kazakhstan,KAZ,Poland,POL,0,0,5,19,24
2006,Kyrgyzstan,KGZ,Poland,POL,0,0,11,28,39
2006,Sri Lanka,LKA,Poland,POL,0,5,0,0,5
2006,Lithuania,LTU,Poland,POL,0,0,0,5,5
2006,Rep. of Moldova,MDA,Poland,POL,0,0,10,5,15
2006,Mongolia,MNG,Poland,POL,0,0,10,0,10
2006,Nepal,NPL,Poland,POL,0,0,5,5,10
2006,Nigeria,NGA,Poland,POL,0,0,10,5,15
2006,Pakistan,PAK,Poland,POL,0,0,28,28,56
2006,Russian Federation,RUS,Poland,POL,383,2015,634,3593,6625
2006,Viet Nam,VNM,Poland,POL,0,0,22,5,27
2006,Syrian Arab Rep.,SYR,Poland,POL,0,0,5,0,5
2006,Turkey,TUR,Poland,POL,5,0,5,5,15
2006,Ukraine,UKR,Poland,POL,0,0,39,18,57
2006,Stateless,XXA,Poland,POL,0,0,5,11,16
2006,Angola,AGO,Portugal,PRT,0,0,5,0,5
2006,Dem. Rep. of the Congo,COD,Portugal,PRT,5,0,10,0,15
2006,Colombia,COL,Portugal,PRT,0,0,5,0,5
2006,Cuba,CUB,Portugal,PRT,0,0,5,0,5
2006,Eritrea,ERI,Portugal,PRT,5,0,0,0,5
2006,Guinea-Bissau,GNB,Portugal,PRT,0,0,5,0,5
2006,Guinea,GIN,Portugal,PRT,0,0,5,0,5
2006,Cote d'Ivoire,CIV,Portugal,PRT,5,0,0,0,5
2006,Nepal,NPL,Portugal,PRT,0,0,5,0,5
2006,Nigeria,NGA,Portugal,PRT,0,0,5,0,5
2006,Russian Federation,RUS,Portugal,PRT,5,0,0,0,5
2006,Sierra Leone,SLE,Portugal,PRT,0,0,5,0,5
2006,Turkey,TUR,Portugal,PRT,0,0,5,0,5
2006,Angola,AGO,South Africa,ZAF,0,0,159,0,159
2006,Burundi,BDI,South Africa,ZAF,45,0,15,0,60
2006,Bangladesh,BGD,South Africa,ZAF,0,0,66,0,66
2006,China,CHN,South Africa,ZAF,0,0,56,0,56
2006,Cameroon,CMR,South Africa,ZAF,27,0,11,0,38
2006,Congo,COG,South Africa,ZAF,44,0,37,0,81
2006,Dem. Rep. of the Congo,COD,South Africa,ZAF,204,0,191,0,395
2006,Eritrea,ERI,South Africa,ZAF,5,0,5,0,10
2006,Ethiopia,ETH,South Africa,ZAF,50,0,82,0,132
2006,Ghana,GHA,South Africa,ZAF,0,0,5,0,5
2006,India,IND,South Africa,ZAF,0,0,44,0,44
2006,Jordan,JOR,South Africa,ZAF,0,0,18,0,18
2006,Kenya,KEN,South Africa,ZAF,10,0,42,0,52
2006,Liberia,LBR,South Africa,ZAF,0,0,11,0,11
2006,Lesotho,LSO,South Africa,ZAF,0,0,5,0,5
2006,Mali,MLI,South Africa,ZAF,0,0,5,0,5
2006,Malawi,MWI,South Africa,ZAF,0,0,1049,0,1049
2006,Mozambique,MOZ,South Africa,ZAF,0,0,313,0,313
2006,Nigeria,NGA,South Africa,ZAF,0,0,81,0,81
2006,Pakistan,PAK,South Africa,ZAF,0,0,48,0,48
2006,Russian Federation,RUS,South Africa,ZAF,5,0,5,0,10
2006,Rwanda,RWA,South Africa,ZAF,5,0,5,0,10
2006,Senegal,SEN,South Africa,ZAF,0,0,5,0,5
2006,Somalia,SOM,South Africa,ZAF,275,0,24,0,299
2006,United Rep. of Tanzania,TZA,South Africa,ZAF,0,0,265,0,265
2006,Uganda,UGA,South Africa,ZAF,15,0,59,0,74
2006,Zambia,ZMB,South Africa,ZAF,0,0,53,0,53
2006,Zimbabwe,ZWE,South Africa,ZAF,103,0,1878,0,1981
2006,Afghanistan,AFG,Russian Federation,RUS,30,0,792,0,822
2006,Armenia,ARM,Russian Federation,RUS,0,0,10,0,10
2006,Azerbaijan,AZE,Russian Federation,RUS,5,0,17,0,22
2006,Congo,COG,Russian Federation,RUS,0,0,5,0,5
2006,Cuba,CUB,Russian Federation,RUS,0,0,14,0,14
2006,Eritrea,ERI,Russian Federation,RUS,0,0,5,0,5
2006,Ethiopia,ETH,Russian Federation,RUS,0,0,10,0,10
2006,Georgia,GEO,Russian Federation,RUS,0,0,128,0,128
2006,Iraq,IRQ,Russian Federation,RUS,0,0,13,0,13
2006,Kazakhstan,KAZ,Russian Federation,RUS,0,0,5,0,5
2006,Dem. People's Rep. of Korea,PRK,Russian Federation,RUS,0,0,5,0,5
2006,Rep. of Moldova,MDA,Russian Federation,RUS,0,0,5,0,5
2006,Nigeria,NGA,Russian Federation,RUS,0,0,10,0,10
2006,Sudan,SDN,Russian Federation,RUS,0,0,5,0,5
2006,Tajikistan,TJK,Russian Federation,RUS,0,0,5,0,5
2006,Turkmenistan,TKM,Russian Federation,RUS,0,0,16,0,16
2006,Ukraine,UKR,Russian Federation,RUS,0,0,5,0,5
2006,Uzbekistan,UZB,Russian Federation,RUS,0,0,58,0,58
2006,Unknown ,,Russian Federation,RUS,0,0,12,0,12
2006,Dem. Rep. of the Congo,COD,Rwanda,RWA,10,0,10,0,20
2006,Colombia,COL,El Salvador,SLV,0,0,0,5,5
2006,Chad,TCD,Senegal,SEN,0,0,5,0,5
2006,Congo,COG,Senegal,SEN,0,0,5,0,5
2006,Dem. Rep. of the Congo,COD,Senegal,SEN,0,0,15,0,15
2006,Gambia,GMB,Senegal,SEN,5,0,0,0,5
2006,Guinea,GIN,Senegal,SEN,0,0,14,0,14
2006,Cote d'Ivoire,CIV,Senegal,SEN,5,0,85,0,90
2006,Liberia,LBR,Senegal,SEN,0,0,23,0,23
2006,Mauritania,MRT,Senegal,SEN,0,0,5,0,5
2006,Rwanda,RWA,Senegal,SEN,0,0,10,0,10
2006,Sierra Leone,SLE,Senegal,SEN,0,0,46,0,46
2006,Togo,TGO,Senegal,SEN,0,0,35,0,35
2006,Afghanistan,AFG,Spain,ESP,0,0,0,10,10
2006,Algeria,DZA,Spain,ESP,0,0,61,20,81
2006,Angola,AGO,Spain,ESP,0,0,10,0,10
2006,Egypt,EGY,Spain,ESP,0,0,0,5,5
2006,Armenia,ARM,Spain,ESP,0,0,27,0,27
2006,Azerbaijan,AZE,Spain,ESP,5,0,0,0,5
2006,Bangladesh,BGD,Spain,ESP,0,0,133,0,133
2006,Belarus,BLR,Spain,ESP,0,0,5,0,5
2006,Bolivia (Plurinational State of),BOL,Spain,ESP,0,0,13,0,13
2006,Chad,TCD,Spain,ESP,0,0,5,0,5
2006,Cameroon,CMR,Spain,ESP,0,5,21,15,41
2006,Congo,COG,Spain,ESP,0,0,10,5,15
2006,Dem. Rep. of the Congo,COD,Spain,ESP,5,0,77,60,142
2006,Colombia,COL,Spain,ESP,40,5,639,1880,2564
2006,Cuba,CUB,Spain,ESP,0,17,82,23,122
2006,Ecuador,ECU,Spain,ESP,0,0,5,0,5
2006,Equatorial Guinea,GNQ,Spain,ESP,10,10,28,5,53
2006,Ethiopia,ETH,Spain,ESP,5,0,18,0,23
2006,Gabon,GAB,Spain,ESP,5,0,0,0,5
2006,Gambia,GMB,Spain,ESP,0,0,5,5,10
2006,Georgia,GEO,Spain,ESP,0,0,14,5,19
2006,Ghana,GHA,Spain,ESP,0,0,5,0,5
2006,Guinea-Bissau,GNB,Spain,ESP,0,0,5,5,10
2006,Guinea,GIN,Spain,ESP,0,0,13,11,24
2006,Haiti,HTI,Spain,ESP,0,0,5,0,5
2006,Cote d'Ivoire,CIV,Spain,ESP,10,69,13,20,112
2006,India,IND,Spain,ESP,0,0,5,11,16
2006,Iran (Islamic Rep. of),IRN,Spain,ESP,0,0,23,5,28
2006,Iraq,IRQ,Spain,ESP,12,21,5,17,55
2006,Liberia,LBR,Spain,ESP,0,0,20,10,30
2006,Sri Lanka,LKA,Spain,ESP,0,0,0,10,10
2006,Mauritania,MRT,Spain,ESP,0,0,5,0,5
2006,Mali,MLI,Spain,ESP,0,0,5,5,10
2006,Mongolia,MNG,Spain,ESP,0,0,5,0,5
2006,Morocco,MAR,Spain,ESP,0,0,13,10,23
2006,Nepal,NPL,Spain,ESP,0,5,10,13,28
2006,Nigeria,NGA,Spain,ESP,0,0,38,30,68
2006,Pakistan,PAK,Spain,ESP,10,0,5,10,25
2006,Peru,PER,Spain,ESP,0,0,0,5,5
2006,Romania,ROU,Spain,ESP,0,5,13,0,18
2006,Russian Federation,RUS,Spain,ESP,14,10,32,13,69
2006,Senegal,SEN,Spain,ESP,0,0,0,5,5
2006,Sierra Leone,SLE,Spain,ESP,0,0,5,0,5
2006,Somalia,SOM,Spain,ESP,5,5,5,5,20
2006,Sudan,SDN,Spain,ESP,0,0,22,0,22
2006,Syrian Arab Rep.,SYR,Spain,ESP,0,0,5,10,15
2006,Turkey,TUR,Spain,ESP,5,0,21,12,38
2006,Ukraine,UKR,Spain,ESP,0,0,16,0,16
2006,Uzbekistan,UZB,Spain,ESP,0,0,5,0,5
2006,Venezuela (Bolivarian Republic of),VEN,Spain,ESP,16,0,5,0,21
2006,Stateless,XXA,Spain,ESP,5,14,5,97,121
2006,Unknown ,,Spain,ESP,0,0,0,10,10
2006,Afghanistan,AFG,Slovakia,SVK,0,0,26,29,55
2006,Armenia,ARM,Slovakia,SVK,0,0,0,11,11
2006,Bangladesh,BGD,Slovakia,SVK,0,0,65,125,190
2006,Belarus,BLR,Slovakia,SVK,0,0,0,11,11
2006,China,CHN,Slovakia,SVK,0,0,74,103,177
2006,Cuba,CUB,Slovakia,SVK,0,0,5,0,5
2006,Palestinian,PSE,Slovakia,SVK,0,0,10,21,31
2006,Georgia,GEO,Slovakia,SVK,0,0,74,153,227
2006,India,IND,Slovakia,SVK,0,0,197,480,677
2006,Iran (Islamic Rep. of),IRN,Slovakia,SVK,5,0,0,5,10
2006,Iraq,IRQ,Slovakia,SVK,0,0,62,115,177
2006,Kazakhstan,KAZ,Slovakia,SVK,0,0,0,5,5
2006,Sri Lanka,LKA,Slovakia,SVK,0,0,5,5,10
2006,North Macedonia,MKD,Slovakia,SVK,0,0,5,5,10
2006,Rep. of Moldova,MDA,Slovakia,SVK,0,0,98,275,373
2006,Nigeria,NGA,Slovakia,SVK,0,0,10,5,15
2006,Pakistan,PAK,Slovakia,SVK,0,0,78,132,210
2006,Russian Federation,RUS,Slovakia,SVK,0,0,106,367,473
2006,Serbia and Kosovo: S/RES/1244 (1999),SRB,Slovakia,SVK,0,0,5,10,15
2006,Somalia,SOM,Slovakia,SVK,0,0,5,0,5
2006,Viet Nam,VNM,Slovakia,SVK,0,0,16,42,58
2006,Syrian Arab Rep.,SYR,Slovakia,SVK,0,0,5,5,10
2006,Turkey,TUR,Slovakia,SVK,0,0,5,21,26
2006,Ukraine,UKR,Slovakia,SVK,0,0,15,14,29
2006,Stateless,XXA,Slovakia,SVK,0,0,0,5,5
2006,Afghanistan,AFG,Sweden,SWE,15,90,173,72,350
2006,Albania,ALB,Sweden,SWE,0,5,49,21,75
2006,Algeria,DZA,Sweden,SWE,0,0,54,47,101
2006,Angola,AGO,Sweden,SWE,0,0,10,5,15
2006,Egypt,EGY,Sweden,SWE,5,10,25,10,50
2006,Argentina,ARG,Sweden,SWE,0,0,5,0,5
2006,Armenia,ARM,Sweden,SWE,0,32,139,69,240
2006,Azerbaijan,AZE,Sweden,SWE,5,56,148,43,252
2006,Burundi,BDI,Sweden,SWE,5,226,37,15,283
2006,Benin,BEN,Sweden,SWE,0,0,5,5,10
2006,Bangladesh,BGD,Sweden,SWE,0,5,44,10,59
2006,Belarus,BLR,Sweden,SWE,0,10,131,141,282
2006,Bolivia (Plurinational State of),BOL,Sweden,SWE,0,5,513,72,590
2006,Brazil,BRA,Sweden,SWE,0,0,10,0,10
2006,Bosnia and Herzegovina,BIH,Sweden,SWE,0,35,164,72,271
2006,Bulgaria,BGR,Sweden,SWE,0,5,586,147,738
2006,China,CHN,Sweden,SWE,0,0,29,33,62
2006,Chile,CHL,Sweden,SWE,0,0,53,0,53
2006,Cameroon,CMR,Sweden,SWE,0,0,14,5,19
2006,Congo,COG,Sweden,SWE,0,0,10,0,10
2006,Dem. Rep. of the Congo,COD,Sweden,SWE,0,10,62,11,83
2006,Colombia,COL,Sweden,SWE,0,5,11,5,21
2006,Cuba,CUB,Sweden,SWE,5,5,5,5,20
2006,Ecuador,ECU,Sweden,SWE,0,5,25,5,35
2006,Eritrea,ERI,Sweden,SWE,62,187,142,65,456
2006,Estonia,EST,Sweden,SWE,0,0,5,5,10
2006,Ethiopia,ETH,Sweden,SWE,5,5,43,5,58
2006,Gambia,GMB,Sweden,SWE,0,0,5,5,10
2006,Georgia,GEO,Sweden,SWE,0,10,75,51,136
2006,Ghana,GHA,Sweden,SWE,0,0,5,5,10
2006,Guinea,GIN,Sweden,SWE,0,0,17,5,22
2006,Honduras,HND,Sweden,SWE,0,0,5,0,5
2006,Croatia,HRV,Sweden,SWE,0,5,43,12,60
2006,Hungary,HUN,Sweden,SWE,0,0,147,204,351
2006,Cote d'Ivoire,CIV,Sweden,SWE,0,0,22,10,32
2006,India,IND,Sweden,SWE,0,0,58,70,128
2006,Iran (Islamic Rep. of),IRN,Sweden,SWE,26,60,206,99,391
2006,Iraq,IRQ,Sweden,SWE,184,3853,430,617,5084
2006,Israel,ISR,Sweden,SWE,0,11,14,5,30
2006,Italy,ITA,Sweden,SWE,0,0,5,0,5
2006,Jordan,JOR,Sweden,SWE,5,5,41,12,63
2006,Kazakhstan,KAZ,Sweden,SWE,0,30,50,34,114
2006,Kenya,KEN,Sweden,SWE,0,0,12,5,17
2006,Kyrgyzstan,KGZ,Sweden,SWE,0,5,32,10,47
2006,Rep. of Korea,KOR,Sweden,SWE,0,0,0,5,5
2006,Kuwait,KWT,Sweden,SWE,0,0,0,5,5
2006,Liberia,LBR,Sweden,SWE,0,5,10,5,20
2006,Libya,LBY,Sweden,SWE,0,5,114,89,208
2006,Lebanon,LBN,Sweden,SWE,0,12,104,70,186
2006,Sri Lanka,LKA,Sweden,SWE,0,0,12,11,23
2006,Latvia,LVA,Sweden,SWE,0,0,5,5,10
2006,North Macedonia,MKD,Sweden,SWE,0,0,50,33,83
2006,Rep. of Moldova,MDA,Sweden,SWE,0,0,28,51,79
2006,Mongolia,MNG,Sweden,SWE,0,10,268,88,366
2006,Morocco,MAR,Sweden,SWE,0,5,15,14,34
2006,Montenegro,MNE,Sweden,SWE,0,5,15,5,25
2006,Myanmar,MMR,Sweden,SWE,5,5,0,0,10
2006,Nepal,NPL,Sweden,SWE,0,0,13,5,18
2006,Niger,NER,Sweden,SWE,0,0,5,0,5
2006,Nicaragua,NIC,Sweden,SWE,0,0,5,0,5
2006,Nigeria,NGA,Sweden,SWE,0,0,72,29,101
2006,Pakistan,PAK,Sweden,SWE,5,0,26,10,41
2006,Peru,PER,Sweden,SWE,0,5,14,5,24
2006,Romania,ROU,Sweden,SWE,0,0,204,75,279
2006,Russian Federation,RUS,Sweden,SWE,13,263,354,268,898
2006,Rwanda,RWA,Sweden,SWE,0,0,11,5,16
2006,El Salvador,SLV,Sweden,SWE,0,10,29,5,44
2006,Serbia and Kosovo: S/RES/1244 (1999),SRB,Sweden,SWE,113,273,981,495,1862
2006,Senegal,SEN,Sweden,SWE,0,0,5,0,5
2006,Sierra Leone,SLE,Sweden,SWE,0,5,10,19,34
2006,Somalia,SOM,Sweden,SWE,89,643,108,91,931
2006,Viet Nam,VNM,Sweden,SWE,0,0,25,16,41
2006,Sudan,SDN,Sweden,SWE,5,5,25,11,46
2006,Slovakia,SVK,Sweden,SWE,0,0,5,0,5
2006,Syrian Arab Rep.,SYR,Sweden,SWE,22,31,121,82,256
2006,United Rep. of Tanzania,TZA,Sweden,SWE,0,0,10,0,10
2006,Thailand,THA,Sweden,SWE,0,0,5,0,5
2006,Tajikistan,TJK,Sweden,SWE,0,5,5,5,15
2006,Turkmenistan,TKM,Sweden,SWE,0,5,5,5,15
2006,Togo,TGO,Sweden,SWE,0,0,5,0,5
2006,Tunisia,TUN,Sweden,SWE,0,0,25,13,38
2006,Turkey,TUR,Sweden,SWE,0,25,140,66,231
2006,Uganda,UGA,Sweden,SWE,0,10,14,5,29
2006,Ukraine,UKR,Sweden,SWE,0,15,48,35,98
2006,Uruguay,URY,Sweden,SWE,0,0,5,0,5
2006,United States of America,USA,Sweden,SWE,0,0,5,5,10
2006,Uzbekistan,UZB,Sweden,SWE,0,231,42,67,340
2006,Yemen,YEM,Sweden,SWE,13,0,10,5,28
2006,Zimbabwe,ZWE,Sweden,SWE,0,5,5,0,10
2006,Stateless,XXA,Sweden,SWE,23,213,280,133,649
2006,Unknown ,,Sweden,SWE,5,5,96,25,131
2006,Afghanistan,AFG,Switzerland,CHE,23,261,180,42,506
2006,Albania,ALB,Switzerland,CHE,0,0,18,20,38
2006,Algeria,DZA,Switzerland,CHE,5,12,48,119,184
2006,Angola,AGO,Switzerland,CHE,0,176,74,10,260
2006,Egypt,EGY,Switzerland,CHE,0,0,10,10,20
2006,Armenia,ARM,Switzerland,CHE,0,18,72,67,157
2006,Azerbaijan,AZE,Switzerland,CHE,5,12,19,17,53
2006,Burundi,BDI,Switzerland,CHE,5,11,15,0,31
2006,Benin,BEN,Switzerland,CHE,0,0,5,10,15
2006,Bangladesh,BGD,Switzerland,CHE,5,12,36,10,63
2006,Burkina Faso,BFA,Switzerland,CHE,0,0,5,0,5
2006,Belarus,BLR,Switzerland,CHE,0,5,25,29,59
2006,Bolivia (Plurinational State of),BOL,Switzerland,CHE,0,10,5,0,15
2006,Brazil,BRA,Switzerland,CHE,0,0,5,0,5
2006,Bosnia and Herzegovina,BIH,Switzerland,CHE,52,390,174,122,738
2006,Bulgaria,BGR,Switzerland,CHE,0,5,57,124,186
2006,Cambodia,KHM,Switzerland,CHE,17,0,0,0,17
2006,Chad,TCD,Switzerland,CHE,5,0,5,0,10
2006,China,CHN,Switzerland,CHE,73,389,590,26,1078
2006,Cameroon,CMR,Switzerland,CHE,20,13,93,52,178
2006,Congo,COG,Switzerland,CHE,5,5,10,5,25
2006,Dem. Rep. of the Congo,COD,Switzerland,CHE,15,192,149,34,390
2006,Colombia,COL,Switzerland,CHE,30,5,0,5,40
2006,Cuba,CUB,Switzerland,CHE,0,10,0,0,10
2006,Czechia,CZE,Switzerland,CHE,0,0,0,5,5
2006,Ecuador,ECU,Switzerland,CHE,0,5,5,5,15
2006,Eritrea,ERI,Switzerland,CHE,398,127,55,100,680
2006,Ethiopia,ETH,Switzerland,CHE,31,116,71,28,246
2006,Gabon,GAB,Switzerland,CHE,0,0,5,5,10
2006,Gambia,GMB,Switzerland,CHE,5,0,10,0,15
2006,Georgia,GEO,Switzerland,CHE,0,11,121,165,297
2006,Ghana,GHA,Switzerland,CHE,0,0,0,10,10
2006,Guinea-Bissau,GNB,Switzerland,CHE,0,0,16,15,31
2006,Guinea,GIN,Switzerland,CHE,5,10,65,41,121
2006,Croatia,HRV,Switzerland,CHE,0,15,0,17,32
2006,Cote d'Ivoire,CIV,Switzerland,CHE,14,10,118,35,177
2006,India,IND,Switzerland,CHE,0,0,10,26,36
2006,Iran (Islamic Rep. of),IRN,Switzerland,CHE,29,153,249,48,479
2006,Iraq,IRQ,Switzerland,CHE,111,1281,579,191,2162
2006,Israel,ISR,Switzerland,CHE,0,0,5,5,10
2006,Jordan,JOR,Switzerland,CHE,0,5,0,0,5
2006,Kazakhstan,KAZ,Switzerland,CHE,0,10,5,5,20
2006,Kenya,KEN,Switzerland,CHE,0,5,5,5,15
2006,Dem. People's Rep. of Korea,PRK,Switzerland,CHE,0,5,5,0,10
2006,Lao People's Dem. Rep.,LAO,Switzerland,CHE,11,0,0,0,11
2006,Liberia,LBR,Switzerland,CHE,0,5,23,13,41
2006,Libya,LBY,Switzerland,CHE,12,5,5,21,43
2006,Lebanon,LBN,Switzerland,CHE,5,5,18,35,63
2006,Sri Lanka,LKA,Switzerland,CHE,64,105,132,42,343
2006,Lithuania,LTU,Switzerland,CHE,0,0,0,5,5
2006,Latvia,LVA,Switzerland,CHE,0,5,0,5,10
2006,Madagascar,MDG,Switzerland,CHE,0,0,5,0,5
2006,Mauritania,MRT,Switzerland,CHE,0,0,0,5,5
2006,North Macedonia,MKD,Switzerland,CHE,0,27,39,52,118
2006,Rep. of Moldova,MDA,Switzerland,CHE,0,0,14,39,53
2006,Mali,MLI,Switzerland,CHE,0,0,15,19,34
2006,Mongolia,MNG,Switzerland,CHE,0,18,131,75,224
2006,Morocco,MAR,Switzerland,CHE,0,5,5,31,41
2006,Montenegro,MNE,Switzerland,CHE,0,0,13,0,13
2006,Myanmar,MMR,Switzerland,CHE,0,5,5,0,10
2006,Nepal,NPL,Switzerland,CHE,0,0,142,10,152
2006,Niger,NER,Switzerland,CHE,0,5,10,5,20
2006,Nigeria,NGA,Switzerland,CHE,0,5,117,110,232
2006,Pakistan,PAK,Switzerland,CHE,0,22,39,40,101
2006,Poland,POL,Switzerland,CHE,0,0,5,16,21
2006,Romania,ROU,Switzerland,CHE,0,0,23,45,68
2006,South Africa,ZAF,Switzerland,CHE,0,0,0,10,10
2006,Russian Federation,RUS,Switzerland,CHE,17,119,191,176,503
2006,Rwanda,RWA,Switzerland,CHE,34,10,15,0,59
2006,Serbia and Kosovo: S/RES/1244 (1999),SRB,Switzerland,CHE,60,704,793,470,2027
2006,Senegal,SEN,Switzerland,CHE,0,0,13,10,23
2006,Sierra Leone,SLE,Switzerland,CHE,0,14,22,19,55
2006,Somalia,SOM,Switzerland,CHE,20,356,263,66,705
2006,Viet Nam,VNM,Switzerland,CHE,27,0,0,0,27
2006,Sudan,SDN,Switzerland,CHE,5,22,43,35,105
2006,Slovakia,SVK,Switzerland,CHE,0,0,0,5,5
2006,Syrian Arab Rep.,SYR,Switzerland,CHE,42,104,105,47,298
2006,Turkmenistan,TKM,Switzerland,CHE,0,5,0,0,5
2006,Togo,TGO,Switzerland,CHE,131,19,92,27,269
2006,Tunisia,TUN,Switzerland,CHE,63,0,20,19,102
2006,Turkey,TUR,Switzerland,CHE,455,220,372,137,1184
2006,Uganda,UGA,Switzerland,CHE,0,0,17,5,22
2006,Ukraine,UKR,Switzerland,CHE,0,10,5,26,41
2006,Uzbekistan,UZB,Switzerland,CHE,5,5,5,0,15
2006,Western Sahara,ESH,Switzerland,CHE,0,0,0,5,5
2006,Yemen,YEM,Switzerland,CHE,5,14,11,0,30
2006,Zimbabwe,ZWE,Switzerland,CHE,0,0,17,25,42
2006,Unknown ,,Switzerland,CHE,23,96,177,381,677
2006,Indonesia,IDN,Timor-Leste,TLS,0,0,0,5,5
2006,Central African Rep.,CAF,Togo,TGO,10,0,0,0,10
2006,Dem. Rep. of the Congo,COD,Togo,TGO,5,0,10,0,15
2006,Cote d'Ivoire,CIV,Togo,TGO,31,0,17,0,48
2006,Rwanda,RWA,Togo,TGO,14,0,0,0,14
2006,Burundi,BDI,Uganda,UGA,75,0,40,0,115
2006,Dem. Rep. of the Congo,COD,Uganda,UGA,371,0,0,0,371
2006,Eritrea,ERI,Uganda,UGA,5,0,22,0,27
2006,Ethiopia,ETH,Uganda,UGA,23,0,56,0,79
2006,Kenya,KEN,Uganda,UGA,14,0,5,0,19
2006,Pakistan,PAK,Uganda,UGA,0,0,5,0,5
2006,Rwanda,RWA,Uganda,UGA,1066,0,1630,0,2696
2006,Somalia,SOM,Uganda,UGA,2046,0,0,0,2046
2006,Sudan,SDN,Uganda,UGA,42,0,5,0,47
2006,Afghanistan,AFG,Ukraine,UKR,32,0,114,38,184
2006,Angola,AGO,Ukraine,UKR,0,0,5,5,10
2006,Armenia,ARM,Ukraine,UKR,0,0,12,29,41
2006,Azerbaijan,AZE,Ukraine,UKR,0,0,22,10,32
2006,Bangladesh,BGD,Ukraine,UKR,0,0,22,221,243
2006,Belarus,BLR,Ukraine,UKR,0,0,0,10,10
2006,Bulgaria,BGR,Ukraine,UKR,0,0,0,5,5
2006,China,CHN,Ukraine,UKR,0,0,0,11,11
2006,Cameroon,CMR,Ukraine,UKR,0,0,5,10,15
2006,Congo,COG,Ukraine,UKR,0,0,5,5,10
2006,Dem. Rep. of the Congo,COD,Ukraine,UKR,0,0,11,5,16
2006,Cuba,CUB,Ukraine,UKR,0,0,0,5,5
2006,Ethiopia,ETH,Ukraine,UKR,0,0,11,10,21
2006,Palestinian,PSE,Ukraine,UKR,0,0,18,136,154
2006,Georgia,GEO,Ukraine,UKR,0,0,12,53,65
2006,Ghana,GHA,Ukraine,UKR,0,0,0,19,19
2006,Guinea,GIN,Ukraine,UKR,0,0,0,5,5
2006,Cote d'Ivoire,CIV,Ukraine,UKR,0,0,0,10,10
2006,India,IND,Ukraine,UKR,0,0,0,631,631
2006,Iran (Islamic Rep. of),IRN,Ukraine,UKR,5,0,35,0,40
2006,Iraq,IRQ,Ukraine,UKR,0,0,24,90,114
2006,Jordan,JOR,Ukraine,UKR,0,0,5,0,5
2006,Kazakhstan,KAZ,Ukraine,UKR,5,0,5,5,15
2006,Kyrgyzstan,KGZ,Ukraine,UKR,0,0,0,18,18
2006,Liberia,LBR,Ukraine,UKR,0,0,5,0,5
2006,Lebanon,LBN,Ukraine,UKR,0,0,5,10,15
2006,Sri Lanka,LKA,Ukraine,UKR,0,0,5,31,36
2006,Rep. of Moldova,MDA,Ukraine,UKR,0,0,0,24,24
2006,Mongolia,MNG,Ukraine,UKR,0,0,0,5,5
2006,Nigeria,NGA,Ukraine,UKR,0,0,26,25,51
2006,Pakistan,PAK,Ukraine,UKR,0,0,16,428,444
2006,Russian Federation,RUS,Ukraine,UKR,0,0,25,131,156
2006,Somalia,SOM,Ukraine,UKR,0,0,58,49,107
2006,Viet Nam,VNM,Ukraine,UKR,0,0,0,24,24
2006,Sudan,SDN,Ukraine,UKR,0,0,10,5,15
2006,Syrian Arab Rep.,SYR,Ukraine,UKR,0,0,18,23,41
2006,Tajikistan,TJK,Ukraine,UKR,0,0,0,10,10
2006,Turkmenistan,TKM,Ukraine,UKR,0,0,5,5,10
2006,Togo,TGO,Ukraine,UKR,0,0,0,10,10
2006,Turkey,TUR,Ukraine,UKR,0,0,10,0,10
2006,Uganda,UGA,Ukraine,UKR,0,0,0,5,5
2006,Uzbekistan,UZB,Ukraine,UKR,5,0,10,65,80
2006,Stateless,XXA,Ukraine,UKR,0,0,5,0,5
2006,Colombia,COL,Venezuela (Bolivarian Republic of),VEN,326,0,49,0,375
2006,Haiti,HTI,Venezuela (Bolivarian Republic of),VEN,5,0,0,0,5
2006,Peru,PER,Venezuela (Bolivarian Republic of),VEN,5,0,0,0,5
2007,Benin,BEN,Argentina,ARG,0,0,0,5,5
2007,Colombia,COL,Argentina,ARG,14,0,28,5,47
2007,Cuba,CUB,Argentina,ARG,5,0,5,0,10
2007,Guinea-Bissau,GNB,Argentina,ARG,0,0,5,0,5
2007,Haiti,HTI,Argentina,ARG,5,0,5,0,10
2007,Cote d'Ivoire,CIV,Argentina,ARG,10,0,0,0,10
2007,India,IND,Argentina,ARG,0,0,5,0,5
2007,Kazakhstan,KAZ,Argentina,ARG,5,0,0,0,5
2007,Nigeria,NGA,Argentina,ARG,5,0,5,0,10
2007,Peru,PER,Argentina,ARG,10,0,34,10,54
2007,Senegal,SEN,Argentina,ARG,0,0,131,0,131
2007,Cuba,CUB,Armenia,ARM,0,0,5,0,5
2007,Iran (Islamic Rep. of),IRN,Armenia,ARM,0,0,5,5,10
2007,Iraq,IRQ,Armenia,ARM,0,253,0,11,264
2007,Afghanistan,AFG,Australia,AUS,20,0,0,0,20
2007,Albania,ALB,Australia,AUS,0,0,12,0,12
2007,Egypt,EGY,Australia,AUS,25,0,15,0,40
2007,Bahrain,BHR,Australia,AUS,0,0,5,0,5
2007,Burundi,BDI,Australia,AUS,5,0,0,0,5
2007,Bangladesh,BGD,Australia,AUS,11,0,49,0,60
2007,Cambodia,KHM,Australia,AUS,0,0,5,0,5
2007,China,CHN,Australia,AUS,140,0,867,10,1017
2007,Chile,CHL,Australia,AUS,0,0,12,0,12
2007,Cameroon,CMR,Australia,AUS,0,0,5,0,5
2007,Colombia,COL,Australia,AUS,11,0,18,0,29
2007,Eritrea,ERI,Australia,AUS,12,0,0,0,12
2007,Ethiopia,ETH,Australia,AUS,12,0,13,0,25
2007,Fiji,FJI,Australia,AUS,26,0,52,0,78
2007,Palestinian,PSE,Australia,AUS,5,0,5,0,10
2007,United Kingdom of Great Britain and Northern Ireland,GBR,Australia,AUS,0,0,5,0,5
2007,Ghana,GHA,Australia,AUS,0,0,14,0,14
2007,"China, Hong Kong SAR",HKG,Australia,AUS,0,0,10,0,10
2007,Croatia,HRV,Australia,AUS,5,0,0,0,5
2007,India,IND,Australia,AUS,12,0,340,5,357
2007,Indonesia,IDN,Australia,AUS,5,0,160,0,165
2007,Iran (Islamic Rep. of),IRN,Australia,AUS,47,0,29,5,81
2007,Iraq,IRQ,Australia,AUS,224,0,10,0,234
2007,Israel,ISR,Australia,AUS,0,0,11,0,11
2007,Jordan,JOR,Australia,AUS,0,0,5,0,5
2007,Kenya,KEN,Australia,AUS,0,0,5,0,5
2007,Rep. of Korea,KOR,Australia,AUS,0,0,68,0,68
2007,Liberia,LBR,Australia,AUS,5,0,0,0,5
2007,Lebanon,LBN,Australia,AUS,10,0,72,5,87
2007,Sri Lanka,LKA,Australia,AUS,424,0,54,0,478
2007,Lithuania,LTU,Australia,AUS,0,0,5,0,5
2007,North Macedonia,MKD,Australia,AUS,0,0,5,0,5
2007,Malaysia,MYS,Australia,AUS,5,0,118,0,123
2007,Mongolia,MNG,Australia,AUS,5,0,14,0,19
2007,Morocco,MAR,Australia,AUS,0,0,11,0,11
2007,Myanmar,MMR,Australia,AUS,34,0,10,0,44
2007,Nepal,NPL,Australia,AUS,5,0,37,0,42
2007,Netherlands,NLD,Australia,AUS,0,0,0,5,5
2007,Nigeria,NGA,Australia,AUS,0,0,13,0,13
2007,New Zealand,NZL,Australia,AUS,0,0,5,0,5
2007,Pakistan,PAK,Australia,AUS,63,0,58,0,121
2007,Philippines,PHL,Australia,AUS,0,0,37,0,37
2007,Papua New Guinea,PNG,Australia,AUS,10,0,10,0,20
2007,Portugal,PRT,Australia,AUS,0,0,10,0,10
2007,Romania,ROU,Australia,AUS,0,0,5,0,5
2007,South Africa,ZAF,Australia,AUS,5,0,10,0,15
2007,Russian Federation,RUS,Australia,AUS,5,0,15,0,20
2007,Saudi Arabia,SAU,Australia,AUS,5,0,0,0,5
2007,Serbia and Kosovo: S/RES/1244 (1999),SRB,Australia,AUS,5,0,5,0,10
2007,Singapore,SGP,Australia,AUS,0,0,5,0,5
2007,Somalia,SOM,Australia,AUS,5,0,0,0,5
2007,Viet Nam,VNM,Australia,AUS,0,0,31,0,31
2007,Sudan,SDN,Australia,AUS,10,0,5,0,15
2007,Syrian Arab Rep.,SYR,Australia,AUS,0,0,10,0,10
2007,United Rep. of Tanzania,TZA,Australia,AUS,0,0,5,0,5
2007,Thailand,THA,Australia,AUS,0,0,25,5,30
2007,Timor-Leste,TLS,Australia,AUS,0,0,19,0,19
2007,Tonga,TON,Australia,AUS,0,0,14,0,14
2007,Turkey,TUR,Australia,AUS,0,0,25,0,25
2007,Ukraine,UKR,Australia,AUS,0,0,10,0,10
2007,Uzbekistan,UZB,Australia,AUS,0,0,5,0,5
2007,Zimbabwe,ZWE,Australia,AUS,42,0,42,5,89
2007,Stateless,XXA,Australia,AUS,0,0,5,0,5
2007,Tibetan,TIB,Australia,AUS,0,0,5,0,5
2007,Afghanistan,AFG,Azerbaijan,AZE,0,0,148,5,153
2007,Iran (Islamic Rep. of),IRN,Azerbaijan,AZE,14,0,30,5,49
2007,Iraq,IRQ,Azerbaijan,AZE,5,0,14,0,19
2007,Jordan,JOR,Azerbaijan,AZE,0,0,0,5,5
2007,Pakistan,PAK,Azerbaijan,AZE,0,0,16,0,16
2007,Russian Federation,RUS,Azerbaijan,AZE,0,0,5,0,5
2007,Dem. Rep. of the Congo,COD,Burundi,BDI,167,0,395,659,1221
2007,Afghanistan,AFG,Belgium,BEL,29,16,282,10,337
2007,Albania,ALB,Belgium,BEL,49,0,66,30,145
2007,Algeria,DZA,Belgium,BEL,11,0,72,20,103
2007,Angola,AGO,Belgium,BEL,12,0,180,5,197
2007,Egypt,EGY,Belgium,BEL,0,0,27,0,27
2007,Armenia,ARM,Belgium,BEL,5,0,241,17,263
2007,Azerbaijan,AZE,Belgium,BEL,11,0,22,5,38
2007,Burundi,BDI,Belgium,BEL,54,0,93,15,162
2007,Benin,BEN,Belgium,BEL,0,0,13,0,13
2007,Bangladesh,BGD,Belgium,BEL,5,0,55,5,65
2007,Bhutan,BTN,Belgium,BEL,0,0,12,0,12
2007,Burkina Faso,BFA,Belgium,BEL,5,0,12,0,17
2007,Belarus,BLR,Belgium,BEL,18,0,54,10,82
2007,Bosnia and Herzegovina,BIH,Belgium,BEL,10,0,33,11,54
2007,Bulgaria,BGR,Belgium,BEL,0,0,18,5,23
2007,Central African Rep.,CAF,Belgium,BEL,5,0,0,0,5
2007,Chad,TCD,Belgium,BEL,17,0,10,0,27
2007,China,CHN,Belgium,BEL,104,0,102,5,211
2007,Cameroon,CMR,Belgium,BEL,53,0,222,10,285
2007,Congo,COG,Belgium,BEL,5,0,36,5,46
2007,Dem. Rep. of the Congo,COD,Belgium,BEL,147,0,901,69,1117
2007,Colombia,COL,Belgium,BEL,5,0,0,0,5
2007,Cuba,CUB,Belgium,BEL,0,0,5,0,5
2007,Djibouti,DJI,Belgium,BEL,20,0,40,16,76
2007,Eritrea,ERI,Belgium,BEL,15,10,11,0,36
2007,Ethiopia,ETH,Belgium,BEL,13,0,21,0,34
2007,Gabon,GAB,Belgium,BEL,0,0,5,0,5
2007,Gambia,GMB,Belgium,BEL,0,0,10,0,10
2007,Palestinian,PSE,Belgium,BEL,5,5,5,5,20
2007,Georgia,GEO,Belgium,BEL,0,0,81,10,91
2007,Ghana,GHA,Belgium,BEL,0,0,5,0,5
2007,Guinea-Bissau,GNB,Belgium,BEL,5,0,0,0,5
2007,Guatemala,GTM,Belgium,BEL,0,0,5,0,5
2007,Guinea,GIN,Belgium,BEL,115,0,317,12,444
2007,Croatia,HRV,Belgium,BEL,0,0,0,5,5
2007,Cote d'Ivoire,CIV,Belgium,BEL,54,0,196,11,261
2007,India,IND,Belgium,BEL,0,0,30,5,35
2007,Iran (Islamic Rep. of),IRN,Belgium,BEL,58,0,345,51,454
2007,Iraq,IRQ,Belgium,BEL,206,238,241,67,752
2007,Israel,ISR,Belgium,BEL,0,0,10,5,15
2007,Jamaica,JAM,Belgium,BEL,0,0,5,0,5
2007,Jordan,JOR,Belgium,BEL,5,0,5,5,15
2007,Kazakhstan,KAZ,Belgium,BEL,0,0,23,15,38
2007,Kenya,KEN,Belgium,BEL,5,0,32,5,42
2007,Kyrgyzstan,KGZ,Belgium,BEL,0,0,22,0,22
2007,Liberia,LBR,Belgium,BEL,0,0,11,5,16
2007,Libya,LBY,Belgium,BEL,10,0,23,0,33
2007,Lebanon,LBN,Belgium,BEL,16,0,139,0,155
2007,Sri Lanka,LKA,Belgium,BEL,25,0,19,5,49
2007,Madagascar,MDG,Belgium,BEL,5,0,0,0,5
2007,Mauritania,MRT,Belgium,BEL,12,0,53,5,70
2007,North Macedonia,MKD,Belgium,BEL,5,0,22,0,27
2007,Rep. of Moldova,MDA,Belgium,BEL,5,0,14,0,19
2007,Mali,MLI,Belgium,BEL,0,0,5,0,5
2007,Mongolia,MNG,Belgium,BEL,0,0,15,0,15
2007,Morocco,MAR,Belgium,BEL,0,0,17,0,17
2007,Montenegro,MNE,Belgium,BEL,0,0,5,0,5
2007,Myanmar,MMR,Belgium,BEL,5,0,10,0,15
2007,Nepal,NPL,Belgium,BEL,5,0,168,5,178
2007,Niger,NER,Belgium,BEL,5,0,40,5,50
2007,Nigeria,NGA,Belgium,BEL,0,0,33,5,38
2007,Pakistan,PAK,Belgium,BEL,10,0,119,13,142
2007,Peru,PER,Belgium,BEL,5,0,0,0,5
2007,Romania,ROU,Belgium,BEL,0,0,24,5,29
2007,Russian Federation,RUS,Belgium,BEL,679,0,776,78,1533
2007,Rwanda,RWA,Belgium,BEL,254,0,587,13,854
2007,Serbia and Kosovo: S/RES/1244 (1999),SRB,Belgium,BEL,295,0,570,80,945
2007,Senegal,SEN,Belgium,BEL,10,0,10,0,20
2007,Sierra Leone,SLE,Belgium,BEL,5,0,14,5,24
2007,Somalia,SOM,Belgium,BEL,19,37,47,5,108
2007,Viet Nam,VNM,Belgium,BEL,0,0,5,0,5
2007,Sudan,SDN,Belgium,BEL,11,0,25,0,36
2007,Slovakia,SVK,Belgium,BEL,0,0,10,25,35
2007,Syrian Arab Rep.,SYR,Belgium,BEL,66,0,258,28,352
2007,United Rep. of Tanzania,TZA,Belgium,BEL,0,0,22,5,27
2007,Tajikistan,TJK,Belgium,BEL,0,0,5,5,10
2007,Togo,TGO,Belgium,BEL,15,0,113,5,133
2007,Tunisia,TUN,Belgium,BEL,16,0,5,0,21
2007,Turkey,TUR,Belgium,BEL,41,0,239,15,295
2007,Uganda,UGA,Belgium,BEL,0,0,5,0,5
2007,Ukraine,UKR,Belgium,BEL,5,0,26,10,41
2007,Uzbekistan,UZB,Belgium,BEL,12,0,19,13,44
2007,Yemen,YEM,Belgium,BEL,0,0,10,0,10
2007,Stateless,XXA,Belgium,BEL,0,0,5,5,10
2007,Unknown ,,Belgium,BEL,90,11,249,20,370
2007,Central African Rep.,CAF,Benin,BEN,0,0,23,5,28
2007,Chad,TCD,Benin,BEN,5,0,44,15,64
2007,Cameroon,CMR,Benin,BEN,0,0,17,0,17
2007,Congo,COG,Benin,BEN,0,0,88,0,88
2007,Dem. Rep. of the Congo,COD,Benin,BEN,5,0,360,86,451
2007,Guinea,GIN,Benin,BEN,0,0,5,0,5
2007,Cote d'Ivoire,CIV,Benin,BEN,11,0,27,26,64
2007,Iraq,IRQ,Benin,BEN,5,0,0,0,5
2007,Nigeria,NGA,Benin,BEN,0,0,185,0,185
2007,Rwanda,RWA,Benin,BEN,0,0,13,0,13
2007,Togo,TGO,Benin,BEN,5,0,114,0,119
2007,Burundi,BDI,Burkina Faso,BFA,5,0,0,0,5
2007,Central African Rep.,CAF,Burkina Faso,BFA,0,0,5,0,5
2007,Chad,TCD,Burkina Faso,BFA,5,0,5,0,10
2007,Congo,COG,Burkina Faso,BFA,0,0,5,0,5
2007,Dem. Rep. of the Congo,COD,Burkina Faso,BFA,5,0,5,0,10
2007,Guinea,GIN,Burkina Faso,BFA,5,0,0,5,10
2007,Cote d'Ivoire,CIV,Burkina Faso,BFA,15,0,5,0,20
2007,Liberia,LBR,Burkina Faso,BFA,0,0,0,98,98
2007,Rwanda,RWA,Burkina Faso,BFA,5,0,0,0,5
2007,Sierra Leone,SLE,Burkina Faso,BFA,0,0,0,30,30
2007,Togo,TGO,Burkina Faso,BFA,0,0,19,0,19
2007,Afghanistan,AFG,Belarus,BLR,0,0,32,5,37
2007,Bangladesh,BGD,Belarus,BLR,0,0,0,5,5
2007,Georgia,GEO,Belarus,BLR,0,0,5,0,5
2007,Latvia,LVA,Belarus,BLR,0,0,5,0,5
2007,Colombia,COL,Bolivia (Plurinational State of),BOL,16,0,0,5,21
2007,Eritrea,ERI,Bolivia (Plurinational State of),BOL,0,0,0,5,5
2007,Somalia,SOM,Bolivia (Plurinational State of),BOL,0,0,0,5,5
2007,Burundi,BDI,Botswana,BWA,5,0,0,0,5
2007,Dem. Rep. of the Congo,COD,Botswana,BWA,5,0,0,0,5
2007,Ethiopia,ETH,Botswana,BWA,0,0,0,5,5
2007,Namibia,NAM,Botswana,BWA,18,0,0,0,18
2007,Rwanda,RWA,Botswana,BWA,5,0,0,0,5
2007,Somalia,SOM,Botswana,BWA,5,0,0,0,5
2007,Zimbabwe,ZWE,Botswana,BWA,11,0,0,0,11
2007,Angola,AGO,Brazil,BRA,5,0,5,5,15
2007,Dem. Rep. of the Congo,COD,Brazil,BRA,22,0,33,0,55
2007,Colombia,COL,Brazil,BRA,50,0,61,5,116
2007,Cuba,CUB,Brazil,BRA,11,0,15,10,36
2007,Ethiopia,ETH,Brazil,BRA,0,0,5,0,5
2007,Ghana,GHA,Brazil,BRA,0,0,5,0,5
2007,Guinea-Bissau,GNB,Brazil,BRA,0,0,11,0,11
2007,Cote d'Ivoire,CIV,Brazil,BRA,0,0,5,0,5
2007,Iraq,IRQ,Brazil,BRA,44,5,0,0,49
2007,Liberia,LBR,Brazil,BRA,0,0,10,0,10
2007,Lebanon,LBN,Brazil,BRA,0,0,170,0,170
2007,Mozambique,MOZ,Brazil,BRA,0,0,5,0,5
2007,Nigeria,NGA,Brazil,BRA,0,0,10,0,10
2007,Peru,PER,Brazil,BRA,0,0,14,0,14
2007,Romania,ROU,Brazil,BRA,0,0,10,0,10
2007,Sudan,SDN,Brazil,BRA,5,0,0,0,5
2007,Burkina Faso,BFA,Central African Rep.,CAF,5,0,0,0,5
2007,Chad,TCD,Central African Rep.,CAF,87,0,21,0,108
2007,Cameroon,CMR,Central African Rep.,CAF,5,0,0,0,5
2007,Congo,COG,Central African Rep.,CAF,5,0,0,0,5
2007,Dem. Rep. of the Congo,COD,Central African Rep.,CAF,208,0,0,0,208
2007,Cote d'Ivoire,CIV,Central African Rep.,CAF,5,0,0,0,5
2007,Rwanda,RWA,Central African Rep.,CAF,5,0,0,0,5
2007,Sierra Leone,SLE,Central African Rep.,CAF,5,0,0,0,5
2007,Sudan,SDN,Central African Rep.,CAF,31,0,0,0,31
2007,Dem. Rep. of the Congo,COD,Chile,CHL,10,0,0,0,10
2007,Colombia,COL,Chile,CHL,223,0,285,31,539
2007,Cuba,CUB,Chile,CHL,5,0,0,0,5
2007,Ecuador,ECU,Chile,CHL,0,0,10,0,10
2007,Peru,PER,Chile,CHL,5,0,5,0,10
2007,Cuba,CUB,Colombia,COL,10,0,75,0,85
2007,Ethiopia,ETH,Colombia,COL,5,0,0,0,5
2007,Iran (Islamic Rep. of),IRN,Colombia,COL,0,0,5,0,5
2007,Venezuela (Bolivarian Republic of),VEN,Colombia,COL,10,0,5,0,15
2007,Afghanistan,AFG,Cyprus,CYP,0,0,61,29,90
2007,Algeria,DZA,Cyprus,CYP,0,0,5,0,5
2007,Egypt,EGY,Cyprus,CYP,0,0,19,48,67
2007,Armenia,ARM,Cyprus,CYP,0,0,153,95,248
2007,Bangladesh,BGD,Cyprus,CYP,0,0,177,148,325
2007,Belarus,BLR,Cyprus,CYP,0,0,5,19,24
2007,Bosnia and Herzegovina,BIH,Cyprus,CYP,0,0,0,5,5
2007,Bulgaria,BGR,Cyprus,CYP,0,0,0,110,110
2007,China,CHN,Cyprus,CYP,0,0,21,78,99
2007,Cameroon,CMR,Cyprus,CYP,0,0,27,17,44
2007,Dem. Rep. of the Congo,COD,Cyprus,CYP,0,0,5,5,10
2007,Palestinian,PSE,Cyprus,CYP,0,40,12,71,123
2007,Georgia,GEO,Cyprus,CYP,0,5,183,279,467
2007,Ghana,GHA,Cyprus,CYP,0,0,5,5,10
2007,India,IND,Cyprus,CYP,0,0,54,133,187
2007,Indonesia,IDN,Cyprus,CYP,0,0,5,5,10
2007,Iran (Islamic Rep. of),IRN,Cyprus,CYP,10,5,109,162,286
2007,Iraq,IRQ,Cyprus,CYP,10,125,19,88,242
2007,Jordan,JOR,Cyprus,CYP,0,0,12,55,67
2007,Kazakhstan,KAZ,Cyprus,CYP,0,0,0,19,19
2007,Lebanon,LBN,Cyprus,CYP,0,5,5,27,37
2007,Sri Lanka,LKA,Cyprus,CYP,0,0,147,157,304
2007,Mauritania,MRT,Cyprus,CYP,0,0,0,5,5
2007,North Macedonia,MKD,Cyprus,CYP,0,0,30,42,72
2007,Rep. of Moldova,MDA,Cyprus,CYP,0,0,42,77,119
2007,Mongolia,MNG,Cyprus,CYP,0,0,0,5,5
2007,Morocco,MAR,Cyprus,CYP,0,0,5,5,10
2007,Nepal,NPL,Cyprus,CYP,0,0,25,25,50
2007,Nigeria,NGA,Cyprus,CYP,0,0,5,5,10
2007,Pakistan,PAK,Cyprus,CYP,0,0,311,372,683
2007,Philippines,PHL,Cyprus,CYP,0,0,22,77,99
2007,Romania,ROU,Cyprus,CYP,0,0,0,38,38
2007,Russian Federation,RUS,Cyprus,CYP,0,0,15,384,399
2007,Viet Nam,VNM,Cyprus,CYP,0,0,0,5,5
2007,Syrian Arab Rep.,SYR,Cyprus,CYP,0,0,761,1517,2278
2007,Tunisia,TUN,Cyprus,CYP,0,0,0,5,5
2007,Turkey,TUR,Cyprus,CYP,13,5,26,57,101
2007,Ukraine,UKR,Cyprus,CYP,0,0,43,397,440
2007,Uzbekistan,UZB,Cyprus,CYP,0,0,5,52,57
2007,Afghanistan,AFG,Czechia,CZE,10,5,0,5,20
2007,Algeria,DZA,Czechia,CZE,0,0,13,0,13
2007,Armenia,ARM,Czechia,CZE,5,0,33,11,49
2007,Bangladesh,BGD,Czechia,CZE,0,0,10,10,20
2007,Belarus,BLR,Czechia,CZE,32,52,80,27,191
2007,China,CHN,Czechia,CZE,0,0,41,15,56
2007,Cameroon,CMR,Czechia,CZE,0,0,10,0,10
2007,Dem. Rep. of the Congo,COD,Czechia,CZE,0,0,14,0,14
2007,Cuba,CUB,Czechia,CZE,10,21,0,12,43
2007,Georgia,GEO,Czechia,CZE,5,5,42,5,57
2007,Ghana,GHA,Czechia,CZE,0,0,10,0,10
2007,Guinea,GIN,Czechia,CZE,0,0,5,0,5
2007,Cote d'Ivoire,CIV,Czechia,CZE,0,0,13,5,18
2007,India,IND,Czechia,CZE,0,0,13,5,18
2007,Iran (Islamic Rep. of),IRN,Czechia,CZE,0,0,5,0,5
2007,Iraq,IRQ,Czechia,CZE,17,33,10,20,80
2007,Kazakhstan,KAZ,Czechia,CZE,5,0,145,0,150
2007,Kyrgyzstan,KGZ,Czechia,CZE,5,0,73,0,78
2007,Sri Lanka,LKA,Czechia,CZE,0,0,27,10,37
2007,North Macedonia,MKD,Czechia,CZE,0,0,10,0,10
2007,Rep. of Moldova,MDA,Czechia,CZE,0,0,19,5,24
2007,Mongolia,MNG,Czechia,CZE,0,0,149,0,149
2007,Myanmar,MMR,Czechia,CZE,5,0,0,0,5
2007,Nepal,NPL,Czechia,CZE,0,0,5,0,5
2007,Nigeria,NGA,Czechia,CZE,0,0,59,27,86
2007,Pakistan,PAK,Czechia,CZE,0,0,20,5,25
2007,Russian Federation,RUS,Czechia,CZE,31,31,96,26,184
2007,Serbia and Kosovo: S/RES/1244 (1999),SRB,Czechia,CZE,0,0,13,29,42
2007,Sierra Leone,SLE,Czechia,CZE,0,0,5,0,5
2007,Somalia,SOM,Czechia,CZE,10,5,0,0,15
2007,Viet Nam,VNM,Czechia,CZE,0,0,93,5,98
2007,Slovakia,SVK,Czechia,CZE,0,0,0,5,5
2007,Syrian Arab Rep.,SYR,Czechia,CZE,0,5,10,23,38
2007,Thailand,THA,Czechia,CZE,0,0,5,0,5
2007,Turkey,TUR,Czechia,CZE,0,0,146,14,160
2007,Ukraine,UKR,Czechia,CZE,19,0,281,10,310
2007,Uzbekistan,UZB,Czechia,CZE,11,10,21,0,42
2007,Stateless,XXA,Czechia,CZE,5,5,37,14,61
2007,Unknown ,,Czechia,CZE,5,19,5,0,29
2007,Afghanistan,AFG,Denmark,DNK,5,16,25,0,46
2007,Albania,ALB,Denmark,DNK,0,0,5,0,5
2007,Armenia,ARM,Denmark,DNK,0,0,5,0,5
2007,Azerbaijan,AZE,Denmark,DNK,0,0,5,0,5
2007,Belarus,BLR,Denmark,DNK,0,0,5,0,5
2007,Bosnia and Herzegovina,BIH,Denmark,DNK,0,0,15,0,15
2007,Bulgaria,BGR,Denmark,DNK,0,0,5,0,5
2007,Cambodia,KHM,Denmark,DNK,0,0,5,0,5
2007,China,CHN,Denmark,DNK,5,0,19,0,24
2007,Palestinian,PSE,Denmark,DNK,11,0,13,0,24
2007,Georgia,GEO,Denmark,DNK,0,0,5,0,5
2007,India,IND,Denmark,DNK,0,0,11,0,11
2007,Iran (Islamic Rep. of),IRN,Denmark,DNK,23,13,22,0,58
2007,Iraq,IRQ,Denmark,DNK,0,28,44,0,72
2007,Kazakhstan,KAZ,Denmark,DNK,0,0,5,0,5
2007,Liberia,LBR,Denmark,DNK,0,0,5,0,5
2007,Lebanon,LBN,Denmark,DNK,0,0,10,0,10
2007,Sri Lanka,LKA,Denmark,DNK,0,5,19,0,24
2007,North Macedonia,MKD,Denmark,DNK,0,0,5,0,5
2007,Morocco,MAR,Denmark,DNK,0,0,5,0,5
2007,Myanmar,MMR,Denmark,DNK,5,0,0,0,5
2007,Netherlands,NLD,Denmark,DNK,0,0,5,0,5
2007,Nigeria,NGA,Denmark,DNK,0,0,20,0,20
2007,Pakistan,PAK,Denmark,DNK,5,0,5,0,10
2007,Poland,POL,Denmark,DNK,0,0,5,0,5
2007,Russian Federation,RUS,Denmark,DNK,0,17,17,0,34
2007,Serbia and Kosovo: S/RES/1244 (1999),SRB,Denmark,DNK,0,0,37,0,37
2007,Somalia,SOM,Denmark,DNK,0,5,10,0,15
2007,Syrian Arab Rep.,SYR,Denmark,DNK,13,10,10,0,33
2007,Turkey,TUR,Denmark,DNK,0,0,10,0,10
2007,Uganda,UGA,Denmark,DNK,0,0,5,0,5
2007,Stateless,XXA,Denmark,DNK,5,0,0,0,5
2007,Belarus,BLR,Estonia,EST,0,0,0,5,5
2007,Russian Federation,RUS,Estonia,EST,0,0,5,0,5
2007,Afghanistan,AFG,Finland,FIN,5,103,25,13,146
2007,Albania,ALB,Finland,FIN,0,0,5,10,15
2007,Algeria,DZA,Finland,FIN,0,0,0,20,20
2007,Angola,AGO,Finland,FIN,0,15,5,5,25
2007,Egypt,EGY,Finland,FIN,0,0,0,5,5
2007,Armenia,ARM,Finland,FIN,0,0,5,5,10
2007,Azerbaijan,AZE,Finland,FIN,0,5,0,0,5
2007,Bangladesh,BGD,Finland,FIN,0,0,5,10,15
2007,Belarus,BLR,Finland,FIN,0,0,19,46,65
2007,Bosnia and Herzegovina,BIH,Finland,FIN,0,5,0,17,22
2007,Bulgaria,BGR,Finland,FIN,0,0,0,32,32
2007,China,CHN,Finland,FIN,5,5,0,0,10
2007,Cameroon,CMR,Finland,FIN,0,5,10,5,20
2007,Dem. Rep. of the Congo,COD,Finland,FIN,0,20,10,5,35
2007,Ethiopia,ETH,Finland,FIN,0,14,0,5,19
2007,Gambia,GMB,Finland,FIN,0,5,5,5,15
2007,Georgia,GEO,Finland,FIN,0,0,0,10,10
2007,Ghana,GHA,Finland,FIN,0,5,5,0,10
2007,Guinea,GIN,Finland,FIN,0,5,0,0,5
2007,Honduras,HND,Finland,FIN,0,5,0,0,5
2007,India,IND,Finland,FIN,0,5,0,14,19
2007,Iran (Islamic Rep. of),IRN,Finland,FIN,5,33,28,28,94
2007,Iraq,IRQ,Finland,FIN,18,192,0,99,309
2007,Israel,ISR,Finland,FIN,0,0,0,5,5
2007,Jordan,JOR,Finland,FIN,0,5,0,0,5
2007,Kazakhstan,KAZ,Finland,FIN,0,0,0,10,10
2007,Kyrgyzstan,KGZ,Finland,FIN,0,0,10,5,15
2007,Libya,LBY,Finland,FIN,0,0,5,13,18
2007,Lebanon,LBN,Finland,FIN,0,5,0,5,10
2007,Sri Lanka,LKA,Finland,FIN,0,5,30,5,40
2007,Lithuania,LTU,Finland,FIN,0,0,0,5,5
2007,North Macedonia,MKD,Finland,FIN,0,0,5,5,10
2007,Rep. of Moldova,MDA,Finland,FIN,0,0,0,24,24
2007,Mali,MLI,Finland,FIN,0,0,0,5,5
2007,Nigeria,NGA,Finland,FIN,0,5,19,22,46
2007,Pakistan,PAK,Finland,FIN,0,0,0,5,5
2007,Romania,ROU,Finland,FIN,0,0,0,5,5
2007,Russian Federation,RUS,Finland,FIN,27,5,30,111,173
2007,Serbia and Kosovo: S/RES/1244 (1999),SRB,Finland,FIN,0,38,30,123,191
2007,Senegal,SEN,Finland,FIN,0,0,0,5,5
2007,Somalia,SOM,Finland,FIN,0,231,0,12,243
2007,Slovakia,SVK,Finland,FIN,0,0,0,10,10
2007,Syrian Arab Rep.,SYR,Finland,FIN,0,5,5,5,15
2007,United Rep. of Tanzania,TZA,Finland,FIN,0,0,0,5,5
2007,Tajikistan,TJK,Finland,FIN,0,5,0,0,5
2007,Turkey,TUR,Finland,FIN,0,10,11,31,52
2007,Ukraine,UKR,Finland,FIN,0,0,0,5,5
2007,United States of America,USA,Finland,FIN,0,0,0,5,5
2007,Uzbekistan,UZB,Finland,FIN,0,5,5,0,10
2007,Stateless,XXA,Finland,FIN,0,5,0,5,10
2007,Unknown ,,Finland,FIN,0,5,0,5,10
2007,Afghanistan,AFG,France,FRA,36,0,82,0,118
2007,Albania,ALB,France,FRA,5,5,189,0,199
2007,Algeria,DZA,France,FRA,35,24,973,0,1032
2007,Angola,AGO,France,FRA,34,0,446,0,480
2007,Egypt,EGY,France,FRA,10,0,22,0,32
2007,Armenia,ARM,France,FRA,52,0,1607,0,1659
2007,Azerbaijan,AZE,France,FRA,80,0,421,0,501
2007,Burundi,BDI,France,FRA,10,0,17,0,27
2007,Bangladesh,BGD,France,FRA,35,0,1050,0,1085
2007,Burkina Faso,BFA,France,FRA,0,0,11,0,11
2007,Belarus,BLR,France,FRA,5,0,109,0,114
2007,Bolivia (Plurinational State of),BOL,France,FRA,5,0,10,0,15
2007,Bosnia and Herzegovina,BIH,France,FRA,14,0,168,0,182
2007,Cambodia,KHM,France,FRA,0,0,30,0,30
2007,Central African Rep.,CAF,France,FRA,22,0,153,0,175
2007,Chad,TCD,France,FRA,22,0,122,0,144
2007,China,CHN,France,FRA,70,0,1401,0,1471
2007,Cameroon,CMR,France,FRA,18,0,166,0,184
2007,Congo,COG,France,FRA,63,0,761,0,824
2007,Dem. Rep. of the Congo,COD,France,FRA,205,5,1874,0,2084
2007,Comoros,COM,France,FRA,0,0,66,0,66
2007,Colombia,COL,France,FRA,29,0,84,0,113
2007,Cuba,CUB,France,FRA,5,0,21,0,26
2007,Dominican Rep.,DOM,France,FRA,0,0,10,0,10
2007,Eritrea,ERI,France,FRA,50,0,17,0,67
2007,Ethiopia,ETH,France,FRA,29,0,23,0,52
2007,Gabon,GAB,France,FRA,0,0,10,0,10
2007,Gambia,GMB,France,FRA,0,0,27,0,27
2007,Palestinian,PSE,France,FRA,5,0,50,0,55
2007,Georgia,GEO,France,FRA,23,5,290,0,318
2007,Guinea-Bissau,GNB,France,FRA,5,0,64,0,69
2007,Guinea,GIN,France,FRA,276,0,846,0,1122
2007,Haiti,HTI,France,FRA,75,39,1102,0,1216
2007,Cote d'Ivoire,CIV,France,FRA,105,0,542,0,647
2007,India,IND,France,FRA,0,0,66,0,66
2007,Iran (Islamic Rep. of),IRN,France,FRA,30,0,89,0,119
2007,Iraq,IRQ,France,FRA,44,26,75,0,145
2007,Kazakhstan,KAZ,France,FRA,0,0,36,0,36
2007,Kyrgyzstan,KGZ,France,FRA,5,0,41,0,46
2007,Liberia,LBR,France,FRA,0,0,17,0,17
2007,Sri Lanka,LKA,France,FRA,536,0,2639,0,3175
2007,Madagascar,MDG,France,FRA,5,0,33,0,38
2007,Mauritania,MRT,France,FRA,55,0,616,0,671
2007,North Macedonia,MKD,France,FRA,0,0,103,0,103
2007,Rep. of Moldova,MDA,France,FRA,0,0,335,0,335
2007,Mali,MLI,France,FRA,206,0,57,0,263
2007,Mongolia,MNG,France,FRA,5,0,103,0,108
2007,Morocco,MAR,France,FRA,0,0,38,0,38
2007,Myanmar,MMR,France,FRA,5,0,22,0,27
2007,Niger,NER,France,FRA,0,0,5,0,5
2007,Nigeria,NGA,France,FRA,13,5,504,0,522
2007,Pakistan,PAK,France,FRA,14,0,385,0,399
2007,Peru,PER,France,FRA,0,0,59,0,59
2007,Romania,ROU,France,FRA,0,0,42,0,42
2007,South Africa,ZAF,France,FRA,0,0,5,0,5
2007,Russian Federation,RUS,France,FRA,302,0,1377,0,1679
2007,Rwanda,RWA,France,FRA,144,0,107,0,251
2007,Serbia and Kosovo: S/RES/1244 (1999),SRB,France,FRA,62,0,2471,0,2533
2007,Senegal,SEN,France,FRA,10,0,41,0,51
2007,Sierra Leone,SLE,France,FRA,19,0,92,0,111
2007,Somalia,SOM,France,FRA,31,0,33,0,64
2007,Sudan,SDN,France,FRA,160,0,322,0,482
2007,Syrian Arab Rep.,SYR,France,FRA,5,0,19,0,24
2007,Tajikistan,TJK,France,FRA,0,0,5,0,5
2007,Togo,TGO,France,FRA,13,0,126,0,139
2007,Tunisia,TUN,France,FRA,10,0,23,0,33
2007,Turkey,TUR,France,FRA,148,0,2702,0,2850
2007,Ukraine,UKR,France,FRA,5,0,91,0,96
2007,United States of America,USA,France,FRA,0,0,10,0,10
2007,Uzbekistan,UZB,France,FRA,0,0,27,0,27
2007,Zimbabwe,ZWE,France,FRA,5,0,5,0,10
2007,Stateless,XXA,France,FRA,51,0,122,0,173
2007,Unknown ,,France,FRA,41,5,319,0,365
2007,Senegal,SEN,Gambia,GMB,0,0,0,600,600
2007,Afghanistan,AFG,United Kingdom of Great Britain and Northern Ireland,GBR,137,810,1309,505,2761
2007,Albania,ALB,United Kingdom of Great Britain and Northern Ireland,GBR,0,38,132,59,229
2007,Algeria,DZA,United Kingdom of Great Britain and Northern Ireland,GBR,5,15,236,102,358
2007,Angola,AGO,United Kingdom of Great Britain and Northern Ireland,GBR,33,23,69,11,136
2007,Egypt,EGY,United Kingdom of Great Britain and Northern Ireland,GBR,5,0,46,13,64
2007,Armenia,ARM,United Kingdom of Great Britain and Northern Ireland,GBR,0,0,15,0,15
2007,Azerbaijan,AZE,United Kingdom of Great Britain and Northern Ireland,GBR,5,0,43,5,53
2007,Bahrain,BHR,United Kingdom of Great Britain and Northern Ireland,GBR,0,0,0,5,5
2007,Burundi,BDI,United Kingdom of Great Britain and Northern Ireland,GBR,5,10,27,5,47
2007,Benin,BEN,United Kingdom of Great Britain and Northern Ireland,GBR,0,5,5,0,10
2007,Bangladesh,BGD,United Kingdom of Great Britain and Northern Ireland,GBR,5,118,310,128,561
2007,Bhutan,BTN,United Kingdom of Great Britain and Northern Ireland,GBR,5,0,17,0,22
2007,Belarus,BLR,United Kingdom of Great Britain and Northern Ireland,GBR,16,0,55,12,83
2007,Bolivia (Plurinational State of),BOL,United Kingdom of Great Britain and Northern Ireland,GBR,0,0,17,0,17
2007,Botswana,BWA,United Kingdom of Great Britain and Northern Ireland,GBR,0,0,5,0,5
2007,Brazil,BRA,United Kingdom of Great Britain and Northern Ireland,GBR,0,0,23,5,28
2007,Bosnia and Herzegovina,BIH,United Kingdom of Great Britain and Northern Ireland,GBR,5,0,18,5,28
2007,Belize,BLZ,United Kingdom of Great Britain and Northern Ireland,GBR,0,0,5,0,5
2007,Chad,TCD,United Kingdom of Great Britain and Northern Ireland,GBR,10,0,0,0,10
2007,China,CHN,United Kingdom of Great Britain and Northern Ireland,GBR,80,95,915,1094,2184
2007,Cameroon,CMR,United Kingdom of Great Britain and Northern Ireland,GBR,31,19,180,19,249
2007,Congo,COG,United Kingdom of Great Britain and Northern Ireland,GBR,5,0,26,5,36
2007,Dem. Rep. of the Congo,COD,United Kingdom of Great Britain and Northern Ireland,GBR,106,64,386,54,610
2007,Colombia,COL,United Kingdom of Great Britain and Northern Ireland,GBR,5,0,38,10,53
2007,Cuba,CUB,United Kingdom of Great Britain and Northern Ireland,GBR,0,0,10,5,15
2007,Czechia,CZE,United Kingdom of Great Britain and Northern Ireland,GBR,0,0,5,10,15
2007,Ecuador,ECU,United Kingdom of Great Britain and Northern Ireland,GBR,0,0,20,10,30
2007,Eritrea,ERI,United Kingdom of Great Britain and Northern Ireland,GBR,1150,79,450,352,2031
2007,Ethiopia,ETH,United Kingdom of Great Britain and Northern Ireland,GBR,28,10,73,12,123
2007,Gambia,GMB,United Kingdom of Great Britain and Northern Ireland,GBR,21,5,94,13,133
2007,Palestinian,PSE,United Kingdom of Great Britain and Northern Ireland,GBR,19,13,247,151,430
2007,Georgia,GEO,United Kingdom of Great Britain and Northern Ireland,GBR,0,0,44,28,72
2007,Ghana,GHA,United Kingdom of Great Britain and Northern Ireland,GBR,0,5,103,37,145
2007,Guinea-Bissau,GNB,United Kingdom of Great Britain and Northern Ireland,GBR,0,5,5,0,10
2007,Guatemala,GTM,United Kingdom of Great Britain and Northern Ireland,GBR,0,0,5,5,10
2007,Guinea,GIN,United Kingdom of Great Britain and Northern Ireland,GBR,13,37,98,25,173
2007,Guyana,GUY,United Kingdom of Great Britain and Northern Ireland,GBR,0,0,5,0,5
2007,"China, Hong Kong SAR",HKG,United Kingdom of Great Britain and Northern Ireland,GBR,0,0,0,5,5
2007,Croatia,HRV,United Kingdom of Great Britain and Northern Ireland,GBR,0,0,12,10,22
2007,Cote d'Ivoire,CIV,United Kingdom of Great Britain and Northern Ireland,GBR,13,5,140,18,176
2007,India,IND,United Kingdom of Great Britain and Northern Ireland,GBR,0,13,363,202,578
2007,Indonesia,IDN,United Kingdom of Great Britain and Northern Ireland,GBR,0,0,5,0,5
2007,Iran (Islamic Rep. of),IRN,United Kingdom of Great Britain and Northern Ireland,GBR,293,220,1669,257,2439
2007,Iraq,IRQ,United Kingdom of Great Britain and Northern Ireland,GBR,207,138,1090,240,1675
2007,Israel,ISR,United Kingdom of Great Britain and Northern Ireland,GBR,0,0,24,5,29
2007,Jamaica,JAM,United Kingdom of Great Britain and Northern Ireland,GBR,5,10,237,72,324
2007,Jordan,JOR,United Kingdom of Great Britain and Northern Ireland,GBR,0,0,23,0,23
2007,Japan,JPN,United Kingdom of Great Britain and Northern Ireland,GBR,0,0,5,0,5
2007,Kazakhstan,KAZ,United Kingdom of Great Britain and Northern Ireland,GBR,0,0,10,0,10
2007,Kenya,KEN,United Kingdom of Great Britain and Northern Ireland,GBR,5,15,98,21,139
2007,Kyrgyzstan,KGZ,United Kingdom of Great Britain and Northern Ireland,GBR,0,0,5,0,5
2007,Rep. of Korea,KOR,United Kingdom of Great Britain and Northern Ireland,GBR,0,0,12,5,17
2007,Dem. People's Rep. of Korea,PRK,United Kingdom of Great Britain and Northern Ireland,GBR,204,19,19,15,257
2007,Kuwait,KWT,United Kingdom of Great Britain and Northern Ireland,GBR,89,5,76,22,192
2007,Liberia,LBR,United Kingdom of Great Britain and Northern Ireland,GBR,0,0,34,10,44
2007,Libya,LBY,United Kingdom of Great Britain and Northern Ireland,GBR,5,5,46,5,61
2007,Saint Lucia,LCA,United Kingdom of Great Britain and Northern Ireland,GBR,0,0,5,0,5
2007,Lebanon,LBN,United Kingdom of Great Britain and Northern Ireland,GBR,5,5,75,11,96
2007,Sri Lanka,LKA,United Kingdom of Great Britain and Northern Ireland,GBR,95,60,925,105,1185
2007,Lithuania,LTU,United Kingdom of Great Britain and Northern Ireland,GBR,0,0,10,0,10
2007,Latvia,LVA,United Kingdom of Great Britain and Northern Ireland,GBR,0,0,5,5,10
2007,North Macedonia,MKD,United Kingdom of Great Britain and Northern Ireland,GBR,0,0,19,15,34
2007,Rep. of Moldova,MDA,United Kingdom of Great Britain and Northern Ireland,GBR,0,5,21,19,45
2007,Malaysia,MYS,United Kingdom of Great Britain and Northern Ireland,GBR,5,0,13,14,32
2007,Malawi,MWI,United Kingdom of Great Britain and Northern Ireland,GBR,0,5,73,10,88
2007,Mongolia,MNG,United Kingdom of Great Britain and Northern Ireland,GBR,0,0,22,14,36
2007,Morocco,MAR,United Kingdom of Great Britain and Northern Ireland,GBR,0,0,18,13,31
2007,Mauritius,MUS,United Kingdom of Great Britain and Northern Ireland,GBR,0,0,25,5,30
2007,Myanmar,MMR,United Kingdom of Great Britain and Northern Ireland,GBR,111,22,62,5,200
2007,Namibia,NAM,United Kingdom of Great Britain and Northern Ireland,GBR,0,0,5,0,5
2007,Nepal,NPL,United Kingdom of Great Britain and Northern Ireland,GBR,5,0,22,13,40
2007,Niger,NER,United Kingdom of Great Britain and Northern Ireland,GBR,0,0,5,5,10
2007,Nicaragua,NIC,United Kingdom of Great Britain and Northern Ireland,GBR,0,0,5,0,5
2007,Nigeria,NGA,United Kingdom of Great Britain and Northern Ireland,GBR,5,38,728,172,943
2007,Pakistan,PAK,United Kingdom of Great Britain and Northern Ireland,GBR,179,79,1373,249,1880
2007,Philippines,PHL,United Kingdom of Great Britain and Northern Ireland,GBR,0,0,10,0,10
2007,Poland,POL,United Kingdom of Great Britain and Northern Ireland,GBR,0,0,0,5,5
2007,Romania,ROU,United Kingdom of Great Britain and Northern Ireland,GBR,0,0,13,21,34
2007,South Africa,ZAF,United Kingdom of Great Britain and Northern Ireland,GBR,0,5,101,43,149
2007,Russian Federation,RUS,United Kingdom of Great Britain and Northern Ireland,GBR,11,0,120,15,146
2007,Rwanda,RWA,United Kingdom of Great Britain and Northern Ireland,GBR,0,5,33,0,38
2007,Serbia and Kosovo: S/RES/1244 (1999),SRB,United Kingdom of Great Britain and Northern Ireland,GBR,0,21,90,72,183
2007,Senegal,SEN,United Kingdom of Great Britain and Northern Ireland,GBR,0,0,17,5,22
2007,Sierra Leone,SLE,United Kingdom of Great Britain and Northern Ireland,GBR,14,19,93,12,138
2007,Somalia,SOM,United Kingdom of Great Britain and Northern Ireland,GBR,990,109,734,163,1996
2007,Viet Nam,VNM,United Kingdom of Great Britain and Northern Ireland,GBR,5,13,55,74,147
2007,Sudan,SDN,United Kingdom of Great Britain and Northern Ireland,GBR,89,17,304,69,479
2007,Eswatini,SWZ,United Kingdom of Great Britain and Northern Ireland,GBR,0,0,10,0,10
2007,Syrian Arab Rep.,SYR,United Kingdom of Great Britain and Northern Ireland,GBR,31,12,113,32,188
2007,United Rep. of Tanzania,TZA,United Kingdom of Great Britain and Northern Ireland,GBR,0,0,23,5,28
2007,Thailand,THA,United Kingdom of Great Britain and Northern Ireland,GBR,0,0,0,5,5
2007,Turkmenistan,TKM,United Kingdom of Great Britain and Northern Ireland,GBR,5,0,5,0,10
2007,Togo,TGO,United Kingdom of Great Britain and Northern Ireland,GBR,5,0,20,5,30
2007,Trinidad and Tobago,TTO,United Kingdom of Great Britain and Northern Ireland,GBR,0,0,5,0,5
2007,Tunisia,TUN,United Kingdom of Great Britain and Northern Ireland,GBR,0,0,5,5,10
2007,Turkey,TUR,United Kingdom of Great Britain and Northern Ireland,GBR,28,36,332,65,461
2007,Uganda,UGA,United Kingdom of Great Britain and Northern Ireland,GBR,5,16,132,19,172
2007,Ukraine,UKR,United Kingdom of Great Britain and Northern Ireland,GBR,0,0,46,17,63
2007,United States of America,USA,United Kingdom of Great Britain and Northern Ireland,GBR,0,0,18,5,23
2007,Uzbekistan,UZB,United Kingdom of Great Britain and Northern Ireland,GBR,0,0,22,5,27
2007,Venezuela (Bolivarian Republic of),VEN,United Kingdom of Great Britain and Northern Ireland,GBR,0,0,10,0,10
2007,Yemen,YEM,United Kingdom of Great Britain and Northern Ireland,GBR,5,5,51,5,66
2007,Zambia,ZMB,United Kingdom of Great Britain and Northern Ireland,GBR,0,0,12,5,17
2007,Zimbabwe,ZWE,United Kingdom of Great Britain and Northern Ireland,GBR,337,26,1518,65,1946
2007,Unknown ,,United Kingdom of Great Britain and Northern Ireland,GBR,37,10,50,5,102
2007,Cote d'Ivoire,CIV,Ghana,GHA,0,0,0,154,154
2007,Liberia,LBR,Ghana,GHA,0,0,0,1051,1051
2007,Sierra Leone,SLE,Ghana,GHA,0,0,0,343,343
2007,Somalia,SOM,Ghana,GHA,0,0,0,5,5
2007,Sudan,SDN,Ghana,GHA,16,0,0,0,16
2007,Togo,TGO,Ghana,GHA,0,0,0,3683,3683
2007,Cote d'Ivoire,CIV,Guinea-Bissau,GNB,5,0,0,0,5
2007,Liberia,LBR,Guinea-Bissau,GNB,20,0,0,0,20
2007,Nigeria,NGA,Guinea-Bissau,GNB,0,0,5,0,5
2007,Senegal,SEN,Guinea-Bissau,GNB,34,0,0,0,34
2007,Sierra Leone,SLE,Guinea-Bissau,GNB,11,0,26,0,37
2007,Afghanistan,AFG,Greece,GRC,0,0,973,18,991
2007,Albania,ALB,Greece,GRC,0,0,20,0,20
2007,Algeria,DZA,Greece,GRC,0,0,11,0,11
2007,Egypt,EGY,Greece,GRC,0,0,47,0,47
2007,Armenia,ARM,Greece,GRC,0,0,25,0,25
2007,Burundi,BDI,Greece,GRC,0,0,5,0,5
2007,Bangladesh,BGD,Greece,GRC,0,0,3652,10,3662
2007,Burkina Faso,BFA,Greece,GRC,0,0,32,0,32
2007,China,CHN,Greece,GRC,0,0,19,5,24
2007,Dem. Rep. of the Congo,COD,Greece,GRC,0,0,5,0,5
2007,Eritrea,ERI,Greece,GRC,0,0,12,0,12
2007,Ethiopia,ETH,Greece,GRC,0,0,125,0,125
2007,Georgia,GEO,Greece,GRC,0,0,1083,5,1088
2007,Ghana,GHA,Greece,GRC,0,0,68,0,68
2007,Guinea-Bissau,GNB,Greece,GRC,0,0,27,0,27
2007,Guinea,GIN,Greece,GRC,0,0,36,0,36
2007,Cote d'Ivoire,CIV,Greece,GRC,0,0,42,0,42
2007,India,IND,Greece,GRC,0,0,223,5,228
2007,Indonesia,IDN,Greece,GRC,0,0,41,0,41
2007,Iran (Islamic Rep. of),IRN,Greece,GRC,0,0,338,5,343
2007,Iraq,IRQ,Greece,GRC,0,0,3948,10,3958
2007,Kazakhstan,KAZ,Greece,GRC,0,0,5,0,5
2007,Kenya,KEN,Greece,GRC,0,0,47,0,47
2007,Lebanon,LBN,Greece,GRC,0,0,41,0,41
2007,Sri Lanka,LKA,Greece,GRC,0,0,111,0,111
2007,Mauritania,MRT,Greece,GRC,0,0,94,0,94
2007,Rep. of Moldova,MDA,Greece,GRC,0,0,49,0,49
2007,Morocco,MAR,Greece,GRC,0,0,5,0,5
2007,Nepal,NPL,Greece,GRC,0,0,5,0,5
2007,Nigeria,NGA,Greece,GRC,0,0,230,0,230
2007,Pakistan,PAK,Greece,GRC,0,0,7737,29,7766
2007,Philippines,PHL,Greece,GRC,0,0,21,0,21
2007,Romania,ROU,Greece,GRC,0,0,5,0,5
2007,Russian Federation,RUS,Greece,GRC,0,0,26,5,31
2007,Rwanda,RWA,Greece,GRC,0,0,5,0,5
2007,Serbia and Kosovo: S/RES/1244 (1999),SRB,Greece,GRC,5,0,0,5,10
2007,Senegal,SEN,Greece,GRC,0,0,164,0,164
2007,Sierra Leone,SLE,Greece,GRC,0,0,10,0,10
2007,Somalia,SOM,Greece,GRC,0,0,116,5,121
2007,Sudan,SDN,Greece,GRC,0,0,109,0,109
2007,Syrian Arab Rep.,SYR,Greece,GRC,0,0,927,5,932
2007,United Rep. of Tanzania,TZA,Greece,GRC,0,0,5,0,5
2007,Tunisia,TUN,Greece,GRC,0,0,5,0,5
2007,Turkey,TUR,Greece,GRC,0,0,84,0,84
2007,Uganda,UGA,Greece,GRC,0,0,5,0,5
2007,Ukraine,UKR,Greece,GRC,0,0,25,0,25
2007,Uzbekistan,UZB,Greece,GRC,0,0,5,0,5
2007,Unknown ,,Greece,GRC,0,0,97,21,118
2007,Cuba,CUB,Guatemala,GTM,0,0,12,22,34
2007,Mexico,MEX,Guatemala,GTM,0,0,10,5,15
2007,Cote d'Ivoire,CIV,Guinea,GIN,159,0,36,0,195
2007,Liberia,LBR,Guinea,GIN,87,0,100,0,187
2007,Rwanda,RWA,Guinea,GIN,5,0,0,0,5
2007,Sierra Leone,SLE,Guinea,GIN,117,0,82,0,199
2007,Colombia,COL,Honduras,HND,0,0,0,5,5
2007,Cuba,CUB,Honduras,HND,0,0,0,5,5
2007,Somalia,SOM,Honduras,HND,0,0,0,5,5
2007,Albania,ALB,Croatia,HRV,0,0,5,5,10
2007,Bosnia and Herzegovina,BIH,Croatia,HRV,0,0,10,0,10
2007,Georgia,GEO,Croatia,HRV,0,0,5,0,5
2007,India,IND,Croatia,HRV,0,0,5,0,5
2007,Iran (Islamic Rep. of),IRN,Croatia,HRV,0,0,0,5,5
2007,Iraq,IRQ,Croatia,HRV,0,0,0,5,5
2007,Sri Lanka,LKA,Croatia,HRV,0,0,5,0,5
2007,North Macedonia,MKD,Croatia,HRV,0,0,5,5,10
2007,Nigeria,NGA,Croatia,HRV,0,0,5,0,5
2007,Pakistan,PAK,Croatia,HRV,0,0,0,11,11
2007,Russian Federation,RUS,Croatia,HRV,0,0,0,5,5
2007,Serbia and Kosovo: S/RES/1244 (1999),SRB,Croatia,HRV,0,0,22,39,61
2007,Afghanistan,AFG,Hungary,HUN,0,5,5,10,20
2007,Albania,ALB,Hungary,HUN,0,0,5,10,15
2007,Algeria,DZA,Hungary,HUN,0,0,28,13,41
2007,Egypt,EGY,Hungary,HUN,0,0,10,5,15
2007,Armenia,ARM,Hungary,HUN,0,0,10,0,10
2007,Bangladesh,BGD,Hungary,HUN,0,0,10,0,10
2007,Belarus,BLR,Hungary,HUN,0,0,0,5,5
2007,China,CHN,Hungary,HUN,0,0,237,34,271
2007,Cameroon,CMR,Hungary,HUN,0,0,14,0,14
2007,Dem. Rep. of the Congo,COD,Hungary,HUN,0,0,5,0,5
2007,Cuba,CUB,Hungary,HUN,28,0,5,0,33
2007,Ethiopia,ETH,Hungary,HUN,0,5,5,0,10
2007,Palestinian,PSE,Hungary,HUN,0,0,10,13,23
2007,Georgia,GEO,Hungary,HUN,0,0,58,107,165
2007,Guinea,GIN,Hungary,HUN,5,0,0,0,5
2007,Cote d'Ivoire,CIV,Hungary,HUN,0,10,0,0,10
2007,India,IND,Hungary,HUN,0,0,0,5,5
2007,Iran (Islamic Rep. of),IRN,Hungary,HUN,5,0,10,5,20
2007,Iraq,IRQ,Hungary,HUN,64,5,5,44,118
2007,Kenya,KEN,Hungary,HUN,0,0,5,0,5
2007,Sri Lanka,LKA,Hungary,HUN,0,0,5,0,5
2007,North Macedonia,MKD,Hungary,HUN,0,0,10,27,37
2007,Rep. of Moldova,MDA,Hungary,HUN,0,0,12,37,49
2007,Mongolia,MNG,Hungary,HUN,0,0,62,5,67
2007,Morocco,MAR,Hungary,HUN,0,0,5,0,5
2007,Nigeria,NGA,Hungary,HUN,0,5,53,23,81
2007,Romania,ROU,Hungary,HUN,5,0,5,0,10
2007,Russian Federation,RUS,Hungary,HUN,0,0,11,38,49
2007,Serbia and Kosovo: S/RES/1244 (1999),SRB,Hungary,HUN,0,16,0,0,16
2007,Senegal,SEN,Hungary,HUN,0,0,5,0,5
2007,Somalia,SOM,Hungary,HUN,30,0,0,10,40
2007,Viet Nam,VNM,Hungary,HUN,0,0,487,27,514
2007,Sudan,SDN,Hungary,HUN,0,0,5,5,10
2007,Slovakia,SVK,Hungary,HUN,0,0,13,0,13
2007,Syrian Arab Rep.,SYR,Hungary,HUN,0,0,30,5,35
2007,Turkey,TUR,Hungary,HUN,5,5,23,25,58
2007,Ukraine,UKR,Hungary,HUN,0,0,13,13,26
2007,Uzbekistan,UZB,Hungary,HUN,0,0,0,5,5
2007,Stateless,XXA,Hungary,HUN,0,0,5,0,5
2007,Unknown ,,Hungary,HUN,10,0,5,0,15
2007,Belarus,BLR,Iceland,ISL,0,0,0,5,5
2007,Russian Federation,RUS,Iceland,ISL,0,0,0,5,5
2007,Syrian Arab Rep.,SYR,Iceland,ISL,0,0,0,5,5
2007,Ukraine,UKR,Iceland,ISL,0,0,0,5,5
2007,Benin,BEN,Cote d'Ivoire,CIV,0,0,5,0,5
2007,Central African Rep.,CAF,Cote d'Ivoire,CIV,0,0,25,10,35
2007,Chad,TCD,Cote d'Ivoire,CIV,0,0,10,0,10
2007,Congo,COG,Cote d'Ivoire,CIV,5,0,93,41,139
2007,Dem. Rep. of the Congo,COD,Cote d'Ivoire,CIV,10,0,168,68,246
2007,Nigeria,NGA,Cote d'Ivoire,CIV,0,0,60,0,60
2007,Rwanda,RWA,Cote d'Ivoire,CIV,5,0,11,10,26
2007,Sierra Leone,SLE,Cote d'Ivoire,CIV,0,0,45,29,74
2007,Somalia,SOM,Cote d'Ivoire,CIV,5,0,0,0,5
2007,Togo,TGO,Cote d'Ivoire,CIV,10,0,66,25,101
2007,Afghanistan,AFG,Ireland,IRL,0,0,52,28,80
2007,Albania,ALB,Ireland,IRL,10,0,34,5,49
2007,Algeria,DZA,Ireland,IRL,0,0,26,18,44
2007,Angola,AGO,Ireland,IRL,0,0,31,5,36
2007,Egypt,EGY,Ireland,IRL,0,0,0,5,5
2007,Armenia,ARM,Ireland,IRL,0,0,15,5,20
2007,Azerbaijan,AZE,Ireland,IRL,0,0,0,5,5
2007,Bahrain,BHR,Ireland,IRL,0,0,5,0,5
2007,Burundi,BDI,Ireland,IRL,0,0,10,5,15
2007,Benin,BEN,Ireland,IRL,0,0,5,0,5
2007,Bangladesh,BGD,Ireland,IRL,0,0,16,0,16
2007,Bhutan,BTN,Ireland,IRL,0,0,10,0,10
2007,Belarus,BLR,Ireland,IRL,0,0,10,13,23
2007,Botswana,BWA,Ireland,IRL,0,0,5,0,5
2007,Brazil,BRA,Ireland,IRL,0,0,5,0,5
2007,China,CHN,Ireland,IRL,5,0,58,161,224
2007,Cameroon,CMR,Ireland,IRL,5,0,38,10,53
2007,Congo,COG,Ireland,IRL,0,0,11,0,11
2007,Dem. Rep. of the Congo,COD,Ireland,IRL,12,0,118,21,151
2007,Eritrea,ERI,Ireland,IRL,20,0,10,12,42
2007,Ethiopia,ETH,Ireland,IRL,0,0,12,5,17
2007,Gambia,GMB,Ireland,IRL,0,0,5,0,5
2007,Palestinian,PSE,Ireland,IRL,5,0,20,10,35
2007,Georgia,GEO,Ireland,IRL,5,0,133,28,166
2007,Ghana,GHA,Ireland,IRL,0,0,65,11,76
2007,Guinea,GIN,Ireland,IRL,5,0,12,5,22
2007,Croatia,HRV,Ireland,IRL,0,0,5,0,5
2007,Cote d'Ivoire,CIV,Ireland,IRL,0,0,19,10,29
2007,India,IND,Ireland,IRL,0,0,10,10,20
2007,Iran (Islamic Rep. of),IRN,Ireland,IRL,12,0,37,49,98
2007,Iraq,IRQ,Ireland,IRL,100,0,105,36,241
2007,Israel,ISR,Ireland,IRL,0,0,17,0,17
2007,Kenya,KEN,Ireland,IRL,5,0,32,10,47
2007,Kuwait,KWT,Ireland,IRL,19,0,20,5,44
2007,Liberia,LBR,Ireland,IRL,0,0,21,5,26
2007,Libya,LBY,Ireland,IRL,0,0,0,5,5
2007,Lebanon,LBN,Ireland,IRL,0,0,10,0,10
2007,Lesotho,LSO,Ireland,IRL,0,0,5,0,5
2007,Sri Lanka,LKA,Ireland,IRL,0,0,5,0,5
2007,Rep. of Moldova,MDA,Ireland,IRL,0,0,68,53,121
2007,Malaysia,MYS,Ireland,IRL,0,0,13,5,18
2007,Malawi,MWI,Ireland,IRL,0,0,10,0,10
2007,Mongolia,MNG,Ireland,IRL,0,0,5,10,15
2007,Morocco,MAR,Ireland,IRL,0,0,10,5,15
2007,Mauritius,MUS,Ireland,IRL,0,0,10,0,10
2007,Niger,NER,Ireland,IRL,0,0,5,0,5
2007,Nigeria,NGA,Ireland,IRL,10,0,1004,74,1088
2007,Pakistan,PAK,Ireland,IRL,17,0,109,14,140
2007,Romania,ROU,Ireland,IRL,0,0,14,5,19
2007,South Africa,ZAF,Ireland,IRL,0,0,37,5,42
2007,Russian Federation,RUS,Ireland,IRL,5,0,26,12,43
2007,Rwanda,RWA,Ireland,IRL,0,0,11,5,16
2007,Serbia and Kosovo: S/RES/1244 (1999),SRB,Ireland,IRL,5,0,23,5,33
2007,Sierra Leone,SLE,Ireland,IRL,0,0,27,5,32
2007,Somalia,SOM,Ireland,IRL,28,0,44,44,116
2007,Viet Nam,VNM,Ireland,IRL,0,0,5,5,10
2007,Sudan,SDN,Ireland,IRL,61,0,51,47,159
2007,Syrian Arab Rep.,SYR,Ireland,IRL,0,0,5,5,10
2007,Togo,TGO,Ireland,IRL,5,0,10,0,15
2007,Uganda,UGA,Ireland,IRL,10,0,20,0,30
2007,Ukraine,UKR,Ireland,IRL,0,0,21,5,26
2007,Uzbekistan,UZB,Ireland,IRL,0,0,5,0,5
2007,Zimbabwe,ZWE,Ireland,IRL,11,0,66,5,82
2007,Afghanistan,AFG,Italy,ITA,151,501,11,0,663
2007,Albania,ALB,Italy,ITA,5,10,12,0,27
2007,Algeria,DZA,Italy,ITA,0,10,61,0,71
2007,Angola,AGO,Italy,ITA,5,5,0,0,10
2007,Egypt,EGY,Italy,ITA,0,5,47,0,52
2007,Armenia,ARM,Italy,ITA,0,17,0,0,17
2007,Azerbaijan,AZE,Italy,ITA,5,5,0,0,10
2007,Benin,BEN,Italy,ITA,5,5,13,0,23
2007,Bangladesh,BGD,Italy,ITA,10,48,257,0,315
2007,Burkina Faso,BFA,Italy,ITA,14,54,124,0,192
2007,Belarus,BLR,Italy,ITA,0,5,10,0,15
2007,Brazil,BRA,Italy,ITA,0,5,10,0,15
2007,Bosnia and Herzegovina,BIH,Italy,ITA,0,5,5,0,10
2007,Chad,TCD,Italy,ITA,5,5,5,0,15
2007,China,CHN,Italy,ITA,5,10,0,0,15
2007,Cameroon,CMR,Italy,ITA,32,42,46,0,120
2007,Congo,COG,Italy,ITA,27,58,12,0,97
2007,Dem. Rep. of the Congo,COD,Italy,ITA,12,21,5,0,38
2007,Colombia,COL,Italy,ITA,5,44,17,0,66
2007,Cuba,CUB,Italy,ITA,5,14,12,0,31
2007,Ecuador,ECU,Italy,ITA,0,0,5,0,5
2007,Eritrea,ERI,Italy,ITA,193,2055,12,0,2260
2007,Ethiopia,ETH,Italy,ITA,132,238,29,0,399
2007,Gambia,GMB,Italy,ITA,16,34,92,0,142
2007,Palestinian,PSE,Italy,ITA,10,5,68,0,83
2007,Georgia,GEO,Italy,ITA,5,5,10,0,20
2007,Ghana,GHA,Italy,ITA,5,66,602,0,673
2007,Guinea-Bissau,GNB,Italy,ITA,0,0,22,0,22
2007,Guinea,GIN,Italy,ITA,35,110,72,0,217
2007,Croatia,HRV,Italy,ITA,0,0,5,0,5
2007,Cote d'Ivoire,CIV,Italy,ITA,72,728,182,0,982
2007,India,IND,Italy,ITA,5,0,57,0,62
2007,Iran (Islamic Rep. of),IRN,Italy,ITA,39,23,5,0,67
2007,Iraq,IRQ,Italy,ITA,99,63,27,0,189
2007,Kenya,KEN,Italy,ITA,0,5,0,0,5
2007,Liberia,LBR,Italy,ITA,5,20,64,0,89
2007,Lebanon,LBN,Italy,ITA,14,62,29,0,105
2007,Sri Lanka,LKA,Italy,ITA,31,173,20,0,224
2007,Mauritania,MRT,Italy,ITA,11,5,11,0,27
2007,North Macedonia,MKD,Italy,ITA,0,5,58,0,63
2007,Rep. of Moldova,MDA,Italy,ITA,0,10,21,0,31
2007,Mali,MLI,Italy,ITA,0,31,236,0,267
2007,Morocco,MAR,Italy,ITA,5,0,20,0,25
2007,Niger,NER,Italy,ITA,0,10,60,0,70
2007,Nigeria,NGA,Italy,ITA,33,213,1090,0,1336
2007,Pakistan,PAK,Italy,ITA,20,33,123,0,176
2007,Peru,PER,Italy,ITA,0,0,5,0,5
2007,Romania,ROU,Italy,ITA,0,0,5,0,5
2007,Russian Federation,RUS,Italy,ITA,5,18,14,0,37
2007,El Salvador,SLV,Italy,ITA,0,5,12,0,17
2007,Serbia and Kosovo: S/RES/1244 (1999),SRB,Italy,ITA,28,242,843,0,1113
2007,Senegal,SEN,Italy,ITA,0,19,46,0,65
2007,Sierra Leone,SLE,Italy,ITA,0,12,38,0,50
2007,Somalia,SOM,Italy,ITA,86,637,34,0,757
2007,Viet Nam,VNM,Italy,ITA,0,5,0,0,5
2007,Sudan,SDN,Italy,ITA,121,221,41,0,383
2007,Syrian Arab Rep.,SYR,Italy,ITA,13,11,5,0,29
2007,Togo,TGO,Italy,ITA,50,200,105,0,355
2007,Tunisia,TUN,Italy,ITA,0,5,5,0,10
2007,Turkey,TUR,Italy,ITA,80,169,145,0,394
2007,Uganda,UGA,Italy,ITA,5,0,5,0,10
2007,Ukraine,UKR,Italy,ITA,0,5,22,0,27
2007,Unknown ,,Italy,ITA,0,0,0,875,875
2007,Burundi,BDI,Japan,JPN,0,0,5,0,5
2007,Bangladesh,BGD,Japan,JPN,0,0,13,0,13
2007,China,CHN,Japan,JPN,0,0,10,0,10
2007,Cameroon,CMR,Japan,JPN,0,0,5,5,10
2007,Dem. Rep. of the Congo,COD,Japan,JPN,0,0,10,0,10
2007,Ethiopia,ETH,Japan,JPN,0,0,5,0,5
2007,Iran (Islamic Rep. of),IRN,Japan,JPN,5,0,19,0,24
2007,Sri Lanka,LKA,Japan,JPN,0,0,32,0,32
2007,Myanmar,MMR,Japan,JPN,31,49,251,17,348
2007,Nepal,NPL,Japan,JPN,0,0,10,0,10
2007,Nigeria,NGA,Japan,JPN,0,0,5,0,5
2007,Pakistan,PAK,Japan,JPN,0,0,5,10,15
2007,Philippines,PHL,Japan,JPN,0,0,5,0,5
2007,Sudan,SDN,Japan,JPN,0,0,0,5,5
2007,Turkey,TUR,Japan,JPN,0,5,55,10,70
2007,Uganda,UGA,Japan,JPN,0,0,5,0,5
2007,Unknown ,,Japan,JPN,0,0,5,5,10
2007,Afghanistan,AFG,Kazakhstan,KAZ,20,0,22,15,57
2007,Togo,TGO,Liberia,LBR,0,0,0,10,10
2007,Dem. Rep. of the Congo,COD,Liechtenstein,LIE,0,0,0,5,5
2007,Russian Federation,RUS,Liechtenstein,LIE,0,0,5,5,10
2007,Serbia and Kosovo: S/RES/1244 (1999),SRB,Liechtenstein,LIE,0,5,0,0,5
2007,Somalia,SOM,Liechtenstein,LIE,0,0,0,5,5
2007,Armenia,ARM,Lithuania,LTU,0,0,0,5,5
2007,Belarus,BLR,Lithuania,LTU,0,0,5,0,5
2007,Eritrea,ERI,Lithuania,LTU,5,0,0,0,5
2007,Ethiopia,ETH,Lithuania,LTU,0,5,0,0,5
2007,Georgia,GEO,Lithuania,LTU,0,0,5,11,16
2007,Kazakhstan,KAZ,Lithuania,LTU,0,0,5,0,5
2007,Morocco,MAR,Lithuania,LTU,0,0,0,5,5
2007,Nepal,NPL,Lithuania,LTU,0,0,5,0,5
2007,Russian Federation,RUS,Lithuania,LTU,0,37,18,10,65
2007,Viet Nam,VNM,Lithuania,LTU,0,0,5,0,5
2007,Uzbekistan,UZB,Lithuania,LTU,5,5,0,0,10
2007,Unknown ,,Luxembourg,LUX,121,386,443,125,1075
2007,Azerbaijan,AZE,Latvia,LVA,5,0,0,0,5
2007,India,IND,North Macedonia,MKD,0,0,0,5,5
2007,Serbia and Kosovo: S/RES/1244 (1999),SRB,North Macedonia,MKD,0,5,55,0,60
2007,Bangladesh,BGD,Mexico,MEX,0,0,24,5,29
2007,China,CHN,Mexico,MEX,0,0,0,5,5
2007,Cameroon,CMR,Mexico,MEX,0,0,0,5,5
2007,Colombia,COL,Mexico,MEX,30,0,14,16,60
2007,Cuba,CUB,Mexico,MEX,0,0,10,23,33
2007,Eritrea,ERI,Mexico,MEX,0,0,0,33,33
2007,Ethiopia,ETH,Mexico,MEX,0,0,0,15,15
2007,Guatemala,GTM,Mexico,MEX,0,0,10,17,27
2007,Haiti,HTI,Mexico,MEX,23,0,13,0,36
2007,Honduras,HND,Mexico,MEX,0,0,13,27,40
2007,Iraq,IRQ,Mexico,MEX,5,0,0,10,15
2007,Liberia,LBR,Mexico,MEX,0,0,0,5,5
2007,Myanmar,MMR,Mexico,MEX,5,0,0,0,5
2007,Nicaragua,NIC,Mexico,MEX,0,0,5,5,10
2007,Nigeria,NGA,Mexico,MEX,0,0,12,0,12
2007,El Salvador,SLV,Mexico,MEX,0,0,20,31,51
2007,Somalia,SOM,Mexico,MEX,5,0,0,18,23
2007,Sudan,SDN,Mexico,MEX,0,0,0,5,5
2007,Turkey,TUR,Mexico,MEX,0,0,0,5,5
2007,Venezuela (Bolivarian Republic of),VEN,Mexico,MEX,5,0,0,0,5
2007,Dem. Rep. of the Congo,COD,Mali,MLI,34,0,10,0,44
2007,Cote d'Ivoire,CIV,Mali,MLI,23,0,13,0,36
2007,Togo,TGO,Mali,MLI,0,0,5,0,5
2007,Burundi,BDI,Mozambique,MOZ,67,0,102,0,169
2007,Congo,COG,Mozambique,MOZ,0,0,0,11,11
2007,Dem. Rep. of the Congo,COD,Mozambique,MOZ,0,0,5,709,714
2007,Rwanda,RWA,Mozambique,MOZ,61,0,43,25,129
2007,Somalia,SOM,Mozambique,MOZ,0,0,0,5,5
2007,Algeria,DZA,Malta,MLT,0,0,5,0,5
2007,Burkina Faso,BFA,Malta,MLT,0,0,5,0,5
2007,Chad,TCD,Malta,MLT,0,0,5,0,5
2007,Cameroon,CMR,Malta,MLT,0,0,5,0,5
2007,Congo,COG,Malta,MLT,0,0,13,0,13
2007,Eritrea,ERI,Malta,MLT,0,210,35,0,245
2007,Ethiopia,ETH,Malta,MLT,0,5,45,0,50
2007,Palestinian,PSE,Malta,MLT,0,0,10,0,10
2007,Ghana,GHA,Malta,MLT,0,0,10,0,10
2007,Cote d'Ivoire,CIV,Malta,MLT,0,0,51,0,51
2007,Iraq,IRQ,Malta,MLT,0,5,0,0,5
2007,Libya,LBY,Malta,MLT,0,0,5,0,5
2007,Mali,MLI,Malta,MLT,0,0,34,0,34
2007,Niger,NER,Malta,MLT,0,0,16,0,16
2007,Nigeria,NGA,Malta,MLT,0,0,27,10,37
2007,Sierra Leone,SLE,Malta,MLT,0,0,5,0,5
2007,Somalia,SOM,Malta,MLT,5,368,5,0,378
2007,Sudan,SDN,Malta,MLT,0,31,31,0,62
2007,Togo,TGO,Malta,MLT,0,0,5,0,5
2007,Turkey,TUR,Malta,MLT,0,0,5,0,5
2007,Burundi,BDI,Namibia,NAM,0,5,16,16,37
2007,Dem. Rep. of the Congo,COD,Namibia,NAM,0,5,67,16,88
2007,Liberia,LBR,Namibia,NAM,0,0,5,0,5
2007,Rwanda,RWA,Namibia,NAM,0,0,5,189,194
2007,Sierra Leone,SLE,Namibia,NAM,0,0,5,0,5
2007,Sudan,SDN,Namibia,NAM,0,0,0,5,5
2007,Bhutan,BTN,Nepal,NPL,0,0,0,1007,1007
2007,Afghanistan,AFG,Netherlands,NLD,11,174,246,269,700
2007,Albania,ALB,Netherlands,NLD,0,0,5,10,15
2007,Algeria,DZA,Netherlands,NLD,0,0,22,25,47
2007,Angola,AGO,Netherlands,NLD,0,19,64,99,182
2007,Egypt,EGY,Netherlands,NLD,0,5,5,5,15
2007,Armenia,ARM,Netherlands,NLD,0,14,126,117,257
2007,Azerbaijan,AZE,Netherlands,NLD,5,22,82,202,311
2007,Burundi,BDI,Netherlands,NLD,0,144,123,27,294
2007,Benin,BEN,Netherlands,NLD,0,0,5,0,5
2007,Bangladesh,BGD,Netherlands,NLD,0,0,0,10,10
2007,Bhutan,BTN,Netherlands,NLD,0,5,5,0,10
2007,Belarus,BLR,Netherlands,NLD,5,0,14,10,29
2007,Bosnia and Herzegovina,BIH,Netherlands,NLD,0,5,16,69,90
2007,Cambodia,KHM,Netherlands,NLD,14,0,0,0,14
2007,Chad,TCD,Netherlands,NLD,0,0,5,0,5
2007,China,CHN,Netherlands,NLD,27,50,156,119,352
2007,Cameroon,CMR,Netherlands,NLD,0,14,24,13,51
2007,Congo,COG,Netherlands,NLD,0,34,33,14,81
2007,Dem. Rep. of the Congo,COD,Netherlands,NLD,24,55,50,34,163
2007,Colombia,COL,Netherlands,NLD,0,13,52,5,70
2007,Cuba,CUB,Netherlands,NLD,0,0,23,10,33
2007,Czechia,CZE,Netherlands,NLD,0,0,0,5,5
2007,Dominican Rep.,DOM,Netherlands,NLD,0,0,12,18,30
2007,Eritrea,ERI,Netherlands,NLD,15,120,28,23,186
2007,Ethiopia,ETH,Netherlands,NLD,20,77,29,33,159
2007,France,FRA,Netherlands,NLD,0,0,5,0,5
2007,Gambia,GMB,Netherlands,NLD,0,5,14,5,24
2007,Palestinian,PSE,Netherlands,NLD,0,0,17,16,33
2007,Georgia,GEO,Netherlands,NLD,0,0,65,43,108
2007,Ghana,GHA,Netherlands,NLD,0,0,15,5,20
2007,Guinea-Bissau,GNB,Netherlands,NLD,0,0,5,0,5
2007,Guinea,GIN,Netherlands,NLD,0,5,35,37,77
2007,Croatia,HRV,Netherlands,NLD,0,0,5,20,25
2007,Cote d'Ivoire,CIV,Netherlands,NLD,0,83,32,10,125
2007,India,IND,Netherlands,NLD,0,0,60,34,94
2007,Indonesia,IDN,Netherlands,NLD,0,0,5,10,15
2007,Iran (Islamic Rep. of),IRN,Netherlands,NLD,32,106,164,526,828
2007,Iraq,IRQ,Netherlands,NLD,231,1263,474,454,2422
2007,Israel,ISR,Netherlands,NLD,0,0,5,0,5
2007,Jamaica,JAM,Netherlands,NLD,0,0,0,5,5
2007,Kazakhstan,KAZ,Netherlands,NLD,0,5,5,23,33
2007,Kenya,KEN,Netherlands,NLD,0,0,5,0,5
2007,Kyrgyzstan,KGZ,Netherlands,NLD,0,5,10,10,25
2007,Dem. People's Rep. of Korea,PRK,Netherlands,NLD,0,5,5,0,10
2007,Liberia,LBR,Netherlands,NLD,0,57,64,20,141
2007,Libya,LBY,Netherlands,NLD,0,26,10,15,51
2007,Lebanon,LBN,Netherlands,NLD,0,0,26,24,50
2007,Sri Lanka,LKA,Netherlands,NLD,11,0,61,78,150
2007,North Macedonia,MKD,Netherlands,NLD,0,0,5,13,18
2007,Rep. of Moldova,MDA,Netherlands,NLD,0,0,5,5,10
2007,Malaysia,MYS,Netherlands,NLD,0,0,5,0,5
2007,Mongolia,MNG,Netherlands,NLD,0,0,97,19,116
2007,Morocco,MAR,Netherlands,NLD,0,0,10,0,10
2007,Myanmar,MMR,Netherlands,NLD,5,68,5,5,83
2007,Nepal,NPL,Netherlands,NLD,5,50,50,5,110
2007,Niger,NER,Netherlands,NLD,0,10,10,0,20
2007,Nigeria,NGA,Netherlands,NLD,0,14,164,49,227
2007,Pakistan,PAK,Netherlands,NLD,0,5,32,31,68
2007,Romania,ROU,Netherlands,NLD,0,0,5,5,10
2007,Russian Federation,RUS,Netherlands,NLD,10,23,76,43,152
2007,Rwanda,RWA,Netherlands,NLD,0,10,24,32,66
2007,El Salvador,SLV,Netherlands,NLD,0,0,5,0,5
2007,Saudi Arabia,SAU,Netherlands,NLD,0,0,5,0,5
2007,Serbia and Kosovo: S/RES/1244 (1999),SRB,Netherlands,NLD,0,14,77,414,505
2007,Senegal,SEN,Netherlands,NLD,0,0,10,5,15
2007,Sierra Leone,SLE,Netherlands,NLD,0,77,97,48,222
2007,Somalia,SOM,Netherlands,NLD,30,1039,450,147,1666
2007,Viet Nam,VNM,Netherlands,NLD,0,5,5,11,21
2007,Sudan,SDN,Netherlands,NLD,5,33,68,63,169
2007,Syrian Arab Rep.,SYR,Netherlands,NLD,5,20,57,164,246
2007,United Rep. of Tanzania,TZA,Netherlands,NLD,0,0,5,0,5
2007,Tajikistan,TJK,Netherlands,NLD,0,0,0,5,5
2007,Togo,TGO,Netherlands,NLD,0,10,16,5,31
2007,Tunisia,TUN,Netherlands,NLD,0,0,5,0,5
2007,Turkey,TUR,Netherlands,NLD,5,28,109,158,300
2007,Uganda,UGA,Netherlands,NLD,0,5,15,5,25
2007,Ukraine,UKR,Netherlands,NLD,0,0,18,21,39
2007,Uzbekistan,UZB,Netherlands,NLD,0,27,17,15,59
2007,Yemen,YEM,Netherlands,NLD,0,0,5,5,10
2007,Zimbabwe,ZWE,Netherlands,NLD,0,5,5,0,10
2007,Stateless,XXA,Netherlands,NLD,5,15,59,42,121
2007,Unknown ,,Netherlands,NLD,5,191,248,389,833
2007,Dem. Rep. of the Congo,COD,Niger,NER,5,0,5,0,10
2007,Cuba,CUB,Nicaragua,NIC,0,0,0,12,12
2007,Guatemala,GTM,Nicaragua,NIC,5,0,0,0,5
2007,Peru,PER,Nicaragua,NIC,0,0,0,5,5
2007,El Salvador,SLV,Nicaragua,NIC,0,0,0,10,10
2007,Somalia,SOM,Nicaragua,NIC,0,0,0,5,5
2007,Cameroon,CMR,Nigeria,NGA,0,0,5,0,5
2007,Dem. Rep. of the Congo,COD,Nigeria,NGA,19,0,100,105,224
2007,Ethiopia,ETH,Nigeria,NGA,0,0,0,5,5
2007,Cote d'Ivoire,CIV,Nigeria,NGA,0,0,10,15,25
2007,Togo,TGO,Nigeria,NGA,0,0,0,5,5
2007,Afghanistan,AFG,Norway,NOR,16,98,10,28,152
2007,Albania,ALB,Norway,NOR,0,0,21,10,31
2007,Algeria,DZA,Norway,NOR,0,0,18,15,33
2007,Angola,AGO,Norway,NOR,5,5,11,0,21
2007,Egypt,EGY,Norway,NOR,0,0,0,5,5
2007,Armenia,ARM,Norway,NOR,0,0,5,5,10
2007,Azerbaijan,AZE,Norway,NOR,0,0,5,10,15
2007,Burundi,BDI,Norway,NOR,5,10,59,21,95
2007,Bangladesh,BGD,Norway,NOR,0,0,14,10,24
2007,Bhutan,BTN,Norway,NOR,0,0,44,5,49
2007,Belarus,BLR,Norway,NOR,0,0,10,12,22
2007,Bosnia and Herzegovina,BIH,Norway,NOR,0,0,10,17,27
2007,Bulgaria,BGR,Norway,NOR,0,0,5,0,5
2007,China,CHN,Norway,NOR,41,16,10,5,72
2007,Cameroon,CMR,Norway,NOR,0,0,10,0,10
2007,Congo,COG,Norway,NOR,0,0,0,5,5
2007,Dem. Rep. of the Congo,COD,Norway,NOR,18,13,27,5,63
2007,Eritrea,ERI,Norway,NOR,119,241,18,127,505
2007,Ethiopia,ETH,Norway,NOR,97,20,154,27,298
2007,Gambia,GMB,Norway,NOR,0,0,0,5,5
2007,United Kingdom of Great Britain and Northern Ireland,GBR,Norway,NOR,0,0,0,5,5
2007,Georgia,GEO,Norway,NOR,0,0,5,0,5
2007,Ghana,GHA,Norway,NOR,0,0,0,10,10
2007,Guinea,GIN,Norway,NOR,0,0,5,0,5
2007,Cote d'Ivoire,CIV,Norway,NOR,0,0,5,0,5
2007,India,IND,Norway,NOR,0,0,12,52,64
2007,Iran (Islamic Rep. of),IRN,Norway,NOR,21,44,187,52,304
2007,Iraq,IRQ,Norway,NOR,54,471,387,228,1140
2007,Jordan,JOR,Norway,NOR,0,0,0,10,10
2007,Kenya,KEN,Norway,NOR,0,0,5,0,5
2007,Kyrgyzstan,KGZ,Norway,NOR,0,0,12,0,12
2007,Rep. of Korea,KOR,Norway,NOR,0,0,0,5,5
2007,Dem. People's Rep. of Korea,PRK,Norway,NOR,5,0,0,12,17
2007,Kuwait,KWT,Norway,NOR,0,0,0,5,5
2007,Liberia,LBR,Norway,NOR,0,0,19,0,19
2007,Libya,LBY,Norway,NOR,5,0,0,20,25
2007,Lebanon,LBN,Norway,NOR,0,5,46,17,68
2007,Sri Lanka,LKA,Norway,NOR,0,43,147,40,230
2007,Mauritania,MRT,Norway,NOR,0,0,5,0,5
2007,North Macedonia,MKD,Norway,NOR,0,0,11,5,16
2007,Rep. of Moldova,MDA,Norway,NOR,0,0,5,5,10
2007,Mongolia,MNG,Norway,NOR,0,0,5,5,10
2007,Morocco,MAR,Norway,NOR,0,0,10,10,20
2007,Montenegro,MNE,Norway,NOR,0,0,5,0,5
2007,Myanmar,MMR,Norway,NOR,11,5,5,5,26
2007,Nepal,NPL,Norway,NOR,0,0,78,5,83
2007,Netherlands,NLD,Norway,NOR,0,0,5,0,5
2007,Niger,NER,Norway,NOR,0,0,5,5,10
2007,Nigeria,NGA,Norway,NOR,0,0,29,18,47
2007,Pakistan,PAK,Norway,NOR,0,5,30,11,46
2007,Romania,ROU,Norway,NOR,0,5,10,0,15
2007,Russian Federation,RUS,Norway,NOR,21,412,142,127,702
2007,Rwanda,RWA,Norway,NOR,5,0,10,5,20
2007,Serbia and Kosovo: S/RES/1244 (1999),SRB,Norway,NOR,124,11,160,87,382
2007,Senegal,SEN,Norway,NOR,0,0,5,0,5
2007,Sierra Leone,SLE,Norway,NOR,0,0,5,10,15
2007,Somalia,SOM,Norway,NOR,250,382,104,53,789
2007,Viet Nam,VNM,Norway,NOR,0,0,10,10,20
2007,Sudan,SDN,Norway,NOR,19,0,16,10,45
2007,Slovakia,SVK,Norway,NOR,0,0,15,0,15
2007,Syrian Arab Rep.,SYR,Norway,NOR,14,0,13,12,39
2007,United Rep. of Tanzania,TZA,Norway,NOR,0,0,0,5,5
2007,Turkmenistan,TKM,Norway,NOR,0,0,5,0,5
2007,Togo,TGO,Norway,NOR,0,0,0,5,5
2007,Tunisia,TUN,Norway,NOR,0,0,0,5,5
2007,Turkey,TUR,Norway,NOR,0,0,26,31,57
2007,Uganda,UGA,Norway,NOR,5,0,10,0,15
2007,Ukraine,UKR,Norway,NOR,0,0,0,5,5
2007,Uzbekistan,UZB,Norway,NOR,0,0,28,10,38
2007,Western Sahara,ESH,Norway,NOR,0,0,0,5,5
2007,Yemen,YEM,Norway,NOR,16,11,0,5,32
2007,Zimbabwe,ZWE,Norway,NOR,5,0,11,0,16
2007,Stateless,XXA,Norway,NOR,150,110,48,90,398
2007,Bangladesh,BGD,New Zealand,NZL,0,0,20,0,20
2007,Chad,TCD,New Zealand,NZL,0,0,5,0,5
2007,China,CHN,New Zealand,NZL,19,0,17,0,36
2007,Czechia,CZE,New Zealand,NZL,0,0,10,0,10
2007,Fiji,FJI,New Zealand,NZL,0,0,10,0,10
2007,Palestinian,PSE,New Zealand,NZL,0,0,5,0,5
2007,Hungary,HUN,New Zealand,NZL,0,0,10,0,10
2007,India,IND,New Zealand,NZL,0,0,10,0,10
2007,Iran (Islamic Rep. of),IRN,New Zealand,NZL,5,0,23,0,28
2007,Iraq,IRQ,New Zealand,NZL,21,0,5,0,26
2007,Israel,ISR,New Zealand,NZL,0,0,5,0,5
2007,Sri Lanka,LKA,New Zealand,NZL,5,0,16,0,21
2007,Malaysia,MYS,New Zealand,NZL,0,0,5,0,5
2007,Myanmar,MMR,New Zealand,NZL,5,0,0,0,5
2007,Pakistan,PAK,New Zealand,NZL,5,0,5,0,10
2007,Poland,POL,New Zealand,NZL,0,0,5,0,5
2007,Russian Federation,RUS,New Zealand,NZL,0,0,5,0,5
2007,Sierra Leone,SLE,New Zealand,NZL,0,0,5,0,5
2007,Somalia,SOM,New Zealand,NZL,0,0,10,0,10
2007,Turkey,TUR,New Zealand,NZL,0,0,5,0,5
2007,Zimbabwe,ZWE,New Zealand,NZL,0,0,5,0,5
2007,Colombia,COL,Panama,PAN,43,0,23,0,66
2007,Sudan,SDN,Panama,PAN,5,0,0,0,5
2007,Colombia,COL,Paraguay,PRY,5,0,0,0,5
2007,Cuba,CUB,Paraguay,PRY,5,0,5,5,15
2007,Bolivia (Plurinational State of),BOL,Peru,PER,5,0,0,0,5
2007,Colombia,COL,Peru,PER,48,0,19,15,82
2007,Cuba,CUB,Peru,PER,19,0,51,5,75
2007,Eritrea,ERI,Peru,PER,0,0,0,5,5
2007,Palestinian,PSE,Peru,PER,10,0,0,0,10
2007,Iraq,IRQ,Peru,PER,15,0,0,5,20
2007,Serbia and Kosovo: S/RES/1244 (1999),SRB,Peru,PER,0,0,0,5,5
2007,Somalia,SOM,Peru,PER,0,0,0,5,5
2007,Venezuela (Bolivarian Republic of),VEN,Peru,PER,5,0,0,0,5
2007,Palestinian,PSE,Philippines,PHL,5,0,0,0,5
2007,Iraq,IRQ,Philippines,PHL,0,0,0,5,5
2007,Myanmar,MMR,Philippines,PHL,0,0,0,5,5
2007,Viet Nam,VNM,Philippines,PHL,5,0,5,0,10
2007,Afghanistan,AFG,Poland,POL,0,0,5,5,10
2007,Algeria,DZA,Poland,POL,0,0,5,5,10
2007,Egypt,EGY,Poland,POL,0,0,5,5,10
2007,Armenia,ARM,Poland,POL,0,0,34,14,48
2007,Azerbaijan,AZE,Poland,POL,0,0,5,0,5
2007,Bangladesh,BGD,Poland,POL,0,0,17,5,22
2007,Belarus,BLR,Poland,POL,5,0,57,13,75
2007,China,CHN,Poland,POL,0,0,22,0,22
2007,Cameroon,CMR,Poland,POL,0,0,20,0,20
2007,Congo,COG,Poland,POL,0,0,10,0,10
2007,Dem. Rep. of the Congo,COD,Poland,POL,0,0,5,0,5
2007,Eritrea,ERI,Poland,POL,0,0,0,5,5
2007,Palestinian,PSE,Poland,POL,0,0,5,0,5
2007,Georgia,GEO,Poland,POL,0,0,23,5,28
2007,Ghana,GHA,Poland,POL,0,0,5,0,5
2007,India,IND,Poland,POL,0,0,34,5,39
2007,Iraq,IRQ,Poland,POL,5,17,14,5,41
2007,Kazakhstan,KAZ,Poland,POL,0,0,0,5,5
2007,Kyrgyzstan,KGZ,Poland,POL,0,0,16,10,26
2007,Sri Lanka,LKA,Poland,POL,0,10,10,5,25
2007,Lithuania,LTU,Poland,POL,0,0,5,0,5
2007,Rep. of Moldova,MDA,Poland,POL,0,0,10,0,10
2007,Mali,MLI,Poland,POL,0,0,5,0,5
2007,Mongolia,MNG,Poland,POL,0,0,10,0,10
2007,Nepal,NPL,Poland,POL,0,0,5,5,10
2007,Nigeria,NGA,Poland,POL,0,0,23,5,28
2007,Pakistan,PAK,Poland,POL,0,0,46,12,58
2007,Russian Federation,RUS,Poland,POL,136,2832,1289,1182,5439
2007,Senegal,SEN,Poland,POL,0,0,5,0,5
2007,Sierra Leone,SLE,Poland,POL,0,0,5,0,5
2007,Viet Nam,VNM,Poland,POL,0,0,41,5,46
2007,Syrian Arab Rep.,SYR,Poland,POL,0,0,5,0,5
2007,Togo,TGO,Poland,POL,0,0,5,0,5
2007,Turkey,TUR,Poland,POL,0,5,10,5,20
2007,Uganda,UGA,Poland,POL,0,0,5,0,5
2007,Ukraine,UKR,Poland,POL,0,0,45,5,50
2007,Stateless,XXA,Poland,POL,0,0,12,0,12
2007,Angola,AGO,Portugal,PRT,0,0,5,0,5
2007,Belarus,BLR,Portugal,PRT,0,5,0,0,5
2007,Bosnia and Herzegovina,BIH,Portugal,PRT,0,0,5,0,5
2007,Dem. Rep. of the Congo,COD,Portugal,PRT,0,0,5,0,5
2007,Colombia,COL,Portugal,PRT,0,18,33,0,51
2007,Guinea,GIN,Portugal,PRT,0,0,10,0,10
2007,India,IND,Portugal,PRT,0,5,0,0,5
2007,Nigeria,NGA,Portugal,PRT,0,0,5,0,5
2007,Sierra Leone,SLE,Portugal,PRT,0,0,5,0,5
2007,Angola,AGO,South Africa,ZAF,5,0,0,0,5
2007,Egypt,EGY,South Africa,ZAF,0,0,30,0,30
2007,Burundi,BDI,South Africa,ZAF,41,0,58,0,99
2007,Bangladesh,BGD,South Africa,ZAF,5,0,186,0,191
2007,China,CHN,South Africa,ZAF,0,0,11,0,11
2007,Cameroon,CMR,South Africa,ZAF,22,0,36,0,58
2007,Congo,COG,South Africa,ZAF,93,0,57,0,150
2007,Dem. Rep. of the Congo,COD,South Africa,ZAF,380,0,375,0,755
2007,Eritrea,ERI,South Africa,ZAF,21,0,36,0,57
2007,Ethiopia,ETH,South Africa,ZAF,99,0,111,0,210
2007,Gabon,GAB,South Africa,ZAF,0,0,10,0,10
2007,Ghana,GHA,South Africa,ZAF,0,0,23,0,23
2007,India,IND,South Africa,ZAF,0,0,99,0,99
2007,Kenya,KEN,South Africa,ZAF,10,0,51,0,61
2007,Malawi,MWI,South Africa,ZAF,5,0,642,0,647
2007,Mozambique,MOZ,South Africa,ZAF,0,0,41,0,41
2007,Nigeria,NGA,South Africa,ZAF,5,0,136,0,141
2007,Pakistan,PAK,South Africa,ZAF,0,0,197,0,197
2007,Poland,POL,South Africa,ZAF,5,0,0,0,5
2007,Rwanda,RWA,South Africa,ZAF,10,0,30,0,40
2007,Senegal,SEN,South Africa,ZAF,0,0,10,0,10
2007,Sierra Leone,SLE,South Africa,ZAF,0,0,5,0,5
2007,Somalia,SOM,South Africa,ZAF,747,0,18,0,765
2007,United Rep. of Tanzania,TZA,South Africa,ZAF,0,0,209,0,209
2007,Uganda,UGA,South Africa,ZAF,11,0,92,0,103
2007,Zambia,ZMB,South Africa,ZAF,0,0,38,0,38
2007,Zimbabwe,ZWE,South Africa,ZAF,271,0,1623,0,1894
2007,Unknown ,,South Africa,ZAF,0,0,10,0,10
2007,Afghanistan,AFG,Russian Federation,RUS,57,312,0,0,369
2007,Angola,AGO,Russian Federation,RUS,0,5,0,0,5
2007,Azerbaijan,AZE,Russian Federation,RUS,5,5,0,0,10
2007,China,CHN,Russian Federation,RUS,0,5,0,0,5
2007,Georgia,GEO,Russian Federation,RUS,68,49,0,0,117
2007,Iraq,IRQ,Russian Federation,RUS,0,5,0,0,5
2007,Pakistan,PAK,Russian Federation,RUS,5,0,0,0,5
2007,Uzbekistan,UZB,Russian Federation,RUS,0,5,0,0,5
2007,Unknown ,,Russian Federation,RUS,5,5,0,0,10
2007,Burundi,BDI,Rwanda,RWA,0,419,0,0,419
2007,Dem. Rep. of the Congo,COD,Rwanda,RWA,157,2637,0,0,2794
2007,Burundi,BDI,Senegal,SEN,0,0,5,0,5
2007,Central African Rep.,CAF,Senegal,SEN,0,0,5,0,5
2007,Chad,TCD,Senegal,SEN,0,0,5,0,5
2007,Congo,COG,Senegal,SEN,0,0,5,0,5
2007,Dem. Rep. of the Congo,COD,Senegal,SEN,0,0,15,0,15
2007,Gambia,GMB,Senegal,SEN,10,0,5,0,15
2007,Guinea,GIN,Senegal,SEN,0,0,19,0,19
2007,Cote d'Ivoire,CIV,Senegal,SEN,0,0,50,0,50
2007,Liberia,LBR,Senegal,SEN,0,0,46,0,46
2007,Sri Lanka,LKA,Senegal,SEN,0,0,11,0,11
2007,Mauritania,MRT,Senegal,SEN,0,0,17,0,17
2007,Niger,NER,Senegal,SEN,0,0,5,0,5
2007,Nigeria,NGA,Senegal,SEN,0,0,5,0,5
2007,Rwanda,RWA,Senegal,SEN,0,0,5,0,5
2007,Sierra Leone,SLE,Senegal,SEN,0,0,60,0,60
2007,Togo,TGO,Senegal,SEN,0,0,20,0,20
2007,Eritrea,ERI,Sudan,SDN,9558,0,10,1932,11500
2007,Ethiopia,ETH,Sudan,SDN,658,0,5,39,702
2007,Somalia,SOM,Sudan,SDN,1111,0,0,5,1116
2007,Unknown ,,Sudan,SDN,0,0,10,282,292
2007,Afghanistan,AFG,Slovakia,SVK,0,5,30,40,75
2007,Armenia,ARM,Slovakia,SVK,0,5,0,17,22
2007,Bangladesh,BGD,Slovakia,SVK,0,0,68,67,135
2007,Bhutan,BTN,Slovakia,SVK,0,0,0,5,5
2007,Belarus,BLR,Slovakia,SVK,0,0,0,10,10
2007,China,CHN,Slovakia,SVK,0,0,69,26,95
2007,Cameroon,CMR,Slovakia,SVK,0,0,5,0,5
2007,Cuba,CUB,Slovakia,SVK,5,0,0,0,5
2007,Palestinian,PSE,Slovakia,SVK,0,0,17,34,51
2007,Georgia,GEO,Slovakia,SVK,0,0,32,103,135
2007,India,IND,Slovakia,SVK,0,0,331,441,772
2007,Iran (Islamic Rep. of),IRN,Slovakia,SVK,5,0,0,0,5
2007,Iraq,IRQ,Slovakia,SVK,0,42,19,82,143
2007,Kazakhstan,KAZ,Slovakia,SVK,0,0,0,5,5
2007,Sri Lanka,LKA,Slovakia,SVK,0,0,5,17,22
2007,North Macedonia,MKD,Slovakia,SVK,0,0,5,5,10
2007,Rep. of Moldova,MDA,Slovakia,SVK,0,0,90,130,220
2007,Nepal,NPL,Slovakia,SVK,0,0,5,5,10
2007,Nigeria,NGA,Slovakia,SVK,0,0,10,0,10
2007,Pakistan,PAK,Slovakia,SVK,0,0,301,368,669
2007,Russian Federation,RUS,Slovakia,SVK,0,0,97,252,349
2007,Serbia and Kosovo: S/RES/1244 (1999),SRB,Slovakia,SVK,0,0,5,5,10
2007,Somalia,SOM,Slovakia,SVK,0,10,0,0,10
2007,Viet Nam,VNM,Slovakia,SVK,0,0,40,22,62
2007,Syrian Arab Rep.,SYR,Slovakia,SVK,0,11,10,22,43
2007,Turkey,TUR,Slovakia,SVK,0,0,5,5,10
2007,Ukraine,UKR,Slovakia,SVK,0,0,20,20,40
2007,Stateless,XXA,Slovakia,SVK,0,0,0,5,5
2007,Afghanistan,AFG,Slovenia,SVN,0,0,10,0,10
2007,Albania,ALB,Slovenia,SVN,0,0,5,14,19
2007,Bosnia and Herzegovina,BIH,Slovenia,SVN,0,0,39,11,50
2007,Palestinian,PSE,Slovenia,SVN,0,0,0,5,5
2007,India,IND,Slovenia,SVN,0,0,0,5,5
2007,Iraq,IRQ,Slovenia,SVN,0,0,5,0,5
2007,North Macedonia,MKD,Slovenia,SVN,0,0,5,15,20
2007,Rep. of Moldova,MDA,Slovenia,SVN,0,0,0,5,5
2007,Montenegro,MNE,Slovenia,SVN,0,0,0,5,5
2007,Pakistan,PAK,Slovenia,SVN,0,0,5,5,10
2007,Russian Federation,RUS,Slovenia,SVN,0,0,0,5,5
2007,Serbia and Kosovo: S/RES/1244 (1999),SRB,Slovenia,SVN,0,5,211,115,331
2007,Turkey,TUR,Slovenia,SVN,0,0,10,40,50
2007,Unknown ,,Slovenia,SVN,0,0,5,10,15
2007,Afghanistan,AFG,Sweden,SWE,24,253,375,315,967
2007,Albania,ALB,Sweden,SWE,5,15,52,51,123
2007,Algeria,DZA,Sweden,SWE,0,5,100,95,200
2007,Angola,AGO,Sweden,SWE,0,26,32,10,68
2007,Egypt,EGY,Sweden,SWE,5,12,110,29,156
2007,Argentina,ARG,Sweden,SWE,0,0,5,0,5
2007,Armenia,ARM,Sweden,SWE,0,119,156,52,327
2007,Azerbaijan,AZE,Sweden,SWE,12,183,173,70,438
2007,Burundi,BDI,Sweden,SWE,0,59,126,14,199
2007,Benin,BEN,Sweden,SWE,0,5,5,0,10
2007,Bangladesh,BGD,Sweden,SWE,5,25,61,10,101
2007,Bhutan,BTN,Sweden,SWE,0,0,0,5,5
2007,Belarus,BLR,Sweden,SWE,5,45,264,174,488
2007,Bolivia (Plurinational State of),BOL,Sweden,SWE,0,5,694,102,801
2007,Brazil,BRA,Sweden,SWE,0,0,5,5,10
2007,Bosnia and Herzegovina,BIH,Sweden,SWE,5,43,147,85,280
2007,Bulgaria,BGR,Sweden,SWE,0,0,56,38,94
2007,Cambodia,KHM,Sweden,SWE,0,5,0,0,5
2007,Canada,CAN,Sweden,SWE,0,0,5,0,5
2007,China,CHN,Sweden,SWE,5,10,53,67,135
2007,Chile,CHL,Sweden,SWE,0,5,25,5,35
2007,Cameroon,CMR,Sweden,SWE,5,10,28,10,53
2007,Congo,COG,Sweden,SWE,0,5,5,0,10
2007,Dem. Rep. of the Congo,COD,Sweden,SWE,5,5,69,11,90
2007,Colombia,COL,Sweden,SWE,0,0,11,5,16
2007,Cuba,CUB,Sweden,SWE,0,5,16,5,26
2007,Ecuador,ECU,Sweden,SWE,0,5,10,5,20
2007,Eritrea,ERI,Sweden,SWE,98,391,286,167,942
2007,Ethiopia,ETH,Sweden,SWE,12,41,82,17,152
2007,Gambia,GMB,Sweden,SWE,0,0,10,5,15
2007,Georgia,GEO,Sweden,SWE,0,31,105,60,196
2007,Ghana,GHA,Sweden,SWE,0,0,18,0,18
2007,Guatemala,GTM,Sweden,SWE,0,0,10,0,10
2007,Guinea,GIN,Sweden,SWE,0,5,12,5,22
2007,Honduras,HND,Sweden,SWE,0,0,5,0,5
2007,Croatia,HRV,Sweden,SWE,0,5,24,14,43
2007,Hungary,HUN,Sweden,SWE,0,0,16,48,64
2007,Cote d'Ivoire,CIV,Sweden,SWE,0,5,17,0,22
2007,India,IND,Sweden,SWE,0,16,44,60,120
2007,Iran (Islamic Rep. of),IRN,Sweden,SWE,49,113,372,138,672
2007,Iraq,IRQ,Sweden,SWE,168,9708,2380,3025,15281
2007,Israel,ISR,Sweden,SWE,0,5,14,10,29
2007,Italy,ITA,Sweden,SWE,0,0,5,0,5
2007,Jordan,JOR,Sweden,SWE,0,114,45,31,190
2007,Kazakhstan,KAZ,Sweden,SWE,0,35,63,42,140
2007,Kenya,KEN,Sweden,SWE,0,5,21,5,31
2007,Kyrgyzstan,KGZ,Sweden,SWE,0,29,50,16,95
2007,Dem. People's Rep. of Korea,PRK,Sweden,SWE,0,0,5,0,5
2007,Kuwait,KWT,Sweden,SWE,0,0,5,0,5
2007,Liberia,LBR,Sweden,SWE,0,5,10,10,25
2007,Libya,LBY,Sweden,SWE,17,16,343,158,534
2007,Lebanon,LBN,Sweden,SWE,0,87,587,198,872
2007,Sri Lanka,LKA,Sweden,SWE,0,5,11,5,21
2007,Lithuania,LTU,Sweden,SWE,0,0,0,5,5
2007,North Macedonia,MKD,Sweden,SWE,0,20,51,71,142
2007,Rep. of Moldova,MDA,Sweden,SWE,0,0,14,110,124
2007,Mexico,MEX,Sweden,SWE,0,0,5,0,5
2007,Mongolia,MNG,Sweden,SWE,0,39,409,105,553
2007,Morocco,MAR,Sweden,SWE,5,0,55,42,102
2007,Montenegro,MNE,Sweden,SWE,0,16,64,41,121
2007,Myanmar,MMR,Sweden,SWE,5,0,0,0,5
2007,Nepal,NPL,Sweden,SWE,0,0,11,0,11
2007,Netherlands,NLD,Sweden,SWE,0,0,5,0,5
2007,Nicaragua,NIC,Sweden,SWE,0,0,22,5,27
2007,Nigeria,NGA,Sweden,SWE,0,5,70,59,134
2007,Pakistan,PAK,Sweden,SWE,5,10,50,16,81
2007,Peru,PER,Sweden,SWE,0,0,22,5,27
2007,Philippines,PHL,Sweden,SWE,0,11,5,0,16
2007,Poland,POL,Sweden,SWE,0,0,0,5,5
2007,Romania,ROU,Sweden,SWE,0,5,62,175,242
2007,Russian Federation,RUS,Sweden,SWE,5,325,458,359,1147
2007,Rwanda,RWA,Sweden,SWE,0,0,5,0,5
2007,El Salvador,SLV,Sweden,SWE,0,0,43,10,53
2007,Saudi Arabia,SAU,Sweden,SWE,0,0,5,10,15
2007,Serbia and Kosovo: S/RES/1244 (1999),SRB,Sweden,SWE,185,337,1323,727,2572
2007,Senegal,SEN,Sweden,SWE,0,0,10,0,10
2007,Sierra Leone,SLE,Sweden,SWE,0,0,18,15,33
2007,Somalia,SOM,Sweden,SWE,117,1433,271,361,2182
2007,Viet Nam,VNM,Sweden,SWE,0,10,36,5,51
2007,Sudan,SDN,Sweden,SWE,10,17,22,10,59
2007,Slovakia,SVK,Sweden,SWE,0,0,5,5,10
2007,Sweden,SWE,Sweden,SWE,0,0,0,5,5
2007,Syrian Arab Rep.,SYR,Sweden,SWE,36,71,353,121,581
2007,United Rep. of Tanzania,TZA,Sweden,SWE,0,0,5,0,5
2007,Thailand,THA,Sweden,SWE,0,0,5,0,5
2007,Tajikistan,TJK,Sweden,SWE,0,17,5,5,27
2007,Turkmenistan,TKM,Sweden,SWE,0,5,10,5,20
2007,Togo,TGO,Sweden,SWE,0,5,5,0,10
2007,Tunisia,TUN,Sweden,SWE,5,0,37,34,76
2007,Turkey,TUR,Sweden,SWE,5,62,274,90,431
2007,Uganda,UGA,Sweden,SWE,5,5,17,0,27
2007,Ukraine,UKR,Sweden,SWE,0,18,73,30,121
2007,United States of America,USA,Sweden,SWE,0,0,10,5,15
2007,Uzbekistan,UZB,Sweden,SWE,19,283,459,79,840
2007,Venezuela (Bolivarian Republic of),VEN,Sweden,SWE,0,0,5,5,10
2007,Yemen,YEM,Sweden,SWE,0,14,38,5,57
2007,Zimbabwe,ZWE,Sweden,SWE,0,5,5,5,15
2007,Stateless,XXA,Sweden,SWE,67,549,520,277,1413
2007,Unknown ,,Sweden,SWE,0,49,183,81,313
2007,Afghanistan,AFG,Switzerland,CHE,32,135,142,82,391
2007,Albania,ALB,Switzerland,CHE,0,0,0,24,24
2007,Algeria,DZA,Switzerland,CHE,5,10,17,109,141
2007,Angola,AGO,Switzerland,CHE,0,125,32,25,182
2007,Egypt,EGY,Switzerland,CHE,5,0,0,11,16
2007,Armenia,ARM,Switzerland,CHE,0,5,24,30,59
2007,Azerbaijan,AZE,Switzerland,CHE,0,0,10,17,27
2007,Burundi,BDI,Switzerland,CHE,0,5,5,5,15
2007,Benin,BEN,Switzerland,CHE,0,5,10,12,27
2007,Bangladesh,BGD,Switzerland,CHE,0,0,5,22,27
2007,Bhutan,BTN,Switzerland,CHE,0,0,5,0,5
2007,Burkina Faso,BFA,Switzerland,CHE,0,0,0,5,5
2007,Belarus,BLR,Switzerland,CHE,5,5,10,27,47
2007,Bolivia (Plurinational State of),BOL,Switzerland,CHE,0,5,0,0,5
2007,Bosnia and Herzegovina,BIH,Switzerland,CHE,27,133,50,61,271
2007,Bulgaria,BGR,Switzerland,CHE,0,5,10,95,110
2007,Cambodia,KHM,Switzerland,CHE,5,0,0,0,5
2007,Chad,TCD,Switzerland,CHE,0,5,0,0,5
2007,China,CHN,Switzerland,CHE,29,187,192,113,521
2007,Chile,CHL,Switzerland,CHE,0,0,0,5,5
2007,Cameroon,CMR,Switzerland,CHE,10,19,57,57,143
2007,Congo,COG,Switzerland,CHE,5,0,5,5,15
2007,Dem. Rep. of the Congo,COD,Switzerland,CHE,19,194,145,55,413
2007,Colombia,COL,Switzerland,CHE,35,0,10,0,45
2007,Cuba,CUB,Switzerland,CHE,0,5,0,0,5
2007,Cabo Verde,CPV,Switzerland,CHE,0,0,0,5,5
2007,Czechia,CZE,Switzerland,CHE,0,0,0,5,5
2007,Eritrea,ERI,Switzerland,CHE,443,86,151,214,894
2007,Ethiopia,ETH,Switzerland,CHE,32,83,123,89,327
2007,France,FRA,Switzerland,CHE,0,0,0,5,5
2007,Gambia,GMB,Switzerland,CHE,0,0,5,10,15
2007,Georgia,GEO,Switzerland,CHE,0,5,21,202,228
2007,Germany,DEU,Switzerland,CHE,0,0,0,5,5
2007,Ghana,GHA,Switzerland,CHE,0,0,0,5,5
2007,Guinea-Bissau,GNB,Switzerland,CHE,0,0,10,17,27
2007,Guinea,GIN,Switzerland,CHE,0,5,13,76,94
2007,Croatia,HRV,Switzerland,CHE,0,0,5,17,22
2007,Cote d'Ivoire,CIV,Switzerland,CHE,10,10,67,85,172
2007,India,IND,Switzerland,CHE,0,0,0,28,28
2007,Iran (Islamic Rep. of),IRN,Switzerland,CHE,41,96,180,64,381
2007,Iraq,IRQ,Switzerland,CHE,118,455,326,363,1262
2007,Israel,ISR,Switzerland,CHE,0,0,5,5,10
2007,Jordan,JOR,Switzerland,CHE,0,0,0,5,5
2007,Kenya,KEN,Switzerland,CHE,0,5,0,0,5
2007,Kyrgyzstan,KGZ,Switzerland,CHE,5,0,0,5,10
2007,Rep. of Korea,KOR,Switzerland,CHE,0,0,0,5,5
2007,Dem. People's Rep. of Korea,PRK,Switzerland,CHE,0,0,0,10,10
2007,Liberia,LBR,Switzerland,CHE,0,5,5,11,21
2007,Libya,LBY,Switzerland,CHE,13,0,15,14,42
2007,Lebanon,LBN,Switzerland,CHE,0,0,14,46,60
2007,Sri Lanka,LKA,Switzerland,CHE,92,91,144,99,426
2007,Lithuania,LTU,Switzerland,CHE,0,0,0,5,5
2007,Mauritania,MRT,Switzerland,CHE,0,0,0,5,5
2007,North Macedonia,MKD,Switzerland,CHE,0,24,24,47,95
2007,Rep. of Moldova,MDA,Switzerland,CHE,0,0,0,36,36
2007,Mali,MLI,Switzerland,CHE,0,0,0,12,12
2007,Mongolia,MNG,Switzerland,CHE,0,10,13,96,119
2007,Morocco,MAR,Switzerland,CHE,0,0,10,27,37
2007,Mozambique,MOZ,Switzerland,CHE,0,5,5,0,10
2007,Montenegro,MNE,Switzerland,CHE,0,5,12,22,39
2007,Myanmar,MMR,Switzerland,CHE,0,5,0,0,5
2007,Nepal,NPL,Switzerland,CHE,0,0,5,5,10
2007,Niger,NER,Switzerland,CHE,0,0,0,5,5
2007,Nigeria,NGA,Switzerland,CHE,0,13,47,261,321
2007,Pakistan,PAK,Switzerland,CHE,5,5,12,27,49
2007,Peru,PER,Switzerland,CHE,0,0,0,5,5
2007,Poland,POL,Switzerland,CHE,0,0,10,5,15
2007,Romania,ROU,Switzerland,CHE,0,0,16,538,554
2007,South Africa,ZAF,Switzerland,CHE,0,0,0,5,5
2007,Russian Federation,RUS,Switzerland,CHE,13,78,96,216,403
2007,Rwanda,RWA,Switzerland,CHE,5,5,5,0,15
2007,Serbia and Kosovo: S/RES/1244 (1999),SRB,Switzerland,CHE,43,365,517,558,1483
2007,Senegal,SEN,Switzerland,CHE,0,0,5,20,25
2007,Sierra Leone,SLE,Switzerland,CHE,0,5,5,12,22
2007,Somalia,SOM,Switzerland,CHE,21,262,183,62,528
2007,Spain,ESP,Switzerland,CHE,0,0,0,5,5
2007,Viet Nam,VNM,Switzerland,CHE,24,0,10,0,34
2007,Sudan,SDN,Switzerland,CHE,5,10,28,40,83
2007,Slovakia,SVK,Switzerland,CHE,0,0,0,10,10
2007,Syrian Arab Rep.,SYR,Switzerland,CHE,22,79,87,19,207
2007,Togo,TGO,Switzerland,CHE,95,13,52,30,190
2007,Tunisia,TUN,Switzerland,CHE,43,5,5,41,94
2007,Turkey,TUR,Switzerland,CHE,307,98,220,165,790
2007,Uganda,UGA,Switzerland,CHE,0,0,5,10,15
2007,Ukraine,UKR,Switzerland,CHE,0,0,5,21,26
2007,Uzbekistan,UZB,Switzerland,CHE,13,5,5,5,28
2007,Yemen,YEM,Switzerland,CHE,15,13,21,10,59
2007,Zimbabwe,ZWE,Switzerland,CHE,5,0,0,16,21
2007,Unknown ,,Switzerland,CHE,5,44,49,213,311
2007,Burundi,BDI,Togo,TGO,0,0,0,5,5
2007,Central African Rep.,CAF,Togo,TGO,0,0,0,11,11
2007,Chad,TCD,Togo,TGO,0,0,0,5,5
2007,Congo,COG,Togo,TGO,0,0,0,10,10
2007,Dem. Rep. of the Congo,COD,Togo,TGO,0,0,16,0,16
2007,Guinea,GIN,Togo,TGO,0,0,0,22,22
2007,Cote d'Ivoire,CIV,Togo,TGO,0,0,25,192,217
2007,Iraq,IRQ,Togo,TGO,0,0,0,10,10
2007,Liberia,LBR,Togo,TGO,0,0,0,44,44
2007,Lebanon,LBN,Togo,TGO,0,0,0,5,5
2007,Sri Lanka,LKA,Togo,TGO,0,0,0,5,5
2007,Nigeria,NGA,Togo,TGO,0,0,0,5,5
2007,Rwanda,RWA,Togo,TGO,0,0,0,24,24
2007,Burundi,BDI,Uganda,UGA,151,0,271,0,422
2007,Dem. Rep. of the Congo,COD,Uganda,UGA,1669,0,64,0,1733
2007,Eritrea,ERI,Uganda,UGA,200,0,33,0,233
2007,Ethiopia,ETH,Uganda,UGA,170,0,63,0,233
2007,Pakistan,PAK,Uganda,UGA,5,0,0,0,5
2007,Rwanda,RWA,Uganda,UGA,235,0,1048,0,1283
2007,Somalia,SOM,Uganda,UGA,644,0,0,0,644
2007,Sudan,SDN,Uganda,UGA,5,0,5,0,10
2007,Afghanistan,AFG,Ukraine,UKR,12,0,12,58,82
2007,Algeria,DZA,Ukraine,UKR,0,0,0,5,5
2007,Egypt,EGY,Ukraine,UKR,0,0,0,10,10
2007,Armenia,ARM,Ukraine,UKR,0,0,0,5,5
2007,Azerbaijan,AZE,Ukraine,UKR,5,0,0,10,15
2007,Bangladesh,BGD,Ukraine,UKR,0,0,0,176,176
2007,Belarus,BLR,Ukraine,UKR,5,0,0,5,10
2007,China,CHN,Ukraine,UKR,0,0,0,5,5
2007,Dem. Rep. of the Congo,COD,Ukraine,UKR,0,0,0,10,10
2007,Palestinian,PSE,Ukraine,UKR,0,0,0,29,29
2007,Georgia,GEO,Ukraine,UKR,0,0,0,40,40
2007,Ghana,GHA,Ukraine,UKR,0,0,0,5,5
2007,India,IND,Ukraine,UKR,0,0,0,451,451
2007,Iran (Islamic Rep. of),IRN,Ukraine,UKR,0,0,0,13,13
2007,Iraq,IRQ,Ukraine,UKR,5,0,22,126,153
2007,Jordan,JOR,Ukraine,UKR,0,0,0,5,5
2007,Kazakhstan,KAZ,Ukraine,UKR,0,0,0,5,5
2007,Kyrgyzstan,KGZ,Ukraine,UKR,0,0,0,5,5
2007,Lebanon,LBN,Ukraine,UKR,0,0,0,5,5
2007,Sri Lanka,LKA,Ukraine,UKR,0,0,0,10,10
2007,Rep. of Moldova,MDA,Ukraine,UKR,0,0,0,10,10
2007,Nepal,NPL,Ukraine,UKR,0,0,0,10,10
2007,Nigeria,NGA,Ukraine,UKR,0,0,0,5,5
2007,Pakistan,PAK,Ukraine,UKR,0,0,0,531,531
2007,Russian Federation,RUS,Ukraine,UKR,0,0,5,52,57
2007,Somalia,SOM,Ukraine,UKR,0,0,29,66,95
2007,Viet Nam,VNM,Ukraine,UKR,0,0,0,58,58
2007,Sudan,SDN,Ukraine,UKR,0,0,5,0,5
2007,Tajikistan,TJK,Ukraine,UKR,0,0,0,5,5
2007,Turkmenistan,TKM,Ukraine,UKR,0,0,0,5,5
2007,Uzbekistan,UZB,Ukraine,UKR,0,0,0,47,47
2007,Stateless,XXA,Ukraine,UKR,0,0,0,10,10
2007,Cameroon,CMR,Uruguay,URY,5,0,0,0,5
2007,Colombia,COL,Uruguay,URY,10,0,0,0,10
2007,Nigeria,NGA,Uruguay,URY,5,0,0,0,5
2007,Colombia,COL,Venezuela (Bolivarian Republic of),VEN,218,0,287,0,505
2007,Iraq,IRQ,Venezuela (Bolivarian Republic of),VEN,5,0,0,0,5
2007,Nigeria,NGA,Venezuela (Bolivarian Republic of),VEN,5,0,0,0,5
2007,Burundi,BDI,Zimbabwe,ZWE,80,0,0,0,80
2007,Dem. Rep. of the Congo,COD,Zimbabwe,ZWE,592,0,12,154,758
2007,Eritrea,ERI,Zimbabwe,ZWE,0,0,0,10,10
2007,Ethiopia,ETH,Zimbabwe,ZWE,5,0,0,1842,1847
2007,Rwanda,RWA,Zimbabwe,ZWE,88,0,0,0,88
2007,Somalia,SOM,Zimbabwe,ZWE,5,0,0,1314,1319
2008,Iraq,IRQ,Armenia,ARM,0,122,0,5,127
2008,Afghanistan,AFG,Australia,AUS,33,0,5,0,38
2008,Albania,ALB,Australia,AUS,5,0,10,0,15
2008,Egypt,EGY,Australia,AUS,27,0,45,0,72
2008,Burundi,BDI,Australia,AUS,5,0,0,0,5
2008,Bangladesh,BGD,Australia,AUS,35,0,80,5,120
2008,Brazil,BRA,Australia,AUS,0,0,5,0,5
2008,China,CHN,Australia,AUS,183,0,1092,14,1289
2008,Chile,CHL,Australia,AUS,0,0,5,0,5
2008,Cameroon,CMR,Australia,AUS,5,0,10,0,15
2008,Dem. Rep. of the Congo,COD,Australia,AUS,5,0,0,0,5
2008,Colombia,COL,Australia,AUS,5,0,10,0,15
2008,Eritrea,ERI,Australia,AUS,11,0,0,0,11
2008,Ethiopia,ETH,Australia,AUS,17,0,12,0,29
2008,Fiji,FJI,Australia,AUS,10,0,61,0,71
2008,Palestinian,PSE,Australia,AUS,10,0,10,0,20
2008,United Kingdom of Great Britain and Northern Ireland,GBR,Australia,AUS,0,0,5,5,10
2008,Germany,DEU,Australia,AUS,0,0,5,0,5
2008,Ghana,GHA,Australia,AUS,0,0,10,0,10
2008,"China, Hong Kong SAR",HKG,Australia,AUS,0,0,5,0,5
2008,India,IND,Australia,AUS,5,0,296,5,306
2008,Indonesia,IDN,Australia,AUS,5,0,213,0,218
2008,Iran (Islamic Rep. of),IRN,Australia,AUS,98,0,27,0,125
2008,Iraq,IRQ,Australia,AUS,154,0,17,10,181
2008,Israel,ISR,Australia,AUS,5,0,5,0,10
2008,Jordan,JOR,Australia,AUS,5,0,5,0,10
2008,Kenya,KEN,Australia,AUS,10,0,40,0,50
2008,Rep. of Korea,KOR,Australia,AUS,5,0,116,0,121
2008,Lebanon,LBN,Australia,AUS,12,0,68,0,80
2008,Sri Lanka,LKA,Australia,AUS,309,0,61,5,375
2008,Latvia,LVA,Australia,AUS,0,0,5,0,5
2008,North Macedonia,MKD,Australia,AUS,0,0,5,0,5
2008,Malaysia,MYS,Australia,AUS,0,0,233,0,233
2008,Mongolia,MNG,Australia,AUS,5,0,10,0,15
2008,Myanmar,MMR,Australia,AUS,66,0,13,0,79
2008,Nepal,NPL,Australia,AUS,10,0,32,0,42
2008,Nigeria,NGA,Australia,AUS,0,0,18,0,18
2008,New Zealand,NZL,Australia,AUS,0,0,10,0,10
2008,Pakistan,PAK,Australia,AUS,133,0,67,0,200
2008,Peru,PER,Australia,AUS,0,0,5,0,5
2008,Philippines,PHL,Australia,AUS,5,0,13,0,18
2008,Papua New Guinea,PNG,Australia,AUS,15,0,15,0,30
2008,South Africa,ZAF,Australia,AUS,0,0,19,5,24
2008,Russian Federation,RUS,Australia,AUS,0,0,11,5,16
2008,Serbia and Kosovo: S/RES/1244 (1999),SRB,Australia,AUS,0,0,10,0,10
2008,Somalia,SOM,Australia,AUS,12,0,0,0,12
2008,Viet Nam,VNM,Australia,AUS,0,0,49,0,49
2008,Sudan,SDN,Australia,AUS,5,0,5,0,10
2008,Sweden,SWE,Australia,AUS,0,0,0,5,5
2008,Syrian Arab Rep.,SYR,Australia,AUS,0,0,5,0,5
2008,Thailand,THA,Australia,AUS,0,0,5,0,5
2008,Timor-Leste,TLS,Australia,AUS,0,0,11,0,11
2008,Tonga,TON,Australia,AUS,0,0,5,0,5
2008,Turkey,TUR,Australia,AUS,23,0,16,0,39
2008,Uganda,UGA,Australia,AUS,5,0,10,0,15
2008,United States of America,USA,Australia,AUS,5,0,0,0,5
2008,Samoa,WSM,Australia,AUS,0,0,5,0,5
2008,Zimbabwe,ZWE,Australia,AUS,124,0,49,0,173
2008,Stateless,XXA,Australia,AUS,10,0,5,0,15
2008,Tibetan,TIB,Australia,AUS,5,0,0,0,5
2008,Afghanistan,AFG,Azerbaijan,AZE,0,0,149,0,149
2008,Iran (Islamic Rep. of),IRN,Azerbaijan,AZE,0,0,24,0,24
2008,Iraq,IRQ,Azerbaijan,AZE,0,0,15,0,15
2008,Pakistan,PAK,Azerbaijan,AZE,0,0,29,0,29
2008,Dem. Rep. of the Congo,COD,Burundi,BDI,3237,0,311,2270,5818
2008,Rwanda,RWA,Burundi,BDI,14,0,0,0,14
2008,Afghanistan,AFG,Belgium,BEL,107,92,459,32,690
2008,Albania,ALB,Belgium,BEL,38,5,108,19,170
2008,Algeria,DZA,Belgium,BEL,0,0,102,17,119
2008,Angola,AGO,Belgium,BEL,20,0,112,0,132
2008,Egypt,EGY,Belgium,BEL,5,0,13,0,18
2008,Armenia,ARM,Belgium,BEL,5,0,243,21,269
2008,Azerbaijan,AZE,Belgium,BEL,0,0,40,5,45
2008,Burundi,BDI,Belgium,BEL,56,0,39,5,100
2008,Benin,BEN,Belgium,BEL,0,0,5,0,5
2008,Bangladesh,BGD,Belgium,BEL,0,0,47,0,47
2008,Bhutan,BTN,Belgium,BEL,0,0,27,0,27
2008,Burkina Faso,BFA,Belgium,BEL,5,0,5,0,10
2008,Belarus,BLR,Belgium,BEL,5,0,31,0,36
2008,Brazil,BRA,Belgium,BEL,0,0,5,0,5
2008,Bosnia and Herzegovina,BIH,Belgium,BEL,11,0,71,10,92
2008,Bulgaria,BGR,Belgium,BEL,0,0,43,0,43
2008,Central African Rep.,CAF,Belgium,BEL,10,0,0,0,10
2008,Chad,TCD,Belgium,BEL,5,0,5,0,10
2008,China,CHN,Belgium,BEL,79,0,35,0,114
2008,Cameroon,CMR,Belgium,BEL,66,0,187,5,258
2008,Congo,COG,Belgium,BEL,5,0,21,0,26
2008,Dem. Rep. of the Congo,COD,Belgium,BEL,126,14,604,46,790
2008,Colombia,COL,Belgium,BEL,5,0,10,5,20
2008,Cuba,CUB,Belgium,BEL,0,0,5,0,5
2008,Czechia,CZE,Belgium,BEL,0,0,47,0,47
2008,Djibouti,DJI,Belgium,BEL,20,0,10,5,35
2008,Eritrea,ERI,Belgium,BEL,22,0,10,5,37
2008,Ethiopia,ETH,Belgium,BEL,25,0,54,0,79
2008,Gambia,GMB,Belgium,BEL,5,0,17,0,22
2008,Palestinian,PSE,Belgium,BEL,5,5,0,0,10
2008,Georgia,GEO,Belgium,BEL,0,0,73,10,83
2008,Ghana,GHA,Belgium,BEL,0,0,10,5,15
2008,Guinea,GIN,Belgium,BEL,359,0,384,36,779
2008,Haiti,HTI,Belgium,BEL,0,0,5,0,5
2008,Croatia,HRV,Belgium,BEL,0,0,5,0,5
2008,Hungary,HUN,Belgium,BEL,0,0,10,0,10
2008,Cote d'Ivoire,CIV,Belgium,BEL,29,0,55,0,84
2008,India,IND,Belgium,BEL,0,0,40,5,45
2008,Iran (Islamic Rep. of),IRN,Belgium,BEL,63,0,294,22,379
2008,Iraq,IRQ,Belgium,BEL,336,267,282,57,942
2008,Israel,ISR,Belgium,BEL,0,5,5,0,10
2008,Jordan,JOR,Belgium,BEL,5,0,5,5,15
2008,Kazakhstan,KAZ,Belgium,BEL,0,0,14,10,24
2008,Kenya,KEN,Belgium,BEL,10,0,13,0,23
2008,Kyrgyzstan,KGZ,Belgium,BEL,0,0,18,5,23
2008,Dem. People's Rep. of Korea,PRK,Belgium,BEL,5,0,0,0,5
2008,Liberia,LBR,Belgium,BEL,0,0,10,0,10
2008,Libya,LBY,Belgium,BEL,0,0,10,0,10
2008,Lebanon,LBN,Belgium,BEL,5,0,89,14,108
2008,Sri Lanka,LKA,Belgium,BEL,89,0,80,5,174
2008,Mauritania,MRT,Belgium,BEL,42,0,54,5,101
2008,North Macedonia,MKD,Belgium,BEL,0,0,61,19,80
2008,Rep. of Moldova,MDA,Belgium,BEL,0,0,12,0,12
2008,Mali,MLI,Belgium,BEL,5,0,0,0,5
2008,Mongolia,MNG,Belgium,BEL,5,0,25,0,30
2008,Morocco,MAR,Belgium,BEL,0,0,22,0,22
2008,Montenegro,MNE,Belgium,BEL,10,0,89,10,109
2008,Myanmar,MMR,Belgium,BEL,5,0,5,0,10
2008,Nepal,NPL,Belgium,BEL,5,0,43,5,53
2008,Niger,NER,Belgium,BEL,15,0,28,0,43
2008,Nigeria,NGA,Belgium,BEL,5,0,32,0,37
2008,Pakistan,PAK,Belgium,BEL,10,0,81,0,91
2008,Poland,POL,Belgium,BEL,0,0,5,0,5
2008,Romania,ROU,Belgium,BEL,0,0,43,0,43
2008,Russian Federation,RUS,Belgium,BEL,582,0,1331,117,2030
2008,Rwanda,RWA,Belgium,BEL,142,0,136,5,283
2008,Serbia and Kosovo: S/RES/1244 (1999),SRB,Belgium,BEL,387,0,675,120,1182
2008,Senegal,SEN,Belgium,BEL,5,0,5,0,10
2008,Sierra Leone,SLE,Belgium,BEL,16,0,21,0,37
2008,Somalia,SOM,Belgium,BEL,25,52,55,14,146
2008,Viet Nam,VNM,Belgium,BEL,0,0,10,0,10
2008,Sudan,SDN,Belgium,BEL,19,12,34,0,65
2008,Slovakia,SVK,Belgium,BEL,0,0,434,5,439
2008,Syrian Arab Rep.,SYR,Belgium,BEL,82,0,157,5,244
2008,United Rep. of Tanzania,TZA,Belgium,BEL,5,0,16,0,21
2008,Tajikistan,TJK,Belgium,BEL,0,0,5,5,10
2008,Turkmenistan,TKM,Belgium,BEL,0,0,5,0,5
2008,Togo,TGO,Belgium,BEL,26,0,114,5,145
2008,Tunisia,TUN,Belgium,BEL,0,0,5,0,5
2008,Turkey,TUR,Belgium,BEL,40,0,144,17,201
2008,Uganda,UGA,Belgium,BEL,0,0,13,0,13
2008,Ukraine,UKR,Belgium,BEL,0,0,21,5,26
2008,Uzbekistan,UZB,Belgium,BEL,17,0,20,5,42
2008,Yemen,YEM,Belgium,BEL,0,0,28,0,28
2008,Stateless,XXA,Belgium,BEL,0,12,11,0,23
2008,Unknown ,,Belgium,BEL,45,5,65,20,135
2008,Central African Rep.,CAF,Benin,BEN,0,0,17,11,28
2008,Chad,TCD,Benin,BEN,51,0,91,0,142
2008,Cameroon,CMR,Benin,BEN,0,0,5,5,10
2008,Congo,COG,Benin,BEN,5,0,12,5,22
2008,Dem. Rep. of the Congo,COD,Benin,BEN,5,0,112,154,271
2008,Equatorial Guinea,GNQ,Benin,BEN,0,0,5,0,5
2008,Haiti,HTI,Benin,BEN,0,0,5,0,5
2008,Cote d'Ivoire,CIV,Benin,BEN,0,0,5,0,5
2008,Kenya,KEN,Benin,BEN,0,0,5,0,5
2008,Nigeria,NGA,Benin,BEN,5,0,57,0,62
2008,Rwanda,RWA,Benin,BEN,5,0,10,5,20
2008,Togo,TGO,Benin,BEN,22,0,95,0,117
2008,Burundi,BDI,Burkina Faso,BFA,5,0,0,0,5
2008,Chad,TCD,Burkina Faso,BFA,14,0,5,0,19
2008,Congo,COG,Burkina Faso,BFA,0,0,14,0,14
2008,Dem. Rep. of the Congo,COD,Burkina Faso,BFA,5,0,5,0,10
2008,Cote d'Ivoire,CIV,Burkina Faso,BFA,0,0,10,0,10
2008,Afghanistan,AFG,Belarus,BLR,0,5,10,5,20
2008,Georgia,GEO,Belarus,BLR,0,0,5,5,10
2008,Iran (Islamic Rep. of),IRN,Belarus,BLR,0,0,5,0,5
2008,Iraq,IRQ,Belarus,BLR,0,0,0,5,5
2008,Pakistan,PAK,Belarus,BLR,0,0,0,5,5
2008,Ukraine,UKR,Belarus,BLR,0,0,0,5,5
2008,Colombia,COL,Bolivia (Plurinational State of),BOL,30,0,5,15,50
2008,Cuba,CUB,Bolivia (Plurinational State of),BOL,0,0,5,0,5
2008,Eritrea,ERI,Bolivia (Plurinational State of),BOL,0,0,5,40,45
2008,Ethiopia,ETH,Bolivia (Plurinational State of),BOL,0,0,0,10,10
2008,Romania,ROU,Bolivia (Plurinational State of),BOL,0,0,0,5,5
2008,Somalia,SOM,Botswana,BWA,16,0,0,0,16
2008,Zimbabwe,ZWE,Botswana,BWA,731,0,0,0,731
2008,Angola,AGO,Brazil,BRA,5,0,12,0,17
2008,Burundi,BDI,Brazil,BRA,0,0,5,0,5
2008,Dem. Rep. of the Congo,COD,Brazil,BRA,51,10,31,5,97
2008,Colombia,COL,Brazil,BRA,14,5,27,31,77
2008,Cuba,CUB,Brazil,BRA,5,0,32,24,61
2008,Eritrea,ERI,Brazil,BRA,0,0,0,15,15
2008,Ethiopia,ETH,Brazil,BRA,0,0,5,10,15
2008,Palestinian,PSE,Brazil,BRA,0,0,0,5,5
2008,Ghana,GHA,Brazil,BRA,0,0,0,5,5
2008,Guinea-Bissau,GNB,Brazil,BRA,0,0,11,12,23
2008,Guinea,GIN,Brazil,BRA,0,0,14,0,14
2008,Cote d'Ivoire,CIV,Brazil,BRA,0,0,0,5,5
2008,Iraq,IRQ,Brazil,BRA,12,0,0,5,17
2008,Israel,ISR,Brazil,BRA,0,0,10,10,20
2008,Lebanon,LBN,Brazil,BRA,0,0,12,5,17
2008,Nigeria,NGA,Brazil,BRA,0,0,15,0,15
2008,Peru,PER,Brazil,BRA,0,0,0,5,5
2008,Senegal,SEN,Brazil,BRA,0,0,5,0,5
2008,Sierra Leone,SLE,Brazil,BRA,0,0,5,0,5
2008,Somalia,SOM,Brazil,BRA,0,0,5,38,43
2008,Sudan,SDN,Brazil,BRA,0,0,0,5,5
2008,Ukraine,UKR,Brazil,BRA,0,0,5,0,5
2008,Afghanistan,AFG,Bulgaria,BGR,5,17,25,11,58
2008,Albania,ALB,Bulgaria,BGR,0,0,5,0,5
2008,Algeria,DZA,Bulgaria,BGR,0,0,5,0,5
2008,Egypt,EGY,Bulgaria,BGR,0,0,10,0,10
2008,Armenia,ARM,Bulgaria,BGR,0,5,66,0,71
2008,China,CHN,Bulgaria,BGR,0,0,10,0,10
2008,Congo,COG,Bulgaria,BGR,0,0,5,0,5
2008,Iran (Islamic Rep. of),IRN,Bulgaria,BGR,5,5,5,5,20
2008,Iraq,IRQ,Bulgaria,BGR,11,219,128,31,389
2008,Lebanon,LBN,Bulgaria,BGR,0,0,0,5,5
2008,Sri Lanka,LKA,Bulgaria,BGR,0,0,5,5,10
2008,North Macedonia,MKD,Bulgaria,BGR,0,0,5,0,5
2008,Nigeria,NGA,Bulgaria,BGR,0,0,19,0,19
2008,Russian Federation,RUS,Bulgaria,BGR,0,0,5,0,5
2008,Somalia,SOM,Bulgaria,BGR,0,5,5,0,10
2008,Viet Nam,VNM,Bulgaria,BGR,0,0,5,0,5
2008,Sudan,SDN,Bulgaria,BGR,0,5,0,0,5
2008,Syrian Arab Rep.,SYR,Bulgaria,BGR,0,0,14,0,14
2008,United Rep. of Tanzania,TZA,Bulgaria,BGR,0,0,5,0,5
2008,Turkey,TUR,Bulgaria,BGR,0,0,5,0,5
2008,Stateless,XXA,Bulgaria,BGR,5,5,38,5,53
2008,Afghanistan,AFG,Canada,CAN,230,0,10,40,280
2008,Albania,ALB,Canada,CAN,24,0,51,5,80
2008,Algeria,DZA,Canada,CAN,16,0,32,10,58
2008,Angola,AGO,Canada,CAN,11,0,5,0,16
2008,Egypt,EGY,Canada,CAN,13,0,11,5,29
2008,Argentina,ARG,Canada,CAN,5,0,10,0,15
2008,Armenia,ARM,Canada,CAN,5,0,11,5,21
2008,Azerbaijan,AZE,Canada,CAN,10,0,5,5,20
2008,Barbados,BRB,Canada,CAN,5,0,14,0,19
2008,Burundi,BDI,Canada,CAN,224,0,84,0,308
2008,Belgium,BEL,Canada,CAN,0,0,5,0,5
2008,Bangladesh,BGD,Canada,CAN,39,0,18,10,67
2008,Bahamas,BHS,Canada,CAN,0,0,5,5,10
2008,Bhutan,BTN,Canada,CAN,5,0,0,0,5
2008,Burkina Faso,BFA,Canada,CAN,5,0,5,0,10
2008,Belarus,BLR,Canada,CAN,15,0,0,10,25
2008,Bolivia (Plurinational State of),BOL,Canada,CAN,11,0,5,0,16
2008,Botswana,BWA,Canada,CAN,5,0,0,5,10
2008,Brazil,BRA,Canada,CAN,10,0,25,16,51
2008,Bosnia and Herzegovina,BIH,Canada,CAN,0,0,5,5,10
2008,Bulgaria,BGR,Canada,CAN,5,0,5,10,20
2008,Cambodia,KHM,Canada,CAN,5,0,5,5,15
2008,Central African Rep.,CAF,Canada,CAN,5,0,0,0,5
2008,Chad,TCD,Canada,CAN,41,0,25,0,66
2008,China,CHN,Canada,CAN,598,0,284,98,980
2008,Chile,CHL,Canada,CAN,13,0,10,5,28
2008,Cameroon,CMR,Canada,CAN,42,0,21,5,68
2008,Congo,COG,Canada,CAN,13,0,5,0,18
2008,Dem. Rep. of the Congo,COD,Canada,CAN,144,0,63,21,228
2008,Colombia,COL,Canada,CAN,1217,0,198,125,1540
2008,Costa Rica,CRI,Canada,CAN,0,0,10,5,15
2008,Cuba,CUB,Canada,CAN,93,0,22,25,140
2008,Czechia,CZE,Canada,CAN,84,0,5,106,195
2008,Djibouti,DJI,Canada,CAN,14,0,0,0,14
2008,Dominican Rep.,DOM,Canada,CAN,5,0,20,10,35
2008,Ecuador,ECU,Canada,CAN,10,0,14,10,34
2008,Eritrea,ERI,Canada,CAN,58,0,0,11,69
2008,Ethiopia,ETH,Canada,CAN,58,0,15,5,78
2008,Fiji,FJI,Canada,CAN,10,0,5,0,15
2008,France,FRA,Canada,CAN,0,0,5,10,15
2008,Gambia,GMB,Canada,CAN,5,0,0,0,5
2008,Palestinian,PSE,Canada,CAN,16,0,5,5,26
2008,United Kingdom of Great Britain and Northern Ireland,GBR,Canada,CAN,0,0,0,5,5
2008,Georgia,GEO,Canada,CAN,22,0,5,0,27
2008,Germany,DEU,Canada,CAN,0,0,5,11,16
2008,Ghana,GHA,Canada,CAN,10,0,12,10,32
2008,Grenada,GRD,Canada,CAN,13,0,16,5,34
2008,Guatemala,GTM,Canada,CAN,74,0,34,17,125
2008,Guinea,GIN,Canada,CAN,36,0,10,5,51
2008,Guyana,GUY,Canada,CAN,24,0,56,14,94
2008,Haiti,HTI,Canada,CAN,311,0,351,93,755
2008,"China, Hong Kong SAR",HKG,Canada,CAN,0,0,0,5,5
2008,Honduras,HND,Canada,CAN,31,0,52,48,131
2008,Hungary,HUN,Canada,CAN,22,0,13,47,82
2008,Cote d'Ivoire,CIV,Canada,CAN,21,0,5,5,31
2008,India,IND,Canada,CAN,102,0,179,132,413
2008,Indonesia,IDN,Canada,CAN,5,0,34,14,53
2008,Iran (Islamic Rep. of),IRN,Canada,CAN,108,0,10,21,139
2008,Iraq,IRQ,Canada,CAN,147,0,5,24,176
2008,Israel,ISR,Canada,CAN,12,0,124,73,209
2008,Italy,ITA,Canada,CAN,0,0,0,5,5
2008,Jamaica,JAM,Canada,CAN,32,0,22,24,78
2008,Jordan,JOR,Canada,CAN,11,0,10,33,54
2008,Kazakhstan,KAZ,Canada,CAN,5,0,11,0,16
2008,Kenya,KEN,Canada,CAN,41,0,21,5,67
2008,Kyrgyzstan,KGZ,Canada,CAN,0,0,5,0,5
2008,Rep. of Korea,KOR,Canada,CAN,5,0,58,43,106
2008,Dem. People's Rep. of Korea,PRK,Canada,CAN,5,0,0,22,27
2008,Liberia,LBR,Canada,CAN,5,0,5,5,15
2008,Libya,LBY,Canada,CAN,15,0,5,0,20
2008,Saint Lucia,LCA,Canada,CAN,29,0,50,16,95
2008,Lebanon,LBN,Canada,CAN,74,0,76,43,193
2008,Sri Lanka,LKA,Canada,CAN,988,0,27,41,1056
2008,Lithuania,LTU,Canada,CAN,0,0,0,5,5
2008,Mauritania,MRT,Canada,CAN,10,0,5,0,15
2008,North Macedonia,MKD,Canada,CAN,5,0,5,5,15
2008,Rep. of Moldova,MDA,Canada,CAN,5,0,5,0,10
2008,Mexico,MEX,Canada,CAN,606,0,3368,1680,5654
2008,Mali,MLI,Canada,CAN,5,0,5,0,10
2008,Malaysia,MYS,Canada,CAN,5,0,10,5,20
2008,Mongolia,MNG,Canada,CAN,5,0,0,0,5
2008,Morocco,MAR,Canada,CAN,14,0,5,14,33
2008,Myanmar,MMR,Canada,CAN,5,0,0,0,5
2008,Namibia,NAM,Canada,CAN,0,0,5,0,5
2008,Nepal,NPL,Canada,CAN,50,0,0,5,55
2008,Netherlands,NLD,Canada,CAN,0,0,5,5,10
2008,Niger,NER,Canada,CAN,0,0,5,0,5
2008,Nicaragua,NIC,Canada,CAN,5,0,10,10,25
2008,Nigeria,NGA,Canada,CAN,210,0,128,46,384
2008,Pakistan,PAK,Canada,CAN,161,0,114,48,323
2008,Panama,PAN,Canada,CAN,0,0,5,0,5
2008,Paraguay,PRY,Canada,CAN,5,0,5,0,10
2008,Peru,PER,Canada,CAN,41,0,36,17,94
2008,Philippines,PHL,Canada,CAN,11,0,46,14,71
2008,Poland,POL,Canada,CAN,10,0,5,5,20
2008,Portugal,PRT,Canada,CAN,0,0,19,10,29
2008,Romania,ROU,Canada,CAN,19,0,10,33,62
2008,South Africa,ZAF,Canada,CAN,0,0,10,5,15
2008,Russian Federation,RUS,Canada,CAN,61,0,29,26,116
2008,Rwanda,RWA,Canada,CAN,151,0,36,5,192
2008,El Salvador,SLV,Canada,CAN,95,0,71,18,184
2008,Saudi Arabia,SAU,Canada,CAN,0,0,0,10,10
2008,Serbia and Kosovo: S/RES/1244 (1999),SRB,Canada,CAN,5,0,11,19,35
2008,Senegal,SEN,Canada,CAN,10,0,5,0,15
2008,Solomon Islands,SLB,Canada,CAN,22,0,0,0,22
2008,Somalia,SOM,Canada,CAN,147,0,10,45,202
2008,Viet Nam,VNM,Canada,CAN,5,0,5,5,15
2008,Sudan,SDN,Canada,CAN,13,0,5,5,23
2008,Suriname,SUR,Canada,CAN,5,0,0,0,5
2008,Slovakia,SVK,Canada,CAN,0,0,0,23,23
2008,Syrian Arab Rep.,SYR,Canada,CAN,16,0,5,5,26
2008,United Rep. of Tanzania,TZA,Canada,CAN,5,0,5,0,10
2008,Thailand,THA,Canada,CAN,5,0,36,53,94
2008,Togo,TGO,Canada,CAN,5,0,0,0,5
2008,Trinidad and Tobago,TTO,Canada,CAN,27,0,23,12,62
2008,Tunisia,TUN,Canada,CAN,13,0,11,5,29
2008,Turkey,TUR,Canada,CAN,82,0,32,22,136
2008,Uganda,UGA,Canada,CAN,67,0,24,0,91
2008,Ukraine,UKR,Canada,CAN,58,0,32,28,118
2008,United States of America,USA,Canada,CAN,5,0,205,113,323
2008,Uzbekistan,UZB,Canada,CAN,15,0,5,5,25
2008,Saint Vincent and the Grenadines,VCT,Canada,CAN,93,0,117,48,258
2008,Venezuela (Bolivarian Republic of),VEN,Canada,CAN,31,0,10,15,56
2008,Yemen,YEM,Canada,CAN,13,0,0,0,13
2008,Zambia,ZMB,Canada,CAN,5,0,5,0,10
2008,Zimbabwe,ZWE,Canada,CAN,188,0,60,14,262
2008,Unknown ,,Canada,CAN,10,0,11,10,31
2008,Angola,AGO,Central African Rep.,CAF,5,0,0,11,16
2008,Chad,TCD,Central African Rep.,CAF,89,0,0,294,383
2008,Cameroon,CMR,Central African Rep.,CAF,0,0,0,5,5
2008,Congo,COG,Central African Rep.,CAF,5,0,0,53,58
2008,Dem. Rep. of the Congo,COD,Central African Rep.,CAF,239,0,0,0,239
2008,Guinea-Bissau,GNB,Central African Rep.,CAF,0,0,0,5,5
2008,Cote d'Ivoire,CIV,Central African Rep.,CAF,0,0,0,5,5
2008,Liberia,LBR,Central African Rep.,CAF,0,0,0,27,27
2008,Nigeria,NGA,Central African Rep.,CAF,5,0,0,0,5
2008,Rwanda,RWA,Central African Rep.,CAF,70,0,0,0,70
2008,Sudan,SDN,Central African Rep.,CAF,18,0,0,551,569
2008,Colombia,COL,Chile,CHL,114,0,348,5,467
2008,Ecuador,ECU,Chile,CHL,0,0,10,0,10
2008,Haiti,HTI,Chile,CHL,0,0,5,0,5
2008,Peru,PER,Chile,CHL,5,0,5,0,10
2008,Cuba,CUB,Colombia,COL,0,0,66,0,66
2008,Ecuador,ECU,Colombia,COL,0,0,5,0,5
2008,Somalia,SOM,Colombia,COL,0,0,18,0,18
2008,Venezuela (Bolivarian Republic of),VEN,Colombia,COL,5,0,0,0,5
2008,Afghanistan,AFG,Cyprus,CYP,0,0,5,5,10
2008,Egypt,EGY,Cyprus,CYP,0,0,116,100,216
2008,Armenia,ARM,Cyprus,CYP,0,0,5,5,10
2008,Bangladesh,BGD,Cyprus,CYP,0,0,332,222,554
2008,Belarus,BLR,Cyprus,CYP,0,0,0,5,5
2008,China,CHN,Cyprus,CYP,0,0,94,111,205
2008,Cameroon,CMR,Cyprus,CYP,0,0,100,34,134
2008,Dem. Rep. of the Congo,COD,Cyprus,CYP,0,0,5,5,10
2008,Ethiopia,ETH,Cyprus,CYP,0,0,5,5,10
2008,Palestinian,PSE,Cyprus,CYP,11,17,11,220,259
2008,Georgia,GEO,Cyprus,CYP,0,10,197,300,507
2008,Ghana,GHA,Cyprus,CYP,0,0,23,10,33
2008,Cote d'Ivoire,CIV,Cyprus,CYP,0,0,0,5,5
2008,India,IND,Cyprus,CYP,0,0,266,253,519
2008,Iran (Islamic Rep. of),IRN,Cyprus,CYP,10,0,114,104,228
2008,Iraq,IRQ,Cyprus,CYP,24,126,0,39,189
2008,Jordan,JOR,Cyprus,CYP,0,0,23,77,100
2008,Kenya,KEN,Cyprus,CYP,0,0,0,5,5
2008,Kyrgyzstan,KGZ,Cyprus,CYP,0,0,5,0,5
2008,Lebanon,LBN,Cyprus,CYP,0,0,16,61,77
2008,Sri Lanka,LKA,Cyprus,CYP,0,0,610,380,990
2008,North Macedonia,MKD,Cyprus,CYP,0,0,5,5,10
2008,Rep. of Moldova,MDA,Cyprus,CYP,0,0,21,21,42
2008,Morocco,MAR,Cyprus,CYP,0,0,0,11,11
2008,Nepal,NPL,Cyprus,CYP,0,0,103,61,164
2008,Nigeria,NGA,Cyprus,CYP,0,0,207,59,266
2008,Pakistan,PAK,Cyprus,CYP,0,0,350,193,543
2008,Philippines,PHL,Cyprus,CYP,0,0,75,25,100
2008,Russian Federation,RUS,Cyprus,CYP,0,0,82,129,211
2008,Somalia,SOM,Cyprus,CYP,0,0,5,0,5
2008,Viet Nam,VNM,Cyprus,CYP,0,0,59,48,107
2008,Syrian Arab Rep.,SYR,Cyprus,CYP,0,0,1042,1005,2047
2008,Turkey,TUR,Cyprus,CYP,20,0,57,21,98
2008,Ukraine,UKR,Cyprus,CYP,0,0,23,102,125
2008,Uzbekistan,UZB,Cyprus,CYP,0,0,36,42,78
2008,Afghanistan,AFG,Czechia,CZE,0,0,5,25,30
2008,Algeria,DZA,Czechia,CZE,0,0,5,10,15
2008,Angola,AGO,Czechia,CZE,0,0,5,0,5
2008,Armenia,ARM,Czechia,CZE,5,0,16,5,26
2008,Azerbaijan,AZE,Czechia,CZE,0,0,5,0,5
2008,Belarus,BLR,Czechia,CZE,19,13,64,38,134
2008,China,CHN,Czechia,CZE,0,0,18,19,37
2008,Cameroon,CMR,Czechia,CZE,5,0,5,0,10
2008,Congo,COG,Czechia,CZE,0,0,5,0,5
2008,Dem. Rep. of the Congo,COD,Czechia,CZE,0,0,15,5,20
2008,Cuba,CUB,Czechia,CZE,5,61,0,17,83
2008,Georgia,GEO,Czechia,CZE,0,0,28,10,38
2008,Ghana,GHA,Czechia,CZE,0,0,0,5,5
2008,Guinea,GIN,Czechia,CZE,0,0,0,5,5
2008,Cote d'Ivoire,CIV,Czechia,CZE,0,0,5,5,10
2008,India,IND,Czechia,CZE,0,0,5,5,10
2008,Iraq,IRQ,Czechia,CZE,10,22,0,5,37
2008,Kazakhstan,KAZ,Czechia,CZE,14,0,66,38,118
2008,Kyrgyzstan,KGZ,Czechia,CZE,0,0,21,20,41
2008,Sri Lanka,LKA,Czechia,CZE,0,0,10,0,10
2008,North Macedonia,MKD,Czechia,CZE,0,0,5,5,10
2008,Rep. of Moldova,MDA,Czechia,CZE,10,0,13,5,28
2008,Mongolia,MNG,Czechia,CZE,0,0,123,72,195
2008,Morocco,MAR,Czechia,CZE,0,0,5,0,5
2008,Myanmar,MMR,Czechia,CZE,26,0,0,0,26
2008,Nepal,NPL,Czechia,CZE,0,0,0,5,5
2008,Nigeria,NGA,Czechia,CZE,0,0,45,10,55
2008,Pakistan,PAK,Czechia,CZE,5,0,5,0,10
2008,Russian Federation,RUS,Czechia,CZE,18,5,34,46,103
2008,Serbia and Kosovo: S/RES/1244 (1999),SRB,Czechia,CZE,0,0,19,11,30
2008,Somalia,SOM,Czechia,CZE,0,5,0,0,5
2008,Viet Nam,VNM,Czechia,CZE,0,0,64,40,104
2008,Sudan,SDN,Czechia,CZE,0,0,5,0,5
2008,Syrian Arab Rep.,SYR,Czechia,CZE,0,0,5,5,10
2008,Turkey,TUR,Czechia,CZE,0,0,222,89,311
2008,Ukraine,UKR,Czechia,CZE,17,5,190,154,366
2008,Uzbekistan,UZB,Czechia,CZE,0,0,11,10,21
2008,Stateless,XXA,Czechia,CZE,11,17,15,11,54
2008,Unknown ,,Czechia,CZE,0,5,5,5,15
2008,Afghanistan,AFG,Denmark,DNK,5,51,56,0,112
2008,Albania,ALB,Denmark,DNK,0,0,5,0,5
2008,Algeria,DZA,Denmark,DNK,0,0,5,0,5
2008,Azerbaijan,AZE,Denmark,DNK,5,0,12,0,17
2008,Burundi,BDI,Denmark,DNK,0,0,5,0,5
2008,Bangladesh,BGD,Denmark,DNK,0,0,5,0,5
2008,Bosnia and Herzegovina,BIH,Denmark,DNK,0,0,28,0,28
2008,China,CHN,Denmark,DNK,0,0,13,0,13
2008,Eritrea,ERI,Denmark,DNK,0,5,0,0,5
2008,Palestinian,PSE,Denmark,DNK,5,0,23,0,28
2008,Haiti,HTI,Denmark,DNK,0,0,5,0,5
2008,Croatia,HRV,Denmark,DNK,0,0,5,0,5
2008,Cote d'Ivoire,CIV,Denmark,DNK,0,0,5,0,5
2008,India,IND,Denmark,DNK,0,0,5,0,5
2008,Iran (Islamic Rep. of),IRN,Denmark,DNK,62,13,24,0,99
2008,Iraq,IRQ,Denmark,DNK,15,125,95,0,235
2008,Kyrgyzstan,KGZ,Denmark,DNK,0,0,5,0,5
2008,Lebanon,LBN,Denmark,DNK,0,0,5,0,5
2008,Sri Lanka,LKA,Denmark,DNK,0,0,21,0,21
2008,North Macedonia,MKD,Denmark,DNK,0,0,5,0,5
2008,Morocco,MAR,Denmark,DNK,0,0,5,0,5
2008,Myanmar,MMR,Denmark,DNK,13,0,5,0,18
2008,Nigeria,NGA,Denmark,DNK,0,0,18,0,18
2008,Pakistan,PAK,Denmark,DNK,0,0,5,0,5
2008,Russian Federation,RUS,Denmark,DNK,12,95,31,0,138
2008,Rwanda,RWA,Denmark,DNK,5,0,0,0,5
2008,Serbia and Kosovo: S/RES/1244 (1999),SRB,Denmark,DNK,0,0,59,0,59
2008,Somalia,SOM,Denmark,DNK,0,0,10,0,10
2008,Sudan,SDN,Denmark,DNK,5,0,0,0,5
2008,Syrian Arab Rep.,SYR,Denmark,DNK,43,13,5,0,61
2008,Tunisia,TUN,Denmark,DNK,0,0,5,0,5
2008,Turkey,TUR,Denmark,DNK,0,0,13,0,13
2008,Uganda,UGA,Denmark,DNK,0,0,5,0,5
2008,Uzbekistan,UZB,Denmark,DNK,0,0,5,0,5
2008,Zimbabwe,ZWE,Denmark,DNK,5,0,0,0,5
2008,Stateless,XXA,Denmark,DNK,10,0,0,0,10
2008,Afghanistan,AFG,Finland,FIN,0,71,5,17,93
2008,Albania,ALB,Finland,FIN,0,0,0,10,10
2008,Algeria,DZA,Finland,FIN,0,5,0,26,31
2008,Angola,AGO,Finland,FIN,0,28,5,0,33
2008,Armenia,ARM,Finland,FIN,0,0,5,10,15
2008,Bangladesh,BGD,Finland,FIN,0,0,5,10,15
2008,Belarus,BLR,Finland,FIN,0,0,14,38,52
2008,Bosnia and Herzegovina,BIH,Finland,FIN,0,0,0,5,5
2008,Bulgaria,BGR,Finland,FIN,0,0,5,73,78
2008,Cameroon,CMR,Finland,FIN,0,5,5,0,10
2008,Dem. Rep. of the Congo,COD,Finland,FIN,5,24,5,5,39
2008,Ethiopia,ETH,Finland,FIN,0,5,5,0,10
2008,Gambia,GMB,Finland,FIN,0,0,0,5,5
2008,Georgia,GEO,Finland,FIN,0,0,0,10,10
2008,Ghana,GHA,Finland,FIN,0,0,5,10,15
2008,Guinea,GIN,Finland,FIN,0,0,5,0,5
2008,Honduras,HND,Finland,FIN,0,0,5,0,5
2008,Croatia,HRV,Finland,FIN,0,10,0,5,15
2008,India,IND,Finland,FIN,0,5,5,5,15
2008,Iran (Islamic Rep. of),IRN,Finland,FIN,5,34,12,25,76
2008,Iraq,IRQ,Finland,FIN,42,227,0,228,497
2008,Israel,ISR,Finland,FIN,0,0,0,5,5
2008,Libya,LBY,Finland,FIN,0,0,0,5,5
2008,Sri Lanka,LKA,Finland,FIN,0,41,5,0,46
2008,Rep. of Moldova,MDA,Finland,FIN,0,0,0,5,5
2008,Morocco,MAR,Finland,FIN,0,0,0,10,10
2008,Nigeria,NGA,Finland,FIN,0,10,15,31,56
2008,Poland,POL,Finland,FIN,0,0,0,5,5
2008,Romania,ROU,Finland,FIN,0,0,0,17,17
2008,Russian Federation,RUS,Finland,FIN,39,5,45,85,174
2008,Serbia and Kosovo: S/RES/1244 (1999),SRB,Finland,FIN,0,24,25,59,108
2008,Somalia,SOM,Finland,FIN,0,149,5,170,324
2008,Slovakia,SVK,Finland,FIN,0,0,0,5,5
2008,Syrian Arab Rep.,SYR,Finland,FIN,0,5,5,5,15
2008,Togo,TGO,Finland,FIN,0,0,0,5,5
2008,Turkey,TUR,Finland,FIN,0,12,32,32,76
2008,Ukraine,UKR,Finland,FIN,0,0,5,5,10
2008,Zimbabwe,ZWE,Finland,FIN,0,0,5,0,5
2008,Stateless,XXA,Finland,FIN,0,5,0,5,10
2008,Unknown ,,Finland,FIN,0,10,5,24,39
2008,Afghanistan,AFG,France,FRA,90,14,146,0,250
2008,Albania,ALB,France,FRA,51,36,185,0,272
2008,Algeria,DZA,France,FRA,83,63,806,0,952
2008,Angola,AGO,France,FRA,138,11,327,0,476
2008,Egypt,EGY,France,FRA,5,0,26,0,31
2008,Armenia,ARM,France,FRA,450,85,1923,0,2458
2008,Azerbaijan,AZE,France,FRA,327,0,472,0,799
2008,Burundi,BDI,France,FRA,13,0,18,0,31
2008,Bangladesh,BGD,France,FRA,304,5,1627,0,1936
2008,Bhutan,BTN,France,FRA,10,0,14,0,24
2008,Burkina Faso,BFA,France,FRA,0,5,12,0,17
2008,Belarus,BLR,France,FRA,35,0,84,0,119
2008,Brazil,BRA,France,FRA,0,0,16,0,16
2008,Bosnia and Herzegovina,BIH,France,FRA,94,5,146,0,245
2008,Cambodia,KHM,France,FRA,11,0,23,0,34
2008,Central African Rep.,CAF,France,FRA,45,5,98,0,148
2008,Chad,TCD,France,FRA,76,0,120,0,196
2008,China,CHN,France,FRA,102,5,507,0,614
2008,Cameroon,CMR,France,FRA,48,11,158,0,217
2008,Congo,COG,France,FRA,183,22,715,0,920
2008,Dem. Rep. of the Congo,COD,France,FRA,744,54,1668,0,2466
2008,Comoros,COM,France,FRA,61,0,408,0,469
2008,Colombia,COL,France,FRA,24,15,53,0,92
2008,Cuba,CUB,France,FRA,5,0,14,0,19
2008,Djibouti,DJI,France,FRA,10,0,5,0,15
2008,Dominican Rep.,DOM,France,FRA,0,0,18,0,18
2008,Eritrea,ERI,France,FRA,62,0,24,0,86
2008,Ethiopia,ETH,France,FRA,28,0,31,0,59
2008,Gambia,GMB,France,FRA,5,11,55,0,71
2008,Palestinian,PSE,France,FRA,17,0,35,0,52
2008,Georgia,GEO,France,FRA,114,18,327,0,459
2008,Ghana,GHA,France,FRA,0,5,22,0,27
2008,Guinea-Bissau,GNB,France,FRA,5,0,57,0,62
2008,Guinea,GIN,France,FRA,451,79,933,0,1463
2008,Haiti,HTI,France,FRA,138,58,1000,0,1196
2008,Cote d'Ivoire,CIV,France,FRA,149,34,512,0,695
2008,India,IND,France,FRA,5,0,85,0,90
2008,Iran (Islamic Rep. of),IRN,France,FRA,72,0,87,0,159
2008,Iraq,IRQ,France,FRA,262,39,61,0,362
2008,Kazakhstan,KAZ,France,FRA,19,5,39,0,63
2008,Kyrgyzstan,KGZ,France,FRA,15,5,22,0,42
2008,Liberia,LBR,France,FRA,5,0,16,0,21
2008,Sri Lanka,LKA,France,FRA,1209,498,2666,0,4373
2008,Madagascar,MDG,France,FRA,5,0,13,0,18
2008,Mauritania,MRT,France,FRA,177,23,927,0,1127
2008,North Macedonia,MKD,France,FRA,16,0,76,0,92
2008,Rep. of Moldova,MDA,France,FRA,10,11,175,0,196
2008,Mali,MLI,France,FRA,662,327,1108,0,2097
2008,Mongolia,MNG,France,FRA,5,12,66,0,83
2008,Morocco,MAR,France,FRA,5,5,42,0,52
2008,Montenegro,MNE,France,FRA,10,5,75,0,90
2008,Myanmar,MMR,France,FRA,20,0,22,0,42
2008,Nepal,NPL,France,FRA,5,0,34,0,39
2008,Nigeria,NGA,France,FRA,50,30,388,0,468
2008,Pakistan,PAK,France,FRA,45,5,348,0,398
2008,South Africa,ZAF,France,FRA,0,0,5,0,5
2008,Russian Federation,RUS,France,FRA,1163,76,2074,0,3313
2008,Rwanda,RWA,France,FRA,182,0,108,0,290
2008,Serbia and Kosovo: S/RES/1244 (1999),SRB,France,FRA,590,94,1889,0,2573
2008,Senegal,SEN,France,FRA,32,34,171,0,237
2008,Sierra Leone,SLE,France,FRA,22,10,130,0,162
2008,Somalia,SOM,France,FRA,39,5,24,0,68
2008,Viet Nam,VNM,France,FRA,5,0,19,0,24
2008,Sudan,SDN,France,FRA,185,10,219,0,414
2008,Syrian Arab Rep.,SYR,France,FRA,19,0,24,0,43
2008,Togo,TGO,France,FRA,49,0,120,0,169
2008,Tunisia,TUN,France,FRA,10,5,22,0,37
2008,Turkey,TUR,France,FRA,683,21,2455,0,3159
2008,Uganda,UGA,France,FRA,5,0,5,0,10
2008,Ukraine,UKR,France,FRA,14,5,65,0,84
2008,Uzbekistan,UZB,France,FRA,10,0,14,0,24
2008,Stateless,XXA,France,FRA,65,0,152,0,217
2008,Unknown ,,France,FRA,94,12,315,0,421
2008,Afghanistan,AFG,United Kingdom of Great Britain and Northern Ireland,GBR,154,892,843,985,2874
2008,Albania,ALB,United Kingdom of Great Britain and Northern Ireland,GBR,0,39,90,34,163
2008,Algeria,DZA,United Kingdom of Great Britain and Northern Ireland,GBR,5,15,152,132,304
2008,Angola,AGO,United Kingdom of Great Britain and Northern Ireland,GBR,10,16,63,19,108
2008,Egypt,EGY,United Kingdom of Great Britain and Northern Ireland,GBR,5,0,32,27,64
2008,Armenia,ARM,United Kingdom of Great Britain and Northern Ireland,GBR,0,0,10,0,10
2008,Azerbaijan,AZE,United Kingdom of Great Britain and Northern Ireland,GBR,5,0,12,5,22
2008,Burundi,BDI,United Kingdom of Great Britain and Northern Ireland,GBR,0,5,5,0,10
2008,Bangladesh,BGD,United Kingdom of Great Britain and Northern Ireland,GBR,5,93,263,137,498
2008,Bhutan,BTN,United Kingdom of Great Britain and Northern Ireland,GBR,15,0,13,0,28
2008,Belarus,BLR,United Kingdom of Great Britain and Northern Ireland,GBR,36,0,19,10,65
2008,Bolivia (Plurinational State of),BOL,United Kingdom of Great Britain and Northern Ireland,GBR,0,0,28,12,40
2008,Botswana,BWA,United Kingdom of Great Britain and Northern Ireland,GBR,0,0,5,0,5
2008,Brazil,BRA,United Kingdom of Great Britain and Northern Ireland,GBR,0,0,17,18,35
2008,Bosnia and Herzegovina,BIH,United Kingdom of Great Britain and Northern Ireland,GBR,5,0,5,0,10
2008,Canada,CAN,United Kingdom of Great Britain and Northern Ireland,GBR,0,0,0,5,5
2008,Chad,TCD,United Kingdom of Great Britain and Northern Ireland,GBR,5,0,5,5,15
2008,China,CHN,United Kingdom of Great Britain and Northern Ireland,GBR,74,59,589,672,1394
2008,Cameroon,CMR,United Kingdom of Great Britain and Northern Ireland,GBR,16,5,105,10,136
2008,Congo,COG,United Kingdom of Great Britain and Northern Ireland,GBR,0,0,25,0,25
2008,Dem. Rep. of the Congo,COD,United Kingdom of Great Britain and Northern Ireland,GBR,72,28,200,28,328
2008,Colombia,COL,United Kingdom of Great Britain and Northern Ireland,GBR,0,5,16,5,26
2008,Cuba,CUB,United Kingdom of Great Britain and Northern Ireland,GBR,0,0,10,0,10
2008,Cyprus,CYP,United Kingdom of Great Britain and Northern Ireland,GBR,0,0,0,5,5
2008,Czechia,CZE,United Kingdom of Great Britain and Northern Ireland,GBR,0,0,0,14,14
2008,Ecuador,ECU,United Kingdom of Great Britain and Northern Ireland,GBR,0,0,12,10,22
2008,Eritrea,ERI,United Kingdom of Great Britain and Northern Ireland,GBR,1212,65,313,544,2134
2008,Ethiopia,ETH,United Kingdom of Great Britain and Northern Ireland,GBR,18,5,64,15,102
2008,Gambia,GMB,United Kingdom of Great Britain and Northern Ireland,GBR,29,11,93,13,146
2008,Palestinian,PSE,United Kingdom of Great Britain and Northern Ireland,GBR,17,17,116,133,283
2008,Georgia,GEO,United Kingdom of Great Britain and Northern Ireland,GBR,0,0,52,18,70
2008,Ghana,GHA,United Kingdom of Great Britain and Northern Ireland,GBR,0,0,113,38,151
2008,Guinea,GIN,United Kingdom of Great Britain and Northern Ireland,GBR,18,10,43,5,76
2008,Guyana,GUY,United Kingdom of Great Britain and Northern Ireland,GBR,0,0,16,0,16
2008,Croatia,HRV,United Kingdom of Great Britain and Northern Ireland,GBR,0,0,5,0,5
2008,Cote d'Ivoire,CIV,United Kingdom of Great Britain and Northern Ireland,GBR,0,5,67,11,83
2008,India,IND,United Kingdom of Great Britain and Northern Ireland,GBR,5,14,272,408,699
2008,Ireland,IRL,United Kingdom of Great Britain and Northern Ireland,GBR,0,0,5,0,5
2008,Iran (Islamic Rep. of),IRN,United Kingdom of Great Britain and Northern Ireland,GBR,290,222,1360,312,2184
2008,Iraq,IRQ,United Kingdom of Great Britain and Northern Ireland,GBR,249,220,1006,285,1760
2008,Israel,ISR,United Kingdom of Great Britain and Northern Ireland,GBR,0,5,13,5,23
2008,Jamaica,JAM,United Kingdom of Great Britain and Northern Ireland,GBR,10,0,183,56,249
2008,Jordan,JOR,United Kingdom of Great Britain and Northern Ireland,GBR,0,0,18,5,23
2008,Kenya,KEN,United Kingdom of Great Britain and Northern Ireland,GBR,5,10,128,23,166
2008,Rep. of Korea,KOR,United Kingdom of Great Britain and Northern Ireland,GBR,0,0,10,5,15
2008,Dem. People's Rep. of Korea,PRK,United Kingdom of Great Britain and Northern Ireland,GBR,279,10,77,68,434
2008,Kuwait,KWT,United Kingdom of Great Britain and Northern Ireland,GBR,97,5,78,17,197
2008,Liberia,LBR,United Kingdom of Great Britain and Northern Ireland,GBR,0,5,12,11,28
2008,Libya,LBY,United Kingdom of Great Britain and Northern Ireland,GBR,10,0,44,10,64
2008,Saint Lucia,LCA,United Kingdom of Great Britain and Northern Ireland,GBR,0,0,5,0,5
2008,Lebanon,LBN,United Kingdom of Great Britain and Northern Ireland,GBR,5,5,50,10,70
2008,Sri Lanka,LKA,United Kingdom of Great Britain and Northern Ireland,GBR,166,65,803,129,1163
2008,North Macedonia,MKD,United Kingdom of Great Britain and Northern Ireland,GBR,0,0,10,21,31
2008,Rep. of Moldova,MDA,United Kingdom of Great Britain and Northern Ireland,GBR,0,0,14,10,24
2008,Mali,MLI,United Kingdom of Great Britain and Northern Ireland,GBR,5,0,5,0,10
2008,Malaysia,MYS,United Kingdom of Great Britain and Northern Ireland,GBR,0,0,21,11,32
2008,Malawi,MWI,United Kingdom of Great Britain and Northern Ireland,GBR,5,0,95,25,125
2008,Mongolia,MNG,United Kingdom of Great Britain and Northern Ireland,GBR,5,0,23,5,33
2008,Morocco,MAR,United Kingdom of Great Britain and Northern Ireland,GBR,5,0,16,10,31
2008,Mauritius,MUS,United Kingdom of Great Britain and Northern Ireland,GBR,0,0,28,5,33
2008,Myanmar,MMR,United Kingdom of Great Britain and Northern Ireland,GBR,119,21,57,5,202
2008,Namibia,NAM,United Kingdom of Great Britain and Northern Ireland,GBR,0,0,5,0,5
2008,Nepal,NPL,United Kingdom of Great Britain and Northern Ireland,GBR,0,0,22,5,27
2008,Niger,NER,United Kingdom of Great Britain and Northern Ireland,GBR,0,0,0,5,5
2008,Nicaragua,NIC,United Kingdom of Great Britain and Northern Ireland,GBR,0,0,5,0,5
2008,Nigeria,NGA,United Kingdom of Great Britain and Northern Ireland,GBR,5,50,702,212,969
2008,Pakistan,PAK,United Kingdom of Great Britain and Northern Ireland,GBR,144,57,1228,265,1694
2008,Philippines,PHL,United Kingdom of Great Britain and Northern Ireland,GBR,0,0,5,0,5
2008,Poland,POL,United Kingdom of Great Britain and Northern Ireland,GBR,0,0,0,10,10
2008,Romania,ROU,United Kingdom of Great Britain and Northern Ireland,GBR,0,0,0,5,5
2008,South Africa,ZAF,United Kingdom of Great Britain and Northern Ireland,GBR,5,5,102,41,153
2008,Russian Federation,RUS,United Kingdom of Great Britain and Northern Ireland,GBR,27,5,37,21,90
2008,Rwanda,RWA,United Kingdom of Great Britain and Northern Ireland,GBR,0,0,15,5,20
2008,Saudi Arabia,SAU,United Kingdom of Great Britain and Northern Ireland,GBR,0,0,26,5,31
2008,Serbia and Kosovo: S/RES/1244 (1999),SRB,United Kingdom of Great Britain and Northern Ireland,GBR,5,14,43,48,110
2008,Senegal,SEN,United Kingdom of Great Britain and Northern Ireland,GBR,0,0,11,5,16
2008,Sierra Leone,SLE,United Kingdom of Great Britain and Northern Ireland,GBR,5,5,34,16,60
2008,Somalia,SOM,United Kingdom of Great Britain and Northern Ireland,GBR,634,73,542,137,1386
2008,Viet Nam,VNM,United Kingdom of Great Britain and Northern Ireland,GBR,0,13,55,126,194
2008,Sudan,SDN,United Kingdom of Great Britain and Northern Ireland,GBR,51,10,114,78,253
2008,Eswatini,SWZ,United Kingdom of Great Britain and Northern Ireland,GBR,5,0,10,0,15
2008,Syrian Arab Rep.,SYR,United Kingdom of Great Britain and Northern Ireland,GBR,20,10,84,20,134
2008,United Rep. of Tanzania,TZA,United Kingdom of Great Britain and Northern Ireland,GBR,0,0,26,5,31
2008,Thailand,THA,United Kingdom of Great Britain and Northern Ireland,GBR,0,5,5,5,15
2008,Tajikistan,TJK,United Kingdom of Great Britain and Northern Ireland,GBR,0,0,5,0,5
2008,Turkmenistan,TKM,United Kingdom of Great Britain and Northern Ireland,GBR,0,0,13,0,13
2008,Togo,TGO,United Kingdom of Great Britain and Northern Ireland,GBR,0,0,19,0,19
2008,Trinidad and Tobago,TTO,United Kingdom of Great Britain and Northern Ireland,GBR,0,0,5,5,10
2008,Tunisia,TUN,United Kingdom of Great Britain and Northern Ireland,GBR,0,0,11,5,16
2008,Turkey,TUR,United Kingdom of Great Britain and Northern Ireland,GBR,17,12,152,69,250
2008,Uganda,UGA,United Kingdom of Great Britain and Northern Ireland,GBR,11,10,96,22,139
2008,Ukraine,UKR,United Kingdom of Great Britain and Northern Ireland,GBR,0,5,24,14,43
2008,United States of America,USA,United Kingdom of Great Britain and Northern Ireland,GBR,0,0,11,5,16
2008,Uzbekistan,UZB,United Kingdom of Great Britain and Northern Ireland,GBR,5,0,11,5,21
2008,Yemen,YEM,United Kingdom of Great Britain and Northern Ireland,GBR,14,10,49,5,78
2008,Zambia,ZMB,United Kingdom of Great Britain and Northern Ireland,GBR,0,0,16,0,16
2008,Zimbabwe,ZWE,United Kingdom of Great Britain and Northern Ireland,GBR,796,151,2802,86,3835
2008,Unknown ,,United Kingdom of Great Britain and Northern Ireland,GBR,71,5,29,16,121
2008,Chad,TCD,Ghana,GHA,0,0,12,5,17
2008,Cameroon,CMR,Ghana,GHA,0,0,5,0,5
2008,Congo,COG,Ghana,GHA,0,0,0,5,5
2008,Dem. Rep. of the Congo,COD,Ghana,GHA,5,0,5,0,10
2008,Cote d'Ivoire,CIV,Ghana,GHA,36,0,0,0,36
2008,Nigeria,NGA,Ghana,GHA,0,0,0,10,10
2008,Sudan,SDN,Ghana,GHA,0,0,5,0,5
2008,Cote d'Ivoire,CIV,Guinea-Bissau,GNB,5,0,0,0,5
2008,Liberia,LBR,Guinea-Bissau,GNB,13,0,5,0,18
2008,Sierra Leone,SLE,Guinea-Bissau,GNB,5,0,76,0,81
2008,Unknown ,,Guinea-Bissau,GNB,0,0,0,10,10
2008,Afghanistan,AFG,Greece,GRC,5,0,1809,13,1827
2008,Albania,ALB,Greece,GRC,0,0,174,10,184
2008,Algeria,DZA,Greece,GRC,0,0,17,0,17
2008,Egypt,EGY,Greece,GRC,0,0,112,0,112
2008,Armenia,ARM,Greece,GRC,0,0,87,0,87
2008,Azerbaijan,AZE,Greece,GRC,0,0,5,0,5
2008,Bangladesh,BGD,Greece,GRC,0,0,1834,0,1834
2008,Burkina Faso,BFA,Greece,GRC,0,0,133,0,133
2008,Belarus,BLR,Greece,GRC,0,0,10,0,10
2008,China,CHN,Greece,GRC,0,0,58,0,58
2008,Cameroon,CMR,Greece,GRC,0,0,31,0,31
2008,Dem. Rep. of the Congo,COD,Greece,GRC,0,0,10,0,10
2008,Dominican Rep.,DOM,Greece,GRC,0,0,5,0,5
2008,Eritrea,ERI,Greece,GRC,0,0,32,0,32
2008,Ethiopia,ETH,Greece,GRC,0,0,111,0,111
2008,Gambia,GMB,Greece,GRC,0,0,34,0,34
2008,Georgia,GEO,Greece,GRC,0,0,1933,20,1953
2008,Ghana,GHA,Greece,GRC,0,0,83,0,83
2008,Guinea,GIN,Greece,GRC,0,0,142,0,142
2008,Cote d'Ivoire,CIV,Greece,GRC,0,0,51,0,51
2008,India,IND,Greece,GRC,0,0,245,0,245
2008,Indonesia,IDN,Greece,GRC,0,0,29,0,29
2008,Iran (Islamic Rep. of),IRN,Greece,GRC,0,0,274,5,279
2008,Iraq,IRQ,Greece,GRC,5,0,2785,23,2813
2008,Kazakhstan,KAZ,Greece,GRC,0,0,5,0,5
2008,Kenya,KEN,Greece,GRC,0,0,85,0,85
2008,Liberia,LBR,Greece,GRC,0,0,5,0,5
2008,Libya,LBY,Greece,GRC,0,0,5,0,5
2008,Lebanon,LBN,Greece,GRC,0,0,40,0,40
2008,Sri Lanka,LKA,Greece,GRC,0,0,136,5,141
2008,Mauritania,MRT,Greece,GRC,0,0,48,0,48
2008,Rep. of Moldova,MDA,Greece,GRC,0,0,103,5,108
2008,Mali,MLI,Greece,GRC,0,0,5,0,5
2008,Morocco,MAR,Greece,GRC,0,0,16,0,16
2008,Myanmar,MMR,Greece,GRC,0,0,5,0,5
2008,Nepal,NPL,Greece,GRC,0,0,5,0,5
2008,Nigeria,NGA,Greece,GRC,0,0,712,5,717
2008,Pakistan,PAK,Greece,GRC,0,0,8808,5,8813
2008,Philippines,PHL,Greece,GRC,0,0,55,0,55
2008,Russian Federation,RUS,Greece,GRC,0,0,107,0,107
2008,Rwanda,RWA,Greece,GRC,0,0,54,0,54
2008,Serbia and Kosovo: S/RES/1244 (1999),SRB,Greece,GRC,0,0,5,0,5
2008,Senegal,SEN,Greece,GRC,0,0,431,0,431
2008,Sierra Leone,SLE,Greece,GRC,0,0,15,0,15
2008,Somalia,SOM,Greece,GRC,0,0,79,0,79
2008,Sudan,SDN,Greece,GRC,0,0,104,0,104
2008,Syrian Arab Rep.,SYR,Greece,GRC,0,0,1072,0,1072
2008,United Rep. of Tanzania,TZA,Greece,GRC,0,0,23,0,23
2008,Tunisia,TUN,Greece,GRC,0,0,5,0,5
2008,Turkey,TUR,Greece,GRC,0,0,54,0,54
2008,Uganda,UGA,Greece,GRC,0,0,10,0,10
2008,Ukraine,UKR,Greece,GRC,0,0,47,5,52
2008,Uzbekistan,UZB,Greece,GRC,0,0,35,0,35
2008,Unknown ,,Greece,GRC,5,0,93,0,98
2008,Mexico,MEX,Guatemala,GTM,0,0,5,0,5
2008,Colombia,COL,Honduras,HND,5,0,0,5,10
2008,Cuba,CUB,Honduras,HND,0,0,0,17,17
2008,Eritrea,ERI,Honduras,HND,0,0,0,12,12
2008,Ethiopia,ETH,Honduras,HND,0,0,0,10,10
2008,Somalia,SOM,Honduras,HND,0,0,0,12,12
2008,Albania,ALB,Croatia,HRV,0,0,5,0,5
2008,Belarus,BLR,Croatia,HRV,0,0,0,5,5
2008,Bosnia and Herzegovina,BIH,Croatia,HRV,0,0,5,0,5
2008,Iran (Islamic Rep. of),IRN,Croatia,HRV,0,0,11,5,16
2008,Sri Lanka,LKA,Croatia,HRV,0,0,0,10,10
2008,North Macedonia,MKD,Croatia,HRV,0,0,0,5,5
2008,Pakistan,PAK,Croatia,HRV,0,0,5,5,10
2008,Serbia and Kosovo: S/RES/1244 (1999),SRB,Croatia,HRV,0,0,28,50,78
2008,Turkey,TUR,Croatia,HRV,0,0,0,10,10
2008,Afghanistan,AFG,Hungary,HUN,5,52,17,5,79
2008,Albania,ALB,Hungary,HUN,0,0,0,10,10
2008,Algeria,DZA,Hungary,HUN,0,0,5,0,5
2008,Egypt,EGY,Hungary,HUN,0,0,11,31,42
2008,Armenia,ARM,Hungary,HUN,0,0,0,5,5
2008,Bangladesh,BGD,Hungary,HUN,0,0,12,21,33
2008,Bosnia and Herzegovina,BIH,Hungary,HUN,0,0,0,10,10
2008,China,CHN,Hungary,HUN,0,0,19,10,29
2008,Cameroon,CMR,Hungary,HUN,0,0,5,0,5
2008,Cuba,CUB,Hungary,HUN,5,5,5,0,15
2008,Palestinian,PSE,Hungary,HUN,0,10,5,21,36
2008,Georgia,GEO,Hungary,HUN,0,5,32,77,114
2008,India,IND,Hungary,HUN,0,0,0,18,18
2008,Iran (Islamic Rep. of),IRN,Hungary,HUN,0,0,0,5,5
2008,Iraq,IRQ,Hungary,HUN,21,36,17,31,105
2008,Lebanon,LBN,Hungary,HUN,0,0,0,5,5
2008,Sri Lanka,LKA,Hungary,HUN,0,0,0,10,10
2008,North Macedonia,MKD,Hungary,HUN,0,0,5,29,34
2008,Rep. of Moldova,MDA,Hungary,HUN,0,0,0,24,24
2008,Mongolia,MNG,Hungary,HUN,0,0,15,0,15
2008,Montenegro,MNE,Hungary,HUN,0,0,0,5,5
2008,Nigeria,NGA,Hungary,HUN,0,0,11,21,32
2008,Pakistan,PAK,Hungary,HUN,0,0,42,179,221
2008,Russian Federation,RUS,Hungary,HUN,0,0,5,12,17
2008,Serbia and Kosovo: S/RES/1244 (1999),SRB,Hungary,HUN,0,15,119,877,1011
2008,Sierra Leone,SLE,Hungary,HUN,0,0,5,0,5
2008,Somalia,SOM,Hungary,HUN,104,0,0,11,115
2008,Viet Nam,VNM,Hungary,HUN,0,0,23,5,28
2008,Sudan,SDN,Hungary,HUN,0,0,5,0,5
2008,Syrian Arab Rep.,SYR,Hungary,HUN,0,0,5,5,10
2008,Tunisia,TUN,Hungary,HUN,0,0,0,5,5
2008,Turkey,TUR,Hungary,HUN,0,0,15,33,48
2008,Ukraine,UKR,Hungary,HUN,0,0,5,0,5
2008,Uzbekistan,UZB,Hungary,HUN,0,5,5,0,10
2008,Unknown ,,Hungary,HUN,5,0,0,0,5
2008,Albania,ALB,Iceland,ISL,0,0,0,5,5
2008,Azerbaijan,AZE,Iceland,ISL,0,0,0,5,5
2008,Georgia,GEO,Iceland,ISL,0,0,0,5,5
2008,Iran (Islamic Rep. of),IRN,Iceland,ISL,0,0,0,5,5
2008,Sri Lanka,LKA,Iceland,ISL,5,0,0,0,5
2008,Nigeria,NGA,Iceland,ISL,0,0,0,5,5
2008,Russian Federation,RUS,Iceland,ISL,0,5,0,0,5
2008,Serbia and Kosovo: S/RES/1244 (1999),SRB,Iceland,ISL,0,0,5,5,10
2008,Afghanistan,AFG,Ireland,IRL,5,0,62,19,86
2008,Albania,ALB,Ireland,IRL,0,0,62,5,67
2008,Algeria,DZA,Ireland,IRL,0,0,31,12,43
2008,Angola,AGO,Ireland,IRL,0,0,28,5,33
2008,Egypt,EGY,Ireland,IRL,0,0,5,15,20
2008,Armenia,ARM,Ireland,IRL,0,0,5,0,5
2008,Azerbaijan,AZE,Ireland,IRL,0,0,5,0,5
2008,Burundi,BDI,Ireland,IRL,0,0,20,0,20
2008,Benin,BEN,Ireland,IRL,0,0,14,0,14
2008,Bangladesh,BGD,Ireland,IRL,5,0,24,0,29
2008,Bhutan,BTN,Ireland,IRL,0,0,31,5,36
2008,Belarus,BLR,Ireland,IRL,0,0,10,5,15
2008,Brazil,BRA,Ireland,IRL,0,0,10,5,15
2008,Chad,TCD,Ireland,IRL,0,0,5,0,5
2008,China,CHN,Ireland,IRL,0,0,61,151,212
2008,Cameroon,CMR,Ireland,IRL,0,0,60,10,70
2008,Congo,COG,Ireland,IRL,0,0,14,5,19
2008,Dem. Rep. of the Congo,COD,Ireland,IRL,5,0,145,13,163
2008,Eritrea,ERI,Ireland,IRL,18,0,20,12,50
2008,Ethiopia,ETH,Ireland,IRL,5,0,10,0,15
2008,Gambia,GMB,Ireland,IRL,0,0,5,0,5
2008,Palestinian,PSE,Ireland,IRL,5,0,24,5,34
2008,Georgia,GEO,Ireland,IRL,0,0,110,39,149
2008,Ghana,GHA,Ireland,IRL,0,0,79,10,89
2008,Guinea,GIN,Ireland,IRL,0,0,20,0,20
2008,Croatia,HRV,Ireland,IRL,0,0,13,0,13
2008,Cote d'Ivoire,CIV,Ireland,IRL,0,0,18,0,18
2008,India,IND,Ireland,IRL,0,0,10,5,15
2008,Iran (Islamic Rep. of),IRN,Ireland,IRL,10,0,39,17,66
2008,Iraq,IRQ,Ireland,IRL,110,0,100,30,240
2008,Israel,ISR,Ireland,IRL,0,0,10,0,10
2008,Jamaica,JAM,Ireland,IRL,0,0,5,0,5
2008,Kenya,KEN,Ireland,IRL,0,0,35,5,40
2008,Kuwait,KWT,Ireland,IRL,10,0,10,5,25
2008,Liberia,LBR,Ireland,IRL,0,0,22,0,22
2008,Libya,LBY,Ireland,IRL,0,0,5,0,5
2008,Sri Lanka,LKA,Ireland,IRL,5,0,10,0,15
2008,Rep. of Moldova,MDA,Ireland,IRL,0,0,99,54,153
2008,Malaysia,MYS,Ireland,IRL,0,0,0,5,5
2008,Malawi,MWI,Ireland,IRL,0,0,19,5,24
2008,Mongolia,MNG,Ireland,IRL,0,0,10,10,20
2008,Morocco,MAR,Ireland,IRL,0,0,10,0,10
2008,Mauritius,MUS,Ireland,IRL,0,0,20,5,25
2008,Myanmar,MMR,Ireland,IRL,0,0,5,0,5
2008,Nepal,NPL,Ireland,IRL,0,0,5,0,5
2008,Niger,NER,Ireland,IRL,0,0,5,0,5
2008,Nigeria,NGA,Ireland,IRL,5,0,989,79,1073
2008,Pakistan,PAK,Ireland,IRL,15,0,145,27,187
2008,South Africa,ZAF,Ireland,IRL,0,0,59,5,64
2008,Russian Federation,RUS,Ireland,IRL,5,0,20,11,36
2008,Rwanda,RWA,Ireland,IRL,0,0,10,0,10
2008,Serbia and Kosovo: S/RES/1244 (1999),SRB,Ireland,IRL,0,0,42,10,52
2008,Sierra Leone,SLE,Ireland,IRL,0,0,16,0,16
2008,Somalia,SOM,Ireland,IRL,23,0,42,11,76
2008,Viet Nam,VNM,Ireland,IRL,0,0,5,0,5
2008,Sudan,SDN,Ireland,IRL,35,0,98,44,177
2008,Syrian Arab Rep.,SYR,Ireland,IRL,0,0,5,10,15
2008,United Rep. of Tanzania,TZA,Ireland,IRL,0,0,5,0,5
2008,Togo,TGO,Ireland,IRL,0,0,16,0,16
2008,Turkey,TUR,Ireland,IRL,0,0,5,0,5
2008,Uganda,UGA,Ireland,IRL,10,0,33,0,43
2008,Ukraine,UKR,Ireland,IRL,0,0,18,10,28
2008,United States of America,USA,Ireland,IRL,0,0,5,0,5
2008,Uzbekistan,UZB,Ireland,IRL,5,0,0,0,5
2008,Zimbabwe,ZWE,Ireland,IRL,5,0,100,10,115
2008,Stateless,XXA,Ireland,IRL,0,0,5,0,5
2008,Unknown ,,Ireland,IRL,0,0,0,385,385
2008,Afghanistan,AFG,Italy,ITA,208,969,582,22,1781
2008,Albania,ALB,Italy,ITA,5,5,22,5,37
2008,Algeria,DZA,Italy,ITA,5,5,111,10,131
2008,Angola,AGO,Italy,ITA,5,5,5,0,15
2008,Egypt,EGY,Italy,ITA,0,5,60,13,78
2008,Armenia,ARM,Italy,ITA,5,10,14,0,29
2008,Burundi,BDI,Italy,ITA,5,0,0,0,5
2008,Benin,BEN,Italy,ITA,0,10,39,0,49
2008,Bangladesh,BGD,Italy,ITA,10,50,890,46,996
2008,Burkina Faso,BFA,Italy,ITA,15,83,340,31,469
2008,Belarus,BLR,Italy,ITA,0,0,5,0,5
2008,Bolivia (Plurinational State of),BOL,Italy,ITA,0,0,5,0,5
2008,Bosnia and Herzegovina,BIH,Italy,ITA,0,5,5,5,15
2008,Central African Rep.,CAF,Italy,ITA,0,5,0,0,5
2008,Chad,TCD,Italy,ITA,5,21,15,0,41
2008,China,CHN,Italy,ITA,10,0,21,5,36
2008,Chile,CHL,Italy,ITA,0,0,5,0,5
2008,Cameroon,CMR,Italy,ITA,34,42,88,5,169
2008,Congo,COG,Italy,ITA,5,12,15,5,37
2008,Dem. Rep. of the Congo,COD,Italy,ITA,15,14,14,0,43
2008,Colombia,COL,Italy,ITA,5,5,12,5,27
2008,Cuba,CUB,Italy,ITA,0,15,26,0,41
2008,Ecuador,ECU,Italy,ITA,0,5,5,0,10
2008,Eritrea,ERI,Italy,ITA,202,1427,174,64,1867
2008,Ethiopia,ETH,Italy,ITA,65,136,78,10,289
2008,Gambia,GMB,Italy,ITA,18,24,121,5,168
2008,Palestinian,PSE,Italy,ITA,14,5,79,11,109
2008,Georgia,GEO,Italy,ITA,0,14,18,0,32
2008,Ghana,GHA,Italy,ITA,10,124,1075,22,1231
2008,Guinea-Bissau,GNB,Italy,ITA,0,0,10,0,10
2008,Guatemala,GTM,Italy,ITA,5,0,0,0,5
2008,Guinea,GIN,Italy,ITA,40,105,249,5,399
2008,Cote d'Ivoire,CIV,Italy,ITA,90,468,829,40,1427
2008,India,IND,Italy,ITA,0,5,57,11,73
2008,Iran (Islamic Rep. of),IRN,Italy,ITA,43,31,19,5,98
2008,Iraq,IRQ,Italy,ITA,210,224,57,24,515
2008,Kenya,KEN,Italy,ITA,5,24,38,0,67
2008,Liberia,LBR,Italy,ITA,0,18,75,24,117
2008,Libya,LBY,Italy,ITA,0,0,5,0,5
2008,Lebanon,LBN,Italy,ITA,17,20,65,5,107
2008,Sri Lanka,LKA,Italy,ITA,12,67,63,12,154
2008,Mauritania,MRT,Italy,ITA,5,13,10,5,33
2008,Rep. of Moldova,MDA,Italy,ITA,0,10,17,0,27
2008,Mali,MLI,Italy,ITA,5,28,286,10,329
2008,Mongolia,MNG,Italy,ITA,0,0,5,0,5
2008,Morocco,MAR,Italy,ITA,5,11,93,11,120
2008,Myanmar,MMR,Italy,ITA,5,0,0,0,5
2008,Niger,NER,Italy,ITA,5,11,76,0,92
2008,Nigeria,NGA,Italy,ITA,41,366,2738,253,3398
2008,Pakistan,PAK,Italy,ITA,43,111,500,52,706
2008,Peru,PER,Italy,ITA,0,0,5,0,5
2008,Philippines,PHL,Italy,ITA,0,0,5,0,5
2008,El Salvador,SLV,Italy,ITA,0,5,5,0,10
2008,Serbia and Kosovo: S/RES/1244 (1999),SRB,Italy,ITA,13,28,40,128,209
2008,Senegal,SEN,Italy,ITA,10,21,63,5,99
2008,Sierra Leone,SLE,Italy,ITA,5,12,47,10,74
2008,Somalia,SOM,Italy,ITA,342,3210,153,13,3718
2008,Sudan,SDN,Italy,ITA,121,146,126,29,422
2008,Syrian Arab Rep.,SYR,Italy,ITA,10,17,5,0,32
2008,Togo,TGO,Italy,ITA,37,114,359,5,515
2008,Tunisia,TUN,Italy,ITA,0,0,56,10,66
2008,Turkey,TUR,Italy,ITA,58,116,177,41,392
2008,Uganda,UGA,Italy,ITA,0,0,5,0,5
2008,Ukraine,UKR,Italy,ITA,0,0,10,5,15
2008,Zimbabwe,ZWE,Italy,ITA,0,5,20,5,30
2008,Unknown ,,Italy,ITA,12,40,268,70,390
2008,Burundi,BDI,Japan,JPN,0,0,5,0,5
2008,Bangladesh,BGD,Japan,JPN,0,0,12,5,17
2008,China,CHN,Japan,JPN,0,0,5,0,5
2008,Cameroon,CMR,Japan,JPN,0,0,5,0,5
2008,Dem. Rep. of the Congo,COD,Japan,JPN,0,0,5,5,10
2008,Ethiopia,ETH,Japan,JPN,0,0,12,0,12
2008,Iran (Islamic Rep. of),IRN,Japan,JPN,0,0,24,0,24
2008,Sri Lanka,LKA,Japan,JPN,0,5,43,5,53
2008,Myanmar,MMR,Japan,JPN,38,312,491,24,865
2008,Nepal,NPL,Japan,JPN,0,0,12,0,12
2008,Nigeria,NGA,Japan,JPN,0,0,10,0,10
2008,Pakistan,PAK,Japan,JPN,0,0,14,5,19
2008,Turkey,TUR,Japan,JPN,0,0,119,13,132
2008,Uganda,UGA,Japan,JPN,0,0,5,0,5
2008,Unknown ,,Japan,JPN,0,0,19,14,33
2008,Afghanistan,AFG,Kyrgyzstan,KGZ,5,0,263,84,352
2008,Iran (Islamic Rep. of),IRN,Kyrgyzstan,KGZ,0,0,11,0,11
2008,Iraq,IRQ,Kyrgyzstan,KGZ,0,0,0,5,5
2008,Kazakhstan,KAZ,Kyrgyzstan,KGZ,0,0,5,0,5
2008,Russian Federation,RUS,Kyrgyzstan,KGZ,0,0,0,46,46
2008,Sudan,SDN,Kyrgyzstan,KGZ,0,0,0,5,5
2008,Turkmenistan,TKM,Kyrgyzstan,KGZ,0,0,5,0,5
2008,Uzbekistan,UZB,Kyrgyzstan,KGZ,0,0,0,167,167
2008,Angola,AGO,Liechtenstein,LIE,0,0,0,5,5
2008,Belarus,BLR,Liechtenstein,LIE,0,0,0,5,5
2008,Belarus,BLR,Lithuania,LTU,0,0,5,5,10
2008,Dem. Rep. of the Congo,COD,Lithuania,LTU,0,0,5,0,5
2008,Cuba,CUB,Lithuania,LTU,0,5,5,0,10
2008,Georgia,GEO,Lithuania,LTU,0,0,5,5,10
2008,India,IND,Lithuania,LTU,0,0,5,0,5
2008,Russian Federation,RUS,Lithuania,LTU,5,45,10,21,81
2008,Syrian Arab Rep.,SYR,Lithuania,LTU,0,0,0,5,5
2008,Turkey,TUR,Lithuania,LTU,0,0,0,5,5
2008,Ukraine,UKR,Lithuania,LTU,0,0,5,0,5
2008,Afghanistan,AFG,Luxembourg,LUX,0,5,0,5,10
2008,Albania,ALB,Luxembourg,LUX,0,5,11,10,26
2008,Algeria,DZA,Luxembourg,LUX,0,0,5,5,10
2008,Angola,AGO,Luxembourg,LUX,10,10,0,0,20
2008,Burundi,BDI,Luxembourg,LUX,0,10,0,0,10
2008,Belarus,BLR,Luxembourg,LUX,0,0,0,5,5
2008,Bosnia and Herzegovina,BIH,Luxembourg,LUX,0,10,16,5,31
2008,Cameroon,CMR,Luxembourg,LUX,0,5,5,5,15
2008,Dem. Rep. of the Congo,COD,Luxembourg,LUX,5,13,0,5,23
2008,Eritrea,ERI,Luxembourg,LUX,0,0,0,5,5
2008,Ethiopia,ETH,Luxembourg,LUX,5,5,5,0,15
2008,Iran (Islamic Rep. of),IRN,Luxembourg,LUX,10,12,12,5,39
2008,Iraq,IRQ,Luxembourg,LUX,5,0,0,0,5
2008,Liberia,LBR,Luxembourg,LUX,0,10,0,0,10
2008,North Macedonia,MKD,Luxembourg,LUX,0,5,5,0,10
2008,Rep. of Moldova,MDA,Luxembourg,LUX,0,0,5,0,5
2008,Mongolia,MNG,Luxembourg,LUX,0,5,0,0,5
2008,Montenegro,MNE,Luxembourg,LUX,0,37,23,10,70
2008,Nigeria,NGA,Luxembourg,LUX,0,41,5,5,51
2008,Russian Federation,RUS,Luxembourg,LUX,0,16,22,11,49
2008,Serbia and Kosovo: S/RES/1244 (1999),SRB,Luxembourg,LUX,12,121,97,50,280
2008,Somalia,SOM,Luxembourg,LUX,0,5,0,0,5
2008,Tajikistan,TJK,Luxembourg,LUX,0,0,0,5,5
2008,Togo,TGO,Luxembourg,LUX,0,11,0,0,11
2008,Turkey,TUR,Luxembourg,LUX,0,5,0,0,5
2008,Ukraine,UKR,Luxembourg,LUX,0,0,0,5,5
2008,Armenia,ARM,Latvia,LVA,0,0,5,0,5
2008,Bangladesh,BGD,Latvia,LVA,0,0,10,0,10
2008,Colombia,COL,Mexico,MEX,22,0,10,14,46
2008,Cuba,CUB,Mexico,MEX,0,0,0,10,10
2008,Ecuador,ECU,Mexico,MEX,0,0,0,5,5
2008,Guatemala,GTM,Mexico,MEX,0,0,5,10,15
2008,Haiti,HTI,Mexico,MEX,46,0,14,5,65
2008,Honduras,HND,Mexico,MEX,0,0,25,34,59
2008,India,IND,Mexico,MEX,0,0,0,5,5
2008,Iraq,IRQ,Mexico,MEX,18,0,0,0,18
2008,Sri Lanka,LKA,Mexico,MEX,5,0,0,0,5
2008,North Macedonia,MKD,Mexico,MEX,0,0,5,5,10
2008,Nepal,NPL,Mexico,MEX,0,0,0,5,5
2008,Nicaragua,NIC,Mexico,MEX,0,0,5,5,10
2008,Romania,ROU,Mexico,MEX,0,0,0,5,5
2008,El Salvador,SLV,Mexico,MEX,0,0,22,25,47
2008,Somalia,SOM,Mexico,MEX,0,0,0,5,5
2008,Burundi,BDI,Mali,MLI,0,0,5,0,5
2008,Chad,TCD,Mali,MLI,0,0,5,0,5
2008,Dem. Rep. of the Congo,COD,Mali,MLI,10,0,0,0,10
2008,Cote d'Ivoire,CIV,Mali,MLI,5,0,16,0,21
2008,Burundi,BDI,Mozambique,MOZ,29,0,73,76,178
2008,Dem. Rep. of the Congo,COD,Mozambique,MOZ,403,0,474,366,1243
2008,Rwanda,RWA,Mozambique,MOZ,16,0,0,10,26
2008,Somalia,SOM,Mozambique,MOZ,5,0,0,0,5
2008,Benin,BEN,Malta,MLT,0,0,5,0,5
2008,Burkina Faso,BFA,Malta,MLT,0,0,31,0,31
2008,Chad,TCD,Malta,MLT,0,0,5,0,5
2008,Cameroon,CMR,Malta,MLT,0,0,5,0,5
2008,Dem. Rep. of the Congo,COD,Malta,MLT,0,0,5,0,5
2008,Eritrea,ERI,Malta,MLT,10,251,18,0,279
2008,Ethiopia,ETH,Malta,MLT,5,5,120,5,135
2008,Gambia,GMB,Malta,MLT,0,0,37,0,37
2008,Palestinian,PSE,Malta,MLT,0,0,5,0,5
2008,Ghana,GHA,Malta,MLT,0,0,93,5,98
2008,Guinea-Bissau,GNB,Malta,MLT,0,0,11,0,11
2008,Guinea,GIN,Malta,MLT,0,0,34,0,34
2008,Cote d'Ivoire,CIV,Malta,MLT,0,0,245,0,245
2008,Iraq,IRQ,Malta,MLT,0,0,5,0,5
2008,Liberia,LBR,Malta,MLT,0,0,19,0,19
2008,Sri Lanka,LKA,Malta,MLT,0,5,0,0,5
2008,Mauritania,MRT,Malta,MLT,0,0,5,0,5
2008,Mali,MLI,Malta,MLT,0,0,168,0,168
2008,Niger,NER,Malta,MLT,0,0,90,0,90
2008,Nigeria,NGA,Malta,MLT,0,0,204,0,204
2008,Senegal,SEN,Malta,MLT,0,0,15,0,15
2008,Sierra Leone,SLE,Malta,MLT,0,0,25,0,25
2008,Somalia,SOM,Malta,MLT,5,1117,22,5,1149
2008,Sudan,SDN,Malta,MLT,0,14,29,0,43
2008,Togo,TGO,Malta,MLT,0,0,73,0,73
2008,Tunisia,TUN,Malta,MLT,0,0,5,0,5
2008,Burundi,BDI,Namibia,NAM,10,0,21,0,31
2008,Dem. Rep. of the Congo,COD,Namibia,NAM,21,0,96,0,117
2008,Rwanda,RWA,Namibia,NAM,0,0,5,0,5
2008,Sudan,SDN,Namibia,NAM,0,0,5,0,5
2008,United Rep. of Tanzania,TZA,Namibia,NAM,0,0,5,0,5
2008,Uganda,UGA,Namibia,NAM,0,0,0,5,5
2008,Bhutan,BTN,Nepal,NPL,0,684,0,0,684
2008,Afghanistan,AFG,Netherlands,NLD,5,157,266,0,428
2008,Albania,ALB,Netherlands,NLD,0,0,5,0,5
2008,Algeria,DZA,Netherlands,NLD,0,0,34,0,34
2008,Angola,AGO,Netherlands,NLD,0,5,33,0,38
2008,Egypt,EGY,Netherlands,NLD,0,0,17,0,17
2008,Armenia,ARM,Netherlands,NLD,5,14,98,0,117
2008,Azerbaijan,AZE,Netherlands,NLD,0,17,75,0,92
2008,Burundi,BDI,Netherlands,NLD,5,90,93,0,188
2008,Benin,BEN,Netherlands,NLD,0,0,5,0,5
2008,Bangladesh,BGD,Netherlands,NLD,0,0,13,0,13
2008,Bhutan,BTN,Netherlands,NLD,5,28,5,0,38
2008,Burkina Faso,BFA,Netherlands,NLD,0,0,5,0,5
2008,Belarus,BLR,Netherlands,NLD,5,5,0,0,10
2008,Bosnia and Herzegovina,BIH,Netherlands,NLD,0,0,11,0,11
2008,Chad,TCD,Netherlands,NLD,0,0,5,0,5
2008,China,CHN,Netherlands,NLD,52,47,437,0,536
2008,Cameroon,CMR,Netherlands,NLD,0,10,41,0,51
2008,Congo,COG,Netherlands,NLD,5,51,39,0,95
2008,Dem. Rep. of the Congo,COD,Netherlands,NLD,11,77,30,0,118
2008,Colombia,COL,Netherlands,NLD,0,15,42,0,57
2008,Cuba,CUB,Netherlands,NLD,0,0,5,0,5
2008,Eritrea,ERI,Netherlands,NLD,16,139,66,0,221
2008,Ethiopia,ETH,Netherlands,NLD,39,59,49,0,147
2008,Gambia,GMB,Netherlands,NLD,0,5,11,0,16
2008,Palestinian,PSE,Netherlands,NLD,0,5,19,0,24
2008,Georgia,GEO,Netherlands,NLD,0,0,49,0,49
2008,Ghana,GHA,Netherlands,NLD,0,0,28,0,28
2008,Guinea,GIN,Netherlands,NLD,24,79,145,0,248
2008,Cote d'Ivoire,CIV,Netherlands,NLD,5,52,22,0,79
2008,India,IND,Netherlands,NLD,0,0,32,0,32
2008,Indonesia,IDN,Netherlands,NLD,0,0,5,0,5
2008,Iran (Islamic Rep. of),IRN,Netherlands,NLD,46,112,201,0,359
2008,Iraq,IRQ,Netherlands,NLD,180,2044,1099,0,3323
2008,Jamaica,JAM,Netherlands,NLD,0,0,5,0,5
2008,Kazakhstan,KAZ,Netherlands,NLD,0,0,14,0,14
2008,Kenya,KEN,Netherlands,NLD,0,0,17,0,17
2008,Kyrgyzstan,KGZ,Netherlands,NLD,0,0,5,0,5
2008,Liberia,LBR,Netherlands,NLD,0,13,44,0,57
2008,Libya,LBY,Netherlands,NLD,0,27,10,0,37
2008,Lebanon,LBN,Netherlands,NLD,0,5,17,0,22
2008,Sri Lanka,LKA,Netherlands,NLD,13,41,129,0,183
2008,North Macedonia,MKD,Netherlands,NLD,0,0,10,0,10
2008,Rep. of Moldova,MDA,Netherlands,NLD,0,5,5,0,10
2008,Mali,MLI,Netherlands,NLD,0,0,5,0,5
2008,Malawi,MWI,Netherlands,NLD,0,0,5,0,5
2008,Mongolia,MNG,Netherlands,NLD,0,0,75,0,75
2008,Morocco,MAR,Netherlands,NLD,0,0,12,0,12
2008,Myanmar,MMR,Netherlands,NLD,5,159,5,0,169
2008,Nepal,NPL,Netherlands,NLD,5,51,31,0,87
2008,Niger,NER,Netherlands,NLD,0,0,5,0,5
2008,Nigeria,NGA,Netherlands,NLD,0,12,98,0,110
2008,Pakistan,PAK,Netherlands,NLD,0,0,41,0,41
2008,Philippines,PHL,Netherlands,NLD,0,0,5,0,5
2008,South Africa,ZAF,Netherlands,NLD,0,0,5,0,5
2008,Russian Federation,RUS,Netherlands,NLD,5,26,94,0,125
2008,Rwanda,RWA,Netherlands,NLD,0,11,10,0,21
2008,Serbia and Kosovo: S/RES/1244 (1999),SRB,Netherlands,NLD,0,5,35,0,40
2008,Senegal,SEN,Netherlands,NLD,0,0,5,0,5
2008,Sierra Leone,SLE,Netherlands,NLD,0,78,114,0,192
2008,Somalia,SOM,Netherlands,NLD,35,1451,817,0,2303
2008,Viet Nam,VNM,Netherlands,NLD,0,0,5,0,5
2008,Sudan,SDN,Netherlands,NLD,0,25,71,0,96
2008,Syrian Arab Rep.,SYR,Netherlands,NLD,5,5,62,0,72
2008,United Rep. of Tanzania,TZA,Netherlands,NLD,0,0,5,0,5
2008,Tajikistan,TJK,Netherlands,NLD,0,0,13,0,13
2008,Togo,TGO,Netherlands,NLD,0,10,20,0,30
2008,Tunisia,TUN,Netherlands,NLD,0,0,10,0,10
2008,Turkey,TUR,Netherlands,NLD,10,5,116,0,131
2008,Uganda,UGA,Netherlands,NLD,5,12,16,0,33
2008,Ukraine,UKR,Netherlands,NLD,0,0,5,0,5
2008,United States of America,USA,Netherlands,NLD,0,0,5,0,5
2008,Uzbekistan,UZB,Netherlands,NLD,5,19,14,0,38
2008,Yemen,YEM,Netherlands,NLD,0,0,5,0,5
2008,Zimbabwe,ZWE,Netherlands,NLD,0,5,5,0,10
2008,Stateless,XXA,Netherlands,NLD,5,49,56,0,110
2008,Unknown ,,Netherlands,NLD,5,119,229,0,353
2008,Central African Rep.,CAF,Niger,NER,0,0,5,0,5
2008,Chad,TCD,Niger,NER,5,0,0,0,5
2008,Cuba,CUB,Nicaragua,NIC,0,0,0,5,5
2008,Eritrea,ERI,Nicaragua,NIC,0,0,0,31,31
2008,Ethiopia,ETH,Nicaragua,NIC,0,0,0,26,26
2008,Nepal,NPL,Nicaragua,NIC,0,0,0,5,5
2008,Pakistan,PAK,Nicaragua,NIC,0,0,0,5,5
2008,Somalia,SOM,Nicaragua,NIC,0,0,0,21,21
2008,Chad,TCD,Nigeria,NGA,0,55,0,0,55
2008,Cameroon,CMR,Nigeria,NGA,0,0,29,0,29
2008,Dem. Rep. of the Congo,COD,Nigeria,NGA,23,0,37,0,60
2008,Cote d'Ivoire,CIV,Nigeria,NGA,0,0,10,5,15
2008,Togo,TGO,Nigeria,NGA,0,0,0,5,5
2008,Afghanistan,AFG,Norway,NOR,20,301,23,59,403
2008,Albania,ALB,Norway,NOR,0,0,26,18,44
2008,Algeria,DZA,Norway,NOR,0,0,21,48,69
2008,Angola,AGO,Norway,NOR,11,10,23,5,49
2008,Egypt,EGY,Norway,NOR,0,0,5,5,10
2008,Armenia,ARM,Norway,NOR,0,0,5,0,5
2008,Azerbaijan,AZE,Norway,NOR,0,0,34,5,39
2008,Burundi,BDI,Norway,NOR,0,5,96,5,106
2008,Bangladesh,BGD,Norway,NOR,0,0,5,5,10
2008,Bhutan,BTN,Norway,NOR,0,0,11,0,11
2008,Burkina Faso,BFA,Norway,NOR,0,5,5,5,15
2008,Belarus,BLR,Norway,NOR,0,0,10,5,15
2008,Bosnia and Herzegovina,BIH,Norway,NOR,0,0,5,10,15
2008,Bulgaria,BGR,Norway,NOR,0,0,5,0,5
2008,China,CHN,Norway,NOR,5,5,5,5,20
2008,Cameroon,CMR,Norway,NOR,0,0,26,10,36
2008,Congo,COG,Norway,NOR,0,0,13,0,13
2008,Dem. Rep. of the Congo,COD,Norway,NOR,18,16,71,13,118
2008,Colombia,COL,Norway,NOR,0,5,0,0,5
2008,Czechia,CZE,Norway,NOR,0,0,5,0,5
2008,Eritrea,ERI,Norway,NOR,310,401,34,327,1072
2008,Ethiopia,ETH,Norway,NOR,106,35,129,44,314
2008,Gambia,GMB,Norway,NOR,0,0,17,5,22
2008,Georgia,GEO,Norway,NOR,0,0,11,5,16
2008,Ghana,GHA,Norway,NOR,0,0,19,34,53
2008,Guatemala,GTM,Norway,NOR,0,0,5,0,5
2008,Guinea,GIN,Norway,NOR,5,0,23,5,33
2008,Croatia,HRV,Norway,NOR,0,0,5,5,10
2008,Cote d'Ivoire,CIV,Norway,NOR,0,5,5,5,15
2008,India,IND,Norway,NOR,0,5,0,75,80
2008,Iran (Islamic Rep. of),IRN,Norway,NOR,59,53,186,53,351
2008,Iraq,IRQ,Norway,NOR,113,452,935,344,1844
2008,Israel,ISR,Norway,NOR,0,0,5,5,10
2008,Jordan,JOR,Norway,NOR,0,0,10,5,15
2008,Kazakhstan,KAZ,Norway,NOR,0,0,0,5,5
2008,Kenya,KEN,Norway,NOR,5,0,16,0,21
2008,Kyrgyzstan,KGZ,Norway,NOR,0,0,10,0,10
2008,Rep. of Korea,KOR,Norway,NOR,0,0,57,16,73
2008,Dem. People's Rep. of Korea,PRK,Norway,NOR,0,5,22,16,43
2008,Kuwait,KWT,Norway,NOR,0,10,0,0,10
2008,Liberia,LBR,Norway,NOR,0,0,25,18,43
2008,Libya,LBY,Norway,NOR,0,0,51,34,85
2008,Lebanon,LBN,Norway,NOR,0,5,32,33,70
2008,Sri Lanka,LKA,Norway,NOR,5,42,95,30,172
2008,Mauritania,MRT,Norway,NOR,0,0,12,5,17
2008,North Macedonia,MKD,Norway,NOR,0,0,11,5,16
2008,Rep. of Moldova,MDA,Norway,NOR,0,0,0,5,5
2008,Mongolia,MNG,Norway,NOR,0,0,5,0,5
2008,Morocco,MAR,Norway,NOR,0,0,14,16,30
2008,Montenegro,MNE,Norway,NOR,0,0,0,5,5
2008,Myanmar,MMR,Norway,NOR,0,5,0,0,5
2008,Nepal,NPL,Norway,NOR,0,0,33,10,43
2008,Netherlands,NLD,Norway,NOR,0,0,5,0,5
2008,Nicaragua,NIC,Norway,NOR,0,0,0,5,5
2008,Nigeria,NGA,Norway,NOR,0,0,147,104,251
2008,Pakistan,PAK,Norway,NOR,0,5,5,5,15
2008,Romania,ROU,Norway,NOR,0,0,5,0,5
2008,Russian Federation,RUS,Norway,NOR,16,121,829,220,1186
2008,Rwanda,RWA,Norway,NOR,11,0,13,5,29
2008,Serbia and Kosovo: S/RES/1244 (1999),SRB,Norway,NOR,34,20,724,130,908
2008,Senegal,SEN,Norway,NOR,0,0,5,0,5
2008,Sierra Leone,SLE,Norway,NOR,0,0,15,5,20
2008,Somalia,SOM,Norway,NOR,141,168,58,225,592
2008,Viet Nam,VNM,Norway,NOR,0,5,5,13,23
2008,Sudan,SDN,Norway,NOR,28,5,10,10,53
2008,Syrian Arab Rep.,SYR,Norway,NOR,5,10,35,26,76
2008,Togo,TGO,Norway,NOR,0,0,5,5,10
2008,Tunisia,TUN,Norway,NOR,0,0,5,5,10
2008,Turkey,TUR,Norway,NOR,10,5,41,29,85
2008,Uganda,UGA,Norway,NOR,5,0,20,5,30
2008,Ukraine,UKR,Norway,NOR,0,0,12,5,17
2008,Uzbekistan,UZB,Norway,NOR,0,5,97,10,112
2008,Western Sahara,ESH,Norway,NOR,0,0,10,0,10
2008,Yemen,YEM,Norway,NOR,5,5,10,5,25
2008,Zimbabwe,ZWE,Norway,NOR,0,0,11,5,16
2008,Stateless,XXA,Norway,NOR,154,258,141,118,671
2008,Afghanistan,AFG,New Zealand,NZL,0,0,5,0,5
2008,Egypt,EGY,New Zealand,NZL,0,0,5,0,5
2008,Bangladesh,BGD,New Zealand,NZL,0,0,5,0,5
2008,Bolivia (Plurinational State of),BOL,New Zealand,NZL,0,0,5,0,5
2008,China,CHN,New Zealand,NZL,5,0,13,0,18
2008,Czechia,CZE,New Zealand,NZL,0,0,5,0,5
2008,Fiji,FJI,New Zealand,NZL,0,0,5,0,5
2008,United Kingdom of Great Britain and Northern Ireland,GBR,New Zealand,NZL,0,0,5,0,5
2008,Hungary,HUN,New Zealand,NZL,0,0,5,0,5
2008,India,IND,New Zealand,NZL,0,0,5,0,5
2008,Iran (Islamic Rep. of),IRN,New Zealand,NZL,5,0,22,0,27
2008,Iraq,IRQ,New Zealand,NZL,37,0,5,0,42
2008,Sri Lanka,LKA,New Zealand,NZL,16,0,20,0,36
2008,Mexico,MEX,New Zealand,NZL,0,0,5,0,5
2008,Malaysia,MYS,New Zealand,NZL,0,0,10,0,10
2008,Myanmar,MMR,New Zealand,NZL,5,0,5,0,10
2008,Nepal,NPL,New Zealand,NZL,0,0,5,0,5
2008,Poland,POL,New Zealand,NZL,0,0,5,0,5
2008,Saudi Arabia,SAU,New Zealand,NZL,5,0,0,0,5
2008,Somalia,SOM,New Zealand,NZL,0,0,5,0,5
2008,Slovakia,SVK,New Zealand,NZL,0,0,5,0,5
2008,Zimbabwe,ZWE,New Zealand,NZL,10,0,0,0,10
2008,Dem. Rep. of the Congo,COD,Panama,PAN,5,0,0,0,5
2008,Colombia,COL,Panama,PAN,30,0,17,71,118
2008,Guatemala,GTM,Panama,PAN,0,0,10,0,10
2008,Colombia,COL,Paraguay,PRY,5,0,0,0,5
2008,Cuba,CUB,Paraguay,PRY,5,0,0,10,15
2008,Colombia,COL,Peru,PER,40,0,11,0,51
2008,Cuba,CUB,Peru,PER,41,0,40,0,81
2008,Haiti,HTI,Peru,PER,5,0,0,12,17
2008,Venezuela (Bolivarian Republic of),VEN,Peru,PER,5,0,0,0,5
2008,Afghanistan,AFG,Poland,POL,0,0,5,0,5
2008,Algeria,DZA,Poland,POL,0,0,0,5,5
2008,Egypt,EGY,Poland,POL,0,0,0,5,5
2008,Armenia,ARM,Poland,POL,0,5,32,13,50
2008,Azerbaijan,AZE,Poland,POL,0,0,0,5,5
2008,Burundi,BDI,Poland,POL,0,0,5,0,5
2008,Bangladesh,BGD,Poland,POL,0,0,5,18,23
2008,Belarus,BLR,Poland,POL,14,5,18,44,81
2008,China,CHN,Poland,POL,0,0,0,5,5
2008,Cameroon,CMR,Poland,POL,0,0,19,10,29
2008,Congo,COG,Poland,POL,0,0,5,0,5
2008,Dem. Rep. of the Congo,COD,Poland,POL,0,0,5,10,15
2008,Palestinian,PSE,Poland,POL,0,0,0,5,5
2008,Georgia,GEO,Poland,POL,0,0,10,21,31
2008,Guinea,GIN,Poland,POL,0,0,14,5,19
2008,India,IND,Poland,POL,0,0,12,14,26
2008,Iran (Islamic Rep. of),IRN,Poland,POL,0,0,5,0,5
2008,Iraq,IRQ,Poland,POL,28,5,0,5,38
2008,Kazakhstan,KAZ,Poland,POL,0,0,5,18,23
2008,Kyrgyzstan,KGZ,Poland,POL,0,0,0,11,11
2008,Sri Lanka,LKA,Poland,POL,0,13,5,5,23
2008,Madagascar,MDG,Poland,POL,0,0,5,0,5
2008,Rep. of Moldova,MDA,Poland,POL,0,0,13,5,18
2008,Mongolia,MNG,Poland,POL,0,0,10,5,15
2008,Nepal,NPL,Poland,POL,0,0,10,5,15
2008,Nigeria,NGA,Poland,POL,0,0,12,11,23
2008,Pakistan,PAK,Poland,POL,0,0,21,12,33
2008,Russian Federation,RUS,Poland,POL,129,2543,1120,5309,9101
2008,Serbia and Kosovo: S/RES/1244 (1999),SRB,Poland,POL,0,0,0,5,5
2008,Senegal,SEN,Poland,POL,0,0,0,5,5
2008,Sierra Leone,SLE,Poland,POL,0,0,0,5,5
2008,Somalia,SOM,Poland,POL,5,0,0,0,5
2008,Viet Nam,VNM,Poland,POL,0,0,55,5,60
2008,Sudan,SDN,Poland,POL,0,0,0,5,5
2008,Turkey,TUR,Poland,POL,0,0,5,5,10
2008,Uganda,UGA,Poland,POL,0,0,0,5,5
2008,Ukraine,UKR,Poland,POL,0,0,21,24,45
2008,Uzbekistan,UZB,Poland,POL,0,0,0,5,5
2008,Stateless,XXA,Poland,POL,0,0,10,5,15
2008,Unknown ,,South Africa,ZAF,7049,0,62065,0,69114
2008,Afghanistan,AFG,Russian Federation,RUS,261,298,2719,0,3278
2008,Algeria,DZA,Russian Federation,RUS,0,0,5,0,5
2008,Angola,AGO,Russian Federation,RUS,0,0,12,0,12
2008,Armenia,ARM,Russian Federation,RUS,0,0,17,0,17
2008,Azerbaijan,AZE,Russian Federation,RUS,5,13,44,0,62
2008,Burundi,BDI,Russian Federation,RUS,0,0,5,0,5
2008,Bangladesh,BGD,Russian Federation,RUS,5,0,5,0,10
2008,Belarus,BLR,Russian Federation,RUS,0,0,23,0,23
2008,Cambodia,KHM,Russian Federation,RUS,0,0,10,0,10
2008,China,CHN,Russian Federation,RUS,0,0,5,0,5
2008,Congo,COG,Russian Federation,RUS,0,0,30,0,30
2008,Dem. Rep. of the Congo,COD,Russian Federation,RUS,0,0,43,0,43
2008,Cuba,CUB,Russian Federation,RUS,0,0,14,0,14
2008,Eritrea,ERI,Russian Federation,RUS,0,0,12,0,12
2008,Estonia,EST,Russian Federation,RUS,0,0,5,0,5
2008,Ethiopia,ETH,Russian Federation,RUS,0,0,16,0,16
2008,Palestinian,PSE,Russian Federation,RUS,0,5,0,0,5
2008,Georgia,GEO,Russian Federation,RUS,46,444,2047,0,2537
2008,Ghana,GHA,Russian Federation,RUS,0,0,5,0,5
2008,Guinea,GIN,Russian Federation,RUS,0,0,5,0,5
2008,Iran (Islamic Rep. of),IRN,Russian Federation,RUS,0,0,5,0,5
2008,Iraq,IRQ,Russian Federation,RUS,5,5,60,0,70
2008,Kazakhstan,KAZ,Russian Federation,RUS,0,0,10,0,10
2008,Kyrgyzstan,KGZ,Russian Federation,RUS,0,0,5,0,5
2008,Dem. People's Rep. of Korea,PRK,Russian Federation,RUS,0,5,25,0,30
2008,Liberia,LBR,Russian Federation,RUS,0,0,5,0,5
2008,Lebanon,LBN,Russian Federation,RUS,5,0,5,0,10
2008,Sri Lanka,LKA,Russian Federation,RUS,0,0,5,0,5
2008,Rep. of Moldova,MDA,Russian Federation,RUS,0,0,12,0,12
2008,Nigeria,NGA,Russian Federation,RUS,0,0,5,0,5
2008,Pakistan,PAK,Russian Federation,RUS,0,0,5,0,5
2008,Somalia,SOM,Russian Federation,RUS,0,0,5,0,5
2008,Sudan,SDN,Russian Federation,RUS,0,0,19,0,19
2008,Syrian Arab Rep.,SYR,Russian Federation,RUS,0,0,14,0,14
2008,Tajikistan,TJK,Russian Federation,RUS,0,5,55,0,60
2008,Turkmenistan,TKM,Russian Federation,RUS,0,5,46,0,51
2008,Ukraine,UKR,Russian Federation,RUS,5,0,32,0,37
2008,Uzbekistan,UZB,Russian Federation,RUS,10,11,80,0,101
2008,Unknown ,,Russian Federation,RUS,5,0,137,0,142
2008,Burundi,BDI,Rwanda,RWA,0,0,22,0,22
2008,Dem. Rep. of the Congo,COD,Rwanda,RWA,16,0,16,296,328
2008,Albania,ALB,Serbia and Kosovo: S/RES/1244 (1999),SRB,0,0,0,5,5
2008,Ethiopia,ETH,Serbia and Kosovo: S/RES/1244 (1999),SRB,0,0,5,0,5
2008,Georgia,GEO,Serbia and Kosovo: S/RES/1244 (1999),SRB,0,0,0,12,12
2008,Iraq,IRQ,Serbia and Kosovo: S/RES/1244 (1999),SRB,0,11,0,0,11
2008,North Macedonia,MKD,Serbia and Kosovo: S/RES/1244 (1999),SRB,0,0,5,0,5
2008,Syrian Arab Rep.,SYR,Serbia and Kosovo: S/RES/1244 (1999),SRB,0,0,0,5,5
2008,Chad,TCD,Senegal,SEN,0,0,19,0,19
2008,Dem. Rep. of the Congo,COD,Senegal,SEN,0,0,5,0,5
2008,Gambia,GMB,Senegal,SEN,0,0,5,0,5
2008,Guinea-Bissau,GNB,Senegal,SEN,0,0,5,0,5
2008,Guinea,GIN,Senegal,SEN,0,0,5,0,5
2008,Cote d'Ivoire,CIV,Senegal,SEN,0,0,5,0,5
2008,Liberia,LBR,Senegal,SEN,0,0,13,0,13
2008,Mauritania,MRT,Senegal,SEN,0,0,5,0,5
2008,Rwanda,RWA,Senegal,SEN,0,0,5,0,5
2008,Sierra Leone,SLE,Senegal,SEN,0,0,13,0,13
2008,Sudan,SDN,Senegal,SEN,0,0,5,0,5
2008,Togo,TGO,Senegal,SEN,0,0,5,0,5
2008,Afghanistan,AFG,Spain,ESP,5,5,11,5,26
2008,Algeria,DZA,Spain,ESP,0,0,117,103,220
2008,Angola,AGO,Spain,ESP,0,5,0,5,10
2008,Armenia,ARM,Spain,ESP,0,0,25,27,52
2008,Azerbaijan,AZE,Spain,ESP,0,0,5,0,5
2008,Burundi,BDI,Spain,ESP,0,5,0,0,5
2008,Benin,BEN,Spain,ESP,0,0,0,10,10
2008,Bangladesh,BGD,Spain,ESP,0,0,10,30,40
2008,Burkina Faso,BFA,Spain,ESP,0,0,0,10,10
2008,Belarus,BLR,Spain,ESP,0,0,11,10,21
2008,Bolivia (Plurinational State of),BOL,Spain,ESP,0,0,0,5,5
2008,Brazil,BRA,Spain,ESP,0,0,5,5,10
2008,Bosnia and Herzegovina,BIH,Spain,ESP,0,0,10,0,10
2008,Chad,TCD,Spain,ESP,0,0,5,10,15
2008,China,CHN,Spain,ESP,0,0,0,5,5
2008,Cameroon,CMR,Spain,ESP,0,0,13,47,60
2008,Congo,COG,Spain,ESP,0,0,0,17,17
2008,Dem. Rep. of the Congo,COD,Spain,ESP,12,0,23,52,87
2008,Colombia,COL,Spain,ESP,15,5,1083,429,1532
2008,Cuba,CUB,Spain,ESP,10,5,48,70,133
2008,Dominican Rep.,DOM,Spain,ESP,0,0,0,5,5
2008,Ecuador,ECU,Spain,ESP,0,0,5,5,10
2008,Equatorial Guinea,GNQ,Spain,ESP,5,10,10,12,37
2008,Eritrea,ERI,Spain,ESP,0,0,14,14,28
2008,Ethiopia,ETH,Spain,ESP,5,0,5,10,20
2008,Gambia,GMB,Spain,ESP,0,0,11,29,40
2008,Palestinian,PSE,Spain,ESP,20,0,0,12,32
2008,Georgia,GEO,Spain,ESP,0,0,10,12,22
2008,Ghana,GHA,Spain,ESP,0,0,0,28,28
2008,Guinea-Bissau,GNB,Spain,ESP,0,0,0,5,5
2008,Guatemala,GTM,Spain,ESP,0,0,5,5,10
2008,Guinea,GIN,Spain,ESP,0,0,5,81,86
2008,Haiti,HTI,Spain,ESP,5,0,5,0,10
2008,Honduras,HND,Spain,ESP,0,0,0,5,5
2008,Cote d'Ivoire,CIV,Spain,ESP,0,10,184,257,451
2008,India,IND,Spain,ESP,0,0,0,41,41
2008,Iran (Islamic Rep. of),IRN,Spain,ESP,5,0,16,22,43
2008,Iraq,IRQ,Spain,ESP,10,53,47,20,130
2008,Jordan,JOR,Spain,ESP,0,0,0,5,5
2008,Kenya,KEN,Spain,ESP,0,0,0,25,25
2008,Liberia,LBR,Spain,ESP,0,0,0,18,18
2008,Lebanon,LBN,Spain,ESP,0,0,10,5,15
2008,Sri Lanka,LKA,Spain,ESP,0,0,5,0,5
2008,Mauritania,MRT,Spain,ESP,0,0,10,24,34
2008,Mexico,MEX,Spain,ESP,0,0,0,5,5
2008,Mali,MLI,Spain,ESP,0,0,5,10,15
2008,Morocco,MAR,Spain,ESP,5,0,141,82,228
2008,Nepal,NPL,Spain,ESP,0,0,5,5,10
2008,Niger,NER,Spain,ESP,0,0,0,11,11
2008,Nigeria,NGA,Spain,ESP,0,5,98,692,795
2008,Pakistan,PAK,Spain,ESP,5,0,5,19,29
2008,Peru,PER,Spain,ESP,0,0,0,5,5
2008,Russian Federation,RUS,Spain,ESP,14,5,41,30,90
2008,Rwanda,RWA,Spain,ESP,0,0,0,5,5
2008,El Salvador,SLV,Spain,ESP,0,0,5,5,10
2008,Serbia and Kosovo: S/RES/1244 (1999),SRB,Spain,ESP,0,0,0,5,5
2008,Senegal,SEN,Spain,ESP,0,0,5,18,23
2008,Sierra Leone,SLE,Spain,ESP,0,0,5,28,33
2008,Somalia,SOM,Spain,ESP,0,10,14,19,43
2008,Sudan,SDN,Spain,ESP,5,0,129,56,190
2008,Syrian Arab Rep.,SYR,Spain,ESP,13,0,69,46,128
2008,Togo,TGO,Spain,ESP,0,0,5,5,10
2008,Tunisia,TUN,Spain,ESP,0,0,0,5,5
2008,Turkey,TUR,Spain,ESP,0,0,10,18,28
2008,Uganda,UGA,Spain,ESP,0,0,5,12,17
2008,Ukraine,UKR,Spain,ESP,0,0,5,5,10
2008,United States of America,USA,Spain,ESP,0,0,0,5,5
2008,Uzbekistan,UZB,Spain,ESP,0,0,0,5,5
2008,Venezuela (Bolivarian Republic of),VEN,Spain,ESP,0,0,10,17,27
2008,Zimbabwe,ZWE,Spain,ESP,0,0,0,10,10
2008,Stateless,XXA,Spain,ESP,15,10,5,5,35
2008,Central African Rep.,CAF,Sudan,SDN,0,0,0,18,18
2008,Eritrea,ERI,Sudan,SDN,3571,6110,54,24493,34228
2008,Ethiopia,ETH,Sudan,SDN,986,298,10,82,1376
2008,Somalia,SOM,Sudan,SDN,25,312,0,94,431
2008,Unknown ,,Sudan,SDN,1060,0,0,5,1065
2008,Afghanistan,AFG,Slovakia,SVK,0,28,25,10,63
2008,Algeria,DZA,Slovakia,SVK,0,0,5,0,5
2008,Armenia,ARM,Slovakia,SVK,0,0,12,14,26
2008,Bangladesh,BGD,Slovakia,SVK,0,0,22,11,33
2008,China,CHN,Slovakia,SVK,0,0,37,10,47
2008,Cuba,CUB,Slovakia,SVK,10,0,0,0,10
2008,Palestinian,PSE,Slovakia,SVK,0,0,0,5,5
2008,Georgia,GEO,Slovakia,SVK,0,0,43,76,119
2008,India,IND,Slovakia,SVK,0,0,46,42,88
2008,Iraq,IRQ,Slovakia,SVK,10,25,0,25,60
2008,Sri Lanka,LKA,Slovakia,SVK,0,0,0,5,5
2008,Rep. of Moldova,MDA,Slovakia,SVK,0,0,45,70,115
2008,Nigeria,NGA,Slovakia,SVK,0,0,5,0,5
2008,Pakistan,PAK,Slovakia,SVK,0,0,66,43,109
2008,Russian Federation,RUS,Slovakia,SVK,0,0,34,84,118
2008,Serbia and Kosovo: S/RES/1244 (1999),SRB,Slovakia,SVK,0,0,5,10,15
2008,Viet Nam,VNM,Slovakia,SVK,0,0,20,22,42
2008,Syrian Arab Rep.,SYR,Slovakia,SVK,0,0,5,5,10
2008,Tajikistan,TJK,Slovakia,SVK,0,0,5,0,5
2008,Turkey,TUR,Slovakia,SVK,0,0,5,0,5
2008,Ukraine,UKR,Slovakia,SVK,0,5,21,12,38
2008,Albania,ALB,Slovenia,SVN,0,0,0,5,5
2008,Bosnia and Herzegovina,BIH,Slovenia,SVN,0,0,15,10,25
2008,Cuba,CUB,Slovenia,SVN,0,0,0,5,5
2008,Croatia,HRV,Slovenia,SVN,0,0,5,0,5
2008,India,IND,Slovenia,SVN,0,0,5,0,5
2008,Iran (Islamic Rep. of),IRN,Slovenia,SVN,0,0,10,5,15
2008,Kazakhstan,KAZ,Slovenia,SVN,0,0,11,0,11
2008,North Macedonia,MKD,Slovenia,SVN,0,0,5,5,10
2008,Nigeria,NGA,Slovenia,SVN,0,0,5,0,5
2008,Pakistan,PAK,Slovenia,SVN,0,0,0,5,5
2008,Russian Federation,RUS,Slovenia,SVN,0,0,5,5,10
2008,Serbia and Kosovo: S/RES/1244 (1999),SRB,Slovenia,SVN,0,0,63,57,120
2008,Turkey,TUR,Slovenia,SVN,0,0,19,54,73
2008,Afghanistan,AFG,Sweden,SWE,50,332,326,24,732
2008,Albania,ALB,Sweden,SWE,0,0,93,19,112
2008,Algeria,DZA,Sweden,SWE,0,10,80,31,121
2008,Angola,AGO,Sweden,SWE,0,10,14,0,24
2008,Egypt,EGY,Sweden,SWE,0,0,81,10,91
2008,Argentina,ARG,Sweden,SWE,0,0,5,0,5
2008,Armenia,ARM,Sweden,SWE,0,56,175,35,266
2008,Azerbaijan,AZE,Sweden,SWE,14,52,256,56,378
2008,Bahrain,BHR,Sweden,SWE,0,0,0,5,5
2008,Burundi,BDI,Sweden,SWE,5,22,159,10,196
2008,Benin,BEN,Sweden,SWE,0,0,5,0,5
2008,Bangladesh,BGD,Sweden,SWE,5,10,80,5,100
2008,Bhutan,BTN,Sweden,SWE,5,0,0,0,5
2008,Belarus,BLR,Sweden,SWE,0,10,225,128,363
2008,Bolivia (Plurinational State of),BOL,Sweden,SWE,0,5,106,13,124
2008,Bosnia and Herzegovina,BIH,Sweden,SWE,0,24,120,24,168
2008,Bulgaria,BGR,Sweden,SWE,0,0,17,0,17
2008,China,CHN,Sweden,SWE,5,5,42,13,65
2008,Chile,CHL,Sweden,SWE,0,5,46,5,56
2008,Cameroon,CMR,Sweden,SWE,0,0,33,5,38
2008,Congo,COG,Sweden,SWE,0,0,13,0,13
2008,Dem. Rep. of the Congo,COD,Sweden,SWE,5,5,57,5,72
2008,Colombia,COL,Sweden,SWE,0,0,5,0,5
2008,Cuba,CUB,Sweden,SWE,0,5,18,0,23
2008,Czechia,CZE,Sweden,SWE,0,0,5,0,5
2008,Ecuador,ECU,Sweden,SWE,0,0,14,0,14
2008,Eritrea,ERI,Sweden,SWE,157,455,202,36,850
2008,Estonia,EST,Sweden,SWE,0,0,5,0,5
2008,Ethiopia,ETH,Sweden,SWE,12,23,149,5,189
2008,Gambia,GMB,Sweden,SWE,0,5,13,0,18
2008,Georgia,GEO,Sweden,SWE,0,10,84,17,111
2008,Ghana,GHA,Sweden,SWE,0,0,17,5,22
2008,Guatemala,GTM,Sweden,SWE,0,0,5,0,5
2008,Guinea,GIN,Sweden,SWE,5,5,28,0,38
2008,Honduras,HND,Sweden,SWE,0,0,5,0,5
2008,Croatia,HRV,Sweden,SWE,0,0,18,0,18
2008,Hungary,HUN,Sweden,SWE,0,0,5,0,5
2008,Cote d'Ivoire,CIV,Sweden,SWE,0,0,33,0,33
2008,India,IND,Sweden,SWE,0,5,43,26,74
2008,Indonesia,IDN,Sweden,SWE,0,0,27,5,32
2008,Iran (Islamic Rep. of),IRN,Sweden,SWE,100,46,461,65,672
2008,Iraq,IRQ,Sweden,SWE,680,3196,7461,1122,12459
2008,Israel,ISR,Sweden,SWE,0,5,29,0,34
2008,Jordan,JOR,Sweden,SWE,5,54,78,23,160
2008,Kazakhstan,KAZ,Sweden,SWE,0,14,131,25,170
2008,Kenya,KEN,Sweden,SWE,0,5,41,5,51
2008,Kyrgyzstan,KGZ,Sweden,SWE,0,5,43,5,53
2008,Dem. People's Rep. of Korea,PRK,Sweden,SWE,0,0,0,5,5
2008,Liberia,LBR,Sweden,SWE,0,0,10,0,10
2008,Libya,LBY,Sweden,SWE,5,5,339,137,486
2008,Lebanon,LBN,Sweden,SWE,0,13,407,76,496
2008,Sri Lanka,LKA,Sweden,SWE,0,10,20,5,35
2008,Latvia,LVA,Sweden,SWE,0,5,5,0,10
2008,North Macedonia,MKD,Sweden,SWE,0,0,28,18,46
2008,Rep. of Moldova,MDA,Sweden,SWE,0,0,14,5,19
2008,Mongolia,MNG,Sweden,SWE,0,12,702,42,756
2008,Morocco,MAR,Sweden,SWE,0,0,43,13,56
2008,Montenegro,MNE,Sweden,SWE,0,5,53,10,68
2008,Myanmar,MMR,Sweden,SWE,0,0,5,0,5
2008,Nepal,NPL,Sweden,SWE,0,0,43,5,48
2008,Nicaragua,NIC,Sweden,SWE,0,0,47,0,47
2008,Nigeria,NGA,Sweden,SWE,0,15,95,29,139
2008,Pakistan,PAK,Sweden,SWE,0,15,38,13,66
2008,Panama,PAN,Sweden,SWE,0,0,5,0,5
2008,Paraguay,PRY,Sweden,SWE,0,0,10,0,10
2008,Peru,PER,Sweden,SWE,0,0,18,0,18
2008,Romania,ROU,Sweden,SWE,0,5,20,5,30
2008,Russian Federation,RUS,Sweden,SWE,16,104,504,142,766
2008,Rwanda,RWA,Sweden,SWE,0,5,13,0,18
2008,El Salvador,SLV,Sweden,SWE,0,0,62,5,67
2008,Serbia and Kosovo: S/RES/1244 (1999),SRB,Sweden,SWE,54,212,1646,304,2216
2008,Senegal,SEN,Sweden,SWE,0,0,15,0,15
2008,Sierra Leone,SLE,Sweden,SWE,0,5,14,5,24
2008,Somalia,SOM,Sweden,SWE,355,1178,663,171,2367
2008,Viet Nam,VNM,Sweden,SWE,0,11,53,10,74
2008,Sudan,SDN,Sweden,SWE,28,11,31,0,70
2008,Slovakia,SVK,Sweden,SWE,0,0,0,5,5
2008,Syrian Arab Rep.,SYR,Sweden,SWE,36,27,411,45,519
2008,United Rep. of Tanzania,TZA,Sweden,SWE,0,0,10,0,10
2008,Thailand,THA,Sweden,SWE,0,0,10,0,10
2008,Tajikistan,TJK,Sweden,SWE,0,0,5,5,10
2008,Turkmenistan,TKM,Sweden,SWE,0,0,5,5,10
2008,Togo,TGO,Sweden,SWE,0,5,13,0,18
2008,Tunisia,TUN,Sweden,SWE,0,0,59,18,77
2008,Turkey,TUR,Sweden,SWE,5,23,218,50,296
2008,Uganda,UGA,Sweden,SWE,0,0,31,5,36
2008,Ukraine,UKR,Sweden,SWE,0,5,36,14,55
2008,United States of America,USA,Sweden,SWE,0,0,5,0,5
2008,Uzbekistan,UZB,Sweden,SWE,5,26,535,70,636
2008,Venezuela (Bolivarian Republic of),VEN,Sweden,SWE,0,0,10,0,10
2008,Yemen,YEM,Sweden,SWE,11,0,63,13,87
2008,Zimbabwe,ZWE,Sweden,SWE,0,0,13,0,13
2008,Stateless,XXA,Sweden,SWE,137,308,562,136,1143
2008,Unknown ,,Sweden,SWE,10,34,336,41,421
2008,Afghanistan,AFG,Switzerland,CHE,21,182,228,80,511
2008,Albania,ALB,Switzerland,CHE,5,0,10,22,37
2008,Algeria,DZA,Switzerland,CHE,5,10,20,158,193
2008,Angola,AGO,Switzerland,CHE,0,146,102,19,267
2008,Egypt,EGY,Switzerland,CHE,5,0,5,10,20
2008,Armenia,ARM,Switzerland,CHE,0,13,46,24,83
2008,Azerbaijan,AZE,Switzerland,CHE,0,10,14,14,38
2008,Burundi,BDI,Switzerland,CHE,0,5,5,0,10
2008,Benin,BEN,Switzerland,CHE,5,5,0,19,29
2008,Bangladesh,BGD,Switzerland,CHE,0,10,21,18,49
2008,Bhutan,BTN,Switzerland,CHE,0,0,0,5,5
2008,Burkina Faso,BFA,Switzerland,CHE,0,0,5,10,15
2008,Belarus,BLR,Switzerland,CHE,0,0,10,27,37
2008,Bolivia (Plurinational State of),BOL,Switzerland,CHE,0,0,5,0,5
2008,Bosnia and Herzegovina,BIH,Switzerland,CHE,14,162,78,54,308
2008,Bulgaria,BGR,Switzerland,CHE,0,5,0,10,15
2008,Cambodia,KHM,Switzerland,CHE,5,0,0,0,5
2008,Central African Rep.,CAF,Switzerland,CHE,0,5,0,0,5
2008,Chad,TCD,Switzerland,CHE,0,0,0,5,5
2008,China,CHN,Switzerland,CHE,27,260,200,20,507
2008,Cameroon,CMR,Switzerland,CHE,16,28,67,24,135
2008,Congo,COG,Switzerland,CHE,5,5,10,5,25
2008,Dem. Rep. of the Congo,COD,Switzerland,CHE,5,199,178,56,438
2008,Colombia,COL,Switzerland,CHE,37,5,5,5,52
2008,Cuba,CUB,Switzerland,CHE,0,5,0,5,10
2008,Czechia,CZE,Switzerland,CHE,0,0,0,5,5
2008,Eritrea,ERI,Switzerland,CHE,950,492,435,141,2018
2008,Ethiopia,ETH,Switzerland,CHE,28,147,221,63,459
2008,Gabon,GAB,Switzerland,CHE,0,0,0,5,5
2008,Gambia,GMB,Switzerland,CHE,0,0,38,100,138
2008,Georgia,GEO,Switzerland,CHE,0,5,39,314,358
2008,Ghana,GHA,Switzerland,CHE,0,0,5,10,15
2008,Guinea-Bissau,GNB,Switzerland,CHE,0,0,5,31,36
2008,Guinea,GIN,Switzerland,CHE,5,5,38,130,178
2008,Croatia,HRV,Switzerland,CHE,0,0,0,5,5
2008,Cote d'Ivoire,CIV,Switzerland,CHE,0,14,49,76,139
2008,India,IND,Switzerland,CHE,0,5,0,15,20
2008,Iran (Islamic Rep. of),IRN,Switzerland,CHE,51,110,159,97,417
2008,Iraq,IRQ,Switzerland,CHE,164,574,360,376,1474
2008,Israel,ISR,Switzerland,CHE,0,0,0,5,5
2008,Italy,ITA,Switzerland,CHE,0,0,0,5,5
2008,Jamaica,JAM,Switzerland,CHE,0,0,0,5,5
2008,Jordan,JOR,Switzerland,CHE,0,5,5,5,15
2008,Kazakhstan,KAZ,Switzerland,CHE,0,0,0,5,5
2008,Kenya,KEN,Switzerland,CHE,0,0,10,10,20
2008,Kyrgyzstan,KGZ,Switzerland,CHE,5,5,0,0,10
2008,Liberia,LBR,Switzerland,CHE,5,12,5,19,41
2008,Libya,LBY,Switzerland,CHE,10,5,16,13,44
2008,Lebanon,LBN,Switzerland,CHE,0,11,5,37,53
2008,Sri Lanka,LKA,Switzerland,CHE,170,354,243,107,874
2008,Mauritania,MRT,Switzerland,CHE,0,0,5,11,16
2008,North Macedonia,MKD,Switzerland,CHE,0,28,28,57,113
2008,Rep. of Moldova,MDA,Switzerland,CHE,0,0,5,16,21
2008,Mexico,MEX,Switzerland,CHE,0,0,5,0,5
2008,Mali,MLI,Switzerland,CHE,0,0,0,23,23
2008,Mongolia,MNG,Switzerland,CHE,0,10,43,88,141
2008,Morocco,MAR,Switzerland,CHE,5,5,10,30,50
2008,Montenegro,MNE,Switzerland,CHE,0,5,0,26,31
2008,Myanmar,MMR,Switzerland,CHE,0,5,5,0,10
2008,Nepal,NPL,Switzerland,CHE,5,5,5,5,20
2008,Niger,NER,Switzerland,CHE,0,0,5,5,10
2008,Nigeria,NGA,Switzerland,CHE,0,13,58,606,677
2008,Pakistan,PAK,Switzerland,CHE,10,19,26,31,86
2008,Romania,ROU,Switzerland,CHE,5,0,5,24,34
2008,South Africa,ZAF,Switzerland,CHE,0,0,14,5,19
2008,Russian Federation,RUS,Switzerland,CHE,27,93,68,142,330
2008,Rwanda,RWA,Switzerland,CHE,5,14,5,0,24
2008,Serbia and Kosovo: S/RES/1244 (1999),SRB,Switzerland,CHE,37,395,589,371,1392
2008,Senegal,SEN,Switzerland,CHE,0,0,0,28,28
2008,Sierra Leone,SLE,Switzerland,CHE,0,5,0,17,22
2008,Somalia,SOM,Switzerland,CHE,18,305,284,109,716
2008,Spain,ESP,Switzerland,CHE,0,0,5,5,10
2008,Viet Nam,VNM,Switzerland,CHE,11,5,0,0,16
2008,Sudan,SDN,Switzerland,CHE,5,18,31,30,84
2008,Slovakia,SVK,Switzerland,CHE,0,0,0,5,5
2008,Syrian Arab Rep.,SYR,Switzerland,CHE,57,180,171,51,459
2008,Togo,TGO,Switzerland,CHE,53,5,48,11,117
2008,Tunisia,TUN,Switzerland,CHE,23,10,14,42,89
2008,Turkey,TUR,Switzerland,CHE,302,192,189,119,802
2008,Uganda,UGA,Switzerland,CHE,0,0,5,5,10
2008,Ukraine,UKR,Switzerland,CHE,0,5,17,13,35
2008,Uzbekistan,UZB,Switzerland,CHE,5,0,0,5,10
2008,Western Sahara,ESH,Switzerland,CHE,0,0,5,0,5
2008,Yemen,YEM,Switzerland,CHE,30,38,25,10,103
2008,Zimbabwe,ZWE,Switzerland,CHE,0,5,0,28,33
2008,Stateless,XXA,Switzerland,CHE,11,17,18,35,81
2008,Unknown ,,Switzerland,CHE,106,133,138,178,555
2008,Central African Rep.,CAF,Togo,TGO,0,0,5,0,5
2008,Chad,TCD,Togo,TGO,5,0,5,0,10
2008,Congo,COG,Togo,TGO,0,0,10,0,10
2008,Dem. Rep. of the Congo,COD,Togo,TGO,0,0,33,0,33
2008,Cote d'Ivoire,CIV,Togo,TGO,5,0,12,0,17
2008,Sri Lanka,LKA,Togo,TGO,10,0,0,0,10
2008,Rwanda,RWA,Togo,TGO,5,0,0,0,5
2008,Burundi,BDI,Uganda,UGA,804,0,262,0,1066
2008,Dem. Rep. of the Congo,COD,Uganda,UGA,3650,0,159,0,3809
2008,Eritrea,ERI,Uganda,UGA,1079,0,19,0,1098
2008,Ethiopia,ETH,Uganda,UGA,349,0,164,0,513
2008,Kenya,KEN,Uganda,UGA,14,0,5,0,19
2008,Pakistan,PAK,Uganda,UGA,5,0,0,0,5
2008,Rwanda,RWA,Uganda,UGA,194,0,373,1402,1969
2008,Somalia,SOM,Uganda,UGA,1330,0,70,0,1400
2008,Sudan,SDN,Uganda,UGA,176,0,22,0,198
2008,Afghanistan,AFG,Ukraine,UKR,57,0,153,211,421
2008,Algeria,DZA,Ukraine,UKR,0,0,0,10,10
2008,Armenia,ARM,Ukraine,UKR,5,0,13,5,23
2008,Azerbaijan,AZE,Ukraine,UKR,10,0,5,10,25
2008,Bangladesh,BGD,Ukraine,UKR,5,0,19,105,129
2008,Belarus,BLR,Ukraine,UKR,5,0,5,5,15
2008,Cameroon,CMR,Ukraine,UKR,0,0,5,5,10
2008,Congo,COG,Ukraine,UKR,0,0,10,5,15
2008,Dem. Rep. of the Congo,COD,Ukraine,UKR,0,0,10,12,22
2008,Palestinian,PSE,Ukraine,UKR,0,0,13,43,56
2008,Georgia,GEO,Ukraine,UKR,0,0,16,26,42
2008,Guinea,GIN,Ukraine,UKR,0,0,5,5,10
2008,Cote d'Ivoire,CIV,Ukraine,UKR,0,0,5,0,5
2008,India,IND,Ukraine,UKR,0,0,0,174,174
2008,Iran (Islamic Rep. of),IRN,Ukraine,UKR,0,0,21,10,31
2008,Iraq,IRQ,Ukraine,UKR,10,0,71,59,140
2008,Jordan,JOR,Ukraine,UKR,0,0,0,5,5
2008,Kenya,KEN,Ukraine,UKR,0,0,0,5,5
2008,Lebanon,LBN,Ukraine,UKR,0,0,5,5,10
2008,Sri Lanka,LKA,Ukraine,UKR,0,0,13,37,50
2008,Rep. of Moldova,MDA,Ukraine,UKR,0,0,0,5,5
2008,Nigeria,NGA,Ukraine,UKR,0,0,15,5,20
2008,Pakistan,PAK,Ukraine,UKR,0,0,10,578,588
2008,Russian Federation,RUS,Ukraine,UKR,13,0,31,30,74
2008,Somalia,SOM,Ukraine,UKR,0,0,68,100,168
2008,Viet Nam,VNM,Ukraine,UKR,0,0,0,63,63
2008,Sudan,SDN,Ukraine,UKR,0,0,10,5,15
2008,Syrian Arab Rep.,SYR,Ukraine,UKR,5,0,18,5,28
2008,Tunisia,TUN,Ukraine,UKR,0,0,0,5,5
2008,Turkey,TUR,Ukraine,UKR,0,0,5,5,10
2008,Uzbekistan,UZB,Ukraine,UKR,5,0,25,26,56
2008,Zimbabwe,ZWE,Ukraine,UKR,0,0,0,5,5
2008,Stateless,XXA,Ukraine,UKR,0,0,5,5,10
2008,Colombia,COL,Uruguay,URY,0,0,5,0,5
2008,Nigeria,NGA,Uruguay,URY,0,0,5,0,5
2008,Colombia,COL,Venezuela (Bolivarian Republic of),VEN,287,0,324,0,611
2008,Burundi,BDI,Zimbabwe,ZWE,18,0,0,65,83
2008,Dem. Rep. of the Congo,COD,Zimbabwe,ZWE,193,0,0,584,777
2008,Eritrea,ERI,Zimbabwe,ZWE,0,0,0,5,5
2008,Rwanda,RWA,Zimbabwe,ZWE,5,0,0,36,41
2008,Somalia,SOM,Zimbabwe,ZWE,0,0,0,5,5
2008,Uganda,UGA,Zimbabwe,ZWE,5,0,0,0,5
2009,Chad,TCD,Angola,AGO,11,0,31,0,42
2009,Congo,COG,Angola,AGO,0,0,0,59,59
2009,Eritrea,ERI,Angola,AGO,0,0,10,95,105
2009,Guinea,GIN,Angola,AGO,10,0,21,0,31
2009,Cote d'Ivoire,CIV,Angola,AGO,37,0,72,286,395
2009,Liberia,LBR,Angola,AGO,5,0,10,0,15
2009,Mauritania,MRT,Angola,AGO,40,0,58,0,98
2009,Rwanda,RWA,Angola,AGO,137,0,0,0,137
2009,Sierra Leone,SLE,Angola,AGO,5,0,5,0,10
2009,Somalia,SOM,Angola,AGO,5,0,11,0,16
2009,Sudan,SDN,Angola,AGO,36,0,38,0,74
2009,United Rep. of Tanzania,TZA,Angola,AGO,0,0,0,14,14
2009,Western Sahara,ESH,Angola,AGO,5,0,10,0,15
2009,Burundi,BDI,Argentina,ARG,5,0,0,0,5
2009,Bangladesh,BGD,Argentina,ARG,0,0,14,0,14
2009,Cameroon,CMR,Argentina,ARG,0,0,0,10,10
2009,Congo,COG,Argentina,ARG,0,0,0,5,5
2009,Colombia,COL,Argentina,ARG,29,0,20,50,99
2009,Cuba,CUB,Argentina,ARG,15,0,10,14,39
2009,Dominican Rep.,DOM,Argentina,ARG,0,0,258,10,268
2009,Eritrea,ERI,Argentina,ARG,0,0,0,5,5
2009,Ghana,GHA,Argentina,ARG,5,0,0,0,5
2009,Guinea,GIN,Argentina,ARG,5,0,0,0,5
2009,Haiti,HTI,Argentina,ARG,5,0,10,5,20
2009,Cote d'Ivoire,CIV,Argentina,ARG,11,0,0,0,11
2009,India,IND,Argentina,ARG,5,0,5,5,15
2009,Iraq,IRQ,Argentina,ARG,5,0,0,0,5
2009,Sri Lanka,LKA,Argentina,ARG,5,0,0,0,5
2009,Nigeria,NGA,Argentina,ARG,10,0,5,10,25
2009,Pakistan,PAK,Argentina,ARG,5,0,0,0,5
2009,Peru,PER,Argentina,ARG,5,0,5,17,27
2009,Senegal,SEN,Argentina,ARG,0,0,134,72,206
2009,Georgia,GEO,Armenia,ARM,0,5,107,10,122
2009,Iran (Islamic Rep. of),IRN,Armenia,ARM,13,0,0,5,18
2009,Iraq,IRQ,Armenia,ARM,0,33,0,23,56
2009,Afghanistan,AFG,Australia,AUS,911,0,0,5,916
2009,Albania,ALB,Australia,AUS,5,0,10,10,25
2009,Algeria,DZA,Australia,AUS,0,0,5,5,10
2009,Egypt,EGY,Australia,AUS,56,0,60,61,177
2009,Burundi,BDI,Australia,AUS,5,0,0,0,5
2009,Bangladesh,BGD,Australia,AUS,23,0,50,49,122
2009,Brazil,BRA,Australia,AUS,0,0,5,5,10
2009,Bulgaria,BGR,Australia,AUS,0,0,5,5,10
2009,Cambodia,KHM,Australia,AUS,5,0,5,0,10
2009,China,CHN,Australia,AUS,211,0,913,925,2049
2009,Cameroon,CMR,Australia,AUS,10,0,5,5,20
2009,Congo,COG,Australia,AUS,5,0,0,0,5
2009,Dem. Rep. of the Congo,COD,Australia,AUS,5,0,0,0,5
2009,Colombia,COL,Australia,AUS,10,0,21,22,53
2009,Eritrea,ERI,Australia,AUS,5,0,0,0,5
2009,Ethiopia,ETH,Australia,AUS,18,0,14,14,46
2009,Fiji,FJI,Australia,AUS,11,0,134,136,281
2009,Gambia,GMB,Australia,AUS,0,0,5,5,10
2009,Palestinian,PSE,Australia,AUS,10,0,5,5,20
2009,United Kingdom of Great Britain and Northern Ireland,GBR,Australia,AUS,0,0,10,10,20
2009,Germany,DEU,Australia,AUS,0,0,10,13,23
2009,Ghana,GHA,Australia,AUS,0,0,11,11,22
2009,Guinea,GIN,Australia,AUS,0,0,5,5,10
2009,"China, Hong Kong SAR",HKG,Australia,AUS,0,0,5,5,10
2009,India,IND,Australia,AUS,5,0,249,253,507
2009,Indonesia,IDN,Australia,AUS,32,0,173,178,383
2009,Iran (Islamic Rep. of),IRN,Australia,AUS,207,0,21,21,249
2009,Iraq,IRQ,Australia,AUS,258,0,16,23,297
2009,Israel,ISR,Australia,AUS,0,0,11,12,23
2009,Italy,ITA,Australia,AUS,0,0,5,5,10
2009,Jordan,JOR,Australia,AUS,12,0,19,19,50
2009,Kenya,KEN,Australia,AUS,0,0,17,17,34
2009,Rep. of Korea,KOR,Australia,AUS,5,0,109,110,224
2009,Dem. People's Rep. of Korea,PRK,Australia,AUS,0,0,21,21,42
2009,Kuwait,KWT,Australia,AUS,5,0,0,0,5
2009,Liberia,LBR,Australia,AUS,5,0,0,0,5
2009,Libya,LBY,Australia,AUS,5,0,0,0,5
2009,Lebanon,LBN,Australia,AUS,14,0,90,95,199
2009,Sri Lanka,LKA,Australia,AUS,408,0,99,103,610
2009,North Macedonia,MKD,Australia,AUS,0,0,10,10,20
2009,Malaysia,MYS,Australia,AUS,0,0,216,218,434
2009,Mongolia,MNG,Australia,AUS,5,0,13,13,31
2009,Morocco,MAR,Australia,AUS,0,0,5,5,10
2009,Mauritius,MUS,Australia,AUS,0,0,5,0,5
2009,Myanmar,MMR,Australia,AUS,72,0,21,22,115
2009,Namibia,NAM,Australia,AUS,0,0,5,0,5
2009,Nepal,NPL,Australia,AUS,15,0,11,11,37
2009,Nigeria,NGA,Australia,AUS,17,0,27,27,71
2009,New Zealand,NZL,Australia,AUS,0,0,10,0,10
2009,Pakistan,PAK,Australia,AUS,151,0,67,70,288
2009,Peru,PER,Australia,AUS,0,0,5,5,10
2009,Philippines,PHL,Australia,AUS,0,0,34,34,68
2009,Papua New Guinea,PNG,Australia,AUS,24,0,5,5,34
2009,Romania,ROU,Australia,AUS,5,0,0,10,15
2009,South Africa,ZAF,Australia,AUS,5,0,17,18,40
2009,Russian Federation,RUS,Australia,AUS,5,0,5,5,15
2009,Rwanda,RWA,Australia,AUS,0,0,5,10,15
2009,El Salvador,SLV,Australia,AUS,0,0,5,5,10
2009,Serbia and Kosovo: S/RES/1244 (1999),SRB,Australia,AUS,0,0,5,5,10
2009,Sierra Leone,SLE,Australia,AUS,5,0,10,10,25
2009,Somalia,SOM,Australia,AUS,10,0,5,10,25
2009,Viet Nam,VNM,Australia,AUS,5,0,32,33,70
2009,Sudan,SDN,Australia,AUS,5,0,5,5,15
2009,Syrian Arab Rep.,SYR,Australia,AUS,5,0,10,11,26
2009,United Rep. of Tanzania,TZA,Australia,AUS,0,0,5,5,10
2009,Thailand,THA,Australia,AUS,5,0,5,5,15
2009,Tonga,TON,Australia,AUS,0,0,20,21,41
2009,Turkey,TUR,Australia,AUS,21,0,27,27,75
2009,Uganda,UGA,Australia,AUS,5,0,0,5,10
2009,United States of America,USA,Australia,AUS,0,0,10,10,20
2009,Uzbekistan,UZB,Australia,AUS,0,0,5,5,10
2009,Venezuela (Bolivarian Republic of),VEN,Australia,AUS,5,0,0,0,5
2009,Zambia,ZMB,Australia,AUS,0,0,0,5,5
2009,Zimbabwe,ZWE,Australia,AUS,244,0,80,86,410
2009,Stateless,XXA,Australia,AUS,51,0,5,5,61
2009,Tibetan,TIB,Australia,AUS,5,0,0,0,5
2009,Afghanistan,AFG,Azerbaijan,AZE,0,0,107,0,107
2009,Iran (Islamic Rep. of),IRN,Azerbaijan,AZE,5,0,18,0,23
2009,Iraq,IRQ,Azerbaijan,AZE,0,0,5,0,5
2009,Pakistan,PAK,Azerbaijan,AZE,0,0,76,0,76
2009,Dem. Rep. of the Congo,COD,Burundi,BDI,2630,0,237,5,2872
2009,Rwanda,RWA,Burundi,BDI,0,5,0,0,5
2009,Afghanistan,AFG,Belgium,BEL,172,114,315,10,611
2009,Albania,ALB,Belgium,BEL,38,0,141,14,193
2009,Algeria,DZA,Belgium,BEL,10,0,131,27,168
2009,Angola,AGO,Belgium,BEL,10,0,107,0,117
2009,Egypt,EGY,Belgium,BEL,0,0,27,0,27
2009,Armenia,ARM,Belgium,BEL,12,5,726,43,786
2009,Azerbaijan,AZE,Belgium,BEL,0,0,21,5,26
2009,Burundi,BDI,Belgium,BEL,42,0,38,0,80
2009,Benin,BEN,Belgium,BEL,0,0,12,0,12
2009,Bangladesh,BGD,Belgium,BEL,0,0,44,5,49
2009,Bhutan,BTN,Belgium,BEL,0,0,10,0,10
2009,Burkina Faso,BFA,Belgium,BEL,10,0,19,0,29
2009,Belarus,BLR,Belgium,BEL,10,0,25,5,40
2009,Bosnia and Herzegovina,BIH,Belgium,BEL,5,5,49,5,64
2009,Bulgaria,BGR,Belgium,BEL,0,0,84,5,89
2009,Central African Rep.,CAF,Belgium,BEL,5,0,0,0,5
2009,Chad,TCD,Belgium,BEL,10,0,5,0,15
2009,China,CHN,Belgium,BEL,128,0,35,5,168
2009,Cameroon,CMR,Belgium,BEL,84,0,239,15,338
2009,Congo,COG,Belgium,BEL,0,0,5,5,10
2009,Dem. Rep. of the Congo,COD,Belgium,BEL,107,10,515,25,657
2009,Colombia,COL,Belgium,BEL,5,0,0,0,5
2009,Cyprus,CYP,Belgium,BEL,0,0,0,5,5
2009,Czechia,CZE,Belgium,BEL,0,0,25,5,30
2009,Djibouti,DJI,Belgium,BEL,11,0,15,5,31
2009,Dominican Rep.,DOM,Belgium,BEL,0,0,10,0,10
2009,Equatorial Guinea,GNQ,Belgium,BEL,0,0,5,0,5
2009,Eritrea,ERI,Belgium,BEL,28,0,5,0,33
2009,Ethiopia,ETH,Belgium,BEL,12,0,29,0,41
2009,Gambia,GMB,Belgium,BEL,5,0,18,0,23
2009,Palestinian,PSE,Belgium,BEL,0,0,10,5,15
2009,Georgia,GEO,Belgium,BEL,5,0,81,19,105
2009,Ghana,GHA,Belgium,BEL,0,0,5,0,5
2009,Guatemala,GTM,Belgium,BEL,0,0,5,0,5
2009,Guinea,GIN,Belgium,BEL,261,5,363,15,644
2009,Croatia,HRV,Belgium,BEL,0,0,5,0,5
2009,Hungary,HUN,Belgium,BEL,0,0,124,14,138
2009,Cote d'Ivoire,CIV,Belgium,BEL,23,0,34,0,57
2009,India,IND,Belgium,BEL,0,0,37,0,37
2009,Iran (Islamic Rep. of),IRN,Belgium,BEL,95,0,211,11,317
2009,Iraq,IRQ,Belgium,BEL,312,299,204,40,855
2009,Israel,ISR,Belgium,BEL,5,0,0,5,10
2009,Jordan,JOR,Belgium,BEL,5,0,5,0,10
2009,Kazakhstan,KAZ,Belgium,BEL,0,0,10,5,15
2009,Kenya,KEN,Belgium,BEL,10,0,51,0,61
2009,Dem. People's Rep. of Korea,PRK,Belgium,BEL,5,0,0,0,5
2009,Liberia,LBR,Belgium,BEL,5,0,12,0,17
2009,Lebanon,LBN,Belgium,BEL,11,0,62,10,83
2009,Sri Lanka,LKA,Belgium,BEL,68,0,40,0,108
2009,Mauritania,MRT,Belgium,BEL,42,0,122,5,169
2009,North Macedonia,MKD,Belgium,BEL,0,0,108,33,141
2009,Rep. of Moldova,MDA,Belgium,BEL,0,0,5,0,5
2009,Mali,MLI,Belgium,BEL,0,0,5,0,5
2009,Mongolia,MNG,Belgium,BEL,0,0,39,5,44
2009,Morocco,MAR,Belgium,BEL,5,0,15,10,30
2009,Montenegro,MNE,Belgium,BEL,10,0,10,5,25
2009,Nepal,NPL,Belgium,BEL,0,0,24,0,24
2009,Niger,NER,Belgium,BEL,21,0,28,5,54
2009,Nigeria,NGA,Belgium,BEL,0,0,63,0,63
2009,Pakistan,PAK,Belgium,BEL,5,0,102,10,117
2009,Poland,POL,Belgium,BEL,0,0,5,0,5
2009,Romania,ROU,Belgium,BEL,0,0,92,0,92
2009,Russian Federation,RUS,Belgium,BEL,302,0,1163,67,1532
2009,Rwanda,RWA,Belgium,BEL,139,0,109,10,258
2009,Serbia and Kosovo: S/RES/1244 (1999),SRB,Belgium,BEL,129,0,996,111,1236
2009,Senegal,SEN,Belgium,BEL,24,0,41,0,65
2009,Sierra Leone,SLE,Belgium,BEL,5,0,20,0,25
2009,Somalia,SOM,Belgium,BEL,25,21,80,5,131
2009,Viet Nam,VNM,Belgium,BEL,0,0,10,0,10
2009,Sudan,SDN,Belgium,BEL,19,12,30,10,71
2009,Slovakia,SVK,Belgium,BEL,0,0,304,17,321
2009,Syrian Arab Rep.,SYR,Belgium,BEL,50,0,116,12,178
2009,United Rep. of Tanzania,TZA,Belgium,BEL,5,0,31,0,36
2009,Tajikistan,TJK,Belgium,BEL,0,0,5,0,5
2009,Togo,TGO,Belgium,BEL,16,0,124,5,145
2009,Tunisia,TUN,Belgium,BEL,0,0,10,5,15
2009,Turkey,TUR,Belgium,BEL,56,0,207,30,293
2009,Uganda,UGA,Belgium,BEL,5,0,14,0,19
2009,Ukraine,UKR,Belgium,BEL,0,0,22,10,32
2009,Uzbekistan,UZB,Belgium,BEL,5,0,5,5,15
2009,Yemen,YEM,Belgium,BEL,0,0,11,0,11
2009,Zimbabwe,ZWE,Belgium,BEL,5,0,0,0,5
2009,Stateless,XXA,Belgium,BEL,0,0,5,0,5
2009,Unknown ,,Belgium,BEL,49,10,86,5,150
2009,Central African Rep.,CAF,Benin,BEN,5,0,5,0,10
2009,Chad,TCD,Benin,BEN,10,0,22,31,63
2009,Cameroon,CMR,Benin,BEN,0,0,5,0,5
2009,Congo,COG,Benin,BEN,5,0,5,5,15
2009,Dem. Rep. of the Congo,COD,Benin,BEN,5,0,28,0,33
2009,Comoros,COM,Benin,BEN,0,0,5,0,5
2009,Equatorial Guinea,GNQ,Benin,BEN,0,0,0,5,5
2009,Guinea,GIN,Benin,BEN,0,0,5,0,5
2009,Niger,NER,Benin,BEN,0,0,5,5,10
2009,Nigeria,NGA,Benin,BEN,0,0,35,34,69
2009,Somalia,SOM,Benin,BEN,5,0,0,0,5
2009,Sudan,SDN,Benin,BEN,0,0,0,5,5
2009,Togo,TGO,Benin,BEN,10,0,25,40,75
2009,Chad,TCD,Burkina Faso,BFA,5,0,12,5,22
2009,Cameroon,CMR,Burkina Faso,BFA,0,0,0,5,5
2009,Congo,COG,Burkina Faso,BFA,0,0,5,5,10
2009,Dem. Rep. of the Congo,COD,Burkina Faso,BFA,0,0,5,10,15
2009,Cote d'Ivoire,CIV,Burkina Faso,BFA,0,0,5,14,19
2009,Rwanda,RWA,Burkina Faso,BFA,0,0,0,10,10
2009,Togo,TGO,Burkina Faso,BFA,0,0,5,5,10
2009,Afghanistan,AFG,Belarus,BLR,12,0,29,10,51
2009,Azerbaijan,AZE,Belarus,BLR,0,0,5,0,5
2009,Congo,COG,Belarus,BLR,0,0,0,5,5
2009,Georgia,GEO,Belarus,BLR,0,0,10,16,26
2009,Iran (Islamic Rep. of),IRN,Belarus,BLR,0,0,5,0,5
2009,Pakistan,PAK,Belarus,BLR,0,0,0,5,5
2009,Russian Federation,RUS,Belarus,BLR,0,0,5,0,5
2009,Ukraine,UKR,Belarus,BLR,0,0,5,5,10
2009,Colombia,COL,Bolivia (Plurinational State of),BOL,13,0,0,14,27
2009,Eritrea,ERI,Bolivia (Plurinational State of),BOL,0,0,0,49,49
2009,Ethiopia,ETH,Bolivia (Plurinational State of),BOL,0,0,0,11,11
2009,Peru,PER,Bolivia (Plurinational State of),BOL,0,0,0,5,5
2009,Burundi,BDI,Botswana,BWA,0,0,5,5,10
2009,Dem. Rep. of the Congo,COD,Botswana,BWA,0,0,36,5,41
2009,Zimbabwe,ZWE,Botswana,BWA,48,0,0,5,53
2009,Bangladesh,BGD,Brazil,BRA,0,0,5,0,5
2009,Bolivia (Plurinational State of),BOL,Brazil,BRA,121,0,5,0,126
2009,Dem. Rep. of the Congo,COD,Brazil,BRA,56,0,66,0,122
2009,Colombia,COL,Brazil,BRA,36,0,17,0,53
2009,Cuba,CUB,Brazil,BRA,0,0,20,0,20
2009,Eritrea,ERI,Brazil,BRA,5,0,0,0,5
2009,Guinea-Bissau,GNB,Brazil,BRA,0,0,10,0,10
2009,Cote d'Ivoire,CIV,Brazil,BRA,0,0,5,0,5
2009,Iraq,IRQ,Brazil,BRA,16,0,0,0,16
2009,Liberia,LBR,Brazil,BRA,0,0,5,0,5
2009,Nigeria,NGA,Brazil,BRA,0,0,5,0,5
2009,Senegal,SEN,Brazil,BRA,0,0,10,0,10
2009,Somalia,SOM,Brazil,BRA,5,0,0,0,5
2009,Sudan,SDN,Brazil,BRA,5,0,0,0,5
2009,Afghanistan,AFG,Bulgaria,BGR,12,16,16,5,49
2009,Albania,ALB,Bulgaria,BGR,0,0,5,0,5
2009,Algeria,DZA,Bulgaria,BGR,0,0,14,0,14
2009,Egypt,EGY,Bulgaria,BGR,0,0,5,0,5
2009,Armenia,ARM,Bulgaria,BGR,0,5,40,0,45
2009,Bosnia and Herzegovina,BIH,Bulgaria,BGR,0,0,5,0,5
2009,China,CHN,Bulgaria,BGR,0,0,5,0,5
2009,Georgia,GEO,Bulgaria,BGR,0,0,5,5,10
2009,Ghana,GHA,Bulgaria,BGR,0,0,5,0,5
2009,Cote d'Ivoire,CIV,Bulgaria,BGR,0,0,5,0,5
2009,Iran (Islamic Rep. of),IRN,Bulgaria,BGR,0,0,18,10,28
2009,Iraq,IRQ,Bulgaria,BGR,16,183,99,28,326
2009,Kazakhstan,KAZ,Bulgaria,BGR,0,0,5,0,5
2009,Liberia,LBR,Bulgaria,BGR,0,0,5,0,5
2009,Lebanon,LBN,Bulgaria,BGR,0,0,10,0,10
2009,Sri Lanka,LKA,Bulgaria,BGR,0,0,14,5,19
2009,Morocco,MAR,Bulgaria,BGR,0,0,5,5,10
2009,Nigeria,NGA,Bulgaria,BGR,0,0,17,0,17
2009,Russian Federation,RUS,Bulgaria,BGR,0,0,5,0,5
2009,Somalia,SOM,Bulgaria,BGR,0,5,0,0,5
2009,Viet Nam,VNM,Bulgaria,BGR,0,0,5,0,5
2009,Syrian Arab Rep.,SYR,Bulgaria,BGR,0,5,18,0,23
2009,United Rep. of Tanzania,TZA,Bulgaria,BGR,0,0,5,0,5
2009,Turkey,TUR,Bulgaria,BGR,0,0,16,0,16
2009,Stateless,XXA,Bulgaria,BGR,5,11,39,21,76
2009,Guatemala,GTM,Belize,BLZ,0,5,0,0,5
2009,El Salvador,SLV,Belize,BLZ,0,0,0,5,5
2009,Afghanistan,AFG,Canada,CAN,275,0,18,44,337
2009,Albania,ALB,Canada,CAN,108,0,139,30,277
2009,Algeria,DZA,Canada,CAN,5,0,29,14,48
2009,Angola,AGO,Canada,CAN,0,0,0,5,5
2009,Antigua and Barbuda,ATG,Canada,CAN,0,0,5,0,5
2009,Egypt,EGY,Canada,CAN,24,0,12,5,41
2009,Argentina,ARG,Canada,CAN,10,0,5,13,28
2009,Armenia,ARM,Canada,CAN,18,0,12,0,30
2009,Australia,AUS,Canada,CAN,0,0,0,5,5
2009,Azerbaijan,AZE,Canada,CAN,5,0,5,0,10
2009,Barbados,BRB,Canada,CAN,0,0,10,5,15
2009,Burundi,BDI,Canada,CAN,211,0,53,5,269
2009,Belgium,BEL,Canada,CAN,5,0,0,10,15
2009,Bangladesh,BGD,Canada,CAN,29,0,29,10,68
2009,Bahamas,BHS,Canada,CAN,5,0,0,5,10
2009,Bhutan,BTN,Canada,CAN,5,0,0,0,5
2009,Burkina Faso,BFA,Canada,CAN,5,0,0,0,5
2009,Belarus,BLR,Canada,CAN,25,0,5,5,35
2009,Bolivia (Plurinational State of),BOL,Canada,CAN,5,0,5,0,10
2009,Botswana,BWA,Canada,CAN,19,0,10,19,48
2009,Brazil,BRA,Canada,CAN,0,0,34,34,68
2009,Bosnia and Herzegovina,BIH,Canada,CAN,5,0,11,5,21
2009,Bulgaria,BGR,Canada,CAN,25,0,5,5,35
2009,Cambodia,KHM,Canada,CAN,5,0,0,0,5
2009,Central African Rep.,CAF,Canada,CAN,5,0,0,0,5
2009,Chad,TCD,Canada,CAN,33,0,5,5,43
2009,China,CHN,Canada,CAN,991,0,547,178,1716
2009,Chile,CHL,Canada,CAN,5,0,5,14,24
2009,Cameroon,CMR,Canada,CAN,83,0,36,10,129
2009,Congo,COG,Canada,CAN,15,0,14,5,34
2009,Dem. Rep. of the Congo,COD,Canada,CAN,178,0,88,20,286
2009,Colombia,COL,Canada,CAN,2431,0,657,122,3210
2009,Costa Rica,CRI,Canada,CAN,5,0,10,5,20
2009,Cuba,CUB,Canada,CAN,46,0,35,25,106
2009,Czechia,CZE,Canada,CAN,90,0,76,734,900
2009,Denmark,DNK,Canada,CAN,0,0,5,5,10
2009,Djibouti,DJI,Canada,CAN,11,0,5,0,16
2009,Dominican Rep.,DOM,Canada,CAN,5,0,14,20,39
2009,Ecuador,ECU,Canada,CAN,0,0,10,11,21
2009,Eritrea,ERI,Canada,CAN,236,0,5,10,251
2009,Ethiopia,ETH,Canada,CAN,147,0,13,15,175
2009,Fiji,FJI,Canada,CAN,24,0,12,10,46
2009,France,FRA,Canada,CAN,0,0,15,10,25
2009,Gabon,GAB,Canada,CAN,5,0,0,0,5
2009,Gambia,GMB,Canada,CAN,5,0,0,5,10
2009,Palestinian,PSE,Canada,CAN,39,0,19,5,63
2009,United Kingdom of Great Britain and Northern Ireland,GBR,Canada,CAN,0,0,0,10,10
2009,Georgia,GEO,Canada,CAN,24,0,25,12,61
2009,Germany,DEU,Canada,CAN,0,0,12,19,31
2009,Ghana,GHA,Canada,CAN,16,0,16,5,37
2009,Grenada,GRD,Canada,CAN,5,0,10,0,15
2009,Guatemala,GTM,Canada,CAN,55,0,75,27,157
2009,Guinea,GIN,Canada,CAN,37,0,33,5,75
2009,Guyana,GUY,Canada,CAN,13,0,42,5,60
2009,Haiti,HTI,Canada,CAN,1040,0,1256,160,2456
2009,"China, Hong Kong SAR",HKG,Canada,CAN,0,0,11,15,26
2009,Honduras,HND,Canada,CAN,98,0,175,71,344
2009,Croatia,HRV,Canada,CAN,0,0,0,5,5
2009,Hungary,HUN,Canada,CAN,5,0,5,259,269
2009,Cote d'Ivoire,CIV,Canada,CAN,23,0,5,5,33
2009,India,IND,Canada,CAN,188,0,284,107,579
2009,Indonesia,IDN,Canada,CAN,22,0,42,10,74
2009,Iran (Islamic Rep. of),IRN,Canada,CAN,192,0,22,34,248
2009,Iraq,IRQ,Canada,CAN,189,0,33,31,253
2009,Israel,ISR,Canada,CAN,14,0,198,79,291
2009,Italy,ITA,Canada,CAN,0,0,5,5,10
2009,Jamaica,JAM,Canada,CAN,12,0,56,27,95
2009,Jordan,JOR,Canada,CAN,25,0,30,23,78
2009,Japan,JPN,Canada,CAN,0,0,0,5,5
2009,Kazakhstan,KAZ,Canada,CAN,5,0,5,0,10
2009,Kenya,KEN,Canada,CAN,45,0,10,5,60
2009,Kyrgyzstan,KGZ,Canada,CAN,5,0,0,5,10
2009,Rep. of Korea,KOR,Canada,CAN,25,0,174,65,264
2009,Dem. People's Rep. of Korea,PRK,Canada,CAN,66,0,10,41,117
2009,Kuwait,KWT,Canada,CAN,5,0,5,0,10
2009,Liberia,LBR,Canada,CAN,10,0,5,5,20
2009,Libya,LBY,Canada,CAN,10,0,0,5,15
2009,Saint Lucia,LCA,Canada,CAN,28,0,38,34,100
2009,Lebanon,LBN,Canada,CAN,97,0,88,43,228
2009,Sri Lanka,LKA,Canada,CAN,981,0,60,41,1082
2009,Latvia,LVA,Canada,CAN,0,0,0,5,5
2009,Mauritania,MRT,Canada,CAN,5,0,0,0,5
2009,North Macedonia,MKD,Canada,CAN,5,0,0,5,10
2009,Rep. of Moldova,MDA,Canada,CAN,11,0,5,10,26
2009,Mexico,MEX,Canada,CAN,516,0,3382,2167,6065
2009,Mali,MLI,Canada,CAN,0,0,5,5,10
2009,Malaysia,MYS,Canada,CAN,5,0,10,5,20
2009,Malawi,MWI,Canada,CAN,0,0,5,0,5
2009,Mongolia,MNG,Canada,CAN,11,0,5,10,26
2009,Morocco,MAR,Canada,CAN,14,0,10,10,34
2009,Mauritius,MUS,Canada,CAN,0,0,5,0,5
2009,Myanmar,MMR,Canada,CAN,22,0,0,0,22
2009,Namibia,NAM,Canada,CAN,5,0,5,0,10
2009,Nepal,NPL,Canada,CAN,26,0,5,10,41
2009,Netherlands,NLD,Canada,CAN,0,0,10,0,10
2009,Nicaragua,NIC,Canada,CAN,5,0,21,5,31
2009,Nigeria,NGA,Canada,CAN,440,0,148,76,664
2009,Pakistan,PAK,Canada,CAN,247,0,119,51,417
2009,Panama,PAN,Canada,CAN,5,0,10,5,20
2009,Paraguay,PRY,Canada,CAN,0,0,5,0,5
2009,Peru,PER,Canada,CAN,40,0,32,25,97
2009,Philippines,PHL,Canada,CAN,11,0,50,16,77
2009,Poland,POL,Canada,CAN,37,0,13,27,77
2009,Portugal,PRT,Canada,CAN,0,0,19,12,31
2009,Romania,ROU,Canada,CAN,5,0,13,15,33
2009,South Africa,ZAF,Canada,CAN,5,0,0,5,10
2009,Russian Federation,RUS,Canada,CAN,81,0,56,33,170
2009,Rwanda,RWA,Canada,CAN,241,0,31,10,282
2009,El Salvador,SLV,Canada,CAN,63,0,111,39,213
2009,Saudi Arabia,SAU,Canada,CAN,5,0,0,5,10
2009,Serbia and Kosovo: S/RES/1244 (1999),SRB,Canada,CAN,46,0,40,25,111
2009,Senegal,SEN,Canada,CAN,10,0,5,0,15
2009,Singapore,SGP,Canada,CAN,5,0,0,0,5
2009,Sierra Leone,SLE,Canada,CAN,10,0,5,0,15
2009,Solomon Islands,SLB,Canada,CAN,5,0,0,0,5
2009,Somalia,SOM,Canada,CAN,170,0,5,32,207
2009,Spain,ESP,Canada,CAN,0,0,5,5,10
2009,Viet Nam,VNM,Canada,CAN,5,0,5,5,15
2009,Sudan,SDN,Canada,CAN,23,0,5,10,38
2009,Suriname,SUR,Canada,CAN,5,0,0,0,5
2009,Slovakia,SVK,Canada,CAN,0,0,5,46,51
2009,Eswatini,SWZ,Canada,CAN,5,0,5,5,15
2009,Sweden,SWE,Canada,CAN,0,0,5,0,5
2009,Syrian Arab Rep.,SYR,Canada,CAN,13,0,10,13,36
2009,United Rep. of Tanzania,TZA,Canada,CAN,10,0,0,0,10
2009,Thailand,THA,Canada,CAN,0,0,24,29,53
2009,Togo,TGO,Canada,CAN,10,0,0,0,10
2009,Trinidad and Tobago,TTO,Canada,CAN,13,0,38,21,72
2009,Tunisia,TUN,Canada,CAN,10,0,11,5,26
2009,Turkey,TUR,Canada,CAN,101,0,31,37,169
2009,United Arab Emirates,ARE,Canada,CAN,5,0,0,0,5
2009,Uganda,UGA,Canada,CAN,46,0,10,5,61
2009,Ukraine,UKR,Canada,CAN,70,0,65,50,185
2009,Uruguay,URY,Canada,CAN,0,0,5,0,5
2009,United States of America,USA,Canada,CAN,5,0,521,197,723
2009,Uzbekistan,UZB,Canada,CAN,10,0,12,0,22
2009,Saint Vincent and the Grenadines,VCT,Canada,CAN,130,0,144,49,323
2009,Venezuela (Bolivarian Republic of),VEN,Canada,CAN,32,0,32,11,75
2009,Yemen,YEM,Canada,CAN,5,0,5,0,10
2009,Zambia,ZMB,Canada,CAN,5,0,0,5,10
2009,Zimbabwe,ZWE,Canada,CAN,219,0,29,14,262
2009,Unknown ,,Canada,CAN,0,0,5,0,5
2009,Chad,TCD,Central African Rep.,CAF,151,0,20,0,171
2009,Dem. Rep. of the Congo,COD,Central African Rep.,CAF,139,0,33,0,172
2009,Rwanda,RWA,Central African Rep.,CAF,38,0,0,0,38
2009,Sudan,SDN,Central African Rep.,CAF,22,0,0,0,22
2009,Cuba,CUB,Colombia,COL,0,0,18,0,18
2009,Eritrea,ERI,Colombia,COL,5,0,118,0,123
2009,Ethiopia,ETH,Colombia,COL,11,0,39,0,50
2009,Ghana,GHA,Colombia,COL,0,0,5,0,5
2009,Nepal,NPL,Colombia,COL,0,0,5,0,5
2009,Somalia,SOM,Colombia,COL,10,0,83,0,93
2009,Venezuela (Bolivarian Republic of),VEN,Colombia,COL,0,0,13,0,13
2009,Afghanistan,AFG,Cyprus,CYP,0,0,50,40,90
2009,Algeria,DZA,Cyprus,CYP,0,0,5,0,5
2009,Egypt,EGY,Cyprus,CYP,0,5,236,148,389
2009,Armenia,ARM,Cyprus,CYP,0,0,10,25,35
2009,Benin,BEN,Cyprus,CYP,0,0,0,5,5
2009,Bangladesh,BGD,Cyprus,CYP,0,0,162,0,162
2009,Burkina Faso,BFA,Cyprus,CYP,0,0,5,0,5
2009,Bosnia and Herzegovina,BIH,Cyprus,CYP,0,0,5,15,20
2009,China,CHN,Cyprus,CYP,0,0,176,122,298
2009,Cameroon,CMR,Cyprus,CYP,0,0,41,20,61
2009,Dem. Rep. of the Congo,COD,Cyprus,CYP,0,0,14,16,30
2009,Ethiopia,ETH,Cyprus,CYP,0,0,10,0,10
2009,Palestinian,PSE,Cyprus,CYP,10,1102,16,0,1128
2009,Georgia,GEO,Cyprus,CYP,0,5,119,235,359
2009,Ghana,GHA,Cyprus,CYP,0,0,17,5,22
2009,Guinea,GIN,Cyprus,CYP,0,0,10,10,20
2009,Cote d'Ivoire,CIV,Cyprus,CYP,0,0,5,5,10
2009,India,IND,Cyprus,CYP,0,0,394,210,604
2009,Indonesia,IDN,Cyprus,CYP,0,0,0,11,11
2009,Iran (Islamic Rep. of),IRN,Cyprus,CYP,14,0,237,389,640
2009,Iraq,IRQ,Cyprus,CYP,0,181,14,40,235
2009,Jordan,JOR,Cyprus,CYP,0,0,54,36,90
2009,Kazakhstan,KAZ,Cyprus,CYP,0,0,0,13,13
2009,Kenya,KEN,Cyprus,CYP,0,0,5,5,10
2009,Lebanon,LBN,Cyprus,CYP,0,0,66,112,178
2009,Sri Lanka,LKA,Cyprus,CYP,0,0,277,123,400
2009,North Macedonia,MKD,Cyprus,CYP,0,0,12,25,37
2009,Rep. of Moldova,MDA,Cyprus,CYP,0,0,20,27,47
2009,Mali,MLI,Cyprus,CYP,0,0,0,5,5
2009,Mongolia,MNG,Cyprus,CYP,0,0,62,27,89
2009,Morocco,MAR,Cyprus,CYP,0,0,20,5,25
2009,Nepal,NPL,Cyprus,CYP,0,0,97,56,153
2009,Nigeria,NGA,Cyprus,CYP,0,0,112,0,112
2009,Pakistan,PAK,Cyprus,CYP,0,0,254,95,349
2009,Philippines,PHL,Cyprus,CYP,0,5,91,24,120
2009,Romania,ROU,Cyprus,CYP,0,0,0,5,5
2009,Russian Federation,RUS,Cyprus,CYP,5,0,30,85,120
2009,Somalia,SOM,Cyprus,CYP,0,0,0,5,5
2009,Viet Nam,VNM,Cyprus,CYP,0,0,86,12,98
2009,Sudan,SDN,Cyprus,CYP,0,0,5,5,10
2009,Syrian Arab Rep.,SYR,Cyprus,CYP,0,5,415,392,812
2009,Tunisia,TUN,Cyprus,CYP,0,0,5,5,10
2009,Turkey,TUR,Cyprus,CYP,20,0,50,0,70
2009,Ukraine,UKR,Cyprus,CYP,0,5,64,210,279
2009,Uzbekistan,UZB,Cyprus,CYP,0,0,22,45,67
2009,Afghanistan,AFG,Czechia,CZE,5,0,0,5,10
2009,Algeria,DZA,Czechia,CZE,0,0,5,5,10
2009,Armenia,ARM,Czechia,CZE,0,0,5,5,10
2009,Bangladesh,BGD,Czechia,CZE,0,0,0,5,5
2009,Belarus,BLR,Czechia,CZE,0,0,34,29,63
2009,China,CHN,Czechia,CZE,0,0,5,11,16
2009,Cameroon,CMR,Czechia,CZE,0,0,5,5,10
2009,Dem. Rep. of the Congo,COD,Czechia,CZE,0,0,0,5,5
2009,Cuba,CUB,Czechia,CZE,0,5,0,0,5
2009,Georgia,GEO,Czechia,CZE,0,0,10,15,25
2009,Ghana,GHA,Czechia,CZE,0,0,0,5,5
2009,Guinea,GIN,Czechia,CZE,0,0,0,5,5
2009,Iraq,IRQ,Czechia,CZE,0,5,0,10,15
2009,Kazakhstan,KAZ,Czechia,CZE,5,0,10,73,88
2009,Kyrgyzstan,KGZ,Czechia,CZE,0,0,15,10,25
2009,Sri Lanka,LKA,Czechia,CZE,0,0,10,0,10
2009,Rep. of Moldova,MDA,Czechia,CZE,0,0,11,0,11
2009,Mongolia,MNG,Czechia,CZE,0,0,94,59,153
2009,Myanmar,MMR,Czechia,CZE,21,0,0,0,21
2009,Nigeria,NGA,Czechia,CZE,0,0,10,12,22
2009,Russian Federation,RUS,Czechia,CZE,0,5,10,17,32
2009,Serbia and Kosovo: S/RES/1244 (1999),SRB,Czechia,CZE,5,0,14,17,36
2009,Viet Nam,VNM,Czechia,CZE,10,0,27,33,70
2009,Syrian Arab Rep.,SYR,Czechia,CZE,0,0,20,18,38
2009,Turkey,TUR,Czechia,CZE,0,0,5,35,40
2009,Ukraine,UKR,Czechia,CZE,10,0,93,88,191
2009,Uzbekistan,UZB,Czechia,CZE,5,0,0,0,5
2009,Stateless,XXA,Czechia,CZE,0,5,5,24,34
2009,Afghanistan,AFG,Denmark,DNK,5,187,166,0,358
2009,Albania,ALB,Denmark,DNK,0,5,5,0,10
2009,Algeria,DZA,Denmark,DNK,0,0,5,0,5
2009,Armenia,ARM,Denmark,DNK,0,0,12,0,12
2009,Azerbaijan,AZE,Denmark,DNK,5,0,10,0,15
2009,Bangladesh,BGD,Denmark,DNK,0,0,5,0,5
2009,Bosnia and Herzegovina,BIH,Denmark,DNK,0,0,38,0,38
2009,Bulgaria,BGR,Denmark,DNK,0,0,5,0,5
2009,China,CHN,Denmark,DNK,0,0,10,0,10
2009,Cameroon,CMR,Denmark,DNK,0,0,5,0,5
2009,Congo,COG,Denmark,DNK,0,0,5,0,5
2009,Dem. Rep. of the Congo,COD,Denmark,DNK,5,0,10,0,15
2009,Eritrea,ERI,Denmark,DNK,0,5,0,0,5
2009,Georgia,GEO,Denmark,DNK,0,0,5,0,5
2009,Ghana,GHA,Denmark,DNK,0,0,17,0,17
2009,Guinea,GIN,Denmark,DNK,0,0,5,0,5
2009,Croatia,HRV,Denmark,DNK,0,0,5,0,5
2009,India,IND,Denmark,DNK,0,0,10,0,10
2009,Iran (Islamic Rep. of),IRN,Denmark,DNK,118,12,76,0,206
2009,Iraq,IRQ,Denmark,DNK,35,52,101,0,188
2009,Jordan,JOR,Denmark,DNK,0,5,0,0,5
2009,Liberia,LBR,Denmark,DNK,0,0,5,0,5
2009,Libya,LBY,Denmark,DNK,0,5,0,0,5
2009,Lebanon,LBN,Denmark,DNK,0,0,5,0,5
2009,Sri Lanka,LKA,Denmark,DNK,0,0,10,0,10
2009,North Macedonia,MKD,Denmark,DNK,0,0,5,0,5
2009,Rep. of Moldova,MDA,Denmark,DNK,0,0,5,0,5
2009,Morocco,MAR,Denmark,DNK,0,0,5,0,5
2009,Myanmar,MMR,Denmark,DNK,5,0,5,0,10
2009,Nigeria,NGA,Denmark,DNK,0,0,15,0,15
2009,Pakistan,PAK,Denmark,DNK,0,0,10,0,10
2009,Poland,POL,Denmark,DNK,0,0,5,0,5
2009,Romania,ROU,Denmark,DNK,0,0,10,0,10
2009,Russian Federation,RUS,Denmark,DNK,29,40,30,0,99
2009,Rwanda,RWA,Denmark,DNK,0,0,5,0,5
2009,Serbia and Kosovo: S/RES/1244 (1999),SRB,Denmark,DNK,0,0,108,0,108
2009,Senegal,SEN,Denmark,DNK,0,0,5,0,5
2009,Somalia,SOM,Denmark,DNK,0,16,16,0,32
2009,Sudan,SDN,Denmark,DNK,5,5,10,0,20
2009,Syrian Arab Rep.,SYR,Denmark,DNK,119,13,60,0,192
2009,Turkey,TUR,Denmark,DNK,0,0,10,0,10
2009,Uganda,UGA,Denmark,DNK,0,0,10,0,10
2009,Zimbabwe,ZWE,Denmark,DNK,0,0,10,0,10
2009,Stateless,XXA,Denmark,DNK,15,0,30,0,45
2009,Belarus,BLR,Estonia,EST,0,0,5,0,5
2009,Syrian Arab Rep.,SYR,Estonia,EST,0,0,5,0,5
2009,Afghanistan,AFG,Finland,FIN,10,86,32,114,242
2009,Albania,ALB,Finland,FIN,0,0,5,10,15
2009,Algeria,DZA,Finland,FIN,0,0,0,21,21
2009,Angola,AGO,Finland,FIN,0,10,0,0,10
2009,Armenia,ARM,Finland,FIN,0,0,0,5,5
2009,Burundi,BDI,Finland,FIN,0,0,0,5,5
2009,Bangladesh,BGD,Finland,FIN,0,0,5,5,10
2009,Belarus,BLR,Finland,FIN,0,0,10,65,75
2009,Bosnia and Herzegovina,BIH,Finland,FIN,0,0,0,13,13
2009,Bulgaria,BGR,Finland,FIN,0,0,5,516,521
2009,China,CHN,Finland,FIN,0,5,0,0,5
2009,Cameroon,CMR,Finland,FIN,0,5,10,0,15
2009,Congo,COG,Finland,FIN,0,0,0,5,5
2009,Dem. Rep. of the Congo,COD,Finland,FIN,0,11,10,5,26
2009,Cuba,CUB,Finland,FIN,0,0,0,5,5
2009,Ecuador,ECU,Finland,FIN,0,5,0,0,5
2009,Eritrea,ERI,Finland,FIN,0,0,0,5,5
2009,Ethiopia,ETH,Finland,FIN,0,5,5,5,15
2009,Gambia,GMB,Finland,FIN,0,0,5,16,21
2009,Georgia,GEO,Finland,FIN,0,0,0,11,11
2009,Ghana,GHA,Finland,FIN,0,0,11,14,25
2009,Guinea,GIN,Finland,FIN,0,5,0,5,10
2009,Croatia,HRV,Finland,FIN,0,0,0,5,5
2009,India,IND,Finland,FIN,0,0,0,12,12
2009,Iran (Islamic Rep. of),IRN,Finland,FIN,10,22,36,60,128
2009,Iraq,IRQ,Finland,FIN,39,451,60,471,1021
2009,Israel,ISR,Finland,FIN,0,0,0,5,5
2009,Libya,LBY,Finland,FIN,0,0,0,12,12
2009,Lebanon,LBN,Finland,FIN,0,0,0,5,5
2009,Sri Lanka,LKA,Finland,FIN,0,10,10,10,30
2009,Morocco,MAR,Finland,FIN,0,0,0,22,22
2009,Nigeria,NGA,Finland,FIN,0,10,38,33,81
2009,Pakistan,PAK,Finland,FIN,0,0,5,0,5
2009,Romania,ROU,Finland,FIN,0,0,0,53,53
2009,Russian Federation,RUS,Finland,FIN,37,28,28,139,232
2009,Serbia and Kosovo: S/RES/1244 (1999),SRB,Finland,FIN,0,5,24,84,113
2009,Senegal,SEN,Finland,FIN,0,0,0,5,5
2009,Somalia,SOM,Finland,FIN,0,540,23,670,1233
2009,Sudan,SDN,Finland,FIN,0,0,0,5,5
2009,Syrian Arab Rep.,SYR,Finland,FIN,0,0,10,10,20
2009,Tunisia,TUN,Finland,FIN,0,0,0,5,5
2009,Turkey,TUR,Finland,FIN,5,10,19,21,55
2009,Ukraine,UKR,Finland,FIN,0,0,0,5,5
2009,United States of America,USA,Finland,FIN,0,0,0,5,5
2009,Stateless,XXA,Finland,FIN,0,5,0,10,15
2009,Unknown ,,Finland,FIN,0,14,11,40,65
2009,Afghanistan,AFG,France,FRA,121,14,227,0,362
2009,Albania,ALB,France,FRA,10,5,301,0,316
2009,Algeria,DZA,France,FRA,35,5,930,0,970
2009,Angola,AGO,France,FRA,49,0,400,0,449
2009,Egypt,EGY,France,FRA,5,0,61,0,66
2009,Armenia,ARM,France,FRA,93,11,1893,0,1997
2009,Azerbaijan,AZE,France,FRA,63,0,439,0,502
2009,Burundi,BDI,France,FRA,10,0,22,0,32
2009,Benin,BEN,France,FRA,0,0,13,0,13
2009,Bangladesh,BGD,France,FRA,33,0,1747,0,1780
2009,Bhutan,BTN,France,FRA,5,0,22,0,27
2009,Burkina Faso,BFA,France,FRA,0,5,27,0,32
2009,Belarus,BLR,France,FRA,5,0,62,0,67
2009,Brazil,BRA,France,FRA,0,0,12,0,12
2009,Bosnia and Herzegovina,BIH,France,FRA,15,0,223,0,238
2009,Bulgaria,BGR,France,FRA,0,0,5,0,5
2009,Central African Rep.,CAF,France,FRA,14,5,125,0,144
2009,Chad,TCD,France,FRA,35,0,184,0,219
2009,China,CHN,France,FRA,179,0,1212,0,1391
2009,Cameroon,CMR,France,FRA,5,5,157,0,167
2009,Congo,COG,France,FRA,47,5,784,0,836
2009,Dem. Rep. of the Congo,COD,France,FRA,338,5,2076,0,2419
2009,Comoros,COM,France,FRA,66,0,724,0,790
2009,Colombia,COL,France,FRA,17,0,72,0,89
2009,Cuba,CUB,France,FRA,5,0,10,0,15
2009,Dominica,DMA,France,FRA,0,0,5,0,5
2009,Dominican Rep.,DOM,France,FRA,0,0,105,0,105
2009,Eritrea,ERI,France,FRA,122,13,59,0,194
2009,Ethiopia,ETH,France,FRA,25,5,28,0,58
2009,Gambia,GMB,France,FRA,5,12,42,0,59
2009,Palestinian,PSE,France,FRA,31,0,57,0,88
2009,Georgia,GEO,France,FRA,33,0,401,0,434
2009,Guinea-Bissau,GNB,France,FRA,12,5,95,0,112
2009,Guinea,GIN,France,FRA,124,177,1374,0,1675
2009,Guyana,GUY,France,FRA,0,0,5,0,5
2009,Haiti,HTI,France,FRA,93,24,1467,0,1584
2009,Hungary,HUN,France,FRA,0,0,10,0,10
2009,Cote d'Ivoire,CIV,France,FRA,43,54,505,0,602
2009,Iran (Islamic Rep. of),IRN,France,FRA,53,0,70,0,123
2009,Iraq,IRQ,France,FRA,421,18,96,0,535
2009,Jamaica,JAM,France,FRA,0,0,5,0,5
2009,Kazakhstan,KAZ,France,FRA,5,0,112,0,117
2009,Kyrgyzstan,KGZ,France,FRA,0,0,22,0,22
2009,Liberia,LBR,France,FRA,5,0,38,0,43
2009,Libya,LBY,France,FRA,0,0,5,0,5
2009,Lebanon,LBN,France,FRA,5,0,30,0,35
2009,Sri Lanka,LKA,France,FRA,631,5,2002,0,2638
2009,Mauritania,MRT,France,FRA,101,29,1132,0,1262
2009,North Macedonia,MKD,France,FRA,5,0,46,0,51
2009,Rep. of Moldova,MDA,France,FRA,5,0,208,0,213
2009,Mali,MLI,France,FRA,28,546,303,0,877
2009,Mongolia,MNG,France,FRA,10,0,185,0,195
2009,Myanmar,MMR,France,FRA,10,0,10,0,20
2009,Nepal,NPL,France,FRA,0,0,59,0,59
2009,Nigeria,NGA,France,FRA,10,18,693,0,721
2009,Pakistan,PAK,France,FRA,22,0,552,0,574
2009,Philippines,PHL,France,FRA,0,0,5,0,5
2009,Romania,ROU,France,FRA,0,0,25,0,25
2009,Russian Federation,RUS,France,FRA,303,10,1721,0,2034
2009,Rwanda,RWA,France,FRA,63,0,86,0,149
2009,Serbia and Kosovo: S/RES/1244 (1999),SRB,France,FRA,128,11,2942,0,3081
2009,Senegal,SEN,France,FRA,17,72,78,0,167
2009,Sierra Leone,SLE,France,FRA,5,10,176,0,191
2009,Somalia,SOM,France,FRA,51,47,31,0,129
2009,Viet Nam,VNM,France,FRA,5,0,23,0,28
2009,Sudan,SDN,France,FRA,132,5,365,0,502
2009,Syrian Arab Rep.,SYR,France,FRA,10,0,26,0,36
2009,Togo,TGO,France,FRA,21,5,147,0,173
2009,Tunisia,TUN,France,FRA,5,0,31,0,36
2009,Turkey,TUR,France,FRA,126,0,2306,0,2432
2009,Ukraine,UKR,France,FRA,5,0,55,0,60
2009,Uzbekistan,UZB,France,FRA,10,0,22,0,32
2009,Stateless,XXA,France,FRA,59,0,106,0,165
2009,Unknown ,,France,FRA,29,5,684,159,877
2009,Afghanistan,AFG,United Kingdom of Great Britain and Northern Ireland,GBR,220,1227,1388,1144,3979
2009,Albania,ALB,United Kingdom of Great Britain and Northern Ireland,GBR,5,43,110,54,212
2009,Algeria,DZA,United Kingdom of Great Britain and Northern Ireland,GBR,5,15,142,114,276
2009,Angola,AGO,United Kingdom of Great Britain and Northern Ireland,GBR,5,0,59,5,69
2009,Egypt,EGY,United Kingdom of Great Britain and Northern Ireland,GBR,5,10,53,19,87
2009,Armenia,ARM,United Kingdom of Great Britain and Northern Ireland,GBR,0,0,5,0,5
2009,Australia,AUS,United Kingdom of Great Britain and Northern Ireland,GBR,0,0,0,5,5
2009,Azerbaijan,AZE,United Kingdom of Great Britain and Northern Ireland,GBR,5,0,27,0,32
2009,Burundi,BDI,United Kingdom of Great Britain and Northern Ireland,GBR,0,5,15,5,25
2009,Benin,BEN,United Kingdom of Great Britain and Northern Ireland,GBR,0,0,5,0,5
2009,Bangladesh,BGD,United Kingdom of Great Britain and Northern Ireland,GBR,5,43,322,119,489
2009,Bhutan,BTN,United Kingdom of Great Britain and Northern Ireland,GBR,10,0,21,5,36
2009,Belarus,BLR,United Kingdom of Great Britain and Northern Ireland,GBR,13,0,25,5,43
2009,Bolivia (Plurinational State of),BOL,United Kingdom of Great Britain and Northern Ireland,GBR,0,0,10,5,15
2009,Botswana,BWA,United Kingdom of Great Britain and Northern Ireland,GBR,0,0,10,5,15
2009,Brazil,BRA,United Kingdom of Great Britain and Northern Ireland,GBR,0,0,29,10,39
2009,Bosnia and Herzegovina,BIH,United Kingdom of Great Britain and Northern Ireland,GBR,5,0,0,12,17
2009,Canada,CAN,United Kingdom of Great Britain and Northern Ireland,GBR,0,0,5,5,10
2009,Chad,TCD,United Kingdom of Great Britain and Northern Ireland,GBR,0,0,13,0,13
2009,China,CHN,United Kingdom of Great Britain and Northern Ireland,GBR,79,52,993,519,1643
2009,Cameroon,CMR,United Kingdom of Great Britain and Northern Ireland,GBR,14,5,83,10,112
2009,Congo,COG,United Kingdom of Great Britain and Northern Ireland,GBR,0,5,26,5,36
2009,Dem. Rep. of the Congo,COD,United Kingdom of Great Britain and Northern Ireland,GBR,45,28,247,18,338
2009,Colombia,COL,United Kingdom of Great Britain and Northern Ireland,GBR,0,0,14,5,19
2009,Cuba,CUB,United Kingdom of Great Britain and Northern Ireland,GBR,0,0,11,0,11
2009,Djibouti,DJI,United Kingdom of Great Britain and Northern Ireland,GBR,0,0,5,0,5
2009,Ecuador,ECU,United Kingdom of Great Britain and Northern Ireland,GBR,0,0,14,5,19
2009,Eritrea,ERI,United Kingdom of Great Britain and Northern Ireland,GBR,874,70,389,565,1898
2009,Ethiopia,ETH,United Kingdom of Great Britain and Northern Ireland,GBR,35,5,75,13,128
2009,Fiji,FJI,United Kingdom of Great Britain and Northern Ireland,GBR,0,0,5,0,5
2009,Gambia,GMB,United Kingdom of Great Britain and Northern Ireland,GBR,46,24,239,39,348
2009,Palestinian,PSE,United Kingdom of Great Britain and Northern Ireland,GBR,5,15,212,100,332
2009,Georgia,GEO,United Kingdom of Great Britain and Northern Ireland,GBR,0,0,76,18,94
2009,Ghana,GHA,United Kingdom of Great Britain and Northern Ireland,GBR,0,10,141,47,198
2009,Guinea-Bissau,GNB,United Kingdom of Great Britain and Northern Ireland,GBR,0,0,5,0,5
2009,Grenada,GRD,United Kingdom of Great Britain and Northern Ireland,GBR,0,0,5,0,5
2009,Guatemala,GTM,United Kingdom of Great Britain and Northern Ireland,GBR,0,0,5,0,5
2009,Guinea,GIN,United Kingdom of Great Britain and Northern Ireland,GBR,22,10,67,19,118
2009,Guyana,GUY,United Kingdom of Great Britain and Northern Ireland,GBR,0,0,14,5,19
2009,"China, Hong Kong SAR",HKG,United Kingdom of Great Britain and Northern Ireland,GBR,0,0,0,5,5
2009,Croatia,HRV,United Kingdom of Great Britain and Northern Ireland,GBR,0,0,5,0,5
2009,Cote d'Ivoire,CIV,United Kingdom of Great Britain and Northern Ireland,GBR,0,11,45,5,61
2009,India,IND,United Kingdom of Great Britain and Northern Ireland,GBR,5,16,330,378,729
2009,Indonesia,IDN,United Kingdom of Great Britain and Northern Ireland,GBR,0,0,5,5,10
2009,Iran (Islamic Rep. of),IRN,United Kingdom of Great Britain and Northern Ireland,GBR,292,172,1835,269,2568
2009,Iraq,IRQ,United Kingdom of Great Britain and Northern Ireland,GBR,124,160,1097,256,1637
2009,Israel,ISR,United Kingdom of Great Britain and Northern Ireland,GBR,0,0,5,5,10
2009,Jamaica,JAM,United Kingdom of Great Britain and Northern Ireland,GBR,10,12,174,41,237
2009,Jordan,JOR,United Kingdom of Great Britain and Northern Ireland,GBR,0,10,18,5,33
2009,Kazakhstan,KAZ,United Kingdom of Great Britain and Northern Ireland,GBR,0,0,5,5,10
2009,Kenya,KEN,United Kingdom of Great Britain and Northern Ireland,GBR,5,10,99,26,140
2009,Rep. of Korea,KOR,United Kingdom of Great Britain and Northern Ireland,GBR,0,0,10,0,10
2009,Dem. People's Rep. of Korea,PRK,United Kingdom of Great Britain and Northern Ireland,GBR,5,0,60,42,107
2009,Kuwait,KWT,United Kingdom of Great Britain and Northern Ireland,GBR,51,0,79,21,151
2009,Liberia,LBR,United Kingdom of Great Britain and Northern Ireland,GBR,0,0,15,5,20
2009,Libya,LBY,United Kingdom of Great Britain and Northern Ireland,GBR,19,12,61,10,102
2009,Saint Lucia,LCA,United Kingdom of Great Britain and Northern Ireland,GBR,0,0,5,0,5
2009,Lebanon,LBN,United Kingdom of Great Britain and Northern Ireland,GBR,0,5,30,11,46
2009,Sri Lanka,LKA,United Kingdom of Great Britain and Northern Ireland,GBR,167,60,1343,119,1689
2009,Mauritania,MRT,United Kingdom of Great Britain and Northern Ireland,GBR,0,0,5,0,5
2009,North Macedonia,MKD,United Kingdom of Great Britain and Northern Ireland,GBR,0,0,5,0,5
2009,Rep. of Moldova,MDA,United Kingdom of Great Britain and Northern Ireland,GBR,0,0,10,10,20
2009,Mexico,MEX,United Kingdom of Great Britain and Northern Ireland,GBR,0,0,0,5,5
2009,Mali,MLI,United Kingdom of Great Britain and Northern Ireland,GBR,0,0,0,5,5
2009,Malaysia,MYS,United Kingdom of Great Britain and Northern Ireland,GBR,0,0,29,18,47
2009,Malawi,MWI,United Kingdom of Great Britain and Northern Ireland,GBR,5,10,206,17,238
2009,Mongolia,MNG,United Kingdom of Great Britain and Northern Ireland,GBR,0,10,26,5,41
2009,Morocco,MAR,United Kingdom of Great Britain and Northern Ireland,GBR,5,5,25,19,54
2009,Mozambique,MOZ,United Kingdom of Great Britain and Northern Ireland,GBR,0,0,10,0,10
2009,Mauritius,MUS,United Kingdom of Great Britain and Northern Ireland,GBR,0,0,18,5,23
2009,Myanmar,MMR,United Kingdom of Great Britain and Northern Ireland,GBR,113,13,107,0,233
2009,Namibia,NAM,United Kingdom of Great Britain and Northern Ireland,GBR,0,0,14,5,19
2009,Nepal,NPL,United Kingdom of Great Britain and Northern Ireland,GBR,0,0,16,5,21
2009,Niger,NER,United Kingdom of Great Britain and Northern Ireland,GBR,0,0,5,0,5
2009,Nicaragua,NIC,United Kingdom of Great Britain and Northern Ireland,GBR,0,0,5,0,5
2009,Nigeria,NGA,United Kingdom of Great Britain and Northern Ireland,GBR,20,37,727,214,998
2009,Pakistan,PAK,United Kingdom of Great Britain and Northern Ireland,GBR,134,32,1767,246,2179
2009,Peru,PER,United Kingdom of Great Britain and Northern Ireland,GBR,0,0,5,0,5
2009,Philippines,PHL,United Kingdom of Great Britain and Northern Ireland,GBR,0,0,5,0,5
2009,Romania,ROU,United Kingdom of Great Britain and Northern Ireland,GBR,0,0,0,5,5
2009,South Africa,ZAF,United Kingdom of Great Britain and Northern Ireland,GBR,10,19,185,25,239
2009,Russian Federation,RUS,United Kingdom of Great Britain and Northern Ireland,GBR,14,0,61,24,99
2009,Rwanda,RWA,United Kingdom of Great Britain and Northern Ireland,GBR,0,5,27,5,37
2009,Saudi Arabia,SAU,United Kingdom of Great Britain and Northern Ireland,GBR,0,5,28,10,43
2009,Serbia and Kosovo: S/RES/1244 (1999),SRB,United Kingdom of Great Britain and Northern Ireland,GBR,10,10,27,29,76
2009,Senegal,SEN,United Kingdom of Great Britain and Northern Ireland,GBR,0,0,34,0,34
2009,Seychelles,SYC,United Kingdom of Great Britain and Northern Ireland,GBR,0,0,5,0,5
2009,Sierra Leone,SLE,United Kingdom of Great Britain and Northern Ireland,GBR,5,10,62,14,91
2009,Somalia,SOM,United Kingdom of Great Britain and Northern Ireland,GBR,535,85,590,116,1326
2009,Viet Nam,VNM,United Kingdom of Great Britain and Northern Ireland,GBR,0,22,72,340,434
2009,Sudan,SDN,United Kingdom of Great Britain and Northern Ireland,GBR,101,5,161,56,323
2009,Slovakia,SVK,United Kingdom of Great Britain and Northern Ireland,GBR,0,0,0,5,5
2009,Eswatini,SWZ,United Kingdom of Great Britain and Northern Ireland,GBR,0,0,5,0,5
2009,Syrian Arab Rep.,SYR,United Kingdom of Great Britain and Northern Ireland,GBR,42,10,135,20,207
2009,United Rep. of Tanzania,TZA,United Kingdom of Great Britain and Northern Ireland,GBR,0,5,36,5,46
2009,Thailand,THA,United Kingdom of Great Britain and Northern Ireland,GBR,0,0,10,0,10
2009,Turkmenistan,TKM,United Kingdom of Great Britain and Northern Ireland,GBR,0,0,5,0,5
2009,Togo,TGO,United Kingdom of Great Britain and Northern Ireland,GBR,0,0,12,0,12
2009,Trinidad and Tobago,TTO,United Kingdom of Great Britain and Northern Ireland,GBR,0,0,24,0,24
2009,Tunisia,TUN,United Kingdom of Great Britain and Northern Ireland,GBR,0,0,20,10,30
2009,Turkey,TUR,United Kingdom of Great Britain and Northern Ireland,GBR,17,10,135,35,197
2009,Uganda,UGA,United Kingdom of Great Britain and Northern Ireland,GBR,5,5,157,10,177
2009,Ukraine,UKR,United Kingdom of Great Britain and Northern Ireland,GBR,0,0,31,26,57
2009,United States of America,USA,United Kingdom of Great Britain and Northern Ireland,GBR,0,0,17,5,22
2009,Uzbekistan,UZB,United Kingdom of Great Britain and Northern Ireland,GBR,0,0,10,0,10
2009,Venezuela (Bolivarian Republic of),VEN,United Kingdom of Great Britain and Northern Ireland,GBR,0,0,5,0,5
2009,Western Sahara,ESH,United Kingdom of Great Britain and Northern Ireland,GBR,0,0,5,0,5
2009,Yemen,YEM,United Kingdom of Great Britain and Northern Ireland,GBR,27,5,43,0,75
2009,Zambia,ZMB,United Kingdom of Great Britain and Northern Ireland,GBR,5,0,36,0,41
2009,Zimbabwe,ZWE,United Kingdom of Great Britain and Northern Ireland,GBR,2386,430,5451,166,8433
2009,Unknown ,,United Kingdom of Great Britain and Northern Ireland,GBR,64,5,61,17,147
2009,Chad,TCD,Ghana,GHA,0,0,23,0,23
2009,Cameroon,CMR,Ghana,GHA,0,0,5,0,5
2009,Congo,COG,Ghana,GHA,11,0,0,0,11
2009,Dem. Rep. of the Congo,COD,Ghana,GHA,15,0,5,0,20
2009,Palestinian,PSE,Ghana,GHA,0,0,0,5,5
2009,Cote d'Ivoire,CIV,Ghana,GHA,5,0,11,0,16
2009,Nigeria,NGA,Ghana,GHA,0,0,10,0,10
2009,Rwanda,RWA,Ghana,GHA,5,0,0,0,5
2009,Somalia,SOM,Ghana,GHA,17,0,0,0,17
2009,Sudan,SDN,Ghana,GHA,23,0,0,0,23
2009,Togo,TGO,Ghana,GHA,10,0,0,0,10
2009,Congo,COG,Guinea-Bissau,GNB,5,0,0,0,5
2009,Liberia,LBR,Guinea-Bissau,GNB,5,0,0,0,5
2009,Sierra Leone,SLE,Guinea-Bissau,GNB,5,0,29,0,34
2009,Afghanistan,AFG,Greece,GRC,0,0,1580,39,1619
2009,Albania,ALB,Greece,GRC,0,0,466,44,510
2009,Algeria,DZA,Greece,GRC,0,0,27,0,27
2009,Egypt,EGY,Greece,GRC,0,0,102,5,107
2009,Armenia,ARM,Greece,GRC,0,0,75,5,80
2009,Burundi,BDI,Greece,GRC,0,0,5,0,5
2009,Bangladesh,BGD,Greece,GRC,0,0,1670,0,1670
2009,Burkina Faso,BFA,Greece,GRC,0,0,60,0,60
2009,Belarus,BLR,Greece,GRC,0,0,10,0,10
2009,Bulgaria,BGR,Greece,GRC,0,0,5,0,5
2009,China,CHN,Greece,GRC,0,0,223,5,228
2009,Chile,CHL,Greece,GRC,0,0,5,0,5
2009,Cameroon,CMR,Greece,GRC,0,0,26,0,26
2009,Dem. Rep. of the Congo,COD,Greece,GRC,0,0,14,0,14
2009,Dominica,DMA,Greece,GRC,0,0,10,0,10
2009,Dominican Rep.,DOM,Greece,GRC,0,0,26,0,26
2009,Eritrea,ERI,Greece,GRC,0,0,27,5,32
2009,Ethiopia,ETH,Greece,GRC,0,0,165,0,165
2009,Gambia,GMB,Greece,GRC,0,0,13,0,13
2009,Georgia,GEO,Greece,GRC,0,0,1665,92,1757
2009,Ghana,GHA,Greece,GRC,0,0,166,5,171
2009,Guinea,GIN,Greece,GRC,0,0,102,5,107
2009,Cote d'Ivoire,CIV,Greece,GRC,0,0,23,0,23
2009,India,IND,Greece,GRC,0,0,130,5,135
2009,Indonesia,IDN,Greece,GRC,0,0,129,0,129
2009,Iran (Islamic Rep. of),IRN,Greece,GRC,0,16,298,0,314
2009,Iraq,IRQ,Greece,GRC,0,0,878,26,904
2009,Kazakhstan,KAZ,Greece,GRC,0,0,10,0,10
2009,Kenya,KEN,Greece,GRC,0,0,67,0,67
2009,Liberia,LBR,Greece,GRC,0,0,5,0,5
2009,Libya,LBY,Greece,GRC,0,0,5,0,5
2009,Lebanon,LBN,Greece,GRC,0,0,20,0,20
2009,Sri Lanka,LKA,Greece,GRC,0,0,119,0,119
2009,Mauritania,MRT,Greece,GRC,0,0,38,0,38
2009,Rep. of Moldova,MDA,Greece,GRC,0,0,88,5,93
2009,Mali,MLI,Greece,GRC,0,0,5,0,5
2009,Morocco,MAR,Greece,GRC,0,0,98,0,98
2009,Myanmar,MMR,Greece,GRC,0,0,20,5,25
2009,Nepal,NPL,Greece,GRC,0,0,5,0,5
2009,Niger,NER,Greece,GRC,0,0,5,0,5
2009,Nigeria,NGA,Greece,GRC,0,0,710,66,776
2009,Pakistan,PAK,Greece,GRC,0,0,3080,25,3105
2009,Philippines,PHL,Greece,GRC,0,0,79,5,84
2009,Russian Federation,RUS,Greece,GRC,0,0,84,20,104
2009,Rwanda,RWA,Greece,GRC,0,0,13,0,13
2009,Serbia and Kosovo: S/RES/1244 (1999),SRB,Greece,GRC,0,0,5,0,5
2009,Senegal,SEN,Greece,GRC,0,0,354,0,354
2009,Sierra Leone,SLE,Greece,GRC,0,0,33,0,33
2009,Somalia,SOM,Greece,GRC,0,0,127,0,127
2009,Sudan,SDN,Greece,GRC,0,0,118,0,118
2009,Syrian Arab Rep.,SYR,Greece,GRC,0,0,891,10,901
2009,United Rep. of Tanzania,TZA,Greece,GRC,0,0,17,0,17
2009,Togo,TGO,Greece,GRC,0,0,5,0,5
2009,Tunisia,TUN,Greece,GRC,0,0,5,0,5
2009,Turkey,TUR,Greece,GRC,0,0,48,10,58
2009,Uganda,UGA,Greece,GRC,0,0,5,0,5
2009,Ukraine,UKR,Greece,GRC,0,0,48,0,48
2009,Uzbekistan,UZB,Greece,GRC,0,0,5,0,5
2009,Unknown ,,Greece,GRC,11,19,176,11,217
2009,Bhutan,BTN,Guatemala,GTM,0,0,0,5,5
2009,China,CHN,Guatemala,GTM,0,0,0,5,5
2009,Cuba,CUB,Guatemala,GTM,0,0,0,10,10
2009,Nepal,NPL,Guatemala,GTM,0,0,0,5,5
2009,Somalia,SOM,Guatemala,GTM,0,0,0,5,5
2009,Bangladesh,BGD,Honduras,HND,0,0,0,5,5
2009,Colombia,COL,Honduras,HND,5,0,0,5,10
2009,Cuba,CUB,Honduras,HND,0,0,0,5,5
2009,Nepal,NPL,Honduras,HND,0,0,0,5,5
2009,Somalia,SOM,Honduras,HND,0,0,0,14,14
2009,Afghanistan,AFG,Croatia,HRV,0,0,0,15,15
2009,Bosnia and Herzegovina,BIH,Croatia,HRV,0,0,11,5,16
2009,Congo,COG,Croatia,HRV,0,0,5,0,5
2009,Czechia,CZE,Croatia,HRV,0,0,14,0,14
2009,Iran (Islamic Rep. of),IRN,Croatia,HRV,0,0,5,5,10
2009,North Macedonia,MKD,Croatia,HRV,0,0,0,5,5
2009,Nigeria,NGA,Croatia,HRV,0,0,5,0,5
2009,Pakistan,PAK,Croatia,HRV,0,0,13,5,18
2009,Russian Federation,RUS,Croatia,HRV,0,0,10,0,10
2009,Serbia and Kosovo: S/RES/1244 (1999),SRB,Croatia,HRV,0,0,15,18,33
2009,Turkey,TUR,Croatia,HRV,0,0,0,5,5
2009,Ukraine,UKR,Croatia,HRV,0,0,5,0,5
2009,Uzbekistan,UZB,Croatia,HRV,5,0,0,0,5
2009,Afghanistan,AFG,Iceland,ISL,0,0,0,5,5
2009,Albania,ALB,Iceland,ISL,0,5,0,5,10
2009,Iran (Islamic Rep. of),IRN,Iceland,ISL,5,0,0,0,5
2009,Iraq,IRQ,Iceland,ISL,0,0,0,5,5
2009,Serbia and Kosovo: S/RES/1244 (1999),SRB,Iceland,ISL,0,5,0,0,5
2009,Syrian Arab Rep.,SYR,Iceland,ISL,0,0,0,5,5
2009,Afghanistan,AFG,Ireland,IRL,0,0,57,5,62
2009,Albania,ALB,Ireland,IRL,0,0,53,13,66
2009,Algeria,DZA,Ireland,IRL,0,0,67,18,85
2009,Angola,AGO,Ireland,IRL,0,0,27,5,32
2009,Egypt,EGY,Ireland,IRL,0,0,20,25,45
2009,Armenia,ARM,Ireland,IRL,0,0,5,0,5
2009,Burundi,BDI,Ireland,IRL,0,0,5,0,5
2009,Benin,BEN,Ireland,IRL,0,0,10,0,10
2009,Bangladesh,BGD,Ireland,IRL,0,0,50,0,50
2009,Bhutan,BTN,Ireland,IRL,0,0,15,0,15
2009,Belarus,BLR,Ireland,IRL,0,0,13,5,18
2009,Botswana,BWA,Ireland,IRL,0,0,5,0,5
2009,Brazil,BRA,Ireland,IRL,0,0,10,5,15
2009,Chad,TCD,Ireland,IRL,0,0,5,0,5
2009,China,CHN,Ireland,IRL,5,0,68,153,226
2009,Cameroon,CMR,Ireland,IRL,0,0,46,5,51
2009,Congo,COG,Ireland,IRL,0,0,12,0,12
2009,Dem. Rep. of the Congo,COD,Ireland,IRL,0,0,123,23,146
2009,Cabo Verde,CPV,Ireland,IRL,0,0,5,0,5
2009,Eritrea,ERI,Ireland,IRL,10,0,37,26,73
2009,Ethiopia,ETH,Ireland,IRL,5,0,11,5,21
2009,Gambia,GMB,Ireland,IRL,0,0,5,0,5
2009,Palestinian,PSE,Ireland,IRL,5,0,15,13,33
2009,Georgia,GEO,Ireland,IRL,0,0,122,45,167
2009,Ghana,GHA,Ireland,IRL,0,0,115,10,125
2009,Guinea,GIN,Ireland,IRL,0,0,16,5,21
2009,Guyana,GUY,Ireland,IRL,0,0,5,0,5
2009,Croatia,HRV,Ireland,IRL,0,0,10,0,10
2009,Cote d'Ivoire,CIV,Ireland,IRL,0,0,13,0,13
2009,India,IND,Ireland,IRL,0,0,19,14,33
2009,Iran (Islamic Rep. of),IRN,Ireland,IRL,5,0,33,21,59
2009,Iraq,IRQ,Ireland,IRL,21,0,85,36,142
2009,Israel,ISR,Ireland,IRL,0,0,10,0,10
2009,Kenya,KEN,Ireland,IRL,0,0,21,0,21
2009,Kuwait,KWT,Ireland,IRL,0,0,5,5,10
2009,Liberia,LBR,Ireland,IRL,0,0,23,5,28
2009,Sri Lanka,LKA,Ireland,IRL,0,0,12,5,17
2009,Rep. of Moldova,MDA,Ireland,IRL,0,0,92,32,124
2009,Malaysia,MYS,Ireland,IRL,0,0,5,0,5
2009,Malawi,MWI,Ireland,IRL,0,0,11,5,16
2009,Mongolia,MNG,Ireland,IRL,0,0,5,13,18
2009,Morocco,MAR,Ireland,IRL,0,0,11,5,16
2009,Mauritius,MUS,Ireland,IRL,0,0,15,0,15
2009,Myanmar,MMR,Ireland,IRL,0,0,10,0,10
2009,Nepal,NPL,Ireland,IRL,0,0,11,0,11
2009,Niger,NER,Ireland,IRL,0,0,5,0,5
2009,Nigeria,NGA,Ireland,IRL,0,0,521,91,612
2009,Pakistan,PAK,Ireland,IRL,5,0,239,67,311
2009,South Africa,ZAF,Ireland,IRL,0,0,57,10,67
2009,Russian Federation,RUS,Ireland,IRL,0,0,26,10,36
2009,Rwanda,RWA,Ireland,IRL,0,0,5,0,5
2009,Serbia and Kosovo: S/RES/1244 (1999),SRB,Ireland,IRL,0,0,27,5,32
2009,Sierra Leone,SLE,Ireland,IRL,0,0,21,5,26
2009,Somalia,SOM,Ireland,IRL,12,0,115,48,175
2009,Sudan,SDN,Ireland,IRL,16,0,75,22,113
2009,Eswatini,SWZ,Ireland,IRL,0,0,5,0,5
2009,Syrian Arab Rep.,SYR,Ireland,IRL,0,0,5,0,5
2009,Togo,TGO,Ireland,IRL,0,0,12,0,12
2009,Uganda,UGA,Ireland,IRL,5,0,34,5,44
2009,Ukraine,UKR,Ireland,IRL,0,0,22,5,27
2009,Zimbabwe,ZWE,Ireland,IRL,5,0,106,10,121
2009,Benin,BEN,Israel,ISR,0,0,5,0,5
2009,Burkina Faso,BFA,Israel,ISR,0,0,5,0,5
2009,Cameroon,CMR,Israel,ISR,0,0,5,0,5
2009,Colombia,COL,Israel,ISR,0,0,32,0,32
2009,Ethiopia,ETH,Israel,ISR,0,0,35,0,35
2009,Georgia,GEO,Israel,ISR,0,0,275,0,275
2009,Ghana,GHA,Israel,ISR,0,0,132,0,132
2009,Guinea-Bissau,GNB,Israel,ISR,0,0,5,0,5
2009,Guinea,GIN,Israel,ISR,0,0,26,0,26
2009,Cote d'Ivoire,CIV,Israel,ISR,0,0,162,0,162
2009,India,IND,Israel,ISR,0,0,10,0,10
2009,Sri Lanka,LKA,Israel,ISR,0,0,10,0,10
2009,Mali,MLI,Israel,ISR,0,0,10,0,10
2009,Nepal,NPL,Israel,ISR,0,0,5,0,5
2009,Niger,NER,Israel,ISR,0,0,10,0,10
2009,Nigeria,NGA,Israel,ISR,0,0,239,0,239
2009,Philippines,PHL,Israel,ISR,0,0,28,0,28
2009,Togo,TGO,Israel,ISR,0,0,5,0,5
2009,Turkey,TUR,Israel,ISR,0,0,40,0,40
2009,Unknown ,,Israel,ISR,0,0,70,0,70
2009,Afghanistan,AFG,Italy,ITA,214,526,111,73,924
2009,Albania,ALB,Italy,ITA,10,29,36,0,75
2009,Algeria,DZA,Italy,ITA,14,15,353,10,392
2009,Angola,AGO,Italy,ITA,0,10,5,0,15
2009,Egypt,EGY,Italy,ITA,0,5,31,5,41
2009,Armenia,ARM,Italy,ITA,0,5,5,0,10
2009,Azerbaijan,AZE,Italy,ITA,5,0,5,0,10
2009,Benin,BEN,Italy,ITA,5,15,37,5,62
2009,Bangladesh,BGD,Italy,ITA,16,126,792,967,1901
2009,Burkina Faso,BFA,Italy,ITA,17,82,360,15,474
2009,Bolivia (Plurinational State of),BOL,Italy,ITA,0,0,5,0,5
2009,Brazil,BRA,Italy,ITA,0,5,12,5,22
2009,Bosnia and Herzegovina,BIH,Italy,ITA,0,26,5,5,36
2009,Central African Rep.,CAF,Italy,ITA,0,5,0,0,5
2009,Chad,TCD,Italy,ITA,5,12,10,0,27
2009,China,CHN,Italy,ITA,21,5,17,0,43
2009,Cameroon,CMR,Italy,ITA,42,46,61,13,162
2009,Congo,COG,Italy,ITA,26,27,27,5,85
2009,Dem. Rep. of the Congo,COD,Italy,ITA,27,10,11,0,48
2009,Colombia,COL,Italy,ITA,10,11,5,0,26
2009,Cuba,CUB,Italy,ITA,5,27,10,5,47
2009,Eritrea,ERI,Italy,ITA,411,935,352,25,1723
2009,Ethiopia,ETH,Italy,ITA,55,68,43,5,171
2009,Gabon,GAB,Italy,ITA,0,0,5,0,5
2009,Gambia,GMB,Italy,ITA,13,71,419,13,516
2009,Palestinian,PSE,Italy,ITA,142,16,34,5,197
2009,Georgia,GEO,Italy,ITA,5,29,44,5,83
2009,Ghana,GHA,Italy,ITA,10,152,1027,52,1241
2009,Guinea-Bissau,GNB,Italy,ITA,0,5,17,0,22
2009,Guatemala,GTM,Italy,ITA,0,0,5,0,5
2009,Guinea,GIN,Italy,ITA,54,90,188,14,346
2009,Croatia,HRV,Italy,ITA,0,13,0,0,13
2009,Cote d'Ivoire,CIV,Italy,ITA,76,370,502,35,983
2009,India,IND,Italy,ITA,5,25,152,20,202
2009,Iran (Islamic Rep. of),IRN,Italy,ITA,103,37,25,12,177
2009,Iraq,IRQ,Italy,ITA,148,260,77,44,529
2009,Jordan,JOR,Italy,ITA,0,0,5,0,5
2009,Kenya,KEN,Italy,ITA,10,15,35,0,60
2009,Liberia,LBR,Italy,ITA,0,28,95,12,135
2009,Libya,LBY,Italy,ITA,0,5,5,0,10
2009,Lebanon,LBN,Italy,ITA,17,18,33,5,73
2009,Sri Lanka,LKA,Italy,ITA,25,89,62,10,186
2009,Madagascar,MDG,Italy,ITA,0,5,0,0,5
2009,Mauritania,MRT,Italy,ITA,10,21,30,5,66
2009,North Macedonia,MKD,Italy,ITA,0,5,5,5,15
2009,Rep. of Moldova,MDA,Italy,ITA,0,10,14,5,29
2009,Mali,MLI,Italy,ITA,5,31,218,10,264
2009,Morocco,MAR,Italy,ITA,5,28,146,14,193
2009,Montenegro,MNE,Italy,ITA,0,13,5,0,18
2009,Myanmar,MMR,Italy,ITA,0,5,0,0,5
2009,Nepal,NPL,Italy,ITA,0,15,0,5,20
2009,Niger,NER,Italy,ITA,5,21,71,0,97
2009,Nigeria,NGA,Italy,ITA,45,656,4643,158,5502
2009,Pakistan,PAK,Italy,ITA,67,304,916,227,1514
2009,Peru,PER,Italy,ITA,0,5,14,0,19
2009,Russian Federation,RUS,Italy,ITA,5,17,5,0,27
2009,El Salvador,SLV,Italy,ITA,0,10,12,5,27
2009,Serbia and Kosovo: S/RES/1244 (1999),SRB,Italy,ITA,27,187,212,43,469
2009,Senegal,SEN,Italy,ITA,16,29,101,5,151
2009,Sierra Leone,SLE,Italy,ITA,5,17,64,5,91
2009,Somalia,SOM,Italy,ITA,252,2248,123,24,2647
2009,Sudan,SDN,Italy,ITA,77,47,82,5,211
2009,Syrian Arab Rep.,SYR,Italy,ITA,54,26,21,0,101
2009,Togo,TGO,Italy,ITA,37,61,130,10,238
2009,Tunisia,TUN,Italy,ITA,5,28,294,21,348
2009,Turkey,TUR,Italy,ITA,84,270,172,31,557
2009,Uganda,UGA,Italy,ITA,0,0,5,0,5
2009,Ukraine,UKR,Italy,ITA,5,10,5,0,20
2009,Zimbabwe,ZWE,Italy,ITA,5,5,15,5,30
2009,Unknown ,,Italy,ITA,22,49,69,5,145
2009,Afghanistan,AFG,Japan,JPN,5,0,10,0,15
2009,Bangladesh,BGD,Japan,JPN,0,5,14,5,24
2009,China,CHN,Japan,JPN,0,17,30,0,47
2009,Cameroon,CMR,Japan,JPN,0,5,20,0,25
2009,Dem. Rep. of the Congo,COD,Japan,JPN,0,0,10,0,10
2009,Colombia,COL,Japan,JPN,0,0,5,0,5
2009,Ethiopia,ETH,Japan,JPN,0,0,35,5,40
2009,Ghana,GHA,Japan,JPN,0,0,5,0,5
2009,Guinea,GIN,Japan,JPN,0,0,5,0,5
2009,India,IND,Japan,JPN,0,0,17,10,27
2009,Iran (Islamic Rep. of),IRN,Japan,JPN,0,0,47,10,57
2009,Iraq,IRQ,Japan,JPN,0,0,0,5,5
2009,Sri Lanka,LKA,Japan,JPN,0,0,102,27,129
2009,Myanmar,MMR,Japan,JPN,15,460,1092,16,1583
2009,Nepal,NPL,Japan,JPN,0,0,18,0,18
2009,Nigeria,NGA,Japan,JPN,0,0,17,5,22
2009,Pakistan,PAK,Japan,JPN,0,0,61,10,71
2009,Philippines,PHL,Japan,JPN,0,0,10,5,15
2009,Viet Nam,VNM,Japan,JPN,0,0,5,0,5
2009,Sudan,SDN,Japan,JPN,0,0,13,0,13
2009,Turkey,TUR,Japan,JPN,0,0,124,18,142
2009,Uganda,UGA,Japan,JPN,0,0,13,0,13
2009,Unknown ,,Japan,JPN,0,18,48,10,76
2009,Afghanistan,AFG,Kyrgyzstan,KGZ,5,0,143,11,159
2009,Kazakhstan,KAZ,Kyrgyzstan,KGZ,0,0,5,0,5
2009,Pakistan,PAK,Kyrgyzstan,KGZ,0,0,5,0,5
2009,Russian Federation,RUS,Kyrgyzstan,KGZ,0,0,0,80,80
2009,Uzbekistan,UZB,Kyrgyzstan,KGZ,0,0,5,100,105
2009,Azerbaijan,AZE,Liechtenstein,LIE,0,0,0,5,5
2009,Eritrea,ERI,Liechtenstein,LIE,0,0,29,65,94
2009,Kyrgyzstan,KGZ,Liechtenstein,LIE,0,0,5,0,5
2009,Russian Federation,RUS,Liechtenstein,LIE,0,0,5,14,19
2009,Serbia and Kosovo: S/RES/1244 (1999),SRB,Liechtenstein,LIE,0,0,5,5,10
2009,Somalia,SOM,Liechtenstein,LIE,0,0,25,76,101
2009,Syrian Arab Rep.,SYR,Liechtenstein,LIE,0,0,0,5,5
2009,Ukraine,UKR,Liechtenstein,LIE,0,0,0,5,5
2009,Afghanistan,AFG,Lithuania,LTU,0,5,0,0,5
2009,Belarus,BLR,Lithuania,LTU,0,0,0,5,5
2009,Cuba,CUB,Lithuania,LTU,0,0,5,0,5
2009,Georgia,GEO,Lithuania,LTU,0,0,18,31,49
2009,India,IND,Lithuania,LTU,0,0,0,5,5
2009,Iraq,IRQ,Lithuania,LTU,0,0,0,10,10
2009,Sri Lanka,LKA,Lithuania,LTU,0,5,0,0,5
2009,Pakistan,PAK,Lithuania,LTU,0,0,5,0,5
2009,Russian Federation,RUS,Lithuania,LTU,5,20,61,28,114
2009,Syrian Arab Rep.,SYR,Lithuania,LTU,0,0,0,5,5
2009,Stateless,XXA,Lithuania,LTU,0,0,5,0,5
2009,Albania,ALB,Luxembourg,LUX,11,0,15,5,31
2009,Algeria,DZA,Luxembourg,LUX,0,0,5,10,15
2009,Benin,BEN,Luxembourg,LUX,0,0,5,0,5
2009,Belarus,BLR,Luxembourg,LUX,0,0,5,5,10
2009,Bosnia and Herzegovina,BIH,Luxembourg,LUX,0,0,15,14,29
2009,Cameroon,CMR,Luxembourg,LUX,0,0,0,5,5
2009,Eritrea,ERI,Luxembourg,LUX,0,0,5,5,10
2009,Ethiopia,ETH,Luxembourg,LUX,0,0,0,5,5
2009,Georgia,GEO,Luxembourg,LUX,0,0,0,5,5
2009,Guinea,GIN,Luxembourg,LUX,0,0,0,5,5
2009,Iran (Islamic Rep. of),IRN,Luxembourg,LUX,5,0,0,16,21
2009,Iraq,IRQ,Luxembourg,LUX,24,0,0,11,35
2009,Israel,ISR,Luxembourg,LUX,0,0,5,0,5
2009,Montenegro,MNE,Luxembourg,LUX,0,0,5,5,10
2009,Niger,NER,Luxembourg,LUX,0,0,0,10,10
2009,Romania,ROU,Luxembourg,LUX,0,0,0,5,5
2009,Russian Federation,RUS,Luxembourg,LUX,13,0,10,19,42
2009,Serbia and Kosovo: S/RES/1244 (1999),SRB,Luxembourg,LUX,13,0,108,61,182
2009,Somalia,SOM,Luxembourg,LUX,5,0,0,5,10
2009,Togo,TGO,Luxembourg,LUX,0,0,5,0,5
2009,Uzbekistan,UZB,Luxembourg,LUX,0,0,5,0,5
2009,Afghanistan,AFG,Latvia,LVA,0,0,5,0,5
2009,Georgia,GEO,Latvia,LVA,0,0,5,5,10
2009,Russian Federation,RUS,Latvia,LVA,5,0,0,0,5
2009,Syrian Arab Rep.,SYR,Latvia,LVA,0,0,5,0,5
2009,China,CHN,Mexico,MEX,0,0,0,5,5
2009,Dem. Rep. of the Congo,COD,Mexico,MEX,5,0,0,0,5
2009,Colombia,COL,Mexico,MEX,25,0,10,11,46
2009,Cuba,CUB,Mexico,MEX,0,0,21,13,34
2009,Ghana,GHA,Mexico,MEX,0,0,5,0,5
2009,Guatemala,GTM,Mexico,MEX,5,0,15,19,39
2009,Haiti,HTI,Mexico,MEX,26,0,23,5,54
2009,Honduras,HND,Mexico,MEX,5,0,72,100,177
2009,India,IND,Mexico,MEX,5,0,0,15,20
2009,Iran (Islamic Rep. of),IRN,Mexico,MEX,5,0,0,0,5
2009,Iraq,IRQ,Mexico,MEX,5,0,0,0,5
2009,Sri Lanka,LKA,Mexico,MEX,10,0,0,0,10
2009,Nicaragua,NIC,Mexico,MEX,0,0,13,16,29
2009,Nigeria,NGA,Mexico,MEX,5,0,5,0,10
2009,Peru,PER,Mexico,MEX,0,0,5,0,5
2009,El Salvador,SLV,Mexico,MEX,12,0,63,40,115
2009,Sierra Leone,SLE,Mali,MLI,0,0,0,364,364
2009,Burundi,BDI,Malawi,MWI,112,0,61,1042,1215
2009,Dem. Rep. of the Congo,COD,Malawi,MWI,303,0,23,610,936
2009,Ethiopia,ETH,Malawi,MWI,0,0,10,0,10
2009,Rwanda,RWA,Malawi,MWI,91,0,82,1603,1776
2009,Somalia,SOM,Malawi,MWI,28,0,0,10,38
2009,Zambia,ZMB,Malawi,MWI,0,0,5,0,5
2009,Zimbabwe,ZWE,Malawi,MWI,0,0,0,5,5
2009,Angola,AGO,Mozambique,MOZ,5,0,0,0,5
2009,Burundi,BDI,Mozambique,MOZ,150,0,42,283,475
2009,Dem. Rep. of the Congo,COD,Mozambique,MOZ,322,0,197,538,1057
2009,Rwanda,RWA,Mozambique,MOZ,24,0,27,69,120
2009,Somalia,SOM,Mozambique,MOZ,5,0,0,69,74
2009,Uganda,UGA,Mozambique,MOZ,0,0,0,5,5
2009,Algeria,DZA,Malta,MLT,0,0,5,0,5
2009,Bangladesh,BGD,Malta,MLT,0,0,19,0,19
2009,Burkina Faso,BFA,Malta,MLT,0,0,21,5,26
2009,Chad,TCD,Malta,MLT,0,0,5,0,5
2009,Eritrea,ERI,Malta,MLT,5,194,23,0,222
2009,Ethiopia,ETH,Malta,MLT,5,0,16,5,26
2009,Gambia,GMB,Malta,MLT,0,0,17,0,17
2009,Palestinian,PSE,Malta,MLT,0,0,14,0,14
2009,Georgia,GEO,Malta,MLT,0,5,0,0,5
2009,Ghana,GHA,Malta,MLT,0,0,40,5,45
2009,Guinea,GIN,Malta,MLT,0,0,24,5,29
2009,Cote d'Ivoire,CIV,Malta,MLT,0,0,77,17,94
2009,India,IND,Malta,MLT,0,0,10,0,10
2009,Iraq,IRQ,Malta,MLT,0,0,5,0,5
2009,Liberia,LBR,Malta,MLT,0,0,10,0,10
2009,Mali,MLI,Malta,MLT,0,5,133,18,156
2009,Morocco,MAR,Malta,MLT,0,0,5,0,5
2009,Niger,NER,Malta,MLT,0,0,24,5,29
2009,Nigeria,NGA,Malta,MLT,0,0,278,11,289
2009,Somalia,SOM,Malta,MLT,5,1446,132,5,1588
2009,Sudan,SDN,Malta,MLT,0,23,22,0,45
2009,Syrian Arab Rep.,SYR,Malta,MLT,5,0,0,0,5
2009,Togo,TGO,Malta,MLT,0,0,15,0,15
2009,Burundi,BDI,Namibia,NAM,17,0,5,0,22
2009,Dem. Rep. of the Congo,COD,Namibia,NAM,114,0,101,23,238
2009,Rwanda,RWA,Namibia,NAM,0,0,16,0,16
2009,Sudan,SDN,Namibia,NAM,5,0,0,0,5
2009,United Rep. of Tanzania,TZA,Namibia,NAM,0,0,5,0,5
2009,Zimbabwe,ZWE,Namibia,NAM,5,0,22,0,27
2009,Bhutan,BTN,Nepal,NPL,0,17,0,5,22
2009,Afghanistan,AFG,Netherlands,NLD,22,263,591,0,876
2009,Albania,ALB,Netherlands,NLD,0,0,11,0,11
2009,Algeria,DZA,Netherlands,NLD,0,0,29,0,29
2009,Angola,AGO,Netherlands,NLD,0,19,57,0,76
2009,Egypt,EGY,Netherlands,NLD,5,12,20,0,37
2009,Argentina,ARG,Netherlands,NLD,0,0,5,0,5
2009,Armenia,ARM,Netherlands,NLD,10,62,218,0,290
2009,Azerbaijan,AZE,Netherlands,NLD,12,43,61,0,116
2009,Burundi,BDI,Netherlands,NLD,0,59,74,0,133
2009,Benin,BEN,Netherlands,NLD,0,0,5,0,5
2009,Bangladesh,BGD,Netherlands,NLD,0,0,13,0,13
2009,Bhutan,BTN,Netherlands,NLD,24,23,5,0,52
2009,Burkina Faso,BFA,Netherlands,NLD,0,0,14,0,14
2009,Belarus,BLR,Netherlands,NLD,0,0,13,0,13
2009,Bosnia and Herzegovina,BIH,Netherlands,NLD,0,0,13,0,13
2009,Cambodia,KHM,Netherlands,NLD,0,5,0,0,5
2009,Central African Rep.,CAF,Netherlands,NLD,0,0,5,0,5
2009,Chad,TCD,Netherlands,NLD,0,0,5,0,5
2009,China,CHN,Netherlands,NLD,55,59,152,0,266
2009,Cameroon,CMR,Netherlands,NLD,0,10,21,0,31
2009,Congo,COG,Netherlands,NLD,5,48,66,0,119
2009,Dem. Rep. of the Congo,COD,Netherlands,NLD,5,43,25,0,73
2009,Colombia,COL,Netherlands,NLD,0,15,31,0,46
2009,Cuba,CUB,Netherlands,NLD,0,0,5,0,5
2009,Eritrea,ERI,Netherlands,NLD,18,223,149,0,390
2009,Ethiopia,ETH,Netherlands,NLD,23,54,40,0,117
2009,Gambia,GMB,Netherlands,NLD,0,0,16,0,16
2009,Palestinian,PSE,Netherlands,NLD,0,14,36,0,50
2009,Georgia,GEO,Netherlands,NLD,0,5,99,0,104
2009,Ghana,GHA,Netherlands,NLD,0,0,25,0,25
2009,Guinea,GIN,Netherlands,NLD,5,96,187,0,288
2009,Cote d'Ivoire,CIV,Netherlands,NLD,5,57,38,0,100
2009,India,IND,Netherlands,NLD,0,0,33,0,33
2009,Indonesia,IDN,Netherlands,NLD,0,0,10,0,10
2009,Iran (Islamic Rep. of),IRN,Netherlands,NLD,91,138,279,0,508
2009,Iraq,IRQ,Netherlands,NLD,200,1643,2510,0,4353
2009,Israel,ISR,Netherlands,NLD,0,0,5,0,5
2009,Jamaica,JAM,Netherlands,NLD,5,0,0,0,5
2009,Kazakhstan,KAZ,Netherlands,NLD,0,5,10,0,15
2009,Kenya,KEN,Netherlands,NLD,0,5,24,0,29
2009,Kyrgyzstan,KGZ,Netherlands,NLD,0,0,5,0,5
2009,Liberia,LBR,Netherlands,NLD,0,20,23,0,43
2009,Libya,LBY,Netherlands,NLD,5,92,16,0,113
2009,Lebanon,LBN,Netherlands,NLD,0,5,10,0,15
2009,Sri Lanka,LKA,Netherlands,NLD,15,59,170,0,244
2009,Mauritania,MRT,Netherlands,NLD,0,0,5,0,5
2009,Malawi,MWI,Netherlands,NLD,0,0,5,0,5
2009,Mongolia,MNG,Netherlands,NLD,0,5,123,0,128
2009,Morocco,MAR,Netherlands,NLD,0,0,17,0,17
2009,Myanmar,MMR,Netherlands,NLD,10,85,15,0,110
2009,Nepal,NPL,Netherlands,NLD,12,30,60,0,102
2009,Niger,NER,Netherlands,NLD,0,5,5,0,10
2009,Nigeria,NGA,Netherlands,NLD,0,19,122,0,141
2009,Pakistan,PAK,Netherlands,NLD,5,5,32,0,42
2009,South Africa,ZAF,Netherlands,NLD,0,0,5,0,5
2009,Russian Federation,RUS,Netherlands,NLD,0,20,106,0,126
2009,Rwanda,RWA,Netherlands,NLD,0,17,10,0,27
2009,Serbia and Kosovo: S/RES/1244 (1999),SRB,Netherlands,NLD,0,5,71,0,76
2009,Senegal,SEN,Netherlands,NLD,0,0,5,0,5
2009,Sierra Leone,SLE,Netherlands,NLD,0,104,130,0,234
2009,Somalia,SOM,Netherlands,NLD,93,3443,1925,0,5461
2009,Viet Nam,VNM,Netherlands,NLD,5,0,10,0,15
2009,Sudan,SDN,Netherlands,NLD,5,37,84,0,126
2009,Suriname,SUR,Netherlands,NLD,0,0,5,0,5
2009,Syrian Arab Rep.,SYR,Netherlands,NLD,10,16,68,0,94
2009,United Rep. of Tanzania,TZA,Netherlands,NLD,0,0,5,0,5
2009,Tajikistan,TJK,Netherlands,NLD,0,0,5,0,5
2009,Togo,TGO,Netherlands,NLD,0,5,17,0,22
2009,Tunisia,TUN,Netherlands,NLD,0,5,10,0,15
2009,Turkey,TUR,Netherlands,NLD,5,5,60,0,70
2009,Uganda,UGA,Netherlands,NLD,0,13,37,0,50
2009,Ukraine,UKR,Netherlands,NLD,0,0,18,0,18
2009,Uzbekistan,UZB,Netherlands,NLD,0,5,17,0,22
2009,Venezuela (Bolivarian Republic of),VEN,Netherlands,NLD,0,0,5,0,5
2009,Yemen,YEM,Netherlands,NLD,0,10,0,0,10
2009,Zimbabwe,ZWE,Netherlands,NLD,0,5,5,0,10
2009,Stateless,XXA,Netherlands,NLD,5,32,60,0,97
2009,Unknown ,,Netherlands,NLD,27,244,271,0,542
2009,Chad,TCD,Niger,NER,0,0,0,5,5
2009,Colombia,COL,Nicaragua,NIC,5,0,0,0,5
2009,Eritrea,ERI,Nicaragua,NIC,0,0,0,89,89
2009,Ethiopia,ETH,Nicaragua,NIC,0,0,0,17,17
2009,Honduras,HND,Nicaragua,NIC,49,0,0,0,49
2009,Nepal,NPL,Nicaragua,NIC,0,0,0,18,18
2009,Somalia,SOM,Nicaragua,NIC,14,0,0,75,89
2009,Afghanistan,AFG,Norway,NOR,138,841,996,862,2837
2009,Albania,ALB,Norway,NOR,0,0,23,13,36
2009,Algeria,DZA,Norway,NOR,0,0,57,87,144
2009,Angola,AGO,Norway,NOR,0,0,5,5,10
2009,Egypt,EGY,Norway,NOR,0,0,5,13,18
2009,Armenia,ARM,Norway,NOR,0,0,10,21,31
2009,Azerbaijan,AZE,Norway,NOR,0,0,40,12,52
2009,Burundi,BDI,Norway,NOR,0,0,25,11,36
2009,Bangladesh,BGD,Norway,NOR,0,0,5,0,5
2009,Bhutan,BTN,Norway,NOR,0,0,11,0,11
2009,Burkina Faso,BFA,Norway,NOR,0,0,5,5,10
2009,Belarus,BLR,Norway,NOR,0,0,5,5,10
2009,Bosnia and Herzegovina,BIH,Norway,NOR,0,0,10,10,20
2009,Bulgaria,BGR,Norway,NOR,0,0,11,0,11
2009,China,CHN,Norway,NOR,28,15,5,5,53
2009,Cameroon,CMR,Norway,NOR,0,0,20,14,34
2009,Congo,COG,Norway,NOR,0,0,0,5,5
2009,Dem. Rep. of the Congo,COD,Norway,NOR,13,5,20,25,63
2009,Colombia,COL,Norway,NOR,0,0,5,5,10
2009,Czechia,CZE,Norway,NOR,0,0,5,5,10
2009,Ecuador,ECU,Norway,NOR,0,0,5,0,5
2009,Eritrea,ERI,Norway,NOR,604,776,87,707,2174
2009,Ethiopia,ETH,Norway,NOR,180,37,201,97,515
2009,Gambia,GMB,Norway,NOR,0,0,29,15,44
2009,Georgia,GEO,Norway,NOR,0,0,14,18,32
2009,Ghana,GHA,Norway,NOR,0,0,12,33,45
2009,Guinea,GIN,Norway,NOR,0,0,30,17,47
2009,Honduras,HND,Norway,NOR,0,0,5,0,5
2009,Croatia,HRV,Norway,NOR,0,0,13,0,13
2009,Hungary,HUN,Norway,NOR,0,0,29,0,29
2009,Cote d'Ivoire,CIV,Norway,NOR,0,0,5,11,16
2009,India,IND,Norway,NOR,0,0,37,20,57
2009,Iran (Islamic Rep. of),IRN,Norway,NOR,118,50,331,137,636
2009,Iraq,IRQ,Norway,NOR,145,222,1545,537,2449
2009,Israel,ISR,Norway,NOR,5,0,10,5,20
2009,Italy,ITA,Norway,NOR,0,0,5,0,5
2009,Jordan,JOR,Norway,NOR,0,0,11,10,21
2009,Kazakhstan,KAZ,Norway,NOR,0,0,10,13,23
2009,Kenya,KEN,Norway,NOR,0,0,5,0,5
2009,Kyrgyzstan,KGZ,Norway,NOR,0,0,16,0,16
2009,Rep. of Korea,KOR,Norway,NOR,0,0,5,5,10
2009,Dem. People's Rep. of Korea,PRK,Norway,NOR,0,0,5,0,5
2009,Liberia,LBR,Norway,NOR,0,0,13,13,26
2009,Libya,LBY,Norway,NOR,0,0,33,46,79
2009,Lebanon,LBN,Norway,NOR,0,5,11,19,35
2009,Sri Lanka,LKA,Norway,NOR,5,39,265,27,336
2009,Lithuania,LTU,Norway,NOR,0,0,5,0,5
2009,Mauritania,MRT,Norway,NOR,0,0,15,14,29
2009,North Macedonia,MKD,Norway,NOR,0,0,5,19,24
2009,Rep. of Moldova,MDA,Norway,NOR,0,0,5,10,15
2009,Morocco,MAR,Norway,NOR,0,0,21,29,50
2009,Myanmar,MMR,Norway,NOR,5,11,5,5,26
2009,Nepal,NPL,Norway,NOR,0,0,218,13,231
2009,Niger,NER,Norway,NOR,0,0,10,5,15
2009,Nigeria,NGA,Norway,NOR,0,10,367,215,592
2009,Pakistan,PAK,Norway,NOR,0,0,48,36,84
2009,Poland,POL,Norway,NOR,0,0,5,0,5
2009,Russian Federation,RUS,Norway,NOR,5,47,466,226,744
2009,Rwanda,RWA,Norway,NOR,0,5,5,0,10
2009,Serbia and Kosovo: S/RES/1244 (1999),SRB,Norway,NOR,0,5,219,163,387
2009,Senegal,SEN,Norway,NOR,0,0,11,10,21
2009,Sierra Leone,SLE,Norway,NOR,0,0,10,12,22
2009,Somalia,SOM,Norway,NOR,296,350,64,834,1544
2009,Viet Nam,VNM,Norway,NOR,0,0,13,10,23
2009,Sudan,SDN,Norway,NOR,52,0,12,77,141
2009,Syrian Arab Rep.,SYR,Norway,NOR,5,0,71,75,151
2009,Tajikistan,TJK,Norway,NOR,0,0,0,5,5
2009,Turkmenistan,TKM,Norway,NOR,5,0,0,0,5
2009,Tunisia,TUN,Norway,NOR,0,0,10,16,26
2009,Turkey,TUR,Norway,NOR,0,0,28,33,61
2009,Uganda,UGA,Norway,NOR,0,0,12,5,17
2009,Ukraine,UKR,Norway,NOR,0,0,5,19,24
2009,Uzbekistan,UZB,Norway,NOR,0,0,88,16,104
2009,Yemen,YEM,Norway,NOR,5,20,71,14,110
2009,Zimbabwe,ZWE,Norway,NOR,0,0,10,5,15
2009,Stateless,XXA,Norway,NOR,129,299,386,255,1069
2009,Algeria,DZA,New Zealand,NZL,0,0,5,0,5
2009,Bangladesh,BGD,New Zealand,NZL,0,0,11,0,11
2009,Brazil,BRA,New Zealand,NZL,0,0,5,0,5
2009,China,CHN,New Zealand,NZL,14,0,10,0,24
2009,Chile,CHL,New Zealand,NZL,0,0,5,0,5
2009,Dem. Rep. of the Congo,COD,New Zealand,NZL,0,0,5,0,5
2009,Czechia,CZE,New Zealand,NZL,0,0,25,0,25
2009,Fiji,FJI,New Zealand,NZL,0,0,28,0,28
2009,Ghana,GHA,New Zealand,NZL,0,0,5,0,5
2009,India,IND,New Zealand,NZL,0,0,31,0,31
2009,Iran (Islamic Rep. of),IRN,New Zealand,NZL,5,0,21,0,26
2009,Iraq,IRQ,New Zealand,NZL,15,0,5,0,20
2009,Sri Lanka,LKA,New Zealand,NZL,13,0,10,0,23
2009,Malaysia,MYS,New Zealand,NZL,0,0,5,0,5
2009,Nigeria,NGA,New Zealand,NZL,0,0,5,0,5
2009,Pakistan,PAK,New Zealand,NZL,0,0,5,0,5
2009,South Africa,ZAF,New Zealand,NZL,0,0,10,0,10
2009,Saudi Arabia,SAU,New Zealand,NZL,0,0,5,0,5
2009,Somalia,SOM,New Zealand,NZL,0,0,5,0,5
2009,Slovakia,SVK,New Zealand,NZL,0,0,5,0,5
2009,Syrian Arab Rep.,SYR,New Zealand,NZL,0,0,10,0,10
2009,Zimbabwe,ZWE,New Zealand,NZL,5,0,0,0,5
2009,Colombia,COL,Panama,PAN,25,0,119,37,181
2009,Cuba,CUB,Panama,PAN,5,0,5,0,10
2009,Eritrea,ERI,Panama,PAN,0,0,0,13,13
2009,Ethiopia,ETH,Panama,PAN,0,0,0,10,10
2009,Guatemala,GTM,Panama,PAN,10,0,0,0,10
2009,Somalia,SOM,Panama,PAN,0,0,0,13,13
2009,Bolivia (Plurinational State of),BOL,Peru,PER,0,0,0,5,5
2009,Colombia,COL,Peru,PER,43,0,19,225,287
2009,Cuba,CUB,Peru,PER,18,0,13,24,55
2009,Palestinian,PSE,Peru,PER,0,0,0,5,5
2009,Nepal,NPL,Peru,PER,0,0,0,5,5
2009,Serbia and Kosovo: S/RES/1244 (1999),SRB,Peru,PER,5,0,0,0,5
2009,Venezuela (Bolivarian Republic of),VEN,Peru,PER,5,0,0,5,10
2009,China,CHN,Philippines,PHL,0,0,0,5,5
2009,Liberia,LBR,Philippines,PHL,0,0,0,5,5
2009,Sri Lanka,LKA,Philippines,PHL,0,0,0,5,5
2009,Nigeria,NGA,Philippines,PHL,0,0,0,5,5
2009,Somalia,SOM,Philippines,PHL,0,0,0,5,5
2009,Viet Nam,VNM,Philippines,PHL,0,0,0,5,5
2009,Afghanistan,AFG,Poland,POL,0,5,5,5,15
2009,Algeria,DZA,Poland,POL,0,0,12,10,22
2009,Egypt,EGY,Poland,POL,0,0,5,5,10
2009,Armenia,ARM,Poland,POL,0,5,58,71,134
2009,Azerbaijan,AZE,Poland,POL,0,0,5,13,18
2009,Bangladesh,BGD,Poland,POL,0,0,14,5,19
2009,Belarus,BLR,Poland,POL,20,0,25,25,70
2009,China,CHN,Poland,POL,0,0,10,10,20
2009,Cameroon,CMR,Poland,POL,0,0,5,5,10
2009,Congo,COG,Poland,POL,0,0,0,5,5
2009,Cuba,CUB,Poland,POL,0,0,5,0,5
2009,Palestinian,PSE,Poland,POL,0,5,5,5,15
2009,Georgia,GEO,Poland,POL,0,0,1482,2577,4059
2009,Ghana,GHA,Poland,POL,0,0,5,0,5
2009,India,IND,Poland,POL,0,0,17,11,28
2009,Iran (Islamic Rep. of),IRN,Poland,POL,5,0,0,0,5
2009,Iraq,IRQ,Poland,POL,0,23,5,22,50
2009,Kazakhstan,KAZ,Poland,POL,0,0,5,10,15
2009,Kyrgyzstan,KGZ,Poland,POL,0,0,5,5,10
2009,Libya,LBY,Poland,POL,0,0,5,0,5
2009,Lebanon,LBN,Poland,POL,0,0,0,5,5
2009,Sri Lanka,LKA,Poland,POL,0,16,0,22,38
2009,Rep. of Moldova,MDA,Poland,POL,0,0,10,0,10
2009,Mongolia,MNG,Poland,POL,0,0,19,5,24
2009,Nepal,NPL,Poland,POL,0,0,0,5,5
2009,Nigeria,NGA,Poland,POL,0,0,13,10,23
2009,Pakistan,PAK,Poland,POL,0,0,17,10,27
2009,Russian Federation,RUS,Poland,POL,102,2307,2144,5928,10481
2009,Somalia,SOM,Poland,POL,0,5,0,0,5
2009,Viet Nam,VNM,Poland,POL,0,5,65,10,80
2009,Syrian Arab Rep.,SYR,Poland,POL,0,0,12,5,17
2009,Togo,TGO,Poland,POL,0,0,10,0,10
2009,Tunisia,TUN,Poland,POL,0,0,0,5,5
2009,Turkey,TUR,Poland,POL,0,0,19,5,24
2009,Ukraine,UKR,Poland,POL,0,5,29,14,48
2009,Uzbekistan,UZB,Poland,POL,0,0,10,23,33
2009,Stateless,XXA,Poland,POL,0,0,10,14,24
2009,Dem. Rep. of the Congo,COD,Portugal,PRT,5,5,5,0,15
2009,Colombia,COL,Portugal,PRT,0,14,0,0,14
2009,Eritrea,ERI,Portugal,PRT,0,5,0,0,5
2009,Guinea-Bissau,GNB,Portugal,PRT,0,0,5,0,5
2009,Guinea,GIN,Portugal,PRT,0,0,11,0,11
2009,Sri Lanka,LKA,Portugal,PRT,0,5,0,0,5
2009,Mauritania,MRT,Portugal,PRT,0,0,10,0,10
2009,Nigeria,NGA,Portugal,PRT,0,0,5,0,5
2009,Somalia,SOM,Portugal,PRT,0,5,0,0,5
2009,Algeria,DZA,South Africa,ZAF,5,0,50,0,55
2009,Angola,AGO,South Africa,ZAF,5,0,132,0,137
2009,Burundi,BDI,South Africa,ZAF,133,0,367,14,514
2009,Benin,BEN,South Africa,ZAF,0,0,19,0,19
2009,Bangladesh,BGD,South Africa,ZAF,31,0,3310,0,3341
2009,Burkina Faso,BFA,South Africa,ZAF,0,0,12,0,12
2009,China,CHN,South Africa,ZAF,0,0,1634,0,1634
2009,Cameroon,CMR,South Africa,ZAF,10,0,429,0,439
2009,Congo,COG,South Africa,ZAF,613,0,1391,0,2004
2009,Dem. Rep. of the Congo,COD,South Africa,ZAF,779,0,1706,28,2513
2009,Eritrea,ERI,South Africa,ZAF,202,0,71,0,273
2009,Ethiopia,ETH,South Africa,ZAF,1307,0,3130,0,4437
2009,Ghana,GHA,South Africa,ZAF,0,0,648,0,648
2009,Cote d'Ivoire,CIV,South Africa,ZAF,0,0,33,0,33
2009,India,IND,South Africa,ZAF,0,0,1045,0,1045
2009,Iraq,IRQ,South Africa,ZAF,5,0,0,0,5
2009,Kenya,KEN,South Africa,ZAF,5,0,276,0,281
2009,Lesotho,LSO,South Africa,ZAF,0,0,54,0,54
2009,Mali,MLI,South Africa,ZAF,0,0,42,0,42
2009,Malawi,MWI,South Africa,ZAF,0,0,7749,0,7749
2009,Mozambique,MOZ,South Africa,ZAF,0,0,882,0,882
2009,Niger,NER,South Africa,ZAF,0,0,1071,0,1071
2009,Nigeria,NGA,South Africa,ZAF,0,0,2046,0,2046
2009,Pakistan,PAK,South Africa,ZAF,0,0,1770,0,1770
2009,Rwanda,RWA,South Africa,ZAF,17,0,68,0,85
2009,Senegal,SEN,South Africa,ZAF,0,0,74,0,74
2009,Somalia,SOM,South Africa,ZAF,1213,0,638,0,1851
2009,Sudan,SDN,South Africa,ZAF,5,0,0,0,5
2009,United Rep. of Tanzania,TZA,South Africa,ZAF,0,0,602,0,602
2009,Uganda,UGA,South Africa,ZAF,20,0,759,0,779
2009,Zambia,ZMB,South Africa,ZAF,5,0,266,0,271
2009,Zimbabwe,ZWE,South Africa,ZAF,200,0,15370,131,15701
2009,Unknown ,,South Africa,ZAF,10,0,406,0,416
2009,Afghanistan,AFG,Russian Federation,RUS,115,366,1291,0,1772
2009,Angola,AGO,Russian Federation,RUS,0,0,5,0,5
2009,Armenia,ARM,Russian Federation,RUS,0,0,10,0,10
2009,Azerbaijan,AZE,Russian Federation,RUS,0,0,11,0,11
2009,Bangladesh,BGD,Russian Federation,RUS,0,0,5,0,5
2009,Belarus,BLR,Russian Federation,RUS,0,0,5,0,5
2009,Cambodia,KHM,Russian Federation,RUS,0,0,5,0,5
2009,China,CHN,Russian Federation,RUS,0,0,5,0,5
2009,Congo,COG,Russian Federation,RUS,0,5,5,0,10
2009,Dem. Rep. of the Congo,COD,Russian Federation,RUS,0,0,17,0,17
2009,Cuba,CUB,Russian Federation,RUS,0,0,5,0,5
2009,Eritrea,ERI,Russian Federation,RUS,0,0,10,0,10
2009,Ethiopia,ETH,Russian Federation,RUS,0,0,10,0,10
2009,Palestinian,PSE,Russian Federation,RUS,5,10,34,0,49
2009,Georgia,GEO,Russian Federation,RUS,60,1782,1578,0,3420
2009,Iran (Islamic Rep. of),IRN,Russian Federation,RUS,0,0,10,0,10
2009,Iraq,IRQ,Russian Federation,RUS,0,20,26,0,46
2009,Kazakhstan,KAZ,Russian Federation,RUS,0,0,10,0,10
2009,Kyrgyzstan,KGZ,Russian Federation,RUS,0,0,5,0,5
2009,Dem. People's Rep. of Korea,PRK,Russian Federation,RUS,0,5,42,0,47
2009,Nigeria,NGA,Russian Federation,RUS,0,0,5,0,5
2009,Pakistan,PAK,Russian Federation,RUS,0,0,10,0,10
2009,Sudan,SDN,Russian Federation,RUS,0,0,16,0,16
2009,Syrian Arab Rep.,SYR,Russian Federation,RUS,0,0,5,0,5
2009,Tajikistan,TJK,Russian Federation,RUS,5,5,30,0,40
2009,Turkmenistan,TKM,Russian Federation,RUS,0,10,21,0,31
2009,Ukraine,UKR,Russian Federation,RUS,0,0,12,0,12
2009,Uzbekistan,UZB,Russian Federation,RUS,0,45,98,0,143
2009,Unknown ,,Russian Federation,RUS,5,0,62,0,67
2009,Burundi,BDI,Rwanda,RWA,0,0,96,0,96
2009,Dem. Rep. of the Congo,COD,Rwanda,RWA,0,39,0,0,39
2009,Ethiopia,ETH,Rwanda,RWA,0,0,0,5,5
2009,Sudan,SDN,Rwanda,RWA,0,0,0,10,10
2009,Afghanistan,AFG,Serbia and Kosovo: S/RES/1244 (1999),SRB,0,0,0,220,220
2009,Albania,ALB,Serbia and Kosovo: S/RES/1244 (1999),SRB,0,0,0,5,5
2009,Armenia,ARM,Serbia and Kosovo: S/RES/1244 (1999),SRB,0,0,5,0,5
2009,Cameroon,CMR,Serbia and Kosovo: S/RES/1244 (1999),SRB,0,0,0,5,5
2009,Ethiopia,ETH,Serbia and Kosovo: S/RES/1244 (1999),SRB,0,0,0,5,5
2009,Palestinian,PSE,Serbia and Kosovo: S/RES/1244 (1999),SRB,0,0,0,5,5
2009,Georgia,GEO,Serbia and Kosovo: S/RES/1244 (1999),SRB,0,0,0,5,5
2009,Guinea,GIN,Serbia and Kosovo: S/RES/1244 (1999),SRB,0,0,0,5,5
2009,Cote d'Ivoire,CIV,Serbia and Kosovo: S/RES/1244 (1999),SRB,0,0,0,19,19
2009,Iran (Islamic Rep. of),IRN,Serbia and Kosovo: S/RES/1244 (1999),SRB,0,0,0,13,13
2009,Iraq,IRQ,Serbia and Kosovo: S/RES/1244 (1999),SRB,0,0,0,5,5
2009,Sri Lanka,LKA,Serbia and Kosovo: S/RES/1244 (1999),SRB,0,0,0,17,17
2009,Nigeria,NGA,Serbia and Kosovo: S/RES/1244 (1999),SRB,0,0,0,5,5
2009,Central African Rep.,CAF,Senegal,SEN,0,0,5,0,5
2009,Chad,TCD,Senegal,SEN,0,0,5,0,5
2009,Dem. Rep. of the Congo,COD,Senegal,SEN,5,0,18,0,23
2009,Gambia,GMB,Senegal,SEN,5,0,10,0,15
2009,Cote d'Ivoire,CIV,Senegal,SEN,0,0,10,0,10
2009,Liberia,LBR,Senegal,SEN,0,0,13,0,13
2009,Mauritania,MRT,Senegal,SEN,0,0,5,0,5
2009,Nigeria,NGA,Senegal,SEN,0,0,5,0,5
2009,Rwanda,RWA,Senegal,SEN,5,0,0,0,5
2009,Sierra Leone,SLE,Senegal,SEN,0,0,10,0,10
2009,Guinea,GIN,Sierra Leone,SLE,0,0,0,5,5
2009,Liberia,LBR,Sierra Leone,SLE,0,0,0,160,160
2009,Nigeria,NGA,Sierra Leone,SLE,0,0,0,11,11
2009,Afghanistan,AFG,Spain,ESP,0,5,47,0,52
2009,Albania,ALB,Spain,ESP,0,0,5,0,5
2009,Algeria,DZA,Spain,ESP,0,5,329,0,334
2009,Angola,AGO,Spain,ESP,0,0,10,0,10
2009,Egypt,EGY,Spain,ESP,0,0,14,0,14
2009,Argentina,ARG,Spain,ESP,0,0,13,0,13
2009,Armenia,ARM,Spain,ESP,0,0,43,0,43
2009,Azerbaijan,AZE,Spain,ESP,5,0,17,0,22
2009,Burundi,BDI,Spain,ESP,0,0,5,0,5
2009,Benin,BEN,Spain,ESP,0,0,12,0,12
2009,Bangladesh,BGD,Spain,ESP,5,0,28,0,33
2009,Burkina Faso,BFA,Spain,ESP,0,0,5,0,5
2009,Belarus,BLR,Spain,ESP,5,0,10,0,15
2009,Bolivia (Plurinational State of),BOL,Spain,ESP,0,0,12,0,12
2009,Brazil,BRA,Spain,ESP,0,0,17,0,17
2009,Bosnia and Herzegovina,BIH,Spain,ESP,0,0,10,0,10
2009,Central African Rep.,CAF,Spain,ESP,0,0,5,0,5
2009,Chad,TCD,Spain,ESP,0,0,21,0,21
2009,China,CHN,Spain,ESP,0,0,14,0,14
2009,Cameroon,CMR,Spain,ESP,0,0,80,0,80
2009,Congo,COG,Spain,ESP,0,0,5,0,5
2009,Dem. Rep. of the Congo,COD,Spain,ESP,18,10,100,0,128
2009,Colombia,COL,Spain,ESP,14,10,1005,0,1029
2009,Costa Rica,CRI,Spain,ESP,0,0,5,0,5
2009,Cuba,CUB,Spain,ESP,5,42,89,0,136
2009,Dominican Rep.,DOM,Spain,ESP,0,0,5,0,5
2009,Ecuador,ECU,Spain,ESP,0,0,10,0,10
2009,Equatorial Guinea,GNQ,Spain,ESP,10,0,22,0,32
2009,Eritrea,ERI,Spain,ESP,0,0,33,0,33
2009,Ethiopia,ETH,Spain,ESP,0,0,20,0,20
2009,Gabon,GAB,Spain,ESP,0,0,5,0,5
2009,Gambia,GMB,Spain,ESP,5,0,53,0,58
2009,Georgia,GEO,Spain,ESP,0,0,30,0,30
2009,Ghana,GHA,Spain,ESP,0,0,17,0,17
2009,Guinea-Bissau,GNB,Spain,ESP,0,0,13,0,13
2009,Guatemala,GTM,Spain,ESP,0,0,13,0,13
2009,Guinea,GIN,Spain,ESP,0,0,83,0,83
2009,Haiti,HTI,Spain,ESP,5,0,0,0,5
2009,Honduras,HND,Spain,ESP,0,0,5,0,5
2009,Cote d'Ivoire,CIV,Spain,ESP,0,26,366,0,392
2009,India,IND,Spain,ESP,0,0,23,0,23
2009,Iran (Islamic Rep. of),IRN,Spain,ESP,10,0,59,0,69
2009,Iraq,IRQ,Spain,ESP,14,22,10,0,46
2009,Israel,ISR,Spain,ESP,0,0,5,0,5
2009,Jordan,JOR,Spain,ESP,5,0,0,0,5
2009,Kenya,KEN,Spain,ESP,0,0,14,0,14
2009,Liberia,LBR,Spain,ESP,0,0,36,0,36
2009,Lebanon,LBN,Spain,ESP,0,0,10,0,10
2009,Sri Lanka,LKA,Spain,ESP,0,23,10,0,33
2009,Mauritania,MRT,Spain,ESP,0,0,27,0,27
2009,North Macedonia,MKD,Spain,ESP,0,0,10,0,10
2009,Mexico,MEX,Spain,ESP,5,0,17,0,22
2009,Mali,MLI,Spain,ESP,0,0,27,0,27
2009,Morocco,MAR,Spain,ESP,0,5,101,0,106
2009,Mozambique,MOZ,Spain,ESP,0,0,5,0,5
2009,Nepal,NPL,Spain,ESP,0,0,10,0,10
2009,Niger,NER,Spain,ESP,0,0,17,0,17
2009,Nicaragua,NIC,Spain,ESP,0,0,5,0,5
2009,Nigeria,NGA,Spain,ESP,0,0,592,0,592
2009,Pakistan,PAK,Spain,ESP,10,0,52,0,62
2009,Paraguay,PRY,Spain,ESP,0,0,14,0,14
2009,Peru,PER,Spain,ESP,0,0,5,0,5
2009,Russian Federation,RUS,Spain,ESP,5,0,76,0,81
2009,Rwanda,RWA,Spain,ESP,0,0,5,0,5
2009,El Salvador,SLV,Spain,ESP,0,0,5,0,5
2009,Serbia and Kosovo: S/RES/1244 (1999),SRB,Spain,ESP,0,0,16,0,16
2009,Senegal,SEN,Spain,ESP,0,0,19,0,19
2009,Sierra Leone,SLE,Spain,ESP,0,0,34,0,34
2009,Somalia,SOM,Spain,ESP,0,5,52,0,57
2009,Viet Nam,VNM,Spain,ESP,0,0,5,0,5
2009,Sudan,SDN,Spain,ESP,0,0,105,0,105
2009,Syrian Arab Rep.,SYR,Spain,ESP,5,0,34,0,39
2009,United Rep. of Tanzania,TZA,Spain,ESP,0,0,5,0,5
2009,Tajikistan,TJK,Spain,ESP,0,0,5,0,5
2009,Togo,TGO,Spain,ESP,0,0,15,0,15
2009,Turkey,TUR,Spain,ESP,0,0,23,0,23
2009,Uganda,UGA,Spain,ESP,0,0,16,0,16
2009,Ukraine,UKR,Spain,ESP,0,0,13,0,13
2009,Venezuela (Bolivarian Republic of),VEN,Spain,ESP,5,0,24,0,29
2009,Zimbabwe,ZWE,Spain,ESP,0,0,20,0,20
2009,Unknown ,,Spain,ESP,28,5,11,216,260
2009,Afghanistan,AFG,Slovakia,SVK,0,47,5,10,62
2009,Armenia,ARM,Slovakia,SVK,0,5,5,13,23
2009,Azerbaijan,AZE,Slovakia,SVK,0,0,0,10,10
2009,Bangladesh,BGD,Slovakia,SVK,0,0,10,10,20
2009,China,CHN,Slovakia,SVK,0,0,28,12,40
2009,Cuba,CUB,Slovakia,SVK,5,0,0,0,5
2009,Palestinian,PSE,Slovakia,SVK,0,0,5,0,5
2009,Georgia,GEO,Slovakia,SVK,0,0,25,79,104
2009,India,IND,Slovakia,SVK,0,0,27,37,64
2009,Iran (Islamic Rep. of),IRN,Slovakia,SVK,5,5,5,0,15
2009,Iraq,IRQ,Slovakia,SVK,0,10,5,5,20
2009,Sri Lanka,LKA,Slovakia,SVK,0,0,5,16,21
2009,Rep. of Moldova,MDA,Slovakia,SVK,0,0,27,50,77
2009,Nigeria,NGA,Slovakia,SVK,0,0,5,5,10
2009,Pakistan,PAK,Slovakia,SVK,0,0,95,71,166
2009,Romania,ROU,Slovakia,SVK,0,0,0,12,12
2009,Russian Federation,RUS,Slovakia,SVK,0,0,11,75,86
2009,Serbia and Kosovo: S/RES/1244 (1999),SRB,Slovakia,SVK,0,0,10,5,15
2009,Somalia,SOM,Slovakia,SVK,0,11,0,0,11
2009,Viet Nam,VNM,Slovakia,SVK,0,0,39,22,61
2009,Syrian Arab Rep.,SYR,Slovakia,SVK,0,5,0,10,15
2009,Turkey,TUR,Slovakia,SVK,0,0,5,5,10
2009,Ukraine,UKR,Slovakia,SVK,0,0,10,5,15
2009,Stateless,XXA,Slovakia,SVK,0,5,0,0,5
2009,Afghanistan,AFG,Slovenia,SVN,0,5,5,5,15
2009,Albania,ALB,Slovenia,SVN,0,0,0,5,5
2009,Bosnia and Herzegovina,BIH,Slovenia,SVN,0,0,20,20,40
2009,Croatia,HRV,Slovenia,SVN,0,0,10,0,10
2009,Iran (Islamic Rep. of),IRN,Slovenia,SVN,0,0,5,5,10
2009,Kazakhstan,KAZ,Slovenia,SVN,5,0,0,0,5
2009,North Macedonia,MKD,Slovenia,SVN,0,0,0,5,5
2009,Montenegro,MNE,Slovenia,SVN,0,0,5,0,5
2009,Nigeria,NGA,Slovenia,SVN,0,0,5,5,10
2009,Pakistan,PAK,Slovenia,SVN,0,0,0,5,5
2009,Russian Federation,RUS,Slovenia,SVN,0,0,5,0,5
2009,Serbia and Kosovo: S/RES/1244 (1999),SRB,Slovenia,SVN,11,0,17,15,43
2009,Turkey,TUR,Slovenia,SVN,0,0,5,10,15
2009,Unknown ,,Slovenia,SVN,0,0,0,5,5
2009,Afghanistan,AFG,Sweden,SWE,122,545,245,59,971
2009,Albania,ALB,Sweden,SWE,0,10,72,17,99
2009,Algeria,DZA,Sweden,SWE,5,0,83,49,137
2009,Angola,AGO,Sweden,SWE,0,0,10,0,10
2009,Egypt,EGY,Sweden,SWE,0,5,81,11,97
2009,Armenia,ARM,Sweden,SWE,0,17,222,29,268
2009,Azerbaijan,AZE,Sweden,SWE,19,29,281,62,391
2009,Burundi,BDI,Sweden,SWE,10,5,45,5,65
2009,Benin,BEN,Sweden,SWE,0,0,5,0,5
2009,Bangladesh,BGD,Sweden,SWE,5,5,78,5,93
2009,Bhutan,BTN,Sweden,SWE,0,0,12,0,12
2009,Belarus,BLR,Sweden,SWE,0,5,213,103,321
2009,Bolivia (Plurinational State of),BOL,Sweden,SWE,0,5,40,5,50
2009,Brazil,BRA,Sweden,SWE,0,0,5,0,5
2009,Bosnia and Herzegovina,BIH,Sweden,SWE,0,17,76,23,116
2009,Bulgaria,BGR,Sweden,SWE,0,0,19,11,30
2009,Chad,TCD,Sweden,SWE,0,0,5,0,5
2009,China,CHN,Sweden,SWE,10,5,58,25,98
2009,Chile,CHL,Sweden,SWE,0,0,24,5,29
2009,Cameroon,CMR,Sweden,SWE,0,0,31,0,31
2009,Congo,COG,Sweden,SWE,0,5,5,0,10
2009,Dem. Rep. of the Congo,COD,Sweden,SWE,15,15,40,5,75
2009,Colombia,COL,Sweden,SWE,0,0,10,0,10
2009,Cuba,CUB,Sweden,SWE,0,11,19,5,35
2009,Denmark,DNK,Sweden,SWE,0,0,0,5,5
2009,Djibouti,DJI,Sweden,SWE,0,0,5,0,5
2009,Ecuador,ECU,Sweden,SWE,0,0,15,5,20
2009,Eritrea,ERI,Sweden,SWE,151,647,69,27,894
2009,Estonia,EST,Sweden,SWE,0,0,5,0,5
2009,Ethiopia,ETH,Sweden,SWE,14,17,134,5,170
2009,Gambia,GMB,Sweden,SWE,0,0,28,10,38
2009,Georgia,GEO,Sweden,SWE,5,10,178,41,234
2009,Ghana,GHA,Sweden,SWE,0,0,28,10,38
2009,Guinea-Bissau,GNB,Sweden,SWE,0,0,5,0,5
2009,Guinea,GIN,Sweden,SWE,0,5,31,5,41
2009,Honduras,HND,Sweden,SWE,0,0,5,0,5
2009,Croatia,HRV,Sweden,SWE,0,0,15,14,29
2009,Cote d'Ivoire,CIV,Sweden,SWE,0,0,25,0,25
2009,India,IND,Sweden,SWE,0,0,65,17,82
2009,Indonesia,IDN,Sweden,SWE,0,0,11,0,11
2009,Iran (Islamic Rep. of),IRN,Sweden,SWE,124,51,580,84,839
2009,Iraq,IRQ,Sweden,SWE,303,746,2929,290,4268
2009,Israel,ISR,Sweden,SWE,0,5,27,5,37
2009,Jordan,JOR,Sweden,SWE,10,11,77,28,126
2009,Kazakhstan,KAZ,Sweden,SWE,5,10,178,25,218
2009,Kenya,KEN,Sweden,SWE,0,5,66,0,71
2009,Kyrgyzstan,KGZ,Sweden,SWE,0,5,126,19,150
2009,Rep. of Korea,KOR,Sweden,SWE,0,0,0,5,5
2009,Kuwait,KWT,Sweden,SWE,0,0,5,0,5
2009,Liberia,LBR,Sweden,SWE,0,0,10,5,15
2009,Libya,LBY,Sweden,SWE,10,10,395,149,564
2009,Lebanon,LBN,Sweden,SWE,0,10,152,35,197
2009,Sri Lanka,LKA,Sweden,SWE,5,0,41,16,62
2009,Latvia,LVA,Sweden,SWE,0,0,5,0,5
2009,Mauritania,MRT,Sweden,SWE,0,0,5,0,5
2009,North Macedonia,MKD,Sweden,SWE,0,0,25,15,40
2009,Rep. of Moldova,MDA,Sweden,SWE,0,0,11,5,16
2009,Malawi,MWI,Sweden,SWE,0,0,5,0,5
2009,Mongolia,MNG,Sweden,SWE,0,11,681,68,760
2009,Morocco,MAR,Sweden,SWE,0,5,31,22,58
2009,Montenegro,MNE,Sweden,SWE,0,5,38,0,43
2009,Myanmar,MMR,Sweden,SWE,5,0,0,0,5
2009,Nepal,NPL,Sweden,SWE,0,0,69,5,74
2009,Nicaragua,NIC,Sweden,SWE,0,0,50,5,55
2009,Nigeria,NGA,Sweden,SWE,5,12,176,41,234
2009,Pakistan,PAK,Sweden,SWE,5,5,62,29,101
2009,Peru,PER,Sweden,SWE,0,0,21,0,21
2009,Philippines,PHL,Sweden,SWE,0,0,5,0,5
2009,Romania,ROU,Sweden,SWE,0,5,10,0,15
2009,Russian Federation,RUS,Sweden,SWE,33,83,530,99,745
2009,Rwanda,RWA,Sweden,SWE,0,0,5,0,5
2009,El Salvador,SLV,Sweden,SWE,0,0,52,5,57
2009,Saudi Arabia,SAU,Sweden,SWE,0,0,0,5,5
2009,Serbia and Kosovo: S/RES/1244 (1999),SRB,Sweden,SWE,15,145,1246,229,1635
2009,Senegal,SEN,Sweden,SWE,0,0,13,0,13
2009,Sierra Leone,SLE,Sweden,SWE,0,0,25,5,30
2009,Somalia,SOM,Sweden,SWE,472,3202,644,215,4533
2009,Viet Nam,VNM,Sweden,SWE,0,12,88,21,121
2009,Sudan,SDN,Sweden,SWE,14,26,36,10,86
2009,Slovakia,SVK,Sweden,SWE,0,0,5,0,5
2009,Sweden,SWE,Sweden,SWE,0,0,0,5,5
2009,Syrian Arab Rep.,SYR,Sweden,SWE,16,19,399,55,489
2009,United Rep. of Tanzania,TZA,Sweden,SWE,0,0,30,10,40
2009,Thailand,THA,Sweden,SWE,0,0,12,0,12
2009,Tajikistan,TJK,Sweden,SWE,0,0,19,10,29
2009,Turkmenistan,TKM,Sweden,SWE,0,0,0,5,5
2009,Togo,TGO,Sweden,SWE,0,0,10,0,10
2009,Tunisia,TUN,Sweden,SWE,0,0,47,23,70
2009,Turkey,TUR,Sweden,SWE,10,12,170,44,236
2009,Uganda,UGA,Sweden,SWE,5,0,38,5,48
2009,Ukraine,UKR,Sweden,SWE,0,0,53,24,77
2009,United States of America,USA,Sweden,SWE,0,0,5,5,10
2009,Uzbekistan,UZB,Sweden,SWE,21,19,416,43,499
2009,Venezuela (Bolivarian Republic of),VEN,Sweden,SWE,0,0,10,0,10
2009,Yemen,YEM,Sweden,SWE,30,15,53,15,113
2009,Zimbabwe,ZWE,Sweden,SWE,0,0,10,0,10
2009,Stateless,XXA,Sweden,SWE,87,289,519,143,1038
2009,Unknown ,,Sweden,SWE,5,27,515,69,616
2009,Afghanistan,AFG,Switzerland,CHE,34,263,298,211,806
2009,Albania,ALB,Switzerland,CHE,0,0,0,19,19
2009,Algeria,DZA,Switzerland,CHE,10,20,33,255,318
2009,Angola,AGO,Switzerland,CHE,0,91,82,25,198
2009,Egypt,EGY,Switzerland,CHE,0,0,0,11,11
2009,Armenia,ARM,Switzerland,CHE,0,5,36,67,108
2009,Austria,AUT,Switzerland,CHE,0,0,0,5,5
2009,Azerbaijan,AZE,Switzerland,CHE,5,14,16,10,45
2009,Benin,BEN,Switzerland,CHE,0,5,5,25,35
2009,Bangladesh,BGD,Switzerland,CHE,0,5,15,21,41
2009,Bhutan,BTN,Switzerland,CHE,0,0,0,5,5
2009,Burkina Faso,BFA,Switzerland,CHE,0,5,5,10,20
2009,Belarus,BLR,Switzerland,CHE,0,0,15,76,91
2009,Bolivia (Plurinational State of),BOL,Switzerland,CHE,0,13,0,0,13
2009,Bosnia and Herzegovina,BIH,Switzerland,CHE,14,86,50,162,312
2009,Bulgaria,BGR,Switzerland,CHE,0,0,5,20,25
2009,Cambodia,KHM,Switzerland,CHE,5,0,5,0,10
2009,Chad,TCD,Switzerland,CHE,5,0,5,10,20
2009,China,CHN,Switzerland,CHE,40,238,252,53,583
2009,Cameroon,CMR,Switzerland,CHE,5,10,37,41,93
2009,Congo,COG,Switzerland,CHE,0,0,5,5,10
2009,Dem. Rep. of the Congo,COD,Switzerland,CHE,5,174,167,51,397
2009,Colombia,COL,Switzerland,CHE,14,5,5,10,34
2009,Czechia,CZE,Switzerland,CHE,0,0,0,5,5
2009,Ecuador,ECU,Switzerland,CHE,0,0,10,0,10
2009,Equatorial Guinea,GNQ,Switzerland,CHE,0,0,0,5,5
2009,Eritrea,ERI,Switzerland,CHE,1302,437,451,654,2844
2009,Ethiopia,ETH,Switzerland,CHE,45,105,122,71,343
2009,Gabon,GAB,Switzerland,CHE,0,0,0,5,5
2009,Gambia,GMB,Switzerland,CHE,0,5,56,176,237
2009,Georgia,GEO,Switzerland,CHE,0,14,57,652,723
2009,Germany,DEU,Switzerland,CHE,0,0,0,10,10
2009,Ghana,GHA,Switzerland,CHE,0,0,0,36,36
2009,Guinea-Bissau,GNB,Switzerland,CHE,0,0,25,141,166
2009,Guinea,GIN,Switzerland,CHE,0,10,57,268,335
2009,Cote d'Ivoire,CIV,Switzerland,CHE,0,20,64,102,186
2009,India,IND,Switzerland,CHE,0,0,5,19,24
2009,Iran (Islamic Rep. of),IRN,Switzerland,CHE,66,100,147,71,384
2009,Iraq,IRQ,Switzerland,CHE,161,360,624,514,1659
2009,Italy,ITA,Switzerland,CHE,0,0,0,13,13
2009,Jamaica,JAM,Switzerland,CHE,0,0,0,5,5
2009,Jordan,JOR,Switzerland,CHE,0,0,5,0,5
2009,Kazakhstan,KAZ,Switzerland,CHE,0,0,5,10,15
2009,Kenya,KEN,Switzerland,CHE,0,0,5,10,15
2009,Kyrgyzstan,KGZ,Switzerland,CHE,5,0,0,0,5
2009,Liberia,LBR,Switzerland,CHE,0,0,5,21,26
2009,Libya,LBY,Switzerland,CHE,10,12,14,20,56
2009,Lebanon,LBN,Switzerland,CHE,0,15,5,22,42
2009,Sri Lanka,LKA,Switzerland,CHE,170,478,539,235,1422
2009,Lithuania,LTU,Switzerland,CHE,0,0,0,5,5
2009,Madagascar,MDG,Switzerland,CHE,0,0,5,0,5
2009,Mauritania,MRT,Switzerland,CHE,0,0,5,40,45
2009,North Macedonia,MKD,Switzerland,CHE,0,21,23,40,84
2009,Rep. of Moldova,MDA,Switzerland,CHE,0,5,5,14,24
2009,Mali,MLI,Switzerland,CHE,0,0,5,24,29
2009,Mongolia,MNG,Switzerland,CHE,0,11,41,271,323
2009,Morocco,MAR,Switzerland,CHE,0,5,0,26,31
2009,Montenegro,MNE,Switzerland,CHE,0,5,5,12,22
2009,Myanmar,MMR,Switzerland,CHE,0,19,19,0,38
2009,Nepal,NPL,Switzerland,CHE,0,0,0,17,17
2009,Niger,NER,Switzerland,CHE,0,0,5,22,27
2009,Nigeria,NGA,Switzerland,CHE,0,11,70,1737,1818
2009,Pakistan,PAK,Switzerland,CHE,0,15,36,47,98
2009,Romania,ROU,Switzerland,CHE,0,0,0,26,26
2009,South Africa,ZAF,Switzerland,CHE,0,0,5,10,15
2009,Russian Federation,RUS,Switzerland,CHE,45,53,63,288,449
2009,Rwanda,RWA,Switzerland,CHE,0,0,5,5,10
2009,Saudi Arabia,SAU,Switzerland,CHE,0,0,0,5,5
2009,Serbia and Kosovo: S/RES/1244 (1999),SRB,Switzerland,CHE,41,343,754,820,1958
2009,Senegal,SEN,Switzerland,CHE,5,0,5,60,70
2009,Sierra Leone,SLE,Switzerland,CHE,0,5,11,43,59
2009,Somalia,SOM,Switzerland,CHE,50,696,696,428,1870
2009,Viet Nam,VNM,Switzerland,CHE,11,0,10,0,21
2009,Sudan,SDN,Switzerland,CHE,10,5,25,61,101
2009,Slovakia,SVK,Switzerland,CHE,0,0,0,5,5
2009,Syrian Arab Rep.,SYR,Switzerland,CHE,67,51,265,125,508
2009,United Rep. of Tanzania,TZA,Switzerland,CHE,0,10,0,5,15
2009,Togo,TGO,Switzerland,CHE,56,24,35,39,154
2009,Tunisia,TUN,Switzerland,CHE,28,5,10,103,146
2009,Turkey,TUR,Switzerland,CHE,303,138,199,165,805
2009,Uganda,UGA,Switzerland,CHE,0,0,5,16,21
2009,Ukraine,UKR,Switzerland,CHE,0,5,10,17,32
2009,United States of America,USA,Switzerland,CHE,0,0,0,5,5
2009,Uzbekistan,UZB,Switzerland,CHE,0,0,0,5,5
2009,Western Sahara,ESH,Switzerland,CHE,0,0,0,10,10
2009,Yemen,YEM,Switzerland,CHE,34,16,36,18,104
2009,Zimbabwe,ZWE,Switzerland,CHE,0,5,0,28,33
2009,Stateless,XXA,Switzerland,CHE,0,0,0,5,5
2009,Unknown ,,Switzerland,CHE,58,97,155,232,542
2009,Central African Rep.,CAF,Togo,TGO,5,0,0,22,27
2009,Chad,TCD,Togo,TGO,10,0,0,5,15
2009,Dem. Rep. of the Congo,COD,Togo,TGO,0,0,19,15,34
2009,Ghana,GHA,Togo,TGO,0,0,0,134,134
2009,Cote d'Ivoire,CIV,Togo,TGO,0,0,13,33,46
2009,Sri Lanka,LKA,Togo,TGO,0,0,64,62,126
2009,Rwanda,RWA,Togo,TGO,0,0,0,42,42
2009,Afghanistan,AFG,Ukraine,UKR,80,0,134,63,277
2009,Armenia,ARM,Ukraine,UKR,0,0,5,5,10
2009,Azerbaijan,AZE,Ukraine,UKR,0,0,5,5,10
2009,Bangladesh,BGD,Ukraine,UKR,0,0,12,12,24
2009,Belarus,BLR,Ukraine,UKR,5,0,5,5,15
2009,Cameroon,CMR,Ukraine,UKR,0,0,10,5,15
2009,Congo,COG,Ukraine,UKR,0,0,5,0,5
2009,Dem. Rep. of the Congo,COD,Ukraine,UKR,0,0,16,13,29
2009,Palestinian,PSE,Ukraine,UKR,0,0,5,12,17
2009,Georgia,GEO,Ukraine,UKR,5,0,35,30,70
2009,Guinea,GIN,Ukraine,UKR,0,0,10,5,15
2009,India,IND,Ukraine,UKR,0,0,0,10,10
2009,Iran (Islamic Rep. of),IRN,Ukraine,UKR,5,0,12,5,22
2009,Iraq,IRQ,Ukraine,UKR,5,0,23,10,38
2009,Sri Lanka,LKA,Ukraine,UKR,0,0,22,0,22
2009,Nigeria,NGA,Ukraine,UKR,0,0,5,5,10
2009,Pakistan,PAK,Ukraine,UKR,0,0,5,55,60
2009,Russian Federation,RUS,Ukraine,UKR,5,0,13,16,34
2009,Serbia and Kosovo: S/RES/1244 (1999),SRB,Ukraine,UKR,0,0,0,10,10
2009,Somalia,SOM,Ukraine,UKR,0,0,41,23,64
2009,Viet Nam,VNM,Ukraine,UKR,0,0,0,5,5
2009,Sudan,SDN,Ukraine,UKR,0,0,5,5,10
2009,Syrian Arab Rep.,SYR,Ukraine,UKR,5,0,16,10,31
2009,Turkey,TUR,Ukraine,UKR,0,0,10,0,10
2009,Uzbekistan,UZB,Ukraine,UKR,5,0,5,26,36
2009,Stateless,XXA,Ukraine,UKR,0,0,0,5,5
2009,Colombia,COL,Uruguay,URY,15,0,0,10,25
2009,Burundi,BDI,Zimbabwe,ZWE,54,0,0,16,70
2009,Dem. Rep. of the Congo,COD,Zimbabwe,ZWE,401,0,5,80,486
2009,Eritrea,ERI,Zimbabwe,ZWE,5,0,0,0,5
2009,Ethiopia,ETH,Zimbabwe,ZWE,0,0,0,5,5
2009,Rwanda,RWA,Zimbabwe,ZWE,49,0,5,16,70
2009,Somalia,SOM,Zimbabwe,ZWE,5,0,0,5,10
2009,Sudan,SDN,Zimbabwe,ZWE,5,0,0,0,5
2009,Uganda,UGA,Zimbabwe,ZWE,5,0,0,0,5
2010,Armenia,ARM,Argentina,ARG,11,0,16,0,27
2010,Bangladesh,BGD,Argentina,ARG,0,0,21,0,21
2010,China,CHN,Argentina,ARG,0,0,5,0,5
2010,Colombia,COL,Argentina,ARG,11,0,26,15,52
2010,Cuba,CUB,Argentina,ARG,0,0,15,10,25
2010,Dominican Rep.,DOM,Argentina,ARG,0,0,116,23,139
2010,Georgia,GEO,Argentina,ARG,0,0,5,0,5
2010,Guinea,GIN,Argentina,ARG,0,0,5,0,5
2010,Haiti,HTI,Argentina,ARG,5,0,27,0,32
2010,India,IND,Argentina,ARG,0,0,28,10,38
2010,Lao People's Dem. Rep.,LAO,Argentina,ARG,0,0,0,5,5
2010,Sri Lanka,LKA,Argentina,ARG,0,0,0,5,5
2010,Nigeria,NGA,Argentina,ARG,0,0,45,0,45
2010,Peru,PER,Argentina,ARG,0,0,13,17,30
2010,Russian Federation,RUS,Argentina,ARG,0,0,5,0,5
2010,Senegal,SEN,Argentina,ARG,5,0,67,22,94
2010,Sierra Leone,SLE,Argentina,ARG,0,0,10,5,15
2010,Ukraine,UKR,Argentina,ARG,0,0,5,0,5
2010,Georgia,GEO,Armenia,ARM,0,0,5,0,5
2010,Cote d'Ivoire,CIV,Armenia,ARM,0,0,5,0,5
2010,Iran (Islamic Rep. of),IRN,Armenia,ARM,0,0,10,5,15
2010,Iraq,IRQ,Armenia,ARM,18,0,0,19,37
2010,Afghanistan,AFG,Australia,AUS,1213,0,26,0,1239
2010,Albania,ALB,Australia,AUS,5,0,10,0,15
2010,Egypt,EGY,Australia,AUS,59,0,107,0,166
2010,Bangladesh,BGD,Australia,AUS,17,0,49,0,66
2010,Brazil,BRA,Australia,AUS,0,0,5,0,5
2010,Cambodia,KHM,Australia,AUS,0,0,5,0,5
2010,China,CHN,Australia,AUS,196,0,976,0,1172
2010,Cameroon,CMR,Australia,AUS,5,0,5,0,10
2010,Colombia,COL,Australia,AUS,0,0,32,0,32
2010,Eritrea,ERI,Australia,AUS,10,0,0,0,10
2010,Ethiopia,ETH,Australia,AUS,16,0,12,0,28
2010,Fiji,FJI,Australia,AUS,18,0,517,0,535
2010,France,FRA,Australia,AUS,0,0,5,0,5
2010,Palestinian,PSE,Australia,AUS,20,0,5,0,25
2010,Ghana,GHA,Australia,AUS,5,0,17,0,22
2010,Hungary,HUN,Australia,AUS,0,0,5,0,5
2010,India,IND,Australia,AUS,13,0,266,0,279
2010,Indonesia,IDN,Australia,AUS,5,0,167,0,172
2010,Iran (Islamic Rep. of),IRN,Australia,AUS,230,0,71,0,301
2010,Iraq,IRQ,Australia,AUS,251,0,26,0,277
2010,Israel,ISR,Australia,AUS,0,0,5,0,5
2010,Italy,ITA,Australia,AUS,0,0,5,0,5
2010,Jordan,JOR,Australia,AUS,5,0,16,0,21
2010,Japan,JPN,Australia,AUS,0,0,5,0,5
2010,Kenya,KEN,Australia,AUS,5,0,16,0,21
2010,Rep. of Korea,KOR,Australia,AUS,5,0,59,0,64
2010,Dem. People's Rep. of Korea,PRK,Australia,AUS,0,0,16,0,16
2010,Kuwait,KWT,Australia,AUS,5,0,0,0,5
2010,Lao People's Dem. Rep.,LAO,Australia,AUS,0,0,5,0,5
2010,Liberia,LBR,Australia,AUS,0,0,5,0,5
2010,Lebanon,LBN,Australia,AUS,10,0,106,0,116
2010,Sri Lanka,LKA,Australia,AUS,478,0,83,0,561
2010,Lithuania,LTU,Australia,AUS,0,0,5,0,5
2010,Latvia,LVA,Australia,AUS,0,0,5,0,5
2010,Malaysia,MYS,Australia,AUS,0,0,241,0,241
2010,Mongolia,MNG,Australia,AUS,0,0,12,0,12
2010,Mauritius,MUS,Australia,AUS,0,0,5,0,5
2010,Myanmar,MMR,Australia,AUS,47,0,21,0,68
2010,Nepal,NPL,Australia,AUS,15,0,94,0,109
2010,Nigeria,NGA,Australia,AUS,12,0,12,0,24
2010,New Zealand,NZL,Australia,AUS,0,0,5,0,5
2010,Pakistan,PAK,Australia,AUS,162,0,91,0,253
2010,Peru,PER,Australia,AUS,0,0,5,0,5
2010,Philippines,PHL,Australia,AUS,0,0,60,0,60
2010,Papua New Guinea,PNG,Australia,AUS,17,0,10,0,27
2010,Poland,POL,Australia,AUS,0,0,5,0,5
2010,Portugal,PRT,Australia,AUS,0,0,5,0,5
2010,Romania,ROU,Australia,AUS,0,0,5,0,5
2010,South Africa,ZAF,Australia,AUS,0,0,29,0,29
2010,Rwanda,RWA,Australia,AUS,5,0,0,0,5
2010,Saudi Arabia,SAU,Australia,AUS,5,0,0,0,5
2010,Serbia and Kosovo: S/RES/1244 (1999),SRB,Australia,AUS,0,0,5,0,5
2010,Singapore,SGP,Australia,AUS,0,0,5,0,5
2010,Somalia,SOM,Australia,AUS,0,0,5,0,5
2010,Viet Nam,VNM,Australia,AUS,5,0,36,0,41
2010,Sudan,SDN,Australia,AUS,5,0,0,0,5
2010,Syrian Arab Rep.,SYR,Australia,AUS,5,0,5,0,10
2010,United Rep. of Tanzania,TZA,Australia,AUS,0,0,5,0,5
2010,Thailand,THA,Australia,AUS,0,0,18,0,18
2010,Timor-Leste,TLS,Australia,AUS,0,0,5,0,5
2010,Tonga,TON,Australia,AUS,0,0,24,0,24
2010,Turkey,TUR,Australia,AUS,20,0,39,0,59
2010,United Arab Emirates,ARE,Australia,AUS,0,0,5,0,5
2010,Uganda,UGA,Australia,AUS,5,0,0,0,5
2010,Ukraine,UKR,Australia,AUS,0,0,5,0,5
2010,United States of America,USA,Australia,AUS,0,0,5,0,5
2010,Uzbekistan,UZB,Australia,AUS,0,0,5,0,5
2010,Samoa,WSM,Australia,AUS,0,0,5,0,5
2010,Zambia,ZMB,Australia,AUS,0,0,5,0,5
2010,Zimbabwe,ZWE,Australia,AUS,175,0,110,0,285
2010,Stateless,XXA,Australia,AUS,241,0,10,0,251
2010,Afghanistan,AFG,Azerbaijan,AZE,0,0,20,0,20
2010,Iran (Islamic Rep. of),IRN,Azerbaijan,AZE,0,0,24,0,24
2010,Iraq,IRQ,Azerbaijan,AZE,0,0,14,0,14
2010,Pakistan,PAK,Azerbaijan,AZE,0,0,31,0,31
2010,Uzbekistan,UZB,Azerbaijan,AZE,0,0,5,0,5
2010,Afghanistan,AFG,Belgium,BEL,387,292,409,18,1106
2010,Albania,ALB,Belgium,BEL,11,0,55,10,76
2010,Algeria,DZA,Belgium,BEL,5,0,169,45,219
2010,Angola,AGO,Belgium,BEL,10,0,192,5,207
2010,Egypt,EGY,Belgium,BEL,0,0,18,0,18
2010,Armenia,ARM,Belgium,BEL,5,0,1751,103,1859
2010,Azerbaijan,AZE,Belgium,BEL,0,0,46,15,61
2010,Burundi,BDI,Belgium,BEL,39,0,123,10,172
2010,Benin,BEN,Belgium,BEL,5,0,37,0,42
2010,Bangladesh,BGD,Belgium,BEL,0,0,25,0,25
2010,Bhutan,BTN,Belgium,BEL,0,0,11,0,11
2010,Burkina Faso,BFA,Belgium,BEL,10,0,55,0,65
2010,Belarus,BLR,Belgium,BEL,5,0,29,20,54
2010,Brazil,BRA,Belgium,BEL,0,0,5,0,5
2010,Bosnia and Herzegovina,BIH,Belgium,BEL,0,0,54,10,64
2010,Bulgaria,BGR,Belgium,BEL,0,0,98,19,117
2010,Chad,TCD,Belgium,BEL,5,0,5,0,10
2010,China,CHN,Belgium,BEL,154,0,41,11,206
2010,Cameroon,CMR,Belgium,BEL,54,0,287,14,355
2010,Congo,COG,Belgium,BEL,0,0,15,0,15
2010,Dem. Rep. of the Congo,COD,Belgium,BEL,85,10,512,33,640
2010,Comoros,COM,Belgium,BEL,17,0,0,0,17
2010,Colombia,COL,Belgium,BEL,0,0,5,0,5
2010,Czechia,CZE,Belgium,BEL,0,0,12,0,12
2010,Djibouti,DJI,Belgium,BEL,22,0,35,0,57
2010,Eritrea,ERI,Belgium,BEL,27,5,11,0,43
2010,Ethiopia,ETH,Belgium,BEL,10,0,23,0,33
2010,Gabon,GAB,Belgium,BEL,0,0,5,0,5
2010,Gambia,GMB,Belgium,BEL,5,0,26,0,31
2010,Palestinian,PSE,Belgium,BEL,5,5,0,0,10
2010,Georgia,GEO,Belgium,BEL,5,0,199,36,240
2010,Ghana,GHA,Belgium,BEL,0,0,23,0,23
2010,Guinea-Bissau,GNB,Belgium,BEL,0,0,5,0,5
2010,Guinea,GIN,Belgium,BEL,362,12,578,45,997
2010,Croatia,HRV,Belgium,BEL,0,0,10,0,10
2010,Hungary,HUN,Belgium,BEL,0,0,22,0,22
2010,Cote d'Ivoire,CIV,Belgium,BEL,0,0,93,5,98
2010,India,IND,Belgium,BEL,0,0,56,5,61
2010,Iran (Islamic Rep. of),IRN,Belgium,BEL,58,0,107,41,206
2010,Iraq,IRQ,Belgium,BEL,303,424,199,55,981
2010,Jordan,JOR,Belgium,BEL,5,0,5,10,20
2010,Kazakhstan,KAZ,Belgium,BEL,5,0,37,0,42
2010,Kenya,KEN,Belgium,BEL,5,0,38,0,43
2010,Kyrgyzstan,KGZ,Belgium,BEL,5,0,13,10,28
2010,Dem. People's Rep. of Korea,PRK,Belgium,BEL,5,0,0,0,5
2010,Liberia,LBR,Belgium,BEL,5,0,18,0,23
2010,Libya,LBY,Belgium,BEL,0,0,5,0,5
2010,Lebanon,LBN,Belgium,BEL,11,0,76,10,97
2010,Sri Lanka,LKA,Belgium,BEL,48,0,76,10,134
2010,Madagascar,MDG,Belgium,BEL,0,0,5,0,5
2010,Mauritania,MRT,Belgium,BEL,23,0,146,0,169
2010,North Macedonia,MKD,Belgium,BEL,24,0,786,244,1054
2010,Rep. of Moldova,MDA,Belgium,BEL,0,0,10,0,10
2010,Mali,MLI,Belgium,BEL,0,0,10,0,10
2010,Mongolia,MNG,Belgium,BEL,0,0,19,5,24
2010,Morocco,MAR,Belgium,BEL,5,0,25,5,35
2010,Malta,MLT,Belgium,BEL,0,0,5,0,5
2010,Montenegro,MNE,Belgium,BEL,5,0,16,5,26
2010,Myanmar,MMR,Belgium,BEL,5,0,5,0,10
2010,Nepal,NPL,Belgium,BEL,0,0,27,5,32
2010,Niger,NER,Belgium,BEL,15,0,63,10,88
2010,Nigeria,NGA,Belgium,BEL,0,0,110,10,120
2010,Pakistan,PAK,Belgium,BEL,5,0,90,10,105
2010,Poland,POL,Belgium,BEL,0,0,0,5,5
2010,Romania,ROU,Belgium,BEL,0,0,69,0,69
2010,Russian Federation,RUS,Belgium,BEL,215,0,1574,117,1906
2010,Rwanda,RWA,Belgium,BEL,115,0,370,17,502
2010,Serbia and Kosovo: S/RES/1244 (1999),SRB,Belgium,BEL,259,0,2427,458,3144
2010,Senegal,SEN,Belgium,BEL,56,0,94,5,155
2010,Sierra Leone,SLE,Belgium,BEL,0,0,39,0,39
2010,Somalia,SOM,Belgium,BEL,44,42,87,5,178
2010,Viet Nam,VNM,Belgium,BEL,0,0,5,0,5
2010,Sudan,SDN,Belgium,BEL,13,5,31,5,54
2010,Suriname,SUR,Belgium,BEL,0,0,5,0,5
2010,Slovakia,SVK,Belgium,BEL,0,0,37,0,37
2010,Syrian Arab Rep.,SYR,Belgium,BEL,98,0,150,10,258
2010,United Rep. of Tanzania,TZA,Belgium,BEL,10,0,117,0,127
2010,Tajikistan,TJK,Belgium,BEL,0,0,5,0,5
2010,Togo,TGO,Belgium,BEL,17,0,207,5,229
2010,Tunisia,TUN,Belgium,BEL,0,0,12,5,17
2010,Turkey,TUR,Belgium,BEL,67,0,272,47,386
2010,Uganda,UGA,Belgium,BEL,5,0,10,0,15
2010,Ukraine,UKR,Belgium,BEL,0,0,32,10,42
2010,Uzbekistan,UZB,Belgium,BEL,0,0,22,5,27
2010,Yemen,YEM,Belgium,BEL,0,0,5,0,5
2010,Stateless,XXA,Belgium,BEL,0,0,5,0,5
2010,Unknown ,,Belgium,BEL,71,10,77,20,178
2010,Central African Rep.,CAF,Benin,BEN,0,0,5,0,5
2010,Chad,TCD,Benin,BEN,0,0,10,0,10
2010,Congo,COG,Benin,BEN,5,0,5,0,10
2010,Dem. Rep. of the Congo,COD,Benin,BEN,0,0,12,0,12
2010,Guinea,GIN,Benin,BEN,0,0,5,0,5
2010,Nigeria,NGA,Benin,BEN,0,0,15,0,15
2010,Togo,TGO,Benin,BEN,11,0,17,0,28
2010,Cuba,CUB,Bahamas,BHS,0,0,0,5,5
2010,Chad,TCD,Burkina Faso,BFA,0,0,0,5,5
2010,Cote d'Ivoire,CIV,Burkina Faso,BFA,0,0,0,5,5
2010,Togo,TGO,Burkina Faso,BFA,0,0,0,5,5
2010,Afghanistan,AFG,Belarus,BLR,5,0,86,10,101
2010,Georgia,GEO,Belarus,BLR,0,0,12,5,17
2010,Iran (Islamic Rep. of),IRN,Belarus,BLR,0,5,0,0,5
2010,Pakistan,PAK,Belarus,BLR,0,0,5,0,5
2010,Poland,POL,Belarus,BLR,0,0,0,5,5
2010,Russian Federation,RUS,Belarus,BLR,0,0,16,0,16
2010,Ukraine,UKR,Belarus,BLR,0,0,0,5,5
2010,Colombia,COL,Bolivia (Plurinational State of),BOL,14,5,0,20,39
2010,Afghanistan,AFG,Brazil,BRA,10,0,0,5,15
2010,Angola,AGO,Brazil,BRA,0,0,5,0,5
2010,Argentina,ARG,Brazil,BRA,0,0,5,0,5
2010,Bangladesh,BGD,Brazil,BRA,0,0,12,0,12
2010,Bhutan,BTN,Brazil,BRA,5,0,0,0,5
2010,Bolivia (Plurinational State of),BOL,Brazil,BRA,5,0,5,0,10
2010,Dem. Rep. of the Congo,COD,Brazil,BRA,43,0,24,5,72
2010,Colombia,COL,Brazil,BRA,21,0,49,11,81
2010,Cuba,CUB,Brazil,BRA,5,0,20,0,25
2010,Eritrea,ERI,Brazil,BRA,10,0,18,0,28
2010,Guinea-Bissau,GNB,Brazil,BRA,0,0,5,5,10
2010,Guinea,GIN,Brazil,BRA,0,0,5,0,5
2010,Haiti,HTI,Brazil,BRA,0,0,5,13,18
2010,Iran (Islamic Rep. of),IRN,Brazil,BRA,5,0,0,0,5
2010,Iraq,IRQ,Brazil,BRA,5,0,0,0,5
2010,Sri Lanka,LKA,Brazil,BRA,0,0,5,0,5
2010,Nigeria,NGA,Brazil,BRA,0,0,0,5,5
2010,Pakistan,PAK,Brazil,BRA,10,0,10,0,20
2010,Peru,PER,Brazil,BRA,5,0,0,0,5
2010,Somalia,SOM,Brazil,BRA,0,0,5,0,5
2010,Sudan,SDN,Brazil,BRA,5,0,5,0,10
2010,Venezuela (Bolivarian Republic of),VEN,Brazil,BRA,0,0,5,0,5
2010,Viet Nam,VNM,Cambodia,KHM,5,0,0,0,5
2010,Afghanistan,AFG,Canada,CAN,412,0,26,49,487
2010,Albania,ALB,Canada,CAN,112,0,173,30,315
2010,Algeria,DZA,Canada,CAN,19,0,24,16,59
2010,Angola,AGO,Canada,CAN,10,0,0,0,10
2010,Antigua and Barbuda,ATG,Canada,CAN,10,0,13,5,28
2010,Egypt,EGY,Canada,CAN,28,0,10,5,43
2010,Argentina,ARG,Canada,CAN,5,0,10,10,25
2010,Armenia,ARM,Canada,CAN,17,0,12,5,34
2010,Australia,AUS,Canada,CAN,0,0,5,5,10
2010,Azerbaijan,AZE,Canada,CAN,15,0,0,0,15
2010,Barbados,BRB,Canada,CAN,14,0,21,5,40
2010,Burundi,BDI,Canada,CAN,131,0,17,5,153
2010,Belgium,BEL,Canada,CAN,0,0,0,5,5
2010,Benin,BEN,Canada,CAN,5,0,5,0,10
2010,Bangladesh,BGD,Canada,CAN,43,0,63,16,122
2010,Bahamas,BHS,Canada,CAN,0,0,10,0,10
2010,Burkina Faso,BFA,Canada,CAN,10,0,10,0,20
2010,Belarus,BLR,Canada,CAN,10,0,10,5,25
2010,Bolivia (Plurinational State of),BOL,Canada,CAN,10,0,10,5,25
2010,Botswana,BWA,Canada,CAN,36,0,23,14,73
2010,Brazil,BRA,Canada,CAN,10,0,48,49,107
2010,Bosnia and Herzegovina,BIH,Canada,CAN,5,0,18,5,28
2010,Bulgaria,BGR,Canada,CAN,18,0,5,10,33
2010,Belize,BLZ,Canada,CAN,0,0,5,0,5
2010,Cambodia,KHM,Canada,CAN,18,0,12,0,30
2010,Chad,TCD,Canada,CAN,29,0,18,0,47
2010,China,CHN,Canada,CAN,883,0,584,192,1659
2010,Chile,CHL,Canada,CAN,10,0,34,10,54
2010,Cameroon,CMR,Canada,CAN,104,0,52,10,166
2010,Congo,COG,Canada,CAN,24,0,11,5,40
2010,Dem. Rep. of the Congo,COD,Canada,CAN,207,0,73,17,297
2010,Colombia,COL,Canada,CAN,1266,0,1019,127,2412
2010,Costa Rica,CRI,Canada,CAN,0,0,10,10,20
2010,Cuba,CUB,Canada,CAN,116,0,103,47,266
2010,Czechia,CZE,Canada,CAN,24,0,274,671,969
2010,Djibouti,DJI,Canada,CAN,50,0,5,0,55
2010,Dominica,DMA,Canada,CAN,0,0,5,0,5
2010,Dominican Rep.,DOM,Canada,CAN,5,0,32,14,51
2010,Ecuador,ECU,Canada,CAN,10,0,31,10,51
2010,Eritrea,ERI,Canada,CAN,144,0,5,11,160
2010,Ethiopia,ETH,Canada,CAN,181,0,19,5,205
2010,Fiji,FJI,Canada,CAN,0,0,24,5,29
2010,France,FRA,Canada,CAN,0,0,26,22,48
2010,Gambia,GMB,Canada,CAN,5,0,5,0,10
2010,Palestinian,PSE,Canada,CAN,80,0,22,10,112
2010,United Kingdom of Great Britain and Northern Ireland,GBR,Canada,CAN,0,0,10,12,22
2010,Georgia,GEO,Canada,CAN,35,0,31,10,76
2010,Germany,DEU,Canada,CAN,0,0,41,18,59
2010,Ghana,GHA,Canada,CAN,26,0,30,13,69
2010,Greece,GRC,Canada,CAN,0,0,0,5,5
2010,Grenada,GRD,Canada,CAN,5,0,30,14,49
2010,Guatemala,GTM,Canada,CAN,69,0,142,42,253
2010,Guinea,GIN,Canada,CAN,43,0,23,5,71
2010,Guyana,GUY,Canada,CAN,33,0,112,33,178
2010,Haiti,HTI,Canada,CAN,2490,0,1778,295,4563
2010,"China, Hong Kong SAR",HKG,Canada,CAN,0,0,19,30,49
2010,Honduras,HND,Canada,CAN,49,0,207,53,309
2010,Croatia,HRV,Canada,CAN,5,0,12,5,22
2010,Hungary,HUN,Canada,CAN,22,0,72,1084,1178
2010,Cote d'Ivoire,CIV,Canada,CAN,25,0,12,5,42
2010,India,IND,Canada,CAN,124,0,206,88,418
2010,Indonesia,IDN,Canada,CAN,14,0,34,5,53
2010,Iran (Islamic Rep. of),IRN,Canada,CAN,270,0,62,34,366
2010,Iraq,IRQ,Canada,CAN,191,0,48,25,264
2010,Israel,ISR,Canada,CAN,56,0,324,104,484
2010,Italy,ITA,Canada,CAN,0,0,11,0,11
2010,Jamaica,JAM,Canada,CAN,75,0,125,60,260
2010,Jordan,JOR,Canada,CAN,37,0,54,14,105
2010,Japan,JPN,Canada,CAN,0,0,10,5,15
2010,Kazakhstan,KAZ,Canada,CAN,10,0,5,0,15
2010,Kenya,KEN,Canada,CAN,71,0,24,5,100
2010,Kyrgyzstan,KGZ,Canada,CAN,5,0,0,0,5
2010,Rep. of Korea,KOR,Canada,CAN,12,0,137,40,189
2010,Dem. People's Rep. of Korea,PRK,Canada,CAN,42,0,0,14,56
2010,Kuwait,KWT,Canada,CAN,14,0,0,0,14
2010,Lao People's Dem. Rep.,LAO,Canada,CAN,0,0,5,5,10
2010,Liberia,LBR,Canada,CAN,11,0,16,5,32
2010,Libya,LBY,Canada,CAN,15,0,10,5,30
2010,Saint Lucia,LCA,Canada,CAN,117,0,210,71,398
2010,Lebanon,LBN,Canada,CAN,59,0,93,32,184
2010,Sri Lanka,LKA,Canada,CAN,513,0,138,21,672
2010,Lithuania,LTU,Canada,CAN,0,0,5,5,10
2010,Latvia,LVA,Canada,CAN,0,0,5,11,16
2010,Madagascar,MDG,Canada,CAN,5,0,0,0,5
2010,Mauritania,MRT,Canada,CAN,10,0,5,5,20
2010,North Macedonia,MKD,Canada,CAN,5,0,15,0,20
2010,Rep. of Moldova,MDA,Canada,CAN,25,0,20,10,55
2010,Mexico,MEX,Canada,CAN,653,0,3437,1737,5827
2010,Mali,MLI,Canada,CAN,0,0,10,5,15
2010,Malaysia,MYS,Canada,CAN,5,0,20,0,25
2010,Mongolia,MNG,Canada,CAN,16,0,22,0,38
2010,Morocco,MAR,Canada,CAN,10,0,5,12,27
2010,Montenegro,MNE,Canada,CAN,0,0,5,0,5
2010,Mauritius,MUS,Canada,CAN,0,0,5,0,5
2010,Myanmar,MMR,Canada,CAN,5,0,0,0,5
2010,Namibia,NAM,Canada,CAN,5,0,5,5,15
2010,Nepal,NPL,Canada,CAN,86,0,33,5,124
2010,Netherlands,NLD,Canada,CAN,0,0,5,5,10
2010,Niger,NER,Canada,CAN,10,0,0,0,10
2010,Nicaragua,NIC,Canada,CAN,19,0,18,5,42
2010,Nigeria,NGA,Canada,CAN,593,0,251,87,931
2010,Norway,NOR,Canada,CAN,0,0,5,0,5
2010,Pakistan,PAK,Canada,CAN,255,0,119,68,442
2010,Panama,PAN,Canada,CAN,0,0,5,5,10
2010,Paraguay,PRY,Canada,CAN,5,0,10,0,15
2010,Peru,PER,Canada,CAN,61,0,108,22,191
2010,Philippines,PHL,Canada,CAN,23,0,127,30,180
2010,Poland,POL,Canada,CAN,5,0,58,23,86
2010,Portugal,PRT,Canada,CAN,0,0,28,5,33
2010,Romania,ROU,Canada,CAN,29,0,18,39,86
2010,South Africa,ZAF,Canada,CAN,0,0,10,5,15
2010,Russian Federation,RUS,Canada,CAN,93,0,49,29,171
2010,Rwanda,RWA,Canada,CAN,159,0,41,5,205
2010,El Salvador,SLV,Canada,CAN,114,0,332,54,500
2010,Saudi Arabia,SAU,Canada,CAN,10,0,0,0,10
2010,Serbia and Kosovo: S/RES/1244 (1999),SRB,Canada,CAN,35,0,58,23,116
2010,Senegal,SEN,Canada,CAN,14,0,5,5,24
2010,Seychelles,SYC,Canada,CAN,0,0,5,0,5
2010,Sierra Leone,SLE,Canada,CAN,16,0,5,0,21
2010,San Marino,SMR,Canada,CAN,0,0,0,5,5
2010,Somalia,SOM,Canada,CAN,382,0,22,79,483
2010,Spain,ESP,Canada,CAN,0,0,12,11,23
2010,Viet Nam,VNM,Canada,CAN,10,0,18,5,33
2010,Saint Kitts and Nevis,KNA,Canada,CAN,0,0,5,5,10
2010,Sudan,SDN,Canada,CAN,35,0,5,5,45
2010,Suriname,SUR,Canada,CAN,0,0,5,0,5
2010,Slovakia,SVK,Canada,CAN,5,0,12,156,173
2010,Eswatini,SWZ,Canada,CAN,19,0,10,0,29
2010,Sweden,SWE,Canada,CAN,0,0,5,5,10
2010,Switzerland,CHE,Canada,CAN,0,0,0,5,5
2010,Syrian Arab Rep.,SYR,Canada,CAN,56,0,26,5,87
2010,United Rep. of Tanzania,TZA,Canada,CAN,29,0,5,10,44
2010,Thailand,THA,Canada,CAN,0,0,126,37,163
2010,Tajikistan,TJK,Canada,CAN,5,0,0,0,5
2010,Togo,TGO,Canada,CAN,10,0,10,0,20
2010,Trinidad and Tobago,TTO,Canada,CAN,21,0,102,28,151
2010,Tunisia,TUN,Canada,CAN,5,0,18,11,34
2010,Turkey,TUR,Canada,CAN,158,0,59,48,265
2010,United Arab Emirates,ARE,Canada,CAN,5,0,0,0,5
2010,Uganda,UGA,Canada,CAN,57,0,5,5,67
2010,Ukraine,UKR,Canada,CAN,66,0,55,38,159
2010,Uruguay,URY,Canada,CAN,5,0,16,5,26
2010,United States of America,USA,Canada,CAN,11,0,815,144,970
2010,Uzbekistan,UZB,Canada,CAN,16,0,5,0,21
2010,Saint Vincent and the Grenadines,VCT,Canada,CAN,236,0,409,90,735
2010,Venezuela (Bolivarian Republic of),VEN,Canada,CAN,110,0,52,29,191
2010,Yemen,YEM,Canada,CAN,14,0,5,0,19
2010,Zambia,ZMB,Canada,CAN,5,0,5,0,10
2010,Zimbabwe,ZWE,Canada,CAN,234,0,55,12,301
2010,Stateless,XXA,Canada,CAN,0,0,0,5,5
2010,Unknown ,,Canada,CAN,5,0,5,0,10
2010,Colombia,COL,Chile,CHL,66,0,394,0,460
2010,Cuba,CUB,Chile,CHL,0,0,5,0,5
2010,Ecuador,ECU,Chile,CHL,0,0,5,0,5
2010,Haiti,HTI,Chile,CHL,0,0,5,0,5
2010,Angola,AGO,Congo,COG,0,0,5,0,5
2010,Chad,TCD,Congo,COG,5,0,5,0,10
2010,Dem. Rep. of the Congo,COD,Congo,COG,130,0,272,0,402
2010,Cote d'Ivoire,CIV,Congo,COG,0,0,22,0,22
2010,Liberia,LBR,Congo,COG,0,0,0,5,5
2010,Rwanda,RWA,Congo,COG,5,0,10,0,15
2010,Sudan,SDN,Congo,COG,10,0,0,0,10
2010,Bangladesh,BGD,Colombia,COL,0,0,0,5,5
2010,Bolivia (Plurinational State of),BOL,Colombia,COL,0,0,5,0,5
2010,Dem. Rep. of the Congo,COD,Colombia,COL,0,0,5,0,5
2010,Cuba,CUB,Colombia,COL,0,0,11,11,22
2010,Eritrea,ERI,Colombia,COL,0,0,0,28,28
2010,Ethiopia,ETH,Colombia,COL,0,0,0,10,10
2010,El Salvador,SLV,Colombia,COL,5,0,0,0,5
2010,Somalia,SOM,Colombia,COL,0,0,0,27,27
2010,Bangladesh,BGD,Costa Rica,CRI,0,0,0,18,18
2010,Colombia,COL,Costa Rica,CRI,62,0,239,315,616
2010,Cuba,CUB,Costa Rica,CRI,29,0,15,14,58
2010,Ecuador,ECU,Costa Rica,CRI,0,0,0,5,5
2010,Eritrea,ERI,Costa Rica,CRI,0,0,0,114,114
2010,Ethiopia,ETH,Costa Rica,CRI,0,0,0,15,15
2010,Ghana,GHA,Costa Rica,CRI,0,0,0,5,5
2010,Guatemala,GTM,Costa Rica,CRI,10,0,0,0,10
2010,Haiti,HTI,Costa Rica,CRI,0,0,5,0,5
2010,Honduras,HND,Costa Rica,CRI,5,0,29,5,39
2010,Mexico,MEX,Costa Rica,CRI,0,0,5,0,5
2010,Nepal,NPL,Costa Rica,CRI,0,0,0,17,17
2010,Nicaragua,NIC,Costa Rica,CRI,0,0,5,33,38
2010,Nigeria,NGA,Costa Rica,CRI,0,0,0,5,5
2010,Pakistan,PAK,Costa Rica,CRI,0,0,0,5,5
2010,Peru,PER,Costa Rica,CRI,0,0,0,5,5
2010,El Salvador,SLV,Costa Rica,CRI,19,0,22,5,46
2010,Somalia,SOM,Costa Rica,CRI,0,0,0,91,91
2010,Sudan,SDN,Costa Rica,CRI,0,0,0,5,5
2010,United States of America,USA,Costa Rica,CRI,0,0,0,5,5
2010,Venezuela (Bolivarian Republic of),VEN,Costa Rica,CRI,23,0,37,0,60
2010,Zimbabwe,ZWE,Costa Rica,CRI,0,0,0,10,10
2010,Afghanistan,AFG,Cyprus,CYP,0,0,32,0,32
2010,Egypt,EGY,Cyprus,CYP,10,0,173,10,193
2010,Armenia,ARM,Cyprus,CYP,0,0,12,0,12
2010,Bangladesh,BGD,Cyprus,CYP,0,0,125,0,125
2010,Belarus,BLR,Cyprus,CYP,0,0,5,0,5
2010,China,CHN,Cyprus,CYP,0,0,105,0,105
2010,Cameroon,CMR,Cyprus,CYP,0,0,104,0,104
2010,Dem. Rep. of the Congo,COD,Cyprus,CYP,0,0,5,0,5
2010,Palestinian,PSE,Cyprus,CYP,5,306,15,0,326
2010,Georgia,GEO,Cyprus,CYP,0,0,65,0,65
2010,Ghana,GHA,Cyprus,CYP,0,0,5,0,5
2010,Guinea,GIN,Cyprus,CYP,0,0,5,0,5
2010,India,IND,Cyprus,CYP,0,0,259,0,259
2010,Indonesia,IDN,Cyprus,CYP,0,0,5,0,5
2010,Iran (Islamic Rep. of),IRN,Cyprus,CYP,5,0,66,5,76
2010,Iraq,IRQ,Cyprus,CYP,0,63,33,79,175
2010,Jordan,JOR,Cyprus,CYP,0,0,5,0,5
2010,Kazakhstan,KAZ,Cyprus,CYP,0,0,5,0,5
2010,Kenya,KEN,Cyprus,CYP,0,0,5,0,5
2010,Lebanon,LBN,Cyprus,CYP,0,5,19,0,24
2010,Sri Lanka,LKA,Cyprus,CYP,0,0,133,28,161
2010,Rep. of Moldova,MDA,Cyprus,CYP,0,0,5,10,15
2010,Mali,MLI,Cyprus,CYP,0,0,5,0,5
2010,Mongolia,MNG,Cyprus,CYP,0,0,5,0,5
2010,Morocco,MAR,Cyprus,CYP,0,0,10,0,10
2010,Nepal,NPL,Cyprus,CYP,0,0,91,10,101
2010,Nigeria,NGA,Cyprus,CYP,0,0,65,0,65
2010,Pakistan,PAK,Cyprus,CYP,0,0,101,10,111
2010,Philippines,PHL,Cyprus,CYP,0,0,92,5,97
2010,Russian Federation,RUS,Cyprus,CYP,0,0,5,0,5
2010,Serbia and Kosovo: S/RES/1244 (1999),SRB,Cyprus,CYP,0,5,5,0,10
2010,Viet Nam,VNM,Cyprus,CYP,0,0,185,5,190
2010,Syrian Arab Rep.,SYR,Cyprus,CYP,0,14,202,0,216
2010,Turkey,TUR,Cyprus,CYP,11,0,60,0,71
2010,Ukraine,UKR,Cyprus,CYP,0,0,16,0,16
2010,Uzbekistan,UZB,Cyprus,CYP,0,0,5,0,5
2010,Afghanistan,AFG,Czechia,CZE,0,5,0,0,5
2010,Algeria,DZA,Czechia,CZE,0,0,10,5,15
2010,Egypt,EGY,Czechia,CZE,0,0,0,5,5
2010,Armenia,ARM,Czechia,CZE,5,0,10,14,29
2010,Belarus,BLR,Czechia,CZE,0,5,23,27,55
2010,Cambodia,KHM,Czechia,CZE,0,0,0,5,5
2010,China,CHN,Czechia,CZE,0,0,0,5,5
2010,Congo,COG,Czechia,CZE,0,0,0,5,5
2010,Dem. Rep. of the Congo,COD,Czechia,CZE,5,5,26,10,46
2010,Cuba,CUB,Czechia,CZE,5,11,0,0,16
2010,Georgia,GEO,Czechia,CZE,0,0,10,5,15
2010,Ghana,GHA,Czechia,CZE,0,0,0,5,5
2010,India,IND,Czechia,CZE,0,0,0,5,5
2010,Iraq,IRQ,Czechia,CZE,5,14,0,5,24
2010,Kazakhstan,KAZ,Czechia,CZE,0,0,5,16,21
2010,Kyrgyzstan,KGZ,Czechia,CZE,5,5,5,13,28
2010,Rep. of Moldova,MDA,Czechia,CZE,0,5,11,5,21
2010,Mongolia,MNG,Czechia,CZE,0,0,58,59,117
2010,Morocco,MAR,Czechia,CZE,0,0,0,5,5
2010,Myanmar,MMR,Czechia,CZE,43,0,0,0,43
2010,Niger,NER,Czechia,CZE,0,0,21,14,35
2010,Pakistan,PAK,Czechia,CZE,0,0,5,0,5
2010,Russian Federation,RUS,Czechia,CZE,18,17,10,28,73
2010,Serbia and Kosovo: S/RES/1244 (1999),SRB,Czechia,CZE,0,0,10,5,15
2010,Sierra Leone,SLE,Czechia,CZE,5,0,0,0,5
2010,Somalia,SOM,Czechia,CZE,5,0,0,0,5
2010,Viet Nam,VNM,Czechia,CZE,0,0,22,18,40
2010,Slovakia,SVK,Czechia,CZE,0,0,0,5,5
2010,Syrian Arab Rep.,SYR,Czechia,CZE,5,0,24,16,45
2010,Turkey,TUR,Czechia,CZE,0,0,10,59,69
2010,Ukraine,UKR,Czechia,CZE,11,5,73,56,145
2010,Uzbekistan,UZB,Czechia,CZE,0,18,0,0,18
2010,Stateless,XXA,Czechia,CZE,5,5,15,21,46
2010,Afghanistan,AFG,Denmark,DNK,16,397,597,0,1010
2010,Albania,ALB,Denmark,DNK,0,0,5,0,5
2010,Algeria,DZA,Denmark,DNK,5,0,5,0,10
2010,Armenia,ARM,Denmark,DNK,0,0,17,0,17
2010,Azerbaijan,AZE,Denmark,DNK,5,5,10,0,20
2010,Bangladesh,BGD,Denmark,DNK,5,0,10,0,15
2010,Bosnia and Herzegovina,BIH,Denmark,DNK,0,0,14,0,14
2010,Bulgaria,BGR,Denmark,DNK,0,0,5,0,5
2010,China,CHN,Denmark,DNK,0,0,10,0,10
2010,Cameroon,CMR,Denmark,DNK,0,0,5,0,5
2010,Congo,COG,Denmark,DNK,0,0,5,0,5
2010,Dem. Rep. of the Congo,COD,Denmark,DNK,5,5,13,0,23
2010,Eritrea,ERI,Denmark,DNK,5,10,10,0,25
2010,Ethiopia,ETH,Denmark,DNK,0,0,5,0,5
2010,Gambia,GMB,Denmark,DNK,0,0,5,0,5
2010,Palestinian,PSE,Denmark,DNK,5,0,27,0,32
2010,Ghana,GHA,Denmark,DNK,0,0,5,0,5
2010,Guinea,GIN,Denmark,DNK,0,0,5,0,5
2010,Haiti,HTI,Denmark,DNK,0,0,5,0,5
2010,Hungary,HUN,Denmark,DNK,0,0,5,0,5
2010,India,IND,Denmark,DNK,0,0,19,0,19
2010,Iran (Islamic Rep. of),IRN,Denmark,DNK,190,17,121,0,328
2010,Iraq,IRQ,Denmark,DNK,5,16,71,0,92
2010,Israel,ISR,Denmark,DNK,0,0,5,0,5
2010,Jordan,JOR,Denmark,DNK,0,0,5,0,5
2010,Kenya,KEN,Denmark,DNK,0,0,5,0,5
2010,Libya,LBY,Denmark,DNK,0,5,10,0,15
2010,Lebanon,LBN,Denmark,DNK,0,0,5,0,5
2010,Sri Lanka,LKA,Denmark,DNK,5,0,54,0,59
2010,North Macedonia,MKD,Denmark,DNK,0,0,13,0,13
2010,Rep. of Moldova,MDA,Denmark,DNK,0,0,5,0,5
2010,Morocco,MAR,Denmark,DNK,0,0,10,0,10
2010,Montenegro,MNE,Denmark,DNK,0,0,5,0,5
2010,Myanmar,MMR,Denmark,DNK,5,0,10,0,15
2010,Nigeria,NGA,Denmark,DNK,0,0,19,0,19
2010,Pakistan,PAK,Denmark,DNK,0,0,12,0,12
2010,Poland,POL,Denmark,DNK,0,0,5,0,5
2010,Russian Federation,RUS,Denmark,DNK,73,26,54,0,153
2010,Rwanda,RWA,Denmark,DNK,0,0,5,0,5
2010,Serbia and Kosovo: S/RES/1244 (1999),SRB,Denmark,DNK,0,0,331,0,331
2010,Somalia,SOM,Denmark,DNK,5,20,47,0,72
2010,Viet Nam,VNM,Denmark,DNK,0,0,5,0,5
2010,Sudan,SDN,Denmark,DNK,0,0,20,0,20
2010,Syrian Arab Rep.,SYR,Denmark,DNK,327,11,250,0,588
2010,United Rep. of Tanzania,TZA,Denmark,DNK,0,0,5,0,5
2010,Tunisia,TUN,Denmark,DNK,0,0,5,0,5
2010,Turkey,TUR,Denmark,DNK,0,0,31,0,31
2010,Uganda,UGA,Denmark,DNK,0,0,16,0,16
2010,Uzbekistan,UZB,Denmark,DNK,0,0,10,0,10
2010,Zimbabwe,ZWE,Denmark,DNK,0,0,5,0,5
2010,Sudan,SDN,Dominican Rep.,DOM,5,0,0,0,5
2010,Afghanistan,AFG,Estonia,EST,5,0,10,0,15
2010,Georgia,GEO,Estonia,EST,0,0,5,0,5
2010,Sri Lanka,LKA,Estonia,EST,5,0,0,0,5
2010,Nigeria,NGA,Estonia,EST,0,0,5,0,5
2010,Russian Federation,RUS,Estonia,EST,0,5,5,0,10
2010,Afghanistan,AFG,Finland,FIN,28,168,154,112,462
2010,Albania,ALB,Finland,FIN,0,0,5,5,10
2010,Algeria,DZA,Finland,FIN,0,5,5,45,55
2010,Angola,AGO,Finland,FIN,0,21,25,5,51
2010,Armenia,ARM,Finland,FIN,0,0,0,13,13
2010,Azerbaijan,AZE,Finland,FIN,0,5,0,5,10
2010,Burundi,BDI,Finland,FIN,0,0,5,0,5
2010,Bangladesh,BGD,Finland,FIN,0,0,5,5,10
2010,Burkina Faso,BFA,Finland,FIN,0,0,0,5,5
2010,Belarus,BLR,Finland,FIN,0,0,12,75,87
2010,Bosnia and Herzegovina,BIH,Finland,FIN,0,0,0,11,11
2010,Bulgaria,BGR,Finland,FIN,0,0,0,644,644
2010,China,CHN,Finland,FIN,0,10,0,0,10
2010,Cameroon,CMR,Finland,FIN,0,5,15,10,30
2010,Congo,COG,Finland,FIN,0,0,5,0,5
2010,Dem. Rep. of the Congo,COD,Finland,FIN,0,19,17,10,46
2010,Eritrea,ERI,Finland,FIN,0,0,0,12,12
2010,Estonia,EST,Finland,FIN,0,0,0,5,5
2010,Ethiopia,ETH,Finland,FIN,0,5,5,10,20
2010,Gambia,GMB,Finland,FIN,0,0,17,31,48
2010,Georgia,GEO,Finland,FIN,0,0,0,53,53
2010,Ghana,GHA,Finland,FIN,0,5,29,36,70
2010,Guinea,GIN,Finland,FIN,0,5,5,5,15
2010,Honduras,HND,Finland,FIN,0,0,0,5,5
2010,Croatia,HRV,Finland,FIN,0,0,0,5,5
2010,Cote d'Ivoire,CIV,Finland,FIN,0,0,0,5,5
2010,India,IND,Finland,FIN,0,0,5,19,24
2010,Iran (Islamic Rep. of),IRN,Finland,FIN,17,41,71,46,175
2010,Iraq,IRQ,Finland,FIN,71,536,266,336,1209
2010,Israel,ISR,Finland,FIN,0,0,0,5,5
2010,Kazakhstan,KAZ,Finland,FIN,0,0,0,5,5
2010,Kenya,KEN,Finland,FIN,0,0,5,5,10
2010,Liberia,LBR,Finland,FIN,0,0,0,5,5
2010,Libya,LBY,Finland,FIN,0,0,0,5,5
2010,Sri Lanka,LKA,Finland,FIN,0,20,42,15,77
2010,North Macedonia,MKD,Finland,FIN,0,0,0,17,17
2010,Rep. of Moldova,MDA,Finland,FIN,0,0,0,5,5
2010,Morocco,MAR,Finland,FIN,0,0,5,17,22
2010,Nigeria,NGA,Finland,FIN,0,22,39,71,132
2010,Pakistan,PAK,Finland,FIN,0,5,5,0,10
2010,Romania,ROU,Finland,FIN,0,0,0,93,93
2010,Russian Federation,RUS,Finland,FIN,38,23,95,288,444
2010,Rwanda,RWA,Finland,FIN,0,0,5,0,5
2010,Serbia and Kosovo: S/RES/1244 (1999),SRB,Finland,FIN,0,19,48,281,348
2010,Senegal,SEN,Finland,FIN,0,0,0,5,5
2010,Sierra Leone,SLE,Finland,FIN,0,0,5,5,10
2010,Somalia,SOM,Finland,FIN,5,647,89,305,1046
2010,Sudan,SDN,Finland,FIN,5,0,0,10,15
2010,Slovakia,SVK,Finland,FIN,0,0,0,5,5
2010,Syrian Arab Rep.,SYR,Finland,FIN,0,5,12,16,33
2010,United Rep. of Tanzania,TZA,Finland,FIN,0,0,0,10,10
2010,Togo,TGO,Finland,FIN,0,0,0,5,5
2010,Tunisia,TUN,Finland,FIN,0,0,0,10,10
2010,Turkey,TUR,Finland,FIN,0,5,88,58,151
2010,Ukraine,UKR,Finland,FIN,0,0,5,5,10
2010,Uzbekistan,UZB,Finland,FIN,0,0,5,5,10
2010,Zimbabwe,ZWE,Finland,FIN,0,0,5,0,5
2010,Stateless,XXA,Finland,FIN,5,5,10,32,52
2010,Unknown ,,Finland,FIN,0,16,11,96,123
2010,Afghanistan,AFG,France,FRA,142,14,297,0,453
2010,Albania,ALB,France,FRA,11,5,417,0,433
2010,Algeria,DZA,France,FRA,19,15,878,0,912
2010,Angola,AGO,France,FRA,49,0,358,0,407
2010,Egypt,EGY,France,FRA,0,0,38,0,38
2010,Armenia,ARM,France,FRA,112,11,2329,0,2452
2010,Azerbaijan,AZE,France,FRA,74,0,489,0,563
2010,Burundi,BDI,France,FRA,14,0,16,0,30
2010,Bangladesh,BGD,France,FRA,26,0,2386,0,2412
2010,Bhutan,BTN,France,FRA,0,0,12,0,12
2010,Belarus,BLR,France,FRA,10,0,53,0,63
2010,Bolivia (Plurinational State of),BOL,France,FRA,0,0,5,0,5
2010,Bosnia and Herzegovina,BIH,France,FRA,24,0,345,0,369
2010,Bulgaria,BGR,France,FRA,0,0,10,0,10
2010,Cambodia,KHM,France,FRA,10,0,10,0,20
2010,Central African Rep.,CAF,France,FRA,10,5,103,0,118
2010,Chad,TCD,France,FRA,26,5,143,0,174
2010,China,CHN,France,FRA,139,0,1307,0,1446
2010,Cameroon,CMR,France,FRA,19,5,156,0,180
2010,Congo,COG,France,FRA,47,5,580,0,632
2010,Dem. Rep. of the Congo,COD,France,FRA,252,5,1828,0,2085
2010,Comoros,COM,France,FRA,84,0,455,0,539
2010,Colombia,COL,France,FRA,15,5,114,0,134
2010,Djibouti,DJI,France,FRA,10,5,5,0,20
2010,Eritrea,ERI,France,FRA,281,5,225,0,511
2010,Ethiopia,ETH,France,FRA,22,5,35,0,62
2010,Gambia,GMB,France,FRA,0,0,51,0,51
2010,Palestinian,PSE,France,FRA,37,0,71,0,108
2010,Georgia,GEO,France,FRA,15,0,510,0,525
2010,Guinea-Bissau,GNB,France,FRA,13,10,136,0,159
2010,Guinea,GIN,France,FRA,120,135,1308,0,1563
2010,Guyana,GUY,France,FRA,0,0,10,0,10
2010,Haiti,HTI,France,FRA,111,41,1411,0,1563
2010,Cote d'Ivoire,CIV,France,FRA,64,65,318,0,447
2010,Iran (Islamic Rep. of),IRN,France,FRA,184,0,79,0,263
2010,Iraq,IRQ,France,FRA,244,5,87,0,336
2010,Kazakhstan,KAZ,France,FRA,0,0,106,0,106
2010,Kenya,KEN,France,FRA,0,0,14,0,14
2010,Kyrgyzstan,KGZ,France,FRA,0,0,37,0,37
2010,Sri Lanka,LKA,France,FRA,579,5,2287,0,2871
2010,Madagascar,MDG,France,FRA,5,5,164,0,174
2010,Mauritania,MRT,France,FRA,55,23,938,0,1016
2010,North Macedonia,MKD,France,FRA,12,0,325,0,337
2010,Mali,MLI,France,FRA,12,415,145,0,572
2010,Mongolia,MNG,France,FRA,5,0,167,0,172
2010,Morocco,MAR,France,FRA,5,0,77,0,82
2010,Montenegro,MNE,France,FRA,0,0,48,0,48
2010,Myanmar,MMR,France,FRA,10,0,17,0,27
2010,Nepal,NPL,France,FRA,0,0,33,0,33
2010,Niger,NER,France,FRA,0,0,18,0,18
2010,Nigeria,NGA,France,FRA,10,16,549,0,575
2010,Pakistan,PAK,France,FRA,15,0,526,0,541
2010,Romania,ROU,France,FRA,0,0,25,0,25
2010,Russian Federation,RUS,France,FRA,367,5,2279,0,2651
2010,Rwanda,RWA,France,FRA,119,0,118,0,237
2010,Serbia and Kosovo: S/RES/1244 (1999),SRB,France,FRA,138,11,3961,0,4110
2010,Senegal,SEN,France,FRA,12,59,87,0,158
2010,Sierra Leone,SLE,France,FRA,5,10,96,0,111
2010,Somalia,SOM,France,FRA,103,86,84,0,273
2010,Sudan,SDN,France,FRA,137,13,736,0,886
2010,Syrian Arab Rep.,SYR,France,FRA,27,0,85,0,112
2010,Tajikistan,TJK,France,FRA,0,0,10,0,10
2010,Togo,TGO,France,FRA,24,0,108,0,132
2010,Tunisia,TUN,France,FRA,10,0,37,0,47
2010,Turkey,TUR,France,FRA,123,0,1895,0,2018
2010,Uganda,UGA,France,FRA,5,0,10,0,15
2010,Ukraine,UKR,France,FRA,10,0,75,0,85
2010,Zimbabwe,ZWE,France,FRA,10,0,5,0,15
2010,Stateless,XXA,France,FRA,61,0,119,0,180
2010,Unknown ,,France,FRA,40,12,820,122,994
2010,Afghanistan,AFG,United Kingdom of Great Britain and Northern Ireland,GBR,216,614,1441,571,2842
2010,Albania,ALB,United Kingdom of Great Britain and Northern Ireland,GBR,14,37,186,46,283
2010,Algeria,DZA,United Kingdom of Great Britain and Northern Ireland,GBR,5,15,228,123,371
2010,Angola,AGO,United Kingdom of Great Britain and Northern Ireland,GBR,12,15,61,10,98
2010,Egypt,EGY,United Kingdom of Great Britain and Northern Ireland,GBR,5,5,108,12,130
2010,Armenia,ARM,United Kingdom of Great Britain and Northern Ireland,GBR,0,0,24,5,29
2010,Azerbaijan,AZE,United Kingdom of Great Britain and Northern Ireland,GBR,21,0,12,5,38
2010,Barbados,BRB,United Kingdom of Great Britain and Northern Ireland,GBR,0,0,5,0,5
2010,Burundi,BDI,United Kingdom of Great Britain and Northern Ireland,GBR,0,5,13,0,18
2010,Benin,BEN,United Kingdom of Great Britain and Northern Ireland,GBR,0,0,10,5,15
2010,Bangladesh,BGD,United Kingdom of Great Britain and Northern Ireland,GBR,10,47,402,117,576
2010,Bahamas,BHS,United Kingdom of Great Britain and Northern Ireland,GBR,0,5,0,0,5
2010,Bhutan,BTN,United Kingdom of Great Britain and Northern Ireland,GBR,16,0,14,0,30
2010,Burkina Faso,BFA,United Kingdom of Great Britain and Northern Ireland,GBR,0,0,5,0,5
2010,Belarus,BLR,United Kingdom of Great Britain and Northern Ireland,GBR,5,0,30,5,40
2010,Bolivia (Plurinational State of),BOL,United Kingdom of Great Britain and Northern Ireland,GBR,0,0,27,5,32
2010,Botswana,BWA,United Kingdom of Great Britain and Northern Ireland,GBR,5,0,13,0,18
2010,Brazil,BRA,United Kingdom of Great Britain and Northern Ireland,GBR,0,5,46,11,62
2010,Bosnia and Herzegovina,BIH,United Kingdom of Great Britain and Northern Ireland,GBR,10,0,11,5,26
2010,Bulgaria,BGR,United Kingdom of Great Britain and Northern Ireland,GBR,0,0,0,5,5
2010,Belize,BLZ,United Kingdom of Great Britain and Northern Ireland,GBR,0,0,5,0,5
2010,Chad,TCD,United Kingdom of Great Britain and Northern Ireland,GBR,0,0,10,0,10
2010,China,CHN,United Kingdom of Great Britain and Northern Ireland,GBR,106,61,1422,317,1906
2010,Chile,CHL,United Kingdom of Great Britain and Northern Ireland,GBR,0,0,10,0,10
2010,Cameroon,CMR,United Kingdom of Great Britain and Northern Ireland,GBR,25,10,82,10,127
2010,Congo,COG,United Kingdom of Great Britain and Northern Ireland,GBR,5,5,24,5,39
2010,Dem. Rep. of the Congo,COD,United Kingdom of Great Britain and Northern Ireland,GBR,59,14,240,25,338
2010,Colombia,COL,United Kingdom of Great Britain and Northern Ireland,GBR,0,5,20,5,30
2010,Cuba,CUB,United Kingdom of Great Britain and Northern Ireland,GBR,0,0,15,0,15
2010,Cyprus,CYP,United Kingdom of Great Britain and Northern Ireland,GBR,0,0,0,5,5
2010,Czechia,CZE,United Kingdom of Great Britain and Northern Ireland,GBR,0,0,0,17,17
2010,Dominica,DMA,United Kingdom of Great Britain and Northern Ireland,GBR,0,0,5,0,5
2010,Dominican Rep.,DOM,United Kingdom of Great Britain and Northern Ireland,GBR,0,0,5,0,5
2010,Ecuador,ECU,United Kingdom of Great Britain and Northern Ireland,GBR,0,0,5,0,5
2010,Eritrea,ERI,United Kingdom of Great Britain and Northern Ireland,GBR,565,34,252,195,1046
2010,Estonia,EST,United Kingdom of Great Britain and Northern Ireland,GBR,0,0,0,5,5
2010,Ethiopia,ETH,United Kingdom of Great Britain and Northern Ireland,GBR,31,10,98,13,152
2010,France,FRA,United Kingdom of Great Britain and Northern Ireland,GBR,0,0,0,5,5
2010,Gambia,GMB,United Kingdom of Great Britain and Northern Ireland,GBR,125,58,324,21,528
2010,Palestinian,PSE,United Kingdom of Great Britain and Northern Ireland,GBR,25,23,188,65,301
2010,United Kingdom of Great Britain and Northern Ireland,GBR,United Kingdom of Great Britain and Northern Ireland,GBR,0,0,10,11,21
2010,Georgia,GEO,United Kingdom of Great Britain and Northern Ireland,GBR,5,0,72,10,87
2010,Ghana,GHA,United Kingdom of Great Britain and Northern Ireland,GBR,0,10,185,48,243
2010,Guinea-Bissau,GNB,United Kingdom of Great Britain and Northern Ireland,GBR,0,0,5,0,5
2010,Guinea,GIN,United Kingdom of Great Britain and Northern Ireland,GBR,25,11,90,17,143
2010,Guyana,GUY,United Kingdom of Great Britain and Northern Ireland,GBR,0,0,10,0,10
2010,Croatia,HRV,United Kingdom of Great Britain and Northern Ireland,GBR,0,0,5,0,5
2010,Cote d'Ivoire,CIV,United Kingdom of Great Britain and Northern Ireland,GBR,5,5,63,5,78
2010,India,IND,United Kingdom of Great Britain and Northern Ireland,GBR,0,13,420,286,719
2010,Indonesia,IDN,United Kingdom of Great Britain and Northern Ireland,GBR,0,0,5,0,5
2010,Iran (Islamic Rep. of),IRN,United Kingdom of Great Britain and Northern Ireland,GBR,699,145,1774,178,2796
2010,Iraq,IRQ,United Kingdom of Great Britain and Northern Ireland,GBR,81,88,699,120,988
2010,Israel,ISR,United Kingdom of Great Britain and Northern Ireland,GBR,0,0,13,0,13
2010,Jamaica,JAM,United Kingdom of Great Britain and Northern Ireland,GBR,24,28,229,44,325
2010,Jordan,JOR,United Kingdom of Great Britain and Northern Ireland,GBR,5,0,16,5,26
2010,Kenya,KEN,United Kingdom of Great Britain and Northern Ireland,GBR,17,5,120,21,163
2010,Kyrgyzstan,KGZ,United Kingdom of Great Britain and Northern Ireland,GBR,0,0,20,5,25
2010,Rep. of Korea,KOR,United Kingdom of Great Britain and Northern Ireland,GBR,0,0,14,0,14
2010,Dem. People's Rep. of Korea,PRK,United Kingdom of Great Britain and Northern Ireland,GBR,0,5,141,28,174
2010,Kuwait,KWT,United Kingdom of Great Britain and Northern Ireland,GBR,30,5,60,10,105
2010,Liberia,LBR,United Kingdom of Great Britain and Northern Ireland,GBR,0,5,11,0,16
2010,Libya,LBY,United Kingdom of Great Britain and Northern Ireland,GBR,22,0,119,15,156
2010,Saint Lucia,LCA,United Kingdom of Great Britain and Northern Ireland,GBR,0,0,5,0,5
2010,Lebanon,LBN,United Kingdom of Great Britain and Northern Ireland,GBR,0,10,55,13,78
2010,Sri Lanka,LKA,United Kingdom of Great Britain and Northern Ireland,GBR,237,48,1695,137,2117
2010,Lithuania,LTU,United Kingdom of Great Britain and Northern Ireland,GBR,0,0,5,10,15
2010,Mauritania,MRT,United Kingdom of Great Britain and Northern Ireland,GBR,0,0,10,0,10
2010,North Macedonia,MKD,United Kingdom of Great Britain and Northern Ireland,GBR,0,0,5,15,20
2010,Rep. of Moldova,MDA,United Kingdom of Great Britain and Northern Ireland,GBR,0,0,5,5,10
2010,Mexico,MEX,United Kingdom of Great Britain and Northern Ireland,GBR,0,0,10,5,15
2010,Mali,MLI,United Kingdom of Great Britain and Northern Ireland,GBR,0,0,12,0,12
2010,Malaysia,MYS,United Kingdom of Great Britain and Northern Ireland,GBR,0,0,43,16,59
2010,Malawi,MWI,United Kingdom of Great Britain and Northern Ireland,GBR,5,24,234,19,282
2010,Mongolia,MNG,United Kingdom of Great Britain and Northern Ireland,GBR,5,5,52,10,72
2010,Morocco,MAR,United Kingdom of Great Britain and Northern Ireland,GBR,5,12,24,19,60
2010,Mauritius,MUS,United Kingdom of Great Britain and Northern Ireland,GBR,0,0,70,5,75
2010,Myanmar,MMR,United Kingdom of Great Britain and Northern Ireland,GBR,106,5,202,0,313
2010,Namibia,NAM,United Kingdom of Great Britain and Northern Ireland,GBR,0,0,19,0,19
2010,Nepal,NPL,United Kingdom of Great Britain and Northern Ireland,GBR,0,0,22,5,27
2010,Netherlands,NLD,United Kingdom of Great Britain and Northern Ireland,GBR,0,0,5,0,5
2010,Niger,NER,United Kingdom of Great Britain and Northern Ireland,GBR,0,0,5,0,5
2010,Nigeria,NGA,United Kingdom of Great Britain and Northern Ireland,GBR,25,45,1052,188,1310
2010,Pakistan,PAK,United Kingdom of Great Britain and Northern Ireland,GBR,174,56,2095,235,2560
2010,Philippines,PHL,United Kingdom of Great Britain and Northern Ireland,GBR,0,0,18,5,23
2010,Poland,POL,United Kingdom of Great Britain and Northern Ireland,GBR,0,0,5,18,23
2010,Romania,ROU,United Kingdom of Great Britain and Northern Ireland,GBR,0,0,5,75,80
2010,South Africa,ZAF,United Kingdom of Great Britain and Northern Ireland,GBR,5,19,196,22,242
2010,Russian Federation,RUS,United Kingdom of Great Britain and Northern Ireland,GBR,36,5,81,10,132
2010,Rwanda,RWA,United Kingdom of Great Britain and Northern Ireland,GBR,5,0,28,0,33
2010,Saudi Arabia,SAU,United Kingdom of Great Britain and Northern Ireland,GBR,5,0,5,0,10
2010,Serbia and Kosovo: S/RES/1244 (1999),SRB,United Kingdom of Great Britain and Northern Ireland,GBR,0,5,25,38,68
2010,Senegal,SEN,United Kingdom of Great Britain and Northern Ireland,GBR,10,0,42,5,57
2010,Sierra Leone,SLE,United Kingdom of Great Britain and Northern Ireland,GBR,10,12,86,11,119
2010,Somalia,SOM,United Kingdom of Great Britain and Northern Ireland,GBR,437,96,441,116,1090
2010,Viet Nam,VNM,United Kingdom of Great Britain and Northern Ireland,GBR,10,42,155,314,521
2010,Saint Kitts and Nevis,KNA,United Kingdom of Great Britain and Northern Ireland,GBR,0,5,0,0,5
2010,Sudan,SDN,United Kingdom of Great Britain and Northern Ireland,GBR,397,17,142,117,673
2010,Slovakia,SVK,United Kingdom of Great Britain and Northern Ireland,GBR,0,0,0,5,5
2010,Eswatini,SWZ,United Kingdom of Great Britain and Northern Ireland,GBR,0,0,5,0,5
2010,Syrian Arab Rep.,SYR,United Kingdom of Great Britain and Northern Ireland,GBR,36,5,135,31,207
2010,United Rep. of Tanzania,TZA,United Kingdom of Great Britain and Northern Ireland,GBR,0,5,34,5,44
2010,Thailand,THA,United Kingdom of Great Britain and Northern Ireland,GBR,5,0,5,5,15
2010,Turkmenistan,TKM,United Kingdom of Great Britain and Northern Ireland,GBR,0,0,5,0,5
2010,Togo,TGO,United Kingdom of Great Britain and Northern Ireland,GBR,0,0,19,5,24
2010,Trinidad and Tobago,TTO,United Kingdom of Great Britain and Northern Ireland,GBR,0,0,24,5,29
2010,Tunisia,TUN,United Kingdom of Great Britain and Northern Ireland,GBR,0,0,21,0,21
2010,Turkey,TUR,United Kingdom of Great Britain and Northern Ireland,GBR,28,10,160,30,228
2010,Uganda,UGA,United Kingdom of Great Britain and Northern Ireland,GBR,37,22,247,13,319
2010,Ukraine,UKR,United Kingdom of Great Britain and Northern Ireland,GBR,0,5,45,15,65
2010,United States of America,USA,United Kingdom of Great Britain and Northern Ireland,GBR,0,0,29,12,41
2010,Uzbekistan,UZB,United Kingdom of Great Britain and Northern Ireland,GBR,0,0,14,0,14
2010,Saint Vincent and the Grenadines,VCT,United Kingdom of Great Britain and Northern Ireland,GBR,0,0,10,0,10
2010,Venezuela (Bolivarian Republic of),VEN,United Kingdom of Great Britain and Northern Ireland,GBR,5,0,11,0,16
2010,Western Sahara,ESH,United Kingdom of Great Britain and Northern Ireland,GBR,0,0,12,0,12
2010,Yemen,YEM,United Kingdom of Great Britain and Northern Ireland,GBR,10,0,48,5,63
2010,Zambia,ZMB,United Kingdom of Great Britain and Northern Ireland,GBR,0,5,28,0,33
2010,Zimbabwe,ZWE,United Kingdom of Great Britain and Northern Ireland,GBR,519,236,1749,55,2559
2010,Stateless,XXA,United Kingdom of Great Britain and Northern Ireland,GBR,151,5,109,17,282
2010,Unknown ,,United Kingdom of Great Britain and Northern Ireland,GBR,0,0,5,5,10
2010,Sierra Leone,SLE,Ghana,GHA,16,0,0,0,16
2010,Sudan,SDN,Ghana,GHA,5,0,0,0,5
2010,Togo,TGO,Ghana,GHA,11,0,0,0,11
2010,Afghanistan,AFG,Greece,GRC,10,5,191,123,329
2010,Albania,ALB,Greece,GRC,0,0,251,162,413
2010,Algeria,DZA,Greece,GRC,0,0,24,10,34
2010,Egypt,EGY,Greece,GRC,0,0,25,14,39
2010,Armenia,ARM,Greece,GRC,0,0,24,17,41
2010,Bangladesh,BGD,Greece,GRC,0,0,208,29,237
2010,Burkina Faso,BFA,Greece,GRC,0,0,5,0,5
2010,Belarus,BLR,Greece,GRC,0,0,0,5,5
2010,China,CHN,Greece,GRC,0,0,292,13,305
2010,Cameroon,CMR,Greece,GRC,0,0,0,5,5
2010,Eritrea,ERI,Greece,GRC,0,0,10,5,15
2010,Ethiopia,ETH,Greece,GRC,0,0,5,11,16
2010,Gambia,GMB,Greece,GRC,0,0,0,5,5
2010,Palestinian,PSE,Greece,GRC,0,0,36,0,36
2010,Georgia,GEO,Greece,GRC,0,0,684,214,898
2010,Ghana,GHA,Greece,GRC,0,0,11,17,28
2010,Guinea,GIN,Greece,GRC,0,0,5,5,10
2010,India,IND,Greece,GRC,0,0,57,5,62
2010,Indonesia,IDN,Greece,GRC,0,0,5,0,5
2010,Iran (Islamic Rep. of),IRN,Greece,GRC,30,0,44,20,94
2010,Iraq,IRQ,Greece,GRC,12,0,131,82,225
2010,Kenya,KEN,Greece,GRC,0,0,5,5,10
2010,Lebanon,LBN,Greece,GRC,0,0,5,0,5
2010,Sri Lanka,LKA,Greece,GRC,0,0,13,5,18
2010,Rep. of Moldova,MDA,Greece,GRC,0,0,14,10,24
2010,Morocco,MAR,Greece,GRC,0,0,13,5,18
2010,Myanmar,MMR,Greece,GRC,0,0,0,5,5
2010,Nigeria,NGA,Greece,GRC,0,10,139,240,389
2010,Pakistan,PAK,Greece,GRC,0,0,845,147,992
2010,Philippines,PHL,Greece,GRC,0,0,5,0,5
2010,Russian Federation,RUS,Greece,GRC,5,0,37,31,73
2010,Serbia and Kosovo: S/RES/1244 (1999),SRB,Greece,GRC,0,0,5,0,5
2010,Senegal,SEN,Greece,GRC,0,0,23,10,33
2010,Sierra Leone,SLE,Greece,GRC,0,0,0,5,5
2010,Somalia,SOM,Greece,GRC,0,0,28,5,33
2010,Viet Nam,VNM,Greece,GRC,0,0,5,0,5
2010,Sudan,SDN,Greece,GRC,0,0,0,5,5
2010,Syrian Arab Rep.,SYR,Greece,GRC,0,0,99,28,127
2010,United Rep. of Tanzania,TZA,Greece,GRC,0,0,5,0,5
2010,Tunisia,TUN,Greece,GRC,0,0,5,0,5
2010,Turkey,TUR,Greece,GRC,0,5,27,17,49
2010,Ukraine,UKR,Greece,GRC,0,0,13,19,32
2010,Uzbekistan,UZB,Greece,GRC,0,0,5,0,5
2010,Unknown ,,Greece,GRC,0,0,23,20,43
2010,Colombia,COL,Guatemala,GTM,0,0,0,5,5
2010,Nepal,NPL,Guatemala,GTM,0,0,0,5,5
2010,El Salvador,SLV,Guatemala,GTM,5,0,0,0,5
2010,Colombia,COL,Honduras,HND,0,0,0,5,5
2010,Eritrea,ERI,Honduras,HND,0,0,0,38,38
2010,Somalia,SOM,Honduras,HND,0,0,0,15,15
2010,Zimbabwe,ZWE,Honduras,HND,0,0,0,5,5
2010,Afghanistan,AFG,Croatia,HRV,0,0,13,86,99
2010,Algeria,DZA,Croatia,HRV,0,0,0,5,5
2010,Bosnia and Herzegovina,BIH,Croatia,HRV,0,0,10,5,15
2010,Palestinian,PSE,Croatia,HRV,0,0,0,32,32
2010,Iran (Islamic Rep. of),IRN,Croatia,HRV,0,0,5,12,17
2010,Pakistan,PAK,Croatia,HRV,0,0,5,0,5
2010,Russian Federation,RUS,Croatia,HRV,0,0,5,0,5
2010,Serbia and Kosovo: S/RES/1244 (1999),SRB,Croatia,HRV,0,0,10,5,15
2010,Somalia,SOM,Croatia,HRV,0,0,0,10,10
2010,Turkey,TUR,Croatia,HRV,0,0,5,0,5
2010,Ukraine,UKR,Croatia,HRV,0,0,5,0,5
2010,Western Sahara,ESH,Croatia,HRV,0,0,0,5,5
2010,Afghanistan,AFG,Hungary,HUN,10,108,222,506,846
2010,Algeria,DZA,Hungary,HUN,0,0,11,24,35
2010,Egypt,EGY,Hungary,HUN,5,0,5,0,10
2010,Armenia,ARM,Hungary,HUN,0,0,0,10,10
2010,Bangladesh,BGD,Hungary,HUN,0,0,5,0,5
2010,China,CHN,Hungary,HUN,0,0,5,10,15
2010,Cameroon,CMR,Hungary,HUN,0,0,5,5,10
2010,Palestinian,PSE,Hungary,HUN,0,16,74,146,236
2010,Georgia,GEO,Hungary,HUN,0,0,24,47,71
2010,Guinea,GIN,Hungary,HUN,0,0,5,0,5
2010,Iran (Islamic Rep. of),IRN,Hungary,HUN,0,5,42,37,84
2010,Iraq,IRQ,Hungary,HUN,5,5,10,27,47
2010,Jordan,JOR,Hungary,HUN,0,0,0,5,5
2010,Kazakhstan,KAZ,Hungary,HUN,0,0,0,5,5
2010,Liberia,LBR,Hungary,HUN,0,0,0,5,5
2010,Lebanon,LBN,Hungary,HUN,0,5,0,13,18
2010,Sri Lanka,LKA,Hungary,HUN,10,0,5,0,15
2010,North Macedonia,MKD,Hungary,HUN,0,0,0,5,5
2010,Rep. of Moldova,MDA,Hungary,HUN,0,0,0,14,14
2010,Mongolia,MNG,Hungary,HUN,0,0,5,0,5
2010,Morocco,MAR,Hungary,HUN,0,0,5,11,16
2010,Nigeria,NGA,Hungary,HUN,0,0,22,28,50
2010,Pakistan,PAK,Hungary,HUN,0,0,16,33,49
2010,Romania,ROU,Hungary,HUN,0,0,0,5,5
2010,Russian Federation,RUS,Hungary,HUN,0,0,0,23,23
2010,Serbia and Kosovo: S/RES/1244 (1999),SRB,Hungary,HUN,0,0,89,412,501
2010,Somalia,SOM,Hungary,HUN,18,24,0,15,57
2010,Viet Nam,VNM,Hungary,HUN,0,0,16,22,38
2010,Sudan,SDN,Hungary,HUN,0,0,12,0,12
2010,Syrian Arab Rep.,SYR,Hungary,HUN,0,0,10,5,15
2010,Tunisia,TUN,Hungary,HUN,0,0,5,5,10
2010,Turkey,TUR,Hungary,HUN,0,0,13,40,53
2010,Ukraine,UKR,Hungary,HUN,0,0,5,5,10
2010,Western Sahara,ESH,Hungary,HUN,0,0,5,0,5
2010,Unknown ,,Hungary,HUN,10,5,5,5,25
2010,Afghanistan,AFG,Iceland,ISL,0,0,0,5,5
2010,Kenya,KEN,Iceland,ISL,0,5,0,0,5
2010,Rep. of Moldova,MDA,Iceland,ISL,0,0,5,0,5
2010,Spain,ESP,Iceland,ISL,0,0,5,0,5
2010,Afghanistan,AFG,Ireland,IRL,0,0,45,30,75
2010,Albania,ALB,Ireland,IRL,0,0,14,5,19
2010,Algeria,DZA,Ireland,IRL,0,0,24,18,42
2010,Angola,AGO,Ireland,IRL,0,0,10,5,15
2010,Egypt,EGY,Ireland,IRL,0,0,5,13,18
2010,Armenia,ARM,Ireland,IRL,0,0,5,5,10
2010,Burundi,BDI,Ireland,IRL,0,0,5,0,5
2010,Benin,BEN,Ireland,IRL,0,0,5,0,5
2010,Bangladesh,BGD,Ireland,IRL,0,0,33,13,46
2010,Bhutan,BTN,Ireland,IRL,0,0,15,5,20
2010,Bolivia (Plurinational State of),BOL,Ireland,IRL,0,0,11,0,11
2010,Brazil,BRA,Ireland,IRL,0,0,5,0,5
2010,China,CHN,Ireland,IRL,5,0,38,182,225
2010,Cameroon,CMR,Ireland,IRL,0,0,55,10,65
2010,Congo,COG,Ireland,IRL,0,0,10,0,10
2010,Dem. Rep. of the Congo,COD,Ireland,IRL,0,0,44,12,56
2010,Eritrea,ERI,Ireland,IRL,0,0,10,21,31
2010,Ethiopia,ETH,Ireland,IRL,0,0,5,5,10
2010,Palestinian,PSE,Ireland,IRL,0,0,5,16,21
2010,Georgia,GEO,Ireland,IRL,0,0,43,25,68
2010,Ghana,GHA,Ireland,IRL,0,0,56,0,56
2010,Guinea,GIN,Ireland,IRL,0,0,5,0,5
2010,Guyana,GUY,Ireland,IRL,0,0,5,0,5
2010,Croatia,HRV,Ireland,IRL,0,0,10,0,10
2010,Cote d'Ivoire,CIV,Ireland,IRL,0,0,5,0,5
2010,India,IND,Ireland,IRL,0,0,11,12,23
2010,Iran (Islamic Rep. of),IRN,Ireland,IRL,0,0,13,10,23
2010,Iraq,IRQ,Ireland,IRL,0,0,15,22,37
2010,Jordan,JOR,Ireland,IRL,0,0,5,0,5
2010,Kenya,KEN,Ireland,IRL,0,0,10,0,10
2010,Liberia,LBR,Ireland,IRL,0,0,5,0,5
2010,Rep. of Moldova,MDA,Ireland,IRL,0,0,43,24,67
2010,Malawi,MWI,Ireland,IRL,0,0,14,0,14
2010,Mongolia,MNG,Ireland,IRL,0,0,5,0,5
2010,Morocco,MAR,Ireland,IRL,0,0,5,5,10
2010,Mauritius,MUS,Ireland,IRL,0,0,14,5,19
2010,Myanmar,MMR,Ireland,IRL,0,0,5,0,5
2010,Nepal,NPL,Ireland,IRL,0,0,5,22,27
2010,Niger,NER,Ireland,IRL,0,0,0,5,5
2010,Nigeria,NGA,Ireland,IRL,0,0,301,93,394
2010,Pakistan,PAK,Ireland,IRL,0,0,148,54,202
2010,South Africa,ZAF,Ireland,IRL,0,0,43,0,43
2010,Russian Federation,RUS,Ireland,IRL,0,0,5,10,15
2010,Rwanda,RWA,Ireland,IRL,0,0,5,0,5
2010,Serbia and Kosovo: S/RES/1244 (1999),SRB,Ireland,IRL,0,0,18,5,23
2010,Sierra Leone,SLE,Ireland,IRL,0,0,17,5,22
2010,Somalia,SOM,Ireland,IRL,5,0,47,23,75
2010,Viet Nam,VNM,Ireland,IRL,0,0,0,5,5
2010,Sudan,SDN,Ireland,IRL,0,0,27,15,42
2010,Togo,TGO,Ireland,IRL,0,0,10,0,10
2010,Turkey,TUR,Ireland,IRL,0,0,5,0,5
2010,Uganda,UGA,Ireland,IRL,0,0,13,0,13
2010,Ukraine,UKR,Ireland,IRL,0,0,5,0,5
2010,Zimbabwe,ZWE,Ireland,IRL,0,0,33,15,48
2010,Sudan,SDN,Israel,ISR,5,0,0,0,5
2010,Stateless,XXA,Israel,ISR,5,0,0,0,5
2010,Afghanistan,AFG,Italy,ITA,176,480,68,0,724
2010,Albania,ALB,Italy,ITA,0,10,23,0,33
2010,Algeria,DZA,Italy,ITA,0,0,76,0,76
2010,Egypt,EGY,Italy,ITA,5,0,25,0,30
2010,Armenia,ARM,Italy,ITA,5,0,19,0,24
2010,Azerbaijan,AZE,Italy,ITA,5,0,5,0,10
2010,Benin,BEN,Italy,ITA,0,0,5,0,5
2010,Bangladesh,BGD,Italy,ITA,5,5,178,0,188
2010,Burkina Faso,BFA,Italy,ITA,10,10,135,0,155
2010,Belarus,BLR,Italy,ITA,0,0,5,0,5
2010,Brazil,BRA,Italy,ITA,0,0,15,0,15
2010,Bosnia and Herzegovina,BIH,Italy,ITA,18,0,490,0,508
2010,Chad,TCD,Italy,ITA,0,0,5,0,5
2010,China,CHN,Italy,ITA,10,0,19,0,29
2010,Chile,CHL,Italy,ITA,0,0,5,0,5
2010,Cameroon,CMR,Italy,ITA,19,5,36,0,60
2010,Congo,COG,Italy,ITA,15,5,12,0,32
2010,Dem. Rep. of the Congo,COD,Italy,ITA,16,10,26,0,52
2010,Colombia,COL,Italy,ITA,26,0,24,0,50
2010,Cuba,CUB,Italy,ITA,5,5,26,0,36
2010,Dominican Rep.,DOM,Italy,ITA,0,0,5,0,5
2010,Ecuador,ECU,Italy,ITA,5,0,10,0,15
2010,Eritrea,ERI,Italy,ITA,347,145,78,0,570
2010,Ethiopia,ETH,Italy,ITA,12,5,12,0,29
2010,Gabon,GAB,Italy,ITA,0,0,5,0,5
2010,Gambia,GMB,Italy,ITA,5,5,81,0,91
2010,Palestinian,PSE,Italy,ITA,101,16,21,0,138
2010,Georgia,GEO,Italy,ITA,5,5,50,0,60
2010,Ghana,GHA,Italy,ITA,5,0,504,0,509
2010,Guinea-Bissau,GNB,Italy,ITA,0,5,10,0,15
2010,Guinea,GIN,Italy,ITA,26,17,129,0,172
2010,Honduras,HND,Italy,ITA,5,0,5,0,10
2010,Croatia,HRV,Italy,ITA,0,0,43,0,43
2010,Cote d'Ivoire,CIV,Italy,ITA,14,62,202,0,278
2010,India,IND,Italy,ITA,5,0,62,0,67
2010,Iran (Islamic Rep. of),IRN,Italy,ITA,157,23,27,0,207
2010,Iraq,IRQ,Italy,ITA,105,154,69,0,328
2010,Kenya,KEN,Italy,ITA,5,5,42,0,52
2010,Liberia,LBR,Italy,ITA,0,0,67,0,67
2010,Lebanon,LBN,Italy,ITA,19,0,23,0,42
2010,Sri Lanka,LKA,Italy,ITA,14,25,42,0,81
2010,Mauritania,MRT,Italy,ITA,11,5,20,0,36
2010,North Macedonia,MKD,Italy,ITA,0,0,102,0,102
2010,Rep. of Moldova,MDA,Italy,ITA,0,0,10,0,10
2010,Mali,MLI,Italy,ITA,5,0,67,0,72
2010,Mongolia,MNG,Italy,ITA,0,0,5,0,5
2010,Morocco,MAR,Italy,ITA,5,0,81,0,86
2010,Montenegro,MNE,Italy,ITA,0,0,182,0,182
2010,Myanmar,MMR,Italy,ITA,5,0,0,0,5
2010,Nepal,NPL,Italy,ITA,0,0,5,0,5
2010,Niger,NER,Italy,ITA,0,0,19,0,19
2010,Nigeria,NGA,Italy,ITA,20,27,1627,0,1674
2010,Pakistan,PAK,Italy,ITA,44,192,437,0,673
2010,Peru,PER,Italy,ITA,0,0,5,0,5
2010,Russian Federation,RUS,Italy,ITA,5,5,17,0,27
2010,El Salvador,SLV,Italy,ITA,0,5,22,0,27
2010,Serbia and Kosovo: S/RES/1244 (1999),SRB,Italy,ITA,12,23,731,0,766
2010,Senegal,SEN,Italy,ITA,12,10,100,0,122
2010,Sierra Leone,SLE,Italy,ITA,5,0,29,0,34
2010,Somalia,SOM,Italy,ITA,41,86,10,0,137
2010,Sudan,SDN,Italy,ITA,10,10,34,0,54
2010,Syrian Arab Rep.,SYR,Italy,ITA,23,0,29,0,52
2010,Togo,TGO,Italy,ITA,21,5,94,0,120
2010,Tunisia,TUN,Italy,ITA,0,0,115,0,115
2010,Turkey,TUR,Italy,ITA,147,60,351,0,558
2010,Uganda,UGA,Italy,ITA,5,0,13,0,18
2010,Ukraine,UKR,Italy,ITA,0,0,16,0,16
2010,Zimbabwe,ZWE,Italy,ITA,0,0,13,0,13
2010,Unknown ,,Italy,ITA,91,25,195,0,311
2010,Afghanistan,AFG,Japan,JPN,0,0,0,5,5
2010,Bangladesh,BGD,Japan,JPN,0,5,33,5,43
2010,China,CHN,Japan,JPN,0,12,10,5,27
2010,Cameroon,CMR,Japan,JPN,0,0,22,0,22
2010,Dem. Rep. of the Congo,COD,Japan,JPN,0,0,22,0,22
2010,Ethiopia,ETH,Japan,JPN,0,5,32,5,42
2010,Ghana,GHA,Japan,JPN,0,0,5,0,5
2010,Guinea,GIN,Japan,JPN,0,0,5,0,5
2010,India,IND,Japan,JPN,0,0,56,5,61
2010,Iran (Islamic Rep. of),IRN,Japan,JPN,0,5,24,5,34
2010,Kenya,KEN,Japan,JPN,0,0,5,0,5
2010,Sri Lanka,LKA,Japan,JPN,0,5,169,28,202
2010,Myanmar,MMR,Japan,JPN,24,288,386,10,708
2010,Nepal,NPL,Japan,JPN,0,0,30,0,30
2010,Nigeria,NGA,Japan,JPN,0,0,18,0,18
2010,Pakistan,PAK,Japan,JPN,0,0,48,10,58
2010,Peru,PER,Japan,JPN,0,5,0,0,5
2010,Philippines,PHL,Japan,JPN,0,0,5,0,5
2010,Russian Federation,RUS,Japan,JPN,0,0,5,0,5
2010,United Rep. of Tanzania,TZA,Japan,JPN,0,0,5,0,5
2010,Turkey,TUR,Japan,JPN,0,0,81,10,91
2010,Uganda,UGA,Japan,JPN,0,0,23,5,28
2010,Afghanistan,AFG,Kyrgyzstan,KGZ,0,0,5,0,5
2010,Iran (Islamic Rep. of),IRN,Kyrgyzstan,KGZ,0,0,0,5,5
2010,Kazakhstan,KAZ,Kyrgyzstan,KGZ,0,0,18,0,18
2010,Russian Federation,RUS,Kyrgyzstan,KGZ,0,0,0,26,26
2010,Uzbekistan,UZB,Kyrgyzstan,KGZ,0,0,0,143,143
2010,Afghanistan,AFG,Lithuania,LTU,0,10,5,15,30
2010,Armenia,ARM,Lithuania,LTU,0,0,5,14,19
2010,Azerbaijan,AZE,Lithuania,LTU,0,0,5,0,5
2010,Belarus,BLR,Lithuania,LTU,0,0,5,5,10
2010,Georgia,GEO,Lithuania,LTU,0,0,104,115,219
2010,Sri Lanka,LKA,Lithuania,LTU,0,0,5,11,16
2010,Pakistan,PAK,Lithuania,LTU,0,0,0,5,5
2010,Russian Federation,RUS,Lithuania,LTU,0,5,20,5,30
2010,Viet Nam,VNM,Lithuania,LTU,0,0,10,5,15
2010,Stateless,XXA,Lithuania,LTU,0,0,0,5,5
2010,Afghanistan,AFG,Luxembourg,LUX,0,0,5,5,10
2010,Albania,ALB,Luxembourg,LUX,0,0,5,5,10
2010,Algeria,DZA,Luxembourg,LUX,0,0,5,13,18
2010,Armenia,ARM,Luxembourg,LUX,0,0,0,5,5
2010,Azerbaijan,AZE,Luxembourg,LUX,0,0,10,0,10
2010,Belarus,BLR,Luxembourg,LUX,0,0,5,11,16
2010,Bosnia and Herzegovina,BIH,Luxembourg,LUX,0,0,12,11,23
2010,Dem. Rep. of the Congo,COD,Luxembourg,LUX,10,0,5,0,15
2010,Eritrea,ERI,Luxembourg,LUX,0,0,0,5,5
2010,Ethiopia,ETH,Luxembourg,LUX,5,0,0,0,5
2010,Gambia,GMB,Luxembourg,LUX,0,0,5,0,5
2010,Georgia,GEO,Luxembourg,LUX,0,0,0,5,5
2010,Cote d'Ivoire,CIV,Luxembourg,LUX,5,0,0,0,5
2010,Iran (Islamic Rep. of),IRN,Luxembourg,LUX,13,0,18,10,41
2010,Iraq,IRQ,Luxembourg,LUX,11,0,5,32,48
2010,Rep. of Moldova,MDA,Luxembourg,LUX,0,0,0,5,5
2010,Russian Federation,RUS,Luxembourg,LUX,0,0,0,17,17
2010,Serbia and Kosovo: S/RES/1244 (1999),SRB,Luxembourg,LUX,5,0,148,40,193
2010,Somalia,SOM,Luxembourg,LUX,0,10,5,5,20
2010,Sudan,SDN,Luxembourg,LUX,0,0,5,0,5
2010,Togo,TGO,Luxembourg,LUX,0,0,5,0,5
2010,Turkey,TUR,Luxembourg,LUX,0,0,0,5,5
2010,Ukraine,UKR,Luxembourg,LUX,0,0,0,5,5
2010,Afghanistan,AFG,Latvia,LVA,0,16,5,0,21
2010,Georgia,GEO,Latvia,LVA,0,0,10,0,10
2010,Russian Federation,RUS,Latvia,LVA,0,0,0,5,5
2010,Uzbekistan,UZB,Latvia,LVA,5,0,5,0,10
2010,India,IND,"China, Macao SAR",MAC,0,0,5,0,5
2010,Syrian Arab Rep.,SYR,"China, Macao SAR",MAC,0,0,5,0,5
2010,Bangladesh,BGD,Mexico,MEX,0,0,5,0,5
2010,Brazil,BRA,Mexico,MEX,0,0,0,5,5
2010,China,CHN,Mexico,MEX,0,0,5,11,16
2010,Colombia,COL,Mexico,MEX,39,0,25,15,79
2010,Cuba,CUB,Mexico,MEX,5,0,18,20,43
2010,Dominican Rep.,DOM,Mexico,MEX,0,0,0,12,12
2010,Ghana,GHA,Mexico,MEX,0,0,5,5,10
2010,Guatemala,GTM,Mexico,MEX,10,0,11,16,37
2010,Guinea,GIN,Mexico,MEX,5,0,0,0,5
2010,Haiti,HTI,Mexico,MEX,5,0,16,26,47
2010,Honduras,HND,Mexico,MEX,21,0,27,80,128
2010,India,IND,Mexico,MEX,5,0,62,204,271
2010,Iran (Islamic Rep. of),IRN,Mexico,MEX,10,0,0,0,10
2010,Iraq,IRQ,Mexico,MEX,5,0,0,0,5
2010,Sri Lanka,LKA,Mexico,MEX,28,0,11,10,49
2010,Nepal,NPL,Mexico,MEX,10,0,5,5,20
2010,Nicaragua,NIC,Mexico,MEX,0,0,5,5,10
2010,Nigeria,NGA,Mexico,MEX,10,0,5,5,20
2010,Pakistan,PAK,Mexico,MEX,0,0,0,5,5
2010,South Africa,ZAF,Mexico,MEX,0,0,5,0,5
2010,El Salvador,SLV,Mexico,MEX,58,0,23,65,146
2010,United States of America,USA,Mexico,MEX,0,0,5,0,5
2010,Venezuela (Bolivarian Republic of),VEN,Mexico,MEX,5,0,0,0,5
2010,Chad,TCD,Mali,MLI,5,0,0,0,5
2010,Dem. Rep. of the Congo,COD,Mali,MLI,5,0,0,0,5
2010,Guinea,GIN,Mali,MLI,5,0,0,0,5
2010,Cote d'Ivoire,CIV,Mali,MLI,0,0,5,5,10
2010,Rwanda,RWA,Mali,MLI,5,0,0,0,5
2010,Togo,TGO,Mali,MLI,5,0,0,0,5
2010,Burundi,BDI,Malawi,MWI,61,0,0,73,134
2010,Dem. Rep. of the Congo,COD,Malawi,MWI,408,0,0,113,521
2010,Ethiopia,ETH,Malawi,MWI,0,0,0,5,5
2010,Rwanda,RWA,Malawi,MWI,34,0,0,129,163
2010,Somalia,SOM,Malawi,MWI,19,0,0,0,19
2010,Burundi,BDI,Mozambique,MOZ,107,0,32,11,150
2010,Congo,COG,Mozambique,MOZ,0,0,5,0,5
2010,Dem. Rep. of the Congo,COD,Mozambique,MOZ,474,0,64,40,578
2010,Cote d'Ivoire,CIV,Mozambique,MOZ,0,0,5,0,5
2010,Rwanda,RWA,Mozambique,MOZ,75,0,20,52,147
2010,Somalia,SOM,Mozambique,MOZ,5,0,0,10,15
2010,Armenia,ARM,Malta,MLT,0,0,5,0,5
2010,Bangladesh,BGD,Malta,MLT,5,0,5,0,10
2010,China,CHN,Malta,MLT,5,0,0,0,5
2010,Eritrea,ERI,Malta,MLT,5,78,10,0,93
2010,Ethiopia,ETH,Malta,MLT,0,10,17,5,32
2010,Palestinian,PSE,Malta,MLT,0,0,5,0,5
2010,Cote d'Ivoire,CIV,Malta,MLT,0,0,5,0,5
2010,Iraq,IRQ,Malta,MLT,0,0,5,0,5
2010,Liberia,LBR,Malta,MLT,0,0,5,0,5
2010,Libya,LBY,Malta,MLT,5,0,0,0,5
2010,Morocco,MAR,Malta,MLT,0,0,5,0,5
2010,Nigeria,NGA,Malta,MLT,0,0,33,5,38
2010,Pakistan,PAK,Malta,MLT,5,0,10,0,15
2010,Somalia,SOM,Malta,MLT,0,75,0,0,75
2010,Sudan,SDN,Malta,MLT,0,0,5,0,5
2010,Syrian Arab Rep.,SYR,Malta,MLT,14,0,5,0,19
2010,Turkey,TUR,Malta,MLT,0,0,5,0,5
2010,Burundi,BDI,Namibia,NAM,30,0,5,0,35
2010,Dem. Rep. of the Congo,COD,Namibia,NAM,87,0,73,0,160
2010,Rwanda,RWA,Namibia,NAM,5,0,0,0,5
2010,Sierra Leone,SLE,Namibia,NAM,0,0,0,19,19
2010,Zimbabwe,ZWE,Namibia,NAM,13,0,5,0,18
2010,Bhutan,BTN,Nepal,NPL,0,5,0,0,5
2010,Afghanistan,AFG,Netherlands,NLD,49,617,1241,0,1907
2010,Albania,ALB,Netherlands,NLD,0,0,16,0,16
2010,Algeria,DZA,Netherlands,NLD,0,0,30,0,30
2010,Angola,AGO,Netherlands,NLD,0,12,43,0,55
2010,Egypt,EGY,Netherlands,NLD,0,10,33,0,43
2010,Armenia,ARM,Netherlands,NLD,20,111,400,0,531
2010,Azerbaijan,AZE,Netherlands,NLD,10,46,96,0,152
2010,Burundi,BDI,Netherlands,NLD,5,28,35,0,68
2010,Benin,BEN,Netherlands,NLD,0,0,10,0,10
2010,Bangladesh,BGD,Netherlands,NLD,0,0,12,0,12
2010,Bhutan,BTN,Netherlands,NLD,0,45,0,0,45
2010,Burkina Faso,BFA,Netherlands,NLD,0,0,22,0,22
2010,Belarus,BLR,Netherlands,NLD,5,10,48,0,63
2010,Bosnia and Herzegovina,BIH,Netherlands,NLD,0,0,14,0,14
2010,Cambodia,KHM,Netherlands,NLD,0,11,0,0,11
2010,Chad,TCD,Netherlands,NLD,0,0,5,0,5
2010,China,CHN,Netherlands,NLD,61,134,163,0,358
2010,Cameroon,CMR,Netherlands,NLD,0,5,51,0,56
2010,Congo,COG,Netherlands,NLD,10,47,55,0,112
2010,Dem. Rep. of the Congo,COD,Netherlands,NLD,5,31,15,0,51
2010,Colombia,COL,Netherlands,NLD,0,5,12,0,17
2010,Cuba,CUB,Netherlands,NLD,5,0,5,0,10
2010,Ecuador,ECU,Netherlands,NLD,0,0,5,0,5
2010,Eritrea,ERI,Netherlands,NLD,36,268,276,0,580
2010,Ethiopia,ETH,Netherlands,NLD,15,15,84,0,114
2010,Gambia,GMB,Netherlands,NLD,0,5,16,0,21
2010,Palestinian,PSE,Netherlands,NLD,0,0,30,0,30
2010,Georgia,GEO,Netherlands,NLD,0,0,733,0,733
2010,Ghana,GHA,Netherlands,NLD,0,0,37,0,37
2010,Guinea,GIN,Netherlands,NLD,5,106,177,0,288
2010,Honduras,HND,Netherlands,NLD,5,0,0,0,5
2010,Croatia,HRV,Netherlands,NLD,0,0,5,0,5
2010,Cote d'Ivoire,CIV,Netherlands,NLD,5,65,79,0,149
2010,India,IND,Netherlands,NLD,0,0,13,0,13
2010,Indonesia,IDN,Netherlands,NLD,0,0,5,0,5
2010,Iran (Islamic Rep. of),IRN,Netherlands,NLD,179,247,406,0,832
2010,Iraq,IRQ,Netherlands,NLD,132,1091,1030,0,2253
2010,Israel,ISR,Netherlands,NLD,0,0,5,0,5
2010,Jamaica,JAM,Netherlands,NLD,5,0,10,0,15
2010,Kazakhstan,KAZ,Netherlands,NLD,0,11,20,0,31
2010,Kenya,KEN,Netherlands,NLD,0,5,11,0,16
2010,Kyrgyzstan,KGZ,Netherlands,NLD,0,0,5,0,5
2010,Dem. People's Rep. of Korea,PRK,Netherlands,NLD,0,5,5,0,10
2010,Lao People's Dem. Rep.,LAO,Netherlands,NLD,0,17,0,0,17
2010,Liberia,LBR,Netherlands,NLD,0,14,32,0,46
2010,Libya,LBY,Netherlands,NLD,5,49,112,0,166
2010,Lebanon,LBN,Netherlands,NLD,0,0,5,0,5
2010,Sri Lanka,LKA,Netherlands,NLD,22,90,125,0,237
2010,Mauritania,MRT,Netherlands,NLD,0,0,5,0,5
2010,North Macedonia,MKD,Netherlands,NLD,0,0,321,0,321
2010,Rep. of Moldova,MDA,Netherlands,NLD,0,0,5,0,5
2010,Mexico,MEX,Netherlands,NLD,0,0,5,0,5
2010,Mali,MLI,Netherlands,NLD,0,0,20,0,20
2010,Malawi,MWI,Netherlands,NLD,0,0,5,0,5
2010,Mongolia,MNG,Netherlands,NLD,0,0,256,0,256
2010,Morocco,MAR,Netherlands,NLD,0,0,18,0,18
2010,Myanmar,MMR,Netherlands,NLD,10,151,18,0,179
2010,Nepal,NPL,Netherlands,NLD,14,28,43,0,85
2010,Niger,NER,Netherlands,NLD,0,0,14,0,14
2010,Nigeria,NGA,Netherlands,NLD,0,10,143,0,153
2010,Pakistan,PAK,Netherlands,NLD,13,10,55,0,78
2010,Peru,PER,Netherlands,NLD,0,5,0,0,5
2010,South Africa,ZAF,Netherlands,NLD,0,0,5,0,5
2010,Russian Federation,RUS,Netherlands,NLD,0,10,185,0,195
2010,Rwanda,RWA,Netherlands,NLD,0,10,12,0,22
2010,Serbia and Kosovo: S/RES/1244 (1999),SRB,Netherlands,NLD,0,0,124,0,124
2010,Senegal,SEN,Netherlands,NLD,5,0,10,0,15
2010,Sierra Leone,SLE,Netherlands,NLD,0,63,73,0,136
2010,Somalia,SOM,Netherlands,NLD,97,3391,1841,0,5329
2010,Viet Nam,VNM,Netherlands,NLD,0,0,10,0,10
2010,Sudan,SDN,Netherlands,NLD,14,47,103,0,164
2010,Syrian Arab Rep.,SYR,Netherlands,NLD,10,36,93,0,139
2010,United Rep. of Tanzania,TZA,Netherlands,NLD,0,0,10,0,10
2010,Tajikistan,TJK,Netherlands,NLD,0,5,12,0,17
2010,Togo,TGO,Netherlands,NLD,0,5,25,0,30
2010,Tunisia,TUN,Netherlands,NLD,0,0,10,0,10
2010,Turkey,TUR,Netherlands,NLD,5,14,60,0,79
2010,Uganda,UGA,Netherlands,NLD,18,29,45,0,92
2010,Ukraine,UKR,Netherlands,NLD,0,5,29,0,34
2010,United States of America,USA,Netherlands,NLD,0,0,5,0,5
2010,Uzbekistan,UZB,Netherlands,NLD,5,12,10,0,27
2010,Venezuela (Bolivarian Republic of),VEN,Netherlands,NLD,0,0,5,0,5
2010,Yemen,YEM,Netherlands,NLD,0,0,16,0,16
2010,Zimbabwe,ZWE,Netherlands,NLD,0,5,10,0,15
2010,Stateless,XXA,Netherlands,NLD,10,31,69,0,110
2010,Unknown ,,Netherlands,NLD,15,221,368,0,604
2010,Chad,TCD,Niger,NER,0,0,0,18,18
2010,Dem. Rep. of the Congo,COD,Niger,NER,0,0,0,11,11
2010,Bangladesh,BGD,Nicaragua,NIC,5,0,0,5,10
2010,Eritrea,ERI,Nicaragua,NIC,10,0,0,35,45
2010,Honduras,HND,Nicaragua,NIC,5,0,0,0,5
2010,Nepal,NPL,Nicaragua,NIC,0,0,0,13,13
2010,El Salvador,SLV,Nicaragua,NIC,5,0,0,0,5
2010,Somalia,SOM,Nicaragua,NIC,14,0,0,12,26
2010,Dem. Rep. of the Congo,COD,Nigeria,NGA,55,0,91,51,197
2010,Guinea,GIN,Nigeria,NGA,10,0,0,0,10
2010,Sierra Leone,SLE,Nigeria,NGA,0,0,13,5,18
2010,Afghanistan,AFG,Norway,NOR,247,785,1483,352,2867
2010,Albania,ALB,Norway,NOR,0,0,18,5,23
2010,Algeria,DZA,Norway,NOR,0,0,85,92,177
2010,Angola,AGO,Norway,NOR,0,0,20,0,20
2010,Egypt,EGY,Norway,NOR,5,0,20,5,30
2010,Armenia,ARM,Norway,NOR,0,0,17,11,28
2010,Azerbaijan,AZE,Norway,NOR,0,0,37,13,50
2010,Burundi,BDI,Norway,NOR,5,0,16,16,37
2010,Benin,BEN,Norway,NOR,0,0,5,0,5
2010,Bangladesh,BGD,Norway,NOR,0,0,12,5,17
2010,Bhutan,BTN,Norway,NOR,0,0,5,0,5
2010,Burkina Faso,BFA,Norway,NOR,0,0,5,0,5
2010,Belarus,BLR,Norway,NOR,0,0,5,25,30
2010,Bosnia and Herzegovina,BIH,Norway,NOR,0,0,12,10,22
2010,Bulgaria,BGR,Norway,NOR,0,0,5,0,5
2010,Chad,TCD,Norway,NOR,0,0,0,5,5
2010,China,CHN,Norway,NOR,99,0,13,10,122
2010,Cameroon,CMR,Norway,NOR,5,5,24,16,50
2010,Dem. Rep. of the Congo,COD,Norway,NOR,26,14,83,12,135
2010,Colombia,COL,Norway,NOR,0,0,10,5,15
2010,Cuba,CUB,Norway,NOR,0,0,0,5,5
2010,Eritrea,ERI,Norway,NOR,1100,503,470,351,2424
2010,Ethiopia,ETH,Norway,NOR,150,31,314,71,566
2010,Gambia,GMB,Norway,NOR,0,0,43,21,64
2010,Georgia,GEO,Norway,NOR,0,0,37,68,105
2010,Ghana,GHA,Norway,NOR,0,0,51,33,84
2010,Guinea-Bissau,GNB,Norway,NOR,0,0,16,5,21
2010,Guinea,GIN,Norway,NOR,0,0,43,17,60
2010,Croatia,HRV,Norway,NOR,0,0,11,0,11
2010,Hungary,HUN,Norway,NOR,0,0,5,0,5
2010,Cote d'Ivoire,CIV,Norway,NOR,0,0,33,12,45
2010,India,IND,Norway,NOR,0,0,58,18,76
2010,Iran (Islamic Rep. of),IRN,Norway,NOR,120,14,466,92,692
2010,Iraq,IRQ,Norway,NOR,137,245,744,291,1417
2010,Israel,ISR,Norway,NOR,0,0,13,5,18
2010,Italy,ITA,Norway,NOR,0,0,0,5,5
2010,Jordan,JOR,Norway,NOR,0,0,28,5,33
2010,Kazakhstan,KAZ,Norway,NOR,0,0,15,13,28
2010,Kenya,KEN,Norway,NOR,0,0,20,0,20
2010,Kyrgyzstan,KGZ,Norway,NOR,0,0,23,10,33
2010,Rep. of Korea,KOR,Norway,NOR,0,0,5,5,10
2010,Liberia,LBR,Norway,NOR,5,0,40,17,62
2010,Libya,LBY,Norway,NOR,0,5,29,36,70
2010,Lebanon,LBN,Norway,NOR,0,0,32,17,49
2010,Sri Lanka,LKA,Norway,NOR,5,26,155,14,200
2010,Mauritania,MRT,Norway,NOR,0,0,38,5,43
2010,North Macedonia,MKD,Norway,NOR,0,0,96,5,101
2010,Rep. of Moldova,MDA,Norway,NOR,0,0,5,0,5
2010,Mexico,MEX,Norway,NOR,0,0,12,0,12
2010,Mali,MLI,Norway,NOR,0,0,5,5,10
2010,Mongolia,MNG,Norway,NOR,0,0,10,0,10
2010,Morocco,MAR,Norway,NOR,5,5,48,51,109
2010,Montenegro,MNE,Norway,NOR,0,0,10,0,10
2010,Myanmar,MMR,Norway,NOR,43,16,10,5,74
2010,Nepal,NPL,Norway,NOR,0,0,24,5,29
2010,Niger,NER,Norway,NOR,0,0,21,5,26
2010,Nigeria,NGA,Norway,NOR,0,10,343,207,560
2010,Pakistan,PAK,Norway,NOR,0,5,90,54,149
2010,Philippines,PHL,Norway,NOR,0,0,5,0,5
2010,Romania,ROU,Norway,NOR,0,0,15,5,20
2010,Russian Federation,RUS,Norway,NOR,22,14,533,231,800
2010,Rwanda,RWA,Norway,NOR,11,0,16,5,32
2010,Serbia and Kosovo: S/RES/1244 (1999),SRB,Norway,NOR,0,5,356,135,496
2010,Senegal,SEN,Norway,NOR,0,0,26,15,41
2010,Sierra Leone,SLE,Norway,NOR,0,0,15,14,29
2010,Somalia,SOM,Norway,NOR,705,541,260,496,2002
2010,Viet Nam,VNM,Norway,NOR,5,0,14,5,24
2010,Sudan,SDN,Norway,NOR,118,0,24,65,207
2010,Syrian Arab Rep.,SYR,Norway,NOR,23,14,156,51,244
2010,Tajikistan,TJK,Norway,NOR,0,0,26,17,43
2010,Togo,TGO,Norway,NOR,0,0,5,10,15
2010,Tunisia,TUN,Norway,NOR,0,0,18,19,37
2010,Turkey,TUR,Norway,NOR,5,0,53,31,89
2010,Uganda,UGA,Norway,NOR,0,0,21,14,35
2010,Ukraine,UKR,Norway,NOR,0,0,5,10,15
2010,United States of America,USA,Norway,NOR,0,0,5,0,5
2010,Uzbekistan,UZB,Norway,NOR,0,5,135,14,154
2010,Venezuela (Bolivarian Republic of),VEN,Norway,NOR,0,0,0,5,5
2010,Yemen,YEM,Norway,NOR,19,5,74,13,111
2010,Zimbabwe,ZWE,Norway,NOR,0,0,43,5,48
2010,Stateless,XXA,Norway,NOR,94,100,600,226,1020
2010,Egypt,EGY,New Zealand,NZL,0,0,10,0,10
2010,Bangladesh,BGD,New Zealand,NZL,0,0,5,0,5
2010,Brazil,BRA,New Zealand,NZL,0,0,5,0,5
2010,China,CHN,New Zealand,NZL,10,0,13,0,23
2010,Colombia,COL,New Zealand,NZL,0,0,5,0,5
2010,Czechia,CZE,New Zealand,NZL,0,0,5,0,5
2010,Fiji,FJI,New Zealand,NZL,0,0,73,0,73
2010,Palestinian,PSE,New Zealand,NZL,5,0,0,0,5
2010,Indonesia,IDN,New Zealand,NZL,0,0,5,0,5
2010,Iran (Islamic Rep. of),IRN,New Zealand,NZL,5,0,18,0,23
2010,Iraq,IRQ,New Zealand,NZL,12,0,5,0,17
2010,Sri Lanka,LKA,New Zealand,NZL,5,0,27,0,32
2010,Madagascar,MDG,New Zealand,NZL,5,0,0,0,5
2010,Nepal,NPL,New Zealand,NZL,0,0,5,0,5
2010,Pakistan,PAK,New Zealand,NZL,10,0,10,0,20
2010,South Africa,ZAF,New Zealand,NZL,0,0,14,0,14
2010,Saudi Arabia,SAU,New Zealand,NZL,5,0,5,0,10
2010,Slovakia,SVK,New Zealand,NZL,0,0,12,0,12
2010,Turkey,TUR,New Zealand,NZL,0,0,5,0,5
2010,Zimbabwe,ZWE,New Zealand,NZL,5,0,0,0,5
2010,Belarus,BLR,Panama,PAN,5,0,0,0,5
2010,Colombia,COL,Panama,PAN,89,0,122,626,837
2010,Cuba,CUB,Panama,PAN,0,0,5,28,33
2010,Somalia,SOM,Panama,PAN,0,0,5,0,5
2010,Venezuela (Bolivarian Republic of),VEN,Panama,PAN,5,0,0,10,15
2010,Zimbabwe,ZWE,Panama,PAN,0,0,0,5,5
2010,Colombia,COL,Paraguay,PRY,0,0,0,5,5
2010,Cuba,CUB,Paraguay,PRY,5,0,0,0,5
2010,Colombia,COL,Peru,PER,32,0,0,214,246
2010,Cuba,CUB,Peru,PER,0,0,19,99,118
2010,Ecuador,ECU,Peru,PER,0,0,5,0,5
2010,Haiti,HTI,Peru,PER,0,5,0,0,5
2010,Afghanistan,AFG,Poland,POL,5,5,5,0,15
2010,Armenia,ARM,Poland,POL,0,0,26,21,47
2010,Belarus,BLR,Poland,POL,19,0,5,5,29
2010,Palestinian,PSE,Poland,POL,0,5,0,0,5
2010,Georgia,GEO,Poland,POL,0,0,327,368,695
2010,Iraq,IRQ,Poland,POL,5,5,0,0,10
2010,Kazakhstan,KAZ,Poland,POL,0,0,5,5,10
2010,Kyrgyzstan,KGZ,Poland,POL,0,0,0,18,18
2010,Mongolia,MNG,Poland,POL,0,0,5,5,10
2010,Russian Federation,RUS,Poland,POL,42,172,1197,2428,3839
2010,Viet Nam,VNM,Poland,POL,0,0,20,0,20
2010,Turkey,TUR,Poland,POL,0,0,0,5,5
2010,Ukraine,UKR,Poland,POL,0,5,12,14,31
2010,Angola,AGO,Portugal,PRT,0,0,0,11,11
2010,Cameroon,CMR,Portugal,PRT,0,5,0,0,5
2010,Dem. Rep. of the Congo,COD,Portugal,PRT,0,5,0,5,10
2010,Colombia,COL,Portugal,PRT,0,14,0,5,19
2010,Eritrea,ERI,Portugal,PRT,0,5,0,0,5
2010,Georgia,GEO,Portugal,PRT,0,0,0,5,5
2010,Guinea-Bissau,GNB,Portugal,PRT,0,0,0,5,5
2010,Guinea,GIN,Portugal,PRT,0,13,0,31,44
2010,Iran (Islamic Rep. of),IRN,Portugal,PRT,5,0,0,0,5
2010,Sri Lanka,LKA,Portugal,PRT,0,5,0,0,5
2010,Mauritania,MRT,Portugal,PRT,0,0,0,5,5
2010,Nigeria,NGA,Portugal,PRT,0,5,0,5,10
2010,Sierra Leone,SLE,Portugal,PRT,0,0,0,5,5
2010,Afghanistan,AFG,South Africa,ZAF,0,0,5,0,5
2010,Algeria,DZA,South Africa,ZAF,0,0,55,0,55
2010,Angola,AGO,South Africa,ZAF,50,0,27,0,77
2010,Egypt,EGY,South Africa,ZAF,0,0,151,0,151
2010,Burundi,BDI,South Africa,ZAF,144,0,351,0,495
2010,Benin,BEN,South Africa,ZAF,0,0,31,0,31
2010,Bangladesh,BGD,South Africa,ZAF,44,0,4433,0,4477
2010,Bahamas,BHS,South Africa,ZAF,0,0,10,0,10
2010,Burkina Faso,BFA,South Africa,ZAF,0,0,13,0,13
2010,China,CHN,South Africa,ZAF,0,0,2203,0,2203
2010,Cameroon,CMR,South Africa,ZAF,22,0,593,0,615
2010,Congo,COG,South Africa,ZAF,266,0,1560,0,1826
2010,Dem. Rep. of the Congo,COD,South Africa,ZAF,1317,0,2708,0,4025
2010,Comoros,COM,South Africa,ZAF,0,0,5,0,5
2010,Eritrea,ERI,South Africa,ZAF,169,0,53,0,222
2010,Ethiopia,ETH,South Africa,ZAF,1893,0,4435,0,6328
2010,Gabon,GAB,South Africa,ZAF,0,0,5,0,5
2010,Gambia,GMB,South Africa,ZAF,0,0,5,0,5
2010,Palestinian,PSE,South Africa,ZAF,5,0,0,0,5
2010,Ghana,GHA,South Africa,ZAF,0,0,1245,0,1245
2010,Guinea-Bissau,GNB,South Africa,ZAF,0,0,10,0,10
2010,Guinea,GIN,South Africa,ZAF,0,0,17,0,17
2010,Cote d'Ivoire,CIV,South Africa,ZAF,5,0,47,0,52
2010,India,IND,South Africa,ZAF,5,0,1327,0,1332
2010,Kenya,KEN,South Africa,ZAF,16,0,348,0,364
2010,Liberia,LBR,South Africa,ZAF,0,0,25,0,25
2010,Lesotho,LSO,South Africa,ZAF,0,0,335,0,335
2010,Sri Lanka,LKA,South Africa,ZAF,0,0,24,0,24
2010,Mauritania,MRT,South Africa,ZAF,0,0,5,0,5
2010,Mali,MLI,South Africa,ZAF,0,0,34,0,34
2010,Malawi,MWI,South Africa,ZAF,0,0,2272,0,2272
2010,Morocco,MAR,South Africa,ZAF,0,0,5,0,5
2010,Mozambique,MOZ,South Africa,ZAF,0,0,1165,0,1165
2010,Namibia,NAM,South Africa,ZAF,0,0,5,0,5
2010,Nepal,NPL,South Africa,ZAF,0,0,10,0,10
2010,Niger,NER,South Africa,ZAF,0,0,111,0,111
2010,Nigeria,NGA,South Africa,ZAF,0,0,2931,0,2931
2010,Pakistan,PAK,South Africa,ZAF,5,0,4361,0,4366
2010,South Africa,ZAF,South Africa,ZAF,0,0,5,0,5
2010,Rwanda,RWA,South Africa,ZAF,92,0,91,0,183
2010,Serbia and Kosovo: S/RES/1244 (1999),SRB,South Africa,ZAF,0,0,5,0,5
2010,Senegal,SEN,South Africa,ZAF,0,0,95,0,95
2010,Sierra Leone,SLE,South Africa,ZAF,0,0,10,0,10
2010,Solomon Islands,SLB,South Africa,ZAF,5,0,0,0,5
2010,Somalia,SOM,South Africa,ZAF,5563,0,1060,0,6623
2010,Sudan,SDN,South Africa,ZAF,5,0,10,0,15
2010,Eswatini,SWZ,South Africa,ZAF,0,0,38,0,38
2010,United Rep. of Tanzania,TZA,South Africa,ZAF,0,0,618,0,618
2010,Thailand,THA,South Africa,ZAF,0,0,36,0,36
2010,Togo,TGO,South Africa,ZAF,0,0,15,0,15
2010,Turkey,TUR,South Africa,ZAF,0,0,5,0,5
2010,Uganda,UGA,South Africa,ZAF,35,0,1147,0,1182
2010,United States of America,USA,South Africa,ZAF,0,0,5,0,5
2010,Yemen,YEM,South Africa,ZAF,5,0,0,0,5
2010,Zambia,ZMB,South Africa,ZAF,5,0,152,0,157
2010,Zimbabwe,ZWE,South Africa,ZAF,429,0,32750,0,33179
2010,Afghanistan,AFG,Russian Federation,RUS,74,0,796,0,870
2010,Angola,AGO,Russian Federation,RUS,0,0,5,0,5
2010,Egypt,EGY,Russian Federation,RUS,13,0,10,0,23
2010,Armenia,ARM,Russian Federation,RUS,0,0,5,0,5
2010,Azerbaijan,AZE,Russian Federation,RUS,0,0,16,0,16
2010,Belarus,BLR,Russian Federation,RUS,0,0,5,0,5
2010,Cambodia,KHM,Russian Federation,RUS,0,0,17,0,17
2010,Congo,COG,Russian Federation,RUS,0,0,10,0,10
2010,Dem. Rep. of the Congo,COD,Russian Federation,RUS,0,0,15,0,15
2010,Cuba,CUB,Russian Federation,RUS,0,0,10,0,10
2010,Eritrea,ERI,Russian Federation,RUS,0,0,5,0,5
2010,Ethiopia,ETH,Russian Federation,RUS,0,0,10,0,10
2010,Palestinian,PSE,Russian Federation,RUS,0,0,10,0,10
2010,Georgia,GEO,Russian Federation,RUS,11,0,711,0,722
2010,Guinea,GIN,Russian Federation,RUS,0,0,5,0,5
2010,Iran (Islamic Rep. of),IRN,Russian Federation,RUS,5,0,11,0,16
2010,Iraq,IRQ,Russian Federation,RUS,0,0,5,0,5
2010,Kazakhstan,KAZ,Russian Federation,RUS,0,0,11,0,11
2010,Kyrgyzstan,KGZ,Russian Federation,RUS,5,0,158,0,163
2010,Dem. People's Rep. of Korea,PRK,Russian Federation,RUS,0,0,15,0,15
2010,Rep. of Moldova,MDA,Russian Federation,RUS,0,0,5,0,5
2010,Pakistan,PAK,Russian Federation,RUS,0,0,5,0,5
2010,Rwanda,RWA,Russian Federation,RUS,0,0,5,0,5
2010,Serbia and Kosovo: S/RES/1244 (1999),SRB,Russian Federation,RUS,5,0,0,0,5
2010,Somalia,SOM,Russian Federation,RUS,0,0,19,0,19
2010,Sudan,SDN,Russian Federation,RUS,0,0,5,0,5
2010,Syrian Arab Rep.,SYR,Russian Federation,RUS,0,0,5,0,5
2010,Tajikistan,TJK,Russian Federation,RUS,0,0,20,0,20
2010,Turkmenistan,TKM,Russian Federation,RUS,0,0,5,0,5
2010,Ukraine,UKR,Russian Federation,RUS,0,0,13,0,13
2010,Uzbekistan,UZB,Russian Federation,RUS,5,0,64,0,69
2010,Unknown ,,Russian Federation,RUS,0,0,17,0,17
2010,Bangladesh,BGD,El Salvador,SLV,0,0,0,27,27
2010,Eritrea,ERI,El Salvador,SLV,0,0,0,15,15
2010,Honduras,HND,El Salvador,SLV,5,0,0,0,5
2010,Nepal,NPL,El Salvador,SLV,0,0,5,22,27
2010,Somalia,SOM,El Salvador,SLV,0,0,0,5,5
2010,Afghanistan,AFG,Serbia and Kosovo: S/RES/1244 (1999),SRB,0,0,62,5,67
2010,Algeria,DZA,Serbia and Kosovo: S/RES/1244 (1999),SRB,0,0,5,0,5
2010,Congo,COG,Serbia and Kosovo: S/RES/1244 (1999),SRB,0,0,5,0,5
2010,Comoros,COM,Serbia and Kosovo: S/RES/1244 (1999),SRB,0,0,0,5,5
2010,Palestinian,PSE,Serbia and Kosovo: S/RES/1244 (1999),SRB,0,0,37,0,37
2010,Iran (Islamic Rep. of),IRN,Serbia and Kosovo: S/RES/1244 (1999),SRB,0,0,5,0,5
2010,Iraq,IRQ,Serbia and Kosovo: S/RES/1244 (1999),SRB,0,0,13,0,13
2010,Morocco,MAR,Serbia and Kosovo: S/RES/1244 (1999),SRB,0,0,5,0,5
2010,Nigeria,NGA,Serbia and Kosovo: S/RES/1244 (1999),SRB,0,0,5,0,5
2010,Pakistan,PAK,Serbia and Kosovo: S/RES/1244 (1999),SRB,0,0,5,5,10
2010,Somalia,SOM,Serbia and Kosovo: S/RES/1244 (1999),SRB,0,0,19,0,19
2010,Tunisia,TUN,Serbia and Kosovo: S/RES/1244 (1999),SRB,0,0,10,0,10
2010,Guinea,GIN,Sierra Leone,SLE,0,0,0,5,5
2010,Afghanistan,AFG,Spain,ESP,5,17,0,10,32
2010,Algeria,DZA,Spain,ESP,14,0,144,0,158
2010,Angola,AGO,Spain,ESP,0,0,10,0,10
2010,Egypt,EGY,Spain,ESP,0,0,0,5,5
2010,Armenia,ARM,Spain,ESP,0,0,14,11,25
2010,Azerbaijan,AZE,Spain,ESP,5,0,5,5,15
2010,Benin,BEN,Spain,ESP,0,0,5,0,5
2010,Bangladesh,BGD,Spain,ESP,0,0,5,0,5
2010,Burkina Faso,BFA,Spain,ESP,0,0,5,0,5
2010,Belarus,BLR,Spain,ESP,0,0,5,0,5
2010,Bolivia (Plurinational State of),BOL,Spain,ESP,0,0,5,0,5
2010,Brazil,BRA,Spain,ESP,0,0,14,0,14
2010,Bosnia and Herzegovina,BIH,Spain,ESP,0,0,5,0,5
2010,Chad,TCD,Spain,ESP,0,0,15,0,15
2010,China,CHN,Spain,ESP,5,0,0,0,5
2010,Cameroon,CMR,Spain,ESP,0,0,105,5,110
2010,Dem. Rep. of the Congo,COD,Spain,ESP,5,5,53,0,63
2010,Colombia,COL,Spain,ESP,27,5,312,10,354
2010,Costa Rica,CRI,Spain,ESP,0,0,5,0,5
2010,Cuba,CUB,Spain,ESP,0,214,25,5,244
2010,Ecuador,ECU,Spain,ESP,0,0,5,0,5
2010,Equatorial Guinea,GNQ,Spain,ESP,0,5,11,0,16
2010,Eritrea,ERI,Spain,ESP,0,0,11,0,11
2010,Ethiopia,ETH,Spain,ESP,0,0,5,0,5
2010,Gambia,GMB,Spain,ESP,0,0,34,0,34
2010,Palestinian,PSE,Spain,ESP,72,19,5,5,101
2010,Georgia,GEO,Spain,ESP,0,0,46,10,56
2010,Ghana,GHA,Spain,ESP,0,0,5,0,5
2010,Guinea-Bissau,GNB,Spain,ESP,0,0,5,0,5
2010,Guatemala,GTM,Spain,ESP,0,0,12,0,12
2010,Guinea,GIN,Spain,ESP,0,0,43,0,43
2010,Haiti,HTI,Spain,ESP,0,5,0,0,5
2010,Honduras,HND,Spain,ESP,10,0,15,0,25
2010,Cote d'Ivoire,CIV,Spain,ESP,0,27,152,5,184
2010,Iran (Islamic Rep. of),IRN,Spain,ESP,5,0,11,10,26
2010,Iraq,IRQ,Spain,ESP,0,5,0,0,5
2010,Kazakhstan,KAZ,Spain,ESP,0,0,5,0,5
2010,Liberia,LBR,Spain,ESP,0,0,5,0,5
2010,Sri Lanka,LKA,Spain,ESP,0,15,0,5,20
2010,Mauritania,MRT,Spain,ESP,0,0,14,0,14
2010,North Macedonia,MKD,Spain,ESP,0,0,18,0,18
2010,Rep. of Moldova,MDA,Spain,ESP,0,0,5,0,5
2010,Mexico,MEX,Spain,ESP,5,0,16,0,21
2010,Mali,MLI,Spain,ESP,0,0,13,0,13
2010,Mongolia,MNG,Spain,ESP,0,0,15,0,15
2010,Morocco,MAR,Spain,ESP,0,5,50,5,60
2010,Niger,NER,Spain,ESP,0,0,10,0,10
2010,Nigeria,NGA,Spain,ESP,0,0,164,5,169
2010,Pakistan,PAK,Spain,ESP,38,0,13,0,51
2010,Panama,PAN,Spain,ESP,0,0,5,0,5
2010,Paraguay,PRY,Spain,ESP,0,0,5,0,5
2010,Russian Federation,RUS,Spain,ESP,17,0,36,5,58
2010,El Salvador,SLV,Spain,ESP,0,0,34,0,34
2010,Serbia and Kosovo: S/RES/1244 (1999),SRB,Spain,ESP,0,0,5,0,5
2010,Senegal,SEN,Spain,ESP,0,0,10,0,10
2010,Sierra Leone,SLE,Spain,ESP,0,0,5,0,5
2010,Somalia,SOM,Spain,ESP,0,38,24,5,67
2010,Sudan,SDN,Spain,ESP,0,0,20,0,20
2010,Syrian Arab Rep.,SYR,Spain,ESP,0,0,21,0,21
2010,Turkmenistan,TKM,Spain,ESP,0,0,10,0,10
2010,Togo,TGO,Spain,ESP,5,0,5,0,10
2010,Uganda,UGA,Spain,ESP,0,0,10,0,10
2010,United States of America,USA,Spain,ESP,0,0,5,0,5
2010,Uzbekistan,UZB,Spain,ESP,5,0,0,0,5
2010,Venezuela (Bolivarian Republic of),VEN,Spain,ESP,5,0,10,0,15
2010,Zimbabwe,ZWE,Spain,ESP,0,0,5,0,5
2010,Afghanistan,AFG,Slovakia,SVK,0,37,12,22,71
2010,Algeria,DZA,Slovakia,SVK,0,0,5,5,10
2010,Armenia,ARM,Slovakia,SVK,0,0,11,5,16
2010,Bangladesh,BGD,Slovakia,SVK,0,0,5,5,10
2010,China,CHN,Slovakia,SVK,0,0,14,15,29
2010,Palestinian,PSE,Slovakia,SVK,0,0,5,5,10
2010,Georgia,GEO,Slovakia,SVK,0,0,14,56,70
2010,India,IND,Slovakia,SVK,0,0,5,36,41
2010,Iran (Islamic Rep. of),IRN,Slovakia,SVK,5,0,0,5,10
2010,Iraq,IRQ,Slovakia,SVK,5,0,5,0,10
2010,Sri Lanka,LKA,Slovakia,SVK,0,0,0,10,10
2010,Rep. of Moldova,MDA,Slovakia,SVK,0,0,10,36,46
2010,Nigeria,NGA,Slovakia,SVK,0,0,5,5,10
2010,Pakistan,PAK,Slovakia,SVK,0,0,20,47,67
2010,Russian Federation,RUS,Slovakia,SVK,0,0,12,57,69
2010,Serbia and Kosovo: S/RES/1244 (1999),SRB,Slovakia,SVK,0,0,5,12,17
2010,Somalia,SOM,Slovakia,SVK,0,15,0,5,20
2010,Viet Nam,VNM,Slovakia,SVK,0,0,19,17,36
2010,Turkey,TUR,Slovakia,SVK,0,0,0,5,5
2010,Ukraine,UKR,Slovakia,SVK,0,0,0,17,17
2010,Stateless,XXA,Slovakia,SVK,0,0,0,5,5
2010,Afghanistan,AFG,Slovenia,SVN,0,0,0,28,28
2010,Algeria,DZA,Slovenia,SVN,0,0,0,5,5
2010,Bosnia and Herzegovina,BIH,Slovenia,SVN,0,0,5,13,18
2010,Palestinian,PSE,Slovenia,SVN,0,0,0,10,10
2010,Croatia,HRV,Slovenia,SVN,0,0,0,5,5
2010,Iran (Islamic Rep. of),IRN,Slovenia,SVN,0,0,0,5,5
2010,Iraq,IRQ,Slovenia,SVN,0,0,0,5,5
2010,Kazakhstan,KAZ,Slovenia,SVN,10,0,0,0,10
2010,Sri Lanka,LKA,Slovenia,SVN,0,0,0,5,5
2010,Morocco,MAR,Slovenia,SVN,0,0,0,5,5
2010,Russian Federation,RUS,Slovenia,SVN,0,0,0,5,5
2010,Serbia and Kosovo: S/RES/1244 (1999),SRB,Slovenia,SVN,0,0,0,37,37
2010,Senegal,SEN,Slovenia,SVN,0,0,0,5,5
2010,Somalia,SOM,Slovenia,SVN,5,0,0,0,5
2010,Sudan,SDN,Slovenia,SVN,5,0,0,0,5
2010,Syrian Arab Rep.,SYR,Slovenia,SVN,0,0,0,5,5
2010,Tunisia,TUN,Slovenia,SVN,0,0,0,5,5
2010,Turkey,TUR,Slovenia,SVN,0,0,0,22,22
2010,Afghanistan,AFG,Sweden,SWE,162,884,413,51,1510
2010,Albania,ALB,Sweden,SWE,0,5,41,11,57
2010,Algeria,DZA,Sweden,SWE,0,0,88,42,130
2010,Angola,AGO,Sweden,SWE,0,0,31,0,31
2010,Egypt,EGY,Sweden,SWE,0,0,148,10,158
2010,Armenia,ARM,Sweden,SWE,0,34,186,12,232
2010,Azerbaijan,AZE,Sweden,SWE,0,50,325,37,412
2010,Burundi,BDI,Sweden,SWE,0,11,5,5,21
2010,Benin,BEN,Sweden,SWE,0,0,10,0,10
2010,Bangladesh,BGD,Sweden,SWE,5,19,85,0,109
2010,Belarus,BLR,Sweden,SWE,10,5,246,78,339
2010,Bolivia (Plurinational State of),BOL,Sweden,SWE,0,0,35,0,35
2010,Bosnia and Herzegovina,BIH,Sweden,SWE,0,15,83,15,113
2010,Bulgaria,BGR,Sweden,SWE,0,0,15,5,20
2010,Canada,CAN,Sweden,SWE,0,0,5,0,5
2010,China,CHN,Sweden,SWE,10,0,53,22,85
2010,Chile,CHL,Sweden,SWE,0,0,25,0,25
2010,Cameroon,CMR,Sweden,SWE,5,5,21,0,31
2010,Congo,COG,Sweden,SWE,0,0,5,5,10
2010,Dem. Rep. of the Congo,COD,Sweden,SWE,17,17,49,0,83
2010,Colombia,COL,Sweden,SWE,0,5,15,0,20
2010,Cuba,CUB,Sweden,SWE,0,10,20,5,35
2010,Djibouti,DJI,Sweden,SWE,0,0,5,0,5
2010,Ecuador,ECU,Sweden,SWE,0,0,13,0,13
2010,Eritrea,ERI,Sweden,SWE,156,745,73,38,1012
2010,Estonia,EST,Sweden,SWE,0,0,0,5,5
2010,Ethiopia,ETH,Sweden,SWE,40,18,134,5,197
2010,Gambia,GMB,Sweden,SWE,5,5,25,0,35
2010,United Kingdom of Great Britain and Northern Ireland,GBR,Sweden,SWE,0,5,0,0,5
2010,Georgia,GEO,Sweden,SWE,0,5,139,25,169
2010,Ghana,GHA,Sweden,SWE,5,0,25,5,35
2010,Guinea,GIN,Sweden,SWE,0,5,17,5,27
2010,Haiti,HTI,Sweden,SWE,0,0,5,0,5
2010,Honduras,HND,Sweden,SWE,0,0,11,0,11
2010,Croatia,HRV,Sweden,SWE,0,0,5,10,15
2010,Cote d'Ivoire,CIV,Sweden,SWE,0,5,12,0,17
2010,India,IND,Sweden,SWE,0,0,39,12,51
2010,Indonesia,IDN,Sweden,SWE,0,0,5,0,5
2010,Iran (Islamic Rep. of),IRN,Sweden,SWE,214,42,821,78,1155
2010,Iraq,IRQ,Sweden,SWE,569,324,774,179,1846
2010,Israel,ISR,Sweden,SWE,0,0,16,5,21
2010,Italy,ITA,Sweden,SWE,0,0,5,0,5
2010,Jordan,JOR,Sweden,SWE,0,5,83,23,111
2010,Kazakhstan,KAZ,Sweden,SWE,5,18,263,27,313
2010,Kenya,KEN,Sweden,SWE,5,5,77,5,92
2010,Kyrgyzstan,KGZ,Sweden,SWE,5,0,190,25,220
2010,Rep. of Korea,KOR,Sweden,SWE,5,0,5,5,15
2010,Dem. People's Rep. of Korea,PRK,Sweden,SWE,0,0,0,5,5
2010,Kuwait,KWT,Sweden,SWE,0,0,5,0,5
2010,Liberia,LBR,Sweden,SWE,0,0,10,0,10
2010,Libya,LBY,Sweden,SWE,5,10,220,56,291
2010,Lebanon,LBN,Sweden,SWE,0,20,106,26,152
2010,Sri Lanka,LKA,Sweden,SWE,0,5,30,5,40
2010,Lithuania,LTU,Sweden,SWE,0,0,13,0,13
2010,Latvia,LVA,Sweden,SWE,0,0,5,5,10
2010,Mauritania,MRT,Sweden,SWE,0,0,5,0,5
2010,North Macedonia,MKD,Sweden,SWE,0,5,597,64,666
2010,Rep. of Moldova,MDA,Sweden,SWE,0,0,10,11,21
2010,Mexico,MEX,Sweden,SWE,0,0,5,5,10
2010,Mali,MLI,Sweden,SWE,0,0,5,0,5
2010,Malawi,MWI,Sweden,SWE,0,0,0,5,5
2010,Mongolia,MNG,Sweden,SWE,0,17,547,32,596
2010,Morocco,MAR,Sweden,SWE,0,5,24,17,46
2010,Montenegro,MNE,Sweden,SWE,0,5,24,5,34
2010,Nepal,NPL,Sweden,SWE,0,0,13,0,13
2010,Nicaragua,NIC,Sweden,SWE,0,0,16,0,16
2010,Nigeria,NGA,Sweden,SWE,10,11,144,32,197
2010,Pakistan,PAK,Sweden,SWE,5,5,71,5,86
2010,Paraguay,PRY,Sweden,SWE,0,0,5,0,5
2010,Peru,PER,Sweden,SWE,0,0,16,0,16
2010,Romania,ROU,Sweden,SWE,0,11,12,0,23
2010,South Africa,ZAF,Sweden,SWE,0,0,5,0,5
2010,Russian Federation,RUS,Sweden,SWE,56,58,510,116,740
2010,Rwanda,RWA,Sweden,SWE,0,0,5,0,5
2010,El Salvador,SLV,Sweden,SWE,0,0,40,5,45
2010,Serbia and Kosovo: S/RES/1244 (1999),SRB,Sweden,SWE,0,122,5343,830,6295
2010,Senegal,SEN,Sweden,SWE,0,0,10,0,10
2010,Sierra Leone,SLE,Sweden,SWE,0,0,10,0,10
2010,Somalia,SOM,Sweden,SWE,464,4141,359,393,5357
2010,Spain,ESP,Sweden,SWE,0,0,5,0,5
2010,Viet Nam,VNM,Sweden,SWE,0,5,141,28,174
2010,Sudan,SDN,Sweden,SWE,17,10,32,10,69
2010,Sweden,SWE,Sweden,SWE,0,0,0,5,5
2010,Syrian Arab Rep.,SYR,Sweden,SWE,50,61,241,28,380
2010,United Rep. of Tanzania,TZA,Sweden,SWE,0,0,10,5,15
2010,Thailand,THA,Sweden,SWE,0,0,5,0,5
2010,Tajikistan,TJK,Sweden,SWE,0,0,29,5,34
2010,Turkmenistan,TKM,Sweden,SWE,0,0,10,5,15
2010,Togo,TGO,Sweden,SWE,0,0,5,0,5
2010,Tunisia,TUN,Sweden,SWE,0,5,29,11,45
2010,Turkey,TUR,Sweden,SWE,5,16,158,31,210
2010,Uganda,UGA,Sweden,SWE,10,5,39,0,54
2010,Ukraine,UKR,Sweden,SWE,0,0,95,20,115
2010,United States of America,USA,Sweden,SWE,0,0,5,0,5
2010,Uzbekistan,UZB,Sweden,SWE,17,13,205,30,265
2010,Venezuela (Bolivarian Republic of),VEN,Sweden,SWE,0,0,5,0,5
2010,Yemen,YEM,Sweden,SWE,28,5,78,13,124
2010,Stateless,XXA,Sweden,SWE,102,214,423,119,858
2010,Unknown ,,Sweden,SWE,5,17,505,56,583
2010,Afghanistan,AFG,Switzerland,CHE,40,385,58,316,799
2010,Albania,ALB,Switzerland,CHE,0,0,0,18,18
2010,Algeria,DZA,Switzerland,CHE,5,5,31,417,458
2010,Angola,AGO,Switzerland,CHE,0,39,24,41,104
2010,Egypt,EGY,Switzerland,CHE,12,0,0,40,52
2010,Armenia,ARM,Switzerland,CHE,0,5,10,82,97
2010,Azerbaijan,AZE,Switzerland,CHE,0,0,10,27,37
2010,Benin,BEN,Switzerland,CHE,0,0,5,26,31
2010,Bangladesh,BGD,Switzerland,CHE,0,0,5,29,34
2010,Bhutan,BTN,Switzerland,CHE,0,0,0,5,5
2010,Burkina Faso,BFA,Switzerland,CHE,0,0,5,23,28
2010,Belarus,BLR,Switzerland,CHE,0,0,5,77,82
2010,Bosnia and Herzegovina,BIH,Switzerland,CHE,25,19,101,149,294
2010,Bulgaria,BGR,Switzerland,CHE,0,0,10,18,28
2010,Cambodia,KHM,Switzerland,CHE,5,0,0,0,5
2010,Chad,TCD,Switzerland,CHE,0,0,5,5,10
2010,China,CHN,Switzerland,CHE,35,237,65,30,367
2010,Chile,CHL,Switzerland,CHE,0,0,5,0,5
2010,Cameroon,CMR,Switzerland,CHE,5,11,37,34,87
2010,Congo,COG,Switzerland,CHE,0,0,10,5,15
2010,Dem. Rep. of the Congo,COD,Switzerland,CHE,10,65,91,49,215
2010,Colombia,COL,Switzerland,CHE,27,0,0,5,32
2010,Cuba,CUB,Switzerland,CHE,0,0,5,0,5
2010,Equatorial Guinea,GNQ,Switzerland,CHE,0,0,0,10,10
2010,Eritrea,ERI,Switzerland,CHE,2160,736,100,470,3466
2010,Ethiopia,ETH,Switzerland,CHE,56,31,73,55,215
2010,Gabon,GAB,Switzerland,CHE,0,0,0,16,16
2010,Gambia,GMB,Switzerland,CHE,0,5,19,182,206
2010,Palestinian,PSE,Switzerland,CHE,0,5,17,59,81
2010,Georgia,GEO,Switzerland,CHE,5,0,28,712,745
2010,Germany,DEU,Switzerland,CHE,0,0,0,10,10
2010,Ghana,GHA,Switzerland,CHE,0,0,0,124,124
2010,Guinea-Bissau,GNB,Switzerland,CHE,0,0,12,143,155
2010,Guinea,GIN,Switzerland,CHE,0,5,35,297,337
2010,Haiti,HTI,Switzerland,CHE,0,0,0,5,5
2010,Croatia,HRV,Switzerland,CHE,0,0,5,5,10
2010,Hungary,HUN,Switzerland,CHE,0,0,0,5,5
2010,Cote d'Ivoire,CIV,Switzerland,CHE,0,5,42,88,135
2010,India,IND,Switzerland,CHE,0,0,5,15,20
2010,Iran (Islamic Rep. of),IRN,Switzerland,CHE,89,53,115,117,374
2010,Iraq,IRQ,Switzerland,CHE,148,305,173,486,1112
2010,Italy,ITA,Switzerland,CHE,0,0,0,10,10
2010,Jamaica,JAM,Switzerland,CHE,0,0,0,5,5
2010,Jordan,JOR,Switzerland,CHE,10,0,0,5,15
2010,Kazakhstan,KAZ,Switzerland,CHE,0,0,0,11,11
2010,Kenya,KEN,Switzerland,CHE,0,5,0,10,15
2010,Liberia,LBR,Switzerland,CHE,0,0,5,50,55
2010,Libya,LBY,Switzerland,CHE,5,0,5,20,30
2010,Lebanon,LBN,Switzerland,CHE,0,0,5,21,26
2010,Sri Lanka,LKA,Switzerland,CHE,194,509,181,203,1087
2010,Lithuania,LTU,Switzerland,CHE,0,0,0,5,5
2010,Mauritania,MRT,Switzerland,CHE,0,0,5,26,31
2010,North Macedonia,MKD,Switzerland,CHE,0,5,58,323,386
2010,Rep. of Moldova,MDA,Switzerland,CHE,0,0,5,36,41
2010,Mexico,MEX,Switzerland,CHE,0,0,0,5,5
2010,Mali,MLI,Switzerland,CHE,0,0,5,57,62
2010,Mongolia,MNG,Switzerland,CHE,0,0,43,138,181
2010,Morocco,MAR,Switzerland,CHE,0,0,5,84,89
2010,Montenegro,MNE,Switzerland,CHE,0,0,0,11,11
2010,Nepal,NPL,Switzerland,CHE,0,0,5,13,18
2010,Niger,NER,Switzerland,CHE,0,0,5,40,45
2010,Nigeria,NGA,Switzerland,CHE,0,0,41,2199,2240
2010,Pakistan,PAK,Switzerland,CHE,5,0,25,68,98
2010,Poland,POL,Switzerland,CHE,0,0,0,5,5
2010,Romania,ROU,Switzerland,CHE,0,0,17,55,72
2010,Russian Federation,RUS,Switzerland,CHE,26,21,53,426,526
2010,Rwanda,RWA,Switzerland,CHE,0,0,0,5,5
2010,Serbia and Kosovo: S/RES/1244 (1999),SRB,Switzerland,CHE,31,97,459,1085,1672
2010,Senegal,SEN,Switzerland,CHE,0,0,5,75,80
2010,Sierra Leone,SLE,Switzerland,CHE,0,0,5,74,79
2010,Somalia,SOM,Switzerland,CHE,148,1141,38,245,1572
2010,Viet Nam,VNM,Switzerland,CHE,5,0,0,0,5
2010,Sudan,SDN,Switzerland,CHE,5,17,16,81,119
2010,Slovakia,SVK,Switzerland,CHE,0,0,5,5,10
2010,Syrian Arab Rep.,SYR,Switzerland,CHE,46,49,239,157,491
2010,Tajikistan,TJK,Switzerland,CHE,0,0,0,5,5
2010,Turkmenistan,TKM,Switzerland,CHE,5,0,0,0,5
2010,Togo,TGO,Switzerland,CHE,29,5,36,83,153
2010,Tunisia,TUN,Switzerland,CHE,21,0,16,304,341
2010,Turkey,TUR,Switzerland,CHE,228,29,218,168,643
2010,Uganda,UGA,Switzerland,CHE,0,0,10,10,20
2010,Ukraine,UKR,Switzerland,CHE,0,0,10,25,35
2010,United States of America,USA,Switzerland,CHE,0,0,0,5,5
2010,Uzbekistan,UZB,Switzerland,CHE,0,0,0,16,16
2010,Western Sahara,ESH,Switzerland,CHE,0,0,0,10,10
2010,Yemen,YEM,Switzerland,CHE,22,25,14,15,76
2010,Zimbabwe,ZWE,Switzerland,CHE,0,0,0,17,17
2010,Stateless,XXA,Switzerland,CHE,0,0,5,5,10
2010,Unknown ,,Switzerland,CHE,27,42,94,154,317
2010,Chad,TCD,Togo,TGO,12,0,0,0,12
2010,Dem. Rep. of the Congo,COD,Togo,TGO,5,0,10,0,15
2010,Cote d'Ivoire,CIV,Togo,TGO,0,0,5,0,5
2010,Rwanda,RWA,Togo,TGO,5,0,0,0,5
2010,Afghanistan,AFG,Ukraine,UKR,101,0,183,156,440
2010,Armenia,ARM,Ukraine,UKR,5,0,5,5,15
2010,Azerbaijan,AZE,Ukraine,UKR,0,0,0,10,10
2010,Bangladesh,BGD,Ukraine,UKR,0,0,5,5,10
2010,Belarus,BLR,Ukraine,UKR,5,0,5,14,24
2010,Cameroon,CMR,Ukraine,UKR,0,0,12,10,22
2010,Congo,COG,Ukraine,UKR,0,0,5,10,15
2010,Dem. Rep. of the Congo,COD,Ukraine,UKR,0,0,14,10,24
2010,Palestinian,PSE,Ukraine,UKR,0,0,12,27,39
2010,Georgia,GEO,Ukraine,UKR,0,0,17,11,28
2010,Guinea,GIN,Ukraine,UKR,0,0,22,5,27
2010,India,IND,Ukraine,UKR,0,0,0,5,5
2010,Iran (Islamic Rep. of),IRN,Ukraine,UKR,5,0,10,13,28
2010,Iraq,IRQ,Ukraine,UKR,5,0,19,14,38
2010,Jordan,JOR,Ukraine,UKR,0,0,5,0,5
2010,Kyrgyzstan,KGZ,Ukraine,UKR,0,0,24,63,87
2010,Rep. of Moldova,MDA,Ukraine,UKR,0,0,0,10,10
2010,Nepal,NPL,Ukraine,UKR,0,0,5,0,5
2010,Nigeria,NGA,Ukraine,UKR,0,0,5,5,10
2010,Pakistan,PAK,Ukraine,UKR,0,0,10,26,36
2010,Russian Federation,RUS,Ukraine,UKR,0,0,12,23,35
2010,Somalia,SOM,Ukraine,UKR,0,0,89,125,214
2010,Viet Nam,VNM,Ukraine,UKR,0,0,0,5,5
2010,Sudan,SDN,Ukraine,UKR,0,0,0,5,5
2010,Syrian Arab Rep.,SYR,Ukraine,UKR,0,0,25,10,35
2010,Turkmenistan,TKM,Ukraine,UKR,5,0,0,0,5
2010,Uzbekistan,UZB,Ukraine,UKR,0,0,25,70,95
2010,Stateless,XXA,Ukraine,UKR,0,0,5,10,15
2010,Colombia,COL,Uruguay,URY,0,0,5,5,10
2010,Afghanistan,AFG,Venezuela (Bolivarian Republic of),VEN,5,0,0,0,5
2010,Colombia,COL,Venezuela (Bolivarian Republic of),VEN,255,0,1700,0,1955
2010,Burundi,BDI,Zimbabwe,ZWE,37,0,5,15,57
2010,Dem. Rep. of the Congo,COD,Zimbabwe,ZWE,469,0,10,488,967
2010,Ethiopia,ETH,Zimbabwe,ZWE,5,0,0,0,5
2010,Rwanda,RWA,Zimbabwe,ZWE,29,0,0,126,155
2010,Somalia,SOM,Zimbabwe,ZWE,5,0,0,0,5
2011,Angola,AGO,Argentina,ARG,0,0,5,0,5
2011,Armenia,ARM,Argentina,ARG,0,0,12,5,17
2011,Bangladesh,BGD,Argentina,ARG,0,0,13,5,18
2011,Brazil,BRA,Argentina,ARG,0,0,5,0,5
2011,Cameroon,CMR,Argentina,ARG,0,0,0,10,10
2011,Dem. Rep. of the Congo,COD,Argentina,ARG,0,0,0,14,14
2011,Colombia,COL,Argentina,ARG,31,24,55,144,254
2011,Cuba,CUB,Argentina,ARG,5,0,20,18,43
2011,Dominican Rep.,DOM,Argentina,ARG,0,0,89,36,125
2011,Ecuador,ECU,Argentina,ARG,0,0,0,5,5
2011,Equatorial Guinea,GNQ,Argentina,ARG,0,0,0,5,5
2011,Ghana,GHA,Argentina,ARG,11,0,10,0,21
2011,Guinea-Bissau,GNB,Argentina,ARG,0,0,0,10,10
2011,Haiti,HTI,Argentina,ARG,12,0,30,28,70
2011,Cote d'Ivoire,CIV,Argentina,ARG,15,0,0,5,20
2011,India,IND,Argentina,ARG,0,0,16,5,21
2011,Kazakhstan,KAZ,Argentina,ARG,0,0,5,0,5
2011,Liberia,LBR,Argentina,ARG,0,0,0,5,5
2011,Sri Lanka,LKA,Argentina,ARG,0,0,0,5,5
2011,Nepal,NPL,Argentina,ARG,0,0,5,0,5
2011,Nigeria,NGA,Argentina,ARG,0,0,18,15,33
2011,Peru,PER,Argentina,ARG,0,0,10,24,34
2011,El Salvador,SLV,Argentina,ARG,0,5,0,0,5
2011,Senegal,SEN,Argentina,ARG,0,0,82,5,87
2011,Sierra Leone,SLE,Argentina,ARG,0,0,0,5,5
2011,Spain,ESP,Argentina,ARG,0,0,5,0,5
2011,Zimbabwe,ZWE,Argentina,ARG,0,0,5,0,5
2011,Cote d'Ivoire,CIV,Armenia,ARM,5,0,0,0,5
2011,Iran (Islamic Rep. of),IRN,Armenia,ARM,0,0,5,5,10
2011,Iraq,IRQ,Armenia,ARM,35,0,0,0,35
2011,Syrian Arab Rep.,SYR,Armenia,ARM,5,0,0,0,5
2011,Turkey,TUR,Armenia,ARM,0,0,10,0,10
2011,Afghanistan,AFG,Australia,AUS,1211,0,900,0,2111
2011,Albania,ALB,Australia,AUS,0,0,17,0,17
2011,Egypt,EGY,Australia,AUS,117,0,298,0,415
2011,Bahrain,BHR,Australia,AUS,40,0,10,0,50
2011,Burundi,BDI,Australia,AUS,0,0,5,0,5
2011,Bangladesh,BGD,Australia,AUS,19,0,83,0,102
2011,Brazil,BRA,Australia,AUS,0,0,12,0,12
2011,Cambodia,KHM,Australia,AUS,5,0,15,0,20
2011,China,CHN,Australia,AUS,132,0,934,0,1066
2011,Cameroon,CMR,Australia,AUS,0,0,5,0,5
2011,Dem. Rep. of the Congo,COD,Australia,AUS,0,0,5,0,5
2011,Colombia,COL,Australia,AUS,5,0,37,0,42
2011,Czechia,CZE,Australia,AUS,0,0,5,0,5
2011,Eritrea,ERI,Australia,AUS,27,0,0,0,27
2011,Ethiopia,ETH,Australia,AUS,13,0,19,0,32
2011,Fiji,FJI,Australia,AUS,27,0,260,0,287
2011,Palestinian,PSE,Australia,AUS,26,0,14,0,40
2011,United Kingdom of Great Britain and Northern Ireland,GBR,Australia,AUS,0,0,5,0,5
2011,Ghana,GHA,Australia,AUS,0,0,15,0,15
2011,"China, Hong Kong SAR",HKG,Australia,AUS,0,0,14,0,14
2011,India,IND,Australia,AUS,14,0,495,0,509
2011,Indonesia,IDN,Australia,AUS,11,0,156,0,167
2011,Iran (Islamic Rep. of),IRN,Australia,AUS,1181,0,859,0,2040
2011,Iraq,IRQ,Australia,AUS,434,0,235,0,669
2011,Israel,ISR,Australia,AUS,0,0,10,0,10
2011,Italy,ITA,Australia,AUS,0,0,5,0,5
2011,Jordan,JOR,Australia,AUS,0,0,26,0,26
2011,Japan,JPN,Australia,AUS,0,0,5,0,5
2011,Kazakhstan,KAZ,Australia,AUS,0,0,5,0,5
2011,Kenya,KEN,Australia,AUS,0,0,15,0,15
2011,Rep. of Korea,KOR,Australia,AUS,5,0,62,0,67
2011,Kuwait,KWT,Australia,AUS,15,0,10,0,25
2011,Libya,LBY,Australia,AUS,13,0,10,0,23
2011,Lebanon,LBN,Australia,AUS,36,0,149,0,185
2011,Sri Lanka,LKA,Australia,AUS,306,0,249,0,555
2011,Lithuania,LTU,Australia,AUS,0,0,5,0,5
2011,North Macedonia,MKD,Australia,AUS,0,0,5,0,5
2011,Maldives,MDV,Australia,AUS,5,0,0,0,5
2011,Malaysia,MYS,Australia,AUS,5,0,160,0,165
2011,Mongolia,MNG,Australia,AUS,0,0,12,0,12
2011,Morocco,MAR,Australia,AUS,0,0,5,0,5
2011,Mozambique,MOZ,Australia,AUS,5,0,0,0,5
2011,Mauritius,MUS,Australia,AUS,0,0,30,0,30
2011,Myanmar,MMR,Australia,AUS,101,0,20,0,121
2011,Nepal,NPL,Australia,AUS,17,0,171,0,188
2011,Nigeria,NGA,Australia,AUS,5,0,28,0,33
2011,New Zealand,NZL,Australia,AUS,0,0,5,0,5
2011,Pakistan,PAK,Australia,AUS,291,0,302,0,593
2011,Peru,PER,Australia,AUS,0,0,12,0,12
2011,Philippines,PHL,Australia,AUS,0,0,61,0,61
2011,Papua New Guinea,PNG,Australia,AUS,38,0,44,0,82
2011,Romania,ROU,Australia,AUS,0,0,5,0,5
2011,South Africa,ZAF,Australia,AUS,5,0,10,0,15
2011,Russian Federation,RUS,Australia,AUS,0,0,5,0,5
2011,Rwanda,RWA,Australia,AUS,5,0,0,0,5
2011,El Salvador,SLV,Australia,AUS,0,0,10,0,10
2011,Saudi Arabia,SAU,Australia,AUS,5,0,0,0,5
2011,Singapore,SGP,Australia,AUS,0,0,5,0,5
2011,Solomon Islands,SLB,Australia,AUS,0,0,5,0,5
2011,Somalia,SOM,Australia,AUS,10,0,0,0,10
2011,Viet Nam,VNM,Australia,AUS,0,0,152,0,152
2011,Syrian Arab Rep.,SYR,Australia,AUS,27,0,20,0,47
2011,Thailand,THA,Australia,AUS,0,0,15,0,15
2011,Tonga,TON,Australia,AUS,5,0,29,0,34
2011,Turkey,TUR,Australia,AUS,40,0,83,0,123
2011,Uganda,UGA,Australia,AUS,5,0,10,0,15
2011,Ukraine,UKR,Australia,AUS,5,0,10,0,15
2011,United States of America,USA,Australia,AUS,0,0,10,0,10
2011,Uzbekistan,UZB,Australia,AUS,0,0,5,0,5
2011,Zambia,ZMB,Australia,AUS,0,0,5,0,5
2011,Zimbabwe,ZWE,Australia,AUS,75,0,109,0,184
2011,Stateless,XXA,Australia,AUS,519,0,356,0,875
2011,Unknown ,,Australia,AUS,5,0,0,0,5
2011,Afghanistan,AFG,Azerbaijan,AZE,0,0,28,0,28
2011,Iran (Islamic Rep. of),IRN,Azerbaijan,AZE,0,0,13,0,13
2011,Pakistan,PAK,Azerbaijan,AZE,0,0,16,0,16
2011,Afghanistan,AFG,Belgium,BEL,379,446,604,31,1460
2011,Albania,ALB,Belgium,BEL,30,0,395,70,495
2011,Algeria,DZA,Belgium,BEL,5,0,121,38,164
2011,Angola,AGO,Belgium,BEL,5,0,145,5,155
2011,Egypt,EGY,Belgium,BEL,5,0,16,10,31
2011,Argentina,ARG,Belgium,BEL,0,0,5,0,5
2011,Armenia,ARM,Belgium,BEL,5,5,896,54,960
2011,Azerbaijan,AZE,Belgium,BEL,5,0,34,5,44
2011,Burundi,BDI,Belgium,BEL,41,5,157,13,216
2011,Benin,BEN,Belgium,BEL,10,0,12,0,22
2011,Bangladesh,BGD,Belgium,BEL,0,0,108,16,124
2011,Bhutan,BTN,Belgium,BEL,0,0,5,0,5
2011,Burkina Faso,BFA,Belgium,BEL,5,0,61,5,71
2011,Belarus,BLR,Belgium,BEL,0,0,37,5,42
2011,Bosnia and Herzegovina,BIH,Belgium,BEL,0,0,268,85,353
2011,Bulgaria,BGR,Belgium,BEL,0,0,59,5,64
2011,Chad,TCD,Belgium,BEL,5,0,10,0,15
2011,China,CHN,Belgium,BEL,189,0,25,13,227
2011,Cameroon,CMR,Belgium,BEL,82,0,320,14,416
2011,Congo,COG,Belgium,BEL,0,0,13,5,18
2011,Dem. Rep. of the Congo,COD,Belgium,BEL,81,5,388,36,510
2011,Colombia,COL,Belgium,BEL,10,0,0,0,10
2011,Czechia,CZE,Belgium,BEL,0,0,12,0,12
2011,Djibouti,DJI,Belgium,BEL,28,0,30,5,63
2011,Equatorial Guinea,GNQ,Belgium,BEL,0,0,0,5,5
2011,Eritrea,ERI,Belgium,BEL,22,0,18,5,45
2011,Ethiopia,ETH,Belgium,BEL,5,0,23,0,28
2011,France,FRA,Belgium,BEL,0,0,5,0,5
2011,Gabon,GAB,Belgium,BEL,5,0,5,0,10
2011,Gambia,GMB,Belgium,BEL,10,0,39,5,54
2011,Palestinian,PSE,Belgium,BEL,5,14,5,0,24
2011,Georgia,GEO,Belgium,BEL,0,0,134,26,160
2011,Ghana,GHA,Belgium,BEL,0,0,42,0,42
2011,Guinea-Bissau,GNB,Belgium,BEL,0,0,10,0,10
2011,Guinea,GIN,Belgium,BEL,842,13,1143,58,2056
2011,Haiti,HTI,Belgium,BEL,0,0,0,5,5
2011,Croatia,HRV,Belgium,BEL,0,0,17,0,17
2011,Cote d'Ivoire,CIV,Belgium,BEL,17,0,135,20,172
2011,India,IND,Belgium,BEL,0,0,119,20,139
2011,Iran (Islamic Rep. of),IRN,Belgium,BEL,48,0,65,28,141
2011,Iraq,IRQ,Belgium,BEL,475,677,277,107,1536
2011,Israel,ISR,Belgium,BEL,0,0,5,0,5
2011,Jordan,JOR,Belgium,BEL,5,0,10,0,15
2011,Kazakhstan,KAZ,Belgium,BEL,0,0,21,15,36
2011,Kenya,KEN,Belgium,BEL,12,0,29,5,46
2011,Kyrgyzstan,KGZ,Belgium,BEL,0,0,5,10,15
2011,Dem. People's Rep. of Korea,PRK,Belgium,BEL,45,0,0,5,50
2011,Liberia,LBR,Belgium,BEL,5,0,20,0,25
2011,Libya,LBY,Belgium,BEL,0,0,0,5,5
2011,Lebanon,LBN,Belgium,BEL,15,0,33,10,58
2011,Sri Lanka,LKA,Belgium,BEL,70,0,148,5,223
2011,Madagascar,MDG,Belgium,BEL,0,0,5,0,5
2011,Mauritania,MRT,Belgium,BEL,19,0,115,10,144
2011,North Macedonia,MKD,Belgium,BEL,11,0,1250,199,1460
2011,Mali,MLI,Belgium,BEL,5,0,15,0,20
2011,Mongolia,MNG,Belgium,BEL,0,0,46,0,46
2011,Morocco,MAR,Belgium,BEL,5,0,28,5,38
2011,Montenegro,MNE,Belgium,BEL,0,0,5,5,10
2011,Mauritius,MUS,Belgium,BEL,0,0,5,0,5
2011,Myanmar,MMR,Belgium,BEL,10,0,0,0,10
2011,Nepal,NPL,Belgium,BEL,0,0,17,5,22
2011,Niger,NER,Belgium,BEL,16,0,71,10,97
2011,Nigeria,NGA,Belgium,BEL,10,0,106,5,121
2011,Pakistan,PAK,Belgium,BEL,5,0,189,24,218
2011,Romania,ROU,Belgium,BEL,0,0,84,5,89
2011,Russian Federation,RUS,Belgium,BEL,333,5,2258,157,2753
2011,Rwanda,RWA,Belgium,BEL,140,0,384,13,537
2011,El Salvador,SLV,Belgium,BEL,0,10,0,0,10
2011,Serbia and Kosovo: S/RES/1244 (1999),SRB,Belgium,BEL,352,0,4814,531,5697
2011,Senegal,SEN,Belgium,BEL,109,0,219,10,338
2011,Sierra Leone,SLE,Belgium,BEL,10,0,19,0,29
2011,Somalia,SOM,Belgium,BEL,95,37,213,10,355
2011,Sudan,SDN,Belgium,BEL,10,12,35,5,62
2011,Slovakia,SVK,Belgium,BEL,0,0,44,0,44
2011,Syrian Arab Rep.,SYR,Belgium,BEL,63,0,19,14,96
2011,United Rep. of Tanzania,TZA,Belgium,BEL,13,5,116,5,139
2011,Togo,TGO,Belgium,BEL,27,5,117,5,154
2011,Tunisia,TUN,Belgium,BEL,0,0,31,5,36
2011,Turkey,TUR,Belgium,BEL,39,0,183,24,246
2011,Uganda,UGA,Belgium,BEL,5,0,10,0,15
2011,Ukraine,UKR,Belgium,BEL,0,0,31,0,31
2011,Uzbekistan,UZB,Belgium,BEL,0,0,18,5,23
2011,Venezuela (Bolivarian Republic of),VEN,Belgium,BEL,0,0,10,0,10
2011,Stateless,XXA,Belgium,BEL,0,0,0,5,5
2011,Unknown ,,Belgium,BEL,56,27,69,24,176
2011,Cote d'Ivoire,CIV,Benin,BEN,142,0,10,0,152
2011,Rwanda,RWA,Benin,BEN,5,0,5,0,10
2011,Togo,TGO,Benin,BEN,0,0,10,0,10
2011,Cuba,CUB,Bahamas,BHS,0,0,0,5,5
2011,Chad,TCD,Burkina Faso,BFA,20,0,0,5,25
2011,Dem. Rep. of the Congo,COD,Burkina Faso,BFA,0,0,0,5,5
2011,Cote d'Ivoire,CIV,Burkina Faso,BFA,0,0,0,5,5
2011,Rwanda,RWA,Burkina Faso,BFA,10,0,0,0,10
2011,Afghanistan,AFG,Belarus,BLR,10,0,28,17,55
2011,Azerbaijan,AZE,Belarus,BLR,0,0,0,5,5
2011,Georgia,GEO,Belarus,BLR,0,0,13,10,23
2011,Pakistan,PAK,Belarus,BLR,5,0,0,5,10
2011,Russian Federation,RUS,Belarus,BLR,0,0,5,0,5
2011,Colombia,COL,Bolivia (Plurinational State of),BOL,21,0,24,0,45
2011,Honduras,HND,Bolivia (Plurinational State of),BOL,0,0,5,0,5
2011,Peru,PER,Bolivia (Plurinational State of),BOL,0,0,5,0,5
2011,Afghanistan,AFG,Brazil,BRA,0,0,5,0,5
2011,Angola,AGO,Brazil,BRA,0,0,11,5,16
2011,Bangladesh,BGD,Brazil,BRA,0,0,46,5,51
2011,Dem. Rep. of the Congo,COD,Brazil,BRA,27,0,43,5,75
2011,Colombia,COL,Brazil,BRA,36,0,65,0,101
2011,Cuba,CUB,Brazil,BRA,0,0,13,5,18
2011,Ghana,GHA,Brazil,BRA,0,0,5,0,5
2011,Guinea-Bissau,GNB,Brazil,BRA,0,0,24,0,24
2011,Guinea,GIN,Brazil,BRA,0,0,5,0,5
2011,Haiti,HTI,Brazil,BRA,0,720,0,0,720
2011,Cote d'Ivoire,CIV,Brazil,BRA,5,0,0,0,5
2011,India,IND,Brazil,BRA,0,0,5,0,5
2011,Iraq,IRQ,Brazil,BRA,5,0,0,0,5
2011,Israel,ISR,Brazil,BRA,0,0,5,0,5
2011,Nigeria,NGA,Brazil,BRA,5,0,22,0,27
2011,Pakistan,PAK,Brazil,BRA,10,0,29,0,39
2011,Peru,PER,Brazil,BRA,0,0,5,0,5
2011,Senegal,SEN,Brazil,BRA,0,0,10,0,10
2011,Somalia,SOM,Brazil,BRA,5,0,0,0,5
2011,United States of America,USA,Brazil,BRA,0,0,5,0,5
2011,Venezuela (Bolivarian Republic of),VEN,Brazil,BRA,0,0,5,0,5
2011,Myanmar,MMR,Cambodia,KHM,0,0,5,5,10
2011,Pakistan,PAK,Cambodia,KHM,5,0,0,0,5
2011,Afghanistan,AFG,Canada,CAN,392,0,50,61,503
2011,Albania,ALB,Canada,CAN,92,0,173,29,294
2011,Algeria,DZA,Canada,CAN,60,0,55,23,138
2011,Angola,AGO,Canada,CAN,10,0,10,5,25
2011,Antigua and Barbuda,ATG,Canada,CAN,10,0,12,5,27
2011,Egypt,EGY,Canada,CAN,87,0,29,12,128
2011,Argentina,ARG,Canada,CAN,0,0,32,5,37
2011,Armenia,ARM,Canada,CAN,10,0,5,5,20
2011,Australia,AUS,Canada,CAN,0,0,5,0,5
2011,Azerbaijan,AZE,Canada,CAN,15,0,5,5,25
2011,Barbados,BRB,Canada,CAN,25,0,24,11,60
2011,Burundi,BDI,Canada,CAN,92,0,47,0,139
2011,Belgium,BEL,Canada,CAN,0,0,5,0,5
2011,Bangladesh,BGD,Canada,CAN,48,0,81,16,145
2011,Bahamas,BHS,Canada,CAN,12,0,5,0,17
2011,Burkina Faso,BFA,Canada,CAN,5,0,5,0,10
2011,Belarus,BLR,Canada,CAN,12,0,5,5,22
2011,Bolivia (Plurinational State of),BOL,Canada,CAN,5,0,13,5,23
2011,Botswana,BWA,Canada,CAN,73,0,64,11,148
2011,Brazil,BRA,Canada,CAN,5,0,110,43,158
2011,Bosnia and Herzegovina,BIH,Canada,CAN,11,0,18,0,29
2011,Bulgaria,BGR,Canada,CAN,27,0,12,0,39
2011,Cambodia,KHM,Canada,CAN,5,0,5,0,10
2011,Chad,TCD,Canada,CAN,16,0,14,0,30
2011,China,CHN,Canada,CAN,958,0,672,179,1809
2011,Chile,CHL,Canada,CAN,5,0,52,17,74
2011,Cameroon,CMR,Canada,CAN,118,0,40,13,171
2011,Congo,COG,Canada,CAN,15,0,17,0,32
2011,Dem. Rep. of the Congo,COD,Canada,CAN,220,0,128,43,391
2011,Colombia,COL,Canada,CAN,639,0,972,121,1732
2011,Costa Rica,CRI,Canada,CAN,10,0,42,5,57
2011,Cuba,CUB,Canada,CAN,128,0,53,38,219
2011,Czechia,CZE,Canada,CAN,43,0,331,167,541
2011,Djibouti,DJI,Canada,CAN,67,0,10,0,77
2011,Dominica,DMA,Canada,CAN,0,0,10,5,15
2011,Dominican Rep.,DOM,Canada,CAN,13,0,46,22,81
2011,Ecuador,ECU,Canada,CAN,12,0,48,10,70
2011,Equatorial Guinea,GNQ,Canada,CAN,0,0,5,0,5
2011,Eritrea,ERI,Canada,CAN,244,0,10,13,267
2011,Estonia,EST,Canada,CAN,0,0,5,5,10
2011,Ethiopia,ETH,Canada,CAN,218,0,32,5,255
2011,Fiji,FJI,Canada,CAN,19,0,34,5,58
2011,France,FRA,Canada,CAN,5,0,13,15,33
2011,Gambia,GMB,Canada,CAN,10,0,10,5,25
2011,Palestinian,PSE,Canada,CAN,36,0,29,5,70
2011,United Kingdom of Great Britain and Northern Ireland,GBR,Canada,CAN,0,0,16,10,26
2011,Georgia,GEO,Canada,CAN,22,0,69,12,103
2011,Germany,DEU,Canada,CAN,0,0,16,5,21
2011,Ghana,GHA,Canada,CAN,40,0,48,5,93
2011,Guinea-Bissau,GNB,Canada,CAN,5,0,0,0,5
2011,Greece,GRC,Canada,CAN,5,0,15,5,25
2011,Grenada,GRD,Canada,CAN,15,0,32,5,52
2011,Guatemala,GTM,Canada,CAN,139,0,234,26,399
2011,Guinea,GIN,Canada,CAN,63,0,42,5,110
2011,Guyana,GUY,Canada,CAN,27,0,100,16,143
2011,Haiti,HTI,Canada,CAN,1440,0,1429,138,3007
2011,Honduras,HND,Canada,CAN,113,0,251,46,410
2011,Croatia,HRV,Canada,CAN,16,0,39,18,73
2011,Hungary,HUN,Canada,CAN,165,0,738,1087,1990
2011,Cote d'Ivoire,CIV,Canada,CAN,30,0,10,10,50
2011,India,IND,Canada,CAN,111,0,381,113,605
2011,Indonesia,IDN,Canada,CAN,13,0,19,5,37
2011,Iran (Islamic Rep. of),IRN,Canada,CAN,329,0,44,33,406
2011,Iraq,IRQ,Canada,CAN,210,0,40,20,270
2011,Israel,ISR,Canada,CAN,31,0,303,106,440
2011,Italy,ITA,Canada,CAN,0,0,26,10,36
2011,Jamaica,JAM,Canada,CAN,169,0,211,54,434
2011,Jordan,JOR,Canada,CAN,39,0,53,14,106
2011,Japan,JPN,Canada,CAN,0,0,0,10,10
2011,Kazakhstan,KAZ,Canada,CAN,15,0,5,0,20
2011,Kenya,KEN,Canada,CAN,107,0,22,0,129
2011,Kyrgyzstan,KGZ,Canada,CAN,5,0,5,0,10
2011,Rep. of Korea,KOR,Canada,CAN,20,0,76,74,170
2011,Dem. People's Rep. of Korea,PRK,Canada,CAN,117,0,12,41,170
2011,Lao People's Dem. Rep.,LAO,Canada,CAN,0,0,24,5,29
2011,Liberia,LBR,Canada,CAN,27,0,24,0,51
2011,Libya,LBY,Canada,CAN,32,0,21,24,77
2011,Saint Lucia,LCA,Canada,CAN,279,0,260,63,602
2011,Lebanon,LBN,Canada,CAN,76,0,89,14,179
2011,Sri Lanka,LKA,Canada,CAN,281,0,183,28,492
2011,Lithuania,LTU,Canada,CAN,5,0,19,20,44
2011,Latvia,LVA,Canada,CAN,27,0,22,30,79
2011,Madagascar,MDG,Canada,CAN,5,0,0,0,5
2011,Mauritania,MRT,Canada,CAN,5,0,10,5,20
2011,North Macedonia,MKD,Canada,CAN,10,0,18,5,33
2011,Rep. of Moldova,MDA,Canada,CAN,43,0,19,10,72
2011,Mexico,MEX,Canada,CAN,1042,0,4184,884,6110
2011,Mali,MLI,Canada,CAN,5,0,5,5,15
2011,Malaysia,MYS,Canada,CAN,0,0,11,5,16
2011,Malawi,MWI,Canada,CAN,10,0,0,0,10
2011,Mongolia,MNG,Canada,CAN,15,0,11,5,31
2011,Morocco,MAR,Canada,CAN,20,0,21,10,51
2011,Montenegro,MNE,Canada,CAN,12,0,19,0,31
2011,Myanmar,MMR,Canada,CAN,12,0,5,0,17
2011,Namibia,NAM,Canada,CAN,65,0,48,26,139
2011,Nepal,NPL,Canada,CAN,127,0,46,0,173
2011,Netherlands,NLD,Canada,CAN,0,0,10,5,15
2011,Niger,NER,Canada,CAN,10,0,5,5,20
2011,Nicaragua,NIC,Canada,CAN,11,0,40,5,56
2011,Nigeria,NGA,Canada,CAN,840,0,422,74,1336
2011,Oman,OMN,Canada,CAN,5,0,0,0,5
2011,Pakistan,PAK,Canada,CAN,433,0,138,73,644
2011,Panama,PAN,Canada,CAN,0,0,15,0,15
2011,Paraguay,PRY,Canada,CAN,10,0,0,0,10
2011,Peru,PER,Canada,CAN,16,0,86,20,122
2011,Philippines,PHL,Canada,CAN,18,0,175,28,221
2011,Poland,POL,Canada,CAN,10,0,40,37,87
2011,Portugal,PRT,Canada,CAN,0,0,48,20,68
2011,Puerto Rico,PRI,Canada,CAN,0,0,0,5,5
2011,Romania,ROU,Canada,CAN,34,0,35,29,98
2011,South Africa,ZAF,Canada,CAN,13,0,11,12,36
2011,Russian Federation,RUS,Canada,CAN,119,0,47,32,198
2011,Rwanda,RWA,Canada,CAN,118,0,44,5,167
2011,El Salvador,SLV,Canada,CAN,190,0,508,51,749
2011,Saudi Arabia,SAU,Canada,CAN,12,0,0,5,17
2011,Serbia and Kosovo: S/RES/1244 (1999),SRB,Canada,CAN,46,0,59,24,129
2011,Senegal,SEN,Canada,CAN,22,0,12,5,39
2011,Singapore,SGP,Canada,CAN,0,0,5,5,10
2011,Sierra Leone,SLE,Canada,CAN,10,0,5,0,15
2011,Somalia,SOM,Canada,CAN,646,0,31,165,842
2011,Spain,ESP,Canada,CAN,0,0,11,15,26
2011,Viet Nam,VNM,Canada,CAN,5,0,10,10,25
2011,Saint Kitts and Nevis,KNA,Canada,CAN,10,0,0,0,10
2011,Sudan,SDN,Canada,CAN,42,0,0,5,47
2011,Slovakia,SVK,Canada,CAN,5,0,58,163,226
2011,Slovenia,SVN,Canada,CAN,0,0,10,0,10
2011,Eswatini,SWZ,Canada,CAN,34,0,5,0,39
2011,Sweden,SWE,Canada,CAN,0,0,13,0,13
2011,Syrian Arab Rep.,SYR,Canada,CAN,83,0,56,14,153
2011,United Rep. of Tanzania,TZA,Canada,CAN,25,0,14,0,39
2011,Thailand,THA,Canada,CAN,5,0,54,21,80
2011,Tajikistan,TJK,Canada,CAN,5,0,5,0,10
2011,Togo,TGO,Canada,CAN,10,0,5,0,15
2011,Trinidad and Tobago,TTO,Canada,CAN,33,0,82,19,134
2011,Tunisia,TUN,Canada,CAN,18,0,23,5,46
2011,Turkey,TUR,Canada,CAN,189,0,104,48,341
2011,United Arab Emirates,ARE,Canada,CAN,14,0,0,5,19
2011,Uganda,UGA,Canada,CAN,67,0,18,0,85
2011,Ukraine,UKR,Canada,CAN,97,0,58,32,187
2011,Uruguay,URY,Canada,CAN,0,0,17,10,27
2011,United States of America,USA,Canada,CAN,5,0,561,103,669
2011,Uzbekistan,UZB,Canada,CAN,23,0,11,5,39
2011,Saint Vincent and the Grenadines,VCT,Canada,CAN,288,0,457,79,824
2011,Venezuela (Bolivarian Republic of),VEN,Canada,CAN,111,0,89,10,210
2011,Yemen,YEM,Canada,CAN,10,0,5,0,15
2011,Zambia,ZMB,Canada,CAN,5,0,5,0,10
2011,Zimbabwe,ZWE,Canada,CAN,224,0,57,13,294
2011,Unknown ,,Canada,CAN,0,0,25,42,67
2011,Burkina Faso,BFA,Central African Rep.,CAF,0,0,0,5,5
2011,Cameroon,CMR,Central African Rep.,CAF,0,0,0,5,5
2011,Congo,COG,Central African Rep.,CAF,0,0,0,23,23
2011,Cote d'Ivoire,CIV,Central African Rep.,CAF,0,0,0,5,5
2011,Liberia,LBR,Central African Rep.,CAF,0,0,0,5,5
2011,Nigeria,NGA,Central African Rep.,CAF,0,0,0,5,5
2011,Rwanda,RWA,Central African Rep.,CAF,0,0,0,5,5
2011,Zambia,ZMB,Central African Rep.,CAF,0,0,0,5,5
2011,Colombia,COL,Chile,CHL,5,52,137,0,194
2011,Costa Rica,CRI,Chile,CHL,0,5,0,0,5
2011,Cuba,CUB,Chile,CHL,0,0,5,0,5
2011,Ecuador,ECU,Chile,CHL,0,5,0,0,5
2011,El Salvador,SLV,Chile,CHL,0,5,0,0,5
2011,Cuba,CUB,Colombia,COL,0,0,30,47,77
2011,Eritrea,ERI,Colombia,COL,0,0,5,5,10
2011,Sri Lanka,LKA,Colombia,COL,0,0,5,0,5
2011,Peru,PER,Colombia,COL,0,0,5,0,5
2011,Russian Federation,RUS,Colombia,COL,5,0,0,0,5
2011,Somalia,SOM,Colombia,COL,0,0,0,24,24
2011,Venezuela (Bolivarian Republic of),VEN,Colombia,COL,0,0,5,0,5
2011,Dem. Rep. of the Congo,COD,Costa Rica,CRI,0,0,5,0,5
2011,Colombia,COL,Costa Rica,CRI,100,0,222,200,522
2011,Cuba,CUB,Costa Rica,CRI,58,0,70,25,153
2011,Guatemala,GTM,Costa Rica,CRI,5,0,17,0,22
2011,Honduras,HND,Costa Rica,CRI,31,0,5,15,51
2011,Nicaragua,NIC,Costa Rica,CRI,0,0,5,5,10
2011,Nigeria,NGA,Costa Rica,CRI,5,0,10,5,20
2011,Peru,PER,Costa Rica,CRI,0,0,0,5,5
2011,El Salvador,SLV,Costa Rica,CRI,10,0,15,5,30
2011,Somalia,SOM,Costa Rica,CRI,5,0,5,5,15
2011,United States of America,USA,Costa Rica,CRI,0,0,5,0,5
2011,Venezuela (Bolivarian Republic of),VEN,Costa Rica,CRI,5,0,24,0,29
2011,Afghanistan,AFG,Cyprus,CYP,0,0,28,0,28
2011,Albania,ALB,Cyprus,CYP,0,0,5,0,5
2011,Algeria,DZA,Cyprus,CYP,0,0,5,5,10
2011,Egypt,EGY,Cyprus,CYP,0,0,149,10,159
2011,Armenia,ARM,Cyprus,CYP,0,0,15,0,15
2011,Benin,BEN,Cyprus,CYP,0,0,5,0,5
2011,Bangladesh,BGD,Cyprus,CYP,0,0,192,5,197
2011,Bosnia and Herzegovina,BIH,Cyprus,CYP,0,0,5,0,5
2011,China,CHN,Cyprus,CYP,0,0,48,0,48
2011,Cameroon,CMR,Cyprus,CYP,0,0,64,0,64
2011,Dem. Rep. of the Congo,COD,Cyprus,CYP,0,0,5,0,5
2011,Ethiopia,ETH,Cyprus,CYP,0,0,18,0,18
2011,Palestinian,PSE,Cyprus,CYP,15,0,242,50,307
2011,Georgia,GEO,Cyprus,CYP,0,0,23,0,23
2011,Ghana,GHA,Cyprus,CYP,0,0,22,0,22
2011,Guinea,GIN,Cyprus,CYP,0,0,36,0,36
2011,Cote d'Ivoire,CIV,Cyprus,CYP,0,0,5,0,5
2011,India,IND,Cyprus,CYP,0,0,183,10,193
2011,Iran (Islamic Rep. of),IRN,Cyprus,CYP,0,5,185,18,208
2011,Iraq,IRQ,Cyprus,CYP,17,0,210,44,271
2011,Jordan,JOR,Cyprus,CYP,0,0,28,27,55
2011,Kenya,KEN,Cyprus,CYP,0,0,5,0,5
2011,Lebanon,LBN,Cyprus,CYP,0,0,23,0,23
2011,Sri Lanka,LKA,Cyprus,CYP,0,0,193,0,193
2011,Rep. of Moldova,MDA,Cyprus,CYP,0,0,5,5,10
2011,Mali,MLI,Cyprus,CYP,0,0,5,0,5
2011,Mongolia,MNG,Cyprus,CYP,0,0,10,5,15
2011,Morocco,MAR,Cyprus,CYP,0,0,10,0,10
2011,Nepal,NPL,Cyprus,CYP,0,0,125,5,130
2011,Nigeria,NGA,Cyprus,CYP,0,0,91,5,96
2011,Pakistan,PAK,Cyprus,CYP,0,0,149,11,160
2011,Philippines,PHL,Cyprus,CYP,0,5,97,5,107
2011,Russian Federation,RUS,Cyprus,CYP,0,0,13,5,18
2011,Serbia and Kosovo: S/RES/1244 (1999),SRB,Cyprus,CYP,0,0,5,0,5
2011,Sierra Leone,SLE,Cyprus,CYP,0,0,5,0,5
2011,Viet Nam,VNM,Cyprus,CYP,0,0,217,5,222
2011,Syrian Arab Rep.,SYR,Cyprus,CYP,0,0,56,15,71
2011,Togo,TGO,Cyprus,CYP,0,0,5,0,5
2011,Tunisia,TUN,Cyprus,CYP,0,0,5,0,5
2011,Turkey,TUR,Cyprus,CYP,14,0,48,0,62
2011,Ukraine,UKR,Cyprus,CYP,0,0,5,0,5
2011,Uzbekistan,UZB,Cyprus,CYP,0,0,5,0,5
2011,Zimbabwe,ZWE,Cyprus,CYP,0,0,5,0,5
2011,Afghanistan,AFG,Czechia,CZE,10,5,0,0,15
2011,Belarus,BLR,Czechia,CZE,12,30,0,0,42
2011,Dem. Rep. of the Congo,COD,Czechia,CZE,0,5,0,0,5
2011,Cuba,CUB,Czechia,CZE,0,11,0,0,11
2011,Cote d'Ivoire,CIV,Czechia,CZE,0,5,0,0,5
2011,Iraq,IRQ,Czechia,CZE,5,5,0,0,10
2011,Kazakhstan,KAZ,Czechia,CZE,5,110,0,0,115
2011,Kyrgyzstan,KGZ,Czechia,CZE,5,0,0,0,5
2011,Myanmar,MMR,Czechia,CZE,23,0,0,0,23
2011,Russian Federation,RUS,Czechia,CZE,18,10,0,0,28
2011,Somalia,SOM,Czechia,CZE,0,5,0,0,5
2011,Syrian Arab Rep.,SYR,Czechia,CZE,0,10,0,0,10
2011,Togo,TGO,Czechia,CZE,0,5,0,0,5
2011,Ukraine,UKR,Czechia,CZE,10,5,0,0,15
2011,Uzbekistan,UZB,Czechia,CZE,15,5,0,0,20
2011,Stateless,XXA,Czechia,CZE,5,53,0,0,58
2011,Afghanistan,AFG,Denmark,DNK,16,281,846,0,1143
2011,Algeria,DZA,Denmark,DNK,0,0,5,0,5
2011,Armenia,ARM,Denmark,DNK,5,0,14,0,19
2011,Azerbaijan,AZE,Denmark,DNK,0,0,18,0,18
2011,Bangladesh,BGD,Denmark,DNK,0,0,37,0,37
2011,Bosnia and Herzegovina,BIH,Denmark,DNK,0,0,5,0,5
2011,China,CHN,Denmark,DNK,0,0,10,0,10
2011,Cameroon,CMR,Denmark,DNK,0,0,10,0,10
2011,Dem. Rep. of the Congo,COD,Denmark,DNK,5,0,13,0,18
2011,Eritrea,ERI,Denmark,DNK,5,5,10,0,20
2011,Gambia,GMB,Denmark,DNK,0,0,5,0,5
2011,Palestinian,PSE,Denmark,DNK,5,0,14,0,19
2011,Ghana,GHA,Denmark,DNK,0,0,5,0,5
2011,Cote d'Ivoire,CIV,Denmark,DNK,0,0,5,0,5
2011,India,IND,Denmark,DNK,0,0,12,0,12
2011,Iran (Islamic Rep. of),IRN,Denmark,DNK,225,24,270,0,519
2011,Iraq,IRQ,Denmark,DNK,0,10,74,0,84
2011,Jordan,JOR,Denmark,DNK,0,0,14,0,14
2011,Kenya,KEN,Denmark,DNK,0,0,5,0,5
2011,Kyrgyzstan,KGZ,Denmark,DNK,0,0,5,0,5
2011,Dem. People's Rep. of Korea,PRK,Denmark,DNK,5,0,0,0,5
2011,Sri Lanka,LKA,Denmark,DNK,5,0,17,0,22
2011,Morocco,MAR,Denmark,DNK,0,0,5,0,5
2011,Myanmar,MMR,Denmark,DNK,5,0,15,0,20
2011,Nepal,NPL,Denmark,DNK,0,0,5,0,5
2011,Nigeria,NGA,Denmark,DNK,0,0,18,0,18
2011,Pakistan,PAK,Denmark,DNK,0,0,20,0,20
2011,Russian Federation,RUS,Denmark,DNK,55,42,116,0,213
2011,Rwanda,RWA,Denmark,DNK,0,0,5,0,5
2011,Serbia and Kosovo: S/RES/1244 (1999),SRB,Denmark,DNK,0,0,5,0,5
2011,Sierra Leone,SLE,Denmark,DNK,0,0,5,0,5
2011,Somalia,SOM,Denmark,DNK,0,5,20,0,25
2011,Viet Nam,VNM,Denmark,DNK,0,0,5,0,5
2011,Sudan,SDN,Denmark,DNK,10,0,11,0,21
2011,Syrian Arab Rep.,SYR,Denmark,DNK,343,10,195,0,548
2011,Turkey,TUR,Denmark,DNK,0,0,10,0,10
2011,Uganda,UGA,Denmark,DNK,0,0,20,0,20
2011,Ukraine,UKR,Denmark,DNK,0,0,5,0,5
2011,Uzbekistan,UZB,Denmark,DNK,0,0,5,0,5
2011,Stateless,XXA,Denmark,DNK,57,0,36,0,93
2011,Haiti,HTI,Dominican Rep.,DOM,0,0,0,5,5
2011,Afghanistan,AFG,Estonia,EST,0,0,5,0,5
2011,Armenia,ARM,Estonia,EST,0,0,5,0,5
2011,Cameroon,CMR,Estonia,EST,0,0,5,0,5
2011,Dem. Rep. of the Congo,COD,Estonia,EST,0,0,11,0,11
2011,Georgia,GEO,Estonia,EST,0,0,5,0,5
2011,Libya,LBY,Estonia,EST,0,0,5,0,5
2011,Russian Federation,RUS,Estonia,EST,0,0,5,5,10
2011,Uzbekistan,UZB,Estonia,EST,0,0,5,0,5
2011,Afghanistan,AFG,Finland,FIN,10,169,118,81,378
2011,Algeria,DZA,Finland,FIN,0,5,0,55,60
2011,Angola,AGO,Finland,FIN,5,28,0,0,33
2011,Egypt,EGY,Finland,FIN,0,0,5,5,10
2011,Armenia,ARM,Finland,FIN,0,0,0,5,5
2011,Azerbaijan,AZE,Finland,FIN,0,0,5,10,15
2011,Burundi,BDI,Finland,FIN,0,0,0,5,5
2011,Bangladesh,BGD,Finland,FIN,0,5,5,11,21
2011,Belarus,BLR,Finland,FIN,0,0,5,65,70
2011,Bosnia and Herzegovina,BIH,Finland,FIN,0,0,0,5,5
2011,Bulgaria,BGR,Finland,FIN,0,0,0,46,46
2011,China,CHN,Finland,FIN,5,5,0,5,15
2011,Chile,CHL,Finland,FIN,0,0,0,5,5
2011,Cameroon,CMR,Finland,FIN,0,5,10,5,20
2011,Dem. Rep. of the Congo,COD,Finland,FIN,5,16,12,0,33
2011,Cuba,CUB,Finland,FIN,0,0,0,5,5
2011,Eritrea,ERI,Finland,FIN,0,5,0,0,5
2011,Ethiopia,ETH,Finland,FIN,0,5,5,0,10
2011,Gambia,GMB,Finland,FIN,0,5,5,19,29
2011,Georgia,GEO,Finland,FIN,0,0,5,50,55
2011,Ghana,GHA,Finland,FIN,0,12,20,32,64
2011,Guatemala,GTM,Finland,FIN,0,0,5,0,5
2011,Guinea,GIN,Finland,FIN,0,5,5,10,20
2011,India,IND,Finland,FIN,0,0,0,10,10
2011,Iran (Islamic Rep. of),IRN,Finland,FIN,23,32,32,32,119
2011,Iraq,IRQ,Finland,FIN,40,356,58,283,737
2011,Kazakhstan,KAZ,Finland,FIN,0,5,0,10,15
2011,Kenya,KEN,Finland,FIN,0,0,5,0,5
2011,Kyrgyzstan,KGZ,Finland,FIN,0,0,0,5,5
2011,Libya,LBY,Finland,FIN,0,0,0,23,23
2011,Lebanon,LBN,Finland,FIN,0,0,0,5,5
2011,Sri Lanka,LKA,Finland,FIN,0,11,29,14,54
2011,North Macedonia,MKD,Finland,FIN,0,0,0,25,25
2011,Morocco,MAR,Finland,FIN,0,5,0,18,23
2011,Myanmar,MMR,Finland,FIN,0,0,0,5,5
2011,Niger,NER,Finland,FIN,0,0,0,5,5
2011,Nigeria,NGA,Finland,FIN,0,17,31,79,127
2011,Pakistan,PAK,Finland,FIN,5,5,5,19,34
2011,Romania,ROU,Finland,FIN,0,0,0,5,5
2011,Russian Federation,RUS,Finland,FIN,60,58,104,151,373
2011,Rwanda,RWA,Finland,FIN,0,0,0,5,5
2011,Serbia and Kosovo: S/RES/1244 (1999),SRB,Finland,FIN,0,11,42,149,202
2011,Sierra Leone,SLE,Finland,FIN,0,5,0,0,5
2011,Somalia,SOM,Finland,FIN,5,264,46,200,515
2011,Sudan,SDN,Finland,FIN,0,0,0,5,5
2011,Syrian Arab Rep.,SYR,Finland,FIN,5,27,5,10,47
2011,United Rep. of Tanzania,TZA,Finland,FIN,0,0,5,0,5
2011,Togo,TGO,Finland,FIN,0,0,5,5,10
2011,Tunisia,TUN,Finland,FIN,0,0,0,15,15
2011,Turkey,TUR,Finland,FIN,0,13,19,54,86
2011,Ukraine,UKR,Finland,FIN,0,0,0,10,10
2011,Uzbekistan,UZB,Finland,FIN,0,0,5,0,5
2011,Yemen,YEM,Finland,FIN,5,0,0,0,5
2011,Stateless,XXA,Finland,FIN,0,11,5,24,40
2011,Unknown ,,Finland,FIN,0,5,16,22,43
2011,Afghanistan,AFG,France,FRA,101,86,304,0,491
2011,Albania,ALB,France,FRA,10,29,424,0,463
2011,Algeria,DZA,France,FRA,31,11,1051,0,1093
2011,Angola,AGO,France,FRA,27,0,385,0,412
2011,Egypt,EGY,France,FRA,5,5,90,0,100
2011,Armenia,ARM,France,FRA,51,10,1765,0,1826
2011,Azerbaijan,AZE,France,FRA,89,0,414,0,503
2011,Burundi,BDI,France,FRA,10,0,5,0,15
2011,Benin,BEN,France,FRA,0,0,13,0,13
2011,Bangladesh,BGD,France,FRA,42,5,3722,0,3769
2011,Bhutan,BTN,France,FRA,0,0,12,0,12
2011,Burkina Faso,BFA,France,FRA,5,0,22,0,27
2011,Belarus,BLR,France,FRA,10,0,65,0,75
2011,Bolivia (Plurinational State of),BOL,France,FRA,0,0,14,0,14
2011,Bosnia and Herzegovina,BIH,France,FRA,13,0,95,0,108
2011,Bulgaria,BGR,France,FRA,0,0,5,0,5
2011,Cambodia,KHM,France,FRA,5,0,20,0,25
2011,Central African Rep.,CAF,France,FRA,11,5,50,0,66
2011,Chad,TCD,France,FRA,19,5,106,0,130
2011,China,CHN,France,FRA,156,0,2088,0,2244
2011,Cameroon,CMR,France,FRA,22,0,169,0,191
2011,Congo,COG,France,FRA,58,10,524,0,592
2011,Dem. Rep. of the Congo,COD,France,FRA,297,10,2327,0,2634
2011,Comoros,COM,France,FRA,49,5,998,0,1052
2011,Colombia,COL,France,FRA,10,0,94,0,104
2011,Cuba,CUB,France,FRA,5,0,5,0,10
2011,Cabo Verde,CPV,France,FRA,0,0,10,0,10
2011,Djibouti,DJI,France,FRA,5,0,5,0,10
2011,Dominican Rep.,DOM,France,FRA,0,0,184,0,184
2011,Equatorial Guinea,GNQ,France,FRA,0,0,5,0,5
2011,Eritrea,ERI,France,FRA,362,5,555,0,922
2011,Ethiopia,ETH,France,FRA,33,5,56,0,94
2011,Gabon,GAB,France,FRA,0,0,10,0,10
2011,Gambia,GMB,France,FRA,0,17,48,0,65
2011,Palestinian,PSE,France,FRA,16,0,40,0,56
2011,Georgia,GEO,France,FRA,33,0,646,0,679
2011,Ghana,GHA,France,FRA,0,0,14,0,14
2011,Guinea-Bissau,GNB,France,FRA,10,5,170,0,185
2011,Guinea,GIN,France,FRA,115,187,1243,0,1545
2011,Guyana,GUY,France,FRA,0,0,86,0,86
2011,Haiti,HTI,France,FRA,78,39,1729,0,1846
2011,Cote d'Ivoire,CIV,France,FRA,38,70,711,0,819
2011,India,IND,France,FRA,0,0,40,0,40
2011,Iran (Islamic Rep. of),IRN,France,FRA,121,0,60,0,181
2011,Iraq,IRQ,France,FRA,154,0,87,0,241
2011,Jamaica,JAM,France,FRA,0,0,5,0,5
2011,Kazakhstan,KAZ,France,FRA,10,0,86,0,96
2011,Kenya,KEN,France,FRA,0,0,20,0,20
2011,Kyrgyzstan,KGZ,France,FRA,5,0,83,0,88
2011,Lao People's Dem. Rep.,LAO,France,FRA,0,0,16,0,16
2011,Liberia,LBR,France,FRA,0,0,26,0,26
2011,Libya,LBY,France,FRA,0,0,22,0,22
2011,Lebanon,LBN,France,FRA,0,0,15,0,15
2011,Sri Lanka,LKA,France,FRA,332,15,2811,0,3158
2011,Madagascar,MDG,France,FRA,10,0,139,0,149
2011,Mauritania,MRT,France,FRA,38,17,1225,0,1280
2011,North Macedonia,MKD,France,FRA,0,0,493,0,493
2011,Rep. of Moldova,MDA,France,FRA,0,0,206,0,206
2011,Mali,MLI,France,FRA,10,379,135,0,524
2011,Mongolia,MNG,France,FRA,10,0,182,0,192
2011,Morocco,MAR,France,FRA,14,0,76,0,90
2011,Montenegro,MNE,France,FRA,0,0,76,0,76
2011,Myanmar,MMR,France,FRA,0,0,67,0,67
2011,Nepal,NPL,France,FRA,0,0,71,0,71
2011,Niger,NER,France,FRA,0,0,11,0,11
2011,Nigeria,NGA,France,FRA,5,22,654,0,681
2011,Pakistan,PAK,France,FRA,16,0,860,0,876
2011,Peru,PER,France,FRA,5,0,100,0,105
2011,Russian Federation,RUS,France,FRA,329,14,2403,0,2746
2011,Rwanda,RWA,France,FRA,88,0,89,0,177
2011,Serbia and Kosovo: S/RES/1244 (1999),SRB,France,FRA,101,10,3650,0,3761
2011,Senegal,SEN,France,FRA,11,53,90,0,154
2011,Sierra Leone,SLE,France,FRA,5,5,101,0,111
2011,Somalia,SOM,France,FRA,49,204,396,0,649
2011,Viet Nam,VNM,France,FRA,0,5,21,0,26
2011,Sudan,SDN,France,FRA,115,0,759,0,874
2011,Syrian Arab Rep.,SYR,France,FRA,33,5,18,0,56
2011,Thailand,THA,France,FRA,0,0,101,0,101
2011,Tajikistan,TJK,France,FRA,0,0,5,0,5
2011,Togo,TGO,France,FRA,22,0,83,0,105
2011,Tunisia,TUN,France,FRA,5,0,142,0,147
2011,Turkey,TUR,France,FRA,77,0,1683,0,1760
2011,Uganda,UGA,France,FRA,5,0,14,0,19
2011,Ukraine,UKR,France,FRA,0,0,73,0,73
2011,Uzbekistan,UZB,France,FRA,0,0,25,0,25
2011,Venezuela (Bolivarian Republic of),VEN,France,FRA,0,0,5,0,5
2011,Western Sahara,ESH,France,FRA,5,0,5,0,10
2011,Yemen,YEM,France,FRA,0,0,5,0,5
2011,Stateless,XXA,France,FRA,55,0,112,0,167
2011,Unknown ,,France,FRA,24,5,603,0,632
2011,Cote d'Ivoire,CIV,Gambia,GMB,0,0,0,154,154
2011,Afghanistan,AFG,United Kingdom of Great Britain and Northern Ireland,GBR,171,280,978,446,1875
2011,Albania,ALB,United Kingdom of Great Britain and Northern Ireland,GBR,21,52,163,101,337
2011,Algeria,DZA,United Kingdom of Great Britain and Northern Ireland,GBR,12,20,193,139,364
2011,Angola,AGO,United Kingdom of Great Britain and Northern Ireland,GBR,11,5,27,0,43
2011,Egypt,EGY,United Kingdom of Great Britain and Northern Ireland,GBR,45,10,130,24,209
2011,Armenia,ARM,United Kingdom of Great Britain and Northern Ireland,GBR,0,0,14,0,14
2011,Australia,AUS,United Kingdom of Great Britain and Northern Ireland,GBR,0,0,5,0,5
2011,Azerbaijan,AZE,United Kingdom of Great Britain and Northern Ireland,GBR,5,0,14,0,19
2011,Bahrain,BHR,United Kingdom of Great Britain and Northern Ireland,GBR,61,0,34,14,109
2011,Burundi,BDI,United Kingdom of Great Britain and Northern Ireland,GBR,5,5,5,0,15
2011,Benin,BEN,United Kingdom of Great Britain and Northern Ireland,GBR,0,0,5,0,5
2011,Bangladesh,BGD,United Kingdom of Great Britain and Northern Ireland,GBR,10,30,431,122,593
2011,Bhutan,BTN,United Kingdom of Great Britain and Northern Ireland,GBR,19,5,5,0,29
2011,Belarus,BLR,United Kingdom of Great Britain and Northern Ireland,GBR,20,0,13,5,38
2011,Bolivia (Plurinational State of),BOL,United Kingdom of Great Britain and Northern Ireland,GBR,0,0,30,11,41
2011,Botswana,BWA,United Kingdom of Great Britain and Northern Ireland,GBR,0,0,13,0,13
2011,Brazil,BRA,United Kingdom of Great Britain and Northern Ireland,GBR,0,0,18,13,31
2011,Bosnia and Herzegovina,BIH,United Kingdom of Great Britain and Northern Ireland,GBR,0,0,0,5,5
2011,Bulgaria,BGR,United Kingdom of Great Britain and Northern Ireland,GBR,0,0,5,5,10
2011,Canada,CAN,United Kingdom of Great Britain and Northern Ireland,GBR,0,0,5,5,10
2011,Chad,TCD,United Kingdom of Great Britain and Northern Ireland,GBR,0,0,5,5,10
2011,China,CHN,United Kingdom of Great Britain and Northern Ireland,GBR,97,131,792,246,1266
2011,Cameroon,CMR,United Kingdom of Great Britain and Northern Ireland,GBR,22,11,52,10,95
2011,Congo,COG,United Kingdom of Great Britain and Northern Ireland,GBR,0,5,11,0,16
2011,Dem. Rep. of the Congo,COD,United Kingdom of Great Britain and Northern Ireland,GBR,43,28,114,22,207
2011,Colombia,COL,United Kingdom of Great Britain and Northern Ireland,GBR,0,5,19,10,34
2011,Cuba,CUB,United Kingdom of Great Britain and Northern Ireland,GBR,0,0,5,0,5
2011,Ecuador,ECU,United Kingdom of Great Britain and Northern Ireland,GBR,5,5,5,0,15
2011,Eritrea,ERI,United Kingdom of Great Britain and Northern Ireland,GBR,643,34,171,121,969
2011,Ethiopia,ETH,United Kingdom of Great Britain and Northern Ireland,GBR,36,5,67,12,120
2011,France,FRA,United Kingdom of Great Britain and Northern Ireland,GBR,0,0,0,5,5
2011,Gambia,GMB,United Kingdom of Great Britain and Northern Ireland,GBR,114,41,206,19,380
2011,Palestinian,PSE,United Kingdom of Great Britain and Northern Ireland,GBR,17,14,133,71,235
2011,Georgia,GEO,United Kingdom of Great Britain and Northern Ireland,GBR,5,0,39,11,55
2011,Ghana,GHA,United Kingdom of Great Britain and Northern Ireland,GBR,5,15,126,34,180
2011,Grenada,GRD,United Kingdom of Great Britain and Northern Ireland,GBR,0,0,5,0,5
2011,Guinea,GIN,United Kingdom of Great Britain and Northern Ireland,GBR,25,5,37,5,72
2011,Guyana,GUY,United Kingdom of Great Britain and Northern Ireland,GBR,0,0,5,0,5
2011,Honduras,HND,United Kingdom of Great Britain and Northern Ireland,GBR,0,0,11,0,11
2011,Cote d'Ivoire,CIV,United Kingdom of Great Britain and Northern Ireland,GBR,16,10,120,15,161
2011,India,IND,United Kingdom of Great Britain and Northern Ireland,GBR,0,18,372,243,633
2011,Indonesia,IDN,United Kingdom of Great Britain and Northern Ireland,GBR,0,0,5,5,10
2011,Iran (Islamic Rep. of),IRN,United Kingdom of Great Britain and Northern Ireland,GBR,1147,126,1330,215,2818
2011,Iraq,IRQ,United Kingdom of Great Britain and Northern Ireland,GBR,62,51,299,78,490
2011,Israel,ISR,United Kingdom of Great Britain and Northern Ireland,GBR,0,5,0,5,10
2011,Jamaica,JAM,United Kingdom of Great Britain and Northern Ireland,GBR,24,26,103,22,175
2011,Jordan,JOR,United Kingdom of Great Britain and Northern Ireland,GBR,0,0,18,0,18
2011,Japan,JPN,United Kingdom of Great Britain and Northern Ireland,GBR,0,0,5,0,5
2011,Kenya,KEN,United Kingdom of Great Britain and Northern Ireland,GBR,23,11,92,15,141
2011,Kyrgyzstan,KGZ,United Kingdom of Great Britain and Northern Ireland,GBR,0,0,5,0,5
2011,Rep. of Korea,KOR,United Kingdom of Great Britain and Northern Ireland,GBR,0,0,5,0,5
2011,Dem. People's Rep. of Korea,PRK,United Kingdom of Great Britain and Northern Ireland,GBR,10,5,46,10,71
2011,Kuwait,KWT,United Kingdom of Great Britain and Northern Ireland,GBR,34,0,29,16,79
2011,Liberia,LBR,United Kingdom of Great Britain and Northern Ireland,GBR,0,0,13,5,18
2011,Libya,LBY,United Kingdom of Great Britain and Northern Ireland,GBR,121,66,721,116,1024
2011,Saint Lucia,LCA,United Kingdom of Great Britain and Northern Ireland,GBR,0,0,5,0,5
2011,Lebanon,LBN,United Kingdom of Great Britain and Northern Ireland,GBR,0,0,46,0,46
2011,Sri Lanka,LKA,United Kingdom of Great Britain and Northern Ireland,GBR,349,39,1522,138,2048
2011,North Macedonia,MKD,United Kingdom of Great Britain and Northern Ireland,GBR,0,5,0,5,10
2011,Rep. of Moldova,MDA,United Kingdom of Great Britain and Northern Ireland,GBR,0,0,0,5,5
2011,Mexico,MEX,United Kingdom of Great Britain and Northern Ireland,GBR,0,0,10,0,10
2011,Mali,MLI,United Kingdom of Great Britain and Northern Ireland,GBR,0,0,5,0,5
2011,Malaysia,MYS,United Kingdom of Great Britain and Northern Ireland,GBR,10,0,50,11,71
2011,Malawi,MWI,United Kingdom of Great Britain and Northern Ireland,GBR,5,23,138,10,176
2011,Mongolia,MNG,United Kingdom of Great Britain and Northern Ireland,GBR,10,10,47,5,72
2011,Morocco,MAR,United Kingdom of Great Britain and Northern Ireland,GBR,5,17,41,26,89
2011,Mauritius,MUS,United Kingdom of Great Britain and Northern Ireland,GBR,0,0,52,5,57
2011,Myanmar,MMR,United Kingdom of Great Britain and Northern Ireland,GBR,98,0,81,0,179
2011,Namibia,NAM,United Kingdom of Great Britain and Northern Ireland,GBR,0,0,14,5,19
2011,Nepal,NPL,United Kingdom of Great Britain and Northern Ireland,GBR,0,0,36,5,41
2011,Nigeria,NGA,United Kingdom of Great Britain and Northern Ireland,GBR,30,106,815,141,1092
2011,Nauru,NRU,United Kingdom of Great Britain and Northern Ireland,GBR,0,0,5,0,5
2011,Oman,OMN,United Kingdom of Great Britain and Northern Ireland,GBR,0,0,5,0,5
2011,Pakistan,PAK,United Kingdom of Great Britain and Northern Ireland,GBR,385,70,2669,286,3410
2011,Philippines,PHL,United Kingdom of Great Britain and Northern Ireland,GBR,0,0,12,0,12
2011,Poland,POL,United Kingdom of Great Britain and Northern Ireland,GBR,0,0,5,0,5
2011,Romania,ROU,United Kingdom of Great Britain and Northern Ireland,GBR,0,0,0,5,5
2011,South Africa,ZAF,United Kingdom of Great Britain and Northern Ireland,GBR,5,12,98,10,125
2011,Russian Federation,RUS,United Kingdom of Great Britain and Northern Ireland,GBR,22,5,51,17,95
2011,Rwanda,RWA,United Kingdom of Great Britain and Northern Ireland,GBR,5,13,14,5,37
2011,Saudi Arabia,SAU,United Kingdom of Great Britain and Northern Ireland,GBR,10,0,5,0,15
2011,Serbia and Kosovo: S/RES/1244 (1999),SRB,United Kingdom of Great Britain and Northern Ireland,GBR,5,10,10,32,57
2011,Senegal,SEN,United Kingdom of Great Britain and Northern Ireland,GBR,10,0,34,0,44
2011,Sierra Leone,SLE,United Kingdom of Great Britain and Northern Ireland,GBR,22,10,60,12,104
2011,Somalia,SOM,United Kingdom of Great Britain and Northern Ireland,GBR,410,60,164,82,716
2011,Viet Nam,VNM,United Kingdom of Great Britain and Northern Ireland,GBR,11,48,89,183,331
2011,Sudan,SDN,United Kingdom of Great Britain and Northern Ireland,GBR,543,0,109,108,760
2011,Slovakia,SVK,United Kingdom of Great Britain and Northern Ireland,GBR,0,0,0,5,5
2011,Eswatini,SWZ,United Kingdom of Great Britain and Northern Ireland,GBR,0,0,5,0,5
2011,Syrian Arab Rep.,SYR,United Kingdom of Great Britain and Northern Ireland,GBR,141,5,192,21,359
2011,United Rep. of Tanzania,TZA,United Kingdom of Great Britain and Northern Ireland,GBR,0,10,36,5,51
2011,Thailand,THA,United Kingdom of Great Britain and Northern Ireland,GBR,0,0,5,5,10
2011,Tajikistan,TJK,United Kingdom of Great Britain and Northern Ireland,GBR,0,0,5,0,5
2011,Trinidad and Tobago,TTO,United Kingdom of Great Britain and Northern Ireland,GBR,5,0,10,0,15
2011,Tunisia,TUN,United Kingdom of Great Britain and Northern Ireland,GBR,0,0,23,12,35
2011,Turkey,TUR,United Kingdom of Great Britain and Northern Ireland,GBR,28,15,126,26,195
2011,United Arab Emirates,ARE,United Kingdom of Great Britain and Northern Ireland,GBR,0,5,0,0,5
2011,Uganda,UGA,United Kingdom of Great Britain and Northern Ireland,GBR,91,13,165,24,293
2011,Ukraine,UKR,United Kingdom of Great Britain and Northern Ireland,GBR,0,0,31,10,41
2011,United States of America,USA,United Kingdom of Great Britain and Northern Ireland,GBR,0,0,16,17,33
2011,Uzbekistan,UZB,United Kingdom of Great Britain and Northern Ireland,GBR,12,0,10,0,22
2011,Saint Vincent and the Grenadines,VCT,United Kingdom of Great Britain and Northern Ireland,GBR,0,0,5,0,5
2011,Venezuela (Bolivarian Republic of),VEN,United Kingdom of Great Britain and Northern Ireland,GBR,5,0,16,0,21
2011,Western Sahara,ESH,United Kingdom of Great Britain and Northern Ireland,GBR,0,0,5,0,5
2011,Yemen,YEM,United Kingdom of Great Britain and Northern Ireland,GBR,10,14,33,5,62
2011,Zambia,ZMB,United Kingdom of Great Britain and Northern Ireland,GBR,5,5,13,0,23
2011,Zimbabwe,ZWE,United Kingdom of Great Britain and Northern Ireland,GBR,112,141,571,32,856
2011,Stateless,XXA,United Kingdom of Great Britain and Northern Ireland,GBR,68,5,81,30,184
2011,Unknown ,,United Kingdom of Great Britain and Northern Ireland,GBR,233,5,47,21,306
2011,Burundi,BDI,Guinea-Bissau,GNB,0,0,0,5,5
2011,Cote d'Ivoire,CIV,Guinea-Bissau,GNB,13,0,0,33,46
2011,Liberia,LBR,Guinea-Bissau,GNB,0,0,0,57,57
2011,Nigeria,NGA,Guinea-Bissau,GNB,0,0,5,5,10
2011,Senegal,SEN,Guinea-Bissau,GNB,0,0,0,164,164
2011,Sudan,SDN,Guinea-Bissau,GNB,0,0,0,5,5
2011,Afghanistan,AFG,Greece,GRC,12,23,285,93,413
2011,Albania,ALB,Greece,GRC,0,0,420,53,473
2011,Algeria,DZA,Greece,GRC,0,0,125,12,137
2011,Egypt,EGY,Greece,GRC,0,0,206,37,243
2011,Armenia,ARM,Greece,GRC,0,0,54,35,89
2011,Burundi,BDI,Greece,GRC,0,0,5,0,5
2011,Bangladesh,BGD,Greece,GRC,0,5,1048,80,1133
2011,Burkina Faso,BFA,Greece,GRC,0,0,19,5,24
2011,Belarus,BLR,Greece,GRC,0,0,10,0,10
2011,Central African Rep.,CAF,Greece,GRC,0,0,16,0,16
2011,China,CHN,Greece,GRC,0,0,355,45,400
2011,Cameroon,CMR,Greece,GRC,0,0,0,5,5
2011,Dem. Rep. of the Congo,COD,Greece,GRC,0,0,5,0,5
2011,Cuba,CUB,Greece,GRC,0,0,5,5,10
2011,Dominica,DMA,Greece,GRC,0,0,20,0,20
2011,Dominican Rep.,DOM,Greece,GRC,0,0,69,16,85
2011,Eritrea,ERI,Greece,GRC,0,0,12,0,12
2011,Ethiopia,ETH,Greece,GRC,0,0,22,23,45
2011,Gambia,GMB,Greece,GRC,0,0,20,0,20
2011,Palestinian,PSE,Greece,GRC,0,0,20,10,30
2011,Georgia,GEO,Greece,GRC,0,10,1281,416,1707
2011,Ghana,GHA,Greece,GRC,0,0,119,10,129
2011,Guinea,GIN,Greece,GRC,0,10,25,5,40
2011,Cote d'Ivoire,CIV,Greece,GRC,0,0,11,0,11
2011,India,IND,Greece,GRC,0,0,148,37,185
2011,Indonesia,IDN,Greece,GRC,0,0,5,0,5
2011,Iran (Islamic Rep. of),IRN,Greece,GRC,5,5,102,24,136
2011,Iraq,IRQ,Greece,GRC,10,5,218,87,320
2011,Kazakhstan,KAZ,Greece,GRC,0,0,5,0,5
2011,Kenya,KEN,Greece,GRC,0,0,12,10,22
2011,Liberia,LBR,Greece,GRC,0,0,10,0,10
2011,Libya,LBY,Greece,GRC,0,0,5,0,5
2011,Lebanon,LBN,Greece,GRC,0,0,5,5,10
2011,Sri Lanka,LKA,Greece,GRC,0,0,23,0,23
2011,Mauritania,MRT,Greece,GRC,0,0,5,0,5
2011,Rep. of Moldova,MDA,Greece,GRC,0,0,24,20,44
2011,Mali,MLI,Greece,GRC,0,0,5,0,5
2011,Morocco,MAR,Greece,GRC,0,0,84,25,109
2011,Myanmar,MMR,Greece,GRC,0,0,10,0,10
2011,Niger,NER,Greece,GRC,0,0,53,0,53
2011,Nigeria,NGA,Greece,GRC,0,0,329,148,477
2011,Pakistan,PAK,Greece,GRC,0,5,2627,403,3035
2011,Philippines,PHL,Greece,GRC,0,0,15,0,15
2011,Russian Federation,RUS,Greece,GRC,0,0,78,31,109
2011,Rwanda,RWA,Greece,GRC,0,0,17,0,17
2011,Serbia and Kosovo: S/RES/1244 (1999),SRB,Greece,GRC,0,0,5,0,5
2011,Senegal,SEN,Greece,GRC,0,0,123,41,164
2011,Sierra Leone,SLE,Greece,GRC,0,0,20,5,25
2011,Somalia,SOM,Greece,GRC,0,5,41,5,51
2011,Sudan,SDN,Greece,GRC,0,5,28,0,33
2011,Syrian Arab Rep.,SYR,Greece,GRC,5,0,146,42,193
2011,United Rep. of Tanzania,TZA,Greece,GRC,0,0,10,0,10
2011,Turkmenistan,TKM,Greece,GRC,0,0,0,5,5
2011,Timor-Leste,TLS,Greece,GRC,0,0,5,0,5
2011,Tunisia,TUN,Greece,GRC,0,0,29,0,29
2011,Turkey,TUR,Greece,GRC,0,5,5,12,22
2011,Uganda,UGA,Greece,GRC,0,5,0,5,10
2011,Ukraine,UKR,Greece,GRC,0,0,41,14,55
2011,Uzbekistan,UZB,Greece,GRC,0,5,5,0,10
2011,Unknown ,,Greece,GRC,0,0,98,5,103
2011,Cuba,CUB,Guatemala,GTM,0,0,0,5,5
2011,El Salvador,SLV,Guatemala,GTM,5,0,0,0,5
2011,Afghanistan,AFG,Croatia,HRV,0,0,12,355,367
2011,Algeria,DZA,Croatia,HRV,0,0,0,5,5
2011,Belgium,BEL,Croatia,HRV,0,0,5,0,5
2011,Bosnia and Herzegovina,BIH,Croatia,HRV,0,0,5,0,5
2011,Eritrea,ERI,Croatia,HRV,0,0,0,5,5
2011,Palestinian,PSE,Croatia,HRV,0,0,5,29,34
2011,Iran (Islamic Rep. of),IRN,Croatia,HRV,0,0,5,32,37
2011,Iraq,IRQ,Croatia,HRV,0,0,0,13,13
2011,Libya,LBY,Croatia,HRV,0,0,0,12,12
2011,Morocco,MAR,Croatia,HRV,0,0,5,5,10
2011,Pakistan,PAK,Croatia,HRV,0,0,5,65,70
2011,Russian Federation,RUS,Croatia,HRV,0,0,5,0,5
2011,Senegal,SEN,Croatia,HRV,0,0,5,0,5
2011,Somalia,SOM,Croatia,HRV,0,0,0,15,15
2011,Sudan,SDN,Croatia,HRV,0,0,0,5,5
2011,Syrian Arab Rep.,SYR,Croatia,HRV,0,0,5,5,10
2011,Tunisia,TUN,Croatia,HRV,0,0,5,10,15
2011,Turkey,TUR,Croatia,HRV,0,0,0,5,5
2011,Western Sahara,ESH,Croatia,HRV,0,0,0,5,5
2011,Stateless,XXA,Croatia,HRV,0,0,5,5,10
2011,Afghanistan,AFG,Hungary,HUN,10,78,301,229,618
2011,Algeria,DZA,Hungary,HUN,0,0,18,14,32
2011,Egypt,EGY,Hungary,HUN,0,0,5,10,15
2011,Armenia,ARM,Hungary,HUN,0,0,11,0,11
2011,China,CHN,Hungary,HUN,0,0,5,5,10
2011,Cameroon,CMR,Hungary,HUN,5,0,0,0,5
2011,Dem. Rep. of the Congo,COD,Hungary,HUN,0,0,10,5,15
2011,Palestinian,PSE,Hungary,HUN,0,0,16,12,28
2011,Georgia,GEO,Hungary,HUN,0,0,10,12,22
2011,Guinea,GIN,Hungary,HUN,0,0,5,0,5
2011,India,IND,Hungary,HUN,0,0,5,0,5
2011,Iran (Islamic Rep. of),IRN,Hungary,HUN,5,0,10,19,34
2011,Iraq,IRQ,Hungary,HUN,0,5,19,23,47
2011,Libya,LBY,Hungary,HUN,0,5,5,5,15
2011,Lebanon,LBN,Hungary,HUN,0,0,10,5,15
2011,Sri Lanka,LKA,Hungary,HUN,5,0,0,0,5
2011,Rep. of Moldova,MDA,Hungary,HUN,0,0,5,5,10
2011,Mongolia,MNG,Hungary,HUN,0,0,5,0,5
2011,Morocco,MAR,Hungary,HUN,0,0,0,16,16
2011,Nigeria,NGA,Hungary,HUN,0,0,13,10,23
2011,Pakistan,PAK,Hungary,HUN,0,0,39,22,61
2011,Russian Federation,RUS,Hungary,HUN,0,0,5,5,10
2011,Serbia and Kosovo: S/RES/1244 (1999),SRB,Hungary,HUN,0,0,133,97,230
2011,Sierra Leone,SLE,Hungary,HUN,0,0,5,0,5
2011,Somalia,SOM,Hungary,HUN,0,0,11,5,16
2011,Viet Nam,VNM,Hungary,HUN,0,0,5,5,10
2011,Sudan,SDN,Hungary,HUN,5,0,0,0,5
2011,Syrian Arab Rep.,SYR,Hungary,HUN,0,5,17,50,72
2011,Tunisia,TUN,Hungary,HUN,0,0,15,10,25
2011,Turkey,TUR,Hungary,HUN,0,0,19,19,38
2011,Ukraine,UKR,Hungary,HUN,0,0,5,5,10
2011,Zimbabwe,ZWE,Hungary,HUN,0,0,5,0,5
2011,Unknown ,,Hungary,HUN,13,5,5,5,28
2011,Ethiopia,ETH,Iceland,ISL,0,0,0,5,5
2011,India,IND,Iceland,ISL,0,0,0,5,5
2011,Iraq,IRQ,Iceland,ISL,0,0,0,5,5
2011,North Macedonia,MKD,Iceland,ISL,0,0,5,0,5
2011,Russian Federation,RUS,Iceland,ISL,0,0,0,5,5
2011,Somalia,SOM,Iceland,ISL,0,5,0,0,5
2011,Afghanistan,AFG,Ireland,IRL,5,0,48,20,73
2011,Albania,ALB,Ireland,IRL,0,0,34,0,34
2011,Algeria,DZA,Ireland,IRL,0,0,48,5,53
2011,Angola,AGO,Ireland,IRL,0,0,5,0,5
2011,Egypt,EGY,Ireland,IRL,0,0,19,5,24
2011,Armenia,ARM,Ireland,IRL,0,0,12,0,12
2011,Bangladesh,BGD,Ireland,IRL,0,0,20,11,31
2011,Bolivia (Plurinational State of),BOL,Ireland,IRL,0,0,10,0,10
2011,Brazil,BRA,Ireland,IRL,0,0,5,0,5
2011,China,CHN,Ireland,IRL,0,0,179,10,189
2011,Chile,CHL,Ireland,IRL,0,0,5,0,5
2011,Cameroon,CMR,Ireland,IRL,0,0,36,0,36
2011,Congo,COG,Ireland,IRL,0,0,5,0,5
2011,Dem. Rep. of the Congo,COD,Ireland,IRL,0,0,76,18,94
2011,Eritrea,ERI,Ireland,IRL,0,0,5,5,10
2011,Ethiopia,ETH,Ireland,IRL,0,0,5,0,5
2011,Palestinian,PSE,Ireland,IRL,5,0,5,5,15
2011,Georgia,GEO,Ireland,IRL,0,0,24,0,24
2011,Ghana,GHA,Ireland,IRL,0,0,29,5,34
2011,Guinea,GIN,Ireland,IRL,0,0,5,0,5
2011,Cote d'Ivoire,CIV,Ireland,IRL,0,0,10,0,10
2011,India,IND,Ireland,IRL,0,0,10,5,15
2011,Iran (Islamic Rep. of),IRN,Ireland,IRL,10,0,24,5,39
2011,Iraq,IRQ,Ireland,IRL,0,0,16,13,29
2011,Kenya,KEN,Ireland,IRL,0,0,5,5,10
2011,Kyrgyzstan,KGZ,Ireland,IRL,5,0,0,5,10
2011,Liberia,LBR,Ireland,IRL,0,0,5,0,5
2011,Libya,LBY,Ireland,IRL,0,0,5,0,5
2011,Sri Lanka,LKA,Ireland,IRL,0,0,5,10,15
2011,Rep. of Moldova,MDA,Ireland,IRL,0,0,29,0,29
2011,Malawi,MWI,Ireland,IRL,0,0,22,0,22
2011,Mongolia,MNG,Ireland,IRL,0,0,10,0,10
2011,Morocco,MAR,Ireland,IRL,0,0,5,0,5
2011,Mauritius,MUS,Ireland,IRL,0,0,15,0,15
2011,Nepal,NPL,Ireland,IRL,0,0,5,0,5
2011,Niger,NER,Ireland,IRL,0,0,5,0,5
2011,Nigeria,NGA,Ireland,IRL,0,0,227,42,269
2011,Pakistan,PAK,Ireland,IRL,12,0,161,54,227
2011,South Africa,ZAF,Ireland,IRL,0,0,53,5,58
2011,Russian Federation,RUS,Ireland,IRL,5,0,16,0,21
2011,Rwanda,RWA,Ireland,IRL,0,0,10,0,10
2011,Serbia and Kosovo: S/RES/1244 (1999),SRB,Ireland,IRL,0,0,11,0,11
2011,Sierra Leone,SLE,Ireland,IRL,0,0,5,0,5
2011,Somalia,SOM,Ireland,IRL,5,0,19,10,34
2011,Sudan,SDN,Ireland,IRL,0,0,10,5,15
2011,Syrian Arab Rep.,SYR,Ireland,IRL,0,0,5,0,5
2011,Uganda,UGA,Ireland,IRL,0,0,15,0,15
2011,Ukraine,UKR,Ireland,IRL,0,0,5,0,5
2011,Yemen,YEM,Ireland,IRL,0,0,10,0,10
2011,Zimbabwe,ZWE,Ireland,IRL,0,0,69,5,74
2011,Stateless,XXA,Ireland,IRL,0,0,0,5,5
2011,Dem. Rep. of the Congo,COD,Israel,ISR,0,0,96,0,96
2011,Colombia,COL,Israel,ISR,0,0,29,0,29
2011,Eritrea,ERI,Israel,ISR,0,0,10,0,10
2011,Ethiopia,ETH,Israel,ISR,0,0,108,0,108
2011,Ghana,GHA,Israel,ISR,0,0,38,0,38
2011,Cote d'Ivoire,CIV,Israel,ISR,0,0,96,0,96
2011,Mongolia,MNG,Israel,ISR,0,0,5,0,5
2011,Myanmar,MMR,Israel,ISR,0,0,30,0,30
2011,Nigeria,NGA,Israel,ISR,0,0,61,0,61
2011,Sudan,SDN,Israel,ISR,0,0,5,0,5
2011,Unknown ,,Israel,ISR,0,0,3246,0,3246
2011,Afghanistan,AFG,Italy,ITA,165,544,370,0,1079
2011,Albania,ALB,Italy,ITA,0,5,23,0,28
2011,Algeria,DZA,Italy,ITA,5,0,95,0,100
2011,Angola,AGO,Italy,ITA,0,0,5,0,5
2011,Egypt,EGY,Italy,ITA,24,23,72,0,119
2011,Armenia,ARM,Italy,ITA,5,10,33,0,48
2011,Azerbaijan,AZE,Italy,ITA,13,5,5,0,23
2011,Benin,BEN,Italy,ITA,0,0,37,0,37
2011,Bangladesh,BGD,Italy,ITA,11,29,799,0,839
2011,Burkina Faso,BFA,Italy,ITA,5,19,421,0,445
2011,Brazil,BRA,Italy,ITA,0,0,10,0,10
2011,Bosnia and Herzegovina,BIH,Italy,ITA,0,0,510,0,510
2011,Central African Rep.,CAF,Italy,ITA,0,0,5,0,5
2011,Chad,TCD,Italy,ITA,13,23,94,0,130
2011,China,CHN,Italy,ITA,0,5,28,0,33
2011,Cameroon,CMR,Italy,ITA,13,12,85,0,110
2011,Congo,COG,Italy,ITA,24,10,62,0,96
2011,Dem. Rep. of the Congo,COD,Italy,ITA,21,14,40,0,75
2011,Colombia,COL,Italy,ITA,5,0,29,0,34
2011,Cuba,CUB,Italy,ITA,0,0,26,0,26
2011,Eritrea,ERI,Italy,ITA,257,117,64,0,438
2011,Ethiopia,ETH,Italy,ITA,81,26,80,0,187
2011,Gabon,GAB,Italy,ITA,0,0,5,0,5
2011,Gambia,GMB,Italy,ITA,5,10,154,0,169
2011,Palestinian,PSE,Italy,ITA,29,5,30,0,64
2011,Georgia,GEO,Italy,ITA,5,0,45,0,50
2011,Ghana,GHA,Italy,ITA,10,44,1449,0,1503
2011,Guinea-Bissau,GNB,Italy,ITA,0,0,69,0,69
2011,Guinea,GIN,Italy,ITA,33,22,246,0,301
2011,Haiti,HTI,Italy,ITA,10,0,0,0,10
2011,Honduras,HND,Italy,ITA,0,0,5,0,5
2011,Croatia,HRV,Italy,ITA,0,0,36,0,36
2011,Cote d'Ivoire,CIV,Italy,ITA,63,204,926,0,1193
2011,India,IND,Italy,ITA,0,5,22,0,27
2011,Iran (Islamic Rep. of),IRN,Italy,ITA,126,18,78,0,222
2011,Iraq,IRQ,Italy,ITA,42,129,113,0,284
2011,Kenya,KEN,Italy,ITA,5,0,22,0,27
2011,Kyrgyzstan,KGZ,Italy,ITA,0,0,5,0,5
2011,Liberia,LBR,Italy,ITA,0,0,71,0,71
2011,Libya,LBY,Italy,ITA,11,56,77,0,144
2011,Lebanon,LBN,Italy,ITA,0,5,10,0,15
2011,Sri Lanka,LKA,Italy,ITA,10,5,50,0,65
2011,Madagascar,MDG,Italy,ITA,0,0,5,0,5
2011,Mauritania,MRT,Italy,ITA,14,5,29,0,48
2011,North Macedonia,MKD,Italy,ITA,0,0,34,0,34
2011,Rep. of Moldova,MDA,Italy,ITA,0,5,10,0,15
2011,Mali,MLI,Italy,ITA,5,17,1233,0,1255
2011,Morocco,MAR,Italy,ITA,10,5,157,0,172
2011,Montenegro,MNE,Italy,ITA,0,0,21,0,21
2011,Nepal,NPL,Italy,ITA,0,0,5,0,5
2011,Niger,NER,Italy,ITA,0,10,181,0,191
2011,Nigeria,NGA,Italy,ITA,41,138,2958,0,3137
2011,Pakistan,PAK,Italy,ITA,89,311,1127,0,1527
2011,Russian Federation,RUS,Italy,ITA,10,5,15,0,30
2011,Rwanda,RWA,Italy,ITA,0,0,5,0,5
2011,El Salvador,SLV,Italy,ITA,0,5,10,0,15
2011,Serbia and Kosovo: S/RES/1244 (1999),SRB,Italy,ITA,10,34,264,0,308
2011,Senegal,SEN,Italy,ITA,35,28,321,0,384
2011,Sierra Leone,SLE,Italy,ITA,5,15,47,0,67
2011,Somalia,SOM,Italy,ITA,253,411,37,0,701
2011,Sudan,SDN,Italy,ITA,145,62,102,0,309
2011,Syrian Arab Rep.,SYR,Italy,ITA,31,20,57,0,108
2011,United Rep. of Tanzania,TZA,Italy,ITA,0,0,5,0,5
2011,Thailand,THA,Italy,ITA,0,0,5,0,5
2011,Togo,TGO,Italy,ITA,5,13,156,0,174
2011,Tunisia,TUN,Italy,ITA,11,38,3258,0,3307
2011,Turkey,TUR,Italy,ITA,120,39,555,0,714
2011,Uganda,UGA,Italy,ITA,0,0,5,0,5
2011,Ukraine,UKR,Italy,ITA,0,0,19,0,19
2011,Venezuela (Bolivarian Republic of),VEN,Italy,ITA,0,0,5,0,5
2011,Yemen,YEM,Italy,ITA,10,0,0,0,10
2011,Unknown ,,Italy,ITA,0,10,39,0,49
2011,Angola,AGO,Japan,JPN,0,0,10,0,10
2011,Bangladesh,BGD,Japan,JPN,0,0,69,0,69
2011,China,CHN,Japan,JPN,0,5,27,0,32
2011,Cameroon,CMR,Japan,JPN,0,5,32,0,37
2011,Congo,COG,Japan,JPN,0,0,10,0,10
2011,Dem. Rep. of the Congo,COD,Japan,JPN,0,5,15,0,20
2011,Ethiopia,ETH,Japan,JPN,0,0,34,0,34
2011,Palestinian,PSE,Japan,JPN,0,5,14,0,19
2011,Ghana,GHA,Japan,JPN,0,0,15,0,15
2011,Guinea,GIN,Japan,JPN,0,0,5,0,5
2011,Cote d'Ivoire,CIV,Japan,JPN,0,0,5,0,5
2011,India,IND,Japan,JPN,0,0,90,5,95
2011,Indonesia,IDN,Japan,JPN,0,0,5,0,5
2011,Iran (Islamic Rep. of),IRN,Japan,JPN,0,0,43,0,43
2011,Iraq,IRQ,Japan,JPN,0,0,0,5,5
2011,Liberia,LBR,Japan,JPN,0,0,5,0,5
2011,Sri Lanka,LKA,Japan,JPN,0,10,278,12,300
2011,Malaysia,MYS,Japan,JPN,0,0,5,0,5
2011,Myanmar,MMR,Japan,JPN,5,136,583,15,739
2011,Nepal,NPL,Japan,JPN,0,0,208,16,224
2011,Nigeria,NGA,Japan,JPN,0,0,51,5,56
2011,Pakistan,PAK,Japan,JPN,0,0,154,10,164
2011,Peru,PER,Japan,JPN,0,0,5,0,5
2011,Philippines,PHL,Japan,JPN,0,0,18,0,18
2011,Senegal,SEN,Japan,JPN,0,0,5,0,5
2011,Viet Nam,VNM,Japan,JPN,0,0,5,0,5
2011,Sudan,SDN,Japan,JPN,0,0,5,0,5
2011,United Rep. of Tanzania,TZA,Japan,JPN,0,0,5,0,5
2011,Tunisia,TUN,Japan,JPN,0,0,5,0,5
2011,Turkey,TUR,Japan,JPN,0,5,221,23,249
2011,Uganda,UGA,Japan,JPN,0,5,45,0,50
2011,Afghanistan,AFG,Kazakhstan,KAZ,12,0,5,0,17
2011,China,CHN,Kazakhstan,KAZ,0,0,14,18,32
2011,Palestinian,PSE,Kazakhstan,KAZ,0,0,5,0,5
2011,Kyrgyzstan,KGZ,Kazakhstan,KAZ,0,0,10,0,10
2011,Russian Federation,RUS,Kazakhstan,KAZ,0,0,0,5,5
2011,Uzbekistan,UZB,Kazakhstan,KAZ,0,0,5,214,219
2011,Afghanistan,AFG,Kyrgyzstan,KGZ,0,0,58,5,63
2011,Iran (Islamic Rep. of),IRN,Kyrgyzstan,KGZ,0,0,10,0,10
2011,Iraq,IRQ,Kyrgyzstan,KGZ,0,0,0,5,5
2011,Kazakhstan,KAZ,Kyrgyzstan,KGZ,0,0,5,0,5
2011,Russian Federation,RUS,Kyrgyzstan,KGZ,0,0,0,15,15
2011,Uzbekistan,UZB,Kyrgyzstan,KGZ,0,0,0,32,32
2011,Afghanistan,AFG,Liechtenstein,LIE,0,0,0,5,5
2011,Eritrea,ERI,Liechtenstein,LIE,0,5,0,0,5
2011,Kyrgyzstan,KGZ,Liechtenstein,LIE,0,0,0,5,5
2011,Nigeria,NGA,Liechtenstein,LIE,0,0,0,5,5
2011,Russian Federation,RUS,Liechtenstein,LIE,0,0,0,10,10
2011,Serbia and Kosovo: S/RES/1244 (1999),SRB,Liechtenstein,LIE,0,0,16,15,31
2011,Somalia,SOM,Liechtenstein,LIE,0,5,0,0,5
2011,Afghanistan,AFG,Lithuania,LTU,0,5,5,19,29
2011,Armenia,ARM,Lithuania,LTU,0,0,5,19,24
2011,Belarus,BLR,Lithuania,LTU,5,0,0,0,5
2011,Georgia,GEO,Lithuania,LTU,0,0,189,52,241
2011,Kyrgyzstan,KGZ,Lithuania,LTU,0,0,16,5,21
2011,Russian Federation,RUS,Lithuania,LTU,0,5,17,26,48
2011,Tajikistan,TJK,Lithuania,LTU,0,0,5,5,10
2011,Uzbekistan,UZB,Lithuania,LTU,0,0,5,0,5
2011,Afghanistan,AFG,Luxembourg,LUX,0,0,10,0,10
2011,Albania,ALB,Luxembourg,LUX,0,0,11,0,11
2011,Algeria,DZA,Luxembourg,LUX,0,0,5,0,5
2011,Bosnia and Herzegovina,BIH,Luxembourg,LUX,0,0,19,0,19
2011,Iran (Islamic Rep. of),IRN,Luxembourg,LUX,5,0,0,0,5
2011,Iraq,IRQ,Luxembourg,LUX,10,0,10,0,20
2011,North Macedonia,MKD,Luxembourg,LUX,0,0,148,0,148
2011,Mexico,MEX,Luxembourg,LUX,0,0,5,0,5
2011,Montenegro,MNE,Luxembourg,LUX,0,0,35,0,35
2011,Serbia and Kosovo: S/RES/1244 (1999),SRB,Luxembourg,LUX,5,0,465,0,470
2011,Syrian Arab Rep.,SYR,Luxembourg,LUX,0,0,5,0,5
2011,Unknown ,,Luxembourg,LUX,0,0,0,426,426
2011,Afghanistan,AFG,Latvia,LVA,0,5,5,0,10
2011,Cameroon,CMR,Latvia,LVA,0,0,0,5,5
2011,Dem. Rep. of the Congo,COD,Latvia,LVA,0,0,5,10,15
2011,Georgia,GEO,Latvia,LVA,0,0,5,62,67
2011,Kyrgyzstan,KGZ,Latvia,LVA,0,0,5,0,5
2011,Lebanon,LBN,Latvia,LVA,0,0,0,5,5
2011,Pakistan,PAK,Latvia,LVA,0,0,0,5,5
2011,Russian Federation,RUS,Latvia,LVA,5,0,0,5,10
2011,Syrian Arab Rep.,SYR,Latvia,LVA,0,5,0,0,5
2011,Dem. Rep. of the Congo,COD,Mali,MLI,16,0,5,0,21
2011,Cote d'Ivoire,CIV,Mali,MLI,21,0,27,0,48
2011,Rwanda,RWA,Mali,MLI,5,0,0,0,5
2011,Burundi,BDI,Malawi,MWI,92,0,162,10,264
2011,Dem. Rep. of the Congo,COD,Malawi,MWI,415,0,58,18,491
2011,Ethiopia,ETH,Malawi,MWI,0,0,5,0,5
2011,Rwanda,RWA,Malawi,MWI,80,0,92,16,188
2011,Uganda,UGA,Malawi,MWI,0,0,0,5,5
2011,Burundi,BDI,Mozambique,MOZ,12,0,0,0,12
2011,Dem. Rep. of the Congo,COD,Mozambique,MOZ,88,0,0,0,88
2011,Rwanda,RWA,Mozambique,MOZ,19,0,0,0,19
2011,Somalia,SOM,Mozambique,MOZ,5,0,0,0,5
2011,Egypt,EGY,Malta,MLT,0,0,10,0,10
2011,Bangladesh,BGD,Malta,MLT,0,0,31,0,31
2011,Burkina Faso,BFA,Malta,MLT,0,0,10,0,10
2011,Chad,TCD,Malta,MLT,0,5,12,0,17
2011,Cameroon,CMR,Malta,MLT,0,0,10,0,10
2011,Eritrea,ERI,Malta,MLT,15,245,43,5,308
2011,Ethiopia,ETH,Malta,MLT,10,14,78,0,102
2011,Gambia,GMB,Malta,MLT,0,0,10,0,10
2011,Palestinian,PSE,Malta,MLT,0,0,0,5,5
2011,Ghana,GHA,Malta,MLT,0,0,0,69,69
2011,Cote d'Ivoire,CIV,Malta,MLT,0,0,105,0,105
2011,India,IND,Malta,MLT,0,0,5,0,5
2011,Iran (Islamic Rep. of),IRN,Malta,MLT,5,0,0,0,5
2011,Libya,LBY,Malta,MLT,0,31,0,23,54
2011,Mali,MLI,Malta,MLT,0,0,83,5,88
2011,Morocco,MAR,Malta,MLT,5,0,5,0,10
2011,Niger,NER,Malta,MLT,0,0,13,0,13
2011,Nigeria,NGA,Malta,MLT,0,0,240,5,245
2011,Pakistan,PAK,Malta,MLT,14,16,15,0,45
2011,Senegal,SEN,Malta,MLT,0,0,0,5,5
2011,Sierra Leone,SLE,Malta,MLT,0,0,5,0,5
2011,Somalia,SOM,Malta,MLT,5,401,5,0,411
2011,Sudan,SDN,Malta,MLT,5,43,10,0,58
2011,Syrian Arab Rep.,SYR,Malta,MLT,0,45,0,5,50
2011,Togo,TGO,Malta,MLT,0,0,10,0,10
2011,Tunisia,TUN,Malta,MLT,0,0,5,0,5
2011,Unknown ,,Malta,MLT,0,0,0,5,5
2011,Burundi,BDI,Namibia,NAM,22,0,13,41,76
2011,Cameroon,CMR,Namibia,NAM,0,0,0,10,10
2011,Congo,COG,Namibia,NAM,0,0,0,5,5
2011,Dem. Rep. of the Congo,COD,Namibia,NAM,79,0,94,352,525
2011,Ethiopia,ETH,Namibia,NAM,0,0,0,5,5
2011,Kenya,KEN,Namibia,NAM,0,0,0,5,5
2011,Liberia,LBR,Namibia,NAM,0,0,0,5,5
2011,Rwanda,RWA,Namibia,NAM,10,0,0,32,42
2011,Somalia,SOM,Namibia,NAM,5,0,0,0,5
2011,Sudan,SDN,Namibia,NAM,0,0,0,5,5
2011,United Rep. of Tanzania,TZA,Namibia,NAM,0,0,0,10,10
2011,Uganda,UGA,Namibia,NAM,0,0,0,5,5
2011,Zimbabwe,ZWE,Namibia,NAM,0,0,5,46,51
2011,Bhutan,BTN,Nepal,NPL,0,0,0,5,5
2011,Afghanistan,AFG,Netherlands,NLD,73,983,1453,0,2509
2011,Albania,ALB,Netherlands,NLD,0,0,24,0,24
2011,Algeria,DZA,Netherlands,NLD,0,0,15,0,15
2011,Angola,AGO,Netherlands,NLD,0,5,27,0,32
2011,Egypt,EGY,Netherlands,NLD,0,5,61,0,66
2011,Armenia,ARM,Netherlands,NLD,5,55,566,0,626
2011,Azerbaijan,AZE,Netherlands,NLD,10,30,101,0,141
2011,Burundi,BDI,Netherlands,NLD,0,5,27,0,32
2011,Benin,BEN,Netherlands,NLD,0,0,10,0,10
2011,Bangladesh,BGD,Netherlands,NLD,0,0,17,0,17
2011,Bhutan,BTN,Netherlands,NLD,0,54,0,0,54
2011,Burkina Faso,BFA,Netherlands,NLD,0,0,11,0,11
2011,Belarus,BLR,Netherlands,NLD,10,5,197,0,212
2011,Bolivia (Plurinational State of),BOL,Netherlands,NLD,0,0,5,0,5
2011,Brazil,BRA,Netherlands,NLD,0,0,5,0,5
2011,Bosnia and Herzegovina,BIH,Netherlands,NLD,0,0,25,0,25
2011,Chad,TCD,Netherlands,NLD,0,0,5,0,5
2011,China,CHN,Netherlands,NLD,36,148,177,0,361
2011,Cameroon,CMR,Netherlands,NLD,0,5,17,0,22
2011,Congo,COG,Netherlands,NLD,13,79,51,0,143
2011,Dem. Rep. of the Congo,COD,Netherlands,NLD,0,39,15,0,54
2011,Colombia,COL,Netherlands,NLD,0,5,12,0,17
2011,Ecuador,ECU,Netherlands,NLD,0,5,0,0,5
2011,Eritrea,ERI,Netherlands,NLD,27,404,181,0,612
2011,Ethiopia,ETH,Netherlands,NLD,24,97,61,0,182
2011,Gambia,GMB,Netherlands,NLD,0,0,22,0,22
2011,Palestinian,PSE,Netherlands,NLD,5,5,38,0,48
2011,Georgia,GEO,Netherlands,NLD,0,5,224,0,229
2011,Ghana,GHA,Netherlands,NLD,0,0,40,0,40
2011,Guinea,GIN,Netherlands,NLD,5,80,178,0,263
2011,Croatia,HRV,Netherlands,NLD,0,0,10,0,10
2011,Cote d'Ivoire,CIV,Netherlands,NLD,5,19,48,0,72
2011,India,IND,Netherlands,NLD,0,0,27,0,27
2011,Indonesia,IDN,Netherlands,NLD,0,0,5,0,5
2011,Iran (Islamic Rep. of),IRN,Netherlands,NLD,171,363,606,0,1140
2011,Iraq,IRQ,Netherlands,NLD,127,1117,1028,0,2272
2011,Israel,ISR,Netherlands,NLD,0,0,5,0,5
2011,Jamaica,JAM,Netherlands,NLD,10,5,0,0,15
2011,Kazakhstan,KAZ,Netherlands,NLD,0,0,15,0,15
2011,Kenya,KEN,Netherlands,NLD,0,0,10,0,10
2011,Kyrgyzstan,KGZ,Netherlands,NLD,5,5,16,0,26
2011,Dem. People's Rep. of Korea,PRK,Netherlands,NLD,0,5,0,0,5
2011,Lao People's Dem. Rep.,LAO,Netherlands,NLD,0,16,0,0,16
2011,Liberia,LBR,Netherlands,NLD,0,10,16,0,26
2011,Libya,LBY,Netherlands,NLD,5,10,59,0,74
2011,Lebanon,LBN,Netherlands,NLD,0,0,17,0,17
2011,Sri Lanka,LKA,Netherlands,NLD,26,86,125,0,237
2011,Mauritania,MRT,Netherlands,NLD,0,0,5,0,5
2011,North Macedonia,MKD,Netherlands,NLD,0,0,275,0,275
2011,Rep. of Moldova,MDA,Netherlands,NLD,0,0,5,0,5
2011,Mali,MLI,Netherlands,NLD,0,0,17,0,17
2011,Malaysia,MYS,Netherlands,NLD,0,5,0,0,5
2011,Mongolia,MNG,Netherlands,NLD,0,0,148,0,148
2011,Morocco,MAR,Netherlands,NLD,0,0,24,0,24
2011,Myanmar,MMR,Netherlands,NLD,18,120,10,0,148
2011,Nepal,NPL,Netherlands,NLD,10,35,84,0,129
2011,Niger,NER,Netherlands,NLD,0,0,5,0,5
2011,Nigeria,NGA,Netherlands,NLD,0,19,153,0,172
2011,Pakistan,PAK,Netherlands,NLD,12,22,75,0,109
2011,South Africa,ZAF,Netherlands,NLD,0,0,5,0,5
2011,Russian Federation,RUS,Netherlands,NLD,5,16,446,0,467
2011,Rwanda,RWA,Netherlands,NLD,5,5,11,0,21
2011,El Salvador,SLV,Netherlands,NLD,0,0,5,0,5
2011,Saudi Arabia,SAU,Netherlands,NLD,0,0,5,0,5
2011,Serbia and Kosovo: S/RES/1244 (1999),SRB,Netherlands,NLD,0,0,142,0,142
2011,Senegal,SEN,Netherlands,NLD,0,0,10,0,10
2011,Sierra Leone,SLE,Netherlands,NLD,0,43,123,0,166
2011,Somalia,SOM,Netherlands,NLD,35,1638,950,0,2623
2011,Viet Nam,VNM,Netherlands,NLD,0,0,5,0,5
2011,Sudan,SDN,Netherlands,NLD,23,85,117,0,225
2011,Syrian Arab Rep.,SYR,Netherlands,NLD,5,16,63,0,84
2011,United Rep. of Tanzania,TZA,Netherlands,NLD,0,0,5,0,5
2011,Tajikistan,TJK,Netherlands,NLD,0,0,14,0,14
2011,Togo,TGO,Netherlands,NLD,0,0,24,0,24
2011,Trinidad and Tobago,TTO,Netherlands,NLD,0,5,0,0,5
2011,Tunisia,TUN,Netherlands,NLD,0,0,12,0,12
2011,Turkey,TUR,Netherlands,NLD,5,16,62,0,83
2011,Uganda,UGA,Netherlands,NLD,19,16,77,0,112
2011,Ukraine,UKR,Netherlands,NLD,0,0,34,0,34
2011,United States of America,USA,Netherlands,NLD,0,0,5,0,5
2011,Uzbekistan,UZB,Netherlands,NLD,0,10,15,0,25
2011,Yemen,YEM,Netherlands,NLD,0,5,13,0,18
2011,Zimbabwe,ZWE,Netherlands,NLD,0,0,11,0,11
2011,Stateless,XXA,Netherlands,NLD,0,23,70,0,93
2011,Unknown ,,Netherlands,NLD,5,364,359,0,728
2011,Cote d'Ivoire,CIV,Niger,NER,5,0,36,23,64
2011,Bangladesh,BGD,Nicaragua,NIC,0,0,0,5,5
2011,Congo,COG,Nicaragua,NIC,5,0,0,0,5
2011,Eritrea,ERI,Nicaragua,NIC,0,0,0,5,5
2011,Honduras,HND,Nicaragua,NIC,5,0,0,5,10
2011,Somalia,SOM,Nicaragua,NIC,0,0,0,11,11
2011,Afghanistan,AFG,Norway,NOR,204,337,615,153,1309
2011,Albania,ALB,Norway,NOR,0,0,34,5,39
2011,Algeria,DZA,Norway,NOR,0,0,47,69,116
2011,Angola,AGO,Norway,NOR,0,0,12,5,17
2011,Egypt,EGY,Norway,NOR,5,5,18,5,33
2011,Armenia,ARM,Norway,NOR,0,0,13,5,18
2011,Azerbaijan,AZE,Norway,NOR,0,0,34,16,50
2011,Burundi,BDI,Norway,NOR,5,0,5,5,15
2011,Benin,BEN,Norway,NOR,0,0,5,0,5
2011,Bangladesh,BGD,Norway,NOR,0,0,46,10,56
2011,Burkina Faso,BFA,Norway,NOR,0,0,5,0,5
2011,Belarus,BLR,Norway,NOR,0,0,16,22,38
2011,Brazil,BRA,Norway,NOR,0,0,5,0,5
2011,Bosnia and Herzegovina,BIH,Norway,NOR,0,0,17,5,22
2011,Bulgaria,BGR,Norway,NOR,0,0,5,0,5
2011,Chad,TCD,Norway,NOR,0,0,0,5,5
2011,China,CHN,Norway,NOR,185,0,36,11,232
2011,Cameroon,CMR,Norway,NOR,0,0,10,5,15
2011,Congo,COG,Norway,NOR,0,0,5,5,10
2011,Dem. Rep. of the Congo,COD,Norway,NOR,12,10,73,16,111
2011,Colombia,COL,Norway,NOR,5,0,0,5,10
2011,Czechia,CZE,Norway,NOR,0,0,10,0,10
2011,Eritrea,ERI,Norway,NOR,1045,98,274,244,1661
2011,Ethiopia,ETH,Norway,NOR,152,43,219,58,472
2011,Gambia,GMB,Norway,NOR,0,0,55,26,81
2011,Georgia,GEO,Norway,NOR,0,0,10,32,42
2011,Ghana,GHA,Norway,NOR,0,0,22,14,36
2011,Guinea-Bissau,GNB,Norway,NOR,0,0,5,5,10
2011,Guinea,GIN,Norway,NOR,5,10,49,22,86
2011,Croatia,HRV,Norway,NOR,0,0,0,5,5
2011,Hungary,HUN,Norway,NOR,0,0,5,0,5
2011,Cote d'Ivoire,CIV,Norway,NOR,0,0,17,13,30
2011,India,IND,Norway,NOR,0,0,29,30,59
2011,Iran (Islamic Rep. of),IRN,Norway,NOR,120,14,285,88,507
2011,Iraq,IRQ,Norway,NOR,89,58,201,164,512
2011,Israel,ISR,Norway,NOR,0,0,10,0,10
2011,Jordan,JOR,Norway,NOR,0,0,10,19,29
2011,Kazakhstan,KAZ,Norway,NOR,5,0,5,5,15
2011,Kenya,KEN,Norway,NOR,0,0,5,0,5
2011,Kyrgyzstan,KGZ,Norway,NOR,0,0,49,21,70
2011,Kuwait,KWT,Norway,NOR,0,0,5,0,5
2011,Liberia,LBR,Norway,NOR,0,0,27,10,37
2011,Libya,LBY,Norway,NOR,0,0,16,66,82
2011,Lebanon,LBN,Norway,NOR,0,0,12,15,27
2011,Sri Lanka,LKA,Norway,NOR,0,10,67,11,88
2011,Latvia,LVA,Norway,NOR,0,0,10,0,10
2011,Mauritania,MRT,Norway,NOR,0,0,10,5,15
2011,North Macedonia,MKD,Norway,NOR,0,0,20,0,20
2011,Rep. of Moldova,MDA,Norway,NOR,0,0,0,5,5
2011,Mexico,MEX,Norway,NOR,0,0,10,0,10
2011,Mali,MLI,Norway,NOR,0,0,5,0,5
2011,Mongolia,MNG,Norway,NOR,0,0,5,5,10
2011,Morocco,MAR,Norway,NOR,0,0,52,41,93
2011,Montenegro,MNE,Norway,NOR,0,0,5,5,10
2011,Myanmar,MMR,Norway,NOR,10,19,5,19,53
2011,Nepal,NPL,Norway,NOR,0,0,13,10,23
2011,Niger,NER,Norway,NOR,0,0,10,5,15
2011,Nicaragua,NIC,Norway,NOR,0,0,0,5,5
2011,Nigeria,NGA,Norway,NOR,10,17,126,132,285
2011,Pakistan,PAK,Norway,NOR,5,5,82,31,123
2011,Romania,ROU,Norway,NOR,0,0,5,0,5
2011,South Africa,ZAF,Norway,NOR,0,0,0,5,5
2011,Russian Federation,RUS,Norway,NOR,0,20,236,201,457
2011,Rwanda,RWA,Norway,NOR,5,5,5,5,20
2011,El Salvador,SLV,Norway,NOR,0,0,15,5,20
2011,Saudi Arabia,SAU,Norway,NOR,0,0,0,5,5
2011,Serbia and Kosovo: S/RES/1244 (1999),SRB,Norway,NOR,0,0,144,100,244
2011,Senegal,SEN,Norway,NOR,0,0,23,12,35
2011,Sierra Leone,SLE,Norway,NOR,0,0,26,5,31
2011,Somalia,SOM,Norway,NOR,759,446,106,454,1765
2011,Spain,ESP,Norway,NOR,0,0,5,0,5
2011,Viet Nam,VNM,Norway,NOR,0,0,12,10,22
2011,Sudan,SDN,Norway,NOR,137,11,11,56,215
2011,Syrian Arab Rep.,SYR,Norway,NOR,5,5,52,51,113
2011,United Rep. of Tanzania,TZA,Norway,NOR,0,0,0,5,5
2011,Tajikistan,TJK,Norway,NOR,0,0,5,10,15
2011,Togo,TGO,Norway,NOR,0,0,5,0,5
2011,Tunisia,TUN,Norway,NOR,0,0,20,55,75
2011,Turkey,TUR,Norway,NOR,5,5,48,13,71
2011,Uganda,UGA,Norway,NOR,5,0,29,5,39
2011,Ukraine,UKR,Norway,NOR,0,0,5,10,15
2011,United States of America,USA,Norway,NOR,0,0,5,0,5
2011,Uzbekistan,UZB,Norway,NOR,5,12,71,24,112
2011,Yemen,YEM,Norway,NOR,0,10,15,11,36
2011,Zimbabwe,ZWE,Norway,NOR,5,0,18,10,33
2011,Stateless,XXA,Norway,NOR,31,92,191,119,433
2011,Afghanistan,AFG,New Zealand,NZL,10,0,5,0,15
2011,Egypt,EGY,New Zealand,NZL,0,0,10,0,10
2011,Bahrain,BHR,New Zealand,NZL,15,0,5,0,20
2011,Bangladesh,BGD,New Zealand,NZL,0,0,5,0,5
2011,Brazil,BRA,New Zealand,NZL,0,0,5,0,5
2011,China,CHN,New Zealand,NZL,10,0,14,0,24
2011,Colombia,COL,New Zealand,NZL,0,0,5,0,5
2011,Czechia,CZE,New Zealand,NZL,5,0,11,0,16
2011,Fiji,FJI,New Zealand,NZL,5,0,23,0,28
2011,Germany,DEU,New Zealand,NZL,0,0,5,0,5
2011,Ghana,GHA,New Zealand,NZL,0,0,5,0,5
2011,Hungary,HUN,New Zealand,NZL,0,0,5,0,5
2011,Iran (Islamic Rep. of),IRN,New Zealand,NZL,10,0,37,0,47
2011,Iraq,IRQ,New Zealand,NZL,5,0,5,0,10
2011,Sri Lanka,LKA,New Zealand,NZL,5,0,17,0,22
2011,Nepal,NPL,New Zealand,NZL,0,0,5,0,5
2011,Pakistan,PAK,New Zealand,NZL,0,0,12,0,12
2011,South Africa,ZAF,New Zealand,NZL,0,0,21,0,21
2011,Russian Federation,RUS,New Zealand,NZL,0,0,5,0,5
2011,El Salvador,SLV,New Zealand,NZL,5,0,0,0,5
2011,Saudi Arabia,SAU,New Zealand,NZL,5,0,10,0,15
2011,Tunisia,TUN,New Zealand,NZL,0,0,5,0,5
2011,Turkey,TUR,New Zealand,NZL,0,0,5,0,5
2011,Zimbabwe,ZWE,New Zealand,NZL,0,0,5,0,5
2011,Bangladesh,BGD,Panama,PAN,0,0,0,10,10
2011,China,CHN,Panama,PAN,0,0,5,0,5
2011,Colombia,COL,Panama,PAN,135,0,57,758,950
2011,Cuba,CUB,Panama,PAN,5,0,0,42,47
2011,Ethiopia,ETH,Panama,PAN,0,0,0,5,5
2011,Honduras,HND,Panama,PAN,0,0,0,5,5
2011,Nicaragua,NIC,Panama,PAN,0,0,0,25,25
2011,El Salvador,SLV,Panama,PAN,0,0,0,5,5
2011,Venezuela (Bolivarian Republic of),VEN,Panama,PAN,5,0,0,5,10
2011,Bolivia (Plurinational State of),BOL,Paraguay,PRY,5,0,0,0,5
2011,Argentina,ARG,Peru,PER,0,0,0,10,10
2011,Bolivia (Plurinational State of),BOL,Peru,PER,5,0,0,0,5
2011,Colombia,COL,Peru,PER,5,0,0,22,27
2011,Cuba,CUB,Peru,PER,5,0,35,12,52
2011,Haiti,HTI,Peru,PER,5,0,0,102,107
2011,Niger,NER,Peru,PER,0,0,0,5,5
2011,Nigeria,NGA,Peru,PER,0,0,0,10,10
2011,Sierra Leone,SLE,Peru,PER,0,0,0,5,5
2011,Venezuela (Bolivarian Republic of),VEN,Peru,PER,5,0,0,5,10
2011,China,CHN,Philippines,PHL,0,0,0,5,5
2011,Iran (Islamic Rep. of),IRN,Philippines,PHL,5,0,0,10,15
2011,Afghanistan,AFG,Poland,POL,5,0,18,12,35
2011,Algeria,DZA,Poland,POL,0,0,5,5,10
2011,Egypt,EGY,Poland,POL,0,5,5,0,10
2011,Armenia,ARM,Poland,POL,0,32,82,108,222
2011,Azerbaijan,AZE,Poland,POL,0,0,0,5,5
2011,Bangladesh,BGD,Poland,POL,0,0,5,10,15
2011,Belarus,BLR,Poland,POL,19,5,19,12,55
2011,China,CHN,Poland,POL,0,0,5,5,10
2011,Cameroon,CMR,Poland,POL,0,0,10,5,15
2011,Congo,COG,Poland,POL,0,0,13,0,13
2011,Dem. Rep. of the Congo,COD,Poland,POL,0,0,5,0,5
2011,Eritrea,ERI,Poland,POL,12,0,0,0,12
2011,Palestinian,PSE,Poland,POL,0,0,5,5,10
2011,Georgia,GEO,Poland,POL,0,5,552,1409,1966
2011,Guinea,GIN,Poland,POL,0,0,5,5,10
2011,India,IND,Poland,POL,0,0,10,10,20
2011,Iran (Islamic Rep. of),IRN,Poland,POL,0,0,5,0,5
2011,Iraq,IRQ,Poland,POL,16,10,5,14,45
2011,Kazakhstan,KAZ,Poland,POL,0,0,5,24,29
2011,Kenya,KEN,Poland,POL,0,5,0,0,5
2011,Kyrgyzstan,KGZ,Poland,POL,0,5,0,24,29
2011,Libya,LBY,Poland,POL,0,5,0,5,10
2011,Sri Lanka,LKA,Poland,POL,0,5,0,0,5
2011,Rep. of Moldova,MDA,Poland,POL,0,0,5,0,5
2011,Mongolia,MNG,Poland,POL,0,14,10,5,29
2011,Nepal,NPL,Poland,POL,0,0,32,21,53
2011,Nigeria,NGA,Poland,POL,5,0,14,5,24
2011,Pakistan,PAK,Poland,POL,0,0,10,13,23
2011,Russian Federation,RUS,Poland,POL,82,214,1798,4796,6890
2011,Somalia,SOM,Poland,POL,5,0,5,0,10
2011,Viet Nam,VNM,Poland,POL,0,5,23,5,33
2011,Syrian Arab Rep.,SYR,Poland,POL,0,0,0,10,10
2011,United Rep. of Tanzania,TZA,Poland,POL,0,0,5,0,5
2011,Tunisia,TUN,Poland,POL,0,0,5,5,10
2011,Turkey,TUR,Poland,POL,0,0,10,5,15
2011,Ukraine,UKR,Poland,POL,0,5,39,31,75
2011,Uzbekistan,UZB,Poland,POL,0,5,5,13,23
2011,Stateless,XXA,Poland,POL,0,0,10,5,15
2011,Unknown ,,Poland,POL,0,0,5,0,5
2011,Bosnia and Herzegovina,BIH,Portugal,PRT,0,5,0,0,5
2011,Dem. Rep. of the Congo,COD,Portugal,PRT,11,0,0,5,16
2011,Colombia,COL,Portugal,PRT,0,10,0,0,10
2011,Guinea-Bissau,GNB,Portugal,PRT,0,0,0,5,5
2011,Guinea,GIN,Portugal,PRT,0,0,0,18,18
2011,Cote d'Ivoire,CIV,Portugal,PRT,0,0,0,5,5
2011,Nigeria,NGA,Portugal,PRT,0,0,0,5,5
2011,Pakistan,PAK,Portugal,PRT,5,0,0,0,5
2011,Russian Federation,RUS,Portugal,PRT,0,5,0,0,5
2011,Somalia,SOM,Portugal,PRT,0,10,0,0,10
2011,Turkey,TUR,Portugal,PRT,5,0,0,0,5
2011,Algeria,DZA,South Africa,ZAF,0,0,31,0,31
2011,Angola,AGO,South Africa,ZAF,16,0,0,0,16
2011,Egypt,EGY,South Africa,ZAF,0,0,97,0,97
2011,Burundi,BDI,South Africa,ZAF,49,0,543,0,592
2011,Benin,BEN,South Africa,ZAF,0,0,5,0,5
2011,Bangladesh,BGD,South Africa,ZAF,5,0,2048,0,2053
2011,Burkina Faso,BFA,South Africa,ZAF,0,0,5,0,5
2011,China,CHN,South Africa,ZAF,0,0,555,0,555
2011,Cameroon,CMR,South Africa,ZAF,5,0,206,0,211
2011,Congo,COG,South Africa,ZAF,107,0,696,0,803
2011,Dem. Rep. of the Congo,COD,South Africa,ZAF,802,0,2399,0,3201
2011,Comoros,COM,South Africa,ZAF,0,0,5,0,5
2011,Eritrea,ERI,South Africa,ZAF,292,0,48,0,340
2011,Ethiopia,ETH,South Africa,ZAF,1663,0,7387,0,9050
2011,Palestinian,PSE,South Africa,ZAF,14,0,0,0,14
2011,Ghana,GHA,South Africa,ZAF,0,0,553,0,553
2011,Cote d'Ivoire,CIV,South Africa,ZAF,0,0,10,0,10
2011,India,IND,South Africa,ZAF,0,0,644,0,644
2011,Kenya,KEN,South Africa,ZAF,5,0,146,0,151
2011,Lesotho,LSO,South Africa,ZAF,0,0,27,0,27
2011,Sri Lanka,LKA,South Africa,ZAF,0,0,5,0,5
2011,Mali,MLI,South Africa,ZAF,0,0,10,0,10
2011,Malawi,MWI,South Africa,ZAF,0,0,1018,0,1018
2011,Mozambique,MOZ,South Africa,ZAF,0,0,219,0,219
2011,Nepal,NPL,South Africa,ZAF,0,0,5,0,5
2011,Niger,NER,South Africa,ZAF,0,0,27,0,27
2011,Nigeria,NGA,South Africa,ZAF,0,0,957,0,957
2011,Pakistan,PAK,South Africa,ZAF,0,0,1581,0,1581
2011,Rwanda,RWA,South Africa,ZAF,35,0,86,0,121
2011,Senegal,SEN,South Africa,ZAF,0,0,48,0,48
2011,Somalia,SOM,South Africa,ZAF,3639,0,669,0,4308
2011,Sudan,SDN,South Africa,ZAF,5,0,10,0,15
2011,Eswatini,SWZ,South Africa,ZAF,0,0,22,0,22
2011,United Rep. of Tanzania,TZA,South Africa,ZAF,0,0,162,0,162
2011,Thailand,THA,South Africa,ZAF,0,0,5,0,5
2011,Togo,TGO,South Africa,ZAF,0,0,5,0,5
2011,Uganda,UGA,South Africa,ZAF,11,0,921,0,932
2011,Zambia,ZMB,South Africa,ZAF,5,0,58,0,63
2011,Zimbabwe,ZWE,South Africa,ZAF,83,0,15904,0,15987
2011,Unknown ,,South Africa,ZAF,66,0,0,0,66
2011,Afghanistan,AFG,Russian Federation,RUS,88,0,0,656,744
2011,Egypt,EGY,Russian Federation,RUS,0,0,0,10,10
2011,Armenia,ARM,Russian Federation,RUS,0,0,0,5,5
2011,Azerbaijan,AZE,Russian Federation,RUS,0,0,0,5,5
2011,Bangladesh,BGD,Russian Federation,RUS,5,0,0,0,5
2011,Belarus,BLR,Russian Federation,RUS,0,0,0,10,10
2011,Cambodia,KHM,Russian Federation,RUS,0,0,0,5,5
2011,China,CHN,Russian Federation,RUS,0,0,0,5,5
2011,Congo,COG,Russian Federation,RUS,0,0,0,5,5
2011,Dem. Rep. of the Congo,COD,Russian Federation,RUS,0,0,0,10,10
2011,Palestinian,PSE,Russian Federation,RUS,0,0,0,10,10
2011,Georgia,GEO,Russian Federation,RUS,11,0,0,506,517
2011,Guinea,GIN,Russian Federation,RUS,0,0,0,5,5
2011,Iran (Islamic Rep. of),IRN,Russian Federation,RUS,0,0,0,5,5
2011,Iraq,IRQ,Russian Federation,RUS,0,0,0,10,10
2011,Kazakhstan,KAZ,Russian Federation,RUS,0,0,0,10,10
2011,Kyrgyzstan,KGZ,Russian Federation,RUS,0,0,0,82,82
2011,Dem. People's Rep. of Korea,PRK,Russian Federation,RUS,0,0,0,55,55
2011,Lebanon,LBN,Russian Federation,RUS,0,0,0,5,5
2011,Rep. of Moldova,MDA,Russian Federation,RUS,0,0,0,5,5
2011,Nigeria,NGA,Russian Federation,RUS,0,0,0,5,5
2011,Pakistan,PAK,Russian Federation,RUS,0,0,0,5,5
2011,Serbia and Kosovo: S/RES/1244 (1999),SRB,Russian Federation,RUS,0,0,0,5,5
2011,Somalia,SOM,Russian Federation,RUS,0,0,0,5,5
2011,Syrian Arab Rep.,SYR,Russian Federation,RUS,0,0,0,24,24
2011,Tajikistan,TJK,Russian Federation,RUS,0,0,0,14,14
2011,Turkmenistan,TKM,Russian Federation,RUS,0,0,0,5,5
2011,Turkey,TUR,Russian Federation,RUS,0,0,0,5,5
2011,Ukraine,UKR,Russian Federation,RUS,0,0,0,10,10
2011,Uzbekistan,UZB,Russian Federation,RUS,0,0,0,78,78
2011,Yemen,YEM,Russian Federation,RUS,0,0,0,5,5
2011,Unknown ,,Russian Federation,RUS,0,0,0,11,11
2011,Cuba,CUB,El Salvador,SLV,0,0,0,5,5
2011,Eritrea,ERI,El Salvador,SLV,0,0,0,5,5
2011,Honduras,HND,El Salvador,SLV,0,0,0,14,14
2011,Afghanistan,AFG,Serbia and Kosovo: S/RES/1244 (1999),SRB,0,0,96,1587,1683
2011,Algeria,DZA,Serbia and Kosovo: S/RES/1244 (1999),SRB,0,0,11,47,58
2011,Bangladesh,BGD,Serbia and Kosovo: S/RES/1244 (1999),SRB,0,0,0,10,10
2011,Dem. Rep. of the Congo,COD,Serbia and Kosovo: S/RES/1244 (1999),SRB,0,0,0,10,10
2011,Eritrea,ERI,Serbia and Kosovo: S/RES/1244 (1999),SRB,0,0,0,5,5
2011,Palestinian,PSE,Serbia and Kosovo: S/RES/1244 (1999),SRB,0,0,10,154,164
2011,India,IND,Serbia and Kosovo: S/RES/1244 (1999),SRB,0,0,0,26,26
2011,Iran (Islamic Rep. of),IRN,Serbia and Kosovo: S/RES/1244 (1999),SRB,0,0,0,38,38
2011,Iraq,IRQ,Serbia and Kosovo: S/RES/1244 (1999),SRB,0,0,5,30,35
2011,Libya,LBY,Serbia and Kosovo: S/RES/1244 (1999),SRB,0,0,0,140,140
2011,Sri Lanka,LKA,Serbia and Kosovo: S/RES/1244 (1999),SRB,0,0,0,5,5
2011,Morocco,MAR,Serbia and Kosovo: S/RES/1244 (1999),SRB,0,0,5,88,93
2011,Myanmar,MMR,Serbia and Kosovo: S/RES/1244 (1999),SRB,0,0,0,5,5
2011,Nepal,NPL,Serbia and Kosovo: S/RES/1244 (1999),SRB,0,0,0,10,10
2011,Pakistan,PAK,Serbia and Kosovo: S/RES/1244 (1999),SRB,0,0,0,356,356
2011,Somalia,SOM,Serbia and Kosovo: S/RES/1244 (1999),SRB,0,0,15,319,334
2011,Sudan,SDN,Serbia and Kosovo: S/RES/1244 (1999),SRB,0,0,0,18,18
2011,Syrian Arab Rep.,SYR,Serbia and Kosovo: S/RES/1244 (1999),SRB,0,0,0,33,33
2011,Tunisia,TUN,Serbia and Kosovo: S/RES/1244 (1999),SRB,0,0,5,68,73
2011,Chad,TCD,Senegal,SEN,0,0,5,0,5
2011,Cameroon,CMR,Senegal,SEN,0,0,5,0,5
2011,Dem. Rep. of the Congo,COD,Senegal,SEN,0,0,5,0,5
2011,Guinea,GIN,Senegal,SEN,0,0,13,0,13
2011,Cote d'Ivoire,CIV,Senegal,SEN,0,0,38,0,38
2011,Mauritania,MRT,Senegal,SEN,0,0,5,0,5
2011,Unknown ,,Senegal,SEN,0,0,0,31,31
2011,Afghanistan,AFG,Spain,ESP,10,12,5,5,32
2011,Algeria,DZA,Spain,ESP,0,5,80,5,90
2011,Angola,AGO,Spain,ESP,0,0,5,0,5
2011,Armenia,ARM,Spain,ESP,0,0,37,0,37
2011,Azerbaijan,AZE,Spain,ESP,5,0,0,0,5
2011,Benin,BEN,Spain,ESP,0,0,5,0,5
2011,Bangladesh,BGD,Spain,ESP,5,0,5,0,10
2011,Burkina Faso,BFA,Spain,ESP,0,0,27,0,27
2011,Belarus,BLR,Spain,ESP,5,0,5,0,10
2011,Bolivia (Plurinational State of),BOL,Spain,ESP,0,0,5,0,5
2011,Central African Rep.,CAF,Spain,ESP,0,0,15,0,15
2011,Chad,TCD,Spain,ESP,0,0,10,0,10
2011,Cameroon,CMR,Spain,ESP,5,0,62,0,67
2011,Congo,COG,Spain,ESP,0,0,10,0,10
2011,Dem. Rep. of the Congo,COD,Spain,ESP,10,5,84,5,104
2011,Colombia,COL,Spain,ESP,36,13,334,5,388
2011,Cuba,CUB,Spain,ESP,80,468,23,10,581
2011,Ecuador,ECU,Spain,ESP,0,0,5,0,5
2011,Equatorial Guinea,GNQ,Spain,ESP,0,0,10,5,15
2011,Eritrea,ERI,Spain,ESP,0,5,5,0,10
2011,Ethiopia,ETH,Spain,ESP,0,0,5,0,5
2011,Gabon,GAB,Spain,ESP,0,0,5,0,5
2011,Gambia,GMB,Spain,ESP,0,0,51,5,56
2011,Palestinian,PSE,Spain,ESP,85,12,5,0,102
2011,Georgia,GEO,Spain,ESP,0,0,18,0,18
2011,Ghana,GHA,Spain,ESP,0,0,11,0,11
2011,Guinea-Bissau,GNB,Spain,ESP,0,0,17,0,17
2011,Guatemala,GTM,Spain,ESP,5,0,10,0,15
2011,Guinea,GIN,Spain,ESP,0,0,156,12,168
2011,Honduras,HND,Spain,ESP,0,0,37,0,37
2011,Cote d'Ivoire,CIV,Spain,ESP,0,28,22,5,55
2011,India,IND,Spain,ESP,0,0,10,5,15
2011,Iran (Islamic Rep. of),IRN,Spain,ESP,10,5,36,5,56
2011,Iraq,IRQ,Spain,ESP,0,5,0,5,10
2011,Jordan,JOR,Spain,ESP,5,0,0,0,5
2011,Kazakhstan,KAZ,Spain,ESP,5,0,0,0,5
2011,Kyrgyzstan,KGZ,Spain,ESP,0,0,10,5,15
2011,Liberia,LBR,Spain,ESP,0,0,11,0,11
2011,Sri Lanka,LKA,Spain,ESP,5,5,18,10,38
2011,Mauritania,MRT,Spain,ESP,0,0,5,0,5
2011,Mexico,MEX,Spain,ESP,0,0,23,0,23
2011,Mali,MLI,Spain,ESP,0,0,34,0,34
2011,Malawi,MWI,Spain,ESP,0,0,5,0,5
2011,Morocco,MAR,Spain,ESP,0,0,25,5,30
2011,Niger,NER,Spain,ESP,0,0,24,0,24
2011,Nicaragua,NIC,Spain,ESP,0,0,5,0,5
2011,Nigeria,NGA,Spain,ESP,0,0,209,15,224
2011,Pakistan,PAK,Spain,ESP,12,0,24,5,41
2011,Russian Federation,RUS,Spain,ESP,13,0,33,5,51
2011,Rwanda,RWA,Spain,ESP,0,0,5,0,5
2011,El Salvador,SLV,Spain,ESP,0,0,28,0,28
2011,Senegal,SEN,Spain,ESP,0,0,20,0,20
2011,Sierra Leone,SLE,Spain,ESP,0,5,31,5,41
2011,Somalia,SOM,Spain,ESP,10,67,11,33,121
2011,Sudan,SDN,Spain,ESP,0,0,10,0,10
2011,Syrian Arab Rep.,SYR,Spain,ESP,0,0,0,5,5
2011,Togo,TGO,Spain,ESP,5,0,21,0,26
2011,Turkey,TUR,Spain,ESP,0,0,5,0,5
2011,Ukraine,UKR,Spain,ESP,0,0,10,0,10
2011,United States of America,USA,Spain,ESP,0,0,5,0,5
2011,Venezuela (Bolivarian Republic of),VEN,Spain,ESP,13,0,59,0,72
2011,Western Sahara,ESH,Spain,ESP,5,0,43,0,48
2011,Zimbabwe,ZWE,Spain,ESP,0,0,13,0,13
2011,Unknown ,,Spain,ESP,0,0,5,0,5
2011,Afghanistan,AFG,Slovenia,SVN,0,0,25,23,48
2011,Algeria,DZA,Slovenia,SVN,0,0,5,10,15
2011,Egypt,EGY,Slovenia,SVN,0,0,0,5,5
2011,Belarus,BLR,Slovenia,SVN,0,0,0,5,5
2011,Bosnia and Herzegovina,BIH,Slovenia,SVN,0,5,13,5,23
2011,Palestinian,PSE,Slovenia,SVN,0,0,0,10,10
2011,Croatia,HRV,Slovenia,SVN,0,0,5,0,5
2011,India,IND,Slovenia,SVN,0,0,5,0,5
2011,Iran (Islamic Rep. of),IRN,Slovenia,SVN,0,0,5,5,10
2011,Iraq,IRQ,Slovenia,SVN,0,0,5,0,5
2011,Kazakhstan,KAZ,Slovenia,SVN,5,0,0,0,5
2011,Libya,LBY,Slovenia,SVN,0,0,0,5,5
2011,Rep. of Moldova,MDA,Slovenia,SVN,0,0,0,5,5
2011,Morocco,MAR,Slovenia,SVN,0,0,0,5,5
2011,Nigeria,NGA,Slovenia,SVN,0,0,5,5,10
2011,Pakistan,PAK,Slovenia,SVN,0,0,19,10,29
2011,Russian Federation,RUS,Slovenia,SVN,5,0,5,0,10
2011,Serbia and Kosovo: S/RES/1244 (1999),SRB,Slovenia,SVN,0,0,32,5,37
2011,Somalia,SOM,Slovenia,SVN,5,0,12,5,22
2011,Sudan,SDN,Slovenia,SVN,0,0,0,5,5
2011,Syrian Arab Rep.,SYR,Slovenia,SVN,0,0,0,5,5
2011,Tunisia,TUN,Slovenia,SVN,0,0,0,23,23
2011,Turkey,TUR,Slovenia,SVN,0,0,18,41,59
2011,Ukraine,UKR,Slovenia,SVN,0,0,5,5,10
2011,Western Sahara,ESH,Slovenia,SVN,0,0,0,10,10
2011,Afghanistan,AFG,Sweden,SWE,401,2188,957,102,3648
2011,Albania,ALB,Sweden,SWE,5,11,158,24,198
2011,Algeria,DZA,Sweden,SWE,0,5,105,82,192
2011,Angola,AGO,Sweden,SWE,0,0,10,0,10
2011,Egypt,EGY,Sweden,SWE,10,5,104,5,124
2011,Armenia,ARM,Sweden,SWE,5,33,254,22,314
2011,Azerbaijan,AZE,Sweden,SWE,10,31,287,28,356
2011,Burundi,BDI,Sweden,SWE,0,5,0,0,5
2011,Benin,BEN,Sweden,SWE,0,0,5,0,5
2011,Bangladesh,BGD,Sweden,SWE,5,5,106,17,133
2011,Belarus,BLR,Sweden,SWE,5,5,211,100,321
2011,Bolivia (Plurinational State of),BOL,Sweden,SWE,0,5,32,0,37
2011,Botswana,BWA,Sweden,SWE,0,0,0,5,5
2011,Brazil,BRA,Sweden,SWE,0,5,0,0,5
2011,Bosnia and Herzegovina,BIH,Sweden,SWE,0,13,357,44,414
2011,Bulgaria,BGR,Sweden,SWE,0,12,5,0,17
2011,China,CHN,Sweden,SWE,26,5,50,25,106
2011,Chile,CHL,Sweden,SWE,0,5,18,5,28
2011,Cameroon,CMR,Sweden,SWE,5,5,19,5,34
2011,Congo,COG,Sweden,SWE,5,5,10,0,20
2011,Dem. Rep. of the Congo,COD,Sweden,SWE,16,33,54,5,108
2011,Colombia,COL,Sweden,SWE,0,0,14,5,19
2011,Cuba,CUB,Sweden,SWE,0,5,19,0,24
2011,Czechia,CZE,Sweden,SWE,0,0,5,0,5
2011,Denmark,DNK,Sweden,SWE,0,0,5,0,5
2011,Djibouti,DJI,Sweden,SWE,0,0,17,0,17
2011,Ecuador,ECU,Sweden,SWE,0,0,5,0,5
2011,Eritrea,ERI,Sweden,SWE,174,1020,123,52,1369
2011,Estonia,EST,Sweden,SWE,0,0,13,0,13
2011,Ethiopia,ETH,Sweden,SWE,47,26,198,16,287
2011,Gambia,GMB,Sweden,SWE,0,5,33,5,43
2011,Georgia,GEO,Sweden,SWE,5,0,129,20,154
2011,Ghana,GHA,Sweden,SWE,0,5,35,5,45
2011,Guinea,GIN,Sweden,SWE,5,5,30,5,45
2011,Honduras,HND,Sweden,SWE,0,0,5,0,5
2011,Croatia,HRV,Sweden,SWE,0,0,19,5,24
2011,Cote d'Ivoire,CIV,Sweden,SWE,5,10,24,0,39
2011,India,IND,Sweden,SWE,0,0,44,5,49
2011,Indonesia,IDN,Sweden,SWE,0,0,5,0,5
2011,Iran (Islamic Rep. of),IRN,Sweden,SWE,378,67,759,70,1274
2011,Iraq,IRQ,Sweden,SWE,590,397,909,118,2014
2011,Israel,ISR,Sweden,SWE,0,0,10,5,15
2011,Jordan,JOR,Sweden,SWE,10,5,72,12,99
2011,Japan,JPN,Sweden,SWE,0,0,5,0,5
2011,Kazakhstan,KAZ,Sweden,SWE,5,16,250,37,308
2011,Kenya,KEN,Sweden,SWE,5,11,80,10,106
2011,Kyrgyzstan,KGZ,Sweden,SWE,0,16,387,34,437
2011,Rep. of Korea,KOR,Sweden,SWE,0,0,0,5,5
2011,Kuwait,KWT,Sweden,SWE,0,0,19,0,19
2011,Liberia,LBR,Sweden,SWE,5,0,10,0,15
2011,Libya,LBY,Sweden,SWE,12,94,204,105,415
2011,Lebanon,LBN,Sweden,SWE,5,16,155,22,198
2011,Sri Lanka,LKA,Sweden,SWE,0,0,20,5,25
2011,Latvia,LVA,Sweden,SWE,0,0,5,0,5
2011,Mauritania,MRT,Sweden,SWE,0,0,5,0,5
2011,North Macedonia,MKD,Sweden,SWE,0,5,709,306,1020
2011,Mexico,MEX,Sweden,SWE,0,0,5,0,5
2011,Mali,MLI,Sweden,SWE,0,0,5,0,5
2011,Mongolia,MNG,Sweden,SWE,0,16,747,49,812
2011,Morocco,MAR,Sweden,SWE,0,10,76,26,112
2011,Montenegro,MNE,Sweden,SWE,0,5,92,0,97
2011,Myanmar,MMR,Sweden,SWE,0,5,0,12,17
2011,Nepal,NPL,Sweden,SWE,0,0,13,0,13
2011,Netherlands,NLD,Sweden,SWE,0,0,0,5,5
2011,Niger,NER,Sweden,SWE,0,0,5,0,5
2011,Nicaragua,NIC,Sweden,SWE,0,0,10,0,10
2011,Nigeria,NGA,Sweden,SWE,10,17,222,23,272
2011,Pakistan,PAK,Sweden,SWE,18,14,117,14,163
2011,Peru,PER,Sweden,SWE,0,0,5,0,5
2011,Philippines,PHL,Sweden,SWE,0,0,5,0,5
2011,Romania,ROU,Sweden,SWE,0,5,5,5,15
2011,Russian Federation,RUS,Sweden,SWE,30,58,645,113,846
2011,Rwanda,RWA,Sweden,SWE,5,5,0,0,10
2011,El Salvador,SLV,Sweden,SWE,0,5,69,0,74
2011,Saudi Arabia,SAU,Sweden,SWE,5,0,5,5,15
2011,Serbia and Kosovo: S/RES/1244 (1999),SRB,Sweden,SWE,5,124,3118,533,3780
2011,Senegal,SEN,Sweden,SWE,0,0,12,0,12
2011,Sierra Leone,SLE,Sweden,SWE,0,5,20,0,25
2011,Somalia,SOM,Sweden,SWE,222,2168,229,348,2967
2011,Viet Nam,VNM,Sweden,SWE,0,14,106,21,141
2011,Sudan,SDN,Sweden,SWE,29,16,41,12,98
2011,Syrian Arab Rep.,SYR,Sweden,SWE,91,57,334,16,498
2011,United Rep. of Tanzania,TZA,Sweden,SWE,0,5,35,5,45
2011,Thailand,THA,Sweden,SWE,0,0,0,5,5
2011,Tajikistan,TJK,Sweden,SWE,0,0,34,5,39
2011,Turkmenistan,TKM,Sweden,SWE,0,0,5,0,5
2011,Togo,TGO,Sweden,SWE,0,0,5,0,5
2011,Tunisia,TUN,Sweden,SWE,5,5,63,21,94
2011,Turkey,TUR,Sweden,SWE,5,10,147,19,181
2011,Uganda,UGA,Sweden,SWE,44,5,48,5,102
2011,Ukraine,UKR,Sweden,SWE,0,5,127,17,149
2011,United States of America,USA,Sweden,SWE,0,0,5,0,5
2011,Uzbekistan,UZB,Sweden,SWE,16,24,284,16,340
2011,Venezuela (Bolivarian Republic of),VEN,Sweden,SWE,0,0,5,0,5
2011,Yemen,YEM,Sweden,SWE,81,65,60,15,221
2011,Stateless,XXA,Sweden,SWE,125,378,519,86,1108
2011,Unknown ,,Sweden,SWE,5,19,653,57,734
2011,Afghanistan,AFG,Switzerland,CHE,25,185,48,244,502
2011,Albania,ALB,Switzerland,CHE,0,0,5,24,29
2011,Algeria,DZA,Switzerland,CHE,0,0,38,514,552
2011,Angola,AGO,Switzerland,CHE,0,49,21,11,81
2011,Egypt,EGY,Switzerland,CHE,5,0,5,63,73
2011,Armenia,ARM,Switzerland,CHE,5,5,26,86,122
2011,Azerbaijan,AZE,Switzerland,CHE,5,0,11,17,33
2011,Burundi,BDI,Switzerland,CHE,0,5,0,5,10
2011,Benin,BEN,Switzerland,CHE,0,0,0,5,5
2011,Bangladesh,BGD,Switzerland,CHE,0,0,12,16,28
2011,Bhutan,BTN,Switzerland,CHE,0,0,5,0,5
2011,Burkina Faso,BFA,Switzerland,CHE,0,0,5,17,22
2011,Belarus,BLR,Switzerland,CHE,0,0,10,92,102
2011,Bosnia and Herzegovina,BIH,Switzerland,CHE,11,5,48,91,155
2011,Bulgaria,BGR,Switzerland,CHE,0,0,0,64,64
2011,Chad,TCD,Switzerland,CHE,0,0,0,10,10
2011,China,CHN,Switzerland,CHE,51,337,40,35,463
2011,Cameroon,CMR,Switzerland,CHE,5,10,19,25,59
2011,Congo,COG,Switzerland,CHE,0,0,5,5,10
2011,Dem. Rep. of the Congo,COD,Switzerland,CHE,18,59,71,22,170
2011,Colombia,COL,Switzerland,CHE,40,0,0,5,45
2011,Cuba,CUB,Switzerland,CHE,0,0,0,5,5
2011,Czechia,CZE,Switzerland,CHE,0,0,0,14,14
2011,Djibouti,DJI,Switzerland,CHE,5,0,0,0,5
2011,Equatorial Guinea,GNQ,Switzerland,CHE,0,0,0,5,5
2011,Eritrea,ERI,Switzerland,CHE,2577,315,78,481,3451
2011,Ethiopia,ETH,Switzerland,CHE,50,34,40,46,170
2011,France,FRA,Switzerland,CHE,0,0,0,5,5
2011,Gabon,GAB,Switzerland,CHE,0,0,5,5,10
2011,Gambia,GMB,Switzerland,CHE,0,0,17,247,264
2011,Palestinian,PSE,Switzerland,CHE,10,11,0,53,74
2011,Georgia,GEO,Switzerland,CHE,5,0,11,396,412
2011,Germany,DEU,Switzerland,CHE,0,0,0,5,5
2011,Ghana,GHA,Switzerland,CHE,0,0,5,215,220
2011,Guinea-Bissau,GNB,Switzerland,CHE,0,0,15,106,121
2011,Guatemala,GTM,Switzerland,CHE,0,0,5,0,5
2011,Guinea,GIN,Switzerland,CHE,5,5,21,262,293
2011,Haiti,HTI,Switzerland,CHE,0,0,0,5,5
2011,Croatia,HRV,Switzerland,CHE,0,0,0,5,5
2011,Hungary,HUN,Switzerland,CHE,0,0,0,5,5
2011,Cote d'Ivoire,CIV,Switzerland,CHE,5,0,5,119,129
2011,India,IND,Switzerland,CHE,0,5,5,27,37
2011,Iran (Islamic Rep. of),IRN,Switzerland,CHE,84,68,36,118,306
2011,Iraq,IRQ,Switzerland,CHE,78,140,80,243,541
2011,Italy,ITA,Switzerland,CHE,0,0,0,10,10
2011,Kazakhstan,KAZ,Switzerland,CHE,0,0,0,10,10
2011,Kenya,KEN,Switzerland,CHE,5,5,0,13,23
2011,Kyrgyzstan,KGZ,Switzerland,CHE,0,0,13,5,18
2011,Liberia,LBR,Switzerland,CHE,5,0,0,77,82
2011,Libya,LBY,Switzerland,CHE,16,0,0,166,182
2011,Lebanon,LBN,Switzerland,CHE,0,0,0,18,18
2011,Sri Lanka,LKA,Switzerland,CHE,90,100,478,187,855
2011,Lithuania,LTU,Switzerland,CHE,0,0,0,10,10
2011,Mauritania,MRT,Switzerland,CHE,0,0,0,36,36
2011,North Macedonia,MKD,Switzerland,CHE,0,13,133,578,724
2011,Rep. of Moldova,MDA,Switzerland,CHE,0,0,0,25,25
2011,Mali,MLI,Switzerland,CHE,0,0,0,51,51
2011,Malawi,MWI,Switzerland,CHE,0,0,0,5,5
2011,Mongolia,MNG,Switzerland,CHE,0,0,24,54,78
2011,Morocco,MAR,Switzerland,CHE,0,0,23,349,372
2011,Montenegro,MNE,Switzerland,CHE,0,0,0,11,11
2011,Nepal,NPL,Switzerland,CHE,0,0,21,5,26
2011,Niger,NER,Switzerland,CHE,0,0,0,83,83
2011,Nigeria,NGA,Switzerland,CHE,0,5,21,1792,1818
2011,Pakistan,PAK,Switzerland,CHE,0,0,23,59,82
2011,Romania,ROU,Switzerland,CHE,0,0,0,36,36
2011,Russian Federation,RUS,Switzerland,CHE,49,33,73,174,329
2011,Rwanda,RWA,Switzerland,CHE,5,0,0,5,10
2011,Serbia and Kosovo: S/RES/1244 (1999),SRB,Switzerland,CHE,14,96,433,730,1273
2011,Senegal,SEN,Switzerland,CHE,0,0,10,113,123
2011,Sierra Leone,SLE,Switzerland,CHE,0,0,5,77,82
2011,Somalia,SOM,Switzerland,CHE,152,282,18,195,647
2011,Spain,ESP,Switzerland,CHE,0,0,0,5,5
2011,Viet Nam,VNM,Switzerland,CHE,5,0,0,5,10
2011,Sudan,SDN,Switzerland,CHE,13,5,0,73,91
2011,Slovakia,SVK,Switzerland,CHE,0,0,0,5,5
2011,Syrian Arab Rep.,SYR,Switzerland,CHE,115,215,42,203,575
2011,United Rep. of Tanzania,TZA,Switzerland,CHE,0,0,0,5,5
2011,Togo,TGO,Switzerland,CHE,41,10,15,51,117
2011,Tunisia,TUN,Switzerland,CHE,5,0,49,2042,2096
2011,Turkey,TUR,Switzerland,CHE,139,23,115,137,414
2011,Uganda,UGA,Switzerland,CHE,0,0,0,11,11
2011,Ukraine,UKR,Switzerland,CHE,0,0,5,21,26
2011,United States of America,USA,Switzerland,CHE,0,0,0,5,5
2011,Uzbekistan,UZB,Switzerland,CHE,5,5,5,5,20
2011,Western Sahara,ESH,Switzerland,CHE,0,0,0,5,5
2011,Yemen,YEM,Switzerland,CHE,13,13,0,22,48
2011,Zimbabwe,ZWE,Switzerland,CHE,0,0,0,25,25
2011,Stateless,XXA,Switzerland,CHE,0,5,0,0,5
2011,Unknown ,,Switzerland,CHE,38,30,52,170,290
2011,Afghanistan,AFG,Turkmenistan,TKM,0,0,0,5,5
2011,Benin,BEN,Togo,TGO,5,0,0,0,5
2011,Central African Rep.,CAF,Togo,TGO,5,0,0,0,5
2011,Congo,COG,Togo,TGO,10,0,0,0,10
2011,Dem. Rep. of the Congo,COD,Togo,TGO,12,0,5,0,17
2011,Guinea,GIN,Togo,TGO,0,0,5,0,5
2011,Cote d'Ivoire,CIV,Togo,TGO,0,5022,0,0,5022
2011,Rwanda,RWA,Togo,TGO,5,0,0,0,5
2011,Colombia,COL,Uruguay,URY,0,0,0,5,5
2011,Colombia,COL,Venezuela (Bolivarian Republic of),VEN,490,0,1165,0,1655
2011,Burundi,BDI,Zambia,ZMB,5,0,10,0,15
2011,Dem. Rep. of the Congo,COD,Zambia,ZMB,127,0,18,0,145
2011,Eritrea,ERI,Zambia,ZMB,0,0,5,0,5
2011,Ethiopia,ETH,Zambia,ZMB,5,0,0,5,10
2011,Rwanda,RWA,Zambia,ZMB,0,0,10,0,10
2011,Somalia,SOM,Zambia,ZMB,64,0,0,0,64
2011,Burundi,BDI,Zimbabwe,ZWE,0,0,10,11,21
2011,Dem. Rep. of the Congo,COD,Zimbabwe,ZWE,0,146,132,339,617
2011,Rwanda,RWA,Zimbabwe,ZWE,0,10,11,0,21
2011,Somalia,SOM,Zimbabwe,ZWE,0,0,0,10,10
2012,Armenia,ARM,Argentina,ARG,5,0,5,0,10
2012,Bangladesh,BGD,Argentina,ARG,0,0,35,0,35
2012,China,CHN,Argentina,ARG,0,0,17,0,17
2012,Chile,CHL,Argentina,ARG,0,0,5,0,5
2012,Cameroon,CMR,Argentina,ARG,0,0,10,10,20
2012,Dem. Rep. of the Congo,COD,Argentina,ARG,5,0,0,5,10
2012,Colombia,COL,Argentina,ARG,35,0,63,99,197
2012,Cuba,CUB,Argentina,ARG,0,0,24,10,34
2012,Dominican Rep.,DOM,Argentina,ARG,0,0,94,26,120
2012,Ghana,GHA,Argentina,ARG,10,0,5,5,20
2012,Haiti,HTI,Argentina,ARG,0,0,11,5,16
2012,Cote d'Ivoire,CIV,Argentina,ARG,0,0,0,5,5
2012,India,IND,Argentina,ARG,0,0,11,10,21
2012,Liberia,LBR,Argentina,ARG,5,0,0,10,15
2012,Nigeria,NGA,Argentina,ARG,5,0,29,24,58
2012,Peru,PER,Argentina,ARG,0,0,0,5,5
2012,South Africa,ZAF,Argentina,ARG,0,0,5,0,5
2012,Senegal,SEN,Argentina,ARG,0,0,66,5,71
2012,Syrian Arab Rep.,SYR,Argentina,ARG,40,0,0,0,40
2012,Venezuela (Bolivarian Republic of),VEN,Argentina,ARG,0,0,5,0,5
2012,Yemen,YEM,Argentina,ARG,15,0,0,0,15
2012,Stateless,XXA,Argentina,ARG,5,0,0,0,5
2012,Congo,COG,Armenia,ARM,0,0,5,0,5
2012,Iran (Islamic Rep. of),IRN,Armenia,ARM,5,0,10,5,20
2012,Iraq,IRQ,Armenia,ARM,20,0,0,0,20
2012,Liberia,LBR,Armenia,ARM,0,0,0,10,10
2012,Syrian Arab Rep.,SYR,Armenia,ARM,130,0,0,26,156
2012,Turkey,TUR,Armenia,ARM,0,0,0,5,5
2012,Afghanistan,AFG,Australia,AUS,1874,0,496,79,2449
2012,Albania,ALB,Australia,AUS,5,0,15,0,20
2012,Egypt,EGY,Australia,AUS,140,0,210,0,350
2012,Bahrain,BHR,Australia,AUS,5,0,5,0,10
2012,Burundi,BDI,Australia,AUS,0,0,5,0,5
2012,Bangladesh,BGD,Australia,AUS,45,0,105,0,150
2012,Brazil,BRA,Australia,AUS,0,0,14,0,14
2012,Cambodia,KHM,Australia,AUS,0,0,18,0,18
2012,China,CHN,Australia,AUS,70,0,1013,0,1083
2012,Dem. Rep. of the Congo,COD,Australia,AUS,5,0,0,0,5
2012,Colombia,COL,Australia,AUS,0,0,29,0,29
2012,Djibouti,DJI,Australia,AUS,0,0,5,0,5
2012,Estonia,EST,Australia,AUS,0,0,5,0,5
2012,Ethiopia,ETH,Australia,AUS,5,0,15,0,20
2012,Fiji,FJI,Australia,AUS,29,0,225,0,254
2012,Palestinian,PSE,Australia,AUS,48,0,5,0,53
2012,United Kingdom of Great Britain and Northern Ireland,GBR,Australia,AUS,0,0,20,0,20
2012,Georgia,GEO,Australia,AUS,0,0,13,0,13
2012,Germany,DEU,Australia,AUS,0,0,5,0,5
2012,Ghana,GHA,Australia,AUS,0,0,18,0,18
2012,Guinea,GIN,Australia,AUS,0,0,5,0,5
2012,"China, Hong Kong SAR",HKG,Australia,AUS,0,0,16,0,16
2012,Hungary,HUN,Australia,AUS,0,0,5,0,5
2012,India,IND,Australia,AUS,0,0,714,0,714
2012,Indonesia,IDN,Australia,AUS,10,0,86,0,96
2012,Iran (Islamic Rep. of),IRN,Australia,AUS,1023,0,488,73,1584
2012,Iraq,IRQ,Australia,AUS,342,0,118,27,487
2012,Israel,ISR,Australia,AUS,0,0,5,0,5
2012,Jordan,JOR,Australia,AUS,12,0,38,0,50
2012,Japan,JPN,Australia,AUS,0,0,5,0,5
2012,Kenya,KEN,Australia,AUS,5,0,26,0,31
2012,Rep. of Korea,KOR,Australia,AUS,5,0,52,0,57
2012,Liberia,LBR,Australia,AUS,0,0,5,0,5
2012,Libya,LBY,Australia,AUS,81,0,80,0,161
2012,Lebanon,LBN,Australia,AUS,18,0,208,0,226
2012,Sri Lanka,LKA,Australia,AUS,166,0,490,296,952
2012,North Macedonia,MKD,Australia,AUS,0,0,5,0,5
2012,Malaysia,MYS,Australia,AUS,10,0,134,0,144
2012,Mongolia,MNG,Australia,AUS,0,0,5,0,5
2012,Mauritius,MUS,Australia,AUS,0,0,25,0,25
2012,Myanmar,MMR,Australia,AUS,49,0,12,0,61
2012,Nepal,NPL,Australia,AUS,5,0,272,0,277
2012,Nigeria,NGA,Australia,AUS,0,0,60,0,60
2012,New Zealand,NZL,Australia,AUS,0,0,10,0,10
2012,Pakistan,PAK,Australia,AUS,669,0,444,59,1172
2012,Peru,PER,Australia,AUS,0,0,14,0,14
2012,Philippines,PHL,Australia,AUS,5,0,46,0,51
2012,Papua New Guinea,PNG,Australia,AUS,30,0,16,0,46
2012,Portugal,PRT,Australia,AUS,0,0,5,0,5
2012,Romania,ROU,Australia,AUS,0,0,5,0,5
2012,South Africa,ZAF,Australia,AUS,0,0,10,0,10
2012,Russian Federation,RUS,Australia,AUS,0,0,16,0,16
2012,Rwanda,RWA,Australia,AUS,5,0,5,0,10
2012,Saudi Arabia,SAU,Australia,AUS,13,0,0,0,13
2012,Singapore,SGP,Australia,AUS,0,0,10,0,10
2012,Somalia,SOM,Australia,AUS,5,0,11,0,16
2012,Viet Nam,VNM,Australia,AUS,5,0,67,0,72
2012,Sudan,SDN,Australia,AUS,5,0,5,0,10
2012,Syrian Arab Rep.,SYR,Australia,AUS,117,0,11,0,128
2012,Thailand,THA,Australia,AUS,0,0,18,0,18
2012,Tonga,TON,Australia,AUS,5,0,41,0,46
2012,Turkey,TUR,Australia,AUS,36,0,56,0,92
2012,Uganda,UGA,Australia,AUS,0,0,12,0,12
2012,Ukraine,UKR,Australia,AUS,0,0,16,0,16
2012,United States of America,USA,Australia,AUS,0,0,10,0,10
2012,Yemen,YEM,Australia,AUS,5,0,5,0,10
2012,Zimbabwe,ZWE,Australia,AUS,28,0,90,0,118
2012,Stateless,XXA,Australia,AUS,349,0,109,0,458
2012,Afghanistan,AFG,Azerbaijan,AZE,5,0,43,0,48
2012,Algeria,DZA,Azerbaijan,AZE,0,0,5,0,5
2012,Palestinian,PSE,Azerbaijan,AZE,0,0,5,0,5
2012,Iran (Islamic Rep. of),IRN,Azerbaijan,AZE,0,0,5,0,5
2012,Pakistan,PAK,Azerbaijan,AZE,0,0,27,0,27
2012,Syrian Arab Rep.,SYR,Azerbaijan,AZE,0,0,5,0,5
2012,Afghanistan,AFG,Belgium,BEL,567,937,1021,39,2564
2012,Albania,ALB,Belgium,BEL,218,5,1298,157,1678
2012,Algeria,DZA,Belgium,BEL,10,0,111,41,162
2012,Angola,AGO,Belgium,BEL,5,0,146,5,156
2012,Egypt,EGY,Belgium,BEL,0,0,38,0,38
2012,Argentina,ARG,Belgium,BEL,0,5,5,0,10
2012,Armenia,ARM,Belgium,BEL,17,10,449,19,495
2012,Azerbaijan,AZE,Belgium,BEL,12,0,148,11,171
2012,Burundi,BDI,Belgium,BEL,44,0,233,12,289
2012,Benin,BEN,Belgium,BEL,5,0,59,5,69
2012,Bangladesh,BGD,Belgium,BEL,0,0,343,26,369
2012,Bhutan,BTN,Belgium,BEL,0,0,11,0,11
2012,Burkina Faso,BFA,Belgium,BEL,22,0,101,0,123
2012,Belarus,BLR,Belgium,BEL,10,0,81,11,102
2012,Bosnia and Herzegovina,BIH,Belgium,BEL,5,0,320,35,360
2012,Bulgaria,BGR,Belgium,BEL,0,0,25,0,25
2012,Canada,CAN,Belgium,BEL,0,0,5,0,5
2012,Central African Rep.,CAF,Belgium,BEL,0,0,5,0,5
2012,Chad,TCD,Belgium,BEL,5,0,5,0,10
2012,China,CHN,Belgium,BEL,283,0,24,5,312
2012,Cameroon,CMR,Belgium,BEL,86,0,398,15,499
2012,Congo,COG,Belgium,BEL,5,0,13,0,18
2012,Dem. Rep. of the Congo,COD,Belgium,BEL,167,12,1411,78,1668
2012,Colombia,COL,Belgium,BEL,0,0,5,0,5
2012,Cuba,CUB,Belgium,BEL,0,0,5,0,5
2012,Djibouti,DJI,Belgium,BEL,20,0,54,0,74
2012,Equatorial Guinea,GNQ,Belgium,BEL,5,0,0,0,5
2012,Eritrea,ERI,Belgium,BEL,12,0,12,0,24
2012,Ethiopia,ETH,Belgium,BEL,0,0,13,0,13
2012,Gabon,GAB,Belgium,BEL,0,0,5,0,5
2012,Gambia,GMB,Belgium,BEL,5,0,43,5,53
2012,Palestinian,PSE,Belgium,BEL,0,10,0,0,10
2012,Georgia,GEO,Belgium,BEL,5,5,496,57,563
2012,Ghana,GHA,Belgium,BEL,5,0,88,5,98
2012,Guinea-Bissau,GNB,Belgium,BEL,0,0,5,0,5
2012,Guatemala,GTM,Belgium,BEL,0,5,0,0,5
2012,Guinea,GIN,Belgium,BEL,608,10,2202,97,2917
2012,Croatia,HRV,Belgium,BEL,0,0,23,0,23
2012,Hungary,HUN,Belgium,BEL,0,0,5,0,5
2012,Cote d'Ivoire,CIV,Belgium,BEL,42,0,287,19,348
2012,India,IND,Belgium,BEL,0,0,112,11,123
2012,Iran (Islamic Rep. of),IRN,Belgium,BEL,169,0,120,44,333
2012,Iraq,IRQ,Belgium,BEL,290,17,891,131,1329
2012,Israel,ISR,Belgium,BEL,0,0,5,0,5
2012,Jordan,JOR,Belgium,BEL,0,0,10,5,15
2012,Kazakhstan,KAZ,Belgium,BEL,5,0,266,45,316
2012,Kenya,KEN,Belgium,BEL,10,0,43,5,58
2012,Kyrgyzstan,KGZ,Belgium,BEL,35,0,187,21,243
2012,Dem. People's Rep. of Korea,PRK,Belgium,BEL,24,0,0,24,48
2012,Liberia,LBR,Belgium,BEL,0,0,25,0,25
2012,Lebanon,LBN,Belgium,BEL,0,0,37,17,54
2012,Sri Lanka,LKA,Belgium,BEL,43,0,31,5,79
2012,Madagascar,MDG,Belgium,BEL,0,0,5,0,5
2012,Mauritania,MRT,Belgium,BEL,51,0,189,19,259
2012,North Macedonia,MKD,Belgium,BEL,16,0,596,56,668
2012,Rep. of Moldova,MDA,Belgium,BEL,0,0,11,5,16
2012,Mali,MLI,Belgium,BEL,5,0,10,5,20
2012,Mongolia,MNG,Belgium,BEL,0,0,43,5,48
2012,Morocco,MAR,Belgium,BEL,5,0,51,14,70
2012,Montenegro,MNE,Belgium,BEL,0,0,122,5,127
2012,Mauritius,MUS,Belgium,BEL,0,0,5,0,5
2012,Myanmar,MMR,Belgium,BEL,0,0,5,0,5
2012,Nepal,NPL,Belgium,BEL,5,0,253,36,294
2012,Niger,NER,Belgium,BEL,5,0,81,5,91
2012,Nicaragua,NIC,Belgium,BEL,0,0,5,0,5
2012,Nigeria,NGA,Belgium,BEL,10,0,139,5,154
2012,Pakistan,PAK,Belgium,BEL,21,5,380,44,450
2012,Romania,ROU,Belgium,BEL,0,0,51,0,51
2012,Russian Federation,RUS,Belgium,BEL,375,0,1443,73,1891
2012,Rwanda,RWA,Belgium,BEL,141,0,412,13,566
2012,El Salvador,SLV,Belgium,BEL,0,0,10,0,10
2012,Serbia and Kosovo: S/RES/1244 (1999),SRB,Belgium,BEL,144,14,1979,142,2279
2012,Senegal,SEN,Belgium,BEL,50,0,279,10,339
2012,Sierra Leone,SLE,Belgium,BEL,5,0,40,5,50
2012,Somalia,SOM,Belgium,BEL,101,32,185,11,329
2012,Sudan,SDN,Belgium,BEL,36,10,29,5,80
2012,Suriname,SUR,Belgium,BEL,0,0,5,0,5
2012,Slovakia,SVK,Belgium,BEL,0,0,23,0,23
2012,Syrian Arab Rep.,SYR,Belgium,BEL,128,468,0,32,628
2012,United Rep. of Tanzania,TZA,Belgium,BEL,5,0,73,5,83
2012,Tajikistan,TJK,Belgium,BEL,0,0,10,0,10
2012,Togo,TGO,Belgium,BEL,22,0,204,5,231
2012,Tunisia,TUN,Belgium,BEL,0,0,13,5,18
2012,Turkey,TUR,Belgium,BEL,75,0,193,27,295
2012,Uganda,UGA,Belgium,BEL,5,0,13,0,18
2012,Ukraine,UKR,Belgium,BEL,10,0,76,16,102
2012,United States of America,USA,Belgium,BEL,0,0,5,0,5
2012,Uzbekistan,UZB,Belgium,BEL,5,0,15,5,25
2012,Stateless,XXA,Belgium,BEL,0,0,5,0,5
2012,Unknown ,,Belgium,BEL,70,25,101,24,220
2012,Cameroon,CMR,Benin,BEN,0,0,0,10,10
2012,Congo,COG,Benin,BEN,5,0,0,0,5
2012,Dem. Rep. of the Congo,COD,Benin,BEN,0,0,0,45,45
2012,Eritrea,ERI,Benin,BEN,0,0,13,0,13
2012,Cote d'Ivoire,CIV,Benin,BEN,148,0,0,109,257
2012,Mali,MLI,Benin,BEN,5,0,0,0,5
2012,Niger,NER,Benin,BEN,0,0,0,5,5
2012,Nigeria,NGA,Benin,BEN,0,0,28,0,28
2012,Sudan,SDN,Benin,BEN,0,0,0,5,5
2012,Togo,TGO,Benin,BEN,0,0,0,26,26
2012,Afghanistan,AFG,Belarus,BLR,10,0,27,5,42
2012,Georgia,GEO,Belarus,BLR,0,0,10,0,10
2012,Iran (Islamic Rep. of),IRN,Belarus,BLR,5,0,0,0,5
2012,Syrian Arab Rep.,SYR,Belarus,BLR,0,0,0,5,5
2012,Argentina,ARG,Bolivia (Plurinational State of),BOL,0,0,0,5,5
2012,Colombia,COL,Bolivia (Plurinational State of),BOL,13,5,19,5,42
2012,Afghanistan,AFG,Brazil,BRA,5,0,0,0,5
2012,Angola,AGO,Brazil,BRA,5,0,29,0,34
2012,Egypt,EGY,Brazil,BRA,0,0,5,0,5
2012,Bangladesh,BGD,Brazil,BRA,0,0,56,5,61
2012,Bhutan,BTN,Brazil,BRA,13,0,0,0,13
2012,Bolivia (Plurinational State of),BOL,Brazil,BRA,5,0,0,0,5
2012,Dem. Rep. of the Congo,COD,Brazil,BRA,40,0,35,0,75
2012,Colombia,COL,Brazil,BRA,52,0,84,0,136
2012,Cuba,CUB,Brazil,BRA,0,0,28,0,28
2012,Dominican Rep.,DOM,Brazil,BRA,0,0,5,0,5
2012,Ecuador,ECU,Brazil,BRA,0,0,5,0,5
2012,Ghana,GHA,Brazil,BRA,0,0,5,0,5
2012,Guinea-Bissau,GNB,Brazil,BRA,0,0,67,0,67
2012,Guinea,GIN,Brazil,BRA,0,0,5,0,5
2012,Cote d'Ivoire,CIV,Brazil,BRA,5,0,0,0,5
2012,India,IND,Brazil,BRA,0,0,5,0,5
2012,Iraq,IRQ,Brazil,BRA,5,0,0,0,5
2012,Morocco,MAR,Brazil,BRA,0,0,5,0,5
2012,Nigeria,NGA,Brazil,BRA,5,0,41,0,46
2012,Pakistan,PAK,Brazil,BRA,0,0,41,0,41
2012,Senegal,SEN,Brazil,BRA,5,0,26,0,31
2012,Sierra Leone,SLE,Brazil,BRA,0,0,5,0,5
2012,Somalia,SOM,Brazil,BRA,0,0,13,0,13
2012,Sudan,SDN,Brazil,BRA,0,0,5,0,5
2012,Syrian Arab Rep.,SYR,Brazil,BRA,36,0,0,0,36
2012,Venezuela (Bolivarian Republic of),VEN,Brazil,BRA,0,0,5,0,5
2012,Guatemala,GTM,Belize,BLZ,0,0,5,5,10
2012,El Salvador,SLV,Belize,BLZ,0,0,33,0,33
2012,Sri Lanka,LKA,Cambodia,KHM,0,0,0,5,5
2012,Myanmar,MMR,Cambodia,KHM,12,0,0,5,17
2012,Afghanistan,AFG,Canada,CAN,302,0,57,35,394
2012,Albania,ALB,Canada,CAN,63,0,118,23,204
2012,Algeria,DZA,Canada,CAN,57,0,89,17,163
2012,Angola,AGO,Canada,CAN,10,0,0,0,10
2012,Antigua and Barbuda,ATG,Canada,CAN,12,0,19,5,36
2012,Egypt,EGY,Canada,CAN,89,0,28,5,122
2012,Argentina,ARG,Canada,CAN,0,0,23,5,28
2012,Armenia,ARM,Canada,CAN,12,0,14,5,31
2012,Australia,AUS,Canada,CAN,0,0,5,0,5
2012,Azerbaijan,AZE,Canada,CAN,14,0,10,0,24
2012,Bahrain,BHR,Canada,CAN,5,0,5,0,10
2012,Barbados,BRB,Canada,CAN,21,0,32,5,58
2012,Burundi,BDI,Canada,CAN,155,0,36,5,196
2012,Benin,BEN,Canada,CAN,5,0,5,0,10
2012,Bangladesh,BGD,Canada,CAN,30,0,65,15,110
2012,Bahamas,BHS,Canada,CAN,10,0,11,0,21
2012,Burkina Faso,BFA,Canada,CAN,10,0,5,0,15
2012,Belarus,BLR,Canada,CAN,10,0,10,5,25
2012,Bolivia (Plurinational State of),BOL,Canada,CAN,5,0,5,0,10
2012,Botswana,BWA,Canada,CAN,88,0,51,14,153
2012,Brazil,BRA,Canada,CAN,0,0,58,17,75
2012,Bosnia and Herzegovina,BIH,Canada,CAN,5,0,57,5,67
2012,Bulgaria,BGR,Canada,CAN,20,0,12,5,37
2012,Belize,BLZ,Canada,CAN,5,0,5,0,10
2012,Cambodia,KHM,Canada,CAN,5,0,5,5,15
2012,Central African Rep.,CAF,Canada,CAN,5,0,0,0,5
2012,Chad,TCD,Canada,CAN,17,0,5,0,22
2012,China,CHN,Canada,CAN,626,0,880,210,1716
2012,Chile,CHL,Canada,CAN,5,0,37,15,57
2012,Cameroon,CMR,Canada,CAN,100,0,44,15,159
2012,Congo,COG,Canada,CAN,42,0,36,0,78
2012,Dem. Rep. of the Congo,COD,Canada,CAN,290,0,169,29,488
2012,Colombia,COL,Canada,CAN,482,0,731,113,1326
2012,Costa Rica,CRI,Canada,CAN,0,0,19,5,24
2012,Cuba,CUB,Canada,CAN,79,0,73,16,168
2012,Czechia,CZE,Canada,CAN,25,0,385,96,506
2012,Djibouti,DJI,Canada,CAN,117,0,26,5,148
2012,Dominica,DMA,Canada,CAN,0,0,5,0,5
2012,Dominican Rep.,DOM,Canada,CAN,21,0,70,30,121
2012,Ecuador,ECU,Canada,CAN,5,0,35,5,45
2012,Eritrea,ERI,Canada,CAN,154,0,17,5,176
2012,Estonia,EST,Canada,CAN,5,0,5,0,10
2012,Ethiopia,ETH,Canada,CAN,158,0,17,10,185
2012,Fiji,FJI,Canada,CAN,5,0,28,5,38
2012,France,FRA,Canada,CAN,0,0,18,17,35
2012,Gabon,GAB,Canada,CAN,10,0,0,5,15
2012,Gambia,GMB,Canada,CAN,5,0,5,5,15
2012,Palestinian,PSE,Canada,CAN,26,0,11,5,42
2012,United Kingdom of Great Britain and Northern Ireland,GBR,Canada,CAN,0,0,15,5,20
2012,Georgia,GEO,Canada,CAN,25,0,41,17,83
2012,Germany,DEU,Canada,CAN,0,0,10,5,15
2012,Ghana,GHA,Canada,CAN,37,0,53,5,95
2012,Greece,GRC,Canada,CAN,0,0,24,5,29
2012,Grenada,GRD,Canada,CAN,5,0,21,5,31
2012,Guatemala,GTM,Canada,CAN,74,0,205,28,307
2012,Guinea,GIN,Canada,CAN,68,0,39,5,112
2012,Guyana,GUY,Canada,CAN,18,0,40,10,68
2012,Haiti,HTI,Canada,CAN,571,0,605,46,1222
2012,"China, Hong Kong SAR",HKG,Canada,CAN,0,0,19,26,45
2012,Honduras,HND,Canada,CAN,131,0,193,40,364
2012,Croatia,HRV,Canada,CAN,23,0,246,77,346
2012,Hungary,HUN,Canada,CAN,448,0,2151,1553,4152
2012,Cote d'Ivoire,CIV,Canada,CAN,42,0,32,11,85
2012,India,IND,Canada,CAN,118,0,288,169,575
2012,Indonesia,IDN,Canada,CAN,14,0,21,0,35
2012,Ireland,IRL,Canada,CAN,0,0,5,0,5
2012,Iran (Islamic Rep. of),IRN,Canada,CAN,245,0,44,19,308
2012,Iraq,IRQ,Canada,CAN,90,0,34,13,137
2012,Israel,ISR,Canada,CAN,19,0,180,87,286
2012,Italy,ITA,Canada,CAN,0,0,15,11,26
2012,Jamaica,JAM,Canada,CAN,134,0,179,50,363
2012,Jordan,JOR,Canada,CAN,17,0,30,5,52
2012,Japan,JPN,Canada,CAN,0,0,22,5,27
2012,Kazakhstan,KAZ,Canada,CAN,10,0,5,10,25
2012,Kenya,KEN,Canada,CAN,51,0,22,0,73
2012,Kyrgyzstan,KGZ,Canada,CAN,5,0,5,0,10
2012,Rep. of Korea,KOR,Canada,CAN,10,0,59,27,96
2012,Dem. People's Rep. of Korea,PRK,Canada,CAN,230,0,18,42,290
2012,Kuwait,KWT,Canada,CAN,17,0,0,11,28
2012,Lao People's Dem. Rep.,LAO,Canada,CAN,0,0,10,0,10
2012,Liberia,LBR,Canada,CAN,15,0,12,0,27
2012,Libya,LBY,Canada,CAN,34,0,33,22,89
2012,Saint Lucia,LCA,Canada,CAN,300,0,236,62,598
2012,Lebanon,LBN,Canada,CAN,47,0,79,15,141
2012,Sri Lanka,LKA,Canada,CAN,371,0,269,20,660
2012,Lithuania,LTU,Canada,CAN,14,0,14,31,59
2012,Latvia,LVA,Canada,CAN,23,0,44,14,81
2012,Madagascar,MDG,Canada,CAN,0,0,5,0,5
2012,Mauritania,MRT,Canada,CAN,17,0,5,5,27
2012,North Macedonia,MKD,Canada,CAN,17,0,15,0,32
2012,Rep. of Moldova,MDA,Canada,CAN,16,0,21,10,47
2012,Mexico,MEX,Canada,CAN,568,0,2144,310,3022
2012,Mali,MLI,Canada,CAN,5,0,5,5,15
2012,Malaysia,MYS,Canada,CAN,5,0,10,0,15
2012,Malawi,MWI,Canada,CAN,5,0,5,0,10
2012,Mongolia,MNG,Canada,CAN,5,0,10,0,15
2012,Morocco,MAR,Canada,CAN,13,0,21,21,55
2012,Montenegro,MNE,Canada,CAN,0,0,5,0,5
2012,Namibia,NAM,Canada,CAN,170,0,354,28,552
2012,Nepal,NPL,Canada,CAN,38,0,20,0,58
2012,Netherlands,NLD,Canada,CAN,0,0,13,5,18
2012,Niger,NER,Canada,CAN,13,0,5,0,18
2012,Nicaragua,NIC,Canada,CAN,15,0,19,10,44
2012,Nigeria,NGA,Canada,CAN,521,0,388,32,941
2012,Pakistan,PAK,Canada,CAN,500,0,182,54,736
2012,Panama,PAN,Canada,CAN,0,0,11,0,11
2012,Paraguay,PRY,Canada,CAN,0,0,5,0,5
2012,Peru,PER,Canada,CAN,31,0,101,15,147
2012,Philippines,PHL,Canada,CAN,11,0,121,15,147
2012,Poland,POL,Canada,CAN,24,0,128,90,242
2012,Portugal,PRT,Canada,CAN,0,0,75,0,75
2012,Qatar,QAT,Canada,CAN,5,0,0,0,5
2012,Romania,ROU,Canada,CAN,39,0,47,60,146
2012,South Africa,ZAF,Canada,CAN,5,0,15,5,25
2012,Russian Federation,RUS,Canada,CAN,104,0,56,23,183
2012,Rwanda,RWA,Canada,CAN,98,0,54,5,157
2012,El Salvador,SLV,Canada,CAN,188,0,358,30,576
2012,Saudi Arabia,SAU,Canada,CAN,5,0,10,10,25
2012,Serbia and Kosovo: S/RES/1244 (1999),SRB,Canada,CAN,40,0,68,20,128
2012,Senegal,SEN,Canada,CAN,29,0,21,10,60
2012,Singapore,SGP,Canada,CAN,5,0,5,5,15
2012,Sierra Leone,SLE,Canada,CAN,17,0,5,0,22
2012,Somalia,SOM,Canada,CAN,354,0,28,85,467
2012,Spain,ESP,Canada,CAN,0,0,48,10,58
2012,Viet Nam,VNM,Canada,CAN,10,0,15,5,30
2012,Saint Kitts and Nevis,KNA,Canada,CAN,5,0,0,0,5
2012,Sudan,SDN,Canada,CAN,47,0,10,5,62
2012,Slovakia,SVK,Canada,CAN,15,0,160,283,458
2012,Slovenia,SVN,Canada,CAN,5,0,5,0,10
2012,Eswatini,SWZ,Canada,CAN,57,0,14,0,71
2012,Sweden,SWE,Canada,CAN,0,0,0,5,5
2012,Syrian Arab Rep.,SYR,Canada,CAN,155,0,34,5,194
2012,United Rep. of Tanzania,TZA,Canada,CAN,11,0,10,0,21
2012,Thailand,THA,Canada,CAN,5,0,19,10,34
2012,Tajikistan,TJK,Canada,CAN,5,0,5,0,10
2012,Togo,TGO,Canada,CAN,11,0,5,0,16
2012,Trinidad and Tobago,TTO,Canada,CAN,10,0,28,12,50
2012,Tunisia,TUN,Canada,CAN,22,0,30,13,65
2012,Turkey,TUR,Canada,CAN,162,0,138,44,344
2012,United Arab Emirates,ARE,Canada,CAN,5,0,0,0,5
2012,Uganda,UGA,Canada,CAN,47,0,10,5,62
2012,Ukraine,UKR,Canada,CAN,72,0,57,23,152
2012,Uruguay,URY,Canada,CAN,0,0,12,5,17
2012,United States of America,USA,Canada,CAN,5,0,317,81,403
2012,Uzbekistan,UZB,Canada,CAN,24,0,10,5,39
2012,Saint Vincent and the Grenadines,VCT,Canada,CAN,308,0,400,64,772
2012,Venezuela (Bolivarian Republic of),VEN,Canada,CAN,74,0,86,20,180
2012,Yemen,YEM,Canada,CAN,14,0,5,0,19
2012,Zambia,ZMB,Canada,CAN,0,0,5,0,5
2012,Zimbabwe,ZWE,Canada,CAN,32,0,23,5,60
2012,Unknown ,,Canada,CAN,5,0,5,5,15
2012,Colombia,COL,Chile,CHL,10,0,159,0,169
2012,Cuba,CUB,Chile,CHL,0,0,5,0,5
2012,Nepal,NPL,Chile,CHL,0,0,5,0,5
2012,Afghanistan,AFG,Colombia,COL,0,0,0,5,5
2012,Cuba,CUB,Colombia,COL,0,0,43,10,53
2012,Ecuador,ECU,Colombia,COL,5,0,0,0,5
2012,Eritrea,ERI,Colombia,COL,0,0,0,29,29
2012,Ethiopia,ETH,Colombia,COL,0,0,0,5,5
2012,Nepal,NPL,Colombia,COL,0,0,0,5,5
2012,Peru,PER,Colombia,COL,0,0,5,0,5
2012,Somalia,SOM,Colombia,COL,0,0,0,11,11
2012,Venezuela (Bolivarian Republic of),VEN,Colombia,COL,0,0,5,0,5
2012,Bangladesh,BGD,Costa Rica,CRI,0,0,10,0,10
2012,Dem. Rep. of the Congo,COD,Costa Rica,CRI,0,0,0,5,5
2012,Colombia,COL,Costa Rica,CRI,62,0,187,215,464
2012,Cuba,CUB,Costa Rica,CRI,41,0,56,265,362
2012,Honduras,HND,Costa Rica,CRI,0,0,11,0,11
2012,Nepal,NPL,Costa Rica,CRI,0,0,10,5,15
2012,Nicaragua,NIC,Costa Rica,CRI,0,0,0,5,5
2012,Nigeria,NGA,Costa Rica,CRI,5,0,5,0,10
2012,El Salvador,SLV,Costa Rica,CRI,5,0,43,30,78
2012,Venezuela (Bolivarian Republic of),VEN,Costa Rica,CRI,10,0,5,0,15
2012,Afghanistan,AFG,Cyprus,CYP,0,0,43,0,43
2012,Egypt,EGY,Cyprus,CYP,0,0,149,28,177
2012,Bangladesh,BGD,Cyprus,CYP,0,0,175,5,180
2012,China,CHN,Cyprus,CYP,0,0,13,0,13
2012,Cameroon,CMR,Cyprus,CYP,0,0,25,5,30
2012,Palestinian,PSE,Cyprus,CYP,50,15,83,64,212
2012,Georgia,GEO,Cyprus,CYP,0,0,5,0,5
2012,Cote d'Ivoire,CIV,Cyprus,CYP,0,0,5,0,5
2012,India,IND,Cyprus,CYP,0,0,62,14,76
2012,Iran (Islamic Rep. of),IRN,Cyprus,CYP,0,5,57,13,75
2012,Iraq,IRQ,Cyprus,CYP,18,0,76,5,99
2012,Jordan,JOR,Cyprus,CYP,5,0,10,5,20
2012,Lebanon,LBN,Cyprus,CYP,5,0,5,0,10
2012,Sri Lanka,LKA,Cyprus,CYP,0,5,53,10,68
2012,Rep. of Moldova,MDA,Cyprus,CYP,0,0,5,5,10
2012,Nepal,NPL,Cyprus,CYP,0,0,22,5,27
2012,Nigeria,NGA,Cyprus,CYP,0,0,15,0,15
2012,Pakistan,PAK,Cyprus,CYP,0,0,129,20,149
2012,Philippines,PHL,Cyprus,CYP,0,0,38,0,38
2012,Russian Federation,RUS,Cyprus,CYP,0,0,5,11,16
2012,Viet Nam,VNM,Cyprus,CYP,0,0,211,5,216
2012,Syrian Arab Rep.,SYR,Cyprus,CYP,0,0,10,55,65
2012,Turkey,TUR,Cyprus,CYP,0,0,17,0,17
2012,Ukraine,UKR,Cyprus,CYP,0,0,5,5,10
2012,Afghanistan,AFG,Czechia,CZE,0,10,0,5,15
2012,Algeria,DZA,Czechia,CZE,0,0,0,11,11
2012,Egypt,EGY,Czechia,CZE,0,0,0,5,5
2012,Armenia,ARM,Czechia,CZE,0,0,14,5,19
2012,Azerbaijan,AZE,Czechia,CZE,0,0,5,5,10
2012,Belarus,BLR,Czechia,CZE,10,25,0,15,50
2012,China,CHN,Czechia,CZE,0,0,5,5,10
2012,Cameroon,CMR,Czechia,CZE,0,0,0,5,5
2012,Dem. Rep. of the Congo,COD,Czechia,CZE,0,0,0,5,5
2012,Cuba,CUB,Czechia,CZE,0,16,0,0,16
2012,Eritrea,ERI,Czechia,CZE,0,10,0,0,10
2012,Georgia,GEO,Czechia,CZE,0,0,10,5,15
2012,India,IND,Czechia,CZE,0,0,5,0,5
2012,Iran (Islamic Rep. of),IRN,Czechia,CZE,0,0,0,5,5
2012,Iraq,IRQ,Czechia,CZE,0,5,0,5,10
2012,Kazakhstan,KAZ,Czechia,CZE,5,13,5,18,41
2012,Kyrgyzstan,KGZ,Czechia,CZE,0,0,5,13,18
2012,Libya,LBY,Czechia,CZE,0,0,0,5,5
2012,Sri Lanka,LKA,Czechia,CZE,0,5,0,0,5
2012,Rep. of Moldova,MDA,Czechia,CZE,0,0,5,0,5
2012,Mongolia,MNG,Czechia,CZE,0,0,17,14,31
2012,Myanmar,MMR,Czechia,CZE,5,0,0,0,5
2012,Nigeria,NGA,Czechia,CZE,0,0,11,11,22
2012,Pakistan,PAK,Czechia,CZE,5,0,5,5,15
2012,Poland,POL,Czechia,CZE,0,0,0,5,5
2012,Russian Federation,RUS,Czechia,CZE,5,0,23,17,45
2012,Saudi Arabia,SAU,Czechia,CZE,5,0,0,0,5
2012,Serbia and Kosovo: S/RES/1244 (1999),SRB,Czechia,CZE,0,0,5,10,15
2012,Viet Nam,VNM,Czechia,CZE,0,0,32,23,55
2012,Slovakia,SVK,Czechia,CZE,0,0,0,5,5
2012,Syrian Arab Rep.,SYR,Czechia,CZE,0,22,0,10,32
2012,Tunisia,TUN,Czechia,CZE,0,0,5,0,5
2012,Turkey,TUR,Czechia,CZE,0,0,13,5,18
2012,Ukraine,UKR,Czechia,CZE,5,5,117,74,201
2012,Uzbekistan,UZB,Czechia,CZE,10,13,0,0,23
2012,Stateless,XXA,Czechia,CZE,0,17,0,10,27
2012,Afghanistan,AFG,Denmark,DNK,20,103,346,0,469
2012,Albania,ALB,Denmark,DNK,0,0,30,0,30
2012,Algeria,DZA,Denmark,DNK,0,0,10,0,10
2012,Egypt,EGY,Denmark,DNK,0,0,5,0,5
2012,Armenia,ARM,Denmark,DNK,0,0,46,0,46
2012,Azerbaijan,AZE,Denmark,DNK,0,0,18,0,18
2012,Bangladesh,BGD,Denmark,DNK,0,0,56,0,56
2012,Belarus,BLR,Denmark,DNK,0,0,19,0,19
2012,Bosnia and Herzegovina,BIH,Denmark,DNK,0,0,44,0,44
2012,China,CHN,Denmark,DNK,0,0,10,0,10
2012,Cameroon,CMR,Denmark,DNK,0,0,5,0,5
2012,Dem. Rep. of the Congo,COD,Denmark,DNK,5,5,12,0,22
2012,Eritrea,ERI,Denmark,DNK,0,5,5,0,10
2012,Ethiopia,ETH,Denmark,DNK,5,0,5,0,10
2012,Gambia,GMB,Denmark,DNK,0,0,10,0,10
2012,Georgia,GEO,Denmark,DNK,0,0,5,0,5
2012,Ghana,GHA,Denmark,DNK,0,0,14,0,14
2012,Guinea-Bissau,GNB,Denmark,DNK,0,0,5,0,5
2012,Guinea,GIN,Denmark,DNK,0,0,5,0,5
2012,Hungary,HUN,Denmark,DNK,0,0,5,0,5
2012,Cote d'Ivoire,CIV,Denmark,DNK,5,0,5,0,10
2012,India,IND,Denmark,DNK,0,0,10,0,10
2012,Iran (Islamic Rep. of),IRN,Denmark,DNK,225,38,144,0,407
2012,Iraq,IRQ,Denmark,DNK,5,5,56,0,66
2012,Kazakhstan,KAZ,Denmark,DNK,0,0,5,0,5
2012,Libya,LBY,Denmark,DNK,0,0,15,0,15
2012,Lebanon,LBN,Denmark,DNK,0,0,11,0,11
2012,Sri Lanka,LKA,Denmark,DNK,0,0,19,0,19
2012,North Macedonia,MKD,Denmark,DNK,0,0,10,0,10
2012,Mali,MLI,Denmark,DNK,0,0,5,0,5
2012,Morocco,MAR,Denmark,DNK,0,5,5,0,10
2012,Myanmar,MMR,Denmark,DNK,0,0,11,0,11
2012,Nepal,NPL,Denmark,DNK,0,0,5,0,5
2012,Nigeria,NGA,Denmark,DNK,0,0,54,0,54
2012,Pakistan,PAK,Denmark,DNK,5,5,20,0,30
2012,Russian Federation,RUS,Denmark,DNK,78,50,103,0,231
2012,Serbia and Kosovo: S/RES/1244 (1999),SRB,Denmark,DNK,0,0,510,0,510
2012,Somalia,SOM,Denmark,DNK,5,262,21,0,288
2012,Sudan,SDN,Denmark,DNK,5,0,0,0,5
2012,Syrian Arab Rep.,SYR,Denmark,DNK,606,55,81,0,742
2012,Tajikistan,TJK,Denmark,DNK,5,0,0,0,5
2012,Tunisia,TUN,Denmark,DNK,0,0,5,0,5
2012,Turkey,TUR,Denmark,DNK,0,0,13,0,13
2012,Uganda,UGA,Denmark,DNK,0,0,20,0,20
2012,Uzbekistan,UZB,Denmark,DNK,5,0,5,0,10
2012,Stateless,XXA,Denmark,DNK,52,0,52,0,104
2012,Haiti,HTI,Dominican Rep.,DOM,25,0,28,964,1017
2012,Iran (Islamic Rep. of),IRN,Dominican Rep.,DOM,0,0,0,5,5
2012,Iraq,IRQ,Dominican Rep.,DOM,5,0,0,0,5
2012,Georgia,GEO,Estonia,EST,0,5,21,10,36
2012,Russian Federation,RUS,Estonia,EST,0,0,5,0,5
2012,Somalia,SOM,Estonia,EST,5,0,0,0,5
2012,Viet Nam,VNM,Estonia,EST,0,0,5,0,5
2012,Syrian Arab Rep.,SYR,Estonia,EST,0,0,5,0,5
2012,Afghanistan,AFG,Finland,FIN,74,135,74,45,328
2012,Albania,ALB,Finland,FIN,0,0,13,11,24
2012,Algeria,DZA,Finland,FIN,0,0,21,50,71
2012,Angola,AGO,Finland,FIN,13,0,14,5,32
2012,Egypt,EGY,Finland,FIN,0,0,12,5,17
2012,Armenia,ARM,Finland,FIN,0,0,5,5,10
2012,Azerbaijan,AZE,Finland,FIN,5,0,0,10,15
2012,Bangladesh,BGD,Finland,FIN,5,0,10,5,20
2012,Belarus,BLR,Finland,FIN,0,0,13,48,61
2012,Bosnia and Herzegovina,BIH,Finland,FIN,0,0,72,26,98
2012,Bulgaria,BGR,Finland,FIN,0,0,11,0,11
2012,China,CHN,Finland,FIN,17,5,0,0,22
2012,Cameroon,CMR,Finland,FIN,0,0,19,5,24
2012,Dem. Rep. of the Congo,COD,Finland,FIN,12,5,21,11,49
2012,Colombia,COL,Finland,FIN,0,0,5,5,10
2012,Cuba,CUB,Finland,FIN,0,0,0,5,5
2012,Ecuador,ECU,Finland,FIN,0,0,0,5,5
2012,Equatorial Guinea,GNQ,Finland,FIN,0,0,5,0,5
2012,Eritrea,ERI,Finland,FIN,5,0,0,0,5
2012,Ethiopia,ETH,Finland,FIN,5,0,10,5,20
2012,Gambia,GMB,Finland,FIN,0,0,13,14,27
2012,Georgia,GEO,Finland,FIN,0,0,5,41,46
2012,Ghana,GHA,Finland,FIN,5,0,25,5,35
2012,Greece,GRC,Finland,FIN,0,0,5,0,5
2012,Guatemala,GTM,Finland,FIN,0,5,0,0,5
2012,Guinea,GIN,Finland,FIN,0,0,10,5,15
2012,Cote d'Ivoire,CIV,Finland,FIN,0,0,0,5,5
2012,India,IND,Finland,FIN,0,0,10,5,15
2012,Iran (Islamic Rep. of),IRN,Finland,FIN,84,13,44,29,170
2012,Iraq,IRQ,Finland,FIN,103,274,119,218,714
2012,Kazakhstan,KAZ,Finland,FIN,0,0,5,5,10
2012,Kenya,KEN,Finland,FIN,0,0,5,0,5
2012,Kyrgyzstan,KGZ,Finland,FIN,0,5,0,5,10
2012,Libya,LBY,Finland,FIN,0,0,5,15,20
2012,Sri Lanka,LKA,Finland,FIN,0,5,17,11,33
2012,North Macedonia,MKD,Finland,FIN,0,0,15,11,26
2012,Morocco,MAR,Finland,FIN,0,0,10,32,42
2012,Montenegro,MNE,Finland,FIN,0,0,18,5,23
2012,Myanmar,MMR,Finland,FIN,5,0,0,0,5
2012,Nigeria,NGA,Finland,FIN,5,0,26,33,64
2012,Pakistan,PAK,Finland,FIN,0,0,0,5,5
2012,Russian Federation,RUS,Finland,FIN,83,36,192,68,379
2012,Rwanda,RWA,Finland,FIN,5,0,5,0,10
2012,Serbia and Kosovo: S/RES/1244 (1999),SRB,Finland,FIN,0,0,131,49,180
2012,Senegal,SEN,Finland,FIN,0,0,5,5,10
2012,Sierra Leone,SLE,Finland,FIN,0,0,5,5,10
2012,Somalia,SOM,Finland,FIN,16,210,71,82,379
2012,Sudan,SDN,Finland,FIN,0,0,5,5,10
2012,Syrian Arab Rep.,SYR,Finland,FIN,71,71,0,28,170
2012,Tunisia,TUN,Finland,FIN,0,0,0,21,21
2012,Turkey,TUR,Finland,FIN,0,0,38,26,64
2012,United Arab Emirates,ARE,Finland,FIN,0,0,0,5,5
2012,Uganda,UGA,Finland,FIN,5,0,0,0,5
2012,Venezuela (Bolivarian Republic of),VEN,Finland,FIN,5,0,0,0,5
2012,Stateless,XXA,Finland,FIN,21,11,0,16,48
2012,Unknown ,,Finland,FIN,5,5,10,14,34
2012,Afghanistan,AFG,France,FRA,125,139,316,0,580
2012,Albania,ALB,France,FRA,10,10,431,0,451
2012,Algeria,DZA,France,FRA,20,17,1002,0,1039
2012,Angola,AGO,France,FRA,48,10,622,0,680
2012,Egypt,EGY,France,FRA,41,0,342,0,383
2012,Armenia,ARM,France,FRA,100,50,2687,0,2837
2012,Azerbaijan,AZE,France,FRA,59,0,336,0,395
2012,Burundi,BDI,France,FRA,15,0,20,0,35
2012,Benin,BEN,France,FRA,0,0,13,0,13
2012,Bangladesh,BGD,France,FRA,47,5,3551,0,3603
2012,Bhutan,BTN,France,FRA,5,0,39,0,44
2012,Burkina Faso,BFA,France,FRA,0,0,24,0,24
2012,Belarus,BLR,France,FRA,10,0,60,0,70
2012,Bolivia (Plurinational State of),BOL,France,FRA,0,0,10,0,10
2012,Brazil,BRA,France,FRA,0,0,12,0,12
2012,Bosnia and Herzegovina,BIH,France,FRA,12,0,349,0,361
2012,Bulgaria,BGR,France,FRA,0,0,5,0,5
2012,Cambodia,KHM,France,FRA,5,0,26,0,31
2012,Central African Rep.,CAF,France,FRA,10,0,51,0,61
2012,Chad,TCD,France,FRA,16,10,190,0,216
2012,China,CHN,France,FRA,375,0,2141,0,2516
2012,Chile,CHL,France,FRA,0,0,5,0,5
2012,Cameroon,CMR,France,FRA,19,5,226,0,250
2012,Congo,COG,France,FRA,46,13,600,0,659
2012,Dem. Rep. of the Congo,COD,France,FRA,331,21,3812,0,4164
2012,Comoros,COM,France,FRA,23,5,566,0,594
2012,Colombia,COL,France,FRA,13,0,85,0,98
2012,Cuba,CUB,France,FRA,5,0,11,0,16
2012,Cabo Verde,CPV,France,FRA,0,0,5,0,5
2012,Djibouti,DJI,France,FRA,0,12,10,0,22
2012,Dominica,DMA,France,FRA,0,0,5,0,5
2012,Dominican Rep.,DOM,France,FRA,0,0,107,0,107
2012,Equatorial Guinea,GNQ,France,FRA,0,0,5,0,5
2012,Eritrea,ERI,France,FRA,92,0,558,0,650
2012,Ethiopia,ETH,France,FRA,21,0,100,0,121
2012,Gabon,GAB,France,FRA,0,5,13,0,18
2012,Gambia,GMB,France,FRA,0,5,54,0,59
2012,Palestinian,PSE,France,FRA,22,0,43,0,65
2012,Georgia,GEO,France,FRA,31,5,1738,0,1774
2012,Ghana,GHA,France,FRA,0,0,25,0,25
2012,Guinea-Bissau,GNB,France,FRA,15,5,111,0,131
2012,Guinea,GIN,France,FRA,111,175,1394,0,1680
2012,Guyana,GUY,France,FRA,0,0,73,0,73
2012,Haiti,HTI,France,FRA,31,31,1705,0,1767
2012,Croatia,HRV,France,FRA,0,0,10,0,10
2012,Cote d'Ivoire,CIV,France,FRA,49,59,1043,0,1151
2012,India,IND,France,FRA,0,0,31,0,31
2012,Iran (Islamic Rep. of),IRN,France,FRA,102,5,90,0,197
2012,Iraq,IRQ,France,FRA,102,0,47,0,149
2012,Israel,ISR,France,FRA,0,0,5,0,5
2012,Jamaica,JAM,France,FRA,0,0,5,0,5
2012,Jordan,JOR,France,FRA,0,0,5,0,5
2012,Kazakhstan,KAZ,France,FRA,10,0,89,0,99
2012,Kenya,KEN,France,FRA,5,0,26,0,31
2012,Kyrgyzstan,KGZ,France,FRA,5,0,64,0,69
2012,Lao People's Dem. Rep.,LAO,France,FRA,0,0,10,0,10
2012,Liberia,LBR,France,FRA,0,0,12,0,12
2012,Libya,LBY,France,FRA,5,0,78,0,83
2012,Saint Lucia,LCA,France,FRA,0,0,5,0,5
2012,Lebanon,LBN,France,FRA,0,0,14,0,14
2012,Sri Lanka,LKA,France,FRA,188,10,2943,0,3141
2012,Madagascar,MDG,France,FRA,13,0,107,0,120
2012,Mauritania,MRT,France,FRA,49,24,1442,0,1515
2012,North Macedonia,MKD,France,FRA,5,0,433,0,438
2012,Rep. of Moldova,MDA,France,FRA,0,0,155,0,155
2012,Mexico,MEX,France,FRA,0,0,5,0,5
2012,Mali,MLI,France,FRA,17,267,313,0,597
2012,Mongolia,MNG,France,FRA,5,10,259,0,274
2012,Morocco,MAR,France,FRA,28,5,116,0,149
2012,Montenegro,MNE,France,FRA,0,0,209,0,209
2012,Mauritius,MUS,France,FRA,0,0,5,0,5
2012,Myanmar,MMR,France,FRA,5,0,168,0,173
2012,Nepal,NPL,France,FRA,5,0,130,0,135
2012,Niger,NER,France,FRA,0,0,10,0,10
2012,Nigeria,NGA,France,FRA,5,40,763,0,808
2012,Pakistan,PAK,France,FRA,24,0,1515,0,1539
2012,Peru,PER,France,FRA,0,5,120,0,125
2012,Philippines,PHL,France,FRA,0,0,5,0,5
2012,Romania,ROU,France,FRA,0,0,10,0,10
2012,South Africa,ZAF,France,FRA,0,0,5,0,5
2012,Russian Federation,RUS,France,FRA,256,5,2248,0,2509
2012,Rwanda,RWA,France,FRA,117,0,147,0,264
2012,El Salvador,SLV,France,FRA,0,0,5,0,5
2012,Serbia and Kosovo: S/RES/1244 (1999),SRB,France,FRA,56,10,1753,0,1819
2012,Senegal,SEN,France,FRA,15,38,112,0,165
2012,Sierra Leone,SLE,France,FRA,10,10,131,0,151
2012,Somalia,SOM,France,FRA,36,46,492,0,574
2012,Viet Nam,VNM,France,FRA,12,0,19,0,31
2012,Sudan,SDN,France,FRA,72,10,769,0,851
2012,Suriname,SUR,France,FRA,0,0,5,0,5
2012,Syrian Arab Rep.,SYR,France,FRA,126,117,21,0,264
2012,Thailand,THA,France,FRA,0,0,31,0,31
2012,Tajikistan,TJK,France,FRA,0,0,5,0,5
2012,Togo,TGO,France,FRA,11,0,93,0,104
2012,Tunisia,TUN,France,FRA,5,0,159,0,164
2012,Turkey,TUR,France,FRA,78,0,1693,0,1771
2012,Uganda,UGA,France,FRA,5,0,11,0,16
2012,Ukraine,UKR,France,FRA,5,0,89,0,94
2012,Uzbekistan,UZB,France,FRA,5,0,16,0,21
2012,Venezuela (Bolivarian Republic of),VEN,France,FRA,0,0,5,0,5
2012,Western Sahara,ESH,France,FRA,28,0,55,0,83
2012,Yemen,YEM,France,FRA,5,0,0,0,5
2012,Unknown ,,France,FRA,0,0,27,0,27
2012,Dem. Rep. of the Congo,COD,Gambia,GMB,5,0,0,0,5
2012,Cote d'Ivoire,CIV,Gambia,GMB,15,0,0,0,15
2012,Iraq,IRQ,Gambia,GMB,5,0,0,0,5
2012,Afghanistan,AFG,United Kingdom of Great Britain and Northern Ireland,GBR,204,149,578,234,1165
2012,Albania,ALB,United Kingdom of Great Britain and Northern Ireland,GBR,85,100,309,141,635
2012,Algeria,DZA,United Kingdom of Great Britain and Northern Ireland,GBR,16,5,148,98,267
2012,Angola,AGO,United Kingdom of Great Britain and Northern Ireland,GBR,5,10,23,0,38
2012,Egypt,EGY,United Kingdom of Great Britain and Northern Ireland,GBR,63,0,155,26,244
2012,Argentina,ARG,United Kingdom of Great Britain and Northern Ireland,GBR,0,0,5,0,5
2012,Armenia,ARM,United Kingdom of Great Britain and Northern Ireland,GBR,0,0,5,0,5
2012,Azerbaijan,AZE,United Kingdom of Great Britain and Northern Ireland,GBR,5,0,10,0,15
2012,Bahrain,BHR,United Kingdom of Great Britain and Northern Ireland,GBR,28,0,14,5,47
2012,Barbados,BRB,United Kingdom of Great Britain and Northern Ireland,GBR,0,0,5,0,5
2012,Burundi,BDI,United Kingdom of Great Britain and Northern Ireland,GBR,0,0,5,0,5
2012,Bangladesh,BGD,United Kingdom of Great Britain and Northern Ireland,GBR,32,18,737,199,986
2012,Bhutan,BTN,United Kingdom of Great Britain and Northern Ireland,GBR,5,0,0,0,5
2012,Belarus,BLR,United Kingdom of Great Britain and Northern Ireland,GBR,14,0,10,0,24
2012,Bolivia (Plurinational State of),BOL,United Kingdom of Great Britain and Northern Ireland,GBR,0,0,5,5,10
2012,Botswana,BWA,United Kingdom of Great Britain and Northern Ireland,GBR,0,0,13,0,13
2012,Brazil,BRA,United Kingdom of Great Britain and Northern Ireland,GBR,0,0,14,15,29
2012,Bosnia and Herzegovina,BIH,United Kingdom of Great Britain and Northern Ireland,GBR,0,5,5,0,10
2012,Bulgaria,BGR,United Kingdom of Great Britain and Northern Ireland,GBR,0,0,10,0,10
2012,Canada,CAN,United Kingdom of Great Britain and Northern Ireland,GBR,0,0,5,5,10
2012,Central African Rep.,CAF,United Kingdom of Great Britain and Northern Ireland,GBR,0,0,5,0,5
2012,Chad,TCD,United Kingdom of Great Britain and Northern Ireland,GBR,0,0,0,5,5
2012,China,CHN,United Kingdom of Great Britain and Northern Ireland,GBR,51,90,613,155,909
2012,Cameroon,CMR,United Kingdom of Great Britain and Northern Ireland,GBR,31,5,65,5,106
2012,Congo,COG,United Kingdom of Great Britain and Northern Ireland,GBR,5,0,12,5,22
2012,Dem. Rep. of the Congo,COD,United Kingdom of Great Britain and Northern Ireland,GBR,65,18,125,15,223
2012,Colombia,COL,United Kingdom of Great Britain and Northern Ireland,GBR,0,0,13,5,18
2012,Cuba,CUB,United Kingdom of Great Britain and Northern Ireland,GBR,0,0,5,0,5
2012,Dominica,DMA,United Kingdom of Great Britain and Northern Ireland,GBR,0,0,5,0,5
2012,Eritrea,ERI,United Kingdom of Great Britain and Northern Ireland,GBR,617,5,81,64,767
2012,Ethiopia,ETH,United Kingdom of Great Britain and Northern Ireland,GBR,45,5,64,14,128
2012,Fiji,FJI,United Kingdom of Great Britain and Northern Ireland,GBR,5,0,0,0,5
2012,Gambia,GMB,United Kingdom of Great Britain and Northern Ireland,GBR,104,60,232,15,411
2012,Palestinian,PSE,United Kingdom of Great Britain and Northern Ireland,GBR,24,5,77,40,146
2012,United Kingdom of Great Britain and Northern Ireland,GBR,United Kingdom of Great Britain and Northern Ireland,GBR,5,0,5,0,10
2012,Georgia,GEO,United Kingdom of Great Britain and Northern Ireland,GBR,5,0,18,10,33
2012,Ghana,GHA,United Kingdom of Great Britain and Northern Ireland,GBR,5,32,132,33,202
2012,Guinea-Bissau,GNB,United Kingdom of Great Britain and Northern Ireland,GBR,0,0,0,5,5
2012,Greece,GRC,United Kingdom of Great Britain and Northern Ireland,GBR,0,0,5,0,5
2012,Guinea,GIN,United Kingdom of Great Britain and Northern Ireland,GBR,11,10,35,0,56
2012,Guyana,GUY,United Kingdom of Great Britain and Northern Ireland,GBR,5,0,0,0,5
2012,Honduras,HND,United Kingdom of Great Britain and Northern Ireland,GBR,0,14,5,0,19
2012,Croatia,HRV,United Kingdom of Great Britain and Northern Ireland,GBR,0,0,5,0,5
2012,Cote d'Ivoire,CIV,United Kingdom of Great Britain and Northern Ireland,GBR,16,5,41,5,67
2012,India,IND,United Kingdom of Great Britain and Northern Ireland,GBR,5,5,550,373,933
2012,Iran (Islamic Rep. of),IRN,United Kingdom of Great Britain and Northern Ireland,GBR,1338,85,1150,201,2774
2012,Iraq,IRQ,United Kingdom of Great Britain and Northern Ireland,GBR,63,32,188,52,335
2012,Israel,ISR,United Kingdom of Great Britain and Northern Ireland,GBR,0,0,5,0,5
2012,Jamaica,JAM,United Kingdom of Great Britain and Northern Ireland,GBR,12,11,81,25,129
2012,Jordan,JOR,United Kingdom of Great Britain and Northern Ireland,GBR,0,0,16,0,16
2012,Kenya,KEN,United Kingdom of Great Britain and Northern Ireland,GBR,10,5,78,5,98
2012,Kyrgyzstan,KGZ,United Kingdom of Great Britain and Northern Ireland,GBR,5,0,5,0,10
2012,Rep. of Korea,KOR,United Kingdom of Great Britain and Northern Ireland,GBR,0,0,10,0,10
2012,Dem. People's Rep. of Korea,PRK,United Kingdom of Great Britain and Northern Ireland,GBR,10,0,15,5,30
2012,Kuwait,KWT,United Kingdom of Great Britain and Northern Ireland,GBR,36,0,34,5,75
2012,Liberia,LBR,United Kingdom of Great Britain and Northern Ireland,GBR,0,0,0,5,5
2012,Libya,LBY,United Kingdom of Great Britain and Northern Ireland,GBR,83,24,218,40,365
2012,Saint Lucia,LCA,United Kingdom of Great Britain and Northern Ireland,GBR,0,0,5,0,5
2012,Lebanon,LBN,United Kingdom of Great Britain and Northern Ireland,GBR,5,0,40,5,50
2012,Sri Lanka,LKA,United Kingdom of Great Britain and Northern Ireland,GBR,371,25,1281,89,1766
2012,Lithuania,LTU,United Kingdom of Great Britain and Northern Ireland,GBR,0,0,5,5,10
2012,Mauritania,MRT,United Kingdom of Great Britain and Northern Ireland,GBR,0,0,5,0,5
2012,Rep. of Moldova,MDA,United Kingdom of Great Britain and Northern Ireland,GBR,0,0,0,5,5
2012,Maldives,MDV,United Kingdom of Great Britain and Northern Ireland,GBR,5,0,0,0,5
2012,Mexico,MEX,United Kingdom of Great Britain and Northern Ireland,GBR,0,0,5,0,5
2012,Mali,MLI,United Kingdom of Great Britain and Northern Ireland,GBR,0,0,5,5,10
2012,Malaysia,MYS,United Kingdom of Great Britain and Northern Ireland,GBR,14,5,34,11,64
2012,Malawi,MWI,United Kingdom of Great Britain and Northern Ireland,GBR,5,30,109,17,161
2012,Mongolia,MNG,United Kingdom of Great Britain and Northern Ireland,GBR,0,10,25,5,40
2012,Morocco,MAR,United Kingdom of Great Britain and Northern Ireland,GBR,5,10,32,11,58
2012,Mauritius,MUS,United Kingdom of Great Britain and Northern Ireland,GBR,0,10,49,5,64
2012,Myanmar,MMR,United Kingdom of Great Britain and Northern Ireland,GBR,58,0,34,0,92
2012,Namibia,NAM,United Kingdom of Great Britain and Northern Ireland,GBR,0,0,20,0,20
2012,Nepal,NPL,United Kingdom of Great Britain and Northern Ireland,GBR,0,0,51,5,56
2012,Nigeria,NGA,United Kingdom of Great Britain and Northern Ireland,GBR,78,95,925,118,1216
2012,Pakistan,PAK,United Kingdom of Great Britain and Northern Ireland,GBR,599,63,3165,384,4211
2012,Philippines,PHL,United Kingdom of Great Britain and Northern Ireland,GBR,0,0,20,5,25
2012,Poland,POL,United Kingdom of Great Britain and Northern Ireland,GBR,0,0,15,5,20
2012,Romania,ROU,United Kingdom of Great Britain and Northern Ireland,GBR,0,0,5,0,5
2012,South Africa,ZAF,United Kingdom of Great Britain and Northern Ireland,GBR,0,5,59,10,74
2012,Russian Federation,RUS,United Kingdom of Great Britain and Northern Ireland,GBR,53,0,67,18,138
2012,Rwanda,RWA,United Kingdom of Great Britain and Northern Ireland,GBR,0,0,10,0,10
2012,El Salvador,SLV,United Kingdom of Great Britain and Northern Ireland,GBR,0,0,5,0,5
2012,Saudi Arabia,SAU,United Kingdom of Great Britain and Northern Ireland,GBR,15,0,0,0,15
2012,Serbia and Kosovo: S/RES/1244 (1999),SRB,United Kingdom of Great Britain and Northern Ireland,GBR,0,5,12,10,27
2012,Senegal,SEN,United Kingdom of Great Britain and Northern Ireland,GBR,10,0,33,0,43
2012,Sierra Leone,SLE,United Kingdom of Great Britain and Northern Ireland,GBR,5,13,60,0,78
2012,Somalia,SOM,United Kingdom of Great Britain and Northern Ireland,GBR,359,36,136,46,577
2012,Viet Nam,VNM,United Kingdom of Great Britain and Northern Ireland,GBR,16,20,106,192,334
2012,Sudan,SDN,United Kingdom of Great Britain and Northern Ireland,GBR,496,0,94,106,696
2012,Eswatini,SWZ,United Kingdom of Great Britain and Northern Ireland,GBR,0,0,5,0,5
2012,Syrian Arab Rep.,SYR,United Kingdom of Great Britain and Northern Ireland,GBR,868,51,195,62,1176
2012,United Rep. of Tanzania,TZA,United Kingdom of Great Britain and Northern Ireland,GBR,0,5,24,5,34
2012,Thailand,THA,United Kingdom of Great Britain and Northern Ireland,GBR,0,5,5,5,15
2012,Turkmenistan,TKM,United Kingdom of Great Britain and Northern Ireland,GBR,0,0,5,0,5
2012,Togo,TGO,United Kingdom of Great Britain and Northern Ireland,GBR,0,0,10,0,10
2012,Trinidad and Tobago,TTO,United Kingdom of Great Britain and Northern Ireland,GBR,0,0,12,0,12
2012,Tunisia,TUN,United Kingdom of Great Britain and Northern Ireland,GBR,0,5,17,5,27
2012,Turkey,TUR,United Kingdom of Great Britain and Northern Ireland,GBR,30,5,93,23,151
2012,Uganda,UGA,United Kingdom of Great Britain and Northern Ireland,GBR,107,20,132,11,270
2012,Ukraine,UKR,United Kingdom of Great Britain and Northern Ireland,GBR,5,0,34,12,51
2012,United States of America,USA,United Kingdom of Great Britain and Northern Ireland,GBR,5,5,10,5,25
2012,Uzbekistan,UZB,United Kingdom of Great Britain and Northern Ireland,GBR,11,0,10,0,21
2012,Saint Vincent and the Grenadines,VCT,United Kingdom of Great Britain and Northern Ireland,GBR,5,0,0,0,5
2012,Venezuela (Bolivarian Republic of),VEN,United Kingdom of Great Britain and Northern Ireland,GBR,5,0,0,0,5
2012,Yemen,YEM,United Kingdom of Great Britain and Northern Ireland,GBR,11,5,32,5,53
2012,Zambia,ZMB,United Kingdom of Great Britain and Northern Ireland,GBR,0,0,20,5,25
2012,Zimbabwe,ZWE,United Kingdom of Great Britain and Northern Ireland,GBR,133,98,235,23,489
2012,Stateless,XXA,United Kingdom of Great Britain and Northern Ireland,GBR,230,0,64,14,308
2012,Dem. Rep. of the Congo,COD,Ghana,GHA,5,0,19,0,24
2012,Ethiopia,ETH,Ghana,GHA,0,0,5,0,5
2012,Cote d'Ivoire,CIV,Ghana,GHA,9142,0,0,891,10033
2012,Sri Lanka,LKA,Ghana,GHA,0,0,5,0,5
2012,Rwanda,RWA,Ghana,GHA,0,0,5,0,5
2012,Sudan,SDN,Ghana,GHA,45,0,0,0,45
2012,Togo,TGO,Ghana,GHA,0,0,14,0,14
2012,Afghanistan,AFG,Greece,GRC,5,23,345,325,698
2012,Albania,ALB,Greece,GRC,0,0,317,85,402
2012,Algeria,DZA,Greece,GRC,0,0,337,35,372
2012,Egypt,EGY,Greece,GRC,0,0,339,100,439
2012,Armenia,ARM,Greece,GRC,0,0,43,36,79
2012,Azerbaijan,AZE,Greece,GRC,0,0,5,0,5
2012,Bahrain,BHR,Greece,GRC,0,0,0,5,5
2012,Bangladesh,BGD,Greece,GRC,0,0,1851,522,2373
2012,Burkina Faso,BFA,Greece,GRC,0,0,17,10,27
2012,Belarus,BLR,Greece,GRC,0,0,0,5,5
2012,China,CHN,Greece,GRC,0,0,279,97,376
2012,Cameroon,CMR,Greece,GRC,0,5,20,5,30
2012,Congo,COG,Greece,GRC,0,5,29,5,39
2012,Dem. Rep. of the Congo,COD,Greece,GRC,0,0,33,0,33
2012,Comoros,COM,Greece,GRC,0,0,10,0,10
2012,Cuba,CUB,Greece,GRC,0,0,5,5,10
2012,Dominican Rep.,DOM,Greece,GRC,0,0,308,107,415
2012,Eritrea,ERI,Greece,GRC,0,0,59,5,64
2012,Ethiopia,ETH,Greece,GRC,0,0,47,58,105
2012,Gambia,GMB,Greece,GRC,0,0,16,5,21
2012,Palestinian,PSE,Greece,GRC,0,0,13,10,23
2012,Georgia,GEO,Greece,GRC,0,5,1116,502,1623
2012,Ghana,GHA,Greece,GRC,0,0,198,55,253
2012,Guinea,GIN,Greece,GRC,0,0,47,10,57
2012,Cote d'Ivoire,CIV,Greece,GRC,0,0,82,5,87
2012,India,IND,Greece,GRC,0,0,263,144,407
2012,Indonesia,IDN,Greece,GRC,0,0,13,5,18
2012,Iran (Islamic Rep. of),IRN,Greece,GRC,5,5,227,85,322
2012,Iraq,IRQ,Greece,GRC,5,5,165,236,411
2012,Israel,ISR,Greece,GRC,0,0,0,16,16
2012,Kenya,KEN,Greece,GRC,0,0,10,16,26
2012,Liberia,LBR,Greece,GRC,0,0,10,0,10
2012,Libya,LBY,Greece,GRC,0,0,5,0,5
2012,Lebanon,LBN,Greece,GRC,0,0,5,0,5
2012,Sri Lanka,LKA,Greece,GRC,0,0,14,21,35
2012,Mauritania,MRT,Greece,GRC,0,0,10,5,15
2012,North Macedonia,MKD,Greece,GRC,0,0,5,0,5
2012,Rep. of Moldova,MDA,Greece,GRC,0,0,22,16,38
2012,Mali,MLI,Greece,GRC,0,0,13,0,13
2012,Morocco,MAR,Greece,GRC,0,0,199,52,251
2012,Nepal,NPL,Greece,GRC,0,0,5,0,5
2012,Niger,NER,Greece,GRC,0,0,12,0,12
2012,Nigeria,NGA,Greece,GRC,0,0,521,130,651
2012,Pakistan,PAK,Greece,GRC,0,0,3309,1565,4874
2012,Philippines,PHL,Greece,GRC,0,0,24,15,39
2012,Russian Federation,RUS,Greece,GRC,0,0,34,35,69
2012,Rwanda,RWA,Greece,GRC,0,0,5,0,5
2012,Serbia and Kosovo: S/RES/1244 (1999),SRB,Greece,GRC,0,0,0,5,5
2012,Senegal,SEN,Greece,GRC,0,0,245,92,337
2012,Sierra Leone,SLE,Greece,GRC,0,0,18,5,23
2012,Somalia,SOM,Greece,GRC,0,0,38,0,38
2012,Sudan,SDN,Greece,GRC,0,10,83,11,104
2012,Syrian Arab Rep.,SYR,Greece,GRC,0,0,150,113,263
2012,United Rep. of Tanzania,TZA,Greece,GRC,0,0,5,13,18
2012,Timor-Leste,TLS,Greece,GRC,0,0,5,11,16
2012,Togo,TGO,Greece,GRC,0,0,0,5,5
2012,Tunisia,TUN,Greece,GRC,0,0,39,10,49
2012,Turkey,TUR,Greece,GRC,5,5,24,15,49
2012,Ukraine,UKR,Greece,GRC,0,0,32,30,62
2012,Uzbekistan,UZB,Greece,GRC,0,0,5,5,10
2012,Unknown ,,Greece,GRC,0,5,43,15,63
2012,Colombia,COL,Guatemala,GTM,5,0,0,0,5
2012,El Salvador,SLV,Guatemala,GTM,0,0,0,5,5
2012,Colombia,COL,Honduras,HND,0,0,0,5,5
2012,Somalia,SOM,Honduras,HND,0,0,0,5,5
2012,Afghanistan,AFG,Croatia,HRV,0,0,32,334,366
2012,Algeria,DZA,Croatia,HRV,0,0,41,76,117
2012,Egypt,EGY,Croatia,HRV,0,0,0,5,5
2012,Bangladesh,BGD,Croatia,HRV,0,0,0,11,11
2012,Bosnia and Herzegovina,BIH,Croatia,HRV,0,0,5,0,5
2012,Eritrea,ERI,Croatia,HRV,0,0,5,13,18
2012,Palestinian,PSE,Croatia,HRV,0,0,0,10,10
2012,Iran (Islamic Rep. of),IRN,Croatia,HRV,0,0,0,15,15
2012,Iraq,IRQ,Croatia,HRV,0,0,0,12,12
2012,Libya,LBY,Croatia,HRV,0,0,0,5,5
2012,Morocco,MAR,Croatia,HRV,0,0,20,12,32
2012,Pakistan,PAK,Croatia,HRV,0,0,5,48,53
2012,Russian Federation,RUS,Croatia,HRV,5,0,5,5,15
2012,Serbia and Kosovo: S/RES/1244 (1999),SRB,Croatia,HRV,0,0,5,10,15
2012,Somalia,SOM,Croatia,HRV,0,0,20,245,265
2012,Sudan,SDN,Croatia,HRV,0,0,0,12,12
2012,Syrian Arab Rep.,SYR,Croatia,HRV,0,11,0,37,48
2012,Tunisia,TUN,Croatia,HRV,0,0,10,5,15
2012,Turkey,TUR,Croatia,HRV,5,0,0,13,18
2012,Ukraine,UKR,Croatia,HRV,5,0,5,0,10
2012,Afghanistan,AFG,Hungary,HUN,32,143,166,490,831
2012,Algeria,DZA,Hungary,HUN,0,0,5,61,66
2012,Egypt,EGY,Hungary,HUN,0,0,5,5,10
2012,Armenia,ARM,Hungary,HUN,0,0,0,5,5
2012,Bangladesh,BGD,Hungary,HUN,0,0,0,19,19
2012,Belarus,BLR,Hungary,HUN,0,0,5,0,5
2012,Bulgaria,BGR,Hungary,HUN,0,0,0,5,5
2012,China,CHN,Hungary,HUN,0,0,20,10,30
2012,Cuba,CUB,Hungary,HUN,0,0,0,5,5
2012,Eritrea,ERI,Hungary,HUN,0,0,0,5,5
2012,Palestinian,PSE,Hungary,HUN,0,10,0,17,27
2012,Cote d'Ivoire,CIV,Hungary,HUN,0,0,5,0,5
2012,India,IND,Hungary,HUN,0,0,10,10,20
2012,Iran (Islamic Rep. of),IRN,Hungary,HUN,0,0,11,35,46
2012,Iraq,IRQ,Hungary,HUN,0,10,20,5,35
2012,Kenya,KEN,Hungary,HUN,0,0,0,5,5
2012,Liberia,LBR,Hungary,HUN,0,0,0,5,5
2012,Libya,LBY,Hungary,HUN,0,0,5,5,10
2012,Sri Lanka,LKA,Hungary,HUN,0,0,0,5,5
2012,Morocco,MAR,Hungary,HUN,0,0,0,27,27
2012,Montenegro,MNE,Hungary,HUN,0,0,0,5,5
2012,Nigeria,NGA,Hungary,HUN,0,0,5,21,26
2012,Pakistan,PAK,Hungary,HUN,0,11,76,258,345
2012,Russian Federation,RUS,Hungary,HUN,0,0,0,5,5
2012,Serbia and Kosovo: S/RES/1244 (1999),SRB,Hungary,HUN,5,0,5,284,294
2012,Sierra Leone,SLE,Hungary,HUN,0,0,0,13,13
2012,Somalia,SOM,Hungary,HUN,11,47,0,47,105
2012,Syrian Arab Rep.,SYR,Hungary,HUN,0,44,15,75,134
2012,Tunisia,TUN,Hungary,HUN,0,0,5,19,24
2012,Turkey,TUR,Hungary,HUN,0,5,5,16,26
2012,Unknown ,,Hungary,HUN,13,14,0,0,27
2012,Afghanistan,AFG,Iceland,ISL,0,0,0,5,5
2012,Albania,ALB,Iceland,ISL,0,0,5,0,5
2012,Algeria,DZA,Iceland,ISL,0,0,0,5,5
2012,Georgia,GEO,Iceland,ISL,0,0,0,5,5
2012,Iran (Islamic Rep. of),IRN,Iceland,ISL,0,0,0,5,5
2012,Nigeria,NGA,Iceland,ISL,0,0,0,12,12
2012,Afghanistan,AFG,Ireland,IRL,5,0,25,29,59
2012,Albania,ALB,Ireland,IRL,0,0,24,10,34
2012,Algeria,DZA,Ireland,IRL,0,0,32,14,46
2012,Angola,AGO,Ireland,IRL,0,0,5,0,5
2012,Egypt,EGY,Ireland,IRL,10,0,5,5,20
2012,Bangladesh,BGD,Ireland,IRL,0,0,16,20,36
2012,Bhutan,BTN,Ireland,IRL,0,0,0,5,5
2012,Brazil,BRA,Ireland,IRL,0,0,10,5,15
2012,China,CHN,Ireland,IRL,0,0,10,25,35
2012,Cameroon,CMR,Ireland,IRL,0,0,11,5,16
2012,Congo,COG,Ireland,IRL,0,0,5,0,5
2012,Dem. Rep. of the Congo,COD,Ireland,IRL,5,0,51,10,66
2012,Eritrea,ERI,Ireland,IRL,0,0,5,5,10
2012,Palestinian,PSE,Ireland,IRL,0,0,5,5,10
2012,Georgia,GEO,Ireland,IRL,0,0,14,5,19
2012,Ghana,GHA,Ireland,IRL,0,0,10,5,15
2012,India,IND,Ireland,IRL,0,0,5,5,10
2012,Iran (Islamic Rep. of),IRN,Ireland,IRL,5,0,10,5,20
2012,Iraq,IRQ,Ireland,IRL,5,0,5,5,15
2012,Israel,ISR,Ireland,IRL,0,0,5,0,5
2012,Kenya,KEN,Ireland,IRL,0,0,5,0,5
2012,Sri Lanka,LKA,Ireland,IRL,0,0,0,5,5
2012,Rep. of Moldova,MDA,Ireland,IRL,0,0,14,5,19
2012,Malawi,MWI,Ireland,IRL,0,0,23,0,23
2012,Mongolia,MNG,Ireland,IRL,0,0,0,5,5
2012,Morocco,MAR,Ireland,IRL,0,0,5,0,5
2012,Mauritius,MUS,Ireland,IRL,5,0,12,0,17
2012,Myanmar,MMR,Ireland,IRL,0,0,5,0,5
2012,Nepal,NPL,Ireland,IRL,0,0,11,26,37
2012,Niger,NER,Ireland,IRL,0,0,5,0,5
2012,Nigeria,NGA,Ireland,IRL,5,0,117,54,176
2012,Pakistan,PAK,Ireland,IRL,0,0,84,53,137
2012,South Africa,ZAF,Ireland,IRL,0,0,32,5,37
2012,Russian Federation,RUS,Ireland,IRL,0,0,0,5,5
2012,Rwanda,RWA,Ireland,IRL,0,0,10,0,10
2012,Serbia and Kosovo: S/RES/1244 (1999),SRB,Ireland,IRL,0,0,5,5,10
2012,Sierra Leone,SLE,Ireland,IRL,0,0,5,5,10
2012,Somalia,SOM,Ireland,IRL,0,0,5,5,10
2012,Sudan,SDN,Ireland,IRL,0,0,5,11,16
2012,Eswatini,SWZ,Ireland,IRL,0,0,5,0,5
2012,Syrian Arab Rep.,SYR,Ireland,IRL,13,0,5,0,18
2012,Togo,TGO,Ireland,IRL,0,0,5,0,5
2012,Ukraine,UKR,Ireland,IRL,0,0,14,0,14
2012,Zimbabwe,ZWE,Ireland,IRL,0,0,46,10,56
2012,Stateless,XXA,Ireland,IRL,0,0,5,0,5
2012,Afghanistan,AFG,Italy,ITA,182,625,253,0,1060
2012,Albania,ALB,Italy,ITA,11,18,34,0,63
2012,Algeria,DZA,Italy,ITA,5,5,63,0,73
2012,Angola,AGO,Italy,ITA,0,0,5,0,5
2012,Egypt,EGY,Italy,ITA,109,68,109,0,286
2012,Armenia,ARM,Italy,ITA,5,11,12,0,28
2012,Azerbaijan,AZE,Italy,ITA,5,5,0,0,10
2012,Bahrain,BHR,Italy,ITA,5,0,0,0,5
2012,Benin,BEN,Italy,ITA,0,5,27,0,32
2012,Bangladesh,BGD,Italy,ITA,14,75,839,0,928
2012,Burkina Faso,BFA,Italy,ITA,5,41,294,0,340
2012,Brazil,BRA,Italy,ITA,0,0,10,0,10
2012,Bosnia and Herzegovina,BIH,Italy,ITA,0,56,67,0,123
2012,Chad,TCD,Italy,ITA,57,103,219,0,379
2012,China,CHN,Italy,ITA,5,0,26,0,31
2012,Chile,CHL,Italy,ITA,0,0,5,0,5
2012,Cameroon,CMR,Italy,ITA,24,18,63,0,105
2012,Congo,COG,Italy,ITA,20,13,29,0,62
2012,Dem. Rep. of the Congo,COD,Italy,ITA,29,22,21,0,72
2012,Colombia,COL,Italy,ITA,10,10,15,0,35
2012,Cuba,CUB,Italy,ITA,5,0,18,0,23
2012,Ecuador,ECU,Italy,ITA,0,0,5,0,5
2012,Eritrea,ERI,Italy,ITA,116,77,22,0,215
2012,Ethiopia,ETH,Italy,ITA,20,20,16,0,56
2012,Gabon,GAB,Italy,ITA,0,5,5,0,10
2012,Gambia,GMB,Italy,ITA,15,62,164,0,241
2012,Palestinian,PSE,Italy,ITA,37,5,16,0,58
2012,Georgia,GEO,Italy,ITA,5,5,36,0,46
2012,Ghana,GHA,Italy,ITA,19,250,1546,0,1815
2012,Guinea-Bissau,GNB,Italy,ITA,0,24,69,0,93
2012,Guinea,GIN,Italy,ITA,13,68,283,0,364
2012,Croatia,HRV,Italy,ITA,0,5,5,0,10
2012,Cote d'Ivoire,CIV,Italy,ITA,74,452,672,0,1198
2012,India,IND,Italy,ITA,0,0,19,0,19
2012,Iran (Islamic Rep. of),IRN,Italy,ITA,105,27,27,0,159
2012,Iraq,IRQ,Italy,ITA,38,159,39,0,236
2012,Kenya,KEN,Italy,ITA,5,0,5,0,10
2012,Liberia,LBR,Italy,ITA,0,5,81,0,86
2012,Libya,LBY,Italy,ITA,27,40,71,0,138
2012,Lebanon,LBN,Italy,ITA,13,5,17,0,35
2012,Sri Lanka,LKA,Italy,ITA,10,16,47,0,73
2012,Mauritania,MRT,Italy,ITA,18,19,59,0,96
2012,North Macedonia,MKD,Italy,ITA,0,5,16,0,21
2012,Rep. of Moldova,MDA,Italy,ITA,0,0,10,0,10
2012,Mali,MLI,Italy,ITA,32,1920,786,0,2738
2012,Mongolia,MNG,Italy,ITA,0,0,5,0,5
2012,Morocco,MAR,Italy,ITA,16,5,246,0,267
2012,Montenegro,MNE,Italy,ITA,0,10,10,0,20
2012,Niger,NER,Italy,ITA,12,50,319,0,381
2012,Nicaragua,NIC,Italy,ITA,0,0,5,0,5
2012,Nigeria,NGA,Italy,ITA,74,550,3779,0,4403
2012,Pakistan,PAK,Italy,ITA,130,573,1145,0,1848
2012,Peru,PER,Italy,ITA,0,5,5,0,10
2012,Philippines,PHL,Italy,ITA,0,0,5,0,5
2012,Russian Federation,RUS,Italy,ITA,15,0,5,0,20
2012,Rwanda,RWA,Italy,ITA,0,0,5,0,5
2012,El Salvador,SLV,Italy,ITA,0,5,10,0,15
2012,Serbia and Kosovo: S/RES/1244 (1999),SRB,Italy,ITA,0,41,119,0,160
2012,Senegal,SEN,Italy,ITA,36,92,674,0,802
2012,Sierra Leone,SLE,Italy,ITA,5,22,40,0,67
2012,Somalia,SOM,Italy,ITA,238,568,29,0,835
2012,Sudan,SDN,Italy,ITA,125,152,122,0,399
2012,South Sudan,SSD,Italy,ITA,55,0,0,0,55
2012,Syrian Arab Rep.,SYR,Italy,ITA,98,103,28,0,229
2012,Togo,TGO,Italy,ITA,10,40,70,0,120
2012,Tunisia,TUN,Italy,ITA,5,81,822,0,908
2012,Turkey,TUR,Italy,ITA,56,73,275,0,404
2012,Ukraine,UKR,Italy,ITA,0,0,11,0,11
2012,Unknown ,,Italy,ITA,0,5,29,0,34
2012,Afghanistan,AFG,Japan,JPN,0,0,5,0,5
2012,Bangladesh,BGD,Japan,JPN,0,5,154,10,169
2012,Brazil,BRA,Japan,JPN,0,0,5,0,5
2012,China,CHN,Japan,JPN,0,5,18,0,23
2012,Cameroon,CMR,Japan,JPN,0,0,66,5,71
2012,Ethiopia,ETH,Japan,JPN,0,0,10,0,10
2012,Gambia,GMB,Japan,JPN,0,0,5,0,5
2012,Ghana,GHA,Japan,JPN,0,0,27,0,27
2012,Guinea,GIN,Japan,JPN,0,0,5,0,5
2012,India,IND,Japan,JPN,0,0,96,5,101
2012,Indonesia,IDN,Japan,JPN,0,0,5,0,5
2012,Iran (Islamic Rep. of),IRN,Japan,JPN,0,0,49,5,54
2012,Sri Lanka,LKA,Japan,JPN,0,0,210,10,220
2012,Mali,MLI,Japan,JPN,0,0,5,0,5
2012,Mongolia,MNG,Japan,JPN,0,0,5,0,5
2012,Myanmar,MMR,Japan,JPN,5,36,337,10,388
2012,Nepal,NPL,Japan,JPN,0,0,303,5,308
2012,Nigeria,NGA,Japan,JPN,0,0,75,0,75
2012,Pakistan,PAK,Japan,JPN,0,0,247,14,261
2012,Peru,PER,Japan,JPN,0,0,5,0,5
2012,Philippines,PHL,Japan,JPN,0,0,16,0,16
2012,Senegal,SEN,Japan,JPN,0,0,5,0,5
2012,Viet Nam,VNM,Japan,JPN,0,0,5,0,5
2012,Syrian Arab Rep.,SYR,Japan,JPN,0,5,0,0,5
2012,Thailand,THA,Japan,JPN,0,0,5,0,5
2012,Tunisia,TUN,Japan,JPN,0,0,11,0,11
2012,Turkey,TUR,Japan,JPN,0,0,334,26,360
2012,Uganda,UGA,Japan,JPN,0,0,24,0,24
2012,Uzbekistan,UZB,Japan,JPN,0,0,0,5,5
2012,Unknown ,,Japan,JPN,0,0,29,0,29
2012,Afghanistan,AFG,Kazakhstan,KAZ,14,0,10,0,24
2012,China,CHN,Kazakhstan,KAZ,0,0,5,0,5
2012,Kyrgyzstan,KGZ,Kazakhstan,KAZ,0,0,5,5,10
2012,Syrian Arab Rep.,SYR,Kazakhstan,KAZ,0,0,5,0,5
2012,Afghanistan,AFG,Kyrgyzstan,KGZ,0,0,20,15,35
2012,Uzbekistan,UZB,Kyrgyzstan,KGZ,0,0,0,126,126
2012,Zimbabwe,ZWE,Lesotho,LSO,5,0,0,0,5
2012,Armenia,ARM,Liechtenstein,LIE,0,0,5,0,5
2012,Bosnia and Herzegovina,BIH,Liechtenstein,LIE,0,0,5,0,5
2012,Eritrea,ERI,Liechtenstein,LIE,5,0,0,0,5
2012,Iraq,IRQ,Liechtenstein,LIE,5,0,0,0,5
2012,Russian Federation,RUS,Liechtenstein,LIE,0,0,10,0,10
2012,Serbia and Kosovo: S/RES/1244 (1999),SRB,Liechtenstein,LIE,0,0,10,5,15
2012,Somalia,SOM,Liechtenstein,LIE,10,0,0,0,10
2012,Ukraine,UKR,Liechtenstein,LIE,0,0,5,0,5
2012,Afghanistan,AFG,Lithuania,LTU,0,21,0,52,73
2012,Armenia,ARM,Lithuania,LTU,0,0,0,5,5
2012,Belarus,BLR,Lithuania,LTU,0,10,5,0,15
2012,Eritrea,ERI,Lithuania,LTU,5,0,0,0,5
2012,Georgia,GEO,Lithuania,LTU,0,0,223,60,283
2012,Iraq,IRQ,Lithuania,LTU,5,0,0,0,5
2012,Kyrgyzstan,KGZ,Lithuania,LTU,0,0,15,0,15
2012,Russian Federation,RUS,Lithuania,LTU,0,0,27,18,45
2012,Viet Nam,VNM,Lithuania,LTU,0,0,41,5,46
2012,Afghanistan,AFG,Luxembourg,LUX,0,5,5,0,10
2012,Albania,ALB,Luxembourg,LUX,0,0,162,0,162
2012,Algeria,DZA,Luxembourg,LUX,0,0,20,0,20
2012,Bosnia and Herzegovina,BIH,Luxembourg,LUX,0,0,232,0,232
2012,Cameroon,CMR,Luxembourg,LUX,0,0,5,0,5
2012,Greece,GRC,Luxembourg,LUX,0,0,10,0,10
2012,Iran (Islamic Rep. of),IRN,Luxembourg,LUX,10,0,5,0,15
2012,Iraq,IRQ,Luxembourg,LUX,17,0,16,0,33
2012,Israel,ISR,Luxembourg,LUX,0,0,5,0,5
2012,Kyrgyzstan,KGZ,Luxembourg,LUX,0,0,5,0,5
2012,North Macedonia,MKD,Luxembourg,LUX,0,0,249,0,249
2012,Montenegro,MNE,Luxembourg,LUX,0,0,59,0,59
2012,Serbia and Kosovo: S/RES/1244 (1999),SRB,Luxembourg,LUX,5,0,1093,0,1098
2012,Somalia,SOM,Luxembourg,LUX,0,0,10,0,10
2012,Syrian Arab Rep.,SYR,Luxembourg,LUX,5,0,0,0,5
2012,Tunisia,TUN,Luxembourg,LUX,0,0,5,0,5
2012,Zimbabwe,ZWE,Luxembourg,LUX,0,0,5,0,5
2012,Unknown ,,Luxembourg,LUX,0,0,0,770,770
2012,Afghanistan,AFG,Latvia,LVA,0,0,5,11,16
2012,Algeria,DZA,Latvia,LVA,0,0,5,0,5
2012,Dem. Rep. of the Congo,COD,Latvia,LVA,0,0,10,23,33
2012,Georgia,GEO,Latvia,LVA,0,0,39,77,116
2012,Iran (Islamic Rep. of),IRN,Latvia,LVA,5,5,0,0,10
2012,Russian Federation,RUS,Latvia,LVA,0,0,11,5,16
2012,Syrian Arab Rep.,SYR,Latvia,LVA,0,13,0,0,13
2012,Turkey,TUR,Latvia,LVA,0,0,5,0,5
2012,Uzbekistan,UZB,Latvia,LVA,0,0,5,0,5
2012,Afghanistan,AFG,Rep. of Moldova,MDA,0,5,0,10,15
2012,Egypt,EGY,Rep. of Moldova,MDA,0,0,0,5,5
2012,Armenia,ARM,Rep. of Moldova,MDA,0,5,5,0,10
2012,Bangladesh,BGD,Rep. of Moldova,MDA,0,0,0,5,5
2012,Georgia,GEO,Rep. of Moldova,MDA,0,0,5,0,5
2012,India,IND,Rep. of Moldova,MDA,0,0,5,0,5
2012,Iran (Islamic Rep. of),IRN,Rep. of Moldova,MDA,0,0,0,5,5
2012,Kazakhstan,KAZ,Rep. of Moldova,MDA,0,0,5,0,5
2012,Russian Federation,RUS,Rep. of Moldova,MDA,0,0,0,5,5
2012,Syrian Arab Rep.,SYR,Rep. of Moldova,MDA,12,33,0,5,50
2012,Turkey,TUR,Rep. of Moldova,MDA,0,0,5,0,5
2012,Dem. Rep. of the Congo,COD,Mexico,MEX,5,0,0,0,5
2012,Colombia,COL,Mexico,MEX,13,0,12,10,35
2012,Cuba,CUB,Mexico,MEX,11,0,23,32,66
2012,Ecuador,ECU,Mexico,MEX,0,0,0,5,5
2012,Eritrea,ERI,Mexico,MEX,5,0,0,0,5
2012,Guatemala,GTM,Mexico,MEX,21,0,17,10,48
2012,Haiti,HTI,Mexico,MEX,0,0,10,0,10
2012,Honduras,HND,Mexico,MEX,66,22,54,70,212
2012,Iran (Islamic Rep. of),IRN,Mexico,MEX,5,0,0,0,5
2012,Sri Lanka,LKA,Mexico,MEX,17,0,0,0,17
2012,Nicaragua,NIC,Mexico,MEX,0,0,0,5,5
2012,Nigeria,NGA,Mexico,MEX,5,0,5,0,10
2012,Pakistan,PAK,Mexico,MEX,0,0,0,5,5
2012,El Salvador,SLV,Mexico,MEX,80,5,44,35,164
2012,Burundi,BDI,Malawi,MWI,39,0,311,226,576
2012,Dem. Rep. of the Congo,COD,Malawi,MWI,81,0,119,2060,2260
2012,Ethiopia,ETH,Malawi,MWI,0,0,0,10,10
2012,Rwanda,RWA,Malawi,MWI,34,0,133,369,536
2012,Somalia,SOM,Malawi,MWI,5,0,0,27,32
2012,Uganda,UGA,Malawi,MWI,0,0,0,5,5
2012,Burundi,BDI,Mozambique,MOZ,80,0,0,386,466
2012,Congo,COG,Mozambique,MOZ,0,0,0,5,5
2012,Dem. Rep. of the Congo,COD,Mozambique,MOZ,405,0,0,1181,1586
2012,Ethiopia,ETH,Mozambique,MOZ,0,0,0,759,759
2012,Guinea,GIN,Mozambique,MOZ,0,0,0,5,5
2012,Liberia,LBR,Mozambique,MOZ,0,0,0,5,5
2012,Rwanda,RWA,Mozambique,MOZ,37,0,0,72,109
2012,Somalia,SOM,Mozambique,MOZ,54,0,0,1231,1285
2012,Sudan,SDN,Mozambique,MOZ,5,0,0,10,15
2012,Uganda,UGA,Mozambique,MOZ,0,0,0,5,5
2012,Cameroon,CMR,Malta,MLT,5,0,0,0,5
2012,Eritrea,ERI,Malta,MLT,154,5,37,5,201
2012,Ethiopia,ETH,Malta,MLT,11,5,11,0,27
2012,Ghana,GHA,Malta,MLT,0,0,0,5,5
2012,Cote d'Ivoire,CIV,Malta,MLT,0,5,5,0,10
2012,Libya,LBY,Malta,MLT,0,27,5,22,54
2012,Mali,MLI,Malta,MLT,0,0,5,0,5
2012,Nigeria,NGA,Malta,MLT,5,0,41,12,58
2012,Pakistan,PAK,Malta,MLT,0,0,17,0,17
2012,Serbia and Kosovo: S/RES/1244 (1999),SRB,Malta,MLT,0,0,0,5,5
2012,Somalia,SOM,Malta,MLT,1083,5,17,5,1110
2012,Sudan,SDN,Malta,MLT,5,0,0,0,5
2012,Syrian Arab Rep.,SYR,Malta,MLT,0,113,0,5,118
2012,Burundi,BDI,Namibia,NAM,0,0,0,5,5
2012,Dem. Rep. of the Congo,COD,Namibia,NAM,0,0,0,31,31
2012,Rwanda,RWA,Namibia,NAM,0,0,0,10,10
2012,Bhutan,BTN,Nepal,NPL,0,1184,149,371,1704
2012,Afghanistan,AFG,Netherlands,NLD,45,606,1200,0,1851
2012,Albania,ALB,Netherlands,NLD,0,0,14,0,14
2012,Algeria,DZA,Netherlands,NLD,0,0,23,0,23
2012,Angola,AGO,Netherlands,NLD,0,0,15,0,15
2012,Egypt,EGY,Netherlands,NLD,11,26,111,0,148
2012,Armenia,ARM,Netherlands,NLD,0,24,379,0,403
2012,Azerbaijan,AZE,Netherlands,NLD,10,10,88,0,108
2012,Burundi,BDI,Netherlands,NLD,0,12,37,0,49
2012,Belgium,BEL,Netherlands,NLD,0,0,5,0,5
2012,Benin,BEN,Netherlands,NLD,0,0,5,0,5
2012,Bangladesh,BGD,Netherlands,NLD,0,0,35,0,35
2012,Burkina Faso,BFA,Netherlands,NLD,0,0,11,0,11
2012,Belarus,BLR,Netherlands,NLD,0,5,76,0,81
2012,Bosnia and Herzegovina,BIH,Netherlands,NLD,0,0,65,0,65
2012,Canada,CAN,Netherlands,NLD,0,0,5,0,5
2012,Chad,TCD,Netherlands,NLD,0,0,5,0,5
2012,China,CHN,Netherlands,NLD,20,99,125,0,244
2012,Cameroon,CMR,Netherlands,NLD,0,5,32,0,37
2012,Congo,COG,Netherlands,NLD,10,52,76,0,138
2012,Dem. Rep. of the Congo,COD,Netherlands,NLD,0,11,12,0,23
2012,Colombia,COL,Netherlands,NLD,0,0,13,0,13
2012,Cuba,CUB,Netherlands,NLD,0,0,5,0,5
2012,Eritrea,ERI,Netherlands,NLD,12,259,197,0,468
2012,Ethiopia,ETH,Netherlands,NLD,0,23,62,0,85
2012,Gambia,GMB,Netherlands,NLD,0,0,20,0,20
2012,Palestinian,PSE,Netherlands,NLD,0,14,29,0,43
2012,Georgia,GEO,Netherlands,NLD,0,0,233,0,233
2012,Ghana,GHA,Netherlands,NLD,0,0,28,0,28
2012,Guinea-Bissau,GNB,Netherlands,NLD,0,0,5,0,5
2012,Guatemala,GTM,Netherlands,NLD,0,0,5,0,5
2012,Guinea,GIN,Netherlands,NLD,5,79,153,0,237
2012,Croatia,HRV,Netherlands,NLD,0,0,5,0,5
2012,Cote d'Ivoire,CIV,Netherlands,NLD,0,32,163,0,195
2012,India,IND,Netherlands,NLD,0,0,16,0,16
2012,Indonesia,IDN,Netherlands,NLD,0,0,5,0,5
2012,Iran (Islamic Rep. of),IRN,Netherlands,NLD,192,326,679,0,1197
2012,Iraq,IRQ,Netherlands,NLD,132,1073,658,0,1863
2012,Israel,ISR,Netherlands,NLD,0,0,5,0,5
2012,Jamaica,JAM,Netherlands,NLD,12,15,11,0,38
2012,Jordan,JOR,Netherlands,NLD,0,0,5,0,5
2012,Kazakhstan,KAZ,Netherlands,NLD,0,0,19,0,19
2012,Kenya,KEN,Netherlands,NLD,0,5,20,0,25
2012,Kyrgyzstan,KGZ,Netherlands,NLD,0,5,10,0,15
2012,Dem. People's Rep. of Korea,PRK,Netherlands,NLD,0,23,5,0,28
2012,Liberia,LBR,Netherlands,NLD,0,10,10,0,20
2012,Libya,LBY,Netherlands,NLD,0,10,152,0,162
2012,Lebanon,LBN,Netherlands,NLD,0,5,10,0,15
2012,Sri Lanka,LKA,Netherlands,NLD,5,78,111,0,194
2012,Mauritania,MRT,Netherlands,NLD,0,0,5,0,5
2012,North Macedonia,MKD,Netherlands,NLD,0,0,32,0,32
2012,Rep. of Moldova,MDA,Netherlands,NLD,0,0,10,0,10
2012,Mali,MLI,Netherlands,NLD,0,0,25,0,25
2012,Malaysia,MYS,Netherlands,NLD,0,0,5,0,5
2012,Malawi,MWI,Netherlands,NLD,0,0,5,0,5
2012,Mongolia,MNG,Netherlands,NLD,0,0,120,0,120
2012,Morocco,MAR,Netherlands,NLD,0,0,16,0,16
2012,Myanmar,MMR,Netherlands,NLD,0,34,5,0,39
2012,Nepal,NPL,Netherlands,NLD,5,31,84,0,120
2012,Niger,NER,Netherlands,NLD,0,0,5,0,5
2012,Nigeria,NGA,Netherlands,NLD,0,12,123,0,135
2012,Pakistan,PAK,Netherlands,NLD,25,42,74,0,141
2012,Romania,ROU,Netherlands,NLD,0,0,10,0,10
2012,Russian Federation,RUS,Netherlands,NLD,5,25,771,0,801
2012,Rwanda,RWA,Netherlands,NLD,0,5,5,0,10
2012,Serbia and Kosovo: S/RES/1244 (1999),SRB,Netherlands,NLD,0,5,118,0,123
2012,Senegal,SEN,Netherlands,NLD,0,0,18,0,18
2012,Sierra Leone,SLE,Netherlands,NLD,5,37,89,0,131
2012,Somalia,SOM,Netherlands,NLD,11,941,647,0,1599
2012,Viet Nam,VNM,Netherlands,NLD,0,0,5,0,5
2012,Sudan,SDN,Netherlands,NLD,15,53,95,0,163
2012,Suriname,SUR,Netherlands,NLD,0,0,5,0,5
2012,Syrian Arab Rep.,SYR,Netherlands,NLD,46,538,48,0,632
2012,United Rep. of Tanzania,TZA,Netherlands,NLD,0,0,5,0,5
2012,Tajikistan,TJK,Netherlands,NLD,0,5,15,0,20
2012,Togo,TGO,Netherlands,NLD,0,5,12,0,17
2012,Tunisia,TUN,Netherlands,NLD,0,0,14,0,14
2012,Turkey,TUR,Netherlands,NLD,16,15,92,0,123
2012,Uganda,UGA,Netherlands,NLD,20,23,62,0,105
2012,Ukraine,UKR,Netherlands,NLD,0,0,32,0,32
2012,United States of America,USA,Netherlands,NLD,0,0,5,0,5
2012,Uzbekistan,UZB,Netherlands,NLD,0,0,15,0,15
2012,Yemen,YEM,Netherlands,NLD,5,5,14,0,24
2012,Zimbabwe,ZWE,Netherlands,NLD,0,0,5,0,5
2012,Stateless,XXA,Netherlands,NLD,0,61,65,0,126
2012,Unknown ,,Netherlands,NLD,5,207,286,0,498
2012,Bangladesh,BGD,Nicaragua,NIC,0,0,0,16,16
2012,El Salvador,SLV,Nicaragua,NIC,18,0,0,0,18
2012,Somalia,SOM,Nicaragua,NIC,0,0,0,18,18
2012,Afghanistan,AFG,Norway,NOR,256,215,443,176,1090
2012,Albania,ALB,Norway,NOR,0,0,132,37,169
2012,Algeria,DZA,Norway,NOR,0,0,31,95,126
2012,Angola,AGO,Norway,NOR,0,5,5,11,21
2012,Egypt,EGY,Norway,NOR,0,0,10,18,28
2012,Armenia,ARM,Norway,NOR,0,0,10,10,20
2012,Azerbaijan,AZE,Norway,NOR,0,0,41,12,53
2012,Burundi,BDI,Norway,NOR,0,0,5,0,5
2012,Bangladesh,BGD,Norway,NOR,0,0,209,20,229
2012,Bhutan,BTN,Norway,NOR,0,0,5,0,5
2012,Belarus,BLR,Norway,NOR,0,0,83,62,145
2012,Bosnia and Herzegovina,BIH,Norway,NOR,0,0,40,14,54
2012,Bulgaria,BGR,Norway,NOR,0,0,31,0,31
2012,Chad,TCD,Norway,NOR,0,0,5,0,5
2012,China,CHN,Norway,NOR,80,0,10,5,95
2012,Cameroon,CMR,Norway,NOR,0,0,11,0,11
2012,Congo,COG,Norway,NOR,0,0,5,0,5
2012,Dem. Rep. of the Congo,COD,Norway,NOR,10,0,46,5,61
2012,Cuba,CUB,Norway,NOR,0,0,5,0,5
2012,Eritrea,ERI,Norway,NOR,1224,5,150,111,1490
2012,Ethiopia,ETH,Norway,NOR,226,0,206,17,449
2012,Gambia,GMB,Norway,NOR,0,0,30,11,41
2012,Georgia,GEO,Norway,NOR,0,0,17,97,114
2012,Ghana,GHA,Norway,NOR,0,0,10,22,32
2012,Guinea-Bissau,GNB,Norway,NOR,0,0,5,5,10
2012,Greece,GRC,Norway,NOR,0,0,5,0,5
2012,Guinea,GIN,Norway,NOR,5,0,24,16,45
2012,Croatia,HRV,Norway,NOR,0,0,5,5,10
2012,Hungary,HUN,Norway,NOR,0,0,15,0,15
2012,Cote d'Ivoire,CIV,Norway,NOR,0,0,36,10,46
2012,India,IND,Norway,NOR,0,0,29,13,42
2012,Iran (Islamic Rep. of),IRN,Norway,NOR,120,0,229,66,415
2012,Iraq,IRQ,Norway,NOR,49,0,118,88,255
2012,Israel,ISR,Norway,NOR,0,0,0,5,5
2012,Italy,ITA,Norway,NOR,0,0,5,5,10
2012,Jordan,JOR,Norway,NOR,0,0,5,5,10
2012,Kazakhstan,KAZ,Norway,NOR,0,0,18,5,23
2012,Kenya,KEN,Norway,NOR,0,0,10,5,15
2012,Kyrgyzstan,KGZ,Norway,NOR,0,0,20,10,30
2012,Rep. of Korea,KOR,Norway,NOR,0,0,5,0,5
2012,Dem. People's Rep. of Korea,PRK,Norway,NOR,0,0,5,0,5
2012,Liberia,LBR,Norway,NOR,0,0,5,10,15
2012,Libya,LBY,Norway,NOR,0,0,50,67,117
2012,Lebanon,LBN,Norway,NOR,0,0,5,11,16
2012,Sri Lanka,LKA,Norway,NOR,0,0,20,5,25
2012,Latvia,LVA,Norway,NOR,0,0,5,0,5
2012,Mauritania,MRT,Norway,NOR,0,0,5,0,5
2012,North Macedonia,MKD,Norway,NOR,0,0,27,5,32
2012,Maldives,MDV,Norway,NOR,0,0,0,12,12
2012,Mexico,MEX,Norway,NOR,0,0,5,0,5
2012,Mali,MLI,Norway,NOR,0,0,13,10,23
2012,Malawi,MWI,Norway,NOR,0,0,5,0,5
2012,Mongolia,MNG,Norway,NOR,0,0,15,10,25
2012,Morocco,MAR,Norway,NOR,0,0,45,79,124
2012,Montenegro,MNE,Norway,NOR,0,0,5,5,10
2012,Myanmar,MMR,Norway,NOR,0,0,13,0,13
2012,Nepal,NPL,Norway,NOR,0,0,18,10,28
2012,Niger,NER,Norway,NOR,0,0,5,5,10
2012,Nigeria,NGA,Norway,NOR,10,0,152,179,341
2012,Pakistan,PAK,Norway,NOR,12,0,88,36,136
2012,Poland,POL,Norway,NOR,0,0,5,0,5
2012,Romania,ROU,Norway,NOR,0,0,10,5,15
2012,Russian Federation,RUS,Norway,NOR,18,0,275,115,408
2012,Rwanda,RWA,Norway,NOR,5,0,5,0,10
2012,El Salvador,SLV,Norway,NOR,0,0,5,0,5
2012,Serbia and Kosovo: S/RES/1244 (1999),SRB,Norway,NOR,0,0,154,107,261
2012,Senegal,SEN,Norway,NOR,0,0,10,5,15
2012,Sierra Leone,SLE,Norway,NOR,0,0,10,10,20
2012,Somalia,SOM,Norway,NOR,1124,726,303,380,2533
2012,Viet Nam,VNM,Norway,NOR,0,0,18,13,31
2012,Sudan,SDN,Norway,NOR,375,0,50,39,464
2012,Syrian Arab Rep.,SYR,Norway,NOR,56,188,12,57,313
2012,United Rep. of Tanzania,TZA,Norway,NOR,0,0,5,0,5
2012,Tajikistan,TJK,Norway,NOR,0,0,10,5,15
2012,Tunisia,TUN,Norway,NOR,0,0,18,56,74
2012,Turkey,TUR,Norway,NOR,5,0,27,10,42
2012,Uganda,UGA,Norway,NOR,16,0,17,10,43
2012,Ukraine,UKR,Norway,NOR,0,0,18,10,28
2012,Uzbekistan,UZB,Norway,NOR,10,0,130,17,157
2012,Yemen,YEM,Norway,NOR,10,5,44,5,64
2012,Zimbabwe,ZWE,Norway,NOR,0,0,5,0,5
2012,Stateless,XXA,Norway,NOR,50,39,117,76,282
2012,Iraq,IRQ,Nauru,NRU,0,0,0,5,5
2012,Sri Lanka,LKA,Nauru,NRU,0,0,0,29,29
2012,Afghanistan,AFG,New Zealand,NZL,5,0,0,0,5
2012,Egypt,EGY,New Zealand,NZL,10,0,10,0,20
2012,Bahrain,BHR,New Zealand,NZL,5,0,0,0,5
2012,Bangladesh,BGD,New Zealand,NZL,0,0,10,0,10
2012,China,CHN,New Zealand,NZL,10,0,22,0,32
2012,Czechia,CZE,New Zealand,NZL,0,0,10,0,10
2012,Fiji,FJI,New Zealand,NZL,0,0,32,0,32
2012,Palestinian,PSE,New Zealand,NZL,5,0,0,0,5
2012,Georgia,GEO,New Zealand,NZL,0,0,5,0,5
2012,Hungary,HUN,New Zealand,NZL,0,0,10,0,10
2012,India,IND,New Zealand,NZL,0,0,10,0,10
2012,Iran (Islamic Rep. of),IRN,New Zealand,NZL,16,0,22,0,38
2012,Iraq,IRQ,New Zealand,NZL,5,0,5,0,10
2012,Jordan,JOR,New Zealand,NZL,0,0,5,0,5
2012,Rep. of Korea,KOR,New Zealand,NZL,0,0,5,0,5
2012,Sri Lanka,LKA,New Zealand,NZL,10,0,10,0,20
2012,Nepal,NPL,New Zealand,NZL,0,0,5,0,5
2012,Pakistan,PAK,New Zealand,NZL,5,0,25,0,30
2012,South Africa,ZAF,New Zealand,NZL,0,0,5,0,5
2012,Saudi Arabia,SAU,New Zealand,NZL,0,0,5,0,5
2012,Viet Nam,VNM,New Zealand,NZL,0,0,5,0,5
2012,Switzerland,CHE,New Zealand,NZL,0,0,5,0,5
2012,Syrian Arab Rep.,SYR,New Zealand,NZL,10,0,5,0,15
2012,Turkey,TUR,New Zealand,NZL,5,0,5,0,10
2012,United Arab Emirates,ARE,New Zealand,NZL,0,0,5,0,5
2012,Afghanistan,AFG,Panama,PAN,0,0,5,0,5
2012,Bangladesh,BGD,Panama,PAN,0,0,0,5,5
2012,Colombia,COL,Panama,PAN,104,0,15,881,1000
2012,Cuba,CUB,Panama,PAN,14,0,0,55,69
2012,Dominican Rep.,DOM,Panama,PAN,5,0,0,0,5
2012,Eritrea,ERI,Panama,PAN,0,0,0,5,5
2012,Ethiopia,ETH,Panama,PAN,0,0,0,5,5
2012,Ghana,GHA,Panama,PAN,0,0,0,10,10
2012,Haiti,HTI,Panama,PAN,5,0,0,0,5
2012,Honduras,HND,Panama,PAN,0,0,0,5,5
2012,India,IND,Panama,PAN,0,0,0,14,14
2012,Libya,LBY,Panama,PAN,0,0,0,5,5
2012,Mexico,MEX,Panama,PAN,5,0,0,0,5
2012,Nicaragua,NIC,Panama,PAN,0,0,0,5,5
2012,Pakistan,PAK,Panama,PAN,0,0,0,5,5
2012,Peru,PER,Panama,PAN,0,0,0,5,5
2012,Venezuela (Bolivarian Republic of),VEN,Panama,PAN,5,0,0,12,17
2012,Bolivia (Plurinational State of),BOL,Paraguay,PRY,5,0,0,0,5
2012,Bangladesh,BGD,Peru,PER,5,0,5,0,10
2012,Colombia,COL,Peru,PER,119,0,0,80,199
2012,Cuba,CUB,Peru,PER,5,0,121,11,137
2012,Haiti,HTI,Peru,PER,0,0,0,5,5
2012,Nigeria,NGA,Peru,PER,5,0,0,0,5
2012,Venezuela (Bolivarian Republic of),VEN,Peru,PER,5,0,5,0,10
2012,Afghanistan,AFG,Philippines,PHL,5,0,0,0,5
2012,Palestinian,PSE,Philippines,PHL,0,0,0,10,10
2012,Iran (Islamic Rep. of),IRN,Philippines,PHL,17,0,0,5,22
2012,Iraq,IRQ,Philippines,PHL,0,0,0,5,5
2012,Pakistan,PAK,Philippines,PHL,0,0,0,5,5
2012,Afghanistan,AFG,Poland,POL,0,5,26,17,48
2012,Angola,AGO,Poland,POL,0,0,0,5,5
2012,Egypt,EGY,Poland,POL,0,0,13,68,81
2012,Armenia,ARM,Poland,POL,0,0,111,320,431
2012,Azerbaijan,AZE,Poland,POL,0,0,0,5,5
2012,Bangladesh,BGD,Poland,POL,0,0,5,10,15
2012,Belarus,BLR,Poland,POL,24,5,18,26,73
2012,China,CHN,Poland,POL,5,0,0,0,5
2012,Cameroon,CMR,Poland,POL,0,0,5,5,10
2012,Congo,COG,Poland,POL,0,0,5,5,10
2012,Dem. Rep. of the Congo,COD,Poland,POL,0,0,5,10,15
2012,Palestinian,PSE,Poland,POL,0,0,0,5,5
2012,Georgia,GEO,Poland,POL,0,0,468,2934,3402
2012,Guinea,GIN,Poland,POL,0,0,0,5,5
2012,India,IND,Poland,POL,0,0,5,5,10
2012,Iran (Islamic Rep. of),IRN,Poland,POL,0,0,10,12,22
2012,Iraq,IRQ,Poland,POL,0,0,0,12,12
2012,Kazakhstan,KAZ,Poland,POL,0,0,10,43,53
2012,Kyrgyzstan,KGZ,Poland,POL,0,0,13,20,33
2012,Lebanon,LBN,Poland,POL,0,0,0,5,5
2012,Rep. of Moldova,MDA,Poland,POL,0,0,0,5,5
2012,Mongolia,MNG,Poland,POL,0,0,5,10,15
2012,Morocco,MAR,Poland,POL,0,0,5,0,5
2012,Nepal,NPL,Poland,POL,0,0,5,10,15
2012,Nigeria,NGA,Poland,POL,0,0,12,5,17
2012,Pakistan,PAK,Poland,POL,0,0,17,28,45
2012,Russian Federation,RUS,Poland,POL,65,142,1098,5050,6355
2012,Viet Nam,VNM,Poland,POL,0,0,40,10,50
2012,Syrian Arab Rep.,SYR,Poland,POL,0,5,0,24,29
2012,Tajikistan,TJK,Poland,POL,0,0,0,10,10
2012,Turkmenistan,TKM,Poland,POL,0,0,0,5,5
2012,Tunisia,TUN,Poland,POL,0,0,0,5,5
2012,Turkey,TUR,Poland,POL,5,0,5,5,15
2012,Ukraine,UKR,Poland,POL,0,0,48,32,80
2012,Uzbekistan,UZB,Poland,POL,0,0,13,5,18
2012,Stateless,XXA,Poland,POL,0,0,5,25,30
2012,Afghanistan,AFG,Portugal,PRT,0,0,0,5,5
2012,Angola,AGO,Portugal,PRT,0,0,0,5,5
2012,Belarus,BLR,Portugal,PRT,0,0,0,10,10
2012,Bosnia and Herzegovina,BIH,Portugal,PRT,0,5,0,0,5
2012,Cameroon,CMR,Portugal,PRT,0,5,0,5,10
2012,Congo,COG,Portugal,PRT,0,0,0,5,5
2012,Dem. Rep. of the Congo,COD,Portugal,PRT,0,5,0,5,10
2012,Colombia,COL,Portugal,PRT,0,5,0,10,15
2012,Georgia,GEO,Portugal,PRT,0,0,0,5,5
2012,Ghana,GHA,Portugal,PRT,0,0,0,5,5
2012,Guinea-Bissau,GNB,Portugal,PRT,0,0,0,12,12
2012,Guinea,GIN,Portugal,PRT,0,28,0,48,76
2012,Cote d'Ivoire,CIV,Portugal,PRT,0,13,0,5,18
2012,Iran (Islamic Rep. of),IRN,Portugal,PRT,5,0,0,5,10
2012,Sri Lanka,LKA,Portugal,PRT,0,0,0,5,5
2012,Morocco,MAR,Portugal,PRT,0,0,0,5,5
2012,Nigeria,NGA,Portugal,PRT,0,5,0,26,31
2012,Pakistan,PAK,Portugal,PRT,0,0,0,5,5
2012,Russian Federation,RUS,Portugal,PRT,0,5,0,5,10
2012,Senegal,SEN,Portugal,PRT,0,0,0,5,5
2012,Sierra Leone,SLE,Portugal,PRT,0,5,0,0,5
2012,Somalia,SOM,Portugal,PRT,0,5,0,5,10
2012,Syrian Arab Rep.,SYR,Portugal,PRT,0,0,0,13,13
2012,Ukraine,UKR,Portugal,PRT,0,0,0,5,5
2012,Algeria,DZA,South Africa,ZAF,0,0,149,0,149
2012,Angola,AGO,South Africa,ZAF,0,0,58,0,58
2012,Egypt,EGY,South Africa,ZAF,0,0,274,0,274
2012,Burundi,BDI,South Africa,ZAF,10,0,473,5,488
2012,Benin,BEN,South Africa,ZAF,0,0,43,0,43
2012,Bangladesh,BGD,South Africa,ZAF,64,0,3140,0,3204
2012,Burkina Faso,BFA,South Africa,ZAF,0,0,19,0,19
2012,China,CHN,South Africa,ZAF,0,0,1346,0,1346
2012,Chile,CHL,South Africa,ZAF,0,0,5,0,5
2012,Cameroon,CMR,South Africa,ZAF,0,0,720,0,720
2012,Congo,COG,South Africa,ZAF,164,0,941,0,1105
2012,Dem. Rep. of the Congo,COD,South Africa,ZAF,489,0,3237,0,3726
2012,Comoros,COM,South Africa,ZAF,0,0,5,0,5
2012,Eritrea,ERI,South Africa,ZAF,253,0,50,0,303
2012,Estonia,EST,South Africa,ZAF,0,0,5,0,5
2012,Ethiopia,ETH,South Africa,ZAF,2163,0,6622,0,8785
2012,Gabon,GAB,South Africa,ZAF,0,0,5,0,5
2012,Gambia,GMB,South Africa,ZAF,0,0,5,0,5
2012,Palestinian,PSE,South Africa,ZAF,0,0,5,0,5
2012,Ghana,GHA,South Africa,ZAF,0,0,2124,0,2124
2012,Guinea-Bissau,GNB,South Africa,ZAF,0,0,5,0,5
2012,Guinea,GIN,South Africa,ZAF,0,0,10,0,10
2012,Cote d'Ivoire,CIV,South Africa,ZAF,0,0,59,0,59
2012,India,IND,South Africa,ZAF,0,0,2701,0,2701
2012,Kenya,KEN,South Africa,ZAF,0,0,247,0,247
2012,Liberia,LBR,South Africa,ZAF,0,0,18,0,18
2012,Lesotho,LSO,South Africa,ZAF,0,0,371,0,371
2012,Sri Lanka,LKA,South Africa,ZAF,0,0,26,0,26
2012,Mali,MLI,South Africa,ZAF,0,0,34,0,34
2012,Malawi,MWI,South Africa,ZAF,0,0,3017,0,3017
2012,Morocco,MAR,South Africa,ZAF,0,0,5,0,5
2012,Mozambique,MOZ,South Africa,ZAF,0,0,1327,0,1327
2012,Nepal,NPL,South Africa,ZAF,0,0,60,0,60
2012,Niger,NER,South Africa,ZAF,0,0,94,0,94
2012,Nigeria,NGA,South Africa,ZAF,0,0,6403,0,6403
2012,Pakistan,PAK,South Africa,ZAF,0,0,3641,0,3641
2012,Philippines,PHL,South Africa,ZAF,0,0,5,0,5
2012,Rwanda,RWA,South Africa,ZAF,5,0,78,0,83
2012,Senegal,SEN,South Africa,ZAF,0,0,237,0,237
2012,Sierra Leone,SLE,South Africa,ZAF,0,0,5,0,5
2012,Somalia,SOM,South Africa,ZAF,3046,0,579,0,3625
2012,Sudan,SDN,South Africa,ZAF,0,0,5,0,5
2012,Eswatini,SWZ,South Africa,ZAF,0,0,24,0,24
2012,United Rep. of Tanzania,TZA,South Africa,ZAF,0,0,162,0,162
2012,Thailand,THA,South Africa,ZAF,0,0,5,0,5
2012,Togo,TGO,South Africa,ZAF,0,0,22,0,22
2012,Uganda,UGA,South Africa,ZAF,5,0,1677,0,1682
2012,Zambia,ZMB,South Africa,ZAF,0,0,160,0,160
2012,Zimbabwe,ZWE,South Africa,ZAF,10,0,16776,0,16786
2012,Afghanistan,AFG,Russian Federation,RUS,76,0,438,0,514
2012,Egypt,EGY,Russian Federation,RUS,0,0,10,0,10
2012,Armenia,ARM,Russian Federation,RUS,0,0,5,0,5
2012,Azerbaijan,AZE,Russian Federation,RUS,0,0,5,0,5
2012,Bangladesh,BGD,Russian Federation,RUS,0,0,5,0,5
2012,Belarus,BLR,Russian Federation,RUS,0,0,10,0,10
2012,China,CHN,Russian Federation,RUS,0,0,5,0,5
2012,Congo,COG,Russian Federation,RUS,0,0,5,0,5
2012,Dem. Rep. of the Congo,COD,Russian Federation,RUS,0,0,12,0,12
2012,Eritrea,ERI,Russian Federation,RUS,0,0,5,0,5
2012,Georgia,GEO,Russian Federation,RUS,5,0,316,0,321
2012,Guinea,GIN,Russian Federation,RUS,0,0,5,0,5
2012,Cote d'Ivoire,CIV,Russian Federation,RUS,0,0,5,0,5
2012,Iran (Islamic Rep. of),IRN,Russian Federation,RUS,0,0,5,0,5
2012,Iraq,IRQ,Russian Federation,RUS,0,0,13,0,13
2012,Kazakhstan,KAZ,Russian Federation,RUS,0,0,12,0,12
2012,Kyrgyzstan,KGZ,Russian Federation,RUS,0,0,45,0,45
2012,Dem. People's Rep. of Korea,PRK,Russian Federation,RUS,0,0,38,0,38
2012,Lebanon,LBN,Russian Federation,RUS,5,0,0,0,5
2012,Rep. of Moldova,MDA,Russian Federation,RUS,0,0,5,0,5
2012,Nigeria,NGA,Russian Federation,RUS,0,0,5,0,5
2012,Pakistan,PAK,Russian Federation,RUS,0,0,5,0,5
2012,Viet Nam,VNM,Russian Federation,RUS,0,0,5,0,5
2012,Sudan,SDN,Russian Federation,RUS,0,0,5,0,5
2012,Syrian Arab Rep.,SYR,Russian Federation,RUS,0,0,137,0,137
2012,Tajikistan,TJK,Russian Federation,RUS,5,0,16,0,21
2012,Turkmenistan,TKM,Russian Federation,RUS,0,0,10,0,10
2012,Ukraine,UKR,Russian Federation,RUS,0,0,13,0,13
2012,United States of America,USA,Russian Federation,RUS,0,0,5,0,5
2012,Uzbekistan,UZB,Russian Federation,RUS,5,0,68,0,73
2012,Yemen,YEM,Russian Federation,RUS,0,0,5,0,5
2012,Unknown ,,Russian Federation,RUS,0,0,16,0,16
2012,Honduras,HND,El Salvador,SLV,5,0,0,0,5
2012,Afghanistan,AFG,Serbia and Kosovo: S/RES/1244 (1999),SRB,0,0,31,875,906
2012,Algeria,DZA,Serbia and Kosovo: S/RES/1244 (1999),SRB,0,0,12,169,181
2012,Egypt,EGY,Serbia and Kosovo: S/RES/1244 (1999),SRB,0,0,0,10,10
2012,Bangladesh,BGD,Serbia and Kosovo: S/RES/1244 (1999),SRB,0,0,0,104,104
2012,Burkina Faso,BFA,Serbia and Kosovo: S/RES/1244 (1999),SRB,0,0,0,5,5
2012,Eritrea,ERI,Serbia and Kosovo: S/RES/1244 (1999),SRB,0,0,0,99,99
2012,Gambia,GMB,Serbia and Kosovo: S/RES/1244 (1999),SRB,0,0,0,14,14
2012,Palestinian,PSE,Serbia and Kosovo: S/RES/1244 (1999),SRB,0,0,5,52,57
2012,Guinea-Bissau,GNB,Serbia and Kosovo: S/RES/1244 (1999),SRB,0,0,0,5,5
2012,Guinea,GIN,Serbia and Kosovo: S/RES/1244 (1999),SRB,0,0,0,12,12
2012,India,IND,Serbia and Kosovo: S/RES/1244 (1999),SRB,0,0,0,10,10
2012,Iran (Islamic Rep. of),IRN,Serbia and Kosovo: S/RES/1244 (1999),SRB,0,0,0,23,23
2012,Iraq,IRQ,Serbia and Kosovo: S/RES/1244 (1999),SRB,0,0,0,14,14
2012,Libya,LBY,Serbia and Kosovo: S/RES/1244 (1999),SRB,0,0,0,44,44
2012,Mauritania,MRT,Serbia and Kosovo: S/RES/1244 (1999),SRB,0,0,0,5,5
2012,Mali,MLI,Serbia and Kosovo: S/RES/1244 (1999),SRB,0,0,0,19,19
2012,Morocco,MAR,Serbia and Kosovo: S/RES/1244 (1999),SRB,0,0,0,84,84
2012,Myanmar,MMR,Serbia and Kosovo: S/RES/1244 (1999),SRB,0,0,0,11,11
2012,Netherlands,NLD,Serbia and Kosovo: S/RES/1244 (1999),SRB,0,0,0,5,5
2012,Nigeria,NGA,Serbia and Kosovo: S/RES/1244 (1999),SRB,0,0,0,5,5
2012,Pakistan,PAK,Serbia and Kosovo: S/RES/1244 (1999),SRB,0,0,0,230,230
2012,Sierra Leone,SLE,Serbia and Kosovo: S/RES/1244 (1999),SRB,0,0,0,5,5
2012,Somalia,SOM,Serbia and Kosovo: S/RES/1244 (1999),SRB,0,0,25,613,638
2012,Sudan,SDN,Serbia and Kosovo: S/RES/1244 (1999),SRB,0,0,0,48,48
2012,Syrian Arab Rep.,SYR,Serbia and Kosovo: S/RES/1244 (1999),SRB,0,0,0,238,238
2012,Tunisia,TUN,Serbia and Kosovo: S/RES/1244 (1999),SRB,0,0,5,39,44
2012,Eritrea,ERI,Senegal,SEN,0,0,10,0,10
2012,Gambia,GMB,Senegal,SEN,0,0,10,0,10
2012,Guinea,GIN,Senegal,SEN,0,0,10,0,10
2012,Cote d'Ivoire,CIV,Senegal,SEN,0,0,27,0,27
2012,Liberia,LBR,Senegal,SEN,0,0,20,5,25
2012,Mauritania,MRT,Senegal,SEN,0,0,5,0,5
2012,Nigeria,NGA,Senegal,SEN,0,0,5,0,5
2012,Sierra Leone,SLE,Senegal,SEN,0,0,5,0,5
2012,Cote d'Ivoire,CIV,Sierra Leone,SLE,0,0,0,5,5
2012,Afghanistan,AFG,Spain,ESP,5,25,0,0,30
2012,Algeria,DZA,Spain,ESP,5,0,200,0,205
2012,Angola,AGO,Spain,ESP,0,0,15,0,15
2012,Egypt,EGY,Spain,ESP,0,0,20,0,20
2012,Armenia,ARM,Spain,ESP,5,0,5,0,10
2012,Azerbaijan,AZE,Spain,ESP,10,0,0,0,10
2012,Burundi,BDI,Spain,ESP,0,0,5,0,5
2012,Benin,BEN,Spain,ESP,0,0,10,0,10
2012,Bangladesh,BGD,Spain,ESP,0,0,10,0,10
2012,Burkina Faso,BFA,Spain,ESP,0,0,15,0,15
2012,Belarus,BLR,Spain,ESP,0,0,5,0,5
2012,Central African Rep.,CAF,Spain,ESP,0,0,5,0,5
2012,Chad,TCD,Spain,ESP,0,0,20,0,20
2012,Cameroon,CMR,Spain,ESP,5,0,220,0,225
2012,Congo,COG,Spain,ESP,5,0,40,0,45
2012,Dem. Rep. of the Congo,COD,Spain,ESP,5,0,80,15,100
2012,Colombia,COL,Spain,ESP,15,5,100,0,120
2012,Cuba,CUB,Spain,ESP,0,25,40,0,65
2012,Ecuador,ECU,Spain,ESP,0,0,5,0,5
2012,Equatorial Guinea,GNQ,Spain,ESP,0,0,5,0,5
2012,Eritrea,ERI,Spain,ESP,10,5,5,0,20
2012,Ethiopia,ETH,Spain,ESP,0,35,10,0,45
2012,Gambia,GMB,Spain,ESP,0,0,30,0,30
2012,Palestinian,PSE,Spain,ESP,75,15,5,0,95
2012,Georgia,GEO,Spain,ESP,0,0,10,0,10
2012,Ghana,GHA,Spain,ESP,0,0,25,0,25
2012,Guinea-Bissau,GNB,Spain,ESP,0,0,5,0,5
2012,Guatemala,GTM,Spain,ESP,0,0,10,0,10
2012,Guinea,GIN,Spain,ESP,0,0,130,0,130
2012,Haiti,HTI,Spain,ESP,5,0,0,0,5
2012,Honduras,HND,Spain,ESP,5,0,45,0,50
2012,Cote d'Ivoire,CIV,Spain,ESP,0,55,45,0,100
2012,India,IND,Spain,ESP,0,0,10,0,10
2012,Iran (Islamic Rep. of),IRN,Spain,ESP,0,0,40,0,40
2012,Iraq,IRQ,Spain,ESP,0,5,0,0,5
2012,Jordan,JOR,Spain,ESP,0,5,0,0,5
2012,Liberia,LBR,Spain,ESP,0,0,5,0,5
2012,Libya,LBY,Spain,ESP,0,0,10,0,10
2012,Sri Lanka,LKA,Spain,ESP,5,15,20,0,40
2012,Mauritania,MRT,Spain,ESP,0,0,5,0,5
2012,Mexico,MEX,Spain,ESP,0,0,10,0,10
2012,Mali,MLI,Spain,ESP,0,0,20,0,20
2012,Malawi,MWI,Spain,ESP,0,0,15,0,15
2012,Mongolia,MNG,Spain,ESP,0,0,5,0,5
2012,Morocco,MAR,Spain,ESP,0,5,50,0,55
2012,Niger,NER,Spain,ESP,0,0,10,0,10
2012,Nicaragua,NIC,Spain,ESP,5,0,15,0,20
2012,Nigeria,NGA,Spain,ESP,0,0,300,0,300
2012,Pakistan,PAK,Spain,ESP,30,5,35,0,70
2012,Romania,ROU,Spain,ESP,0,0,5,0,5
2012,Russian Federation,RUS,Spain,ESP,5,0,25,0,30
2012,Rwanda,RWA,Spain,ESP,0,0,5,0,5
2012,El Salvador,SLV,Spain,ESP,0,0,40,0,40
2012,Senegal,SEN,Spain,ESP,0,0,25,0,25
2012,Sierra Leone,SLE,Spain,ESP,0,0,20,0,20
2012,Somalia,SOM,Spain,ESP,5,45,5,10,65
2012,Sudan,SDN,Spain,ESP,0,35,5,0,40
2012,Syrian Arab Rep.,SYR,Spain,ESP,0,0,15,0,15
2012,Togo,TGO,Spain,ESP,0,0,5,0,5
2012,Turkey,TUR,Spain,ESP,0,0,30,0,30
2012,Uganda,UGA,Spain,ESP,0,0,5,0,5
2012,Ukraine,UKR,Spain,ESP,0,0,15,0,15
2012,Venezuela (Bolivarian Republic of),VEN,Spain,ESP,0,0,30,0,30
2012,Western Sahara,ESH,Spain,ESP,5,0,65,0,70
2012,Yemen,YEM,Spain,ESP,5,0,0,0,5
2012,Zimbabwe,ZWE,Spain,ESP,0,0,5,0,5
2012,Unknown ,,Spain,ESP,15,15,110,0,140
2012,Chad,TCD,Sudan,SDN,21,0,0,0,21
2012,Cameroon,CMR,Sudan,SDN,0,0,12,0,12
2012,Dem. Rep. of the Congo,COD,Sudan,SDN,0,0,5,0,5
2012,Eritrea,ERI,Sudan,SDN,13449,0,47,127,13623
2012,Ethiopia,ETH,Sudan,SDN,211,0,5,5,221
2012,Guinea,GIN,Sudan,SDN,0,0,5,0,5
2012,Cote d'Ivoire,CIV,Sudan,SDN,0,0,10,5,15
2012,Liberia,LBR,Sudan,SDN,0,0,15,12,27
2012,Mali,MLI,Sudan,SDN,0,0,5,5,10
2012,Nigeria,NGA,Sudan,SDN,0,0,16,0,16
2012,Sierra Leone,SLE,Sudan,SDN,0,0,5,5,10
2012,Somalia,SOM,Sudan,SDN,257,0,0,0,257
2012,Afghanistan,AFG,Slovakia,SVK,10,29,42,37,118
2012,Algeria,DZA,Slovakia,SVK,0,0,5,5,10
2012,Armenia,ARM,Slovakia,SVK,0,0,0,34,34
2012,Bangladesh,BGD,Slovakia,SVK,0,0,5,10,15
2012,China,CHN,Slovakia,SVK,0,0,5,13,18
2012,Cameroon,CMR,Slovakia,SVK,0,0,5,0,5
2012,Congo,COG,Slovakia,SVK,0,0,5,35,40
2012,Dem. Rep. of the Congo,COD,Slovakia,SVK,0,0,19,12,31
2012,Cuba,CUB,Slovakia,SVK,5,0,0,0,5
2012,Eritrea,ERI,Slovakia,SVK,0,0,0,11,11
2012,Gambia,GMB,Slovakia,SVK,0,0,0,5,5
2012,Palestinian,PSE,Slovakia,SVK,0,0,0,5,5
2012,Georgia,GEO,Slovakia,SVK,0,0,11,50,61
2012,Guinea,GIN,Slovakia,SVK,0,0,0,5,5
2012,India,IND,Slovakia,SVK,0,0,0,17,17
2012,Iran (Islamic Rep. of),IRN,Slovakia,SVK,0,0,10,0,10
2012,Iraq,IRQ,Slovakia,SVK,0,0,0,5,5
2012,Rep. of Moldova,MDA,Slovakia,SVK,0,0,5,24,29
2012,Morocco,MAR,Slovakia,SVK,0,0,0,5,5
2012,Pakistan,PAK,Slovakia,SVK,0,0,5,10,15
2012,Russian Federation,RUS,Slovakia,SVK,0,0,5,10,15
2012,Serbia and Kosovo: S/RES/1244 (1999),SRB,Slovakia,SVK,0,0,5,0,5
2012,Somalia,SOM,Slovakia,SVK,10,72,37,95,214
2012,Viet Nam,VNM,Slovakia,SVK,0,0,5,12,17
2012,Syrian Arab Rep.,SYR,Slovakia,SVK,0,0,5,0,5
2012,Thailand,THA,Slovakia,SVK,0,0,0,5,5
2012,Tajikistan,TJK,Slovakia,SVK,0,0,0,5,5
2012,Turkey,TUR,Slovakia,SVK,0,0,10,5,15
2012,Ukraine,UKR,Slovakia,SVK,0,0,5,5,10
2012,Afghanistan,AFG,Slovenia,SVN,5,5,39,25,74
2012,Algeria,DZA,Slovenia,SVN,0,0,10,10,20
2012,Egypt,EGY,Slovenia,SVN,0,0,5,0,5
2012,Bosnia and Herzegovina,BIH,Slovenia,SVN,0,0,5,0,5
2012,China,CHN,Slovenia,SVN,0,0,5,0,5
2012,Cuba,CUB,Slovenia,SVN,0,0,5,0,5
2012,Palestinian,PSE,Slovenia,SVN,0,0,5,5,10
2012,Croatia,HRV,Slovenia,SVN,0,0,10,0,10
2012,Iran (Islamic Rep. of),IRN,Slovenia,SVN,5,0,5,0,10
2012,Libya,LBY,Slovenia,SVN,0,0,0,5,5
2012,Lebanon,LBN,Slovenia,SVN,0,0,5,0,5
2012,Morocco,MAR,Slovenia,SVN,0,0,5,5,10
2012,Nigeria,NGA,Slovenia,SVN,0,0,0,5,5
2012,Pakistan,PAK,Slovenia,SVN,0,0,5,5,10
2012,Serbia and Kosovo: S/RES/1244 (1999),SRB,Slovenia,SVN,0,5,30,5,40
2012,Somalia,SOM,Slovenia,SVN,5,0,0,0,5
2012,Syrian Arab Rep.,SYR,Slovenia,SVN,0,0,13,16,29
2012,Tunisia,TUN,Slovenia,SVN,0,0,0,5,5
2012,Turkey,TUR,Slovenia,SVN,0,0,12,12,24
2012,Dem. Rep. of the Congo,COD,Eswatini,SWZ,5,0,0,0,5
2012,Rwanda,RWA,Eswatini,SWZ,5,0,0,0,5
2012,Afghanistan,AFG,Sweden,SWE,783,1188,912,292,3175
2012,Albania,ALB,Sweden,SWE,27,20,880,279,1206
2012,Algeria,DZA,Sweden,SWE,0,0,91,104,195
2012,Angola,AGO,Sweden,SWE,0,0,10,0,10
2012,Egypt,EGY,Sweden,SWE,27,0,88,13,128
2012,Armenia,ARM,Sweden,SWE,0,0,174,34,208
2012,Azerbaijan,AZE,Sweden,SWE,13,0,210,42,265
2012,Burundi,BDI,Sweden,SWE,0,0,5,0,5
2012,Bangladesh,BGD,Sweden,SWE,12,0,77,5,94
2012,Burkina Faso,BFA,Sweden,SWE,0,0,5,0,5
2012,Belarus,BLR,Sweden,SWE,5,0,190,124,319
2012,Bolivia (Plurinational State of),BOL,Sweden,SWE,0,0,28,5,33
2012,Bosnia and Herzegovina,BIH,Sweden,SWE,0,0,1270,636,1906
2012,Chad,TCD,Sweden,SWE,0,0,0,5,5
2012,China,CHN,Sweden,SWE,53,0,29,14,96
2012,Chile,CHL,Sweden,SWE,0,0,5,0,5
2012,Cameroon,CMR,Sweden,SWE,10,0,18,5,33
2012,Congo,COG,Sweden,SWE,0,5,5,0,10
2012,Dem. Rep. of the Congo,COD,Sweden,SWE,17,10,43,5,75
2012,Colombia,COL,Sweden,SWE,0,0,5,0,5
2012,Cuba,CUB,Sweden,SWE,0,0,36,20,56
2012,Djibouti,DJI,Sweden,SWE,0,0,5,0,5
2012,Ecuador,ECU,Sweden,SWE,0,0,10,5,15
2012,Eritrea,ERI,Sweden,SWE,199,1080,89,209,1577
2012,Estonia,EST,Sweden,SWE,0,0,0,5,5
2012,Ethiopia,ETH,Sweden,SWE,54,5,156,31,246
2012,Gambia,GMB,Sweden,SWE,10,0,47,10,67
2012,Georgia,GEO,Sweden,SWE,0,0,158,194,352
2012,Ghana,GHA,Sweden,SWE,5,0,29,5,39
2012,Greece,GRC,Sweden,SWE,0,0,5,5,10
2012,Guatemala,GTM,Sweden,SWE,0,5,0,0,5
2012,Guinea,GIN,Sweden,SWE,0,0,22,10,32
2012,Honduras,HND,Sweden,SWE,0,0,5,0,5
2012,Croatia,HRV,Sweden,SWE,0,0,5,5,10
2012,Hungary,HUN,Sweden,SWE,0,0,13,0,13
2012,Cote d'Ivoire,CIV,Sweden,SWE,0,0,12,5,17
2012,India,IND,Sweden,SWE,0,0,29,5,34
2012,Iran (Islamic Rep. of),IRN,Sweden,SWE,416,22,537,88,1063
2012,Iraq,IRQ,Sweden,SWE,217,123,499,131,970
2012,Israel,ISR,Sweden,SWE,0,0,15,5,20
2012,Jordan,JOR,Sweden,SWE,5,0,59,22,86
2012,Japan,JPN,Sweden,SWE,0,0,5,0,5
2012,Kazakhstan,KAZ,Sweden,SWE,5,0,277,38,320
2012,Kenya,KEN,Sweden,SWE,0,0,51,5,56
2012,Kyrgyzstan,KGZ,Sweden,SWE,5,5,218,20,248
2012,Rep. of Korea,KOR,Sweden,SWE,0,0,5,0,5
2012,Kuwait,KWT,Sweden,SWE,0,0,10,0,10
2012,Liberia,LBR,Sweden,SWE,0,0,5,0,5
2012,Libya,LBY,Sweden,SWE,11,12,64,64,151
2012,Lebanon,LBN,Sweden,SWE,5,5,152,36,198
2012,Sri Lanka,LKA,Sweden,SWE,0,0,5,5,10
2012,Latvia,LVA,Sweden,SWE,0,0,5,0,5
2012,North Macedonia,MKD,Sweden,SWE,0,0,348,99,447
2012,Rep. of Moldova,MDA,Sweden,SWE,0,0,5,5,10
2012,Mexico,MEX,Sweden,SWE,0,0,5,0,5
2012,Mali,MLI,Sweden,SWE,0,0,5,5,10
2012,Mongolia,MNG,Sweden,SWE,5,0,474,44,523
2012,Morocco,MAR,Sweden,SWE,0,0,110,76,186
2012,Montenegro,MNE,Sweden,SWE,0,0,85,13,98
2012,Myanmar,MMR,Sweden,SWE,0,0,5,0,5
2012,Nepal,NPL,Sweden,SWE,0,0,11,0,11
2012,Nicaragua,NIC,Sweden,SWE,0,0,18,0,18
2012,Nigeria,NGA,Sweden,SWE,27,0,199,48,274
2012,Pakistan,PAK,Sweden,SWE,32,5,118,19,174
2012,Peru,PER,Sweden,SWE,0,0,5,5,10
2012,Philippines,PHL,Sweden,SWE,0,0,5,0,5
2012,Romania,ROU,Sweden,SWE,0,0,12,5,17
2012,Russian Federation,RUS,Sweden,SWE,53,29,319,173,574
2012,Rwanda,RWA,Sweden,SWE,5,0,5,0,10
2012,El Salvador,SLV,Sweden,SWE,0,10,43,0,53
2012,Serbia and Kosovo: S/RES/1244 (1999),SRB,Sweden,SWE,0,0,2671,702,3373
2012,Senegal,SEN,Sweden,SWE,0,0,16,5,21
2012,Sierra Leone,SLE,Sweden,SWE,5,0,17,5,27
2012,Somalia,SOM,Sweden,SWE,321,1708,220,981,3230
2012,Spain,ESP,Sweden,SWE,0,0,5,0,5
2012,Viet Nam,VNM,Sweden,SWE,0,0,17,10,27
2012,Sudan,SDN,Sweden,SWE,27,14,20,17,78
2012,Slovakia,SVK,Sweden,SWE,0,0,0,5,5
2012,Syrian Arab Rep.,SYR,Sweden,SWE,1133,3643,47,218,5041
2012,United Rep. of Tanzania,TZA,Sweden,SWE,5,0,10,0,15
2012,Thailand,THA,Sweden,SWE,0,0,5,0,5
2012,Tajikistan,TJK,Sweden,SWE,0,0,17,5,22
2012,Turkmenistan,TKM,Sweden,SWE,0,0,5,5,10
2012,Tunisia,TUN,Sweden,SWE,0,0,35,40,75
2012,Turkey,TUR,Sweden,SWE,15,5,63,20,103
2012,Uganda,UGA,Sweden,SWE,67,0,70,10,147
2012,Ukraine,UKR,Sweden,SWE,0,0,91,24,115
2012,United States of America,USA,Sweden,SWE,0,0,5,5,10
2012,Uzbekistan,UZB,Sweden,SWE,28,0,240,27,295
2012,Yemen,YEM,Sweden,SWE,38,25,67,10,140
2012,Zimbabwe,ZWE,Sweden,SWE,0,0,5,0,5
2012,Stateless,XXA,Sweden,SWE,299,509,359,189,1356
2012,Unknown ,,Sweden,SWE,5,31,507,92,635
2012,Afghanistan,AFG,Switzerland,CHE,38,135,26,389,588
2012,Albania,ALB,Switzerland,CHE,0,0,22,40,62
2012,Algeria,DZA,Switzerland,CHE,0,0,79,614,693
2012,Angola,AGO,Switzerland,CHE,0,40,28,18,86
2012,Egypt,EGY,Switzerland,CHE,0,0,10,124,134
2012,Armenia,ARM,Switzerland,CHE,0,0,22,91,113
2012,Azerbaijan,AZE,Switzerland,CHE,5,0,18,10,33
2012,Bahrain,BHR,Switzerland,CHE,0,0,0,5,5
2012,Burundi,BDI,Switzerland,CHE,5,0,0,0,5
2012,Benin,BEN,Switzerland,CHE,0,0,0,22,22
2012,Bangladesh,BGD,Switzerland,CHE,0,5,5,25,35
2012,Burkina Faso,BFA,Switzerland,CHE,0,0,5,22,27
2012,Belarus,BLR,Switzerland,CHE,0,0,12,135,147
2012,Bosnia and Herzegovina,BIH,Switzerland,CHE,5,11,202,315,533
2012,Bulgaria,BGR,Switzerland,CHE,0,0,16,128,144
2012,Cambodia,KHM,Switzerland,CHE,0,0,5,0,5
2012,Chad,TCD,Switzerland,CHE,0,0,0,202,202
2012,China,CHN,Switzerland,CHE,16,90,10,18,134
2012,Cameroon,CMR,Switzerland,CHE,5,5,11,30,51
2012,Congo,COG,Switzerland,CHE,0,0,0,10,10
2012,Dem. Rep. of the Congo,COD,Switzerland,CHE,0,54,53,40,147
2012,Colombia,COL,Switzerland,CHE,24,0,5,5,34
2012,Cuba,CUB,Switzerland,CHE,0,0,5,5,10
2012,Czechia,CZE,Switzerland,CHE,0,0,5,5,10
2012,Ecuador,ECU,Switzerland,CHE,0,0,5,0,5
2012,Equatorial Guinea,GNQ,Switzerland,CHE,0,0,5,5,10
2012,Eritrea,ERI,Switzerland,CHE,1332,214,24,540,2110
2012,Ethiopia,ETH,Switzerland,CHE,44,28,33,75,180
2012,France,FRA,Switzerland,CHE,0,0,0,5,5
2012,Gabon,GAB,Switzerland,CHE,0,0,5,5,10
2012,Gambia,GMB,Switzerland,CHE,0,5,31,411,447
2012,Palestinian,PSE,Switzerland,CHE,11,14,0,96,121
2012,Georgia,GEO,Switzerland,CHE,0,0,26,659,685
2012,Ghana,GHA,Switzerland,CHE,0,5,10,397,412
2012,Guinea-Bissau,GNB,Switzerland,CHE,0,10,58,218,286
2012,Greece,GRC,Switzerland,CHE,0,0,0,5,5
2012,Guinea,GIN,Switzerland,CHE,0,12,46,282,340
2012,Croatia,HRV,Switzerland,CHE,0,0,5,34,39
2012,Hungary,HUN,Switzerland,CHE,0,0,0,19,19
2012,Cote d'Ivoire,CIV,Switzerland,CHE,0,5,5,114,124
2012,India,IND,Switzerland,CHE,0,0,0,11,11
2012,Iran (Islamic Rep. of),IRN,Switzerland,CHE,92,62,51,125,330
2012,Iraq,IRQ,Switzerland,CHE,136,157,76,207,576
2012,Israel,ISR,Switzerland,CHE,0,0,0,5,5
2012,Italy,ITA,Switzerland,CHE,0,0,0,5,5
2012,Jordan,JOR,Switzerland,CHE,5,0,0,5,10
2012,Kenya,KEN,Switzerland,CHE,10,0,0,10,20
2012,Kyrgyzstan,KGZ,Switzerland,CHE,5,0,5,14,24
2012,Liberia,LBR,Switzerland,CHE,0,0,0,74,74
2012,Libya,LBY,Switzerland,CHE,5,0,5,189,199
2012,Lebanon,LBN,Switzerland,CHE,0,0,0,22,22
2012,Sri Lanka,LKA,Switzerland,CHE,120,107,494,177,898
2012,Mauritania,MRT,Switzerland,CHE,0,0,5,49,54
2012,North Macedonia,MKD,Switzerland,CHE,0,12,392,1006,1410
2012,Rep. of Moldova,MDA,Switzerland,CHE,0,0,0,20,20
2012,Mali,MLI,Switzerland,CHE,0,0,0,128,128
2012,Mongolia,MNG,Switzerland,CHE,0,5,33,68,106
2012,Morocco,MAR,Switzerland,CHE,0,0,21,772,793
2012,Montenegro,MNE,Switzerland,CHE,0,5,10,33,48
2012,Myanmar,MMR,Switzerland,CHE,5,5,0,5,15
2012,Nepal,NPL,Switzerland,CHE,0,0,10,0,10
2012,Netherlands,NLD,Switzerland,CHE,0,0,0,5,5
2012,Niger,NER,Switzerland,CHE,0,0,0,146,146
2012,Nigeria,NGA,Switzerland,CHE,0,10,90,2817,2917
2012,Pakistan,PAK,Switzerland,CHE,0,0,26,88,114
2012,Poland,POL,Switzerland,CHE,0,0,0,5,5
2012,Romania,ROU,Switzerland,CHE,0,0,0,36,36
2012,South Africa,ZAF,Switzerland,CHE,0,0,5,5,10
2012,Russian Federation,RUS,Switzerland,CHE,37,18,63,233,351
2012,Rwanda,RWA,Switzerland,CHE,10,0,5,5,20
2012,Serbia and Kosovo: S/RES/1244 (1999),SRB,Switzerland,CHE,5,78,895,2267,3245
2012,Senegal,SEN,Switzerland,CHE,0,0,13,208,221
2012,Sierra Leone,SLE,Switzerland,CHE,0,0,5,79,84
2012,Somalia,SOM,Switzerland,CHE,97,174,5,185,461
2012,Spain,ESP,Switzerland,CHE,0,0,0,11,11
2012,Sudan,SDN,Switzerland,CHE,15,5,5,130,155
2012,South Sudan,SSD,Switzerland,CHE,0,0,0,5,5
2012,Slovakia,SVK,Switzerland,CHE,0,0,0,19,19
2012,Syrian Arab Rep.,SYR,Switzerland,CHE,184,206,10,212,612
2012,United Rep. of Tanzania,TZA,Switzerland,CHE,0,5,0,0,5
2012,Tajikistan,TJK,Switzerland,CHE,5,0,0,5,10
2012,Togo,TGO,Switzerland,CHE,39,5,17,53,114
2012,Tunisia,TUN,Switzerland,CHE,5,0,124,2453,2582
2012,Turkey,TUR,Switzerland,CHE,160,16,171,168,515
2012,Uganda,UGA,Switzerland,CHE,0,0,0,19,19
2012,Ukraine,UKR,Switzerland,CHE,0,0,5,19,24
2012,Uzbekistan,UZB,Switzerland,CHE,5,0,10,10,25
2012,Samoa,WSM,Switzerland,CHE,0,0,0,5,5
2012,Yemen,YEM,Switzerland,CHE,10,18,5,10,43
2012,Zambia,ZMB,Switzerland,CHE,0,0,0,5,5
2012,Zimbabwe,ZWE,Switzerland,CHE,0,0,0,20,20
2012,Stateless,XXA,Switzerland,CHE,0,0,0,5,5
2012,Unknown ,,Switzerland,CHE,49,42,37,141,269
2012,Central African Rep.,CAF,Togo,TGO,5,0,5,0,10
2012,Congo,COG,Togo,TGO,5,0,5,0,10
2012,Dem. Rep. of the Congo,COD,Togo,TGO,14,0,18,0,32
2012,Ghana,GHA,Togo,TGO,0,4982,0,0,4982
2012,Cote d'Ivoire,CIV,Togo,TGO,10,809,10,0,829
2012,Liberia,LBR,Togo,TGO,0,0,5,0,5
2012,Sri Lanka,LKA,Togo,TGO,0,0,34,0,34
2012,Mali,MLI,Togo,TGO,137,0,0,0,137
2012,Nigeria,NGA,Togo,TGO,0,0,5,0,5
2012,Afghanistan,AFG,Ukraine,UKR,36,17,153,45,251
2012,Angola,AGO,Ukraine,UKR,0,0,5,0,5
2012,Armenia,ARM,Ukraine,UKR,0,0,0,5,5
2012,Azerbaijan,AZE,Ukraine,UKR,5,0,13,5,23
2012,Bangladesh,BGD,Ukraine,UKR,0,0,5,10,15
2012,Belarus,BLR,Ukraine,UKR,0,0,5,0,5
2012,Cameroon,CMR,Ukraine,UKR,0,0,10,0,10
2012,Congo,COG,Ukraine,UKR,0,0,5,0,5
2012,Dem. Rep. of the Congo,COD,Ukraine,UKR,0,0,15,0,15
2012,Eritrea,ERI,Ukraine,UKR,0,5,13,5,23
2012,Ethiopia,ETH,Ukraine,UKR,0,0,5,5,10
2012,Palestinian,PSE,Ukraine,UKR,0,0,14,10,24
2012,Georgia,GEO,Ukraine,UKR,0,0,5,10,15
2012,Guinea,GIN,Ukraine,UKR,0,0,5,5,10
2012,Cote d'Ivoire,CIV,Ukraine,UKR,0,0,5,5,10
2012,India,IND,Ukraine,UKR,0,0,5,0,5
2012,Iran (Islamic Rep. of),IRN,Ukraine,UKR,0,0,24,10,34
2012,Iraq,IRQ,Ukraine,UKR,0,10,20,15,45
2012,Jordan,JOR,Ukraine,UKR,0,0,0,5,5
2012,Kazakhstan,KAZ,Ukraine,UKR,0,0,0,5,5
2012,Kyrgyzstan,KGZ,Ukraine,UKR,0,0,39,96,135
2012,Libya,LBY,Ukraine,UKR,0,0,5,0,5
2012,Lebanon,LBN,Ukraine,UKR,0,0,5,5,10
2012,Sri Lanka,LKA,Ukraine,UKR,0,0,5,5,10
2012,Nigeria,NGA,Ukraine,UKR,0,0,5,0,5
2012,Pakistan,PAK,Ukraine,UKR,0,0,5,5,10
2012,Russian Federation,RUS,Ukraine,UKR,0,0,16,19,35
2012,Somalia,SOM,Ukraine,UKR,5,41,177,68,291
2012,Sudan,SDN,Ukraine,UKR,0,0,5,5,10
2012,Syrian Arab Rep.,SYR,Ukraine,UKR,0,16,38,36,90
2012,Uzbekistan,UZB,Ukraine,UKR,0,0,31,21,52
2012,Stateless,XXA,Ukraine,UKR,0,0,0,5,5
2012,China,CHN,Uruguay,URY,0,0,0,5,5
2012,Colombia,COL,Uruguay,URY,5,0,5,17,27
2012,Cuba,CUB,Uruguay,URY,0,0,0,5,5
2012,Nigeria,NGA,Uruguay,URY,0,0,0,5,5
2012,Colombia,COL,Venezuela (Bolivarian Republic of),VEN,1182,0,9856,7406,18444
2012,Angola,AGO,Zambia,ZMB,0,0,0,20,20
2012,Burundi,BDI,Zambia,ZMB,5,0,0,0,5
2012,Dem. Rep. of the Congo,COD,Zambia,ZMB,321,0,10,31,362
2012,Somalia,SOM,Zambia,ZMB,5,0,0,122,127
2012,Burundi,BDI,Zimbabwe,ZWE,0,0,24,10,34
2012,Dem. Rep. of the Congo,COD,Zimbabwe,ZWE,205,0,299,505,1009
2012,Cote d'Ivoire,CIV,Zimbabwe,ZWE,0,0,5,0,5
2012,Rwanda,RWA,Zimbabwe,ZWE,0,0,5,11,16
2012,Somalia,SOM,Zimbabwe,ZWE,0,0,0,10,10
2012,Unknown ,,Zimbabwe,ZWE,0,0,10,0,10
2013,Dem. Rep. of the Congo,COD,Albania,ALB,5,0,0,0,5
2013,Iran (Islamic Rep. of),IRN,Albania,ALB,0,0,0,5,5
2013,Syrian Arab Rep.,SYR,Albania,ALB,0,0,0,12,12
2013,Chad,TCD,Angola,AGO,0,0,0,294,294
2013,Congo,COG,Angola,AGO,0,0,0,63,63
2013,Cote d'Ivoire,CIV,Angola,AGO,0,0,5,528,533
2013,Liberia,LBR,Angola,AGO,0,0,0,40,40
2013,Mauritania,MRT,Angola,AGO,0,0,0,233,233
2013,Senegal,SEN,Angola,AGO,0,0,0,10,10
2013,Sierra Leone,SLE,Angola,AGO,0,0,0,223,223
2013,Sudan,SDN,Angola,AGO,0,0,0,92,92
2013,Zimbabwe,ZWE,Angola,AGO,0,0,0,5,5
2013,Egypt,EGY,Argentina,ARG,5,0,0,0,5
2013,Armenia,ARM,Argentina,ARG,0,0,5,0,5
2013,Bangladesh,BGD,Argentina,ARG,0,0,26,5,31
2013,Cameroon,CMR,Argentina,ARG,5,0,0,5,10
2013,Dem. Rep. of the Congo,COD,Argentina,ARG,5,0,0,0,5
2013,Colombia,COL,Argentina,ARG,29,0,79,188,296
2013,Cuba,CUB,Argentina,ARG,5,0,78,29,112
2013,Dominican Rep.,DOM,Argentina,ARG,0,0,10,128,138
2013,Ecuador,ECU,Argentina,ARG,0,0,0,5,5
2013,Ghana,GHA,Argentina,ARG,16,0,10,0,26
2013,Haiti,HTI,Argentina,ARG,5,0,18,5,28
2013,Honduras,HND,Argentina,ARG,5,0,0,0,5
2013,India,IND,Argentina,ARG,0,0,34,20,54
2013,Kazakhstan,KAZ,Argentina,ARG,0,0,5,0,5
2013,Liberia,LBR,Argentina,ARG,0,0,0,5,5
2013,Mali,MLI,Argentina,ARG,5,0,0,0,5
2013,Nigeria,NGA,Argentina,ARG,0,0,19,12,31
2013,Peru,PER,Argentina,ARG,0,0,0,5,5
2013,South Africa,ZAF,Argentina,ARG,0,0,5,0,5
2013,Russian Federation,RUS,Argentina,ARG,0,0,5,5,10
2013,El Salvador,SLV,Argentina,ARG,5,0,5,0,10
2013,Senegal,SEN,Argentina,ARG,0,0,13,618,631
2013,Spain,ESP,Argentina,ARG,0,0,5,0,5
2013,Syrian Arab Rep.,SYR,Argentina,ARG,119,0,0,0,119
2013,Ukraine,UKR,Argentina,ARG,5,0,5,0,10
2013,Yemen,YEM,Argentina,ARG,0,0,0,5,5
2013,Stateless,XXA,Argentina,ARG,5,0,5,0,10
2013,Guinea,GIN,Armenia,ARM,0,0,5,0,5
2013,Iran (Islamic Rep. of),IRN,Armenia,ARM,5,0,0,10,15
2013,Iraq,IRQ,Armenia,ARM,24,0,0,0,24
2013,Lebanon,LBN,Armenia,ARM,5,0,0,0,5
2013,Syrian Arab Rep.,SYR,Armenia,ARM,429,0,0,154,583
2013,Afghanistan,AFG,Australia,AUS,918,0,79,0,997
2013,Albania,ALB,Australia,AUS,5,0,10,0,15
2013,Egypt,EGY,Australia,AUS,289,0,86,0,375
2013,Bahrain,BHR,Australia,AUS,5,0,0,0,5
2013,Bangladesh,BGD,Australia,AUS,22,0,91,0,113
2013,Brazil,BRA,Australia,AUS,0,0,5,0,5
2013,Cambodia,KHM,Australia,AUS,0,0,5,0,5
2013,China,CHN,Australia,AUS,131,0,639,0,770
2013,Cameroon,CMR,Australia,AUS,0,0,5,0,5
2013,Dem. Rep. of the Congo,COD,Australia,AUS,0,0,5,0,5
2013,Colombia,COL,Australia,AUS,17,0,11,0,28
2013,Ethiopia,ETH,Australia,AUS,0,0,10,0,10
2013,Fiji,FJI,Australia,AUS,35,0,157,0,192
2013,Palestinian,PSE,Australia,AUS,69,0,5,0,74
2013,United Kingdom of Great Britain and Northern Ireland,GBR,Australia,AUS,0,0,16,0,16
2013,Georgia,GEO,Australia,AUS,0,0,5,0,5
2013,Ghana,GHA,Australia,AUS,5,0,13,0,18
2013,"China, Hong Kong SAR",HKG,Australia,AUS,0,0,20,0,20
2013,India,IND,Australia,AUS,44,0,576,0,620
2013,Indonesia,IDN,Australia,AUS,12,0,67,0,79
2013,Ireland,IRL,Australia,AUS,0,0,5,0,5
2013,Iran (Islamic Rep. of),IRN,Australia,AUS,593,0,139,0,732
2013,Iraq,IRQ,Australia,AUS,224,0,49,0,273
2013,Israel,ISR,Australia,AUS,5,0,5,0,10
2013,Italy,ITA,Australia,AUS,0,0,5,0,5
2013,Jordan,JOR,Australia,AUS,11,0,39,0,50
2013,Japan,JPN,Australia,AUS,0,0,5,0,5
2013,Kenya,KEN,Australia,AUS,0,0,13,0,13
2013,Rep. of Korea,KOR,Australia,AUS,5,0,31,0,36
2013,Liberia,LBR,Australia,AUS,5,0,0,0,5
2013,Libya,LBY,Australia,AUS,173,0,16,0,189
2013,Lebanon,LBN,Australia,AUS,10,0,167,0,177
2013,Sri Lanka,LKA,Australia,AUS,299,0,422,0,721
2013,Malaysia,MYS,Australia,AUS,12,0,91,0,103
2013,Mongolia,MNG,Australia,AUS,0,0,5,0,5
2013,Mauritius,MUS,Australia,AUS,0,0,18,0,18
2013,Myanmar,MMR,Australia,AUS,10,0,5,0,15
2013,Nepal,NPL,Australia,AUS,5,0,130,0,135
2013,Nigeria,NGA,Australia,AUS,15,0,26,0,41
2013,New Zealand,NZL,Australia,AUS,0,0,12,0,12
2013,Pakistan,PAK,Australia,AUS,496,0,168,0,664
2013,Peru,PER,Australia,AUS,0,0,5,0,5
2013,Philippines,PHL,Australia,AUS,0,0,39,0,39
2013,Papua New Guinea,PNG,Australia,AUS,45,0,12,0,57
2013,Portugal,PRT,Australia,AUS,0,0,5,0,5
2013,Romania,ROU,Australia,AUS,0,0,5,0,5
2013,South Africa,ZAF,Australia,AUS,0,0,5,0,5
2013,Russian Federation,RUS,Australia,AUS,5,0,5,0,10
2013,Rwanda,RWA,Australia,AUS,0,0,5,0,5
2013,Saudi Arabia,SAU,Australia,AUS,11,0,5,0,16
2013,Singapore,SGP,Australia,AUS,0,0,11,0,11
2013,Solomon Islands,SLB,Australia,AUS,0,0,5,0,5
2013,Somalia,SOM,Australia,AUS,5,0,0,0,5
2013,Viet Nam,VNM,Australia,AUS,5,0,35,0,40
2013,Sudan,SDN,Australia,AUS,5,0,0,0,5
2013,Syrian Arab Rep.,SYR,Australia,AUS,60,0,0,0,60
2013,Thailand,THA,Australia,AUS,0,0,17,0,17
2013,Tonga,TON,Australia,AUS,5,0,33,0,38
2013,Turkey,TUR,Australia,AUS,36,0,22,0,58
2013,Uganda,UGA,Australia,AUS,5,0,10,0,15
2013,Ukraine,UKR,Australia,AUS,0,0,12,0,12
2013,United States of America,USA,Australia,AUS,0,0,5,0,5
2013,Uzbekistan,UZB,Australia,AUS,0,0,5,0,5
2013,Zimbabwe,ZWE,Australia,AUS,51,0,40,0,91
2013,Stateless,XXA,Australia,AUS,240,0,23,0,263
2013,Afghanistan,AFG,Azerbaijan,AZE,5,0,103,0,108
2013,Iran (Islamic Rep. of),IRN,Azerbaijan,AZE,0,0,11,0,11
2013,Pakistan,PAK,Azerbaijan,AZE,0,0,30,0,30
2013,Afghanistan,AFG,Belgium,BEL,636,803,1042,39,2520
2013,Albania,ALB,Belgium,BEL,83,0,464,5,552
2013,Algeria,DZA,Belgium,BEL,11,0,59,22,92
2013,Angola,AGO,Belgium,BEL,5,0,128,5,138
2013,Egypt,EGY,Belgium,BEL,10,0,60,16,86
2013,Argentina,ARG,Belgium,BEL,0,0,5,0,5
2013,Armenia,ARM,Belgium,BEL,10,0,261,15,286
2013,Azerbaijan,AZE,Belgium,BEL,10,0,116,18,144
2013,Burundi,BDI,Belgium,BEL,68,0,115,5,188
2013,Benin,BEN,Belgium,BEL,5,0,86,5,96
2013,Bangladesh,BGD,Belgium,BEL,11,0,238,39,288
2013,Bhutan,BTN,Belgium,BEL,0,0,5,0,5
2013,Burkina Faso,BFA,Belgium,BEL,15,0,91,0,106
2013,Belarus,BLR,Belgium,BEL,5,0,36,11,52
2013,Bosnia and Herzegovina,BIH,Belgium,BEL,0,0,65,0,65
2013,Bulgaria,BGR,Belgium,BEL,0,0,17,0,17
2013,Central African Rep.,CAF,Belgium,BEL,5,0,0,0,5
2013,Chad,TCD,Belgium,BEL,5,0,13,0,18
2013,China,CHN,Belgium,BEL,206,0,47,10,263
2013,Cameroon,CMR,Belgium,BEL,68,0,278,19,365
2013,Congo,COG,Belgium,BEL,5,0,36,5,46
2013,Dem. Rep. of the Congo,COD,Belgium,BEL,342,22,1728,63,2155
2013,Colombia,COL,Belgium,BEL,5,0,5,5,15
2013,Cuba,CUB,Belgium,BEL,5,0,5,0,10
2013,Djibouti,DJI,Belgium,BEL,61,0,32,5,98
2013,Dominican Rep.,DOM,Belgium,BEL,0,0,5,0,5
2013,Equatorial Guinea,GNQ,Belgium,BEL,5,0,0,0,5
2013,Eritrea,ERI,Belgium,BEL,13,0,13,0,26
2013,Ethiopia,ETH,Belgium,BEL,5,0,12,0,17
2013,Gambia,GMB,Belgium,BEL,5,0,26,0,31
2013,Palestinian,PSE,Belgium,BEL,0,5,0,0,5
2013,Georgia,GEO,Belgium,BEL,0,0,185,19,204
2013,Ghana,GHA,Belgium,BEL,10,0,49,5,64
2013,Guinea-Bissau,GNB,Belgium,BEL,0,0,10,0,10
2013,Guatemala,GTM,Belgium,BEL,0,0,11,0,11
2013,Guinea,GIN,Belgium,BEL,554,5,1461,60,2080
2013,Croatia,HRV,Belgium,BEL,0,0,5,0,5
2013,Hungary,HUN,Belgium,BEL,0,0,5,0,5
2013,Cote d'Ivoire,CIV,Belgium,BEL,44,0,221,5,270
2013,India,IND,Belgium,BEL,0,0,34,0,34
2013,Iran (Islamic Rep. of),IRN,Belgium,BEL,203,0,218,68,489
2013,Iraq,IRQ,Belgium,BEL,161,65,222,73,521
2013,Israel,ISR,Belgium,BEL,0,0,5,0,5
2013,Italy,ITA,Belgium,BEL,0,0,5,0,5
2013,Jordan,JOR,Belgium,BEL,0,0,19,0,19
2013,Kazakhstan,KAZ,Belgium,BEL,14,0,116,12,142
2013,Kenya,KEN,Belgium,BEL,0,0,25,0,25
2013,Kyrgyzstan,KGZ,Belgium,BEL,18,0,83,10,111
2013,Dem. People's Rep. of Korea,PRK,Belgium,BEL,0,0,91,27,118
2013,Liberia,LBR,Belgium,BEL,0,0,14,0,14
2013,Libya,LBY,Belgium,BEL,0,0,0,5,5
2013,Lebanon,LBN,Belgium,BEL,5,0,27,12,44
2013,Sri Lanka,LKA,Belgium,BEL,50,0,38,5,93
2013,Mauritania,MRT,Belgium,BEL,25,0,231,10,266
2013,North Macedonia,MKD,Belgium,BEL,15,0,177,0,192
2013,Rep. of Moldova,MDA,Belgium,BEL,0,0,10,0,10
2013,Mali,MLI,Belgium,BEL,5,0,46,5,56
2013,Mongolia,MNG,Belgium,BEL,0,0,34,5,39
2013,Morocco,MAR,Belgium,BEL,11,0,105,19,135
2013,Montenegro,MNE,Belgium,BEL,0,0,5,0,5
2013,Mauritius,MUS,Belgium,BEL,0,0,5,0,5
2013,Myanmar,MMR,Belgium,BEL,5,0,0,0,5
2013,Nepal,NPL,Belgium,BEL,5,0,322,35,362
2013,Netherlands,NLD,Belgium,BEL,0,0,5,0,5
2013,Niger,NER,Belgium,BEL,17,0,113,0,130
2013,Nigeria,NGA,Belgium,BEL,5,0,109,5,119
2013,Pakistan,PAK,Belgium,BEL,50,0,727,108,885
2013,Romania,ROU,Belgium,BEL,0,0,54,0,54
2013,South Africa,ZAF,Belgium,BEL,0,0,5,0,5
2013,Russian Federation,RUS,Belgium,BEL,282,0,807,77,1166
2013,Rwanda,RWA,Belgium,BEL,85,0,307,15,407
2013,El Salvador,SLV,Belgium,BEL,0,5,10,0,15
2013,Serbia and Kosovo: S/RES/1244 (1999),SRB,Belgium,BEL,60,0,600,28,688
2013,Senegal,SEN,Belgium,BEL,81,0,450,25,556
2013,Sierra Leone,SLE,Belgium,BEL,10,0,62,0,72
2013,Somalia,SOM,Belgium,BEL,98,30,117,5,250
2013,Viet Nam,VNM,Belgium,BEL,0,0,10,0,10
2013,Sudan,SDN,Belgium,BEL,17,0,12,0,29
2013,Suriname,SUR,Belgium,BEL,0,0,5,5,10
2013,Slovakia,SVK,Belgium,BEL,0,0,10,0,10
2013,Syrian Arab Rep.,SYR,Belgium,BEL,213,1315,54,34,1616
2013,United Rep. of Tanzania,TZA,Belgium,BEL,12,0,39,0,51
2013,Tajikistan,TJK,Belgium,BEL,0,0,5,0,5
2013,Togo,TGO,Belgium,BEL,53,5,330,19,407
2013,Tunisia,TUN,Belgium,BEL,5,0,32,5,42
2013,Turkey,TUR,Belgium,BEL,95,0,293,49,437
2013,Uganda,UGA,Belgium,BEL,5,0,10,5,20
2013,Ukraine,UKR,Belgium,BEL,10,0,32,5,47
2013,Uzbekistan,UZB,Belgium,BEL,0,0,12,0,12
2013,Stateless,XXA,Belgium,BEL,0,5,10,0,15
2013,Unknown ,,Belgium,BEL,118,99,57,35,309
2013,Central African Rep.,CAF,Benin,BEN,11,0,0,5,16
2013,Chad,TCD,Benin,BEN,0,0,0,5,5
2013,Congo,COG,Benin,BEN,0,0,0,5,5
2013,Dem. Rep. of the Congo,COD,Benin,BEN,5,0,0,20,25
2013,Cote d'Ivoire,CIV,Benin,BEN,74,0,0,5,79
2013,Sri Lanka,LKA,Benin,BEN,5,0,0,0,5
2013,Mali,MLI,Benin,BEN,5,0,0,0,5
2013,Nigeria,NGA,Benin,BEN,0,0,5,0,5
2013,Pakistan,PAK,Benin,BEN,5,0,0,0,5
2013,Rwanda,RWA,Benin,BEN,0,0,0,5,5
2013,Central African Rep.,CAF,Burkina Faso,BFA,10,5,0,0,15
2013,Chad,TCD,Burkina Faso,BFA,0,5,0,0,5
2013,Afghanistan,AFG,Belarus,BLR,5,0,50,15,70
2013,Egypt,EGY,Belarus,BLR,0,5,0,5,10
2013,Armenia,ARM,Belarus,BLR,5,0,10,0,15
2013,Georgia,GEO,Belarus,BLR,0,0,15,5,20
2013,Iraq,IRQ,Belarus,BLR,0,0,0,5,5
2013,Russian Federation,RUS,Belarus,BLR,0,0,5,5,10
2013,Syrian Arab Rep.,SYR,Belarus,BLR,10,25,0,14,49
2013,Ukraine,UKR,Belarus,BLR,0,0,5,0,5
2013,Colombia,COL,Bolivia (Plurinational State of),BOL,5,0,5,5,15
2013,Syrian Arab Rep.,SYR,Bolivia (Plurinational State of),BOL,5,0,0,0,5
2013,Burundi,BDI,Botswana,BWA,0,0,5,0,5
2013,Dem. Rep. of the Congo,COD,Botswana,BWA,5,0,37,0,42
2013,Ethiopia,ETH,Botswana,BWA,0,0,5,0,5
2013,Somalia,SOM,Botswana,BWA,0,0,55,0,55
2013,Sudan,SDN,Botswana,BWA,0,0,5,0,5
2013,Zimbabwe,ZWE,Botswana,BWA,5,0,19,0,24
2013,Afghanistan,AFG,Brazil,BRA,0,0,0,5,5
2013,Angola,AGO,Brazil,BRA,18,0,25,0,43
2013,Benin,BEN,Brazil,BRA,0,0,5,0,5
2013,Bangladesh,BGD,Brazil,BRA,0,0,100,10,110
2013,Bhutan,BTN,Brazil,BRA,10,0,0,0,10
2013,Burkina Faso,BFA,Brazil,BRA,0,0,10,0,10
2013,Bolivia (Plurinational State of),BOL,Brazil,BRA,16,0,0,0,16
2013,China,CHN,Brazil,BRA,0,0,0,5,5
2013,Cameroon,CMR,Brazil,BRA,0,0,10,0,10
2013,Dem. Rep. of the Congo,COD,Brazil,BRA,107,0,18,5,130
2013,Colombia,COL,Brazil,BRA,93,0,24,124,241
2013,Cuba,CUB,Brazil,BRA,0,0,5,13,18
2013,Eritrea,ERI,Brazil,BRA,5,0,0,14,19
2013,Ghana,GHA,Brazil,BRA,5,0,21,5,31
2013,Guinea-Bissau,GNB,Brazil,BRA,0,0,94,5,99
2013,Guinea,GIN,Brazil,BRA,5,0,16,0,21
2013,Cote d'Ivoire,CIV,Brazil,BRA,5,0,5,0,10
2013,India,IND,Brazil,BRA,0,0,0,5,5
2013,Iran (Islamic Rep. of),IRN,Brazil,BRA,5,0,0,5,10
2013,Iraq,IRQ,Brazil,BRA,5,0,0,5,10
2013,Lebanon,LBN,Brazil,BRA,5,0,5,0,10
2013,Mali,MLI,Brazil,BRA,19,0,0,0,19
2013,Nepal,NPL,Brazil,BRA,0,0,5,5,10
2013,Nigeria,NGA,Brazil,BRA,18,0,37,11,66
2013,Pakistan,PAK,Brazil,BRA,32,0,10,11,53
2013,Paraguay,PRY,Brazil,BRA,0,0,0,5,5
2013,Senegal,SEN,Brazil,BRA,5,0,154,10,169
2013,Somalia,SOM,Brazil,BRA,0,0,0,40,40
2013,Sudan,SDN,Brazil,BRA,5,0,0,0,5
2013,Syrian Arab Rep.,SYR,Brazil,BRA,291,0,0,5,296
2013,Togo,TGO,Brazil,BRA,0,0,5,0,5
2013,Turkey,TUR,Brazil,BRA,0,0,5,0,5
2013,Venezuela (Bolivarian Republic of),VEN,Brazil,BRA,5,0,0,0,5
2013,Algeria,DZA,Bosnia and Herzegovina,BIH,0,0,0,5,5
2013,Serbia and Kosovo: S/RES/1244 (1999),SRB,Bosnia and Herzegovina,BIH,0,0,5,5,10
2013,Syrian Arab Rep.,SYR,Bosnia and Herzegovina,BIH,0,43,0,24,67
2013,Afghanistan,AFG,Bulgaria,BGR,0,5,39,54,98
2013,Algeria,DZA,Bulgaria,BGR,0,0,12,407,419
2013,Egypt,EGY,Bulgaria,BGR,0,5,0,10,15
2013,Armenia,ARM,Bulgaria,BGR,0,0,12,0,12
2013,Cameroon,CMR,Bulgaria,BGR,0,0,13,43,56
2013,Congo,COG,Bulgaria,BGR,0,0,5,5,10
2013,Dem. Rep. of the Congo,COD,Bulgaria,BGR,0,0,10,5,15
2013,Eritrea,ERI,Bulgaria,BGR,0,0,0,11,11
2013,Gambia,GMB,Bulgaria,BGR,0,0,0,5,5
2013,Georgia,GEO,Bulgaria,BGR,0,0,0,5,5
2013,Ghana,GHA,Bulgaria,BGR,0,0,5,17,22
2013,Cote d'Ivoire,CIV,Bulgaria,BGR,0,0,23,24,47
2013,Iran (Islamic Rep. of),IRN,Bulgaria,BGR,0,0,13,15,28
2013,Iraq,IRQ,Bulgaria,BGR,21,53,95,179,348
2013,Libya,LBY,Bulgaria,BGR,0,0,0,5,5
2013,Lebanon,LBN,Bulgaria,BGR,0,5,0,5,10
2013,Mali,MLI,Bulgaria,BGR,0,0,27,57,84
2013,Morocco,MAR,Bulgaria,BGR,0,0,0,85,85
2013,Nigeria,NGA,Bulgaria,BGR,0,0,5,5,10
2013,Pakistan,PAK,Bulgaria,BGR,0,0,10,10,20
2013,Russian Federation,RUS,Bulgaria,BGR,0,0,5,0,5
2013,Rwanda,RWA,Bulgaria,BGR,0,0,11,27,38
2013,Somalia,SOM,Bulgaria,BGR,10,5,5,15,35
2013,Sudan,SDN,Bulgaria,BGR,0,5,12,10,27
2013,Syrian Arab Rep.,SYR,Bulgaria,BGR,149,1862,10,366,2387
2013,United Rep. of Tanzania,TZA,Bulgaria,BGR,0,0,5,0,5
2013,Togo,TGO,Bulgaria,BGR,0,0,0,5,5
2013,Tunisia,TUN,Bulgaria,BGR,0,0,0,35,35
2013,Turkey,TUR,Bulgaria,BGR,0,0,0,5,5
2013,Ukraine,UKR,Bulgaria,BGR,0,0,5,0,5
2013,Yemen,YEM,Bulgaria,BGR,0,0,0,5,5
2013,Stateless,XXA,Bulgaria,BGR,0,324,18,75,417
2013,Syrian Arab Rep.,SYR,Belize,BLZ,0,0,0,5,5
2013,Sri Lanka,LKA,Cambodia,KHM,0,0,0,5,5
2013,Myanmar,MMR,Cambodia,KHM,10,0,0,5,15
2013,Afghanistan,AFG,Canada,CAN,275,0,67,43,385
2013,Albania,ALB,Canada,CAN,107,0,145,20,272
2013,Algeria,DZA,Canada,CAN,65,0,128,22,215
2013,Angola,AGO,Canada,CAN,5,0,17,5,27
2013,Antigua and Barbuda,ATG,Canada,CAN,11,0,10,0,21
2013,Egypt,EGY,Canada,CAN,247,0,22,5,274
2013,Argentina,ARG,Canada,CAN,0,0,5,5,10
2013,Armenia,ARM,Canada,CAN,5,0,11,0,16
2013,Azerbaijan,AZE,Canada,CAN,18,0,5,5,28
2013,Bahrain,BHR,Canada,CAN,10,0,0,0,10
2013,Barbados,BRB,Canada,CAN,17,0,15,5,37
2013,Burundi,BDI,Canada,CAN,140,0,78,5,223
2013,Belgium,BEL,Canada,CAN,0,0,11,5,16
2013,Benin,BEN,Canada,CAN,5,0,22,0,27
2013,Bermuda,BMU,Canada,CAN,0,0,5,0,5
2013,Bangladesh,BGD,Canada,CAN,54,0,77,10,141
2013,Bahamas,BHS,Canada,CAN,11,0,12,0,23
2013,Burkina Faso,BFA,Canada,CAN,13,0,11,0,24
2013,Belarus,BLR,Canada,CAN,10,0,5,5,20
2013,Bolivia (Plurinational State of),BOL,Canada,CAN,0,0,10,0,10
2013,Botswana,BWA,Canada,CAN,12,0,25,5,42
2013,Brazil,BRA,Canada,CAN,13,0,23,22,58
2013,Bosnia and Herzegovina,BIH,Canada,CAN,0,0,33,10,43
2013,Bulgaria,BGR,Canada,CAN,21,0,13,0,34
2013,Cambodia,KHM,Canada,CAN,5,0,21,5,31
2013,Central African Rep.,CAF,Canada,CAN,10,0,5,0,15
2013,Chad,TCD,Canada,CAN,10,0,5,0,15
2013,China,CHN,Canada,CAN,536,0,791,257,1584
2013,Chile,CHL,Canada,CAN,0,0,15,5,20
2013,Cameroon,CMR,Canada,CAN,70,0,58,5,133
2013,Congo,COG,Canada,CAN,11,0,19,0,30
2013,Dem. Rep. of the Congo,COD,Canada,CAN,211,0,173,44,428
2013,Colombia,COL,Canada,CAN,386,0,579,64,1029
2013,Costa Rica,CRI,Canada,CAN,0,0,12,0,12
2013,Cuba,CUB,Canada,CAN,102,0,57,28,187
2013,Czechia,CZE,Canada,CAN,25,0,79,22,126
2013,Djibouti,DJI,Canada,CAN,53,0,32,10,95
2013,Dominican Rep.,DOM,Canada,CAN,11,0,32,16,59
2013,Ecuador,ECU,Canada,CAN,0,0,14,5,19
2013,Equatorial Guinea,GNQ,Canada,CAN,5,0,0,0,5
2013,Eritrea,ERI,Canada,CAN,158,0,32,11,201
2013,Estonia,EST,Canada,CAN,0,0,5,13,18
2013,Ethiopia,ETH,Canada,CAN,74,0,45,5,124
2013,Fiji,FJI,Canada,CAN,5,0,13,5,23
2013,France,FRA,Canada,CAN,0,0,18,10,28
2013,Gabon,GAB,Canada,CAN,0,0,0,5,5
2013,Gambia,GMB,Canada,CAN,15,0,10,0,25
2013,Palestinian,PSE,Canada,CAN,16,0,10,5,31
2013,United Kingdom of Great Britain and Northern Ireland,GBR,Canada,CAN,0,0,5,5,10
2013,Georgia,GEO,Canada,CAN,22,0,31,5,58
2013,Germany,DEU,Canada,CAN,0,0,0,5,5
2013,Ghana,GHA,Canada,CAN,24,0,41,5,70
2013,Greece,GRC,Canada,CAN,5,0,35,22,62
2013,Grenada,GRD,Canada,CAN,5,0,13,0,18
2013,Guatemala,GTM,Canada,CAN,40,0,149,23,212
2013,Guinea,GIN,Canada,CAN,31,0,53,5,89
2013,Guyana,GUY,Canada,CAN,5,0,19,0,24
2013,Haiti,HTI,Canada,CAN,216,0,301,22,539
2013,"China, Hong Kong SAR",HKG,Canada,CAN,0,0,11,16,27
2013,Honduras,HND,Canada,CAN,116,0,156,42,314
2013,Croatia,HRV,Canada,CAN,51,0,318,82,451
2013,Hungary,HUN,Canada,CAN,406,0,1101,477,1984
2013,Cote d'Ivoire,CIV,Canada,CAN,29,0,21,10,60
2013,India,IND,Canada,CAN,75,0,304,114,493
2013,Indonesia,IDN,Canada,CAN,14,0,14,0,28
2013,Iran (Islamic Rep. of),IRN,Canada,CAN,227,0,60,15,302
2013,Iraq,IRQ,Canada,CAN,113,0,40,26,179
2013,Israel,ISR,Canada,CAN,12,0,85,64,161
2013,Italy,ITA,Canada,CAN,0,0,30,10,40
2013,Jamaica,JAM,Canada,CAN,86,0,111,31,228
2013,Jordan,JOR,Canada,CAN,43,0,40,10,93
2013,Japan,JPN,Canada,CAN,0,0,10,5,15
2013,Kazakhstan,KAZ,Canada,CAN,16,0,16,5,37
2013,Kenya,KEN,Canada,CAN,22,0,20,0,42
2013,Kyrgyzstan,KGZ,Canada,CAN,5,0,5,0,10
2013,Rep. of Korea,KOR,Canada,CAN,5,0,37,21,63
2013,Dem. People's Rep. of Korea,PRK,Canada,CAN,21,0,86,150,257
2013,Kuwait,KWT,Canada,CAN,10,0,5,0,15
2013,Lao People's Dem. Rep.,LAO,Canada,CAN,5,0,5,0,10
2013,Liberia,LBR,Canada,CAN,5,0,5,0,10
2013,Libya,LBY,Canada,CAN,23,0,37,0,60
2013,Saint Lucia,LCA,Canada,CAN,148,0,164,19,331
2013,Lebanon,LBN,Canada,CAN,66,0,70,10,146
2013,Sri Lanka,LKA,Canada,CAN,286,0,253,21,560
2013,Lithuania,LTU,Canada,CAN,5,0,14,14,33
2013,Latvia,LVA,Canada,CAN,11,0,26,17,54
2013,Mauritania,MRT,Canada,CAN,16,0,10,5,31
2013,North Macedonia,MKD,Canada,CAN,0,0,17,5,22
2013,Rep. of Moldova,MDA,Canada,CAN,12,0,10,5,27
2013,Mexico,MEX,Canada,CAN,182,0,683,148,1013
2013,Mali,MLI,Canada,CAN,13,0,17,5,35
2013,Malaysia,MYS,Canada,CAN,0,0,10,5,15
2013,Mongolia,MNG,Canada,CAN,15,0,5,0,20
2013,Morocco,MAR,Canada,CAN,21,0,25,10,56
2013,Montenegro,MNE,Canada,CAN,5,0,0,0,5
2013,Myanmar,MMR,Canada,CAN,5,0,0,0,5
2013,Namibia,NAM,Canada,CAN,79,0,210,21,310
2013,Nepal,NPL,Canada,CAN,19,0,14,0,33
2013,Netherlands,NLD,Canada,CAN,0,0,15,5,20
2013,Niger,NER,Canada,CAN,0,0,5,5,10
2013,Nicaragua,NIC,Canada,CAN,14,0,27,5,46
2013,Nigeria,NGA,Canada,CAN,155,0,268,17,440
2013,Norway,NOR,Canada,CAN,0,0,0,5,5
2013,Pakistan,PAK,Canada,CAN,690,0,228,46,964
2013,Panama,PAN,Canada,CAN,5,0,10,0,15
2013,Paraguay,PRY,Canada,CAN,0,0,5,0,5
2013,Peru,PER,Canada,CAN,21,0,59,17,97
2013,Philippines,PHL,Canada,CAN,5,0,49,5,59
2013,Poland,POL,Canada,CAN,5,0,83,65,153
2013,Portugal,PRT,Canada,CAN,0,0,16,16,32
2013,Qatar,QAT,Canada,CAN,0,0,5,0,5
2013,Romania,ROU,Canada,CAN,40,0,53,118,211
2013,South Africa,ZAF,Canada,CAN,0,0,28,0,28
2013,Russian Federation,RUS,Canada,CAN,87,0,63,32,182
2013,Rwanda,RWA,Canada,CAN,39,0,47,5,91
2013,El Salvador,SLV,Canada,CAN,136,0,215,24,375
2013,Saudi Arabia,SAU,Canada,CAN,20,0,5,0,25
2013,Serbia and Kosovo: S/RES/1244 (1999),SRB,Canada,CAN,32,0,71,11,114
2013,Senegal,SEN,Canada,CAN,24,0,18,5,47
2013,Singapore,SGP,Canada,CAN,0,0,5,0,5
2013,Sierra Leone,SLE,Canada,CAN,0,0,5,0,5
2013,Somalia,SOM,Canada,CAN,198,0,56,84,338
2013,Spain,ESP,Canada,CAN,0,0,43,12,55
2013,Viet Nam,VNM,Canada,CAN,5,0,10,0,15
2013,Saint Kitts and Nevis,KNA,Canada,CAN,5,0,10,0,15
2013,Sudan,SDN,Canada,CAN,37,0,5,12,54
2013,Slovakia,SVK,Canada,CAN,16,0,135,52,203
2013,Eswatini,SWZ,Canada,CAN,15,0,14,5,34
2013,Sweden,SWE,Canada,CAN,0,0,5,10,15
2013,Switzerland,CHE,Canada,CAN,0,0,5,0,5
2013,Syrian Arab Rep.,SYR,Canada,CAN,440,0,35,14,489
2013,United Rep. of Tanzania,TZA,Canada,CAN,10,0,13,0,23
2013,Turks and Caicos Islands,TCA,Canada,CAN,0,0,5,0,5
2013,Thailand,THA,Canada,CAN,0,0,11,5,16
2013,Tajikistan,TJK,Canada,CAN,5,0,0,0,5
2013,Togo,TGO,Canada,CAN,10,0,5,0,15
2013,Trinidad and Tobago,TTO,Canada,CAN,5,0,18,5,28
2013,Tunisia,TUN,Canada,CAN,21,0,46,5,72
2013,Turkey,TUR,Canada,CAN,188,0,160,24,372
2013,Uganda,UGA,Canada,CAN,25,0,15,5,45
2013,Ukraine,UKR,Canada,CAN,55,0,57,22,134
2013,Uruguay,URY,Canada,CAN,0,0,11,10,21
2013,United States of America,USA,Canada,CAN,5,0,151,55,211
2013,Uzbekistan,UZB,Canada,CAN,13,0,14,0,27
2013,Saint Vincent and the Grenadines,VCT,Canada,CAN,105,0,202,26,333
2013,Venezuela (Bolivarian Republic of),VEN,Canada,CAN,36,0,55,12,103
2013,Yemen,YEM,Canada,CAN,20,0,5,0,25
2013,Zimbabwe,ZWE,Canada,CAN,33,0,27,0,60
2013,Unknown ,,Canada,CAN,17,0,24,19,60
2013,Cuba,CUB,Cayman Islands,CYM,0,0,25,0,25
2013,Dem. Rep. of the Congo,COD,Chile,CHL,0,0,5,0,5
2013,Colombia,COL,Chile,CHL,27,10,116,5,158
2013,Palestinian,PSE,Chile,CHL,0,5,0,0,5
2013,Nepal,NPL,Chile,CHL,0,0,5,0,5
2013,Syrian Arab Rep.,SYR,Chile,CHL,5,0,0,0,5
2013,Angola,AGO,Dem. Rep. of the Congo,COD,558,0,0,0,558
2013,Burundi,BDI,Dem. Rep. of the Congo,COD,19,0,98,260,377
2013,Congo,COG,Dem. Rep. of the Congo,COD,11,0,21,82,114
2013,Gambia,GMB,Dem. Rep. of the Congo,COD,0,0,5,0,5
2013,Cote d'Ivoire,CIV,Dem. Rep. of the Congo,COD,0,0,5,0,5
2013,Liberia,LBR,Dem. Rep. of the Congo,COD,0,0,11,30,41
2013,Rwanda,RWA,Dem. Rep. of the Congo,COD,23,0,44,462,529
2013,Sierra Leone,SLE,Dem. Rep. of the Congo,COD,0,0,5,0,5
2013,Somalia,SOM,Dem. Rep. of the Congo,COD,5,0,5,0,10
2013,United Rep. of Tanzania,TZA,Dem. Rep. of the Congo,COD,0,0,0,5,5
2013,Bangladesh,BGD,Colombia,COL,0,0,0,42,42
2013,Cuba,CUB,Colombia,COL,0,0,60,30,90
2013,Ecuador,ECU,Colombia,COL,5,0,5,0,10
2013,Ghana,GHA,Colombia,COL,0,0,0,10,10
2013,Honduras,HND,Colombia,COL,0,0,5,0,5
2013,Cote d'Ivoire,CIV,Colombia,COL,0,0,0,5,5
2013,Nepal,NPL,Colombia,COL,0,0,5,0,5
2013,Nigeria,NGA,Colombia,COL,0,0,0,5,5
2013,Somalia,SOM,Colombia,COL,0,0,10,39,49
2013,Syrian Arab Rep.,SYR,Colombia,COL,0,0,5,5,10
2013,Venezuela (Bolivarian Republic of),VEN,Colombia,COL,0,0,5,5,10
2013,Bangladesh,BGD,Costa Rica,CRI,0,0,10,0,10
2013,Colombia,COL,Costa Rica,CRI,32,0,567,70,669
2013,Cuba,CUB,Costa Rica,CRI,24,0,153,10,187
2013,Ecuador,ECU,Costa Rica,CRI,0,0,5,0,5
2013,Ghana,GHA,Costa Rica,CRI,0,0,5,0,5
2013,Guatemala,GTM,Costa Rica,CRI,5,0,26,0,31
2013,Honduras,HND,Costa Rica,CRI,13,0,17,0,30
2013,Iran (Islamic Rep. of),IRN,Costa Rica,CRI,0,0,5,5,10
2013,Nicaragua,NIC,Costa Rica,CRI,0,0,5,0,5
2013,Nigeria,NGA,Costa Rica,CRI,5,0,5,0,10
2013,El Salvador,SLV,Costa Rica,CRI,31,0,131,0,162
2013,Venezuela (Bolivarian Republic of),VEN,Costa Rica,CRI,0,0,21,0,21
2013,Afghanistan,AFG,Cyprus,CYP,0,0,29,10,39
2013,Algeria,DZA,Cyprus,CYP,0,0,5,0,5
2013,Egypt,EGY,Cyprus,CYP,0,0,85,44,129
2013,Armenia,ARM,Cyprus,CYP,0,0,5,0,5
2013,Bangladesh,BGD,Cyprus,CYP,0,0,85,15,100
2013,Bosnia and Herzegovina,BIH,Cyprus,CYP,0,0,0,5,5
2013,Cameroon,CMR,Cyprus,CYP,5,0,5,5,15
2013,Dem. Rep. of the Congo,COD,Cyprus,CYP,0,0,10,0,10
2013,Palestinian,PSE,Cyprus,CYP,5,5,16,15,41
2013,Georgia,GEO,Cyprus,CYP,0,0,5,0,5
2013,Guinea,GIN,Cyprus,CYP,0,0,5,0,5
2013,India,IND,Cyprus,CYP,0,0,26,10,36
2013,Indonesia,IDN,Cyprus,CYP,0,0,0,5,5
2013,Iran (Islamic Rep. of),IRN,Cyprus,CYP,5,0,31,35,71
2013,Iraq,IRQ,Cyprus,CYP,0,0,12,0,12
2013,Jordan,JOR,Cyprus,CYP,0,0,10,5,15
2013,Lebanon,LBN,Cyprus,CYP,0,0,10,0,10
2013,Sri Lanka,LKA,Cyprus,CYP,0,0,58,5,63
2013,Rep. of Moldova,MDA,Cyprus,CYP,5,0,0,0,5
2013,Mali,MLI,Cyprus,CYP,0,0,5,0,5
2013,Nepal,NPL,Cyprus,CYP,0,0,0,5,5
2013,Pakistan,PAK,Cyprus,CYP,0,0,17,0,17
2013,Philippines,PHL,Cyprus,CYP,0,0,23,5,28
2013,Russian Federation,RUS,Cyprus,CYP,0,0,5,5,10
2013,Sierra Leone,SLE,Cyprus,CYP,5,0,0,0,5
2013,Somalia,SOM,Cyprus,CYP,0,0,5,0,5
2013,Viet Nam,VNM,Cyprus,CYP,0,0,80,5,85
2013,Syrian Arab Rep.,SYR,Cyprus,CYP,0,122,71,139,332
2013,Turkey,TUR,Cyprus,CYP,0,0,55,5,60
2013,Uzbekistan,UZB,Cyprus,CYP,0,0,5,0,5
2013,Afghanistan,AFG,Czechia,CZE,0,10,0,5,15
2013,Algeria,DZA,Czechia,CZE,0,0,5,5,10
2013,Armenia,ARM,Czechia,CZE,5,0,21,13,39
2013,Azerbaijan,AZE,Czechia,CZE,5,0,0,5,10
2013,Belarus,BLR,Czechia,CZE,10,68,0,22,100
2013,Bosnia and Herzegovina,BIH,Czechia,CZE,0,0,5,0,5
2013,China,CHN,Czechia,CZE,0,0,5,5,10
2013,Dem. Rep. of the Congo,COD,Czechia,CZE,0,0,0,5,5
2013,Cuba,CUB,Czechia,CZE,5,30,0,14,49
2013,Ecuador,ECU,Czechia,CZE,5,0,0,0,5
2013,Georgia,GEO,Czechia,CZE,5,0,10,5,20
2013,Guinea,GIN,Czechia,CZE,0,0,0,5,5
2013,Iran (Islamic Rep. of),IRN,Czechia,CZE,0,0,5,0,5
2013,Iraq,IRQ,Czechia,CZE,0,13,0,5,18
2013,Kazakhstan,KAZ,Czechia,CZE,0,5,11,12,28
2013,Kyrgyzstan,KGZ,Czechia,CZE,0,0,18,16,34
2013,Libya,LBY,Czechia,CZE,0,5,0,5,10
2013,Rep. of Moldova,MDA,Czechia,CZE,0,0,5,0,5
2013,Mongolia,MNG,Czechia,CZE,0,0,11,10,21
2013,Myanmar,MMR,Czechia,CZE,29,0,0,0,29
2013,Nigeria,NGA,Czechia,CZE,0,0,0,5,5
2013,Pakistan,PAK,Czechia,CZE,0,0,5,0,5
2013,Romania,ROU,Czechia,CZE,0,0,0,5,5
2013,Russian Federation,RUS,Czechia,CZE,12,5,35,26,78
2013,Serbia and Kosovo: S/RES/1244 (1999),SRB,Czechia,CZE,0,0,12,10,22
2013,Viet Nam,VNM,Czechia,CZE,0,0,48,13,61
2013,Slovakia,SVK,Czechia,CZE,0,0,0,10,10
2013,Syrian Arab Rep.,SYR,Czechia,CZE,5,98,0,10,113
2013,Tunisia,TUN,Czechia,CZE,0,0,0,5,5
2013,Turkey,TUR,Czechia,CZE,0,0,11,10,21
2013,Ukraine,UKR,Czechia,CZE,10,0,93,69,172
2013,Uzbekistan,UZB,Czechia,CZE,0,5,0,0,5
2013,Stateless,XXA,Czechia,CZE,0,11,0,10,21
2013,Afghanistan,AFG,Denmark,DNK,18,164,254,0,436
2013,Albania,ALB,Denmark,DNK,0,0,43,0,43
2013,Algeria,DZA,Denmark,DNK,0,0,24,0,24
2013,Egypt,EGY,Denmark,DNK,0,0,5,0,5
2013,Armenia,ARM,Denmark,DNK,0,0,55,0,55
2013,Azerbaijan,AZE,Denmark,DNK,11,0,5,0,16
2013,Bangladesh,BGD,Denmark,DNK,0,0,38,0,38
2013,Belarus,BLR,Denmark,DNK,0,0,15,0,15
2013,Bosnia and Herzegovina,BIH,Denmark,DNK,0,0,13,0,13
2013,Bulgaria,BGR,Denmark,DNK,0,0,15,0,15
2013,China,CHN,Denmark,DNK,0,0,28,0,28
2013,Chile,CHL,Denmark,DNK,0,0,5,0,5
2013,Dem. Rep. of the Congo,COD,Denmark,DNK,0,12,25,0,37
2013,Eritrea,ERI,Denmark,DNK,34,17,10,0,61
2013,Ethiopia,ETH,Denmark,DNK,0,0,5,0,5
2013,Gambia,GMB,Denmark,DNK,0,0,10,0,10
2013,Georgia,GEO,Denmark,DNK,0,0,16,0,16
2013,Ghana,GHA,Denmark,DNK,0,0,15,0,15
2013,Guinea-Bissau,GNB,Denmark,DNK,0,0,10,0,10
2013,Greece,GRC,Denmark,DNK,0,0,5,0,5
2013,Guinea,GIN,Denmark,DNK,0,0,5,0,5
2013,Croatia,HRV,Denmark,DNK,0,0,5,0,5
2013,India,IND,Denmark,DNK,0,0,20,0,20
2013,Iran (Islamic Rep. of),IRN,Denmark,DNK,269,30,108,0,407
2013,Iraq,IRQ,Denmark,DNK,5,5,49,0,59
2013,Jordan,JOR,Denmark,DNK,0,0,14,0,14
2013,Kazakhstan,KAZ,Denmark,DNK,0,0,5,0,5
2013,Kenya,KEN,Denmark,DNK,0,0,5,0,5
2013,Libya,LBY,Denmark,DNK,0,0,11,0,11
2013,Lebanon,LBN,Denmark,DNK,0,0,10,0,10
2013,Sri Lanka,LKA,Denmark,DNK,5,0,11,0,16
2013,Mauritania,MRT,Denmark,DNK,0,0,5,0,5
2013,North Macedonia,MKD,Denmark,DNK,0,0,16,0,16
2013,Mali,MLI,Denmark,DNK,0,0,5,0,5
2013,Morocco,MAR,Denmark,DNK,0,0,24,0,24
2013,Montenegro,MNE,Denmark,DNK,0,0,10,0,10
2013,Myanmar,MMR,Denmark,DNK,0,0,20,0,20
2013,Nepal,NPL,Denmark,DNK,0,0,5,0,5
2013,Nigeria,NGA,Denmark,DNK,0,0,56,0,56
2013,Pakistan,PAK,Denmark,DNK,5,0,48,0,53
2013,Poland,POL,Denmark,DNK,0,0,5,0,5
2013,Romania,ROU,Denmark,DNK,0,0,5,0,5
2013,Russian Federation,RUS,Denmark,DNK,56,139,219,0,414
2013,Serbia and Kosovo: S/RES/1244 (1999),SRB,Denmark,DNK,0,0,488,0,488
2013,Somalia,SOM,Denmark,DNK,5,376,280,0,661
2013,Viet Nam,VNM,Denmark,DNK,0,0,5,0,5
2013,Sudan,SDN,Denmark,DNK,5,0,20,0,25
2013,Slovakia,SVK,Denmark,DNK,0,0,5,0,5
2013,Syrian Arab Rep.,SYR,Denmark,DNK,1005,291,56,0,1352
2013,Tunisia,TUN,Denmark,DNK,0,0,18,0,18
2013,Turkey,TUR,Denmark,DNK,0,0,10,0,10
2013,Uganda,UGA,Denmark,DNK,12,0,10,0,22
2013,Ukraine,UKR,Denmark,DNK,5,0,20,0,25
2013,United States of America,USA,Denmark,DNK,0,0,5,0,5
2013,Uzbekistan,UZB,Denmark,DNK,0,0,5,0,5
2013,Zambia,ZMB,Denmark,DNK,0,0,5,0,5
2013,Stateless,XXA,Denmark,DNK,154,94,78,0,326
2013,Unknown ,,Denmark,DNK,0,0,15,0,15
2013,Eritrea,ERI,Djibouti,DJI,81,0,0,0,81
2013,Cuba,CUB,Dominican Rep.,DOM,0,0,11,0,11
2013,Haiti,HTI,Dominican Rep.,DOM,5,0,265,0,270
2013,Sri Lanka,LKA,Dominican Rep.,DOM,0,0,22,0,22
2013,Albania,ALB,Estonia,EST,0,0,5,0,5
2013,Georgia,GEO,Estonia,EST,0,0,0,5,5
2013,Pakistan,PAK,Estonia,EST,0,0,0,5,5
2013,Russian Federation,RUS,Estonia,EST,0,0,10,0,10
2013,Viet Nam,VNM,Estonia,EST,0,0,18,5,23
2013,Syrian Arab Rep.,SYR,Estonia,EST,0,0,5,0,5
2013,Afghanistan,AFG,Finland,FIN,53,184,60,53,350
2013,Albania,ALB,Finland,FIN,0,0,24,16,40
2013,Algeria,DZA,Finland,FIN,0,0,13,54,67
2013,Angola,AGO,Finland,FIN,0,14,14,10,38
2013,Egypt,EGY,Finland,FIN,0,0,5,5,10
2013,Armenia,ARM,Finland,FIN,0,0,5,0,5
2013,Azerbaijan,AZE,Finland,FIN,5,0,5,5,15
2013,Bangladesh,BGD,Finland,FIN,0,5,13,5,23
2013,Belarus,BLR,Finland,FIN,0,0,18,26,44
2013,Bosnia and Herzegovina,BIH,Finland,FIN,0,0,12,5,17
2013,Bulgaria,BGR,Finland,FIN,0,0,5,0,5
2013,China,CHN,Finland,FIN,13,0,5,0,18
2013,Cameroon,CMR,Finland,FIN,0,13,11,5,29
2013,Congo,COG,Finland,FIN,0,0,5,0,5
2013,Dem. Rep. of the Congo,COD,Finland,FIN,5,19,17,5,46
2013,Colombia,COL,Finland,FIN,0,0,0,5,5
2013,Cuba,CUB,Finland,FIN,0,0,5,5,10
2013,Eritrea,ERI,Finland,FIN,5,5,0,0,10
2013,Ethiopia,ETH,Finland,FIN,14,5,13,5,37
2013,Gambia,GMB,Finland,FIN,0,0,19,33,52
2013,Georgia,GEO,Finland,FIN,0,0,0,12,12
2013,Ghana,GHA,Finland,FIN,5,5,22,28,60
2013,Guinea,GIN,Finland,FIN,0,0,5,13,18
2013,Cote d'Ivoire,CIV,Finland,FIN,5,0,5,5,15
2013,India,IND,Finland,FIN,0,0,5,5,10
2013,Iran (Islamic Rep. of),IRN,Finland,FIN,71,46,42,72,231
2013,Iraq,IRQ,Finland,FIN,200,472,103,334,1109
2013,Jordan,JOR,Finland,FIN,0,0,0,5,5
2013,Kenya,KEN,Finland,FIN,0,5,12,0,17
2013,Kyrgyzstan,KGZ,Finland,FIN,0,10,5,0,15
2013,Libya,LBY,Finland,FIN,0,0,0,18,18
2013,Sri Lanka,LKA,Finland,FIN,0,0,16,5,21
2013,Mauritania,MRT,Finland,FIN,0,0,0,5,5
2013,North Macedonia,MKD,Finland,FIN,0,0,18,5,23
2013,Rep. of Moldova,MDA,Finland,FIN,0,5,0,0,5
2013,Mexico,MEX,Finland,FIN,0,0,5,0,5
2013,Mali,MLI,Finland,FIN,0,0,10,10,20
2013,Morocco,MAR,Finland,FIN,0,0,15,68,83
2013,Montenegro,MNE,Finland,FIN,0,0,5,0,5
2013,Niger,NER,Finland,FIN,0,0,0,5,5
2013,Nigeria,NGA,Finland,FIN,5,22,61,106,194
2013,Pakistan,PAK,Finland,FIN,10,5,13,15,43
2013,Philippines,PHL,Finland,FIN,0,0,5,0,5
2013,Romania,ROU,Finland,FIN,0,0,5,0,5
2013,Russian Federation,RUS,Finland,FIN,50,38,166,67,321
2013,Rwanda,RWA,Finland,FIN,0,0,5,0,5
2013,Serbia and Kosovo: S/RES/1244 (1999),SRB,Finland,FIN,0,18,95,21,134
2013,Senegal,SEN,Finland,FIN,0,0,5,10,15
2013,Singapore,SGP,Finland,FIN,0,0,0,5,5
2013,Sierra Leone,SLE,Finland,FIN,0,0,5,0,5
2013,Somalia,SOM,Finland,FIN,10,238,5,62,315
2013,Viet Nam,VNM,Finland,FIN,0,0,0,5,5
2013,Sudan,SDN,Finland,FIN,5,0,5,5,15
2013,Syrian Arab Rep.,SYR,Finland,FIN,67,78,0,37,182
2013,United Rep. of Tanzania,TZA,Finland,FIN,0,0,5,0,5
2013,Togo,TGO,Finland,FIN,0,5,5,5,15
2013,Tunisia,TUN,Finland,FIN,0,0,5,19,24
2013,Turkey,TUR,Finland,FIN,5,34,29,15,83
2013,Uganda,UGA,Finland,FIN,5,0,0,0,5
2013,Ukraine,UKR,Finland,FIN,0,0,13,5,18
2013,United States of America,USA,Finland,FIN,0,0,0,5,5
2013,Yemen,YEM,Finland,FIN,0,0,0,5,5
2013,Zambia,ZMB,Finland,FIN,0,0,5,0,5
2013,Stateless,XXA,Finland,FIN,15,0,5,17,37
2013,Unknown ,,Finland,FIN,5,17,5,18,45
2013,Afghanistan,AFG,France,FRA,194,268,250,0,712
2013,Albania,ALB,France,FRA,20,67,2045,0,2132
2013,Algeria,DZA,France,FRA,41,14,1052,0,1107
2013,Angola,AGO,France,FRA,34,5,498,0,537
2013,Egypt,EGY,France,FRA,47,0,258,0,305
2013,Armenia,ARM,France,FRA,86,38,2186,0,2310
2013,Azerbaijan,AZE,France,FRA,119,0,444,0,563
2013,Burundi,BDI,France,FRA,13,0,18,0,31
2013,Bangladesh,BGD,France,FRA,106,5,3386,0,3497
2013,Bhutan,BTN,France,FRA,0,0,20,0,20
2013,Burkina Faso,BFA,France,FRA,5,5,20,0,30
2013,Belarus,BLR,France,FRA,13,0,77,0,90
2013,Brazil,BRA,France,FRA,0,0,10,0,10
2013,Bosnia and Herzegovina,BIH,France,FRA,30,0,553,0,583
2013,Central African Rep.,CAF,France,FRA,13,0,36,0,49
2013,Chad,TCD,France,FRA,19,0,260,0,279
2013,China,CHN,France,FRA,267,0,1838,0,2105
2013,Cameroon,CMR,France,FRA,24,5,137,0,166
2013,Congo,COG,France,FRA,24,5,426,0,455
2013,Dem. Rep. of the Congo,COD,France,FRA,433,28,2820,0,3281
2013,Comoros,COM,France,FRA,32,0,439,0,471
2013,Colombia,COL,France,FRA,5,0,58,0,63
2013,Cuba,CUB,France,FRA,12,0,5,0,17
2013,Cabo Verde,CPV,France,FRA,0,0,10,0,10
2013,Djibouti,DJI,France,FRA,10,0,10,0,20
2013,Dominica,DMA,France,FRA,0,0,5,0,5
2013,Dominican Rep.,DOM,France,FRA,0,5,157,0,162
2013,Eritrea,ERI,France,FRA,47,0,284,0,331
2013,Ethiopia,ETH,France,FRA,20,0,59,0,79
2013,Gabon,GAB,France,FRA,0,0,5,0,5
2013,Gambia,GMB,France,FRA,14,0,59,0,73
2013,Palestinian,PSE,France,FRA,46,5,30,0,81
2013,Georgia,GEO,France,FRA,39,11,1519,0,1569
2013,Ghana,GHA,France,FRA,0,0,16,0,16
2013,Guinea-Bissau,GNB,France,FRA,16,0,125,0,141
2013,Guinea,GIN,France,FRA,314,16,1407,0,1737
2013,Guyana,GUY,France,FRA,0,0,34,0,34
2013,Haiti,HTI,France,FRA,24,21,1630,0,1675
2013,Cote d'Ivoire,CIV,France,FRA,152,16,840,0,1008
2013,India,IND,France,FRA,0,0,27,0,27
2013,Iran (Islamic Rep. of),IRN,France,FRA,126,5,103,0,234
2013,Iraq,IRQ,France,FRA,62,0,30,0,92
2013,Kazakhstan,KAZ,France,FRA,12,5,111,0,128
2013,Kenya,KEN,France,FRA,5,0,15,0,20
2013,Kyrgyzstan,KGZ,France,FRA,10,0,47,0,57
2013,Libya,LBY,France,FRA,10,0,47,0,57
2013,Sri Lanka,LKA,France,FRA,385,22,2183,0,2590
2013,Mauritania,MRT,France,FRA,81,0,1140,0,1221
2013,North Macedonia,MKD,France,FRA,5,5,286,0,296
2013,Mali,MLI,France,FRA,276,10,894,0,1180
2013,Mongolia,MNG,France,FRA,5,5,164,0,174
2013,Morocco,MAR,France,FRA,19,5,83,0,107
2013,Montenegro,MNE,France,FRA,0,0,139,0,139
2013,Myanmar,MMR,France,FRA,21,0,376,0,397
2013,Nepal,NPL,France,FRA,10,0,107,0,117
2013,Nigeria,NGA,France,FRA,39,21,711,0,771
2013,Pakistan,PAK,France,FRA,54,5,1711,0,1770
2013,Peru,PER,France,FRA,0,0,78,0,78
2013,Philippines,PHL,France,FRA,0,0,5,0,5
2013,South Africa,ZAF,France,FRA,5,0,5,0,10
2013,Russian Federation,RUS,France,FRA,449,39,2208,0,2696
2013,Rwanda,RWA,France,FRA,58,0,101,0,159
2013,Serbia and Kosovo: S/RES/1244 (1999),SRB,France,FRA,67,28,3218,0,3313
2013,Senegal,SEN,France,FRA,60,10,208,0,278
2013,Sierra Leone,SLE,France,FRA,14,0,77,0,91
2013,Somalia,SOM,France,FRA,15,32,404,0,451
2013,Viet Nam,VNM,France,FRA,10,0,10,0,20
2013,Sudan,SDN,France,FRA,87,5,699,0,791
2013,Syrian Arab Rep.,SYR,France,FRA,474,361,46,0,881
2013,Thailand,THA,France,FRA,0,0,13,0,13
2013,Tajikistan,TJK,France,FRA,0,0,5,0,5
2013,Togo,TGO,France,FRA,11,0,60,0,71
2013,Tunisia,TUN,France,FRA,18,0,172,0,190
2013,Turkey,TUR,France,FRA,143,5,1613,0,1761
2013,Uganda,UGA,France,FRA,10,0,5,0,15
2013,Ukraine,UKR,France,FRA,11,0,97,0,108
2013,Uzbekistan,UZB,France,FRA,5,0,22,0,27
2013,Western Sahara,ESH,France,FRA,28,0,41,0,69
2013,Unknown ,,France,FRA,27,11,310,0,348
2013,Dem. Rep. of the Congo,COD,Gambia,GMB,10,0,0,0,10
2013,Cote d'Ivoire,CIV,Gambia,GMB,0,0,0,5,5
2013,Afghanistan,AFG,United Kingdom of Great Britain and Northern Ireland,GBR,298,142,557,325,1322
2013,Albania,ALB,United Kingdom of Great Britain and Northern Ireland,GBR,95,169,533,293,1090
2013,Algeria,DZA,United Kingdom of Great Britain and Northern Ireland,GBR,11,18,123,61,213
2013,Angola,AGO,United Kingdom of Great Britain and Northern Ireland,GBR,5,5,17,13,40
2013,Egypt,EGY,United Kingdom of Great Britain and Northern Ireland,GBR,66,5,180,25,276
2013,Armenia,ARM,United Kingdom of Great Britain and Northern Ireland,GBR,5,0,10,5,20
2013,Australia,AUS,United Kingdom of Great Britain and Northern Ireland,GBR,5,0,0,0,5
2013,Azerbaijan,AZE,United Kingdom of Great Britain and Northern Ireland,GBR,5,0,11,0,16
2013,Bahrain,BHR,United Kingdom of Great Britain and Northern Ireland,GBR,13,0,0,5,18
2013,Burundi,BDI,United Kingdom of Great Britain and Northern Ireland,GBR,0,0,5,0,5
2013,Benin,BEN,United Kingdom of Great Britain and Northern Ireland,GBR,0,0,10,0,10
2013,Bangladesh,BGD,United Kingdom of Great Britain and Northern Ireland,GBR,29,24,765,257,1075
2013,Bhutan,BTN,United Kingdom of Great Britain and Northern Ireland,GBR,5,0,5,0,10
2013,Belarus,BLR,United Kingdom of Great Britain and Northern Ireland,GBR,13,0,5,0,18
2013,Botswana,BWA,United Kingdom of Great Britain and Northern Ireland,GBR,0,0,5,0,5
2013,Brazil,BRA,United Kingdom of Great Britain and Northern Ireland,GBR,0,5,13,5,23
2013,Bulgaria,BGR,United Kingdom of Great Britain and Northern Ireland,GBR,0,0,0,5,5
2013,Canada,CAN,United Kingdom of Great Britain and Northern Ireland,GBR,0,0,5,5,10
2013,Central African Rep.,CAF,United Kingdom of Great Britain and Northern Ireland,GBR,0,0,5,0,5
2013,Chad,TCD,United Kingdom of Great Britain and Northern Ireland,GBR,0,0,5,10,15
2013,China,CHN,United Kingdom of Great Britain and Northern Ireland,GBR,53,45,655,187,940
2013,Cameroon,CMR,United Kingdom of Great Britain and Northern Ireland,GBR,34,5,80,10,129
2013,Congo,COG,United Kingdom of Great Britain and Northern Ireland,GBR,5,0,18,0,23
2013,Dem. Rep. of the Congo,COD,United Kingdom of Great Britain and Northern Ireland,GBR,69,10,90,21,190
2013,Comoros,COM,United Kingdom of Great Britain and Northern Ireland,GBR,0,0,5,0,5
2013,Colombia,COL,United Kingdom of Great Britain and Northern Ireland,GBR,0,0,10,0,10
2013,Cabo Verde,CPV,United Kingdom of Great Britain and Northern Ireland,GBR,0,5,0,0,5
2013,Czechia,CZE,United Kingdom of Great Britain and Northern Ireland,GBR,0,0,5,0,5
2013,Ecuador,ECU,United Kingdom of Great Britain and Northern Ireland,GBR,0,0,5,0,5
2013,Eritrea,ERI,United Kingdom of Great Britain and Northern Ireland,GBR,823,10,94,107,1034
2013,Ethiopia,ETH,United Kingdom of Great Britain and Northern Ireland,GBR,53,5,67,20,145
2013,Gambia,GMB,United Kingdom of Great Britain and Northern Ireland,GBR,102,32,169,14,317
2013,Palestinian,PSE,United Kingdom of Great Britain and Northern Ireland,GBR,31,10,61,31,133
2013,United Kingdom of Great Britain and Northern Ireland,GBR,United Kingdom of Great Britain and Northern Ireland,GBR,0,5,0,0,5
2013,Georgia,GEO,United Kingdom of Great Britain and Northern Ireland,GBR,0,0,19,5,24
2013,Ghana,GHA,United Kingdom of Great Britain and Northern Ireland,GBR,11,5,138,29,183
2013,Greece,GRC,United Kingdom of Great Britain and Northern Ireland,GBR,0,0,5,0,5
2013,Guinea,GIN,United Kingdom of Great Britain and Northern Ireland,GBR,23,5,44,11,83
2013,Guyana,GUY,United Kingdom of Great Britain and Northern Ireland,GBR,0,0,5,0,5
2013,Hungary,HUN,United Kingdom of Great Britain and Northern Ireland,GBR,0,0,5,0,5
2013,Cote d'Ivoire,CIV,United Kingdom of Great Britain and Northern Ireland,GBR,19,5,46,5,75
2013,India,IND,United Kingdom of Great Britain and Northern Ireland,GBR,5,10,638,366,1019
2013,Indonesia,IDN,United Kingdom of Great Britain and Northern Ireland,GBR,0,5,5,0,10
2013,Iran (Islamic Rep. of),IRN,United Kingdom of Great Britain and Northern Ireland,GBR,1255,52,931,183,2421
2013,Iraq,IRQ,United Kingdom of Great Britain and Northern Ireland,GBR,91,18,207,61,377
2013,Israel,ISR,United Kingdom of Great Britain and Northern Ireland,GBR,0,0,5,5,10
2013,Jamaica,JAM,United Kingdom of Great Britain and Northern Ireland,GBR,10,5,102,22,139
2013,Jordan,JOR,United Kingdom of Great Britain and Northern Ireland,GBR,0,0,18,5,23
2013,Kazakhstan,KAZ,United Kingdom of Great Britain and Northern Ireland,GBR,0,0,5,0,5
2013,Kenya,KEN,United Kingdom of Great Britain and Northern Ireland,GBR,5,5,78,5,93
2013,Kyrgyzstan,KGZ,United Kingdom of Great Britain and Northern Ireland,GBR,5,0,5,5,15
2013,Rep. of Korea,KOR,United Kingdom of Great Britain and Northern Ireland,GBR,0,0,0,5,5
2013,Dem. People's Rep. of Korea,PRK,United Kingdom of Great Britain and Northern Ireland,GBR,10,0,25,0,35
2013,Kuwait,KWT,United Kingdom of Great Britain and Northern Ireland,GBR,28,0,16,10,54
2013,Liberia,LBR,United Kingdom of Great Britain and Northern Ireland,GBR,0,5,0,5,10
2013,Libya,LBY,United Kingdom of Great Britain and Northern Ireland,GBR,170,0,173,29,372
2013,Lebanon,LBN,United Kingdom of Great Britain and Northern Ireland,GBR,10,0,47,5,62
2013,Sri Lanka,LKA,United Kingdom of Great Britain and Northern Ireland,GBR,315,26,1250,92,1683
2013,Lithuania,LTU,United Kingdom of Great Britain and Northern Ireland,GBR,0,0,11,5,16
2013,Latvia,LVA,United Kingdom of Great Britain and Northern Ireland,GBR,0,0,5,0,5
2013,Maldives,MDV,United Kingdom of Great Britain and Northern Ireland,GBR,5,0,0,0,5
2013,Mexico,MEX,United Kingdom of Great Britain and Northern Ireland,GBR,0,0,5,5,10
2013,Mali,MLI,United Kingdom of Great Britain and Northern Ireland,GBR,5,0,14,5,24
2013,Malaysia,MYS,United Kingdom of Great Britain and Northern Ireland,GBR,5,0,38,10,53
2013,Malawi,MWI,United Kingdom of Great Britain and Northern Ireland,GBR,15,25,115,15,170
2013,Mongolia,MNG,United Kingdom of Great Britain and Northern Ireland,GBR,5,5,14,5,29
2013,Morocco,MAR,United Kingdom of Great Britain and Northern Ireland,GBR,5,10,30,5,50
2013,Mauritius,MUS,United Kingdom of Great Britain and Northern Ireland,GBR,5,10,29,5,49
2013,Myanmar,MMR,United Kingdom of Great Britain and Northern Ireland,GBR,21,0,20,5,46
2013,Namibia,NAM,United Kingdom of Great Britain and Northern Ireland,GBR,0,0,14,5,19
2013,Nepal,NPL,United Kingdom of Great Britain and Northern Ireland,GBR,0,0,41,17,58
2013,Niger,NER,United Kingdom of Great Britain and Northern Ireland,GBR,0,0,0,5,5
2013,Nigeria,NGA,United Kingdom of Great Britain and Northern Ireland,GBR,82,82,961,124,1249
2013,Pakistan,PAK,United Kingdom of Great Britain and Northern Ireland,GBR,912,58,2606,463,4039
2013,Philippines,PHL,United Kingdom of Great Britain and Northern Ireland,GBR,0,0,25,0,25
2013,Poland,POL,United Kingdom of Great Britain and Northern Ireland,GBR,0,0,76,24,100
2013,Romania,ROU,United Kingdom of Great Britain and Northern Ireland,GBR,0,0,5,10,15
2013,South Africa,ZAF,United Kingdom of Great Britain and Northern Ireland,GBR,0,5,38,11,54
2013,Russian Federation,RUS,United Kingdom of Great Britain and Northern Ireland,GBR,38,5,53,15,111
2013,Rwanda,RWA,United Kingdom of Great Britain and Northern Ireland,GBR,5,0,16,0,21
2013,El Salvador,SLV,United Kingdom of Great Britain and Northern Ireland,GBR,0,0,5,0,5
2013,Saudi Arabia,SAU,United Kingdom of Great Britain and Northern Ireland,GBR,10,0,5,5,20
2013,Serbia and Kosovo: S/RES/1244 (1999),SRB,United Kingdom of Great Britain and Northern Ireland,GBR,0,5,14,14,33
2013,Senegal,SEN,United Kingdom of Great Britain and Northern Ireland,GBR,5,0,21,0,26
2013,Seychelles,SYC,United Kingdom of Great Britain and Northern Ireland,GBR,0,0,5,0,5
2013,Sierra Leone,SLE,United Kingdom of Great Britain and Northern Ireland,GBR,32,14,50,10,106
2013,Somalia,SOM,United Kingdom of Great Britain and Northern Ireland,GBR,279,14,145,45,483
2013,Viet Nam,VNM,United Kingdom of Great Britain and Northern Ireland,GBR,23,34,171,191,419
2013,Saint Kitts and Nevis,KNA,United Kingdom of Great Britain and Northern Ireland,GBR,0,0,5,0,5
2013,Sudan,SDN,United Kingdom of Great Britain and Northern Ireland,GBR,480,0,105,93,678
2013,Eswatini,SWZ,United Kingdom of Great Britain and Northern Ireland,GBR,0,0,5,0,5
2013,Syrian Arab Rep.,SYR,United Kingdom of Great Britain and Northern Ireland,GBR,1444,11,110,175,1740
2013,United Rep. of Tanzania,TZA,United Kingdom of Great Britain and Northern Ireland,GBR,0,0,38,5,43
2013,Thailand,THA,United Kingdom of Great Britain and Northern Ireland,GBR,0,0,10,0,10
2013,Turkmenistan,TKM,United Kingdom of Great Britain and Northern Ireland,GBR,0,0,5,0,5
2013,Togo,TGO,United Kingdom of Great Britain and Northern Ireland,GBR,0,0,13,0,13
2013,Trinidad and Tobago,TTO,United Kingdom of Great Britain and Northern Ireland,GBR,0,0,18,0,18
2013,Tunisia,TUN,United Kingdom of Great Britain and Northern Ireland,GBR,0,0,22,11,33
2013,Turkey,TUR,United Kingdom of Great Britain and Northern Ireland,GBR,24,14,131,28,197
2013,Uganda,UGA,United Kingdom of Great Britain and Northern Ireland,GBR,76,10,107,5,198
2013,Ukraine,UKR,United Kingdom of Great Britain and Northern Ireland,GBR,10,0,22,14,46
2013,United States of America,USA,United Kingdom of Great Britain and Northern Ireland,GBR,0,0,17,15,32
2013,Uzbekistan,UZB,United Kingdom of Great Britain and Northern Ireland,GBR,5,0,19,0,24
2013,Saint Vincent and the Grenadines,VCT,United Kingdom of Great Britain and Northern Ireland,GBR,0,0,5,0,5
2013,Venezuela (Bolivarian Republic of),VEN,United Kingdom of Great Britain and Northern Ireland,GBR,0,0,5,0,5
2013,Yemen,YEM,United Kingdom of Great Britain and Northern Ireland,GBR,24,0,36,5,65
2013,Zambia,ZMB,United Kingdom of Great Britain and Northern Ireland,GBR,5,5,15,0,25
2013,Zimbabwe,ZWE,United Kingdom of Great Britain and Northern Ireland,GBR,81,54,231,29,395
2013,Stateless,XXA,United Kingdom of Great Britain and Northern Ireland,GBR,217,0,36,22,275
2013,Unknown ,,United Kingdom of Great Britain and Northern Ireland,GBR,0,0,5,5,10
2013,Central African Rep.,CAF,Ghana,GHA,5,0,0,0,5
2013,Chad,TCD,Ghana,GHA,0,0,0,5,5
2013,Guinea,GIN,Ghana,GHA,0,0,0,5,5
2013,Iraq,IRQ,Ghana,GHA,10,0,0,0,10
2013,Liberia,LBR,Ghana,GHA,0,0,0,5,5
2013,Lebanon,LBN,Ghana,GHA,5,0,0,0,5
2013,Nigeria,NGA,Ghana,GHA,0,0,0,35,35
2013,Sierra Leone,SLE,Ghana,GHA,0,0,0,5,5
2013,Sudan,SDN,Ghana,GHA,95,0,0,0,95
2013,Togo,TGO,Ghana,GHA,0,0,0,1892,1892
2013,Afghanistan,AFG,Greece,GRC,34,65,830,369,1298
2013,Albania,ALB,Greece,GRC,0,5,652,84,741
2013,Algeria,DZA,Greece,GRC,0,0,187,95,282
2013,Angola,AGO,Greece,GRC,0,0,10,0,10
2013,Egypt,EGY,Greece,GRC,5,0,253,59,317
2013,Armenia,ARM,Greece,GRC,0,0,73,17,90
2013,Azerbaijan,AZE,Greece,GRC,0,0,5,0,5
2013,Bahrain,BHR,Greece,GRC,0,0,50,0,50
2013,Bangladesh,BGD,Greece,GRC,0,0,1826,424,2250
2013,Burkina Faso,BFA,Greece,GRC,0,0,48,10,58
2013,Belarus,BLR,Greece,GRC,0,0,0,5,5
2013,Central African Rep.,CAF,Greece,GRC,0,5,0,0,5
2013,China,CHN,Greece,GRC,5,0,374,101,480
2013,Cameroon,CMR,Greece,GRC,0,0,73,10,83
2013,Congo,COG,Greece,GRC,0,0,92,14,106
2013,Dem. Rep. of the Congo,COD,Greece,GRC,0,0,71,17,88
2013,Comoros,COM,Greece,GRC,0,0,69,11,80
2013,Dominican Rep.,DOM,Greece,GRC,0,0,17,12,29
2013,Eritrea,ERI,Greece,GRC,35,5,68,57,165
2013,Ethiopia,ETH,Greece,GRC,10,11,120,21,162
2013,Gabon,GAB,Greece,GRC,0,0,5,0,5
2013,Gambia,GMB,Greece,GRC,0,0,39,5,44
2013,Palestinian,PSE,Greece,GRC,10,0,30,14,54
2013,Georgia,GEO,Greece,GRC,0,5,854,393,1252
2013,Ghana,GHA,Greece,GRC,0,0,141,18,159
2013,Guinea-Bissau,GNB,Greece,GRC,0,0,5,0,5
2013,Guinea,GIN,Greece,GRC,0,0,94,14,108
2013,Cote d'Ivoire,CIV,Greece,GRC,5,5,98,18,126
2013,India,IND,Greece,GRC,0,0,292,137,429
2013,Indonesia,IDN,Greece,GRC,0,0,17,10,27
2013,Iran (Islamic Rep. of),IRN,Greece,GRC,21,5,118,64,208
2013,Iraq,IRQ,Greece,GRC,5,17,221,198,441
2013,Kazakhstan,KAZ,Greece,GRC,0,0,5,5,10
2013,Kenya,KEN,Greece,GRC,0,0,26,11,37
2013,Liberia,LBR,Greece,GRC,0,0,5,0,5
2013,Libya,LBY,Greece,GRC,0,0,5,0,5
2013,Lebanon,LBN,Greece,GRC,0,0,0,5,5
2013,Sri Lanka,LKA,Greece,GRC,5,0,47,12,64
2013,Mauritania,MRT,Greece,GRC,0,0,32,5,37
2013,North Macedonia,MKD,Greece,GRC,0,0,5,0,5
2013,Rep. of Moldova,MDA,Greece,GRC,0,0,35,30,65
2013,Mali,MLI,Greece,GRC,0,0,30,5,35
2013,Morocco,MAR,Greece,GRC,0,0,142,45,187
2013,Mauritius,MUS,Greece,GRC,0,0,5,0,5
2013,Myanmar,MMR,Greece,GRC,0,0,5,0,5
2013,Nepal,NPL,Greece,GRC,0,0,19,5,24
2013,Niger,NER,Greece,GRC,0,0,19,5,24
2013,Nigeria,NGA,Greece,GRC,14,5,389,72,480
2013,Pakistan,PAK,Greece,GRC,10,5,4279,1287,5581
2013,Paraguay,PRY,Greece,GRC,0,0,5,0,5
2013,Philippines,PHL,Greece,GRC,0,0,32,10,42
2013,Russian Federation,RUS,Greece,GRC,0,0,34,19,53
2013,Rwanda,RWA,Greece,GRC,0,0,19,0,19
2013,El Salvador,SLV,Greece,GRC,0,0,5,0,5
2013,Serbia and Kosovo: S/RES/1244 (1999),SRB,Greece,GRC,0,0,5,11,16
2013,Senegal,SEN,Greece,GRC,0,0,237,63,300
2013,Sierra Leone,SLE,Greece,GRC,0,0,44,5,49
2013,Somalia,SOM,Greece,GRC,0,18,57,74,149
2013,Viet Nam,VNM,Greece,GRC,0,0,10,0,10
2013,Sudan,SDN,Greece,GRC,29,5,102,21,157
2013,Syrian Arab Rep.,SYR,Greece,GRC,44,61,70,126,301
2013,United Rep. of Tanzania,TZA,Greece,GRC,5,0,25,5,35
2013,Togo,TGO,Greece,GRC,0,0,5,0,5
2013,Tunisia,TUN,Greece,GRC,0,0,45,21,66
2013,Turkey,TUR,Greece,GRC,5,5,29,15,54
2013,Uganda,UGA,Greece,GRC,0,0,5,0,5
2013,Ukraine,UKR,Greece,GRC,0,0,27,15,42
2013,Uzbekistan,UZB,Greece,GRC,0,5,10,5,20
2013,Unknown ,,Greece,GRC,5,0,29,15,49
2013,Bangladesh,BGD,Guatemala,GTM,0,0,0,10,10
2013,Cuba,CUB,Guatemala,GTM,0,0,0,5,5
2013,Honduras,HND,Guatemala,GTM,0,0,0,5,5
2013,India,IND,Guatemala,GTM,0,0,0,10,10
2013,Cote d'Ivoire,CIV,Guinea,GIN,0,0,0,50,50
2013,Iraq,IRQ,Guinea,GIN,0,0,0,5,5
2013,Liberia,LBR,Guinea,GIN,0,0,0,156,156
2013,Sierra Leone,SLE,Guinea,GIN,0,0,0,74,74
2013,Togo,TGO,Guinea,GIN,5,0,0,0,5
2013,Nicaragua,NIC,Honduras,HND,0,0,0,35,35
2013,Afghanistan,AFG,Croatia,HRV,0,0,10,291,301
2013,Algeria,DZA,Croatia,HRV,0,0,69,83,152
2013,Egypt,EGY,Croatia,HRV,0,0,0,5,5
2013,Bangladesh,BGD,Croatia,HRV,0,0,0,18,18
2013,Cuba,CUB,Croatia,HRV,0,0,0,10,10
2013,Eritrea,ERI,Croatia,HRV,0,0,0,25,25
2013,Palestinian,PSE,Croatia,HRV,0,0,0,10,10
2013,Ghana,GHA,Croatia,HRV,0,0,0,5,5
2013,Cote d'Ivoire,CIV,Croatia,HRV,0,0,0,5,5
2013,Iran (Islamic Rep. of),IRN,Croatia,HRV,0,0,5,13,18
2013,Iraq,IRQ,Croatia,HRV,0,0,0,5,5
2013,Kazakhstan,KAZ,Croatia,HRV,5,0,0,0,5
2013,Libya,LBY,Croatia,HRV,0,0,0,10,10
2013,North Macedonia,MKD,Croatia,HRV,0,0,0,5,5
2013,Mali,MLI,Croatia,HRV,0,0,0,15,15
2013,Morocco,MAR,Croatia,HRV,0,0,29,30,59
2013,Nigeria,NGA,Croatia,HRV,0,0,0,5,5
2013,Pakistan,PAK,Croatia,HRV,0,0,5,41,46
2013,Russian Federation,RUS,Croatia,HRV,0,0,5,11,16
2013,Serbia and Kosovo: S/RES/1244 (1999),SRB,Croatia,HRV,0,0,0,5,5
2013,Somalia,SOM,Croatia,HRV,0,5,5,177,187
2013,Sudan,SDN,Croatia,HRV,0,0,0,43,43
2013,Syrian Arab Rep.,SYR,Croatia,HRV,0,10,0,188,198
2013,Tunisia,TUN,Croatia,HRV,0,0,21,25,46
2013,Afghanistan,AFG,Hungary,HUN,33,52,193,1148,1426
2013,Albania,ALB,Hungary,HUN,0,0,0,40,40
2013,Algeria,DZA,Hungary,HUN,0,0,589,440,1029
2013,Egypt,EGY,Hungary,HUN,5,0,30,45,80
2013,Armenia,ARM,Hungary,HUN,0,0,0,5,5
2013,Benin,BEN,Hungary,HUN,0,0,5,0,5
2013,Bangladesh,BGD,Hungary,HUN,0,0,124,447,571
2013,Burkina Faso,BFA,Hungary,HUN,0,0,42,22,64
2013,Bosnia and Herzegovina,BIH,Hungary,HUN,0,0,0,5,5
2013,China,CHN,Hungary,HUN,0,0,0,5,5
2013,Cameroon,CMR,Hungary,HUN,0,0,10,25,35
2013,Congo,COG,Hungary,HUN,0,0,5,14,19
2013,Dem. Rep. of the Congo,COD,Hungary,HUN,0,0,5,35,40
2013,Comoros,COM,Hungary,HUN,0,0,39,54,93
2013,Cuba,CUB,Hungary,HUN,0,0,10,18,28
2013,Eritrea,ERI,Hungary,HUN,5,5,0,55,65
2013,Ethiopia,ETH,Hungary,HUN,5,0,0,0,5
2013,Gambia,GMB,Hungary,HUN,0,0,34,34,68
2013,Palestinian,PSE,Hungary,HUN,5,0,10,75,90
2013,Georgia,GEO,Hungary,HUN,15,0,0,23,38
2013,Ghana,GHA,Hungary,HUN,0,0,72,100,172
2013,Greece,GRC,Hungary,HUN,0,0,0,11,11
2013,Guinea,GIN,Hungary,HUN,0,0,57,67,124
2013,Cote d'Ivoire,CIV,Hungary,HUN,0,0,118,100,218
2013,India,IND,Hungary,HUN,0,0,5,65,70
2013,Iran (Islamic Rep. of),IRN,Hungary,HUN,0,0,10,44,54
2013,Iraq,IRQ,Hungary,HUN,0,10,5,38,53
2013,Liberia,LBR,Hungary,HUN,0,0,5,5,10
2013,Libya,LBY,Hungary,HUN,0,0,5,26,31
2013,Sri Lanka,LKA,Hungary,HUN,0,0,5,10,15
2013,Madagascar,MDG,Hungary,HUN,0,0,0,10,10
2013,Mauritania,MRT,Hungary,HUN,0,0,44,73,117
2013,North Macedonia,MKD,Hungary,HUN,0,0,0,10,10
2013,Rep. of Moldova,MDA,Hungary,HUN,0,0,0,5,5
2013,Mali,MLI,Hungary,HUN,0,0,141,117,258
2013,Mongolia,MNG,Hungary,HUN,0,0,5,0,5
2013,Morocco,MAR,Hungary,HUN,0,0,255,212,467
2013,Montenegro,MNE,Hungary,HUN,0,0,5,5,10
2013,Myanmar,MMR,Hungary,HUN,0,0,5,10,15
2013,Nepal,NPL,Hungary,HUN,0,0,0,5,5
2013,Nigeria,NGA,Hungary,HUN,0,0,116,262,378
2013,Pakistan,PAK,Hungary,HUN,0,5,899,1872,2776
2013,Russian Federation,RUS,Hungary,HUN,0,5,0,5,10
2013,Rwanda,RWA,Hungary,HUN,0,0,0,5,5
2013,Serbia and Kosovo: S/RES/1244 (1999),SRB,Hungary,HUN,0,0,1020,4718,5738
2013,Senegal,SEN,Hungary,HUN,0,0,116,72,188
2013,Sierra Leone,SLE,Hungary,HUN,0,0,15,42,57
2013,Somalia,SOM,Hungary,HUN,10,41,5,78,134
2013,Viet Nam,VNM,Hungary,HUN,0,0,0,5,5
2013,Sudan,SDN,Hungary,HUN,0,0,10,47,57
2013,Syrian Arab Rep.,SYR,Hungary,HUN,73,54,47,554,728
2013,Togo,TGO,Hungary,HUN,0,0,10,10,20
2013,Tunisia,TUN,Hungary,HUN,0,0,92,111,203
2013,Turkey,TUR,Hungary,HUN,0,0,13,80,93
2013,Uganda,UGA,Hungary,HUN,0,0,0,5,5
2013,Ukraine,UKR,Hungary,HUN,0,0,0,5,5
2013,Western Sahara,ESH,Hungary,HUN,0,0,0,5,5
2013,Zimbabwe,ZWE,Hungary,HUN,0,0,0,5,5
2013,Unknown ,,Hungary,HUN,17,5,5,28,55
2013,Afghanistan,AFG,Iceland,ISL,0,0,5,5,10
2013,Albania,ALB,Iceland,ISL,0,0,38,5,43
2013,Algeria,DZA,Iceland,ISL,0,0,0,5,5
2013,Belarus,BLR,Iceland,ISL,0,0,5,0,5
2013,Georgia,GEO,Iceland,ISL,0,0,0,5,5
2013,Croatia,HRV,Iceland,ISL,0,0,46,0,46
2013,Iraq,IRQ,Iceland,ISL,0,0,0,5,5
2013,Nigeria,NGA,Iceland,ISL,0,0,5,5,10
2013,Russian Federation,RUS,Iceland,ISL,0,0,0,5,5
2013,Serbia and Kosovo: S/RES/1244 (1999),SRB,Iceland,ISL,0,0,5,0,5
2013,Somalia,SOM,Iceland,ISL,0,0,0,5,5
2013,Unknown ,,Iceland,ISL,5,5,0,0,10
2013,Afghanistan,AFG,Ireland,IRL,10,0,39,16,65
2013,Albania,ALB,Ireland,IRL,0,0,32,16,48
2013,Algeria,DZA,Ireland,IRL,0,0,28,19,47
2013,Egypt,EGY,Ireland,IRL,5,0,5,0,10
2013,Benin,BEN,Ireland,IRL,0,0,5,0,5
2013,Bangladesh,BGD,Ireland,IRL,0,0,11,14,25
2013,Brazil,BRA,Ireland,IRL,0,0,5,0,5
2013,China,CHN,Ireland,IRL,0,0,10,23,33
2013,Cameroon,CMR,Ireland,IRL,0,0,15,0,15
2013,Dem. Rep. of the Congo,COD,Ireland,IRL,10,0,51,13,74
2013,Ethiopia,ETH,Ireland,IRL,0,0,5,0,5
2013,Palestinian,PSE,Ireland,IRL,0,0,0,5,5
2013,Georgia,GEO,Ireland,IRL,0,0,10,10,20
2013,Ghana,GHA,Ireland,IRL,0,0,5,0,5
2013,Cote d'Ivoire,CIV,Ireland,IRL,0,0,5,0,5
2013,India,IND,Ireland,IRL,0,0,0,5,5
2013,Iran (Islamic Rep. of),IRN,Ireland,IRL,13,0,0,5,18
2013,Iraq,IRQ,Ireland,IRL,10,0,5,5,20
2013,Kenya,KEN,Ireland,IRL,0,0,10,5,15
2013,Kuwait,KWT,Ireland,IRL,5,0,0,0,5
2013,Libya,LBY,Ireland,IRL,0,0,5,5,10
2013,Rep. of Moldova,MDA,Ireland,IRL,0,0,5,5,10
2013,Mali,MLI,Ireland,IRL,5,0,0,0,5
2013,Malawi,MWI,Ireland,IRL,5,0,21,5,31
2013,Mauritius,MUS,Ireland,IRL,0,0,11,5,16
2013,Myanmar,MMR,Ireland,IRL,0,0,5,0,5
2013,Niger,NER,Ireland,IRL,0,0,5,0,5
2013,Nigeria,NGA,Ireland,IRL,0,0,95,61,156
2013,Pakistan,PAK,Ireland,IRL,5,0,64,45,114
2013,South Africa,ZAF,Ireland,IRL,0,0,20,0,20
2013,Russian Federation,RUS,Ireland,IRL,0,0,10,0,10
2013,Somalia,SOM,Ireland,IRL,5,0,5,5,15
2013,Viet Nam,VNM,Ireland,IRL,0,0,5,0,5
2013,Sudan,SDN,Ireland,IRL,5,0,5,5,15
2013,Syrian Arab Rep.,SYR,Ireland,IRL,32,0,0,0,32
2013,Togo,TGO,Ireland,IRL,0,0,0,5,5
2013,Turkey,TUR,Ireland,IRL,0,0,0,5,5
2013,Ukraine,UKR,Ireland,IRL,0,0,5,5,10
2013,Uzbekistan,UZB,Ireland,IRL,0,0,0,5,5
2013,Zimbabwe,ZWE,Ireland,IRL,0,0,54,10,64
2013,Afghanistan,AFG,Italy,ITA,285,1317,162,0,1764
2013,Albania,ALB,Italy,ITA,17,39,38,0,94
2013,Algeria,DZA,Italy,ITA,5,22,128,0,155
2013,Egypt,EGY,Italy,ITA,102,232,134,0,468
2013,Armenia,ARM,Italy,ITA,14,44,24,0,82
2013,Benin,BEN,Italy,ITA,0,11,5,0,16
2013,Bangladesh,BGD,Italy,ITA,22,276,293,0,591
2013,Burkina Faso,BFA,Italy,ITA,5,124,71,0,200
2013,Belarus,BLR,Italy,ITA,0,5,5,0,10
2013,Brazil,BRA,Italy,ITA,0,5,10,0,15
2013,Bosnia and Herzegovina,BIH,Italy,ITA,0,149,255,0,404
2013,Chad,TCD,Italy,ITA,5,38,32,0,75
2013,China,CHN,Italy,ITA,5,0,24,0,29
2013,Cameroon,CMR,Italy,ITA,26,33,29,0,88
2013,Congo,COG,Italy,ITA,18,21,5,0,44
2013,Dem. Rep. of the Congo,COD,Italy,ITA,18,26,18,0,62
2013,Colombia,COL,Italy,ITA,19,26,12,0,57
2013,Cuba,CUB,Italy,ITA,5,24,26,0,55
2013,Ecuador,ECU,Italy,ITA,0,5,5,0,10
2013,Eritrea,ERI,Italy,ITA,930,474,118,0,1522
2013,Ethiopia,ETH,Italy,ITA,67,93,35,0,195
2013,Gabon,GAB,Italy,ITA,0,0,10,0,10
2013,Gambia,GMB,Italy,ITA,18,325,280,0,623
2013,Palestinian,PSE,Italy,ITA,59,12,48,0,119
2013,Georgia,GEO,Italy,ITA,5,18,86,0,109
2013,Ghana,GHA,Italy,ITA,11,508,284,0,803
2013,Guinea-Bissau,GNB,Italy,ITA,0,40,19,0,59
2013,Guinea,GIN,Italy,ITA,10,116,75,0,201
2013,Cote d'Ivoire,CIV,Italy,ITA,49,349,145,0,543
2013,India,IND,Italy,ITA,0,10,41,0,51
2013,Iran (Islamic Rep. of),IRN,Italy,ITA,157,66,51,0,274
2013,Iraq,IRQ,Italy,ITA,71,382,173,0,626
2013,Jordan,JOR,Italy,ITA,0,0,5,0,5
2013,Kenya,KEN,Italy,ITA,5,10,12,0,27
2013,Kyrgyzstan,KGZ,Italy,ITA,0,0,5,0,5
2013,Kuwait,KWT,Italy,ITA,0,0,5,0,5
2013,Liberia,LBR,Italy,ITA,0,25,48,0,73
2013,Libya,LBY,Italy,ITA,18,31,63,0,112
2013,Lebanon,LBN,Italy,ITA,23,29,34,0,86
2013,Sri Lanka,LKA,Italy,ITA,5,27,43,0,75
2013,Mauritania,MRT,Italy,ITA,16,33,48,0,97
2013,North Macedonia,MKD,Italy,ITA,0,17,10,0,27
2013,Rep. of Moldova,MDA,Italy,ITA,0,0,10,0,10
2013,Mali,MLI,Italy,ITA,12,1469,202,0,1683
2013,Mongolia,MNG,Italy,ITA,0,0,5,0,5
2013,Morocco,MAR,Italy,ITA,10,78,247,0,335
2013,Montenegro,MNE,Italy,ITA,0,10,21,0,31
2013,Nepal,NPL,Italy,ITA,0,0,5,0,5
2013,Niger,NER,Italy,ITA,0,77,24,0,101
2013,Nicaragua,NIC,Italy,ITA,0,0,5,0,5
2013,Nigeria,NGA,Italy,ITA,66,1180,1783,0,3029
2013,Pakistan,PAK,Italy,ITA,231,906,1299,0,2436
2013,Peru,PER,Italy,ITA,5,10,5,0,20
2013,Russian Federation,RUS,Italy,ITA,0,5,14,0,19
2013,El Salvador,SLV,Italy,ITA,5,29,16,0,50
2013,Serbia and Kosovo: S/RES/1244 (1999),SRB,Italy,ITA,5,181,180,0,366
2013,Senegal,SEN,Italy,ITA,40,246,495,0,781
2013,Sierra Leone,SLE,Italy,ITA,5,27,17,0,49
2013,Somalia,SOM,Italy,ITA,331,1254,62,0,1647
2013,Sudan,SDN,Italy,ITA,20,50,37,0,107
2013,Syrian Arab Rep.,SYR,Italy,ITA,246,149,383,0,778
2013,United Rep. of Tanzania,TZA,Italy,ITA,0,0,5,0,5
2013,Togo,TGO,Italy,ITA,10,60,44,0,114
2013,Tunisia,TUN,Italy,ITA,5,96,964,0,1065
2013,Turkey,TUR,Italy,ITA,48,287,325,0,660
2013,Uganda,UGA,Italy,ITA,0,5,5,0,10
2013,Ukraine,UKR,Italy,ITA,5,15,18,0,38
2013,Yemen,YEM,Italy,ITA,5,0,0,0,5
2013,Zimbabwe,ZWE,Italy,ITA,0,0,5,0,5
2013,Stateless,XXA,Italy,ITA,5,5,0,0,10
2013,Unknown ,,Italy,ITA,15,185,70,0,270
2013,Bangladesh,BGD,Japan,JPN,0,0,125,0,125
2013,Cameroon,CMR,Japan,JPN,0,0,73,0,73
2013,Ghana,GHA,Japan,JPN,0,0,145,0,145
2013,India,IND,Japan,JPN,0,0,121,0,121
2013,Sri Lanka,LKA,Japan,JPN,0,0,204,0,204
2013,Myanmar,MMR,Japan,JPN,0,0,310,0,310
2013,Nepal,NPL,Japan,JPN,0,0,443,0,443
2013,Nigeria,NGA,Japan,JPN,0,0,95,0,95
2013,Pakistan,PAK,Japan,JPN,0,0,223,0,223
2013,Syrian Arab Rep.,SYR,Japan,JPN,0,26,0,0,26
2013,Turkey,TUR,Japan,JPN,0,0,459,0,459
2013,Unknown ,,Japan,JPN,0,16,257,140,413
2013,Afghanistan,AFG,Kazakhstan,KAZ,50,5,16,5,76
2013,Syrian Arab Rep.,SYR,Kazakhstan,KAZ,5,0,10,0,15
2013,Uzbekistan,UZB,Kazakhstan,KAZ,0,0,0,5,5
2013,Afghanistan,AFG,Kyrgyzstan,KGZ,0,0,65,5,70
2013,Pakistan,PAK,Kyrgyzstan,KGZ,0,0,5,0,5
2013,Syrian Arab Rep.,SYR,Kyrgyzstan,KGZ,12,0,10,15,37
2013,Uzbekistan,UZB,Kyrgyzstan,KGZ,0,0,0,32,32
2013,Albania,ALB,Liechtenstein,LIE,0,0,0,5,5
2013,Algeria,DZA,Liechtenstein,LIE,0,0,0,5,5
2013,Bosnia and Herzegovina,BIH,Liechtenstein,LIE,0,0,0,5,5
2013,China,CHN,Liechtenstein,LIE,0,5,0,0,5
2013,Kyrgyzstan,KGZ,Liechtenstein,LIE,0,0,0,5,5
2013,Morocco,MAR,Liechtenstein,LIE,0,0,0,5,5
2013,Romania,ROU,Liechtenstein,LIE,0,0,0,34,34
2013,Russian Federation,RUS,Liechtenstein,LIE,0,0,0,10,10
2013,Serbia and Kosovo: S/RES/1244 (1999),SRB,Liechtenstein,LIE,0,0,0,5,5
2013,Ukraine,UKR,Liechtenstein,LIE,0,0,0,5,5
2013,Afghanistan,AFG,Lithuania,LTU,0,17,0,18,35
2013,Armenia,ARM,Lithuania,LTU,0,0,0,5,5
2013,Azerbaijan,AZE,Lithuania,LTU,0,0,0,5,5
2013,Georgia,GEO,Lithuania,LTU,0,0,69,47,116
2013,India,IND,Lithuania,LTU,0,0,0,5,5
2013,Russian Federation,RUS,Lithuania,LTU,0,0,11,19,30
2013,Viet Nam,VNM,Lithuania,LTU,0,0,21,5,26
2013,Syrian Arab Rep.,SYR,Lithuania,LTU,0,13,0,0,13
2013,Uzbekistan,UZB,Lithuania,LTU,0,5,0,0,5
2013,Stateless,XXA,Lithuania,LTU,0,0,0,10,10
2013,Afghanistan,AFG,Luxembourg,LUX,10,10,5,16,41
2013,Albania,ALB,Luxembourg,LUX,0,0,109,17,126
2013,Algeria,DZA,Luxembourg,LUX,0,0,13,15,28
2013,Armenia,ARM,Luxembourg,LUX,0,0,0,5,5
2013,Azerbaijan,AZE,Luxembourg,LUX,5,0,0,5,10
2013,Benin,BEN,Luxembourg,LUX,0,0,10,5,15
2013,Belarus,BLR,Luxembourg,LUX,0,0,5,18,23
2013,Bosnia and Herzegovina,BIH,Luxembourg,LUX,0,0,156,28,184
2013,Cameroon,CMR,Luxembourg,LUX,0,0,5,5,10
2013,Dem. Rep. of the Congo,COD,Luxembourg,LUX,0,0,5,0,5
2013,Eritrea,ERI,Luxembourg,LUX,0,0,0,5,5
2013,Gambia,GMB,Luxembourg,LUX,0,0,5,5,10
2013,Palestinian,PSE,Luxembourg,LUX,0,0,5,0,5
2013,Georgia,GEO,Luxembourg,LUX,0,0,0,5,5
2013,Guinea,GIN,Luxembourg,LUX,0,0,0,10,10
2013,Cote d'Ivoire,CIV,Luxembourg,LUX,0,0,5,0,5
2013,Iran (Islamic Rep. of),IRN,Luxembourg,LUX,28,0,5,13,46
2013,Iraq,IRQ,Luxembourg,LUX,10,0,19,18,47
2013,Italy,ITA,Luxembourg,LUX,0,0,0,5,5
2013,Dem. People's Rep. of Korea,PRK,Luxembourg,LUX,5,0,0,0,5
2013,Liberia,LBR,Luxembourg,LUX,0,0,5,10,15
2013,Libya,LBY,Luxembourg,LUX,5,0,0,5,10
2013,North Macedonia,MKD,Luxembourg,LUX,0,0,26,13,39
2013,Marshall Islands,MHL,Luxembourg,LUX,0,0,5,0,5
2013,Morocco,MAR,Luxembourg,LUX,0,0,5,10,15
2013,Montenegro,MNE,Luxembourg,LUX,10,0,127,11,148
2013,Nigeria,NGA,Luxembourg,LUX,0,0,16,26,42
2013,Russian Federation,RUS,Luxembourg,LUX,5,0,5,20,30
2013,Serbia and Kosovo: S/RES/1244 (1999),SRB,Luxembourg,LUX,0,5,260,56,321
2013,Sierra Leone,SLE,Luxembourg,LUX,0,0,0,5,5
2013,Somalia,SOM,Luxembourg,LUX,5,0,5,19,29
2013,Sudan,SDN,Luxembourg,LUX,0,0,0,5,5
2013,Syrian Arab Rep.,SYR,Luxembourg,LUX,10,5,0,5,20
2013,Togo,TGO,Luxembourg,LUX,0,0,5,0,5
2013,Tunisia,TUN,Luxembourg,LUX,0,0,24,33,57
2013,Turkey,TUR,Luxembourg,LUX,0,0,10,5,15
2013,Egypt,EGY,Latvia,LVA,5,0,0,0,5
2013,Dem. Rep. of the Congo,COD,Latvia,LVA,0,0,5,0,5
2013,Georgia,GEO,Latvia,LVA,0,0,23,75,98
2013,Iran (Islamic Rep. of),IRN,Latvia,LVA,0,5,0,0,5
2013,Kyrgyzstan,KGZ,Latvia,LVA,5,0,0,0,5
2013,Russian Federation,RUS,Latvia,LVA,5,0,0,0,5
2013,Syrian Arab Rep.,SYR,Latvia,LVA,0,16,0,0,16
2013,Egypt,EGY,Rep. of Moldova,MDA,0,0,5,0,5
2013,Armenia,ARM,Rep. of Moldova,MDA,0,5,0,0,5
2013,Iraq,IRQ,Rep. of Moldova,MDA,5,0,0,0,5
2013,Kyrgyzstan,KGZ,Rep. of Moldova,MDA,0,0,10,0,10
2013,Pakistan,PAK,Rep. of Moldova,MDA,0,0,0,5,5
2013,Russian Federation,RUS,Rep. of Moldova,MDA,0,0,5,0,5
2013,Syrian Arab Rep.,SYR,Rep. of Moldova,MDA,10,78,0,5,93
2013,Turkey,TUR,Rep. of Moldova,MDA,0,0,5,0,5
2013,Colombia,COL,Mexico,MEX,10,0,0,0,10
2013,Guatemala,GTM,Mexico,MEX,5,0,0,0,5
2013,Honduras,HND,Mexico,MEX,101,27,0,0,128
2013,Iran (Islamic Rep. of),IRN,Mexico,MEX,5,0,0,0,5
2013,Nigeria,NGA,Mexico,MEX,15,0,0,0,15
2013,El Salvador,SLV,Mexico,MEX,98,0,0,0,98
2013,Syrian Arab Rep.,SYR,Mexico,MEX,11,0,0,0,11
2013,Burundi,BDI,Malawi,MWI,0,0,0,424,424
2013,Dem. Rep. of the Congo,COD,Malawi,MWI,10,0,0,1651,1661
2013,Ethiopia,ETH,Malawi,MWI,0,0,0,10,10
2013,Rwanda,RWA,Malawi,MWI,0,0,0,309,309
2013,Sierra Leone,SLE,Malawi,MWI,0,0,0,5,5
2013,Somalia,SOM,Malawi,MWI,0,0,0,5,5
2013,Burundi,BDI,Mozambique,MOZ,5,0,0,0,5
2013,Dem. Rep. of the Congo,COD,Mozambique,MOZ,48,0,0,5,53
2013,Egypt,EGY,Malta,MLT,5,0,0,5,10
2013,Bangladesh,BGD,Malta,MLT,0,0,5,0,5
2013,Eritrea,ERI,Malta,MLT,548,5,29,10,592
2013,Ethiopia,ETH,Malta,MLT,12,5,12,0,29
2013,Palestinian,PSE,Malta,MLT,0,0,5,0,5
2013,Ghana,GHA,Malta,MLT,0,0,0,28,28
2013,Cote d'Ivoire,CIV,Malta,MLT,0,0,5,0,5
2013,India,IND,Malta,MLT,0,0,0,5,5
2013,Iraq,IRQ,Malta,MLT,5,0,0,0,5
2013,Libya,LBY,Malta,MLT,65,47,0,13,125
2013,Mali,MLI,Malta,MLT,0,0,17,0,17
2013,Morocco,MAR,Malta,MLT,0,5,5,0,10
2013,Niger,NER,Malta,MLT,0,0,5,0,5
2013,Nigeria,NGA,Malta,MLT,5,5,44,12,66
2013,Pakistan,PAK,Malta,MLT,0,0,5,0,5
2013,Somalia,SOM,Malta,MLT,657,10,134,38,839
2013,Sudan,SDN,Malta,MLT,12,0,0,0,12
2013,Syrian Arab Rep.,SYR,Malta,MLT,412,171,0,21,604
2013,Tunisia,TUN,Malta,MLT,0,0,5,5,10
2013,Burundi,BDI,Namibia,NAM,12,0,11,0,23
2013,Dem. Rep. of the Congo,COD,Namibia,NAM,141,0,48,0,189
2013,Ethiopia,ETH,Namibia,NAM,5,0,0,0,5
2013,Rwanda,RWA,Namibia,NAM,10,0,5,0,15
2013,Zimbabwe,ZWE,Namibia,NAM,0,0,5,0,5
2013,Afghanistan,AFG,Netherlands,NLD,190,526,617,35,1368
2013,Albania,ALB,Netherlands,NLD,0,0,35,0,35
2013,Algeria,DZA,Netherlands,NLD,0,5,20,5,30
2013,Angola,AGO,Netherlands,NLD,0,0,19,0,19
2013,Egypt,EGY,Netherlands,NLD,16,33,185,10,244
2013,Armenia,ARM,Netherlands,NLD,0,16,281,15,312
2013,Azerbaijan,AZE,Netherlands,NLD,14,10,65,11,100
2013,Burundi,BDI,Netherlands,NLD,0,10,10,0,20
2013,Benin,BEN,Netherlands,NLD,0,0,5,0,5
2013,Bangladesh,BGD,Netherlands,NLD,0,10,28,0,38
2013,Burkina Faso,BFA,Netherlands,NLD,0,5,10,0,15
2013,Belarus,BLR,Netherlands,NLD,0,0,45,5,50
2013,Bosnia and Herzegovina,BIH,Netherlands,NLD,0,0,71,0,71
2013,Chad,TCD,Netherlands,NLD,0,0,5,0,5
2013,China,CHN,Netherlands,NLD,17,66,63,10,156
2013,Cameroon,CMR,Netherlands,NLD,0,0,19,0,19
2013,Congo,COG,Netherlands,NLD,0,86,64,5,155
2013,Dem. Rep. of the Congo,COD,Netherlands,NLD,10,34,12,0,56
2013,Colombia,COL,Netherlands,NLD,0,0,5,5,10
2013,Cuba,CUB,Netherlands,NLD,0,0,5,0,5
2013,Ecuador,ECU,Netherlands,NLD,0,0,5,0,5
2013,Eritrea,ERI,Netherlands,NLD,29,685,164,5,883
2013,Ethiopia,ETH,Netherlands,NLD,13,40,52,0,105
2013,Gambia,GMB,Netherlands,NLD,0,5,27,0,32
2013,Palestinian,PSE,Netherlands,NLD,10,49,18,0,77
2013,Georgia,GEO,Netherlands,NLD,0,10,140,23,173
2013,Ghana,GHA,Netherlands,NLD,0,0,27,5,32
2013,Guinea-Bissau,GNB,Netherlands,NLD,0,0,10,0,10
2013,Guinea,GIN,Netherlands,NLD,5,61,120,10,196
2013,Cote d'Ivoire,CIV,Netherlands,NLD,0,47,44,5,96
2013,India,IND,Netherlands,NLD,0,0,19,0,19
2013,Iran (Islamic Rep. of),IRN,Netherlands,NLD,444,290,489,26,1249
2013,Iraq,IRQ,Netherlands,NLD,114,774,447,42,1377
2013,Israel,ISR,Netherlands,NLD,0,0,5,0,5
2013,Jamaica,JAM,Netherlands,NLD,10,5,10,0,25
2013,Kazakhstan,KAZ,Netherlands,NLD,0,5,19,5,29
2013,Kenya,KEN,Netherlands,NLD,0,5,5,0,10
2013,Kyrgyzstan,KGZ,Netherlands,NLD,0,0,11,0,11
2013,Dem. People's Rep. of Korea,PRK,Netherlands,NLD,0,5,128,0,133
2013,Kuwait,KWT,Netherlands,NLD,0,0,5,0,5
2013,Liberia,LBR,Netherlands,NLD,0,5,5,0,10
2013,Libya,LBY,Netherlands,NLD,5,20,139,10,174
2013,Lebanon,LBN,Netherlands,NLD,0,0,22,5,27
2013,Sri Lanka,LKA,Netherlands,NLD,11,94,86,5,196
2013,Mauritania,MRT,Netherlands,NLD,0,0,5,0,5
2013,North Macedonia,MKD,Netherlands,NLD,0,0,106,5,111
2013,Mali,MLI,Netherlands,NLD,0,0,54,0,54
2013,Mongolia,MNG,Netherlands,NLD,0,0,95,14,109
2013,Morocco,MAR,Netherlands,NLD,0,0,45,16,61
2013,Myanmar,MMR,Netherlands,NLD,0,55,10,0,65
2013,Nepal,NPL,Netherlands,NLD,14,29,45,5,93
2013,Niger,NER,Netherlands,NLD,0,0,10,0,10
2013,Nigeria,NGA,Netherlands,NLD,0,17,117,12,146
2013,Pakistan,PAK,Netherlands,NLD,16,46,97,5,164
2013,Russian Federation,RUS,Netherlands,NLD,5,28,271,18,322
2013,Rwanda,RWA,Netherlands,NLD,0,5,5,0,10
2013,El Salvador,SLV,Netherlands,NLD,0,0,5,0,5
2013,Serbia and Kosovo: S/RES/1244 (1999),SRB,Netherlands,NLD,0,5,325,11,341
2013,Senegal,SEN,Netherlands,NLD,0,5,27,0,32
2013,Sierra Leone,SLE,Netherlands,NLD,5,43,56,5,109
2013,Somalia,SOM,Netherlands,NLD,46,2683,291,18,3038
2013,Viet Nam,VNM,Netherlands,NLD,0,0,5,0,5
2013,Sudan,SDN,Netherlands,NLD,12,72,91,0,175
2013,Suriname,SUR,Netherlands,NLD,0,0,10,0,10
2013,Syrian Arab Rep.,SYR,Netherlands,NLD,62,2010,299,0,2371
2013,United Rep. of Tanzania,TZA,Netherlands,NLD,0,0,10,0,10
2013,Tajikistan,TJK,Netherlands,NLD,0,5,0,0,5
2013,Togo,TGO,Netherlands,NLD,0,5,15,0,20
2013,Trinidad and Tobago,TTO,Netherlands,NLD,0,0,5,0,5
2013,Tunisia,TUN,Netherlands,NLD,0,0,15,0,15
2013,Turkey,TUR,Netherlands,NLD,0,32,52,10,94
2013,Uganda,UGA,Netherlands,NLD,40,67,73,0,180
2013,Ukraine,UKR,Netherlands,NLD,0,5,37,5,47
2013,Uzbekistan,UZB,Netherlands,NLD,0,0,5,0,5
2013,Venezuela (Bolivarian Republic of),VEN,Netherlands,NLD,0,0,5,0,5
2013,Yemen,YEM,Netherlands,NLD,5,5,25,5,40
2013,Zimbabwe,ZWE,Netherlands,NLD,0,10,5,0,15
2013,Stateless,XXA,Netherlands,NLD,95,79,38,0,212
2013,Unknown ,,Netherlands,NLD,34,192,221,24,471
2013,Central African Rep.,CAF,Niger,NER,10,0,0,0,10
2013,Cameroon,CMR,Niger,NER,0,0,0,5,5
2013,Cote d'Ivoire,CIV,Niger,NER,0,0,0,5,5
2013,Rwanda,RWA,Niger,NER,0,0,5,0,5
2013,Syrian Arab Rep.,SYR,Niger,NER,5,0,0,0,5
2013,Ghana,GHA,Nicaragua,NIC,5,0,0,0,5
2013,Honduras,HND,Nicaragua,NIC,21,0,0,0,21
2013,Iran (Islamic Rep. of),IRN,Nicaragua,NIC,0,0,0,5,5
2013,Nepal,NPL,Nicaragua,NIC,0,0,0,5,5
2013,Nigeria,NGA,Nicaragua,NIC,5,0,0,0,5
2013,Pakistan,PAK,Nicaragua,NIC,0,0,0,12,12
2013,El Salvador,SLV,Nicaragua,NIC,38,0,0,0,38
2013,Somalia,SOM,Nicaragua,NIC,5,0,0,0,5
2013,Afghanistan,AFG,Nigeria,NGA,5,0,0,0,5
2013,Burundi,BDI,Nigeria,NGA,0,0,0,5,5
2013,Central African Rep.,CAF,Nigeria,NGA,10,0,0,0,10
2013,Chad,TCD,Nigeria,NGA,10,0,14,227,251
2013,Dem. Rep. of the Congo,COD,Nigeria,NGA,85,0,107,209,401
2013,Eritrea,ERI,Nigeria,NGA,0,0,0,5,5
2013,Guinea,GIN,Nigeria,NGA,0,0,0,14,14
2013,Cote d'Ivoire,CIV,Nigeria,NGA,13,0,17,16,46
2013,Liberia,LBR,Nigeria,NGA,0,0,0,5,5
2013,Mali,MLI,Nigeria,NGA,89,0,5,0,94
2013,Sudan,SDN,Nigeria,NGA,0,0,5,5,10
2013,Syrian Arab Rep.,SYR,Nigeria,NGA,10,0,0,0,10
2013,Togo,TGO,Nigeria,NGA,0,0,5,5,10
2013,Afghanistan,AFG,Norway,NOR,183,162,229,168,742
2013,Albania,ALB,Norway,NOR,0,0,167,14,181
2013,Algeria,DZA,Norway,NOR,0,5,26,80,111
2013,Angola,AGO,Norway,NOR,0,0,12,0,12
2013,Egypt,EGY,Norway,NOR,0,5,14,16,35
2013,Armenia,ARM,Norway,NOR,0,0,20,10,30
2013,Azerbaijan,AZE,Norway,NOR,0,0,23,31,54
2013,Bangladesh,BGD,Norway,NOR,0,0,109,32,141
2013,Burkina Faso,BFA,Norway,NOR,0,0,0,5,5
2013,Belarus,BLR,Norway,NOR,0,0,26,26,52
2013,Bosnia and Herzegovina,BIH,Norway,NOR,0,0,36,14,50
2013,Bulgaria,BGR,Norway,NOR,0,0,5,0,5
2013,Chad,TCD,Norway,NOR,0,0,0,13,13
2013,China,CHN,Norway,NOR,70,0,5,5,80
2013,Cameroon,CMR,Norway,NOR,5,0,0,5,10
2013,Dem. Rep. of the Congo,COD,Norway,NOR,10,12,10,10,42
2013,Colombia,COL,Norway,NOR,0,0,5,0,5
2013,Djibouti,DJI,Norway,NOR,0,0,0,15,15
2013,Eritrea,ERI,Norway,NOR,2141,13,153,434,2741
2013,Ethiopia,ETH,Norway,NOR,174,26,109,70,379
2013,Gambia,GMB,Norway,NOR,0,5,23,19,47
2013,Georgia,GEO,Norway,NOR,0,0,36,45,81
2013,Germany,DEU,Norway,NOR,0,0,5,0,5
2013,Ghana,GHA,Norway,NOR,0,0,17,24,41
2013,Guinea-Bissau,GNB,Norway,NOR,0,0,10,10,20
2013,Guatemala,GTM,Norway,NOR,0,0,5,0,5
2013,Guinea,GIN,Norway,NOR,10,10,28,26,74
2013,Croatia,HRV,Norway,NOR,0,0,0,5,5
2013,Cote d'Ivoire,CIV,Norway,NOR,5,5,10,17,37
2013,India,IND,Norway,NOR,0,0,15,0,15
2013,Iran (Islamic Rep. of),IRN,Norway,NOR,96,5,126,120,347
2013,Iraq,IRQ,Norway,NOR,28,17,60,108,213
2013,Jordan,JOR,Norway,NOR,0,0,10,26,36
2013,Kazakhstan,KAZ,Norway,NOR,0,0,5,10,15
2013,Kenya,KEN,Norway,NOR,0,0,0,5,5
2013,Kyrgyzstan,KGZ,Norway,NOR,0,0,25,10,35
2013,Liberia,LBR,Norway,NOR,0,0,10,14,24
2013,Libya,LBY,Norway,NOR,0,0,14,68,82
2013,Lebanon,LBN,Norway,NOR,0,5,5,16,26
2013,Sri Lanka,LKA,Norway,NOR,5,5,20,5,35
2013,Lithuania,LTU,Norway,NOR,0,0,5,0,5
2013,Latvia,LVA,Norway,NOR,0,0,5,0,5
2013,Mauritania,MRT,Norway,NOR,0,0,0,10,10
2013,North Macedonia,MKD,Norway,NOR,0,0,28,5,33
2013,Rep. of Moldova,MDA,Norway,NOR,0,5,0,0,5
2013,Mali,MLI,Norway,NOR,5,0,19,39,63
2013,Mongolia,MNG,Norway,NOR,0,0,5,5,10
2013,Morocco,MAR,Norway,NOR,0,0,36,100,136
2013,Montenegro,MNE,Norway,NOR,0,0,5,5,10
2013,Myanmar,MMR,Norway,NOR,5,0,5,0,10
2013,Nepal,NPL,Norway,NOR,0,0,14,0,14
2013,Niger,NER,Norway,NOR,0,0,5,5,10
2013,Nigeria,NGA,Norway,NOR,32,17,139,426,614
2013,Pakistan,PAK,Norway,NOR,12,5,90,41,148
2013,Poland,POL,Norway,NOR,0,0,5,0,5
2013,Romania,ROU,Norway,NOR,0,0,12,5,17
2013,South Africa,ZAF,Norway,NOR,0,0,5,0,5
2013,Russian Federation,RUS,Norway,NOR,27,18,200,181,426
2013,Rwanda,RWA,Norway,NOR,0,0,0,5,5
2013,Serbia and Kosovo: S/RES/1244 (1999),SRB,Norway,NOR,0,12,234,96,342
2013,Senegal,SEN,Norway,NOR,0,0,10,11,21
2013,Sierra Leone,SLE,Norway,NOR,5,0,5,5,15
2013,Somalia,SOM,Norway,NOR,962,313,496,411,2182
2013,Spain,ESP,Norway,NOR,0,0,0,5,5
2013,Viet Nam,VNM,Norway,NOR,0,0,23,10,33
2013,Sudan,SDN,Norway,NOR,326,5,119,238,688
2013,South Sudan,SSD,Norway,NOR,0,0,10,5,15
2013,Syrian Arab Rep.,SYR,Norway,NOR,278,413,12,163,866
2013,Tajikistan,TJK,Norway,NOR,0,0,14,0,14
2013,Turkmenistan,TKM,Norway,NOR,0,0,0,5,5
2013,Tunisia,TUN,Norway,NOR,0,0,14,62,76
2013,Turkey,TUR,Norway,NOR,0,0,18,33,51
2013,Uganda,UGA,Norway,NOR,22,0,15,10,47
2013,Ukraine,UKR,Norway,NOR,0,5,14,10,29
2013,United States of America,USA,Norway,NOR,0,0,5,0,5
2013,Uzbekistan,UZB,Norway,NOR,5,0,85,18,108
2013,Yemen,YEM,Norway,NOR,0,0,19,27,46
2013,Zimbabwe,ZWE,Norway,NOR,0,0,0,5,5
2013,Stateless,XXA,Norway,NOR,102,218,72,131,523
2013,Iran (Islamic Rep. of),IRN,Nauru,NRU,0,0,0,5,5
2013,Iraq,IRQ,Nauru,NRU,0,0,0,5,5
2013,Sri Lanka,LKA,Nauru,NRU,0,0,0,21,21
2013,Afghanistan,AFG,New Zealand,NZL,5,0,5,0,10
2013,Bahrain,BHR,New Zealand,NZL,0,0,5,0,5
2013,Bangladesh,BGD,New Zealand,NZL,0,0,10,0,10
2013,China,CHN,New Zealand,NZL,10,0,11,0,21
2013,Czechia,CZE,New Zealand,NZL,0,0,12,0,12
2013,Fiji,FJI,New Zealand,NZL,0,0,34,0,34
2013,Hungary,HUN,New Zealand,NZL,0,0,5,0,5
2013,Indonesia,IDN,New Zealand,NZL,0,0,5,0,5
2013,Iran (Islamic Rep. of),IRN,New Zealand,NZL,11,0,20,0,31
2013,Iraq,IRQ,New Zealand,NZL,5,0,5,0,10
2013,Jordan,JOR,New Zealand,NZL,0,0,5,0,5
2013,Dem. People's Rep. of Korea,PRK,New Zealand,NZL,0,0,5,0,5
2013,Sri Lanka,LKA,New Zealand,NZL,5,0,32,0,37
2013,Malaysia,MYS,New Zealand,NZL,0,0,5,0,5
2013,Myanmar,MMR,New Zealand,NZL,0,0,5,0,5
2013,Pakistan,PAK,New Zealand,NZL,5,0,13,0,18
2013,South Africa,ZAF,New Zealand,NZL,0,0,10,0,10
2013,Saudi Arabia,SAU,New Zealand,NZL,16,0,0,0,16
2013,Somalia,SOM,New Zealand,NZL,5,0,0,0,5
2013,Syrian Arab Rep.,SYR,New Zealand,NZL,5,0,0,0,5
2013,Tunisia,TUN,New Zealand,NZL,0,0,5,0,5
2013,Turkey,TUR,New Zealand,NZL,5,0,0,0,5
2013,Tuvalu,TUV,New Zealand,NZL,0,0,5,0,5
2013,United States of America,USA,New Zealand,NZL,0,0,5,0,5
2013,Zimbabwe,ZWE,New Zealand,NZL,0,0,5,0,5
2013,Cameroon,CMR,Panama,PAN,0,0,0,5,5
2013,Colombia,COL,Panama,PAN,227,0,38,219,484
2013,Cuba,CUB,Panama,PAN,0,0,0,15,15
2013,Ghana,GHA,Panama,PAN,0,0,0,18,18
2013,Haiti,HTI,Panama,PAN,0,0,0,5,5
2013,Nicaragua,NIC,Panama,PAN,0,0,0,5,5
2013,Nigeria,NGA,Panama,PAN,0,0,0,5,5
2013,El Salvador,SLV,Panama,PAN,0,0,0,5,5
2013,Venezuela (Bolivarian Republic of),VEN,Panama,PAN,0,0,5,5,10
2013,Colombia,COL,Peru,PER,36,0,31,83,150
2013,Cuba,CUB,Peru,PER,13,0,47,10,70
2013,Dominican Rep.,DOM,Peru,PER,0,0,10,0,10
2013,Haiti,HTI,Peru,PER,5,0,0,126,131
2013,India,IND,Peru,PER,0,0,5,0,5
2013,Nepal,NPL,Peru,PER,0,0,0,5,5
2013,Nigeria,NGA,Peru,PER,5,0,0,0,5
2013,Senegal,SEN,Peru,PER,0,0,0,5,5
2013,Syrian Arab Rep.,SYR,Peru,PER,5,0,0,0,5
2013,Cote d'Ivoire,CIV,Philippines,PHL,5,0,0,0,5
2013,Somalia,SOM,Philippines,PHL,5,0,0,0,5
2013,Syrian Arab Rep.,SYR,Philippines,PHL,5,0,0,5,10
2013,Iraq,IRQ,Papua New Guinea,PNG,0,0,0,5,5
2013,Afghanistan,AFG,Poland,POL,20,0,26,55,101
2013,Egypt,EGY,Poland,POL,15,0,5,25,45
2013,Armenia,ARM,Poland,POL,0,22,86,181,289
2013,Azerbaijan,AZE,Poland,POL,0,0,0,5,5
2013,Bangladesh,BGD,Poland,POL,0,0,5,13,18
2013,Belarus,BLR,Poland,POL,19,5,17,15,56
2013,China,CHN,Poland,POL,0,0,0,5,5
2013,Cameroon,CMR,Poland,POL,0,0,0,5,5
2013,Dem. Rep. of the Congo,COD,Poland,POL,0,0,5,0,5
2013,Eritrea,ERI,Poland,POL,0,0,0,5,5
2013,Palestinian,PSE,Poland,POL,0,0,0,5,5
2013,Georgia,GEO,Poland,POL,0,62,375,1463,1900
2013,Guinea,GIN,Poland,POL,0,0,0,5,5
2013,India,IND,Poland,POL,0,0,5,5,10
2013,Iran (Islamic Rep. of),IRN,Poland,POL,0,0,0,5,5
2013,Iraq,IRQ,Poland,POL,0,0,5,10,15
2013,Kazakhstan,KAZ,Poland,POL,0,10,28,86,124
2013,Kyrgyzstan,KGZ,Poland,POL,11,5,10,36,62
2013,Lebanon,LBN,Poland,POL,0,0,0,12,12
2013,Sri Lanka,LKA,Poland,POL,0,0,0,5,5
2013,Rep. of Moldova,MDA,Poland,POL,0,0,5,0,5
2013,Mongolia,MNG,Poland,POL,0,0,5,5,10
2013,Morocco,MAR,Poland,POL,0,0,0,5,5
2013,Nepal,NPL,Poland,POL,0,0,0,5,5
2013,Nigeria,NGA,Poland,POL,0,0,5,10,15
2013,Pakistan,PAK,Poland,POL,5,0,10,22,37
2013,Russian Federation,RUS,Poland,POL,23,358,1457,13814,15652
2013,Somalia,SOM,Poland,POL,0,5,0,0,5
2013,Viet Nam,VNM,Poland,POL,0,0,29,20,49
2013,Syrian Arab Rep.,SYR,Poland,POL,69,20,0,149,238
2013,Tajikistan,TJK,Poland,POL,0,0,0,5,5
2013,Turkmenistan,TKM,Poland,POL,0,0,0,5,5
2013,Tunisia,TUN,Poland,POL,0,0,0,5,5
2013,Turkey,TUR,Poland,POL,0,0,5,10,15
2013,Ukraine,UKR,Poland,POL,0,12,38,26,76
2013,Uzbekistan,UZB,Poland,POL,0,5,5,15,25
2013,Stateless,XXA,Poland,POL,25,0,0,24,49
2013,Afghanistan,AFG,Portugal,PRT,0,5,0,0,5
2013,Bangladesh,BGD,Portugal,PRT,0,0,0,5,5
2013,Belarus,BLR,Portugal,PRT,0,5,0,0,5
2013,Dem. Rep. of the Congo,COD,Portugal,PRT,0,11,0,5,16
2013,Colombia,COL,Portugal,PRT,0,5,0,0,5
2013,Gambia,GMB,Portugal,PRT,0,0,0,5,5
2013,Guinea-Bissau,GNB,Portugal,PRT,0,0,0,10,10
2013,Guinea,GIN,Portugal,PRT,0,22,0,60,82
2013,Cote d'Ivoire,CIV,Portugal,PRT,0,5,0,10,15
2013,Iraq,IRQ,Portugal,PRT,0,0,0,5,5
2013,Libya,LBY,Portugal,PRT,0,5,0,0,5
2013,Sri Lanka,LKA,Portugal,PRT,0,10,0,0,10
2013,Mali,MLI,Portugal,PRT,0,0,0,19,19
2013,Morocco,MAR,Portugal,PRT,0,0,0,11,11
2013,Nigeria,NGA,Portugal,PRT,0,5,0,39,44
2013,Pakistan,PAK,Portugal,PRT,0,0,0,5,5
2013,Senegal,SEN,Portugal,PRT,0,0,0,33,33
2013,Sierra Leone,SLE,Portugal,PRT,0,0,0,5,5
2013,Somalia,SOM,Portugal,PRT,0,5,0,5,10
2013,Syrian Arab Rep.,SYR,Portugal,PRT,0,14,0,133,147
2013,Togo,TGO,Portugal,PRT,0,0,0,5,5
2013,Afghanistan,AFG,Romania,ROU,5,5,40,5,55
2013,Albania,ALB,Romania,ROU,0,0,5,5,10
2013,Algeria,DZA,Romania,ROU,0,0,5,5,10
2013,Egypt,EGY,Romania,ROU,10,0,27,5,42
2013,Armenia,ARM,Romania,ROU,0,0,5,0,5
2013,Bangladesh,BGD,Romania,ROU,0,0,23,0,23
2013,China,CHN,Romania,ROU,0,0,23,5,28
2013,Cameroon,CMR,Romania,ROU,0,0,5,0,5
2013,Dem. Rep. of the Congo,COD,Romania,ROU,0,0,5,0,5
2013,Gambia,GMB,Romania,ROU,0,0,5,0,5
2013,Palestinian,PSE,Romania,ROU,13,0,14,0,27
2013,Georgia,GEO,Romania,ROU,0,0,19,5,24
2013,Guinea-Bissau,GNB,Romania,ROU,0,0,5,0,5
2013,Guinea,GIN,Romania,ROU,5,0,0,0,5
2013,Cote d'Ivoire,CIV,Romania,ROU,0,0,5,0,5
2013,Iran (Islamic Rep. of),IRN,Romania,ROU,11,5,19,0,35
2013,Iraq,IRQ,Romania,ROU,19,5,16,0,40
2013,Jordan,JOR,Romania,ROU,0,0,5,0,5
2013,Kazakhstan,KAZ,Romania,ROU,0,0,5,0,5
2013,Lebanon,LBN,Romania,ROU,0,0,5,0,5
2013,Rep. of Moldova,MDA,Romania,ROU,0,0,12,0,12
2013,Morocco,MAR,Romania,ROU,0,0,10,0,10
2013,Myanmar,MMR,Romania,ROU,5,0,0,0,5
2013,Nepal,NPL,Romania,ROU,0,0,5,0,5
2013,Nigeria,NGA,Romania,ROU,0,0,5,5,10
2013,Pakistan,PAK,Romania,ROU,5,5,91,5,106
2013,Philippines,PHL,Romania,ROU,0,0,11,0,11
2013,Russian Federation,RUS,Romania,ROU,0,0,5,10,15
2013,Rwanda,RWA,Romania,ROU,5,0,0,0,5
2013,Serbia and Kosovo: S/RES/1244 (1999),SRB,Romania,ROU,0,0,5,0,5
2013,Senegal,SEN,Romania,ROU,0,0,5,0,5
2013,Somalia,SOM,Romania,ROU,0,0,5,0,5
2013,Sudan,SDN,Romania,ROU,5,5,0,0,10
2013,Syrian Arab Rep.,SYR,Romania,ROU,311,507,127,33,978
2013,Tunisia,TUN,Romania,ROU,0,0,15,5,20
2013,Turkey,TUR,Romania,ROU,0,0,19,5,24
2013,Ukraine,UKR,Romania,ROU,0,0,10,0,10
2013,Stateless,XXA,Romania,ROU,10,5,5,0,20
2013,Algeria,DZA,South Africa,ZAF,0,0,129,0,129
2013,Angola,AGO,South Africa,ZAF,0,0,43,0,43
2013,Egypt,EGY,South Africa,ZAF,0,0,365,0,365
2013,Burundi,BDI,South Africa,ZAF,10,0,676,0,686
2013,Benin,BEN,South Africa,ZAF,0,0,45,0,45
2013,Bangladesh,BGD,South Africa,ZAF,5,0,3773,0,3778
2013,Burkina Faso,BFA,South Africa,ZAF,0,0,22,0,22
2013,Botswana,BWA,South Africa,ZAF,0,0,11,0,11
2013,Central African Rep.,CAF,South Africa,ZAF,0,0,5,0,5
2013,China,CHN,South Africa,ZAF,0,0,1409,0,1409
2013,Cameroon,CMR,South Africa,ZAF,5,0,650,0,655
2013,Congo,COG,South Africa,ZAF,317,0,833,0,1150
2013,Dem. Rep. of the Congo,COD,South Africa,ZAF,1104,0,5703,0,6807
2013,Comoros,COM,South Africa,ZAF,0,0,10,0,10
2013,Eritrea,ERI,South Africa,ZAF,168,0,68,0,236
2013,Ethiopia,ETH,South Africa,ZAF,2055,0,5270,0,7325
2013,Gabon,GAB,South Africa,ZAF,0,0,5,0,5
2013,Gambia,GMB,South Africa,ZAF,0,0,10,0,10
2013,Palestinian,PSE,South Africa,ZAF,5,0,5,0,10
2013,Ghana,GHA,South Africa,ZAF,0,0,2341,0,2341
2013,Guinea-Bissau,GNB,South Africa,ZAF,0,0,5,0,5
2013,Guinea,GIN,South Africa,ZAF,0,0,14,0,14
2013,Cote d'Ivoire,CIV,South Africa,ZAF,0,0,40,0,40
2013,India,IND,South Africa,ZAF,0,0,2272,0,2272
2013,Iran (Islamic Rep. of),IRN,South Africa,ZAF,0,0,10,0,10
2013,Jordan,JOR,South Africa,ZAF,0,0,5,0,5
2013,Kenya,KEN,South Africa,ZAF,0,0,299,0,299
2013,Liberia,LBR,South Africa,ZAF,0,0,5,0,5
2013,Lesotho,LSO,South Africa,ZAF,0,0,3027,0,3027
2013,Sri Lanka,LKA,South Africa,ZAF,0,0,13,0,13
2013,Mali,MLI,South Africa,ZAF,5,0,43,0,48
2013,Malawi,MWI,South Africa,ZAF,0,0,2842,0,2842
2013,Morocco,MAR,South Africa,ZAF,0,0,12,0,12
2013,Mozambique,MOZ,South Africa,ZAF,0,0,3188,0,3188
2013,Nepal,NPL,South Africa,ZAF,0,0,12,0,12
2013,Niger,NER,South Africa,ZAF,0,0,60,0,60
2013,Nigeria,NGA,South Africa,ZAF,0,0,6816,0,6816
2013,Pakistan,PAK,South Africa,ZAF,0,0,3167,0,3167
2013,Rwanda,RWA,South Africa,ZAF,5,0,137,0,142
2013,Senegal,SEN,South Africa,ZAF,0,0,353,0,353
2013,Sierra Leone,SLE,South Africa,ZAF,0,0,11,0,11
2013,Somalia,SOM,South Africa,ZAF,3579,0,520,0,4099
2013,Sudan,SDN,South Africa,ZAF,0,0,17,0,17
2013,Eswatini,SWZ,South Africa,ZAF,0,0,47,0,47
2013,Syrian Arab Rep.,SYR,South Africa,ZAF,5,0,5,0,10
2013,United Rep. of Tanzania,TZA,South Africa,ZAF,0,0,399,0,399
2013,Thailand,THA,South Africa,ZAF,0,0,10,0,10
2013,Togo,TGO,South Africa,ZAF,0,0,12,0,12
2013,Uganda,UGA,South Africa,ZAF,5,0,1363,0,1368
2013,Yemen,YEM,South Africa,ZAF,0,0,5,0,5
2013,Zambia,ZMB,South Africa,ZAF,0,0,176,0,176
2013,Zimbabwe,ZWE,South Africa,ZAF,12,0,14676,0,14688
2013,Afghanistan,AFG,Russian Federation,RUS,20,0,351,111,482
2013,Egypt,EGY,Russian Federation,RUS,5,0,68,0,73
2013,Armenia,ARM,Russian Federation,RUS,0,0,5,0,5
2013,Azerbaijan,AZE,Russian Federation,RUS,0,0,5,0,5
2013,Belarus,BLR,Russian Federation,RUS,0,0,5,5,10
2013,China,CHN,Russian Federation,RUS,0,0,0,5,5
2013,Congo,COG,Russian Federation,RUS,0,0,5,0,5
2013,Dem. Rep. of the Congo,COD,Russian Federation,RUS,0,0,5,19,24
2013,Eritrea,ERI,Russian Federation,RUS,0,0,0,5,5
2013,Georgia,GEO,Russian Federation,RUS,0,0,176,95,271
2013,Guinea,GIN,Russian Federation,RUS,0,0,5,0,5
2013,Iran (Islamic Rep. of),IRN,Russian Federation,RUS,0,0,5,0,5
2013,Iraq,IRQ,Russian Federation,RUS,0,0,5,5,10
2013,Kazakhstan,KAZ,Russian Federation,RUS,0,0,5,5,10
2013,Kyrgyzstan,KGZ,Russian Federation,RUS,0,0,19,16,35
2013,Dem. People's Rep. of Korea,PRK,Russian Federation,RUS,0,0,30,12,42
2013,Rep. of Moldova,MDA,Russian Federation,RUS,0,0,5,0,5
2013,Pakistan,PAK,Russian Federation,RUS,0,0,10,0,10
2013,Sudan,SDN,Russian Federation,RUS,0,0,18,0,18
2013,Syrian Arab Rep.,SYR,Russian Federation,RUS,0,0,710,74,784
2013,Tajikistan,TJK,Russian Federation,RUS,0,0,5,10,15
2013,Turkmenistan,TKM,Russian Federation,RUS,0,0,5,5,10
2013,Ukraine,UKR,Russian Federation,RUS,0,0,10,5,15
2013,Uzbekistan,UZB,Russian Federation,RUS,11,0,52,14,77
2013,Unknown ,,Russian Federation,RUS,0,0,65,0,65
2013,Afghanistan,AFG,Serbia and Kosovo: S/RES/1244 (1999),SRB,0,0,0,551,551
2013,Algeria,DZA,Serbia and Kosovo: S/RES/1244 (1999),SRB,0,0,10,249,259
2013,Egypt,EGY,Serbia and Kosovo: S/RES/1244 (1999),SRB,0,0,0,21,21
2013,Bangladesh,BGD,Serbia and Kosovo: S/RES/1244 (1999),SRB,0,0,0,67,67
2013,Burkina Faso,BFA,Serbia and Kosovo: S/RES/1244 (1999),SRB,0,0,0,16,16
2013,Chad,TCD,Serbia and Kosovo: S/RES/1244 (1999),SRB,0,0,0,5,5
2013,Cameroon,CMR,Serbia and Kosovo: S/RES/1244 (1999),SRB,0,0,0,36,36
2013,Congo,COG,Serbia and Kosovo: S/RES/1244 (1999),SRB,0,0,0,29,29
2013,Comoros,COM,Serbia and Kosovo: S/RES/1244 (1999),SRB,0,0,0,57,57
2013,Cuba,CUB,Serbia and Kosovo: S/RES/1244 (1999),SRB,0,0,0,11,11
2013,Eritrea,ERI,Serbia and Kosovo: S/RES/1244 (1999),SRB,0,0,0,613,613
2013,Ethiopia,ETH,Serbia and Kosovo: S/RES/1244 (1999),SRB,0,0,0,5,5
2013,Gabon,GAB,Serbia and Kosovo: S/RES/1244 (1999),SRB,0,0,0,5,5
2013,Gambia,GMB,Serbia and Kosovo: S/RES/1244 (1999),SRB,0,0,0,28,28
2013,Palestinian,PSE,Serbia and Kosovo: S/RES/1244 (1999),SRB,0,0,0,81,81
2013,Ghana,GHA,Serbia and Kosovo: S/RES/1244 (1999),SRB,0,0,0,72,72
2013,Guinea,GIN,Serbia and Kosovo: S/RES/1244 (1999),SRB,0,0,0,38,38
2013,Cote d'Ivoire,CIV,Serbia and Kosovo: S/RES/1244 (1999),SRB,0,0,0,114,114
2013,India,IND,Serbia and Kosovo: S/RES/1244 (1999),SRB,0,0,0,10,10
2013,Iran (Islamic Rep. of),IRN,Serbia and Kosovo: S/RES/1244 (1999),SRB,0,0,0,39,39
2013,Iraq,IRQ,Serbia and Kosovo: S/RES/1244 (1999),SRB,0,5,0,55,60
2013,Libya,LBY,Serbia and Kosovo: S/RES/1244 (1999),SRB,0,0,0,19,19
2013,Madagascar,MDG,Serbia and Kosovo: S/RES/1244 (1999),SRB,0,0,0,15,15
2013,Mauritania,MRT,Serbia and Kosovo: S/RES/1244 (1999),SRB,0,0,0,32,32
2013,Mali,MLI,Serbia and Kosovo: S/RES/1244 (1999),SRB,0,0,0,224,224
2013,Morocco,MAR,Serbia and Kosovo: S/RES/1244 (1999),SRB,0,0,5,94,99
2013,Nigeria,NGA,Serbia and Kosovo: S/RES/1244 (1999),SRB,0,0,0,119,119
2013,Pakistan,PAK,Serbia and Kosovo: S/RES/1244 (1999),SRB,0,0,0,203,203
2013,Rwanda,RWA,Serbia and Kosovo: S/RES/1244 (1999),SRB,0,0,0,10,10
2013,Senegal,SEN,Serbia and Kosovo: S/RES/1244 (1999),SRB,0,0,0,49,49
2013,Sierra Leone,SLE,Serbia and Kosovo: S/RES/1244 (1999),SRB,0,0,0,41,41
2013,Somalia,SOM,Serbia and Kosovo: S/RES/1244 (1999),SRB,0,0,5,517,522
2013,Sudan,SDN,Serbia and Kosovo: S/RES/1244 (1999),SRB,0,0,0,149,149
2013,Syrian Arab Rep.,SYR,Serbia and Kosovo: S/RES/1244 (1999),SRB,0,5,0,1345,1350
2013,United Rep. of Tanzania,TZA,Serbia and Kosovo: S/RES/1244 (1999),SRB,0,0,0,5,5
2013,Togo,TGO,Serbia and Kosovo: S/RES/1244 (1999),SRB,0,0,0,10,10
2013,Tunisia,TUN,Serbia and Kosovo: S/RES/1244 (1999),SRB,0,0,0,81,81
2013,Western Sahara,ESH,Serbia and Kosovo: S/RES/1244 (1999),SRB,0,0,0,5,5
2013,Yemen,YEM,Serbia and Kosovo: S/RES/1244 (1999),SRB,0,0,0,5,5
2013,Central African Rep.,CAF,Senegal,SEN,0,0,5,0,5
2013,Congo,COG,Senegal,SEN,0,0,5,0,5
2013,Dem. Rep. of the Congo,COD,Senegal,SEN,0,0,5,0,5
2013,Eritrea,ERI,Senegal,SEN,0,0,5,0,5
2013,Gambia,GMB,Senegal,SEN,5,0,5,0,10
2013,Guinea,GIN,Senegal,SEN,0,0,5,0,5
2013,Cote d'Ivoire,CIV,Senegal,SEN,0,0,16,0,16
2013,Liberia,LBR,Senegal,SEN,0,0,5,0,5
2013,Mauritania,MRT,Senegal,SEN,0,0,10,0,10
2013,Mali,MLI,Senegal,SEN,0,0,5,0,5
2013,Sierra Leone,SLE,Senegal,SEN,0,0,5,0,5
2013,Sudan,SDN,Senegal,SEN,0,0,5,0,5
2013,Cote d'Ivoire,CIV,Sierra Leone,SLE,0,0,0,38,38
2013,Afghanistan,AFG,Spain,ESP,5,22,0,0,27
2013,Albania,ALB,Spain,ESP,0,0,10,0,10
2013,Algeria,DZA,Spain,ESP,0,0,183,0,183
2013,Egypt,EGY,Spain,ESP,5,0,0,0,5
2013,Argentina,ARG,Spain,ESP,0,0,5,0,5
2013,Armenia,ARM,Spain,ESP,0,0,10,0,10
2013,Bangladesh,BGD,Spain,ESP,0,0,18,0,18
2013,Burkina Faso,BFA,Spain,ESP,0,0,5,0,5
2013,Belarus,BLR,Spain,ESP,0,0,5,0,5
2013,Bolivia (Plurinational State of),BOL,Spain,ESP,5,0,0,0,5
2013,Chad,TCD,Spain,ESP,0,0,10,0,10
2013,Chile,CHL,Spain,ESP,0,0,5,0,5
2013,Cameroon,CMR,Spain,ESP,0,0,81,0,81
2013,Congo,COG,Spain,ESP,0,0,5,0,5
2013,Dem. Rep. of the Congo,COD,Spain,ESP,0,0,65,0,65
2013,Colombia,COL,Spain,ESP,5,0,46,0,51
2013,Cuba,CUB,Spain,ESP,0,15,20,0,35
2013,Equatorial Guinea,GNQ,Spain,ESP,0,0,5,0,5
2013,Eritrea,ERI,Spain,ESP,5,0,12,0,17
2013,Ethiopia,ETH,Spain,ESP,0,5,10,0,15
2013,Gambia,GMB,Spain,ESP,0,0,16,0,16
2013,Palestinian,PSE,Spain,ESP,63,11,13,0,87
2013,Georgia,GEO,Spain,ESP,0,0,5,0,5
2013,Ghana,GHA,Spain,ESP,0,0,22,0,22
2013,Guinea-Bissau,GNB,Spain,ESP,0,0,10,0,10
2013,Guatemala,GTM,Spain,ESP,0,0,5,0,5
2013,Guinea,GIN,Spain,ESP,0,0,103,0,103
2013,Honduras,HND,Spain,ESP,5,0,24,0,29
2013,Cote d'Ivoire,CIV,Spain,ESP,5,12,220,0,237
2013,India,IND,Spain,ESP,0,0,5,0,5
2013,Iran (Islamic Rep. of),IRN,Spain,ESP,5,0,0,0,5
2013,Iraq,IRQ,Spain,ESP,0,5,0,0,5
2013,Jordan,JOR,Spain,ESP,0,5,0,0,5
2013,Kazakhstan,KAZ,Spain,ESP,0,0,5,0,5
2013,Liberia,LBR,Spain,ESP,0,0,5,0,5
2013,Libya,LBY,Spain,ESP,5,0,16,0,21
2013,Sri Lanka,LKA,Spain,ESP,0,14,0,0,14
2013,Mauritania,MRT,Spain,ESP,0,0,5,0,5
2013,Mexico,MEX,Spain,ESP,0,0,5,0,5
2013,Mongolia,MNG,Spain,ESP,0,0,5,0,5
2013,Morocco,MAR,Spain,ESP,0,0,17,0,17
2013,Niger,NER,Spain,ESP,0,0,5,0,5
2013,Nicaragua,NIC,Spain,ESP,0,0,5,0,5
2013,Nigeria,NGA,Spain,ESP,0,0,169,0,169
2013,Pakistan,PAK,Spain,ESP,60,5,27,0,92
2013,Paraguay,PRY,Spain,ESP,0,0,5,0,5
2013,Peru,PER,Spain,ESP,0,0,5,0,5
2013,Romania,ROU,Spain,ESP,0,0,5,0,5
2013,Russian Federation,RUS,Spain,ESP,5,0,16,0,21
2013,El Salvador,SLV,Spain,ESP,0,0,5,0,5
2013,Senegal,SEN,Spain,ESP,5,0,25,0,30
2013,Sierra Leone,SLE,Spain,ESP,0,0,13,0,13
2013,Somalia,SOM,Spain,ESP,5,85,10,0,100
2013,Sudan,SDN,Spain,ESP,0,0,5,0,5
2013,Syrian Arab Rep.,SYR,Spain,ESP,5,146,0,0,151
2013,Togo,TGO,Spain,ESP,5,0,5,0,10
2013,Turkey,TUR,Spain,ESP,0,0,5,0,5
2013,Uganda,UGA,Spain,ESP,0,0,5,0,5
2013,Ukraine,UKR,Spain,ESP,0,0,11,0,11
2013,Uzbekistan,UZB,Spain,ESP,0,0,5,0,5
2013,Venezuela (Bolivarian Republic of),VEN,Spain,ESP,0,0,26,0,26
2013,Western Sahara,ESH,Spain,ESP,0,0,5,0,5
2013,Central African Rep.,CAF,Sudan,SDN,10,0,0,0,10
2013,Chad,TCD,Sudan,SDN,5,0,0,0,5
2013,Eritrea,ERI,Sudan,SDN,6709,0,440,15,7164
2013,Ethiopia,ETH,Sudan,SDN,210,0,5,0,215
2013,Liberia,LBR,Sudan,SDN,0,0,16,0,16
2013,Nigeria,NGA,Sudan,SDN,0,0,0,5,5
2013,Sierra Leone,SLE,Sudan,SDN,0,0,5,0,5
2013,Somalia,SOM,Sudan,SDN,599,0,0,0,599
2013,Afghanistan,AFG,Slovakia,SVK,5,10,21,68,104
2013,Algeria,DZA,Slovakia,SVK,0,0,5,5,10
2013,Armenia,ARM,Slovakia,SVK,0,0,0,17,17
2013,Bangladesh,BGD,Slovakia,SVK,0,0,5,0,5
2013,China,CHN,Slovakia,SVK,0,0,5,5,10
2013,Cameroon,CMR,Slovakia,SVK,0,0,5,5,10
2013,Congo,COG,Slovakia,SVK,0,0,5,0,5
2013,Dem. Rep. of the Congo,COD,Slovakia,SVK,0,0,5,10,15
2013,Eritrea,ERI,Slovakia,SVK,0,12,12,31,55
2013,Ethiopia,ETH,Slovakia,SVK,0,0,0,5,5
2013,Palestinian,PSE,Slovakia,SVK,0,0,5,5,10
2013,Georgia,GEO,Slovakia,SVK,0,0,5,30,35
2013,India,IND,Slovakia,SVK,0,0,5,11,16
2013,Iran (Islamic Rep. of),IRN,Slovakia,SVK,0,0,0,5,5
2013,Iraq,IRQ,Slovakia,SVK,0,5,5,5,15
2013,Libya,LBY,Slovakia,SVK,0,0,0,5,5
2013,Rep. of Moldova,MDA,Slovakia,SVK,0,0,5,5,10
2013,Mongolia,MNG,Slovakia,SVK,0,0,0,5,5
2013,Nigeria,NGA,Slovakia,SVK,0,0,0,5,5
2013,Pakistan,PAK,Slovakia,SVK,0,0,5,17,22
2013,Russian Federation,RUS,Slovakia,SVK,0,0,13,13,26
2013,Somalia,SOM,Slovakia,SVK,5,5,58,54,122
2013,Viet Nam,VNM,Slovakia,SVK,0,0,0,5,5
2013,Syrian Arab Rep.,SYR,Slovakia,SVK,0,0,5,19,24
2013,Tunisia,TUN,Slovakia,SVK,0,0,0,5,5
2013,Turkey,TUR,Slovakia,SVK,0,0,5,5,10
2013,Ukraine,UKR,Slovakia,SVK,0,0,5,5,10
2013,Afghanistan,AFG,Slovenia,SVN,0,0,11,14,25
2013,Algeria,DZA,Slovenia,SVN,0,0,5,14,19
2013,Bosnia and Herzegovina,BIH,Slovenia,SVN,0,0,5,5,10
2013,Cuba,CUB,Slovenia,SVN,0,0,0,5,5
2013,Eritrea,ERI,Slovenia,SVN,5,0,0,0,5
2013,Iran (Islamic Rep. of),IRN,Slovenia,SVN,5,0,0,0,5
2013,Morocco,MAR,Slovenia,SVN,0,0,5,5,10
2013,Nigeria,NGA,Slovenia,SVN,0,0,5,5,10
2013,Pakistan,PAK,Slovenia,SVN,0,0,20,0,20
2013,Russian Federation,RUS,Slovenia,SVN,5,0,10,5,20
2013,Serbia and Kosovo: S/RES/1244 (1999),SRB,Slovenia,SVN,0,0,21,29,50
2013,Somalia,SOM,Slovenia,SVN,5,0,14,0,19
2013,Syrian Arab Rep.,SYR,Slovenia,SVN,0,5,5,48,58
2013,Tunisia,TUN,Slovenia,SVN,0,0,5,0,5
2013,Turkey,TUR,Slovenia,SVN,0,0,10,5,15
2013,Afghanistan,AFG,Sweden,SWE,858,1216,803,189,3066
2013,Albania,ALB,Sweden,SWE,5,29,808,136,978
2013,Algeria,DZA,Sweden,SWE,5,0,68,135,208
2013,Angola,AGO,Sweden,SWE,0,5,5,0,10
2013,Egypt,EGY,Sweden,SWE,32,10,85,21,148
2013,Armenia,ARM,Sweden,SWE,5,39,276,37,357
2013,Austria,AUT,Sweden,SWE,0,0,5,0,5
2013,Azerbaijan,AZE,Sweden,SWE,45,37,156,29,267
2013,Burundi,BDI,Sweden,SWE,5,16,13,0,34
2013,Bangladesh,BGD,Sweden,SWE,24,5,95,5,129
2013,Burkina Faso,BFA,Sweden,SWE,0,0,5,0,5
2013,Belarus,BLR,Sweden,SWE,5,5,175,165,350
2013,Bolivia (Plurinational State of),BOL,Sweden,SWE,0,18,49,10,77
2013,Brazil,BRA,Sweden,SWE,0,5,0,0,5
2013,Bosnia and Herzegovina,BIH,Sweden,SWE,0,21,403,97,521
2013,Bulgaria,BGR,Sweden,SWE,0,5,5,5,15
2013,Chad,TCD,Sweden,SWE,0,0,0,5,5
2013,China,CHN,Sweden,SWE,16,0,17,10,43
2013,Chile,CHL,Sweden,SWE,0,5,17,10,32
2013,Cameroon,CMR,Sweden,SWE,15,31,20,5,71
2013,Congo,COG,Sweden,SWE,0,0,5,5,10
2013,Dem. Rep. of the Congo,COD,Sweden,SWE,21,5,36,5,67
2013,Comoros,COM,Sweden,SWE,5,0,0,0,5
2013,Colombia,COL,Sweden,SWE,0,5,12,5,22
2013,Cuba,CUB,Sweden,SWE,0,0,27,12,39
2013,Djibouti,DJI,Sweden,SWE,0,5,20,0,25
2013,Ecuador,ECU,Sweden,SWE,0,0,5,0,5
2013,Eritrea,ERI,Sweden,SWE,700,1828,35,109,2672
2013,Ethiopia,ETH,Sweden,SWE,89,47,170,23,329
2013,Gambia,GMB,Sweden,SWE,21,0,55,10,86
2013,Georgia,GEO,Sweden,SWE,10,5,211,120,346
2013,Ghana,GHA,Sweden,SWE,10,5,27,13,55
2013,Guinea-Bissau,GNB,Sweden,SWE,0,0,11,0,11
2013,Greece,GRC,Sweden,SWE,0,0,5,10,15
2013,Guatemala,GTM,Sweden,SWE,0,0,5,0,5
2013,Guinea,GIN,Sweden,SWE,10,0,24,5,39
2013,Honduras,HND,Sweden,SWE,0,0,5,0,5
2013,Croatia,HRV,Sweden,SWE,0,0,16,10,26
2013,Hungary,HUN,Sweden,SWE,0,0,11,5,16
2013,Cote d'Ivoire,CIV,Sweden,SWE,11,0,12,5,28
2013,India,IND,Sweden,SWE,0,5,30,5,40
2013,Iran (Islamic Rep. of),IRN,Sweden,SWE,640,89,508,100,1337
2013,Iraq,IRQ,Sweden,SWE,198,179,596,128,1101
2013,Israel,ISR,Sweden,SWE,0,0,18,5,23
2013,Italy,ITA,Sweden,SWE,0,0,0,5,5
2013,Jordan,JOR,Sweden,SWE,5,11,70,24,110
2013,Kazakhstan,KAZ,Sweden,SWE,12,48,215,50,325
2013,Kenya,KEN,Sweden,SWE,5,5,28,5,43
2013,Kyrgyzstan,KGZ,Sweden,SWE,5,46,173,27,251
2013,Dem. People's Rep. of Korea,PRK,Sweden,SWE,0,0,5,0,5
2013,Kuwait,KWT,Sweden,SWE,5,0,14,0,19
2013,Liberia,LBR,Sweden,SWE,0,0,5,0,5
2013,Libya,LBY,Sweden,SWE,21,5,46,57,129
2013,Lebanon,LBN,Sweden,SWE,17,74,201,46,338
2013,Sri Lanka,LKA,Sweden,SWE,5,0,21,0,26
2013,Latvia,LVA,Sweden,SWE,0,0,5,0,5
2013,Mauritania,MRT,Sweden,SWE,5,0,5,5,15
2013,North Macedonia,MKD,Sweden,SWE,0,5,320,120,445
2013,Rep. of Moldova,MDA,Sweden,SWE,0,0,14,10,24
2013,Mexico,MEX,Sweden,SWE,0,0,11,0,11
2013,Mali,MLI,Sweden,SWE,5,0,18,5,28
2013,Malaysia,MYS,Sweden,SWE,0,0,5,0,5
2013,Mongolia,MNG,Sweden,SWE,0,39,322,53,414
2013,Morocco,MAR,Sweden,SWE,14,24,201,169,408
2013,Montenegro,MNE,Sweden,SWE,0,5,63,18,86
2013,Nepal,NPL,Sweden,SWE,0,5,10,5,20
2013,Netherlands,NLD,Sweden,SWE,0,0,5,0,5
2013,Nicaragua,NIC,Sweden,SWE,0,0,15,5,20
2013,Nigeria,NGA,Sweden,SWE,59,19,227,50,355
2013,Pakistan,PAK,Sweden,SWE,39,15,162,24,240
2013,Philippines,PHL,Sweden,SWE,0,0,5,5,10
2013,Poland,POL,Sweden,SWE,0,0,10,5,15
2013,Romania,ROU,Sweden,SWE,0,10,20,5,35
2013,Russian Federation,RUS,Sweden,SWE,166,127,398,149,840
2013,Rwanda,RWA,Sweden,SWE,0,0,11,0,11
2013,El Salvador,SLV,Sweden,SWE,0,5,35,5,45
2013,Saudi Arabia,SAU,Sweden,SWE,5,0,0,0,5
2013,Serbia and Kosovo: S/RES/1244 (1999),SRB,Sweden,SWE,0,103,1924,542,2569
2013,Senegal,SEN,Sweden,SWE,5,0,16,5,26
2013,Sierra Leone,SLE,Sweden,SWE,5,5,10,0,20
2013,Somalia,SOM,Sweden,SWE,844,768,980,494,3086
2013,Spain,ESP,Sweden,SWE,0,0,5,0,5
2013,Viet Nam,VNM,Sweden,SWE,0,5,26,15,46
2013,Sudan,SDN,Sweden,SWE,67,18,48,35,168
2013,Slovakia,SVK,Sweden,SWE,0,0,5,0,5
2013,Syrian Arab Rep.,SYR,Sweden,SWE,1921,9608,32,671,12232
2013,United Rep. of Tanzania,TZA,Sweden,SWE,0,0,13,5,18
2013,Thailand,THA,Sweden,SWE,0,0,5,10,15
2013,Tajikistan,TJK,Sweden,SWE,5,0,33,10,48
2013,Turkmenistan,TKM,Sweden,SWE,0,0,5,0,5
2013,Togo,TGO,Sweden,SWE,0,0,5,0,5
2013,Tunisia,TUN,Sweden,SWE,5,0,43,41,89
2013,Turkey,TUR,Sweden,SWE,10,22,106,27,165
2013,Uganda,UGA,Sweden,SWE,184,21,36,11,252
2013,Ukraine,UKR,Sweden,SWE,0,12,72,43,127
2013,United States of America,USA,Sweden,SWE,0,5,11,5,21
2013,Uzbekistan,UZB,Sweden,SWE,37,16,227,39,319
2013,Venezuela (Bolivarian Republic of),VEN,Sweden,SWE,0,0,10,0,10
2013,Yemen,YEM,Sweden,SWE,68,30,81,18,197
2013,Zimbabwe,ZWE,Sweden,SWE,5,0,0,5,10
2013,Stateless,XXA,Sweden,SWE,720,3236,432,234,4622
2013,Unknown ,,Sweden,SWE,10,80,346,80,516
2013,Afghanistan,AFG,Switzerland,CHE,92,627,30,312,1061
2013,Albania,ALB,Switzerland,CHE,0,0,67,51,118
2013,Algeria,DZA,Switzerland,CHE,0,10,106,931,1047
2013,Angola,AGO,Switzerland,CHE,0,38,5,15,58
2013,Egypt,EGY,Switzerland,CHE,17,0,31,166,214
2013,Armenia,ARM,Switzerland,CHE,0,22,26,85,133
2013,Azerbaijan,AZE,Switzerland,CHE,0,5,5,12,22
2013,Burundi,BDI,Switzerland,CHE,0,0,0,5,5
2013,Benin,BEN,Switzerland,CHE,0,0,10,33,43
2013,Bangladesh,BGD,Switzerland,CHE,5,0,18,60,83
2013,Burkina Faso,BFA,Switzerland,CHE,0,0,5,28,33
2013,Belarus,BLR,Switzerland,CHE,5,0,21,139,165
2013,Brazil,BRA,Switzerland,CHE,0,5,0,0,5
2013,Bosnia and Herzegovina,BIH,Switzerland,CHE,10,46,133,122,311
2013,Bulgaria,BGR,Switzerland,CHE,0,0,5,10,15
2013,Chad,TCD,Switzerland,CHE,0,0,0,29,29
2013,China,CHN,Switzerland,CHE,36,162,70,41,309
2013,Cameroon,CMR,Switzerland,CHE,5,24,0,60,89
2013,Congo,COG,Switzerland,CHE,0,5,0,0,5
2013,Dem. Rep. of the Congo,COD,Switzerland,CHE,5,81,37,57,180
2013,Colombia,COL,Switzerland,CHE,5,0,5,10,20
2013,Cuba,CUB,Switzerland,CHE,0,5,0,0,5
2013,Cabo Verde,CPV,Switzerland,CHE,0,0,0,5,5
2013,Czechia,CZE,Switzerland,CHE,0,0,0,5,5
2013,Djibouti,DJI,Switzerland,CHE,0,0,0,5,5
2013,Ecuador,ECU,Switzerland,CHE,0,5,0,0,5
2013,Equatorial Guinea,GNQ,Switzerland,CHE,0,0,5,5,10
2013,Eritrea,ERI,Switzerland,CHE,1883,534,58,372,2847
2013,Ethiopia,ETH,Switzerland,CHE,57,43,34,76,210
2013,Gabon,GAB,Switzerland,CHE,0,0,0,5,5
2013,Gambia,GMB,Switzerland,CHE,0,5,60,597,662
2013,Georgia,GEO,Switzerland,CHE,0,5,53,667,725
2013,Germany,DEU,Switzerland,CHE,0,0,0,5,5
2013,Ghana,GHA,Switzerland,CHE,0,0,10,221,231
2013,Guinea-Bissau,GNB,Switzerland,CHE,0,10,102,324,436
2013,Guinea,GIN,Switzerland,CHE,0,10,57,343,410
2013,Haiti,HTI,Switzerland,CHE,0,0,0,10,10
2013,Croatia,HRV,Switzerland,CHE,0,0,5,5,10
2013,Hungary,HUN,Switzerland,CHE,0,0,21,13,34
2013,Cote d'Ivoire,CIV,Switzerland,CHE,5,11,10,99,125
2013,India,IND,Switzerland,CHE,0,0,0,19,19
2013,Iran (Islamic Rep. of),IRN,Switzerland,CHE,78,65,51,138,332
2013,Iraq,IRQ,Switzerland,CHE,92,156,67,182,497
2013,Israel,ISR,Switzerland,CHE,0,0,0,5,5
2013,Italy,ITA,Switzerland,CHE,0,0,0,20,20
2013,Jordan,JOR,Switzerland,CHE,0,5,0,5,10
2013,Kazakhstan,KAZ,Switzerland,CHE,0,5,17,5,27
2013,Kenya,KEN,Switzerland,CHE,0,0,0,13,13
2013,Kyrgyzstan,KGZ,Switzerland,CHE,0,12,0,5,17
2013,Dem. People's Rep. of Korea,PRK,Switzerland,CHE,0,0,0,10,10
2013,Liberia,LBR,Switzerland,CHE,0,5,0,58,63
2013,Libya,LBY,Switzerland,CHE,0,10,0,141,151
2013,Lebanon,LBN,Switzerland,CHE,0,5,0,25,30
2013,Sri Lanka,LKA,Switzerland,CHE,150,139,311,172,772
2013,Latvia,LVA,Switzerland,CHE,0,0,0,5,5
2013,Mauritania,MRT,Switzerland,CHE,0,0,10,57,67
2013,North Macedonia,MKD,Switzerland,CHE,0,5,129,76,210
2013,Rep. of Moldova,MDA,Switzerland,CHE,0,0,0,20,20
2013,Mali,MLI,Switzerland,CHE,0,0,5,248,253
2013,Mongolia,MNG,Switzerland,CHE,0,17,25,36,78
2013,Morocco,MAR,Switzerland,CHE,5,5,64,1220,1294
2013,Mozambique,MOZ,Switzerland,CHE,0,0,0,5,5
2013,Montenegro,MNE,Switzerland,CHE,0,0,15,17,32
2013,Myanmar,MMR,Switzerland,CHE,0,0,0,5,5
2013,Namibia,NAM,Switzerland,CHE,0,0,0,5,5
2013,Nepal,NPL,Switzerland,CHE,0,0,10,20,30
2013,Niger,NER,Switzerland,CHE,0,0,0,67,67
2013,Nigeria,NGA,Switzerland,CHE,0,25,109,2042,2176
2013,Pakistan,PAK,Switzerland,CHE,5,5,59,157,226
2013,Poland,POL,Switzerland,CHE,0,0,10,5,15
2013,Romania,ROU,Switzerland,CHE,0,0,13,21,34
2013,South Africa,ZAF,Switzerland,CHE,0,0,0,5,5
2013,Russian Federation,RUS,Switzerland,CHE,33,18,126,265,442
2013,Rwanda,RWA,Switzerland,CHE,0,5,0,5,10
2013,Serbia and Kosovo: S/RES/1244 (1999),SRB,Switzerland,CHE,11,166,502,740,1419
2013,Senegal,SEN,Switzerland,CHE,5,0,71,357,433
2013,Sierra Leone,SLE,Switzerland,CHE,0,0,0,78,78
2013,Somalia,SOM,Switzerland,CHE,184,344,10,186,724
2013,Spain,ESP,Switzerland,CHE,0,0,0,5,5
2013,Viet Nam,VNM,Switzerland,CHE,5,5,0,0,10
2013,Sudan,SDN,Switzerland,CHE,5,27,0,77,109
2013,South Sudan,SSD,Switzerland,CHE,0,0,0,13,13
2013,Slovakia,SVK,Switzerland,CHE,0,0,0,5,5
2013,Syrian Arab Rep.,SYR,Switzerland,CHE,162,577,77,341,1157
2013,United Rep. of Tanzania,TZA,Switzerland,CHE,0,0,5,5,10
2013,Togo,TGO,Switzerland,CHE,23,11,25,59,118
2013,Tunisia,TUN,Switzerland,CHE,5,0,88,1971,2064
2013,Turkey,TUR,Switzerland,CHE,181,28,254,147,610
2013,Uganda,UGA,Switzerland,CHE,0,5,0,11,16
2013,Ukraine,UKR,Switzerland,CHE,0,13,0,33,46
2013,Uzbekistan,UZB,Switzerland,CHE,5,0,0,5,10
2013,Samoa,WSM,Switzerland,CHE,0,0,0,11,11
2013,Yemen,YEM,Switzerland,CHE,5,0,14,19,38
2013,Zimbabwe,ZWE,Switzerland,CHE,0,0,5,11,16
2013,Stateless,XXA,Switzerland,CHE,0,5,0,10,15
2013,Unknown ,,Switzerland,CHE,64,93,68,280,505
2013,Angola,AGO,United Rep. of Tanzania,TZA,0,0,0,5,5
2013,Burundi,BDI,United Rep. of Tanzania,TZA,10,0,0,0,10
2013,Dem. Rep. of the Congo,COD,United Rep. of Tanzania,TZA,469,0,41,0,510
2013,Kenya,KEN,United Rep. of Tanzania,TZA,0,0,5,0,5
2013,Rwanda,RWA,United Rep. of Tanzania,TZA,10,0,0,0,10
2013,Somalia,SOM,United Rep. of Tanzania,TZA,0,0,0,5,5
2013,Sudan,SDN,United Rep. of Tanzania,TZA,0,0,0,5,5
2013,Central African Rep.,CAF,Togo,TGO,27,0,0,0,27
2013,Congo,COG,Togo,TGO,5,0,5,0,10
2013,Dem. Rep. of the Congo,COD,Togo,TGO,5,0,25,0,30
2013,Ghana,GHA,Togo,TGO,0,0,0,5,5
2013,Cote d'Ivoire,CIV,Togo,TGO,0,0,5,111,116
2013,Liberia,LBR,Togo,TGO,0,0,0,10,10
2013,Libya,LBY,Togo,TGO,0,0,5,0,5
2013,Sri Lanka,LKA,Togo,TGO,0,0,0,5,5
2013,Nigeria,NGA,Togo,TGO,0,0,5,0,5
2013,Pakistan,PAK,Togo,TGO,0,0,0,5,5
2013,Rwanda,RWA,Togo,TGO,0,0,0,10,10
2013,Syrian Arab Rep.,SYR,Togo,TGO,0,0,0,5,5
2013,Afghanistan,AFG,Ukraine,UKR,40,10,138,42,230
2013,Algeria,DZA,Ukraine,UKR,0,0,0,5,5
2013,Armenia,ARM,Ukraine,UKR,0,0,5,0,5
2013,Azerbaijan,AZE,Ukraine,UKR,5,0,10,5,20
2013,Bangladesh,BGD,Ukraine,UKR,0,0,10,5,15
2013,Belarus,BLR,Ukraine,UKR,0,0,5,0,5
2013,Cameroon,CMR,Ukraine,UKR,0,0,5,0,5
2013,Dem. Rep. of the Congo,COD,Ukraine,UKR,0,0,12,5,17
2013,Eritrea,ERI,Ukraine,UKR,0,5,14,5,24
2013,Palestinian,PSE,Ukraine,UKR,0,0,5,5,10
2013,Georgia,GEO,Ukraine,UKR,0,0,5,0,5
2013,Guinea,GIN,Ukraine,UKR,0,0,5,0,5
2013,Cote d'Ivoire,CIV,Ukraine,UKR,0,0,5,0,5
2013,India,IND,Ukraine,UKR,0,0,0,5,5
2013,Iran (Islamic Rep. of),IRN,Ukraine,UKR,5,0,16,5,26
2013,Iraq,IRQ,Ukraine,UKR,5,0,5,5,15
2013,Kyrgyzstan,KGZ,Ukraine,UKR,0,0,5,13,18
2013,Lebanon,LBN,Ukraine,UKR,0,0,10,0,10
2013,Sri Lanka,LKA,Ukraine,UKR,0,0,5,5,10
2013,Pakistan,PAK,Ukraine,UKR,0,0,14,5,19
2013,Russian Federation,RUS,Ukraine,UKR,0,0,16,15,31
2013,Somalia,SOM,Ukraine,UKR,0,5,20,5,30
2013,Sudan,SDN,Ukraine,UKR,0,0,5,5,10
2013,Syrian Arab Rep.,SYR,Ukraine,UKR,10,99,105,20,234
2013,Tajikistan,TJK,Ukraine,UKR,0,0,5,0,5
2013,Turkey,TUR,Ukraine,UKR,0,0,5,0,5
2013,Uzbekistan,UZB,Ukraine,UKR,0,0,14,5,19
2013,Stateless,XXA,Ukraine,UKR,0,10,5,0,15
2013,Colombia,COL,Uruguay,URY,5,0,5,10,20
2013,Colombia,COL,Venezuela (Bolivarian Republic of),VEN,725,0,2613,0,3338
2013,Burundi,BDI,Zambia,ZMB,0,0,30,5,35
2013,Congo,COG,Zambia,ZMB,0,0,0,5,5
2013,Dem. Rep. of the Congo,COD,Zambia,ZMB,759,0,230,238,1227
2013,Equatorial Guinea,GNQ,Zambia,ZMB,0,0,5,5,10
2013,Ethiopia,ETH,Zambia,ZMB,0,0,0,13,13
2013,Somalia,SOM,Zambia,ZMB,0,0,0,292,292
2013,Sudan,SDN,Zambia,ZMB,0,0,0,5,5
2014,Eritrea,ERI,Albania,ALB,0,0,0,26,26
2014,Iran (Islamic Rep. of),IRN,Albania,ALB,0,0,0,19,19
2014,Serbia and Kosovo: S/RES/1244 (1999),SRB,Albania,ALB,0,5,0,0,5
2014,Somalia,SOM,Albania,ALB,0,0,0,5,5
2014,Sudan,SDN,Albania,ALB,0,0,0,5,5
2014,Syrian Arab Rep.,SYR,Albania,ALB,0,5,0,96,101
2014,Congo,COG,Angola,AGO,0,0,0,17,17
2014,Dem. Rep. of the Congo,COD,Angola,AGO,0,0,0,1800,1800
2014,Ethiopia,ETH,Angola,AGO,0,0,0,19,19
2014,Guinea,GIN,Angola,AGO,0,0,10,0,10
2014,Cote d'Ivoire,CIV,Angola,AGO,0,0,16,0,16
2014,Mauritania,MRT,Angola,AGO,0,0,11,11,22
2014,Rwanda,RWA,Angola,AGO,0,0,0,205,205
2014,Afghanistan,AFG,Argentina,ARG,5,0,0,0,5
2014,Bangladesh,BGD,Argentina,ARG,0,0,5,5,10
2014,China,CHN,Argentina,ARG,0,0,5,0,5
2014,Cameroon,CMR,Argentina,ARG,0,0,0,5,5
2014,Dem. Rep. of the Congo,COD,Argentina,ARG,10,0,0,0,10
2014,Colombia,COL,Argentina,ARG,5,0,36,178,219
2014,Cuba,CUB,Argentina,ARG,0,0,82,22,104
2014,Dominican Rep.,DOM,Argentina,ARG,0,0,17,35,52
2014,Germany,DEU,Argentina,ARG,0,0,5,0,5
2014,Ghana,GHA,Argentina,ARG,5,0,0,5,10
2014,Haiti,HTI,Argentina,ARG,5,0,32,27,64
2014,Honduras,HND,Argentina,ARG,0,0,0,5,5
2014,Hungary,HUN,Argentina,ARG,0,0,5,0,5
2014,India,IND,Argentina,ARG,0,0,25,15,40
2014,Morocco,MAR,Argentina,ARG,0,0,5,0,5
2014,Nigeria,NGA,Argentina,ARG,5,0,5,5,15
2014,Pakistan,PAK,Argentina,ARG,5,0,5,5,15
2014,Paraguay,PRY,Argentina,ARG,5,0,0,0,5
2014,Peru,PER,Argentina,ARG,0,0,0,5,5
2014,Russian Federation,RUS,Argentina,ARG,0,0,5,0,5
2014,Senegal,SEN,Argentina,ARG,0,0,97,65,162
2014,Syrian Arab Rep.,SYR,Argentina,ARG,74,0,0,5,79
2014,Turkey,TUR,Argentina,ARG,5,0,0,0,5
2014,Ukraine,UKR,Argentina,ARG,0,0,5,0,5
2014,Azerbaijan,AZE,Armenia,ARM,5,0,0,0,5
2014,Iran (Islamic Rep. of),IRN,Armenia,ARM,0,0,14,13,27
2014,Iraq,IRQ,Armenia,ARM,20,0,0,0,20
2014,Syrian Arab Rep.,SYR,Armenia,ARM,65,0,0,18,83
2014,Ukraine,UKR,Armenia,ARM,43,0,0,46,89
2014,Afghanistan,AFG,Australia,AUS,100,0,363,0,463
2014,Albania,ALB,Australia,AUS,0,0,5,0,5
2014,Algeria,DZA,Australia,AUS,5,0,5,0,10
2014,Egypt,EGY,Australia,AUS,218,0,396,0,614
2014,Bahrain,BHR,Australia,AUS,5,0,0,0,5
2014,Burundi,BDI,Australia,AUS,0,0,5,0,5
2014,Belgium,BEL,Australia,AUS,0,0,5,0,5
2014,Bangladesh,BGD,Australia,AUS,18,0,327,0,345
2014,Brazil,BRA,Australia,AUS,0,0,10,0,10
2014,Cambodia,KHM,Australia,AUS,0,0,5,0,5
2014,Canada,CAN,Australia,AUS,0,0,5,0,5
2014,China,CHN,Australia,AUS,86,0,1218,0,1304
2014,Chile,CHL,Australia,AUS,0,0,5,0,5
2014,Cameroon,CMR,Australia,AUS,0,0,5,0,5
2014,Congo,COG,Australia,AUS,0,0,5,0,5
2014,Dem. Rep. of the Congo,COD,Australia,AUS,0,0,5,0,5
2014,Colombia,COL,Australia,AUS,5,0,24,0,29
2014,Eritrea,ERI,Australia,AUS,18,0,5,0,23
2014,Ethiopia,ETH,Australia,AUS,28,0,26,0,54
2014,Fiji,FJI,Australia,AUS,29,0,441,0,470
2014,Palestinian,PSE,Australia,AUS,10,0,49,0,59
2014,United Kingdom of Great Britain and Northern Ireland,GBR,Australia,AUS,0,0,5,0,5
2014,Georgia,GEO,Australia,AUS,0,0,10,0,10
2014,Germany,DEU,Australia,AUS,5,0,0,0,5
2014,Ghana,GHA,Australia,AUS,0,0,14,0,14
2014,Greece,GRC,Australia,AUS,0,0,5,0,5
2014,Guinea,GIN,Australia,AUS,0,0,5,0,5
2014,"China, Hong Kong SAR",HKG,Australia,AUS,0,0,12,0,12
2014,India,IND,Australia,AUS,23,0,872,0,895
2014,Indonesia,IDN,Australia,AUS,5,0,156,0,161
2014,Ireland,IRL,Australia,AUS,0,0,44,0,44
2014,Iran (Islamic Rep. of),IRN,Australia,AUS,291,0,392,0,683
2014,Iraq,IRQ,Australia,AUS,175,0,145,0,320
2014,Israel,ISR,Australia,AUS,0,0,5,0,5
2014,Italy,ITA,Australia,AUS,0,0,5,0,5
2014,Jordan,JOR,Australia,AUS,14,0,76,0,90
2014,Japan,JPN,Australia,AUS,0,0,5,0,5
2014,Kenya,KEN,Australia,AUS,10,0,26,0,36
2014,Rep. of Korea,KOR,Australia,AUS,0,0,92,0,92
2014,Dem. People's Rep. of Korea,PRK,Australia,AUS,0,0,5,0,5
2014,Liberia,LBR,Australia,AUS,0,0,5,0,5
2014,Libya,LBY,Australia,AUS,145,0,85,0,230
2014,Lebanon,LBN,Australia,AUS,31,0,248,0,279
2014,Sri Lanka,LKA,Australia,AUS,32,0,871,0,903
2014,Latvia,LVA,Australia,AUS,0,0,5,0,5
2014,Maldives,MDV,Australia,AUS,5,0,5,0,10
2014,Malaysia,MYS,Australia,AUS,10,0,232,0,242
2014,Mongolia,MNG,Australia,AUS,0,0,26,0,26
2014,Mauritius,MUS,Australia,AUS,5,0,13,0,18
2014,Myanmar,MMR,Australia,AUS,11,0,31,0,42
2014,Nepal,NPL,Australia,AUS,5,0,244,0,249
2014,Nicaragua,NIC,Australia,AUS,0,0,5,0,5
2014,Nigeria,NGA,Australia,AUS,14,0,47,0,61
2014,Pakistan,PAK,Australia,AUS,315,0,676,0,991
2014,Peru,PER,Australia,AUS,0,0,19,0,19
2014,Philippines,PHL,Australia,AUS,0,0,48,0,48
2014,Papua New Guinea,PNG,Australia,AUS,60,0,50,0,110
2014,Romania,ROU,Australia,AUS,0,0,5,0,5
2014,South Africa,ZAF,Australia,AUS,0,0,12,0,12
2014,Russian Federation,RUS,Australia,AUS,5,0,13,0,18
2014,Rwanda,RWA,Australia,AUS,0,0,16,0,16
2014,Saudi Arabia,SAU,Australia,AUS,11,0,5,0,16
2014,Singapore,SGP,Australia,AUS,0,0,5,0,5
2014,Sierra Leone,SLE,Australia,AUS,5,0,5,0,10
2014,Somalia,SOM,Australia,AUS,5,0,5,0,10
2014,Viet Nam,VNM,Australia,AUS,5,0,96,0,101
2014,Sudan,SDN,Australia,AUS,0,0,5,0,5
2014,Syrian Arab Rep.,SYR,Australia,AUS,46,0,5,0,51
2014,Thailand,THA,Australia,AUS,0,0,12,0,12
2014,Tonga,TON,Australia,AUS,0,0,73,0,73
2014,Tunisia,TUN,Australia,AUS,0,0,5,0,5
2014,Turkey,TUR,Australia,AUS,38,0,55,0,93
2014,Uganda,UGA,Australia,AUS,0,0,5,0,5
2014,Ukraine,UKR,Australia,AUS,0,0,12,0,12
2014,United States of America,USA,Australia,AUS,5,0,5,0,10
2014,Venezuela (Bolivarian Republic of),VEN,Australia,AUS,0,0,5,0,5
2014,Yemen,YEM,Australia,AUS,0,0,5,0,5
2014,Zambia,ZMB,Australia,AUS,0,0,5,0,5
2014,Zimbabwe,ZWE,Australia,AUS,10,0,48,0,58
2014,Stateless,XXA,Australia,AUS,12,0,123,0,135
2014,Tibetan,TIB,Australia,AUS,0,0,5,0,5
2014,Unknown ,,Australia,AUS,0,0,5,0,5
2014,Afghanistan,AFG,Azerbaijan,AZE,0,0,194,5,199
2014,Iran (Islamic Rep. of),IRN,Azerbaijan,AZE,0,0,5,5,10
2014,Iraq,IRQ,Azerbaijan,AZE,5,0,10,0,15
2014,Pakistan,PAK,Azerbaijan,AZE,0,0,99,0,99
2014,Syrian Arab Rep.,SYR,Azerbaijan,AZE,0,0,5,0,5
2014,Ukraine,UKR,Azerbaijan,AZE,0,0,60,10,70
2014,Dem. Rep. of the Congo,COD,Burundi,BDI,5228,0,0,1190,6418
2014,Rwanda,RWA,Burundi,BDI,12,0,0,0,12
2014,Afghanistan,AFG,Belgium,BEL,804,459,315,424,2002
2014,Albania,ALB,Belgium,BEL,69,5,369,147,590
2014,Algeria,DZA,Belgium,BEL,19,0,80,44,143
2014,Angola,AGO,Belgium,BEL,10,0,159,40,209
2014,Egypt,EGY,Belgium,BEL,25,0,76,43,144
2014,Armenia,ARM,Belgium,BEL,15,10,156,111,292
2014,Azerbaijan,AZE,Belgium,BEL,24,0,47,57,128
2014,Burundi,BDI,Belgium,BEL,28,0,95,41,164
2014,Benin,BEN,Belgium,BEL,26,0,61,21,108
2014,Bangladesh,BGD,Belgium,BEL,5,0,266,102,373
2014,Bhutan,BTN,Belgium,BEL,0,0,5,5,10
2014,Burkina Faso,BFA,Belgium,BEL,10,0,51,16,77
2014,Belarus,BLR,Belgium,BEL,5,0,14,19,38
2014,Bosnia and Herzegovina,BIH,Belgium,BEL,16,5,53,37,111
2014,Bulgaria,BGR,Belgium,BEL,0,0,10,10,20
2014,Central African Rep.,CAF,Belgium,BEL,24,14,5,5,48
2014,Chad,TCD,Belgium,BEL,10,0,10,5,25
2014,China,CHN,Belgium,BEL,250,0,322,36,608
2014,Cameroon,CMR,Belgium,BEL,106,0,205,65,376
2014,Congo,COG,Belgium,BEL,10,0,15,5,30
2014,Dem. Rep. of the Congo,COD,Belgium,BEL,220,5,632,221,1078
2014,Colombia,COL,Belgium,BEL,5,0,0,0,5
2014,Djibouti,DJI,Belgium,BEL,76,0,67,19,162
2014,Dominican Rep.,DOM,Belgium,BEL,0,0,5,0,5
2014,Eritrea,ERI,Belgium,BEL,210,0,34,17,261
2014,Ethiopia,ETH,Belgium,BEL,5,0,18,10,33
2014,Gabon,GAB,Belgium,BEL,0,0,5,0,5
2014,Gambia,GMB,Belgium,BEL,12,0,40,19,71
2014,Palestinian,PSE,Belgium,BEL,10,5,0,5,20
2014,Georgia,GEO,Belgium,BEL,23,0,154,121,298
2014,Ghana,GHA,Belgium,BEL,10,0,24,5,39
2014,Guinea-Bissau,GNB,Belgium,BEL,5,0,14,5,24
2014,Guatemala,GTM,Belgium,BEL,0,5,0,0,5
2014,Guinea,GIN,Belgium,BEL,648,13,461,465,1587
2014,Haiti,HTI,Belgium,BEL,0,0,16,0,16
2014,Honduras,HND,Belgium,BEL,0,0,5,0,5
2014,Croatia,HRV,Belgium,BEL,0,0,0,15,15
2014,Cote d'Ivoire,CIV,Belgium,BEL,35,0,105,40,180
2014,India,IND,Belgium,BEL,5,0,24,14,43
2014,Iran (Islamic Rep. of),IRN,Belgium,BEL,309,5,201,133,648
2014,Iraq,IRQ,Belgium,BEL,337,476,189,190,1192
2014,Jordan,JOR,Belgium,BEL,10,0,25,10,45
2014,Kazakhstan,KAZ,Belgium,BEL,15,0,33,34,82
2014,Kenya,KEN,Belgium,BEL,5,0,18,15,38
2014,Kyrgyzstan,KGZ,Belgium,BEL,20,0,48,36,104
2014,Dem. People's Rep. of Korea,PRK,Belgium,BEL,10,0,5,5,20
2014,Liberia,LBR,Belgium,BEL,5,0,11,18,34
2014,Libya,LBY,Belgium,BEL,12,11,5,22,50
2014,Lebanon,LBN,Belgium,BEL,19,0,70,37,126
2014,Sri Lanka,LKA,Belgium,BEL,70,0,25,31,126
2014,Madagascar,MDG,Belgium,BEL,5,0,0,5,10
2014,Mauritania,MRT,Belgium,BEL,66,5,82,76,229
2014,North Macedonia,MKD,Belgium,BEL,5,0,140,149,294
2014,Rep. of Moldova,MDA,Belgium,BEL,0,0,5,21,26
2014,Mali,MLI,Belgium,BEL,56,0,101,24,181
2014,Mongolia,MNG,Belgium,BEL,0,0,12,5,17
2014,Morocco,MAR,Belgium,BEL,26,0,80,54,160
2014,Montenegro,MNE,Belgium,BEL,0,0,10,0,10
2014,Mauritius,MUS,Belgium,BEL,0,0,5,0,5
2014,Myanmar,MMR,Belgium,BEL,0,0,29,10,39
2014,Nepal,NPL,Belgium,BEL,0,0,71,19,90
2014,Netherlands,NLD,Belgium,BEL,0,0,5,0,5
2014,Niger,NER,Belgium,BEL,22,0,41,19,82
2014,Nigeria,NGA,Belgium,BEL,5,0,85,35,125
2014,Pakistan,PAK,Belgium,BEL,61,13,304,194,572
2014,Romania,ROU,Belgium,BEL,10,0,11,0,21
2014,Russian Federation,RUS,Belgium,BEL,424,5,443,727,1599
2014,Rwanda,RWA,Belgium,BEL,146,0,223,65,434
2014,El Salvador,SLV,Belgium,BEL,5,0,27,0,32
2014,Serbia and Kosovo: S/RES/1244 (1999),SRB,Belgium,BEL,93,0,333,451,877
2014,Senegal,SEN,Belgium,BEL,69,0,200,60,329
2014,Sierra Leone,SLE,Belgium,BEL,10,0,35,40,85
2014,Somalia,SOM,Belgium,BEL,135,44,54,69,302
2014,Sudan,SDN,Belgium,BEL,22,0,34,15,71
2014,Syrian Arab Rep.,SYR,Belgium,BEL,1261,444,30,37,1772
2014,United Rep. of Tanzania,TZA,Belgium,BEL,5,0,20,18,43
2014,Tajikistan,TJK,Belgium,BEL,0,0,5,0,5
2014,Turkmenistan,TKM,Belgium,BEL,5,0,0,0,5
2014,Togo,TGO,Belgium,BEL,44,0,139,57,240
2014,Tunisia,TUN,Belgium,BEL,10,5,31,18,64
2014,Turkey,TUR,Belgium,BEL,86,0,169,133,388
2014,United Arab Emirates,ARE,Belgium,BEL,0,0,5,0,5
2014,Uganda,UGA,Belgium,BEL,5,0,20,5,30
2014,Ukraine,UKR,Belgium,BEL,12,0,130,70,212
2014,Uzbekistan,UZB,Belgium,BEL,5,0,5,0,10
2014,Venezuela (Bolivarian Republic of),VEN,Belgium,BEL,5,0,5,0,10
2014,Yemen,YEM,Belgium,BEL,5,0,5,10,20
2014,Unknown ,,Belgium,BEL,401,44,155,72,672
2014,Central African Rep.,CAF,Benin,BEN,223,0,0,5,228
2014,Cote d'Ivoire,CIV,Benin,BEN,5,0,31,0,36
2014,Mali,MLI,Benin,BEN,0,0,5,0,5
2014,Algeria,DZA,Burkina Faso,BFA,0,0,0,5,5
2014,Angola,AGO,Burkina Faso,BFA,0,0,0,5,5
2014,Burundi,BDI,Burkina Faso,BFA,0,0,0,47,47
2014,Central African Rep.,CAF,Burkina Faso,BFA,27,0,0,111,138
2014,Chad,TCD,Burkina Faso,BFA,0,0,0,73,73
2014,Cameroon,CMR,Burkina Faso,BFA,0,0,0,19,19
2014,Congo,COG,Burkina Faso,BFA,0,0,0,79,79
2014,Dem. Rep. of the Congo,COD,Burkina Faso,BFA,0,0,0,49,49
2014,Guinea,GIN,Burkina Faso,BFA,0,0,0,5,5
2014,Cote d'Ivoire,CIV,Burkina Faso,BFA,0,0,0,221,221
2014,Sri Lanka,LKA,Burkina Faso,BFA,0,0,0,5,5
2014,Niger,NER,Burkina Faso,BFA,0,0,0,10,10
2014,Nigeria,NGA,Burkina Faso,BFA,0,0,0,24,24
2014,Rwanda,RWA,Burkina Faso,BFA,0,0,0,26,26
2014,Togo,TGO,Burkina Faso,BFA,0,0,0,67,67
2014,Afghanistan,AFG,Belarus,BLR,12,0,37,10,59
2014,Dem. Rep. of the Congo,COD,Belarus,BLR,0,0,5,0,5
2014,Georgia,GEO,Belarus,BLR,0,0,10,5,15
2014,Iran (Islamic Rep. of),IRN,Belarus,BLR,0,0,5,0,5
2014,Iraq,IRQ,Belarus,BLR,0,5,0,5,10
2014,Sri Lanka,LKA,Belarus,BLR,0,0,0,5,5
2014,Pakistan,PAK,Belarus,BLR,0,0,0,5,5
2014,Russian Federation,RUS,Belarus,BLR,0,0,5,5,10
2014,Syrian Arab Rep.,SYR,Belarus,BLR,10,28,0,34,72
2014,Ukraine,UKR,Belarus,BLR,0,284,31,181,496
2014,Colombia,COL,Bolivia (Plurinational State of),BOL,12,0,5,0,17
2014,Pakistan,PAK,Bolivia (Plurinational State of),BOL,5,0,0,0,5
2014,Dem. Rep. of the Congo,COD,Botswana,BWA,0,0,26,0,26
2014,Rwanda,RWA,Botswana,BWA,0,0,5,0,5
2014,Somalia,SOM,Botswana,BWA,0,0,10,0,10
2014,Zimbabwe,ZWE,Botswana,BWA,0,0,5,0,5
2014,Afghanistan,AFG,Brazil,BRA,11,0,0,0,11
2014,Angola,AGO,Brazil,BRA,10,0,10,0,20
2014,Egypt,EGY,Brazil,BRA,5,0,0,0,5
2014,Burkina Faso,BFA,Brazil,BRA,0,0,5,0,5
2014,Cameroon,CMR,Brazil,BRA,13,0,5,0,18
2014,Dem. Rep. of the Congo,COD,Brazil,BRA,174,0,0,0,174
2014,Colombia,COL,Brazil,BRA,29,0,5,0,34
2014,Gambia,GMB,Brazil,BRA,0,0,5,0,5
2014,Palestinian,PSE,Brazil,BRA,102,0,0,0,102
2014,Guinea-Bissau,GNB,Brazil,BRA,0,0,47,0,47
2014,Guinea,GIN,Brazil,BRA,24,0,5,0,29
2014,Cote d'Ivoire,CIV,Brazil,BRA,5,0,0,0,5
2014,Iran (Islamic Rep. of),IRN,Brazil,BRA,5,0,0,0,5
2014,Iraq,IRQ,Brazil,BRA,16,0,0,0,16
2014,Lebanon,LBN,Brazil,BRA,360,0,0,0,360
2014,Mali,MLI,Brazil,BRA,42,0,5,0,47
2014,Nigeria,NGA,Brazil,BRA,34,0,54,0,88
2014,Pakistan,PAK,Brazil,BRA,10,0,0,0,10
2014,Senegal,SEN,Brazil,BRA,0,0,5,0,5
2014,Sierra Leone,SLE,Brazil,BRA,0,0,5,0,5
2014,Syrian Arab Rep.,SYR,Brazil,BRA,1405,0,0,0,1405
2014,Togo,TGO,Brazil,BRA,10,0,0,0,10
2014,United States of America,USA,Brazil,BRA,0,0,5,0,5
2014,Afghanistan,AFG,Bosnia and Herzegovina,BIH,0,0,0,10,10
2014,Algeria,DZA,Bosnia and Herzegovina,BIH,0,0,0,5,5
2014,Armenia,ARM,Bosnia and Herzegovina,BIH,0,0,5,0,5
2014,Iran (Islamic Rep. of),IRN,Bosnia and Herzegovina,BIH,0,0,5,0,5
2014,Serbia and Kosovo: S/RES/1244 (1999),SRB,Bosnia and Herzegovina,BIH,0,0,0,5,5
2014,Sudan,SDN,Bosnia and Herzegovina,BIH,0,0,0,5,5
2014,Syrian Arab Rep.,SYR,Bosnia and Herzegovina,BIH,5,5,0,11,21
2014,Afghanistan,AFG,Bulgaria,BGR,5,17,104,2146,2272
2014,Algeria,DZA,Bulgaria,BGR,0,0,5,436,441
2014,Egypt,EGY,Bulgaria,BGR,0,0,5,12,17
2014,Armenia,ARM,Bulgaria,BGR,0,0,10,0,10
2014,Bangladesh,BGD,Bulgaria,BGR,0,0,0,11,11
2014,Burkina Faso,BFA,Bulgaria,BGR,0,0,0,5,5
2014,Cameroon,CMR,Bulgaria,BGR,0,0,10,87,97
2014,Congo,COG,Bulgaria,BGR,0,0,5,14,19
2014,Dem. Rep. of the Congo,COD,Bulgaria,BGR,0,0,0,18,18
2014,Eritrea,ERI,Bulgaria,BGR,0,0,5,24,29
2014,Ethiopia,ETH,Bulgaria,BGR,5,0,0,0,5
2014,Gambia,GMB,Bulgaria,BGR,0,0,5,16,21
2014,Georgia,GEO,Bulgaria,BGR,0,0,0,5,5
2014,Ghana,GHA,Bulgaria,BGR,0,0,17,108,125
2014,Guinea,GIN,Bulgaria,BGR,0,0,5,5,10
2014,Cote d'Ivoire,CIV,Bulgaria,BGR,0,0,18,68,86
2014,Iran (Islamic Rep. of),IRN,Bulgaria,BGR,0,13,47,102,162
2014,Iraq,IRQ,Bulgaria,BGR,48,44,121,214,427
2014,Jordan,JOR,Bulgaria,BGR,0,5,0,0,5
2014,Liberia,LBR,Bulgaria,BGR,0,0,0,5,5
2014,Libya,LBY,Bulgaria,BGR,0,0,0,5,5
2014,Lebanon,LBN,Bulgaria,BGR,5,5,5,25,40
2014,Sri Lanka,LKA,Bulgaria,BGR,0,0,0,5,5
2014,Mali,MLI,Bulgaria,BGR,0,0,18,145,163
2014,Morocco,MAR,Bulgaria,BGR,0,0,0,85,85
2014,Myanmar,MMR,Bulgaria,BGR,0,0,0,5,5
2014,Nigeria,NGA,Bulgaria,BGR,0,0,10,5,15
2014,Pakistan,PAK,Bulgaria,BGR,0,0,14,98,112
2014,Rwanda,RWA,Bulgaria,BGR,0,0,11,27,38
2014,Senegal,SEN,Bulgaria,BGR,0,0,0,10,10
2014,Sierra Leone,SLE,Bulgaria,BGR,0,0,0,12,12
2014,Somalia,SOM,Bulgaria,BGR,5,0,20,71,96
2014,Sudan,SDN,Bulgaria,BGR,0,0,5,32,37
2014,Syrian Arab Rep.,SYR,Bulgaria,BGR,4821,1585,15,1109,7530
2014,Togo,TGO,Bulgaria,BGR,0,0,0,5,5
2014,Tunisia,TUN,Bulgaria,BGR,0,0,0,30,30
2014,Turkey,TUR,Bulgaria,BGR,0,0,5,5,10
2014,Uganda,UGA,Bulgaria,BGR,0,0,0,5,5
2014,Ukraine,UKR,Bulgaria,BGR,0,0,0,11,11
2014,Yemen,YEM,Bulgaria,BGR,0,0,5,5,10
2014,Stateless,XXA,Bulgaria,BGR,264,163,23,63,513
2014,Eritrea,ERI,Cambodia,KHM,0,0,5,0,5
2014,Pakistan,PAK,Cambodia,KHM,0,0,0,5,5
2014,Afghanistan,AFG,Canada,CAN,396,0,73,59,528
2014,Albania,ALB,Canada,CAN,145,0,158,25,328
2014,Algeria,DZA,Canada,CAN,61,0,119,5,185
2014,Angola,AGO,Canada,CAN,5,0,18,0,23
2014,Antigua and Barbuda,ATG,Canada,CAN,19,0,10,5,34
2014,Egypt,EGY,Canada,CAN,288,0,36,5,329
2014,Argentina,ARG,Canada,CAN,5,0,5,0,10
2014,Armenia,ARM,Canada,CAN,12,0,10,0,22
2014,Azerbaijan,AZE,Canada,CAN,10,0,5,0,15
2014,Bahrain,BHR,Canada,CAN,5,0,0,0,5
2014,Barbados,BRB,Canada,CAN,13,0,13,5,31
2014,Burundi,BDI,Canada,CAN,71,0,69,5,145
2014,Belgium,BEL,Canada,CAN,0,0,5,0,5
2014,Benin,BEN,Canada,CAN,5,0,5,0,10
2014,Bangladesh,BGD,Canada,CAN,235,0,110,13,358
2014,Bahamas,BHS,Canada,CAN,11,0,13,0,24
2014,Burkina Faso,BFA,Canada,CAN,10,0,10,0,20
2014,Belarus,BLR,Canada,CAN,0,0,10,0,10
2014,Bolivia (Plurinational State of),BOL,Canada,CAN,5,0,0,0,5
2014,Botswana,BWA,Canada,CAN,10,0,10,0,20
2014,Brazil,BRA,Canada,CAN,5,0,11,5,21
2014,Bosnia and Herzegovina,BIH,Canada,CAN,0,0,13,0,13
2014,Bulgaria,BGR,Canada,CAN,5,0,10,5,20
2014,Belize,BLZ,Canada,CAN,5,0,0,0,5
2014,Cambodia,KHM,Canada,CAN,5,0,26,5,36
2014,Central African Rep.,CAF,Canada,CAN,20,0,0,0,20
2014,Chad,TCD,Canada,CAN,40,0,21,0,61
2014,China,CHN,Canada,CAN,917,0,1041,192,2150
2014,Chile,CHL,Canada,CAN,5,0,5,0,10
2014,Cameroon,CMR,Canada,CAN,145,0,85,5,235
2014,Congo,COG,Canada,CAN,46,0,61,15,122
2014,Dem. Rep. of the Congo,COD,Canada,CAN,142,0,166,19,327
2014,Colombia,COL,Canada,CAN,406,0,329,59,794
2014,Costa Rica,CRI,Canada,CAN,0,0,5,5,10
2014,Cuba,CUB,Canada,CAN,120,0,56,27,203
2014,Czechia,CZE,Canada,CAN,19,0,63,15,97
2014,Djibouti,DJI,Canada,CAN,121,0,43,0,164
2014,Dominican Rep.,DOM,Canada,CAN,10,0,20,15,45
2014,Ecuador,ECU,Canada,CAN,0,0,5,5,10
2014,Eritrea,ERI,Canada,CAN,203,0,27,5,235
2014,Ethiopia,ETH,Canada,CAN,90,0,53,0,143
2014,Fiji,FJI,Canada,CAN,0,0,10,5,15
2014,France,FRA,Canada,CAN,0,0,12,5,17
2014,Gambia,GMB,Canada,CAN,10,0,5,0,15
2014,Palestinian,PSE,Canada,CAN,49,0,14,5,68
2014,United Kingdom of Great Britain and Northern Ireland,GBR,Canada,CAN,5,0,10,0,15
2014,Georgia,GEO,Canada,CAN,36,0,33,5,74
2014,Germany,DEU,Canada,CAN,0,0,5,0,5
2014,Ghana,GHA,Canada,CAN,38,0,45,10,93
2014,Guinea-Bissau,GNB,Canada,CAN,0,0,5,0,5
2014,Greece,GRC,Canada,CAN,0,0,30,10,40
2014,Grenada,GRD,Canada,CAN,5,0,10,0,15
2014,Guatemala,GTM,Canada,CAN,41,0,64,11,116
2014,Guinea,GIN,Canada,CAN,64,0,48,5,117
2014,Guyana,GUY,Canada,CAN,14,0,13,0,27
2014,Haiti,HTI,Canada,CAN,202,0,270,23,495
2014,"China, Hong Kong SAR",HKG,Canada,CAN,0,0,5,5,10
2014,Honduras,HND,Canada,CAN,146,0,116,22,284
2014,Croatia,HRV,Canada,CAN,40,0,240,90,370
2014,Hungary,HUN,Canada,CAN,340,0,330,305,975
2014,Cote d'Ivoire,CIV,Canada,CAN,32,0,17,5,54
2014,India,IND,Canada,CAN,114,0,393,126,633
2014,Indonesia,IDN,Canada,CAN,10,0,5,0,15
2014,Ireland,IRL,Canada,CAN,0,0,0,11,11
2014,Iran (Islamic Rep. of),IRN,Canada,CAN,258,0,96,12,366
2014,Iraq,IRQ,Canada,CAN,333,0,39,34,406
2014,Israel,ISR,Canada,CAN,5,0,75,41,121
2014,Italy,ITA,Canada,CAN,0,0,28,5,33
2014,Jamaica,JAM,Canada,CAN,135,0,113,15,263
2014,Jordan,JOR,Canada,CAN,40,0,26,5,71
2014,Kazakhstan,KAZ,Canada,CAN,23,0,0,0,23
2014,Kenya,KEN,Canada,CAN,32,0,24,5,61
2014,Kyrgyzstan,KGZ,Canada,CAN,0,0,5,0,5
2014,Rep. of Korea,KOR,Canada,CAN,5,0,108,29,142
2014,Dem. People's Rep. of Korea,PRK,Canada,CAN,0,0,113,401,514
2014,Kuwait,KWT,Canada,CAN,24,0,5,10,39
2014,Liberia,LBR,Canada,CAN,0,0,0,5,5
2014,Libya,LBY,Canada,CAN,107,0,20,5,132
2014,Saint Lucia,LCA,Canada,CAN,20,0,39,10,69
2014,Lebanon,LBN,Canada,CAN,87,0,111,5,203
2014,Sri Lanka,LKA,Canada,CAN,229,0,152,14,395
2014,Lithuania,LTU,Canada,CAN,0,0,10,16,26
2014,Latvia,LVA,Canada,CAN,5,0,5,0,10
2014,Madagascar,MDG,Canada,CAN,5,0,5,0,10
2014,Mauritania,MRT,Canada,CAN,10,0,12,0,22
2014,Rep. of Moldova,MDA,Canada,CAN,5,0,5,5,15
2014,Mexico,MEX,Canada,CAN,93,0,186,44,323
2014,Mali,MLI,Canada,CAN,21,0,25,0,46
2014,Malaysia,MYS,Canada,CAN,0,0,0,5,5
2014,Mongolia,MNG,Canada,CAN,27,0,10,0,37
2014,Morocco,MAR,Canada,CAN,18,0,17,5,40
2014,Malta,MLT,Canada,CAN,0,0,5,0,5
2014,Myanmar,MMR,Canada,CAN,0,0,5,0,5
2014,Namibia,NAM,Canada,CAN,31,0,126,22,179
2014,Nepal,NPL,Canada,CAN,29,0,13,0,42
2014,Netherlands,NLD,Canada,CAN,0,0,15,0,15
2014,Niger,NER,Canada,CAN,10,0,5,0,15
2014,Nicaragua,NIC,Canada,CAN,5,0,5,0,10
2014,Nigeria,NGA,Canada,CAN,332,0,279,22,633
2014,Norway,NOR,Canada,CAN,0,0,5,0,5
2014,Oman,OMN,Canada,CAN,0,0,0,5,5
2014,Pakistan,PAK,Canada,CAN,854,0,201,42,1097
2014,Panama,PAN,Canada,CAN,0,0,5,0,5
2014,Peru,PER,Canada,CAN,17,0,46,5,68
2014,Philippines,PHL,Canada,CAN,10,0,45,11,66
2014,Poland,POL,Canada,CAN,12,0,47,31,90
2014,Portugal,PRT,Canada,CAN,0,0,15,0,15
2014,Romania,ROU,Canada,CAN,10,0,16,62,88
2014,South Africa,ZAF,Canada,CAN,0,0,12,0,12
2014,Russian Federation,RUS,Canada,CAN,117,0,44,17,178
2014,Rwanda,RWA,Canada,CAN,63,0,35,5,103
2014,El Salvador,SLV,Canada,CAN,126,0,136,12,274
2014,Saudi Arabia,SAU,Canada,CAN,31,0,0,0,31
2014,Serbia and Kosovo: S/RES/1244 (1999),SRB,Canada,CAN,23,0,56,10,89
2014,Senegal,SEN,Canada,CAN,41,0,31,5,77
2014,Singapore,SGP,Canada,CAN,0,0,5,0,5
2014,Sierra Leone,SLE,Canada,CAN,5,0,5,0,10
2014,Somalia,SOM,Canada,CAN,189,0,83,53,325
2014,Spain,ESP,Canada,CAN,0,0,25,10,35
2014,Viet Nam,VNM,Canada,CAN,5,0,13,0,18
2014,Saint Kitts and Nevis,KNA,Canada,CAN,10,0,5,0,15
2014,Sudan,SDN,Canada,CAN,61,0,23,5,89
2014,Slovakia,SVK,Canada,CAN,197,0,140,42,379
2014,Syrian Arab Rep.,SYR,Canada,CAN,685,0,27,18,730
2014,United Rep. of Tanzania,TZA,Canada,CAN,15,0,10,0,25
2014,Turks and Caicos Islands,TCA,Canada,CAN,0,0,10,0,10
2014,Tajikistan,TJK,Canada,CAN,5,0,0,0,5
2014,Togo,TGO,Canada,CAN,13,0,17,0,30
2014,Trinidad and Tobago,TTO,Canada,CAN,10,0,27,0,37
2014,Tunisia,TUN,Canada,CAN,40,0,33,5,78
2014,Turkey,TUR,Canada,CAN,167,0,121,10,298
2014,Uganda,UGA,Canada,CAN,27,0,21,0,48
2014,Ukraine,UKR,Canada,CAN,214,0,132,23,369
2014,United States of America,USA,Canada,CAN,0,0,98,40,138
2014,Uzbekistan,UZB,Canada,CAN,27,0,10,5,42
2014,Saint Vincent and the Grenadines,VCT,Canada,CAN,45,0,71,15,131
2014,Venezuela (Bolivarian Republic of),VEN,Canada,CAN,90,0,54,5,149
2014,Yemen,YEM,Canada,CAN,21,0,19,0,40
2014,Zimbabwe,ZWE,Canada,CAN,55,0,22,0,77
2014,Stateless,XXA,Canada,CAN,24,0,10,0,34
2014,Unknown ,,Canada,CAN,5,0,10,5,20
2014,Chad,TCD,Central African Rep.,CAF,0,0,699,0,699
2014,Dem. Rep. of the Congo,COD,Central African Rep.,CAF,0,0,1049,0,1049
2014,Sudan,SDN,Central African Rep.,CAF,0,0,475,0,475
2014,Togo,TGO,Central African Rep.,CAF,0,0,19,0,19
2014,Colombia,COL,Chile,CHL,19,0,105,0,124
2014,Bangladesh,BGD,Colombia,COL,0,0,0,29,29
2014,Bhutan,BTN,Colombia,COL,0,0,0,5,5
2014,Cuba,CUB,Colombia,COL,0,0,30,355,385
2014,Ecuador,ECU,Colombia,COL,0,0,5,0,5
2014,Eritrea,ERI,Colombia,COL,0,0,0,5,5
2014,Ghana,GHA,Colombia,COL,0,0,0,5,5
2014,India,IND,Colombia,COL,0,0,0,5,5
2014,Nepal,NPL,Colombia,COL,0,0,0,84,84
2014,Pakistan,PAK,Colombia,COL,0,0,0,5,5
2014,Somalia,SOM,Colombia,COL,0,0,0,47,47
2014,Syrian Arab Rep.,SYR,Colombia,COL,0,0,0,5,5
2014,Venezuela (Bolivarian Republic of),VEN,Colombia,COL,12,0,10,5,27
2014,Stateless,XXA,Colombia,COL,0,0,5,0,5
2014,Bangladesh,BGD,Costa Rica,CRI,0,0,5,0,5
2014,Colombia,COL,Costa Rica,CRI,32,0,486,154,672
2014,Cuba,CUB,Costa Rica,CRI,13,0,77,0,90
2014,Dominican Rep.,DOM,Costa Rica,CRI,0,0,5,0,5
2014,Eritrea,ERI,Costa Rica,CRI,0,0,0,5,5
2014,Ghana,GHA,Costa Rica,CRI,0,0,5,0,5
2014,Guatemala,GTM,Costa Rica,CRI,5,0,5,0,10
2014,Haiti,HTI,Costa Rica,CRI,0,0,0,10,10
2014,Honduras,HND,Costa Rica,CRI,16,0,52,0,68
2014,Mexico,MEX,Costa Rica,CRI,0,0,10,0,10
2014,Nepal,NPL,Costa Rica,CRI,0,0,0,51,51
2014,Nicaragua,NIC,Costa Rica,CRI,5,0,10,0,15
2014,Nigeria,NGA,Costa Rica,CRI,0,0,10,0,10
2014,El Salvador,SLV,Costa Rica,CRI,62,0,146,0,208
2014,Syrian Arab Rep.,SYR,Costa Rica,CRI,5,0,0,0,5
2014,Ukraine,UKR,Costa Rica,CRI,5,0,0,0,5
2014,Venezuela (Bolivarian Republic of),VEN,Costa Rica,CRI,13,0,63,0,76
2014,Unknown ,,Costa Rica,CRI,0,0,0,278,278
2014,Egypt,EGY,Cyprus,CYP,0,0,29,21,50
2014,Bangladesh,BGD,Cyprus,CYP,0,0,52,32,84
2014,Cameroon,CMR,Cyprus,CYP,0,0,5,0,5
2014,Dem. Rep. of the Congo,COD,Cyprus,CYP,0,0,5,0,5
2014,India,IND,Cyprus,CYP,0,0,39,30,69
2014,Iran (Islamic Rep. of),IRN,Cyprus,CYP,0,5,0,0,5
2014,Iraq,IRQ,Cyprus,CYP,27,0,0,19,46
2014,Kazakhstan,KAZ,Cyprus,CYP,5,0,0,0,5
2014,Sri Lanka,LKA,Cyprus,CYP,0,0,44,5,49
2014,Mali,MLI,Cyprus,CYP,0,0,5,0,5
2014,Nigeria,NGA,Cyprus,CYP,0,0,10,5,15
2014,Pakistan,PAK,Cyprus,CYP,0,0,32,52,84
2014,Philippines,PHL,Cyprus,CYP,0,0,23,11,34
2014,Somalia,SOM,Cyprus,CYP,12,5,0,15,32
2014,Viet Nam,VNM,Cyprus,CYP,0,0,53,24,77
2014,Syrian Arab Rep.,SYR,Cyprus,CYP,5,926,0,0,931
2014,Ukraine,UKR,Cyprus,CYP,0,0,0,10,10
2014,Afghanistan,AFG,Czechia,CZE,5,5,0,10,20
2014,Algeria,DZA,Czechia,CZE,0,0,5,10,15
2014,Egypt,EGY,Czechia,CZE,0,0,5,0,5
2014,Armenia,ARM,Czechia,CZE,5,5,12,14,36
2014,Azerbaijan,AZE,Czechia,CZE,0,0,5,5,10
2014,Belarus,BLR,Czechia,CZE,5,20,0,10,35
2014,China,CHN,Czechia,CZE,5,0,5,5,15
2014,Dem. Rep. of the Congo,COD,Czechia,CZE,0,0,0,5,5
2014,Cuba,CUB,Czechia,CZE,0,28,0,0,28
2014,Georgia,GEO,Czechia,CZE,0,0,16,10,26
2014,India,IND,Czechia,CZE,0,0,0,5,5
2014,Iran (Islamic Rep. of),IRN,Czechia,CZE,0,0,5,5,10
2014,Iraq,IRQ,Czechia,CZE,0,10,0,5,15
2014,Kazakhstan,KAZ,Czechia,CZE,0,5,5,5,15
2014,Kyrgyzstan,KGZ,Czechia,CZE,0,0,18,10,28
2014,Libya,LBY,Czechia,CZE,0,0,0,5,5
2014,North Macedonia,MKD,Czechia,CZE,0,0,5,0,5
2014,Rep. of Moldova,MDA,Czechia,CZE,0,0,5,0,5
2014,Mongolia,MNG,Czechia,CZE,0,0,11,10,21
2014,Myanmar,MMR,Czechia,CZE,5,0,0,0,5
2014,Nigeria,NGA,Czechia,CZE,0,0,13,20,33
2014,Russian Federation,RUS,Czechia,CZE,5,5,22,15,47
2014,Serbia and Kosovo: S/RES/1244 (1999),SRB,Czechia,CZE,0,0,5,10,15
2014,Viet Nam,VNM,Czechia,CZE,0,0,26,15,41
2014,Slovakia,SVK,Czechia,CZE,0,0,0,5,5
2014,Syrian Arab Rep.,SYR,Czechia,CZE,0,71,0,5,76
2014,Tunisia,TUN,Czechia,CZE,0,0,0,5,5
2014,Turkey,TUR,Czechia,CZE,0,0,13,5,18
2014,Ukraine,UKR,Czechia,CZE,25,119,106,120,370
2014,Yemen,YEM,Czechia,CZE,0,0,10,0,10
2014,Stateless,XXA,Czechia,CZE,5,16,5,5,31
2014,Afghanistan,AFG,Denmark,DNK,10,67,128,0,205
2014,Albania,ALB,Denmark,DNK,0,0,39,0,39
2014,Algeria,DZA,Denmark,DNK,0,0,18,0,18
2014,Egypt,EGY,Denmark,DNK,0,0,17,0,17
2014,Armenia,ARM,Denmark,DNK,0,0,56,0,56
2014,Azerbaijan,AZE,Denmark,DNK,5,0,13,0,18
2014,Benin,BEN,Denmark,DNK,0,0,5,0,5
2014,Bangladesh,BGD,Denmark,DNK,0,0,69,0,69
2014,Burkina Faso,BFA,Denmark,DNK,0,0,5,0,5
2014,Belarus,BLR,Denmark,DNK,0,0,15,0,15
2014,Bosnia and Herzegovina,BIH,Denmark,DNK,0,0,23,0,23
2014,Bulgaria,BGR,Denmark,DNK,0,0,5,0,5
2014,China,CHN,Denmark,DNK,0,0,23,0,23
2014,Cameroon,CMR,Denmark,DNK,0,0,5,0,5
2014,Dem. Rep. of the Congo,COD,Denmark,DNK,5,0,14,0,19
2014,Eritrea,ERI,Denmark,DNK,193,17,10,0,220
2014,Ethiopia,ETH,Denmark,DNK,11,5,37,0,53
2014,Gambia,GMB,Denmark,DNK,0,0,5,0,5
2014,Georgia,GEO,Denmark,DNK,0,0,24,0,24
2014,Ghana,GHA,Denmark,DNK,0,0,23,0,23
2014,Croatia,HRV,Denmark,DNK,0,0,5,0,5
2014,Cote d'Ivoire,CIV,Denmark,DNK,0,0,5,0,5
2014,India,IND,Denmark,DNK,0,0,14,0,14
2014,Iran (Islamic Rep. of),IRN,Denmark,DNK,60,5,93,0,158
2014,Iraq,IRQ,Denmark,DNK,5,5,73,0,83
2014,Kazakhstan,KAZ,Denmark,DNK,0,0,5,0,5
2014,Kenya,KEN,Denmark,DNK,0,0,10,0,10
2014,Kyrgyzstan,KGZ,Denmark,DNK,0,0,5,0,5
2014,Liberia,LBR,Denmark,DNK,0,0,5,0,5
2014,Libya,LBY,Denmark,DNK,0,0,5,0,5
2014,Lebanon,LBN,Denmark,DNK,0,5,21,0,26
2014,Sri Lanka,LKA,Denmark,DNK,0,0,14,0,14
2014,Lithuania,LTU,Denmark,DNK,0,0,5,0,5
2014,North Macedonia,MKD,Denmark,DNK,0,0,18,0,18
2014,Mali,MLI,Denmark,DNK,0,0,5,0,5
2014,Morocco,MAR,Denmark,DNK,0,0,29,0,29
2014,Montenegro,MNE,Denmark,DNK,0,0,5,0,5
2014,Myanmar,MMR,Denmark,DNK,0,0,22,0,22
2014,Nepal,NPL,Denmark,DNK,0,0,5,0,5
2014,Nigeria,NGA,Denmark,DNK,0,0,38,0,38
2014,Pakistan,PAK,Denmark,DNK,0,0,33,0,33
2014,Poland,POL,Denmark,DNK,0,0,5,0,5
2014,Romania,ROU,Denmark,DNK,0,0,5,0,5
2014,Russian Federation,RUS,Denmark,DNK,25,66,245,0,336
2014,Serbia and Kosovo: S/RES/1244 (1999),SRB,Denmark,DNK,0,0,135,0,135
2014,Senegal,SEN,Denmark,DNK,0,0,5,0,5
2014,Sierra Leone,SLE,Denmark,DNK,0,0,5,0,5
2014,Somalia,SOM,Denmark,DNK,5,352,305,0,662
2014,Viet Nam,VNM,Denmark,DNK,0,0,5,0,5
2014,Sudan,SDN,Denmark,DNK,5,0,10,0,15
2014,Syrian Arab Rep.,SYR,Denmark,DNK,3122,864,137,0,4123
2014,Tajikistan,TJK,Denmark,DNK,0,0,5,0,5
2014,Tunisia,TUN,Denmark,DNK,0,0,11,0,11
2014,Uganda,UGA,Denmark,DNK,10,0,14,0,24
2014,Ukraine,UKR,Denmark,DNK,0,0,10,0,10
2014,Uzbekistan,UZB,Denmark,DNK,0,0,5,0,5
2014,Stateless,XXA,Denmark,DNK,291,256,68,0,615
2014,Unknown ,,Denmark,DNK,0,0,14,0,14
2014,Eritrea,ERI,Djibouti,DJI,17,0,0,48,65
2014,Ethiopia,ETH,Djibouti,DJI,42,0,0,18,60
2014,Iraq,IRQ,Djibouti,DJI,5,0,0,0,5
2014,Colombia,COL,Dominican Rep.,DOM,0,0,5,0,5
2014,Haiti,HTI,Dominican Rep.,DOM,0,0,20,32,52
2014,Egypt,EGY,Estonia,EST,0,0,5,0,5
2014,Belarus,BLR,Estonia,EST,0,0,0,5,5
2014,Georgia,GEO,Estonia,EST,0,0,5,0,5
2014,Russian Federation,RUS,Estonia,EST,0,0,5,5,10
2014,Serbia and Kosovo: S/RES/1244 (1999),SRB,Estonia,EST,5,0,0,0,5
2014,Sudan,SDN,Estonia,EST,5,0,0,0,5
2014,Syrian Arab Rep.,SYR,Estonia,EST,5,0,5,5,15
2014,Ukraine,UKR,Estonia,EST,0,0,5,10,15
2014,Afghanistan,AFG,Finland,FIN,24,95,33,54,206
2014,Albania,ALB,Finland,FIN,0,0,77,19,96
2014,Algeria,DZA,Finland,FIN,0,0,16,65,81
2014,Angola,AGO,Finland,FIN,10,5,10,11,36
2014,Egypt,EGY,Finland,FIN,5,0,5,13,23
2014,Bangladesh,BGD,Finland,FIN,0,5,11,5,21
2014,Burkina Faso,BFA,Finland,FIN,0,5,0,5,10
2014,Belarus,BLR,Finland,FIN,5,0,5,24,34
2014,Bosnia and Herzegovina,BIH,Finland,FIN,0,0,10,0,10
2014,China,CHN,Finland,FIN,10,0,0,5,15
2014,Cameroon,CMR,Finland,FIN,13,10,12,13,48
2014,Dem. Rep. of the Congo,COD,Finland,FIN,5,18,14,5,42
2014,Cuba,CUB,Finland,FIN,0,0,5,0,5
2014,Eritrea,ERI,Finland,FIN,0,5,0,0,5
2014,Ethiopia,ETH,Finland,FIN,0,10,5,10,25
2014,Gambia,GMB,Finland,FIN,5,10,34,27,76
2014,Georgia,GEO,Finland,FIN,0,0,10,17,27
2014,Ghana,GHA,Finland,FIN,5,10,20,21,56
2014,Guinea,GIN,Finland,FIN,0,5,5,5,15
2014,Cote d'Ivoire,CIV,Finland,FIN,0,0,0,5,5
2014,India,IND,Finland,FIN,0,0,5,0,5
2014,Iran (Islamic Rep. of),IRN,Finland,FIN,77,32,31,31,171
2014,Iraq,IRQ,Finland,FIN,123,243,134,289,789
2014,Israel,ISR,Finland,FIN,0,0,0,5,5
2014,Jordan,JOR,Finland,FIN,0,0,5,10,15
2014,Kenya,KEN,Finland,FIN,0,0,5,10,15
2014,Kyrgyzstan,KGZ,Finland,FIN,0,5,0,0,5
2014,Liberia,LBR,Finland,FIN,0,5,0,0,5
2014,Libya,LBY,Finland,FIN,0,0,0,30,30
2014,Lebanon,LBN,Finland,FIN,0,0,0,5,5
2014,Sri Lanka,LKA,Finland,FIN,5,5,5,10,25
2014,Mauritania,MRT,Finland,FIN,0,0,0,5,5
2014,Mali,MLI,Finland,FIN,0,0,5,0,5
2014,Morocco,MAR,Finland,FIN,5,0,10,61,76
2014,Mozambique,MOZ,Finland,FIN,0,0,0,5,5
2014,Montenegro,MNE,Finland,FIN,0,0,5,0,5
2014,Nigeria,NGA,Finland,FIN,5,63,78,97,243
2014,Pakistan,PAK,Finland,FIN,5,5,5,24,39
2014,Russian Federation,RUS,Finland,FIN,75,43,156,21,295
2014,El Salvador,SLV,Finland,FIN,0,5,0,0,5
2014,Saudi Arabia,SAU,Finland,FIN,0,0,0,5,5
2014,Serbia and Kosovo: S/RES/1244 (1999),SRB,Finland,FIN,0,18,84,28,130
2014,Senegal,SEN,Finland,FIN,0,0,5,5,10
2014,Somalia,SOM,Finland,FIN,33,125,14,74,246
2014,Viet Nam,VNM,Finland,FIN,0,0,10,5,15
2014,Sudan,SDN,Finland,FIN,0,0,5,5,10
2014,Syrian Arab Rep.,SYR,Finland,FIN,35,61,10,45,151
2014,Togo,TGO,Finland,FIN,0,0,0,5,5
2014,Tunisia,TUN,Finland,FIN,0,0,5,24,29
2014,Turkey,TUR,Finland,FIN,5,25,33,13,76
2014,Ukraine,UKR,Finland,FIN,0,5,200,53,258
2014,United States of America,USA,Finland,FIN,0,0,5,5,10
2014,Stateless,XXA,Finland,FIN,28,5,5,10,48
2014,Unknown ,,Finland,FIN,10,12,10,17,49
2014,Afghanistan,AFG,France,FRA,255,230,110,0,595
2014,Albania,ALB,France,FRA,67,277,3479,0,3823
2014,Algeria,DZA,France,FRA,48,23,986,0,1057
2014,Angola,AGO,France,FRA,28,10,357,0,395
2014,Egypt,EGY,France,FRA,120,5,279,0,404
2014,Armenia,ARM,France,FRA,59,29,1429,0,1517
2014,Azerbaijan,AZE,France,FRA,116,5,661,0,782
2014,Burundi,BDI,France,FRA,12,0,12,0,24
2014,Benin,BEN,France,FRA,0,0,21,0,21
2014,Bangladesh,BGD,France,FRA,194,10,3459,0,3663
2014,Bhutan,BTN,France,FRA,0,0,22,0,22
2014,Burkina Faso,BFA,France,FRA,0,0,31,0,31
2014,Belarus,BLR,France,FRA,10,0,47,0,57
2014,Bolivia (Plurinational State of),BOL,France,FRA,0,0,5,0,5
2014,Brazil,BRA,France,FRA,0,0,10,0,10
2014,Bosnia and Herzegovina,BIH,France,FRA,27,21,468,0,516
2014,Cambodia,KHM,France,FRA,0,0,31,0,31
2014,Central African Rep.,CAF,France,FRA,130,250,18,0,398
2014,Chad,TCD,France,FRA,24,0,208,0,232
2014,China,CHN,France,FRA,601,5,1955,0,2561
2014,Chile,CHL,France,FRA,0,0,5,0,5
2014,Cameroon,CMR,France,FRA,26,5,189,0,220
2014,Congo,COG,France,FRA,32,5,602,0,639
2014,Dem. Rep. of the Congo,COD,France,FRA,379,36,3706,0,4121
2014,Comoros,COM,France,FRA,32,5,532,0,569
2014,Colombia,COL,France,FRA,5,0,63,0,68
2014,Cuba,CUB,France,FRA,5,0,29,0,34
2014,Cabo Verde,CPV,France,FRA,0,0,10,0,10
2014,Djibouti,DJI,France,FRA,11,0,15,0,26
2014,Dominica,DMA,France,FRA,0,0,13,0,13
2014,Dominican Rep.,DOM,France,FRA,0,5,214,0,219
2014,Equatorial Guinea,GNQ,France,FRA,0,0,5,0,5
2014,Eritrea,ERI,France,FRA,69,0,404,0,473
2014,Ethiopia,ETH,France,FRA,15,0,38,0,53
2014,Gabon,GAB,France,FRA,0,0,15,0,15
2014,Gambia,GMB,France,FRA,20,0,52,0,72
2014,Palestinian,PSE,France,FRA,102,5,14,0,121
2014,Georgia,GEO,France,FRA,80,27,1704,0,1811
2014,Ghana,GHA,France,FRA,0,0,17,0,17
2014,Guinea-Bissau,GNB,France,FRA,5,0,107,0,112
2014,Guinea,GIN,France,FRA,436,45,1544,0,2025
2014,Guyana,GUY,France,FRA,5,0,46,0,51
2014,Haiti,HTI,France,FRA,13,13,1572,0,1598
2014,Honduras,HND,France,FRA,0,0,5,0,5
2014,Cote d'Ivoire,CIV,France,FRA,151,12,678,0,841
2014,India,IND,France,FRA,0,5,39,0,44
2014,Iran (Islamic Rep. of),IRN,France,FRA,88,11,50,0,149
2014,Iraq,IRQ,France,FRA,383,0,27,0,410
2014,Jamaica,JAM,France,FRA,0,0,5,0,5
2014,Kazakhstan,KAZ,France,FRA,22,0,98,0,120
2014,Kenya,KEN,France,FRA,5,5,10,0,20
2014,Kyrgyzstan,KGZ,France,FRA,15,0,29,0,44
2014,Dem. People's Rep. of Korea,PRK,France,FRA,13,0,24,0,37
2014,Liberia,LBR,France,FRA,0,0,10,0,10
2014,Libya,LBY,France,FRA,10,0,78,0,88
2014,Saint Lucia,LCA,France,FRA,0,0,10,0,10
2014,Lebanon,LBN,France,FRA,0,0,36,0,36
2014,Sri Lanka,LKA,France,FRA,407,39,1492,0,1938
2014,Madagascar,MDG,France,FRA,5,0,72,0,77
2014,Mauritania,MRT,France,FRA,78,5,733,0,816
2014,North Macedonia,MKD,France,FRA,5,0,140,0,145
2014,Rep. of Moldova,MDA,France,FRA,0,0,20,0,20
2014,Mexico,MEX,France,FRA,0,0,5,0,5
2014,Mali,MLI,France,FRA,264,19,1345,0,1628
2014,Mongolia,MNG,France,FRA,5,5,119,0,129
2014,Morocco,MAR,France,FRA,23,5,99,0,127
2014,Montenegro,MNE,France,FRA,5,5,144,0,154
2014,Myanmar,MMR,France,FRA,5,0,191,0,196
2014,Nepal,NPL,France,FRA,0,0,48,0,48
2014,Niger,NER,France,FRA,0,0,10,0,10
2014,Nigeria,NGA,France,FRA,30,38,784,0,852
2014,Pakistan,PAK,France,FRA,97,20,1577,0,1694
2014,Peru,PER,France,FRA,0,5,49,0,54
2014,Philippines,PHL,France,FRA,0,0,5,0,5
2014,South Africa,ZAF,France,FRA,0,0,10,0,10
2014,Russian Federation,RUS,France,FRA,459,38,2502,0,2999
2014,Rwanda,RWA,France,FRA,82,0,93,0,175
2014,Serbia and Kosovo: S/RES/1244 (1999),SRB,France,FRA,179,106,3632,0,3917
2014,Senegal,SEN,France,FRA,74,0,175,0,249
2014,Sierra Leone,SLE,France,FRA,11,0,43,0,54
2014,Somalia,SOM,France,FRA,22,36,460,0,518
2014,Viet Nam,VNM,France,FRA,5,0,35,0,40
2014,Sudan,SDN,France,FRA,159,11,1110,0,1280
2014,Syrian Arab Rep.,SYR,France,FRA,884,520,63,0,1467
2014,United Rep. of Tanzania,TZA,France,FRA,0,0,10,0,10
2014,Thailand,THA,France,FRA,0,0,5,0,5
2014,Turkmenistan,TKM,France,FRA,5,0,0,0,5
2014,Togo,TGO,France,FRA,11,0,122,0,133
2014,Tunisia,TUN,France,FRA,15,5,137,0,157
2014,Turkey,TUR,France,FRA,171,12,1739,0,1922
2014,Uganda,UGA,France,FRA,10,0,5,0,15
2014,Ukraine,UKR,France,FRA,20,0,171,0,191
2014,United States of America,USA,France,FRA,0,0,5,0,5
2014,Uzbekistan,UZB,France,FRA,11,0,15,0,26
2014,Venezuela (Bolivarian Republic of),VEN,France,FRA,0,0,17,0,17
2014,Western Sahara,ESH,France,FRA,84,0,156,0,240
2014,Yemen,YEM,France,FRA,5,5,10,0,20
2014,Unknown ,,France,FRA,5609,934,10659,0,17202
2014,Afghanistan,AFG,United Kingdom of Great Britain and Northern Ireland,GBR,437,91,703,290,1521
2014,Albania,ALB,United Kingdom of Great Britain and Northern Ireland,GBR,5,230,953,361,1549
2014,Algeria,DZA,United Kingdom of Great Britain and Northern Ireland,GBR,10,12,158,55,235
2014,Angola,AGO,United Kingdom of Great Britain and Northern Ireland,GBR,5,10,45,5,65
2014,Egypt,EGY,United Kingdom of Great Britain and Northern Ireland,GBR,29,20,149,47,245
2014,Armenia,ARM,United Kingdom of Great Britain and Northern Ireland,GBR,5,0,5,0,10
2014,Australia,AUS,United Kingdom of Great Britain and Northern Ireland,GBR,0,0,0,5,5
2014,Azerbaijan,AZE,United Kingdom of Great Britain and Northern Ireland,GBR,10,0,5,0,15
2014,Bahrain,BHR,United Kingdom of Great Britain and Northern Ireland,GBR,10,0,5,5,20
2014,Barbados,BRB,United Kingdom of Great Britain and Northern Ireland,GBR,0,0,0,5,5
2014,Burundi,BDI,United Kingdom of Great Britain and Northern Ireland,GBR,0,0,5,0,5
2014,Benin,BEN,United Kingdom of Great Britain and Northern Ireland,GBR,0,0,5,0,5
2014,Bangladesh,BGD,United Kingdom of Great Britain and Northern Ireland,GBR,52,18,625,160,855
2014,Bhutan,BTN,United Kingdom of Great Britain and Northern Ireland,GBR,5,0,5,0,10
2014,Burkina Faso,BFA,United Kingdom of Great Britain and Northern Ireland,GBR,0,0,5,0,5
2014,Belarus,BLR,United Kingdom of Great Britain and Northern Ireland,GBR,21,0,0,5,26
2014,Bolivia (Plurinational State of),BOL,United Kingdom of Great Britain and Northern Ireland,GBR,5,5,10,5,25
2014,Botswana,BWA,United Kingdom of Great Britain and Northern Ireland,GBR,0,0,12,0,12
2014,Brazil,BRA,United Kingdom of Great Britain and Northern Ireland,GBR,0,0,15,10,25
2014,Bosnia and Herzegovina,BIH,United Kingdom of Great Britain and Northern Ireland,GBR,0,0,14,10,24
2014,Canada,CAN,United Kingdom of Great Britain and Northern Ireland,GBR,0,0,0,5,5
2014,Chad,TCD,United Kingdom of Great Britain and Northern Ireland,GBR,5,0,5,0,10
2014,China,CHN,United Kingdom of Great Britain and Northern Ireland,GBR,40,37,921,133,1131
2014,Cameroon,CMR,United Kingdom of Great Britain and Northern Ireland,GBR,30,0,87,0,117
2014,Congo,COG,United Kingdom of Great Britain and Northern Ireland,GBR,5,0,15,0,20
2014,Dem. Rep. of the Congo,COD,United Kingdom of Great Britain and Northern Ireland,GBR,64,17,140,30,251
2014,Comoros,COM,United Kingdom of Great Britain and Northern Ireland,GBR,0,0,0,5,5
2014,Colombia,COL,United Kingdom of Great Britain and Northern Ireland,GBR,0,0,10,5,15
2014,Costa Rica,CRI,United Kingdom of Great Britain and Northern Ireland,GBR,0,0,5,0,5
2014,Czechia,CZE,United Kingdom of Great Britain and Northern Ireland,GBR,0,0,0,14,14
2014,Ecuador,ECU,United Kingdom of Great Britain and Northern Ireland,GBR,0,0,5,0,5
2014,Eritrea,ERI,United Kingdom of Great Britain and Northern Ireland,GBR,2184,13,199,163,2559
2014,Ethiopia,ETH,United Kingdom of Great Britain and Northern Ireland,GBR,50,0,74,35,159
2014,France,FRA,United Kingdom of Great Britain and Northern Ireland,GBR,0,0,0,5,5
2014,Gambia,GMB,United Kingdom of Great Britain and Northern Ireland,GBR,149,5,151,5,310
2014,Palestinian,PSE,United Kingdom of Great Britain and Northern Ireland,GBR,58,10,65,27,160
2014,Georgia,GEO,United Kingdom of Great Britain and Northern Ireland,GBR,0,0,36,10,46
2014,Ghana,GHA,United Kingdom of Great Britain and Northern Ireland,GBR,14,10,125,28,177
2014,Greece,GRC,United Kingdom of Great Britain and Northern Ireland,GBR,0,0,5,0,5
2014,Grenada,GRD,United Kingdom of Great Britain and Northern Ireland,GBR,0,0,5,0,5
2014,Guinea,GIN,United Kingdom of Great Britain and Northern Ireland,GBR,12,0,35,0,47
2014,Guyana,GUY,United Kingdom of Great Britain and Northern Ireland,GBR,0,0,5,0,5
2014,Honduras,HND,United Kingdom of Great Britain and Northern Ireland,GBR,5,0,5,0,10
2014,Cote d'Ivoire,CIV,United Kingdom of Great Britain and Northern Ireland,GBR,10,0,58,0,68
2014,India,IND,United Kingdom of Great Britain and Northern Ireland,GBR,5,17,709,252,983
2014,Indonesia,IDN,United Kingdom of Great Britain and Northern Ireland,GBR,0,0,14,0,14
2014,Iran (Islamic Rep. of),IRN,United Kingdom of Great Britain and Northern Ireland,GBR,1215,43,943,203,2404
2014,Iraq,IRQ,United Kingdom of Great Britain and Northern Ireland,GBR,178,29,347,75,629
2014,Israel,ISR,United Kingdom of Great Britain and Northern Ireland,GBR,0,0,5,0,5
2014,Jamaica,JAM,United Kingdom of Great Britain and Northern Ireland,GBR,13,5,97,16,131
2014,Jordan,JOR,United Kingdom of Great Britain and Northern Ireland,GBR,5,0,22,5,32
2014,Japan,JPN,United Kingdom of Great Britain and Northern Ireland,GBR,0,0,5,0,5
2014,Kazakhstan,KAZ,United Kingdom of Great Britain and Northern Ireland,GBR,0,0,5,0,5
2014,Kenya,KEN,United Kingdom of Great Britain and Northern Ireland,GBR,15,5,51,5,76
2014,Rep. of Korea,KOR,United Kingdom of Great Britain and Northern Ireland,GBR,0,0,5,5,10
2014,Dem. People's Rep. of Korea,PRK,United Kingdom of Great Britain and Northern Ireland,GBR,5,5,23,5,38
2014,Kuwait,KWT,United Kingdom of Great Britain and Northern Ireland,GBR,29,0,15,5,49
2014,Liberia,LBR,United Kingdom of Great Britain and Northern Ireland,GBR,0,0,10,0,10
2014,Libya,LBY,United Kingdom of Great Britain and Northern Ireland,GBR,109,5,240,47,401
2014,Lebanon,LBN,United Kingdom of Great Britain and Northern Ireland,GBR,13,0,46,16,75
2014,Sri Lanka,LKA,United Kingdom of Great Britain and Northern Ireland,GBR,171,31,1373,102,1677
2014,Lithuania,LTU,United Kingdom of Great Britain and Northern Ireland,GBR,0,0,15,10,25
2014,Latvia,LVA,United Kingdom of Great Britain and Northern Ireland,GBR,0,0,11,0,11
2014,North Macedonia,MKD,United Kingdom of Great Britain and Northern Ireland,GBR,5,5,0,0,10
2014,Rep. of Moldova,MDA,United Kingdom of Great Britain and Northern Ireland,GBR,0,0,5,5,10
2014,Mali,MLI,United Kingdom of Great Britain and Northern Ireland,GBR,0,0,5,5,10
2014,Malaysia,MYS,United Kingdom of Great Britain and Northern Ireland,GBR,10,5,26,13,54
2014,Malawi,MWI,United Kingdom of Great Britain and Northern Ireland,GBR,10,10,86,20,126
2014,Mongolia,MNG,United Kingdom of Great Britain and Northern Ireland,GBR,0,0,27,0,27
2014,Morocco,MAR,United Kingdom of Great Britain and Northern Ireland,GBR,5,12,37,12,66
2014,Mauritius,MUS,United Kingdom of Great Britain and Northern Ireland,GBR,0,0,50,12,62
2014,Myanmar,MMR,United Kingdom of Great Britain and Northern Ireland,GBR,41,0,46,0,87
2014,Namibia,NAM,United Kingdom of Great Britain and Northern Ireland,GBR,0,0,16,5,21
2014,Nepal,NPL,United Kingdom of Great Britain and Northern Ireland,GBR,0,0,37,10,47
2014,Niger,NER,United Kingdom of Great Britain and Northern Ireland,GBR,0,0,0,5,5
2014,Nigeria,NGA,United Kingdom of Great Britain and Northern Ireland,GBR,156,98,1040,117,1411
2014,Norway,NOR,United Kingdom of Great Britain and Northern Ireland,GBR,5,0,0,0,5
2014,Pakistan,PAK,United Kingdom of Great Britain and Northern Ireland,GBR,718,52,2610,435,3815
2014,Philippines,PHL,United Kingdom of Great Britain and Northern Ireland,GBR,0,0,31,5,36
2014,Poland,POL,United Kingdom of Great Britain and Northern Ireland,GBR,0,0,108,57,165
2014,Portugal,PRT,United Kingdom of Great Britain and Northern Ireland,GBR,0,0,5,0,5
2014,Romania,ROU,United Kingdom of Great Britain and Northern Ireland,GBR,0,0,30,5,35
2014,South Africa,ZAF,United Kingdom of Great Britain and Northern Ireland,GBR,5,5,57,10,77
2014,Russian Federation,RUS,United Kingdom of Great Britain and Northern Ireland,GBR,33,0,57,10,100
2014,Rwanda,RWA,United Kingdom of Great Britain and Northern Ireland,GBR,10,5,5,0,20
2014,El Salvador,SLV,United Kingdom of Great Britain and Northern Ireland,GBR,5,0,23,5,33
2014,Saudi Arabia,SAU,United Kingdom of Great Britain and Northern Ireland,GBR,5,0,17,14,36
2014,Serbia and Kosovo: S/RES/1244 (1999),SRB,United Kingdom of Great Britain and Northern Ireland,GBR,0,0,78,14,92
2014,Senegal,SEN,United Kingdom of Great Britain and Northern Ireland,GBR,0,0,17,5,22
2014,Seychelles,SYC,United Kingdom of Great Britain and Northern Ireland,GBR,0,0,5,0,5
2014,Sierra Leone,SLE,United Kingdom of Great Britain and Northern Ireland,GBR,19,5,64,15,103
2014,Somalia,SOM,United Kingdom of Great Britain and Northern Ireland,GBR,173,19,173,62,427
2014,Viet Nam,VNM,United Kingdom of Great Britain and Northern Ireland,GBR,41,38,148,133,360
2014,Sudan,SDN,United Kingdom of Great Britain and Northern Ireland,GBR,881,5,154,121,1161
2014,South Sudan,SSD,United Kingdom of Great Britain and Northern Ireland,GBR,5,5,0,0,10
2014,Eswatini,SWZ,United Kingdom of Great Britain and Northern Ireland,GBR,10,0,5,0,15
2014,Syrian Arab Rep.,SYR,United Kingdom of Great Britain and Northern Ireland,GBR,1391,31,112,183,1717
2014,United Rep. of Tanzania,TZA,United Kingdom of Great Britain and Northern Ireland,GBR,5,5,18,5,33
2014,Thailand,THA,United Kingdom of Great Britain and Northern Ireland,GBR,0,0,5,0,5
2014,Trinidad and Tobago,TTO,United Kingdom of Great Britain and Northern Ireland,GBR,0,0,26,0,26
2014,Tunisia,TUN,United Kingdom of Great Britain and Northern Ireland,GBR,0,0,37,12,49
2014,Turkey,TUR,United Kingdom of Great Britain and Northern Ireland,GBR,38,37,187,29,291
2014,United Arab Emirates,ARE,United Kingdom of Great Britain and Northern Ireland,GBR,5,0,0,5,10
2014,Uganda,UGA,United Kingdom of Great Britain and Northern Ireland,GBR,125,10,122,11,268
2014,Ukraine,UKR,United Kingdom of Great Britain and Northern Ireland,GBR,0,5,153,55,213
2014,United States of America,USA,United Kingdom of Great Britain and Northern Ireland,GBR,5,0,31,15,51
2014,Uzbekistan,UZB,United Kingdom of Great Britain and Northern Ireland,GBR,0,0,13,5,18
2014,Venezuela (Bolivarian Republic of),VEN,United Kingdom of Great Britain and Northern Ireland,GBR,5,0,23,5,33
2014,Western Sahara,ESH,United Kingdom of Great Britain and Northern Ireland,GBR,0,0,5,0,5
2014,Yemen,YEM,United Kingdom of Great Britain and Northern Ireland,GBR,13,5,61,10,89
2014,Zambia,ZMB,United Kingdom of Great Britain and Northern Ireland,GBR,5,5,16,5,31
2014,Zimbabwe,ZWE,United Kingdom of Great Britain and Northern Ireland,GBR,49,27,196,15,287
2014,Stateless,XXA,United Kingdom of Great Britain and Northern Ireland,GBR,209,5,96,20,330
2014,Unknown ,,United Kingdom of Great Britain and Northern Ireland,GBR,5,0,17,12,34
2014,Afghanistan,AFG,Georgia,GEO,0,0,0,5,5
2014,Egypt,EGY,Georgia,GEO,0,5,26,24,55
2014,Azerbaijan,AZE,Georgia,GEO,5,0,0,5,10
2014,Bangladesh,BGD,Georgia,GEO,0,0,0,5,5
2014,Iran (Islamic Rep. of),IRN,Georgia,GEO,0,0,10,16,26
2014,Iraq,IRQ,Georgia,GEO,28,62,138,381,609
2014,Sri Lanka,LKA,Georgia,GEO,0,0,0,5,5
2014,Nigeria,NGA,Georgia,GEO,0,0,5,0,5
2014,Pakistan,PAK,Georgia,GEO,0,0,5,0,5
2014,Russian Federation,RUS,Georgia,GEO,0,0,5,10,15
2014,Sudan,SDN,Georgia,GEO,0,0,5,5,10
2014,Syrian Arab Rep.,SYR,Georgia,GEO,0,37,15,24,76
2014,Turkey,TUR,Georgia,GEO,0,0,5,0,5
2014,Ukraine,UKR,Georgia,GEO,0,0,5,64,69
2014,Central African Rep.,CAF,Ghana,GHA,26,0,0,0,26
2014,Chad,TCD,Ghana,GHA,0,0,0,18,18
2014,Cameroon,CMR,Ghana,GHA,0,0,0,5,5
2014,Dem. Rep. of the Congo,COD,Ghana,GHA,15,0,0,0,15
2014,Eritrea,ERI,Ghana,GHA,5,0,0,5,10
2014,Liberia,LBR,Ghana,GHA,0,0,5,0,5
2014,Nigeria,NGA,Ghana,GHA,5,0,0,0,5
2014,Pakistan,PAK,Ghana,GHA,10,0,0,0,10
2014,Rwanda,RWA,Ghana,GHA,0,0,0,14,14
2014,Somalia,SOM,Ghana,GHA,12,0,0,0,12
2014,Sudan,SDN,Ghana,GHA,50,0,0,0,50
2014,Syrian Arab Rep.,SYR,Ghana,GHA,5,0,0,0,5
2014,Togo,TGO,Ghana,GHA,5,0,0,52,57
2014,Uganda,UGA,Ghana,GHA,5,0,0,5,10
2014,Afghanistan,AFG,Greece,GRC,219,288,1418,1545,3470
2014,Albania,ALB,Greece,GRC,5,5,957,313,1280
2014,Algeria,DZA,Greece,GRC,5,0,136,98,239
2014,Angola,AGO,Greece,GRC,0,0,5,0,5
2014,Egypt,EGY,Greece,GRC,10,0,396,164,570
2014,Armenia,ARM,Greece,GRC,0,5,66,25,96
2014,Azerbaijan,AZE,Greece,GRC,0,0,5,0,5
2014,Benin,BEN,Greece,GRC,0,0,0,5,5
2014,Bangladesh,BGD,Greece,GRC,13,5,625,449,1092
2014,Burkina Faso,BFA,Greece,GRC,0,0,16,41,57
2014,Belarus,BLR,Greece,GRC,0,0,5,0,5
2014,Central African Rep.,CAF,Greece,GRC,0,0,0,5,5
2014,Chad,TCD,Greece,GRC,0,0,0,5,5
2014,China,CHN,Greece,GRC,0,0,210,100,310
2014,Cameroon,CMR,Greece,GRC,5,0,73,156,234
2014,Congo,COG,Greece,GRC,0,5,46,90,141
2014,Dem. Rep. of the Congo,COD,Greece,GRC,18,0,89,55,162
2014,Comoros,COM,Greece,GRC,0,0,13,33,46
2014,Cuba,CUB,Greece,GRC,0,0,5,0,5
2014,Dominican Rep.,DOM,Greece,GRC,0,0,15,12,27
2014,Equatorial Guinea,GNQ,Greece,GRC,0,0,0,5,5
2014,Eritrea,ERI,Greece,GRC,128,5,140,140,413
2014,Ethiopia,ETH,Greece,GRC,37,5,133,45,220
2014,Gambia,GMB,Greece,GRC,0,0,22,36,58
2014,Palestinian,PSE,Greece,GRC,10,0,81,142,233
2014,Georgia,GEO,Greece,GRC,0,12,1093,625,1730
2014,Ghana,GHA,Greece,GRC,0,0,68,145,213
2014,Guinea,GIN,Greece,GRC,5,0,67,77,149
2014,Cote d'Ivoire,CIV,Greece,GRC,5,0,93,198,296
2014,India,IND,Greece,GRC,0,0,91,77,168
2014,Indonesia,IDN,Greece,GRC,0,0,17,10,27
2014,Iran (Islamic Rep. of),IRN,Greece,GRC,110,11,231,213,565
2014,Iraq,IRQ,Greece,GRC,42,40,467,370,919
2014,Kazakhstan,KAZ,Greece,GRC,0,0,5,5,10
2014,Kenya,KEN,Greece,GRC,0,0,31,18,49
2014,Liberia,LBR,Greece,GRC,0,0,5,12,17
2014,Libya,LBY,Greece,GRC,0,0,18,0,18
2014,Lebanon,LBN,Greece,GRC,0,0,17,17,34
2014,Sri Lanka,LKA,Greece,GRC,5,0,42,40,87
2014,Mauritania,MRT,Greece,GRC,10,0,28,19,57
2014,Rep. of Moldova,MDA,Greece,GRC,0,0,30,30,60
2014,Mali,MLI,Greece,GRC,0,0,27,81,108
2014,Morocco,MAR,Greece,GRC,10,0,105,71,186
2014,Myanmar,MMR,Greece,GRC,5,0,0,0,5
2014,Nepal,NPL,Greece,GRC,0,0,10,0,10
2014,Nigeria,NGA,Greece,GRC,22,0,341,280,643
2014,Pakistan,PAK,Greece,GRC,14,55,2130,1615,3814
2014,Philippines,PHL,Greece,GRC,0,0,38,22,60
2014,Russian Federation,RUS,Greece,GRC,5,0,36,37,78
2014,Rwanda,RWA,Greece,GRC,0,0,5,15,20
2014,Serbia and Kosovo: S/RES/1244 (1999),SRB,Greece,GRC,5,0,5,5,15
2014,Senegal,SEN,Greece,GRC,0,0,91,225,316
2014,Sierra Leone,SLE,Greece,GRC,0,0,29,39,68
2014,Somalia,SOM,Greece,GRC,11,38,172,165,386
2014,Viet Nam,VNM,Greece,GRC,5,0,0,5,10
2014,Sudan,SDN,Greece,GRC,96,24,170,153,443
2014,Syrian Arab Rep.,SYR,Greece,GRC,430,165,394,503,1492
2014,United Rep. of Tanzania,TZA,Greece,GRC,0,0,21,23,44
2014,Togo,TGO,Greece,GRC,0,0,5,5,10
2014,Tunisia,TUN,Greece,GRC,0,0,41,23,64
2014,Turkey,TUR,Greece,GRC,15,5,55,58,133
2014,Uganda,UGA,Greece,GRC,0,0,0,5,5
2014,Ukraine,UKR,Greece,GRC,0,5,78,39,122
2014,Uzbekistan,UZB,Greece,GRC,0,0,5,0,5
2014,Venezuela (Bolivarian Republic of),VEN,Greece,GRC,0,0,5,0,5
2014,Yemen,YEM,Greece,GRC,0,0,0,5,5
2014,Zimbabwe,ZWE,Greece,GRC,0,0,5,0,5
2014,Stateless,XXA,Greece,GRC,13,0,5,11,29
2014,Unknown ,,Greece,GRC,0,0,29,16,45
2014,Honduras,HND,Guatemala,GTM,10,0,0,0,10
2014,El Salvador,SLV,Guatemala,GTM,5,0,0,10,15
2014,Central African Rep.,CAF,Guinea,GIN,40,0,0,0,40
2014,Dem. Rep. of the Congo,COD,Guinea,GIN,5,5,5,0,15
2014,Cote d'Ivoire,CIV,Guinea,GIN,11,0,41,0,52
2014,Liberia,LBR,Guinea,GIN,24,0,45,5,74
2014,Sri Lanka,LKA,Guinea,GIN,13,0,10,0,23
2014,Niger,NER,Guinea,GIN,5,0,0,0,5
2014,Sierra Leone,SLE,Guinea,GIN,25,0,55,0,80
2014,Afghanistan,AFG,Croatia,HRV,0,0,5,15,20
2014,Algeria,DZA,Croatia,HRV,0,0,46,35,81
2014,Egypt,EGY,Croatia,HRV,0,0,20,5,25
2014,Bangladesh,BGD,Croatia,HRV,0,0,0,15,15
2014,Belarus,BLR,Croatia,HRV,5,0,0,0,5
2014,Bosnia and Herzegovina,BIH,Croatia,HRV,0,0,10,0,10
2014,Dem. Rep. of the Congo,COD,Croatia,HRV,0,0,0,5,5
2014,Comoros,COM,Croatia,HRV,0,0,0,5,5
2014,Eritrea,ERI,Croatia,HRV,0,0,0,5,5
2014,Gambia,GMB,Croatia,HRV,0,0,0,5,5
2014,Palestinian,PSE,Croatia,HRV,0,0,0,11,11
2014,Ghana,GHA,Croatia,HRV,0,0,5,5,10
2014,Cote d'Ivoire,CIV,Croatia,HRV,0,0,0,11,11
2014,Iran (Islamic Rep. of),IRN,Croatia,HRV,0,0,0,5,5
2014,Libya,LBY,Croatia,HRV,0,0,0,5,5
2014,Mali,MLI,Croatia,HRV,0,0,5,10,15
2014,Morocco,MAR,Croatia,HRV,0,0,17,11,28
2014,Nigeria,NGA,Croatia,HRV,5,0,12,24,41
2014,Pakistan,PAK,Croatia,HRV,0,0,5,27,32
2014,Serbia and Kosovo: S/RES/1244 (1999),SRB,Croatia,HRV,0,0,5,5,10
2014,Senegal,SEN,Croatia,HRV,0,0,0,5,5
2014,Somalia,SOM,Croatia,HRV,0,5,0,10,15
2014,Syrian Arab Rep.,SYR,Croatia,HRV,0,0,0,84,84
2014,Tunisia,TUN,Croatia,HRV,0,0,14,36,50
2014,Turkey,TUR,Croatia,HRV,0,0,5,0,5
2014,Ukraine,UKR,Croatia,HRV,0,0,5,5,10
2014,Unknown ,,Croatia,HRV,0,0,13,0,13
2014,Afghanistan,AFG,Hungary,HUN,17,58,236,6564,6875
2014,Albania,ALB,Hungary,HUN,0,0,10,34,44
2014,Algeria,DZA,Hungary,HUN,0,0,56,69,125
2014,Egypt,EGY,Hungary,HUN,0,0,16,17,33
2014,Azerbaijan,AZE,Hungary,HUN,0,0,5,0,5
2014,Bangladesh,BGD,Hungary,HUN,0,0,41,183,224
2014,Burkina Faso,BFA,Hungary,HUN,0,0,5,5,10
2014,Bosnia and Herzegovina,BIH,Hungary,HUN,0,0,5,5,10
2014,Central African Rep.,CAF,Hungary,HUN,0,0,0,5,5
2014,China,CHN,Hungary,HUN,0,0,5,10,15
2014,Cameroon,CMR,Hungary,HUN,0,0,5,91,96
2014,Congo,COG,Hungary,HUN,0,0,13,77,90
2014,Dem. Rep. of the Congo,COD,Hungary,HUN,0,0,5,53,58
2014,Comoros,COM,Hungary,HUN,0,0,10,67,77
2014,Costa Rica,CRI,Hungary,HUN,0,0,0,43,43
2014,Cuba,CUB,Hungary,HUN,12,0,43,72,127
2014,Eritrea,ERI,Hungary,HUN,10,20,5,103,138
2014,Ethiopia,ETH,Hungary,HUN,0,0,0,5,5
2014,Gambia,GMB,Hungary,HUN,0,0,14,71,85
2014,Palestinian,PSE,Hungary,HUN,14,11,25,819,869
2014,Georgia,GEO,Hungary,HUN,5,0,11,25,41
2014,Ghana,GHA,Hungary,HUN,0,0,44,172,216
2014,Guinea,GIN,Hungary,HUN,0,0,23,29,52
2014,Cote d'Ivoire,CIV,Hungary,HUN,5,0,26,83,114
2014,India,IND,Hungary,HUN,0,0,10,10,20
2014,Iran (Islamic Rep. of),IRN,Hungary,HUN,5,0,22,201,228
2014,Iraq,IRQ,Hungary,HUN,5,15,10,335,365
2014,Jordan,JOR,Hungary,HUN,0,0,0,5,5
2014,Kenya,KEN,Hungary,HUN,0,0,5,5,10
2014,Liberia,LBR,Hungary,HUN,0,0,0,5,5
2014,Libya,LBY,Hungary,HUN,0,0,12,14,26
2014,Lebanon,LBN,Hungary,HUN,0,0,0,5,5
2014,Sri Lanka,LKA,Hungary,HUN,0,0,5,11,16
2014,Mauritania,MRT,Hungary,HUN,0,0,14,17,31
2014,North Macedonia,MKD,Hungary,HUN,0,0,0,10,10
2014,Rep. of Moldova,MDA,Hungary,HUN,0,0,5,5,10
2014,Mali,MLI,Hungary,HUN,0,0,19,113,132
2014,Mongolia,MNG,Hungary,HUN,0,0,0,5,5
2014,Morocco,MAR,Hungary,HUN,0,0,24,31,55
2014,Montenegro,MNE,Hungary,HUN,0,0,0,5,5
2014,Nigeria,NGA,Hungary,HUN,5,0,97,192,294
2014,Pakistan,PAK,Hungary,HUN,0,0,128,289,417
2014,Russian Federation,RUS,Hungary,HUN,0,0,5,10,15
2014,Rwanda,RWA,Hungary,HUN,0,0,0,17,17
2014,Serbia and Kosovo: S/RES/1244 (1999),SRB,Hungary,HUN,0,0,3536,7612,11148
2014,Senegal,SEN,Hungary,HUN,0,0,54,37,91
2014,Sierra Leone,SLE,Hungary,HUN,0,0,10,39,49
2014,Somalia,SOM,Hungary,HUN,18,48,5,158,229
2014,Viet Nam,VNM,Hungary,HUN,0,0,13,11,24
2014,Sudan,SDN,Hungary,HUN,5,10,19,76,110
2014,Syrian Arab Rep.,SYR,Hungary,HUN,110,61,91,5991,6253
2014,United Rep. of Tanzania,TZA,Hungary,HUN,0,0,0,5,5
2014,Togo,TGO,Hungary,HUN,0,0,5,5,10
2014,Tunisia,TUN,Hungary,HUN,0,0,11,39,50
2014,Turkey,TUR,Hungary,HUN,0,0,12,93,105
2014,Uganda,UGA,Hungary,HUN,0,0,5,5,10
2014,Ukraine,UKR,Hungary,HUN,0,0,17,20,37
2014,Western Sahara,ESH,Hungary,HUN,0,0,0,5,5
2014,Yemen,YEM,Hungary,HUN,0,0,0,12,12
2014,Stateless,XXA,Hungary,HUN,0,5,0,5,10
2014,Unknown ,,Hungary,HUN,18,5,65,317,405
2014,Afghanistan,AFG,Iceland,ISL,5,0,0,0,5
2014,Albania,ALB,Iceland,ISL,0,0,10,0,10
2014,Azerbaijan,AZE,Iceland,ISL,0,0,5,0,5
2014,Colombia,COL,Iceland,ISL,0,0,5,0,5
2014,Georgia,GEO,Iceland,ISL,0,0,5,0,5
2014,Iran (Islamic Rep. of),IRN,Iceland,ISL,5,0,5,0,10
2014,Iraq,IRQ,Iceland,ISL,0,0,5,0,5
2014,Nigeria,NGA,Iceland,ISL,0,0,5,0,5
2014,Syrian Arab Rep.,SYR,Iceland,ISL,0,0,5,0,5
2014,Ukraine,UKR,Iceland,ISL,0,5,5,0,10
2014,Stateless,XXA,Iceland,ISL,5,0,5,0,10
2014,Afghanistan,AFG,Ireland,IRL,5,0,10,5,20
2014,Albania,ALB,Ireland,IRL,5,0,41,10,56
2014,Algeria,DZA,Ireland,IRL,0,0,43,13,56
2014,Angola,AGO,Ireland,IRL,0,0,5,0,5
2014,Egypt,EGY,Ireland,IRL,5,0,0,5,10
2014,Bangladesh,BGD,Ireland,IRL,0,0,27,17,44
2014,Botswana,BWA,Ireland,IRL,0,0,5,0,5
2014,China,CHN,Ireland,IRL,0,0,5,16,21
2014,Cameroon,CMR,Ireland,IRL,5,0,14,0,19
2014,Dem. Rep. of the Congo,COD,Ireland,IRL,5,0,44,10,59
2014,Ethiopia,ETH,Ireland,IRL,5,0,5,0,10
2014,Palestinian,PSE,Ireland,IRL,10,0,0,0,10
2014,Georgia,GEO,Ireland,IRL,0,0,5,5,10
2014,Ghana,GHA,Ireland,IRL,0,0,5,0,5
2014,Honduras,HND,Ireland,IRL,5,0,0,0,5
2014,India,IND,Ireland,IRL,0,0,5,10,15
2014,Iran (Islamic Rep. of),IRN,Ireland,IRL,10,0,5,5,20
2014,Iraq,IRQ,Ireland,IRL,11,0,10,5,26
2014,Israel,ISR,Ireland,IRL,0,0,5,0,5
2014,Kuwait,KWT,Ireland,IRL,0,0,5,0,5
2014,Lesotho,LSO,Ireland,IRL,0,0,5,0,5
2014,Malaysia,MYS,Ireland,IRL,0,0,5,5,10
2014,Malawi,MWI,Ireland,IRL,10,0,53,5,68
2014,Mozambique,MOZ,Ireland,IRL,0,0,5,0,5
2014,Mauritius,MUS,Ireland,IRL,0,0,16,0,16
2014,Nepal,NPL,Ireland,IRL,0,0,0,5,5
2014,Nigeria,NGA,Ireland,IRL,0,0,92,36,128
2014,Pakistan,PAK,Ireland,IRL,10,0,61,70,141
2014,South Africa,ZAF,Ireland,IRL,0,0,53,0,53
2014,Saudi Arabia,SAU,Ireland,IRL,5,0,0,0,5
2014,Serbia and Kosovo: S/RES/1244 (1999),SRB,Ireland,IRL,0,0,5,0,5
2014,Sudan,SDN,Ireland,IRL,5,0,5,0,10
2014,Eswatini,SWZ,Ireland,IRL,0,0,10,0,10
2014,Syrian Arab Rep.,SYR,Ireland,IRL,20,0,0,5,25
2014,Ukraine,UKR,Ireland,IRL,5,0,22,5,32
2014,Venezuela (Bolivarian Republic of),VEN,Ireland,IRL,0,0,19,0,19
2014,Zimbabwe,ZWE,Ireland,IRL,5,0,54,10,69
2014,Afghanistan,AFG,Italy,ITA,255,2143,119,5,2522
2014,Albania,ALB,Italy,ITA,12,56,73,0,141
2014,Algeria,DZA,Italy,ITA,0,24,57,0,81
2014,Angola,AGO,Italy,ITA,0,5,0,0,5
2014,Egypt,EGY,Italy,ITA,81,483,201,0,765
2014,Armenia,ARM,Italy,ITA,21,52,26,0,99
2014,Benin,BEN,Italy,ITA,0,15,21,0,36
2014,Bangladesh,BGD,Italy,ITA,30,283,423,0,736
2014,Burkina Faso,BFA,Italy,ITA,0,99,72,0,171
2014,Belarus,BLR,Italy,ITA,0,5,0,0,5
2014,Bolivia (Plurinational State of),BOL,Italy,ITA,0,5,5,0,10
2014,Brazil,BRA,Italy,ITA,0,12,5,0,17
2014,Bosnia and Herzegovina,BIH,Italy,ITA,0,106,55,0,161
2014,Central African Rep.,CAF,Italy,ITA,10,10,0,0,20
2014,Chad,TCD,Italy,ITA,5,33,5,0,43
2014,China,CHN,Italy,ITA,12,10,12,0,34
2014,Cameroon,CMR,Italy,ITA,41,41,25,0,107
2014,Congo,COG,Italy,ITA,14,19,5,0,38
2014,Dem. Rep. of the Congo,COD,Italy,ITA,36,36,5,0,77
2014,Colombia,COL,Italy,ITA,32,42,10,0,84
2014,Cuba,CUB,Italy,ITA,0,23,19,0,42
2014,Ecuador,ECU,Italy,ITA,0,5,0,0,5
2014,Eritrea,ERI,Italy,ITA,851,448,156,0,1455
2014,Ethiopia,ETH,Italy,ITA,92,125,37,0,254
2014,Gabon,GAB,Italy,ITA,0,5,5,0,10
2014,Gambia,GMB,Italy,ITA,121,1163,2117,0,3401
2014,Palestinian,PSE,Italy,ITA,91,27,23,0,141
2014,Georgia,GEO,Italy,ITA,0,23,37,0,60
2014,Ghana,GHA,Italy,ITA,23,324,531,0,878
2014,Guinea-Bissau,GNB,Italy,ITA,0,89,103,0,192
2014,Guinea,GIN,Italy,ITA,13,238,182,0,433
2014,Cote d'Ivoire,CIV,Italy,ITA,51,492,163,0,706
2014,India,IND,Italy,ITA,5,17,18,0,40
2014,Iran (Islamic Rep. of),IRN,Italy,ITA,221,101,52,0,374
2014,Iraq,IRQ,Italy,ITA,97,605,68,5,775
2014,Kazakhstan,KAZ,Italy,ITA,5,0,0,0,5
2014,Kenya,KEN,Italy,ITA,5,5,0,0,10
2014,Liberia,LBR,Italy,ITA,0,51,39,5,95
2014,Libya,LBY,Italy,ITA,5,33,10,0,48
2014,Lebanon,LBN,Italy,ITA,5,26,20,0,51
2014,Sri Lanka,LKA,Italy,ITA,11,36,27,0,74
2014,Madagascar,MDG,Italy,ITA,0,5,0,0,5
2014,Mauritania,MRT,Italy,ITA,15,25,28,0,68
2014,North Macedonia,MKD,Italy,ITA,0,10,5,0,15
2014,Rep. of Moldova,MDA,Italy,ITA,0,5,0,0,5
2014,Mali,MLI,Italy,ITA,29,1954,1885,0,3868
2014,Morocco,MAR,Italy,ITA,13,35,166,0,214
2014,Montenegro,MNE,Italy,ITA,0,18,15,0,33
2014,Mauritius,MUS,Italy,ITA,0,0,5,0,5
2014,Myanmar,MMR,Italy,ITA,5,0,0,0,5
2014,Nepal,NPL,Italy,ITA,0,0,33,0,33
2014,Niger,NER,Italy,ITA,5,41,30,0,76
2014,Nicaragua,NIC,Italy,ITA,0,0,5,0,5
2014,Nigeria,NGA,Italy,ITA,137,2007,3014,0,5158
2014,Pakistan,PAK,Italy,ITA,386,2018,2258,0,4662
2014,Peru,PER,Italy,ITA,0,5,5,0,10
2014,Philippines,PHL,Italy,ITA,0,5,5,0,10
2014,Russian Federation,RUS,Italy,ITA,18,15,13,0,46
2014,El Salvador,SLV,Italy,ITA,5,42,13,0,60
2014,Serbia and Kosovo: S/RES/1244 (1999),SRB,Italy,ITA,5,100,142,5,252
2014,Senegal,SEN,Italy,ITA,43,828,1129,0,2000
2014,Sierra Leone,SLE,Italy,ITA,0,62,40,0,102
2014,Somalia,SOM,Italy,ITA,373,1500,106,0,1979
2014,Sudan,SDN,Italy,ITA,62,112,45,0,219
2014,Syrian Arab Rep.,SYR,Italy,ITA,229,84,176,0,489
2014,Togo,TGO,Italy,ITA,19,93,49,0,161
2014,Tunisia,TUN,Italy,ITA,11,101,318,0,430
2014,Turkey,TUR,Italy,ITA,67,260,173,0,500
2014,Ukraine,UKR,Italy,ITA,10,155,80,0,245
2014,Venezuela (Bolivarian Republic of),VEN,Italy,ITA,10,5,5,0,20
2014,Yemen,YEM,Italy,ITA,10,17,5,0,32
2014,Unknown ,,Italy,ITA,21,104,95,0,220
2014,Afghanistan,AFG,Japan,JPN,0,0,12,0,12
2014,Egypt,EGY,Japan,JPN,0,0,5,0,5
2014,Bangladesh,BGD,Japan,JPN,0,0,109,10,119
2014,Brazil,BRA,Japan,JPN,0,0,5,5,10
2014,China,CHN,Japan,JPN,0,0,38,12,50
2014,Cameroon,CMR,Japan,JPN,0,5,62,0,67
2014,Dem. Rep. of the Congo,COD,Japan,JPN,0,0,17,5,22
2014,Ethiopia,ETH,Japan,JPN,0,0,5,5,10
2014,Gambia,GMB,Japan,JPN,0,0,5,0,5
2014,Ghana,GHA,Japan,JPN,0,0,52,5,57
2014,Guinea,GIN,Japan,JPN,0,0,10,0,10
2014,India,IND,Japan,JPN,0,0,107,19,126
2014,Indonesia,IDN,Japan,JPN,0,0,15,0,15
2014,Iran (Islamic Rep. of),IRN,Japan,JPN,0,0,40,0,40
2014,Liberia,LBR,Japan,JPN,0,0,5,0,5
2014,Sri Lanka,LKA,Japan,JPN,0,0,298,23,321
2014,Mali,MLI,Japan,JPN,0,0,5,0,5
2014,Malaysia,MYS,Japan,JPN,0,0,5,0,5
2014,Myanmar,MMR,Japan,JPN,0,19,255,21,295
2014,Nepal,NPL,Japan,JPN,0,0,689,21,710
2014,Nigeria,NGA,Japan,JPN,0,0,63,5,68
2014,Pakistan,PAK,Japan,JPN,0,0,164,20,184
2014,Peru,PER,Japan,JPN,0,0,10,0,10
2014,Philippines,PHL,Japan,JPN,0,0,62,5,67
2014,Viet Nam,VNM,Japan,JPN,0,0,187,17,204
2014,Syrian Arab Rep.,SYR,Japan,JPN,5,12,0,0,17
2014,United Rep. of Tanzania,TZA,Japan,JPN,0,0,5,0,5
2014,Thailand,THA,Japan,JPN,0,0,26,5,31
2014,Tunisia,TUN,Japan,JPN,0,0,23,11,34
2014,Turkey,TUR,Japan,JPN,0,0,505,60,565
2014,Uganda,UGA,Japan,JPN,0,0,21,0,21
2014,Unknown ,,Japan,JPN,0,0,48,5,53
2014,Afghanistan,AFG,Kazakhstan,KAZ,62,0,82,5,149
2014,China,CHN,Kazakhstan,KAZ,0,0,0,5,5
2014,Kyrgyzstan,KGZ,Kazakhstan,KAZ,0,0,0,10,10
2014,Syrian Arab Rep.,SYR,Kazakhstan,KAZ,5,0,43,0,48
2014,Ukraine,UKR,Kazakhstan,KAZ,0,0,84,5,89
2014,Uzbekistan,UZB,Kazakhstan,KAZ,5,0,5,0,10
2014,Afghanistan,AFG,Kyrgyzstan,KGZ,0,0,116,28,144
2014,Germany,DEU,Kyrgyzstan,KGZ,0,0,5,0,5
2014,Iran (Islamic Rep. of),IRN,Kyrgyzstan,KGZ,0,0,5,0,5
2014,Pakistan,PAK,Kyrgyzstan,KGZ,0,0,5,0,5
2014,Syrian Arab Rep.,SYR,Kyrgyzstan,KGZ,40,0,19,16,75
2014,Tajikistan,TJK,Kyrgyzstan,KGZ,0,0,5,0,5
2014,Uzbekistan,UZB,Kyrgyzstan,KGZ,0,0,0,93,93
2014,Albania,ALB,Liechtenstein,LIE,0,0,5,0,5
2014,Kyrgyzstan,KGZ,Liechtenstein,LIE,0,0,0,5,5
2014,Serbia and Kosovo: S/RES/1244 (1999),SRB,Liechtenstein,LIE,0,0,0,12,12
2014,Syrian Arab Rep.,SYR,Liechtenstein,LIE,5,0,0,0,5
2014,Ukraine,UKR,Liechtenstein,LIE,0,0,0,5,5
2014,Afghanistan,AFG,Lithuania,LTU,10,22,0,18,50
2014,Azerbaijan,AZE,Lithuania,LTU,0,0,0,16,16
2014,Belarus,BLR,Lithuania,LTU,0,0,0,5,5
2014,Georgia,GEO,Lithuania,LTU,0,0,33,71,104
2014,Guinea,GIN,Lithuania,LTU,0,0,5,0,5
2014,India,IND,Lithuania,LTU,0,0,5,10,15
2014,Nigeria,NGA,Lithuania,LTU,0,0,5,0,5
2014,Pakistan,PAK,Lithuania,LTU,0,0,5,0,5
2014,Russian Federation,RUS,Lithuania,LTU,11,14,15,16,56
2014,Viet Nam,VNM,Lithuania,LTU,0,0,19,5,24
2014,Syrian Arab Rep.,SYR,Lithuania,LTU,0,0,0,5,5
2014,Ukraine,UKR,Lithuania,LTU,0,28,5,11,44
2014,Afghanistan,AFG,Luxembourg,LUX,0,0,0,5,5
2014,Albania,ALB,Luxembourg,LUX,0,0,83,10,93
2014,Algeria,DZA,Luxembourg,LUX,0,0,10,37,47
2014,Egypt,EGY,Luxembourg,LUX,5,0,0,5,10
2014,Armenia,ARM,Luxembourg,LUX,0,0,0,5,5
2014,Azerbaijan,AZE,Luxembourg,LUX,0,0,5,5,10
2014,Benin,BEN,Luxembourg,LUX,0,0,5,10,15
2014,Belarus,BLR,Luxembourg,LUX,0,0,5,13,18
2014,Bosnia and Herzegovina,BIH,Luxembourg,LUX,0,0,137,10,147
2014,China,CHN,Luxembourg,LUX,0,0,0,5,5
2014,Cameroon,CMR,Luxembourg,LUX,5,0,0,5,10
2014,Dem. Rep. of the Congo,COD,Luxembourg,LUX,5,0,12,5,22
2014,Eritrea,ERI,Luxembourg,LUX,14,0,5,0,19
2014,Ethiopia,ETH,Luxembourg,LUX,5,0,5,0,10
2014,Gambia,GMB,Luxembourg,LUX,0,0,0,5,5
2014,Georgia,GEO,Luxembourg,LUX,0,0,0,11,11
2014,Guinea,GIN,Luxembourg,LUX,0,0,5,0,5
2014,Iran (Islamic Rep. of),IRN,Luxembourg,LUX,10,0,5,5,20
2014,Iraq,IRQ,Luxembourg,LUX,5,5,12,5,27
2014,Kazakhstan,KAZ,Luxembourg,LUX,0,0,0,5,5
2014,Libya,LBY,Luxembourg,LUX,0,0,10,5,15
2014,North Macedonia,MKD,Luxembourg,LUX,0,0,27,0,27
2014,Mali,MLI,Luxembourg,LUX,0,0,0,5,5
2014,Morocco,MAR,Luxembourg,LUX,0,0,5,11,16
2014,Montenegro,MNE,Luxembourg,LUX,0,5,132,0,137
2014,Nigeria,NGA,Luxembourg,LUX,0,0,23,51,74
2014,Russian Federation,RUS,Luxembourg,LUX,0,0,5,0,5
2014,Serbia and Kosovo: S/RES/1244 (1999),SRB,Luxembourg,LUX,5,0,140,54,199
2014,Somalia,SOM,Luxembourg,LUX,5,0,10,5,20
2014,Syrian Arab Rep.,SYR,Luxembourg,LUX,38,5,5,16,64
2014,Tunisia,TUN,Luxembourg,LUX,0,0,26,18,44
2014,Turkey,TUR,Luxembourg,LUX,0,0,27,0,27
2014,Ukraine,UKR,Luxembourg,LUX,0,0,0,5,5
2014,Algeria,DZA,Latvia,LVA,0,0,0,5,5
2014,Egypt,EGY,Latvia,LVA,0,0,5,0,5
2014,Armenia,ARM,Latvia,LVA,0,0,5,0,5
2014,Dem. Rep. of the Congo,COD,Latvia,LVA,0,0,0,5,5
2014,Cuba,CUB,Latvia,LVA,0,0,5,0,5
2014,Georgia,GEO,Latvia,LVA,0,0,31,137,168
2014,Iraq,IRQ,Latvia,LVA,0,0,0,5,5
2014,Russian Federation,RUS,Latvia,LVA,0,0,5,5,10
2014,Syrian Arab Rep.,SYR,Latvia,LVA,0,19,0,10,29
2014,Ukraine,UKR,Latvia,LVA,0,0,5,13,18
2014,Afghanistan,AFG,Rep. of Moldova,MDA,10,0,0,5,15
2014,Cuba,CUB,Rep. of Moldova,MDA,0,5,0,0,5
2014,Georgia,GEO,Rep. of Moldova,MDA,0,0,0,5,5
2014,Iraq,IRQ,Rep. of Moldova,MDA,5,0,0,5,10
2014,Syrian Arab Rep.,SYR,Rep. of Moldova,MDA,22,40,0,5,67
2014,Tajikistan,TJK,Rep. of Moldova,MDA,5,0,0,0,5
2014,Ukraine,UKR,Rep. of Moldova,MDA,0,17,16,18,51
2014,Uzbekistan,UZB,Rep. of Moldova,MDA,5,0,0,0,5
2014,Burundi,BDI,Malawi,MWI,0,0,0,122,122
2014,Belgium,BEL,Malawi,MWI,0,0,0,5,5
2014,Dem. Rep. of the Congo,COD,Malawi,MWI,0,0,0,182,182
2014,Ethiopia,ETH,Malawi,MWI,0,0,0,5,5
2014,Rwanda,RWA,Malawi,MWI,25,0,0,122,147
2014,Dem. Rep. of the Congo,COD,Mozambique,MOZ,5,0,0,0,5
2014,Egypt,EGY,Malta,MLT,5,11,5,5,26
2014,Belarus,BLR,Malta,MLT,0,5,5,5,15
2014,Chad,TCD,Malta,MLT,5,0,5,5,15
2014,Comoros,COM,Malta,MLT,0,0,10,0,10
2014,Eritrea,ERI,Malta,MLT,5,142,22,15,184
2014,Ethiopia,ETH,Malta,MLT,11,10,19,0,40
2014,Gambia,GMB,Malta,MLT,5,0,93,5,103
2014,Palestinian,PSE,Malta,MLT,10,16,5,10,41
2014,Ghana,GHA,Malta,MLT,0,0,0,5,5
2014,Guinea-Bissau,GNB,Malta,MLT,0,0,5,0,5
2014,Guinea,GIN,Malta,MLT,0,0,5,5,10
2014,Cote d'Ivoire,CIV,Malta,MLT,0,0,5,0,5
2014,Iran (Islamic Rep. of),IRN,Malta,MLT,10,0,0,0,10
2014,Libya,LBY,Malta,MLT,144,242,0,64,450
2014,Mali,MLI,Malta,MLT,0,5,45,5,55
2014,Morocco,MAR,Malta,MLT,0,5,5,0,10
2014,Nigeria,NGA,Malta,MLT,0,14,64,17,95
2014,Pakistan,PAK,Malta,MLT,5,0,0,0,5
2014,Russian Federation,RUS,Malta,MLT,5,10,5,5,25
2014,Senegal,SEN,Malta,MLT,0,5,0,37,42
2014,Sierra Leone,SLE,Malta,MLT,0,0,5,0,5
2014,Somalia,SOM,Malta,MLT,5,296,76,150,527
2014,Sudan,SDN,Malta,MLT,5,61,10,38,114
2014,South Sudan,SSD,Malta,MLT,0,20,5,0,25
2014,Syrian Arab Rep.,SYR,Malta,MLT,5,360,5,26,396
2014,Togo,TGO,Malta,MLT,0,0,5,0,5
2014,Tunisia,TUN,Malta,MLT,0,0,5,0,5
2014,Ukraine,UKR,Malta,MLT,0,26,0,18,44
2014,Burundi,BDI,Namibia,NAM,52,0,0,0,52
2014,Cameroon,CMR,Namibia,NAM,0,0,0,5,5
2014,Dem. Rep. of the Congo,COD,Namibia,NAM,337,0,0,53,390
2014,Rwanda,RWA,Namibia,NAM,21,0,0,0,21
2014,Somalia,SOM,Namibia,NAM,0,0,0,10,10
2014,South Sudan,SSD,Namibia,NAM,0,0,0,5,5
2014,Uganda,UGA,Namibia,NAM,0,0,0,5,5
2014,Zimbabwe,ZWE,Namibia,NAM,5,0,0,42,47
2014,Afghanistan,AFG,Netherlands,NLD,182,233,414,0,829
2014,Albania,ALB,Netherlands,NLD,0,0,59,0,59
2014,Algeria,DZA,Netherlands,NLD,5,0,11,0,16
2014,Angola,AGO,Netherlands,NLD,0,0,13,0,13
2014,Egypt,EGY,Netherlands,NLD,10,18,115,0,143
2014,Armenia,ARM,Netherlands,NLD,0,10,233,0,243
2014,Australia,AUS,Netherlands,NLD,0,0,5,0,5
2014,Azerbaijan,AZE,Netherlands,NLD,0,5,39,0,44
2014,Burundi,BDI,Netherlands,NLD,0,5,12,0,17
2014,Benin,BEN,Netherlands,NLD,0,0,5,0,5
2014,Bangladesh,BGD,Netherlands,NLD,0,0,10,0,10
2014,Burkina Faso,BFA,Netherlands,NLD,0,0,12,0,12
2014,Belarus,BLR,Netherlands,NLD,0,0,50,0,50
2014,Brazil,BRA,Netherlands,NLD,0,0,5,0,5
2014,Bosnia and Herzegovina,BIH,Netherlands,NLD,0,0,95,0,95
2014,Bulgaria,BGR,Netherlands,NLD,0,0,5,0,5
2014,China,CHN,Netherlands,NLD,14,43,64,0,121
2014,Cameroon,CMR,Netherlands,NLD,12,0,23,0,35
2014,Congo,COG,Netherlands,NLD,5,16,86,0,107
2014,Colombia,COL,Netherlands,NLD,0,0,11,0,11
2014,Cuba,CUB,Netherlands,NLD,0,0,10,0,10
2014,Eritrea,ERI,Netherlands,NLD,33,3455,357,0,3845
2014,Ethiopia,ETH,Netherlands,NLD,17,14,79,0,110
2014,Gambia,GMB,Netherlands,NLD,0,0,19,0,19
2014,Palestinian,PSE,Netherlands,NLD,18,11,5,0,34
2014,Georgia,GEO,Netherlands,NLD,0,5,282,0,287
2014,Ghana,GHA,Netherlands,NLD,0,0,29,0,29
2014,Guinea,GIN,Netherlands,NLD,5,52,75,0,132
2014,Cote d'Ivoire,CIV,Netherlands,NLD,0,0,26,0,26
2014,India,IND,Netherlands,NLD,0,0,12,0,12
2014,Iran (Islamic Rep. of),IRN,Netherlands,NLD,203,58,319,0,580
2014,Iraq,IRQ,Netherlands,NLD,86,241,450,0,777
2014,Israel,ISR,Netherlands,NLD,0,0,5,0,5
2014,Jamaica,JAM,Netherlands,NLD,22,5,17,0,44
2014,Jordan,JOR,Netherlands,NLD,0,5,5,0,10
2014,Kazakhstan,KAZ,Netherlands,NLD,0,0,29,0,29
2014,Kenya,KEN,Netherlands,NLD,0,10,5,0,15
2014,Kyrgyzstan,KGZ,Netherlands,NLD,0,0,12,0,12
2014,Dem. People's Rep. of Korea,PRK,Netherlands,NLD,0,0,34,0,34
2014,Liberia,LBR,Netherlands,NLD,0,0,10,0,10
2014,Libya,LBY,Netherlands,NLD,5,14,144,0,163
2014,Lebanon,LBN,Netherlands,NLD,0,0,14,0,14
2014,Sri Lanka,LKA,Netherlands,NLD,10,22,88,0,120
2014,Latvia,LVA,Netherlands,NLD,0,0,5,0,5
2014,Mauritania,MRT,Netherlands,NLD,0,0,5,0,5
2014,North Macedonia,MKD,Netherlands,NLD,0,0,101,0,101
2014,Mali,MLI,Netherlands,NLD,0,10,26,0,36
2014,Malawi,MWI,Netherlands,NLD,0,0,5,0,5
2014,Mongolia,MNG,Netherlands,NLD,0,10,295,0,305
2014,Morocco,MAR,Netherlands,NLD,0,0,35,0,35
2014,Montenegro,MNE,Netherlands,NLD,0,0,11,0,11
2014,Myanmar,MMR,Netherlands,NLD,0,17,0,0,17
2014,Nepal,NPL,Netherlands,NLD,5,5,44,0,54
2014,Niger,NER,Netherlands,NLD,0,0,5,0,5
2014,Nigeria,NGA,Netherlands,NLD,30,13,153,0,196
2014,Pakistan,PAK,Netherlands,NLD,25,14,117,0,156
2014,South Africa,ZAF,Netherlands,NLD,0,0,5,0,5
2014,Russian Federation,RUS,Netherlands,NLD,10,22,145,0,177
2014,Rwanda,RWA,Netherlands,NLD,0,0,15,0,15
2014,Serbia and Kosovo: S/RES/1244 (1999),SRB,Netherlands,NLD,0,0,177,0,177
2014,Senegal,SEN,Netherlands,NLD,5,0,5,0,10
2014,Sierra Leone,SLE,Netherlands,NLD,5,30,81,0,116
2014,Somalia,SOM,Netherlands,NLD,10,326,235,0,571
2014,Viet Nam,VNM,Netherlands,NLD,0,0,11,0,11
2014,Sudan,SDN,Netherlands,NLD,10,32,106,0,148
2014,Suriname,SUR,Netherlands,NLD,0,0,5,0,5
2014,Syrian Arab Rep.,SYR,Netherlands,NLD,349,5090,513,0,5952
2014,United Rep. of Tanzania,TZA,Netherlands,NLD,0,0,11,0,11
2014,Tajikistan,TJK,Netherlands,NLD,0,0,5,0,5
2014,Trinidad and Tobago,TTO,Netherlands,NLD,5,0,0,0,5
2014,Tunisia,TUN,Netherlands,NLD,0,0,16,0,16
2014,Turkey,TUR,Netherlands,NLD,5,10,40,0,55
2014,Uganda,UGA,Netherlands,NLD,67,11,87,0,165
2014,Ukraine,UKR,Netherlands,NLD,0,0,155,0,155
2014,United States of America,USA,Netherlands,NLD,0,0,5,0,5
2014,Uzbekistan,UZB,Netherlands,NLD,0,0,12,0,12
2014,Yemen,YEM,Netherlands,NLD,0,10,20,0,30
2014,Zimbabwe,ZWE,Netherlands,NLD,0,0,5,0,5
2014,Stateless,XXA,Netherlands,NLD,1285,82,238,0,1605
2014,Unknown ,,Netherlands,NLD,38,151,227,0,416
2014,Central African Rep.,CAF,Niger,NER,0,0,14,0,14
2014,Chad,TCD,Niger,NER,0,0,0,10,10
2014,Cameroon,CMR,Niger,NER,0,0,0,5,5
2014,Dem. Rep. of the Congo,COD,Niger,NER,0,0,0,5,5
2014,Cote d'Ivoire,CIV,Niger,NER,0,0,0,15,15
2014,Nigeria,NGA,Niger,NER,0,0,0,10,10
2014,Cuba,CUB,Nicaragua,NIC,5,0,0,0,5
2014,Guatemala,GTM,Nicaragua,NIC,5,0,0,0,5
2014,Honduras,HND,Nicaragua,NIC,5,0,0,0,5
2014,El Salvador,SLV,Nicaragua,NIC,73,0,0,0,73
2014,Central African Rep.,CAF,Nigeria,NGA,67,0,10,33,110
2014,Chad,TCD,Nigeria,NGA,5,0,0,47,52
2014,Cameroon,CMR,Nigeria,NGA,0,0,0,10,10
2014,Congo,COG,Nigeria,NGA,0,0,0,5,5
2014,Dem. Rep. of the Congo,COD,Nigeria,NGA,22,0,115,51,188
2014,Cote d'Ivoire,CIV,Nigeria,NGA,5,0,14,12,31
2014,Mali,MLI,Nigeria,NGA,26,0,24,5,55
2014,Sierra Leone,SLE,Nigeria,NGA,5,0,0,0,5
2014,Sudan,SDN,Nigeria,NGA,0,0,0,5,5
2014,Syrian Arab Rep.,SYR,Nigeria,NGA,5,0,0,0,5
2014,Togo,TGO,Nigeria,NGA,5,0,5,0,10
2014,Afghanistan,AFG,Norway,NOR,140,107,157,121,525
2014,Albania,ALB,Norway,NOR,0,0,205,10,215
2014,Algeria,DZA,Norway,NOR,0,0,25,100,125
2014,Angola,AGO,Norway,NOR,0,0,0,10,10
2014,Egypt,EGY,Norway,NOR,0,0,5,22,27
2014,Armenia,ARM,Norway,NOR,0,0,10,10,20
2014,Azerbaijan,AZE,Norway,NOR,0,0,13,0,13
2014,Burundi,BDI,Norway,NOR,0,0,5,0,5
2014,Bangladesh,BGD,Norway,NOR,5,0,142,12,159
2014,Burkina Faso,BFA,Norway,NOR,0,0,0,5,5
2014,Belarus,BLR,Norway,NOR,0,0,26,28,54
2014,Bosnia and Herzegovina,BIH,Norway,NOR,0,0,32,50,82
2014,Bulgaria,BGR,Norway,NOR,0,0,5,0,5
2014,Central African Rep.,CAF,Norway,NOR,0,5,0,0,5
2014,Chad,TCD,Norway,NOR,0,0,0,10,10
2014,China,CHN,Norway,NOR,30,0,5,10,45
2014,Cameroon,CMR,Norway,NOR,0,0,12,5,17
2014,Dem. Rep. of the Congo,COD,Norway,NOR,0,0,10,5,15
2014,Cuba,CUB,Norway,NOR,0,0,5,0,5
2014,Czechia,CZE,Norway,NOR,0,0,0,5,5
2014,Djibouti,DJI,Norway,NOR,0,0,0,5,5
2014,Eritrea,ERI,Norway,NOR,1890,0,85,374,2349
2014,Ethiopia,ETH,Norway,NOR,143,0,50,64,257
2014,France,FRA,Norway,NOR,0,0,5,0,5
2014,Gambia,GMB,Norway,NOR,0,0,11,5,16
2014,Georgia,GEO,Norway,NOR,0,0,29,10,39
2014,Germany,DEU,Norway,NOR,0,0,5,0,5
2014,Ghana,GHA,Norway,NOR,0,0,13,13,26
2014,Guinea-Bissau,GNB,Norway,NOR,0,0,5,0,5
2014,Guinea,GIN,Norway,NOR,0,0,11,18,29
2014,Cote d'Ivoire,CIV,Norway,NOR,0,0,10,10,20
2014,India,IND,Norway,NOR,0,0,23,14,37
2014,Iran (Islamic Rep. of),IRN,Norway,NOR,46,0,55,59,160
2014,Iraq,IRQ,Norway,NOR,12,10,44,93,159
2014,Jordan,JOR,Norway,NOR,0,0,11,19,30
2014,Kazakhstan,KAZ,Norway,NOR,0,0,10,10,20
2014,Kenya,KEN,Norway,NOR,0,0,0,5,5
2014,Kyrgyzstan,KGZ,Norway,NOR,0,0,5,12,17
2014,Liberia,LBR,Norway,NOR,0,0,0,13,13
2014,Libya,LBY,Norway,NOR,0,0,5,61,66
2014,Lebanon,LBN,Norway,NOR,0,0,12,19,31
2014,Sri Lanka,LKA,Norway,NOR,5,0,5,10,20
2014,Lithuania,LTU,Norway,NOR,0,0,5,0,5
2014,Mauritania,MRT,Norway,NOR,0,0,0,5,5
2014,North Macedonia,MKD,Norway,NOR,0,0,24,5,29
2014,Rep. of Moldova,MDA,Norway,NOR,0,0,5,0,5
2014,Mali,MLI,Norway,NOR,0,0,10,12,22
2014,Mongolia,MNG,Norway,NOR,0,0,10,0,10
2014,Morocco,MAR,Norway,NOR,0,0,37,108,145
2014,Montenegro,MNE,Norway,NOR,0,0,5,0,5
2014,Myanmar,MMR,Norway,NOR,5,0,5,16,26
2014,Niger,NER,Norway,NOR,0,0,0,5,5
2014,Nigeria,NGA,Norway,NOR,5,0,140,244,389
2014,Pakistan,PAK,Norway,NOR,14,0,67,63,144
2014,Philippines,PHL,Norway,NOR,0,0,10,0,10
2014,Poland,POL,Norway,NOR,0,0,5,0,5
2014,Romania,ROU,Norway,NOR,0,0,5,0,5
2014,Russian Federation,RUS,Norway,NOR,10,0,128,105,243
2014,Rwanda,RWA,Norway,NOR,0,0,0,10,10
2014,El Salvador,SLV,Norway,NOR,0,0,10,0,10
2014,Serbia and Kosovo: S/RES/1244 (1999),SRB,Norway,NOR,0,0,166,68,234
2014,Senegal,SEN,Norway,NOR,0,0,10,10,20
2014,Sierra Leone,SLE,Norway,NOR,5,0,5,11,21
2014,Somalia,SOM,Norway,NOR,384,73,273,185,915
2014,Spain,ESP,Norway,NOR,0,0,0,5,5
2014,Viet Nam,VNM,Norway,NOR,0,0,12,17,29
2014,Sudan,SDN,Norway,NOR,136,0,60,165,361
2014,Slovakia,SVK,Norway,NOR,0,0,5,0,5
2014,Syrian Arab Rep.,SYR,Norway,NOR,575,669,16,175,1435
2014,United Rep. of Tanzania,TZA,Norway,NOR,0,0,0,5,5
2014,Tajikistan,TJK,Norway,NOR,0,0,5,5,10
2014,Tunisia,TUN,Norway,NOR,0,0,16,71,87
2014,Turkey,TUR,Norway,NOR,0,10,20,23,53
2014,Uganda,UGA,Norway,NOR,16,0,14,23,53
2014,Ukraine,UKR,Norway,NOR,0,0,77,40,117
2014,Uzbekistan,UZB,Norway,NOR,5,5,94,23,127
2014,Venezuela (Bolivarian Republic of),VEN,Norway,NOR,0,0,5,0,5
2014,Yemen,YEM,Norway,NOR,0,0,12,18,30
2014,Stateless,XXA,Norway,NOR,145,260,51,101,557
2014,Afghanistan,AFG,Nauru,NRU,29,0,0,0,29
2014,Bangladesh,BGD,Nauru,NRU,0,0,12,0,12
2014,Iran (Islamic Rep. of),IRN,Nauru,NRU,158,0,39,0,197
2014,Iraq,IRQ,Nauru,NRU,10,0,5,0,15
2014,Lebanon,LBN,Nauru,NRU,10,0,0,0,10
2014,Sri Lanka,LKA,Nauru,NRU,0,0,5,0,5
2014,Myanmar,MMR,Nauru,NRU,5,0,0,0,5
2014,Nepal,NPL,Nauru,NRU,0,0,5,0,5
2014,Pakistan,PAK,Nauru,NRU,62,0,24,0,86
2014,Somalia,SOM,Nauru,NRU,43,0,5,0,48
2014,Sudan,SDN,Nauru,NRU,11,0,0,0,11
2014,Stateless,XXA,Nauru,NRU,49,0,0,0,49
2014,Unknown ,,Nauru,NRU,0,0,0,48,48
2014,Congo,COG,Panama,PAN,0,0,0,5,5
2014,Colombia,COL,Panama,PAN,52,0,18,260,330
2014,Cuba,CUB,Panama,PAN,0,0,0,17,17
2014,Ghana,GHA,Panama,PAN,0,0,0,16,16
2014,Mexico,MEX,Panama,PAN,0,0,0,5,5
2014,Nicaragua,NIC,Panama,PAN,0,0,0,5,5
2014,Venezuela (Bolivarian Republic of),VEN,Panama,PAN,10,0,5,5,20
2014,Bolivia (Plurinational State of),BOL,Paraguay,PRY,5,0,0,0,5
2014,Cuba,CUB,Paraguay,PRY,5,0,5,0,10
2014,Syrian Arab Rep.,SYR,Paraguay,PRY,5,0,0,0,5
2014,Argentina,ARG,Peru,PER,0,0,5,0,5
2014,Bangladesh,BGD,Peru,PER,5,0,5,5,15
2014,Colombia,COL,Peru,PER,71,0,104,93,268
2014,Cuba,CUB,Peru,PER,22,0,44,5,71
2014,Dominican Rep.,DOM,Peru,PER,5,0,16,18,39
2014,Ecuador,ECU,Peru,PER,0,0,10,0,10
2014,Palestinian,PSE,Peru,PER,5,0,0,0,5
2014,Haiti,HTI,Peru,PER,5,0,0,0,5
2014,India,IND,Peru,PER,0,0,10,0,10
2014,Iraq,IRQ,Peru,PER,10,0,0,0,10
2014,Sri Lanka,LKA,Peru,PER,0,0,0,10,10
2014,Nigeria,NGA,Peru,PER,5,0,5,0,10
2014,El Salvador,SLV,Peru,PER,0,0,0,5,5
2014,Syrian Arab Rep.,SYR,Peru,PER,17,0,0,0,17
2014,Venezuela (Bolivarian Republic of),VEN,Peru,PER,5,0,16,0,21
2014,Palestinian,PSE,Philippines,PHL,12,0,0,0,12
2014,Iran (Islamic Rep. of),IRN,Philippines,PHL,10,0,0,0,10
2014,Iraq,IRQ,Philippines,PHL,10,0,0,0,10
2014,Pakistan,PAK,Philippines,PHL,5,0,0,0,5
2014,Syrian Arab Rep.,SYR,Philippines,PHL,13,0,0,0,13
2014,Afghanistan,AFG,Papua New Guinea,PNG,26,0,16,5,47
2014,Bangladesh,BGD,Papua New Guinea,PNG,0,0,14,0,14
2014,Iran (Islamic Rep. of),IRN,Papua New Guinea,PNG,35,0,55,196,286
2014,Iraq,IRQ,Papua New Guinea,PNG,10,0,5,56,71
2014,Lebanon,LBN,Papua New Guinea,PNG,0,0,10,10,20
2014,Myanmar,MMR,Papua New Guinea,PNG,0,0,0,5,5
2014,Nepal,NPL,Papua New Guinea,PNG,0,0,5,0,5
2014,Pakistan,PAK,Papua New Guinea,PNG,26,0,13,5,44
2014,Viet Nam,VNM,Papua New Guinea,PNG,0,0,0,5,5
2014,Sudan,SDN,Papua New Guinea,PNG,18,0,0,0,18
2014,Stateless,XXA,Papua New Guinea,PNG,15,0,0,5,20
2014,Afghanistan,AFG,Poland,POL,27,0,15,23,65
2014,Algeria,DZA,Poland,POL,0,0,0,5,5
2014,Egypt,EGY,Poland,POL,10,0,5,5,20
2014,Armenia,ARM,Poland,POL,0,0,30,122,152
2014,Bangladesh,BGD,Poland,POL,0,0,5,30,35
2014,Belarus,BLR,Poland,POL,14,0,11,18,43
2014,China,CHN,Poland,POL,5,0,0,5,10
2014,Eritrea,ERI,Poland,POL,0,5,0,5,10
2014,Georgia,GEO,Poland,POL,0,0,133,674,807
2014,India,IND,Poland,POL,0,0,5,10,15
2014,Iran (Islamic Rep. of),IRN,Poland,POL,5,0,5,14,24
2014,Iraq,IRQ,Poland,POL,10,15,0,16,41
2014,Jordan,JOR,Poland,POL,0,0,0,5,5
2014,Kazakhstan,KAZ,Poland,POL,22,11,22,73,128
2014,Kyrgyzstan,KGZ,Poland,POL,0,0,19,70,89
2014,Libya,LBY,Poland,POL,0,0,5,5,10
2014,Lebanon,LBN,Poland,POL,0,0,0,5,5
2014,Sri Lanka,LKA,Poland,POL,0,0,0,5,5
2014,Rep. of Moldova,MDA,Poland,POL,0,0,5,0,5
2014,Mongolia,MNG,Poland,POL,0,0,0,10,10
2014,Nigeria,NGA,Poland,POL,0,0,0,5,5
2014,Pakistan,PAK,Poland,POL,0,0,13,31,44
2014,Russian Federation,RUS,Poland,POL,13,107,1002,3822,4944
2014,Somalia,SOM,Poland,POL,12,5,0,0,17
2014,Viet Nam,VNM,Poland,POL,0,0,42,16,58
2014,Syrian Arab Rep.,SYR,Poland,POL,115,17,0,62,194
2014,Tajikistan,TJK,Poland,POL,0,0,0,81,81
2014,Turkmenistan,TKM,Poland,POL,5,0,0,0,5
2014,Tunisia,TUN,Poland,POL,0,0,5,5,10
2014,Turkey,TUR,Poland,POL,0,0,5,5,10
2014,Uganda,UGA,Poland,POL,0,0,0,5,5
2014,Ukraine,UKR,Poland,POL,0,5,645,372,1022
2014,Uzbekistan,UZB,Poland,POL,0,0,12,12,24
2014,Stateless,XXA,Poland,POL,22,0,0,19,41
2014,Unknown ,,Poland,POL,0,0,5,0,5
2014,Angola,AGO,Portugal,PRT,0,0,0,16,16
2014,Armenia,ARM,Portugal,PRT,5,0,0,0,5
2014,Bangladesh,BGD,Portugal,PRT,0,0,0,5,5
2014,Belarus,BLR,Portugal,PRT,0,5,0,0,5
2014,Brazil,BRA,Portugal,PRT,0,0,0,5,5
2014,China,CHN,Portugal,PRT,0,0,0,5,5
2014,Dem. Rep. of the Congo,COD,Portugal,PRT,0,5,0,10,15
2014,Eritrea,ERI,Portugal,PRT,0,5,0,0,5
2014,Palestinian,PSE,Portugal,PRT,0,0,0,5,5
2014,Guinea-Bissau,GNB,Portugal,PRT,0,0,0,11,11
2014,Guinea,GIN,Portugal,PRT,0,13,5,20,38
2014,Cote d'Ivoire,CIV,Portugal,PRT,0,0,0,11,11
2014,Iran (Islamic Rep. of),IRN,Portugal,PRT,5,0,0,0,5
2014,Iraq,IRQ,Portugal,PRT,0,0,0,5,5
2014,Sri Lanka,LKA,Portugal,PRT,0,5,0,5,10
2014,Mali,MLI,Portugal,PRT,0,5,0,18,23
2014,Morocco,MAR,Portugal,PRT,5,0,0,21,26
2014,Nigeria,NGA,Portugal,PRT,0,5,0,5,10
2014,Pakistan,PAK,Portugal,PRT,0,15,0,5,20
2014,Russian Federation,RUS,Portugal,PRT,5,0,0,0,5
2014,Senegal,SEN,Portugal,PRT,0,0,0,10,10
2014,Sierra Leone,SLE,Portugal,PRT,0,5,0,0,5
2014,Somalia,SOM,Portugal,PRT,0,0,0,5,5
2014,Syrian Arab Rep.,SYR,Portugal,PRT,0,0,0,10,10
2014,Ukraine,UKR,Portugal,PRT,0,15,0,5,20
2014,Afghanistan,AFG,Romania,ROU,32,19,221,0,272
2014,Albania,ALB,Romania,ROU,0,0,14,5,19
2014,Algeria,DZA,Romania,ROU,0,0,5,0,5
2014,Egypt,EGY,Romania,ROU,0,0,10,0,10
2014,Armenia,ARM,Romania,ROU,0,0,5,0,5
2014,Central African Rep.,CAF,Romania,ROU,5,0,0,0,5
2014,China,CHN,Romania,ROU,0,0,10,0,10
2014,Cameroon,CMR,Romania,ROU,5,0,10,0,15
2014,Dem. Rep. of the Congo,COD,Romania,ROU,5,0,0,0,5
2014,Ethiopia,ETH,Romania,ROU,0,0,5,0,5
2014,Palestinian,PSE,Romania,ROU,0,5,5,0,10
2014,Georgia,GEO,Romania,ROU,0,0,5,5,10
2014,Ghana,GHA,Romania,ROU,0,0,5,0,5
2014,Guinea,GIN,Romania,ROU,0,0,5,0,5
2014,Cote d'Ivoire,CIV,Romania,ROU,0,0,5,0,5
2014,India,IND,Romania,ROU,0,0,5,0,5
2014,Iran (Islamic Rep. of),IRN,Romania,ROU,0,0,61,0,61
2014,Iraq,IRQ,Romania,ROU,110,10,88,0,208
2014,Jordan,JOR,Romania,ROU,0,0,5,0,5
2014,Libya,LBY,Romania,ROU,0,0,5,0,5
2014,Lebanon,LBN,Romania,ROU,0,0,5,5,10
2014,Rep. of Moldova,MDA,Romania,ROU,0,0,10,5,15
2014,Morocco,MAR,Romania,ROU,0,0,5,5,10
2014,Myanmar,MMR,Romania,ROU,5,0,0,0,5
2014,Nigeria,NGA,Romania,ROU,0,0,10,0,10
2014,Pakistan,PAK,Romania,ROU,5,0,25,5,35
2014,Philippines,PHL,Romania,ROU,0,0,10,0,10
2014,Russian Federation,RUS,Romania,ROU,0,0,10,0,10
2014,Serbia and Kosovo: S/RES/1244 (1999),SRB,Romania,ROU,0,0,5,5,10
2014,Senegal,SEN,Romania,ROU,0,0,5,0,5
2014,Somalia,SOM,Romania,ROU,5,0,5,0,10
2014,Viet Nam,VNM,Romania,ROU,0,0,5,0,5
2014,Sudan,SDN,Romania,ROU,5,0,0,0,5
2014,Syrian Arab Rep.,SYR,Romania,ROU,180,287,136,10,613
2014,Tunisia,TUN,Romania,ROU,0,0,5,0,5
2014,Turkey,TUR,Romania,ROU,5,0,21,5,31
2014,Ukraine,UKR,Romania,ROU,0,15,10,10,35
2014,Zimbabwe,ZWE,Romania,ROU,5,0,0,0,5
2014,Afghanistan,AFG,South Africa,ZAF,0,0,10,0,10
2014,Algeria,DZA,South Africa,ZAF,0,0,74,0,74
2014,Egypt,EGY,South Africa,ZAF,0,0,241,0,241
2014,Burundi,BDI,South Africa,ZAF,41,0,985,5,1031
2014,Benin,BEN,South Africa,ZAF,0,0,35,0,35
2014,Bangladesh,BGD,South Africa,ZAF,0,0,6656,11,6667
2014,Burkina Faso,BFA,South Africa,ZAF,0,0,21,0,21
2014,Botswana,BWA,South Africa,ZAF,0,0,5,0,5
2014,Central African Rep.,CAF,South Africa,ZAF,5,0,5,0,10
2014,China,CHN,South Africa,ZAF,0,0,621,0,621
2014,Cameroon,CMR,South Africa,ZAF,5,0,704,0,709
2014,Congo,COG,South Africa,ZAF,599,0,993,0,1592
2014,Dem. Rep. of the Congo,COD,South Africa,ZAF,2321,0,7245,12,9578
2014,Comoros,COM,South Africa,ZAF,0,0,16,0,16
2014,Eritrea,ERI,South Africa,ZAF,167,0,33,0,200
2014,Ethiopia,ETH,South Africa,ZAF,3041,0,5142,0,8183
2014,Gabon,GAB,South Africa,ZAF,0,0,10,0,10
2014,Gambia,GMB,South Africa,ZAF,0,0,5,0,5
2014,Palestinian,PSE,South Africa,ZAF,0,0,5,0,5
2014,Ghana,GHA,South Africa,ZAF,0,0,2401,0,2401
2014,Guinea,GIN,South Africa,ZAF,0,0,12,0,12
2014,Cote d'Ivoire,CIV,South Africa,ZAF,0,0,38,0,38
2014,India,IND,South Africa,ZAF,0,0,1808,0,1808
2014,Jordan,JOR,South Africa,ZAF,0,0,5,0,5
2014,Kenya,KEN,South Africa,ZAF,5,0,259,0,264
2014,Liberia,LBR,South Africa,ZAF,0,0,10,0,10
2014,Lesotho,LSO,South Africa,ZAF,0,0,1463,0,1463
2014,Sri Lanka,LKA,South Africa,ZAF,0,0,17,0,17
2014,Mali,MLI,South Africa,ZAF,0,0,12,0,12
2014,Malawi,MWI,South Africa,ZAF,0,0,2766,5,2771
2014,Morocco,MAR,South Africa,ZAF,0,0,10,0,10
2014,Mozambique,MOZ,South Africa,ZAF,0,0,1567,0,1567
2014,Nepal,NPL,South Africa,ZAF,0,0,14,0,14
2014,Niger,NER,South Africa,ZAF,0,0,116,0,116
2014,Nigeria,NGA,South Africa,ZAF,0,0,7711,5,7716
2014,Pakistan,PAK,South Africa,ZAF,0,0,2605,0,2605
2014,Rwanda,RWA,South Africa,ZAF,25,0,210,0,235
2014,Senegal,SEN,South Africa,ZAF,0,0,197,0,197
2014,Sierra Leone,SLE,South Africa,ZAF,0,0,15,0,15
2014,Somalia,SOM,South Africa,ZAF,2903,0,216,0,3119
2014,Sudan,SDN,South Africa,ZAF,14,0,10,0,24
2014,Eswatini,SWZ,South Africa,ZAF,0,0,58,0,58
2014,Syrian Arab Rep.,SYR,South Africa,ZAF,11,0,5,0,16
2014,United Rep. of Tanzania,TZA,South Africa,ZAF,0,0,588,0,588
2014,Thailand,THA,South Africa,ZAF,0,0,5,0,5
2014,Togo,TGO,South Africa,ZAF,0,0,18,0,18
2014,Uganda,UGA,South Africa,ZAF,62,0,1088,0,1150
2014,Ukraine,UKR,South Africa,ZAF,5,0,0,0,5
2014,Yemen,YEM,South Africa,ZAF,0,0,5,0,5
2014,Zambia,ZMB,South Africa,ZAF,0,0,148,0,148
2014,Zimbabwe,ZWE,South Africa,ZAF,16,0,20245,10,20271
2014,Afghanistan,AFG,Russian Federation,RUS,5,0,290,0,295
2014,Egypt,EGY,Russian Federation,RUS,0,0,25,0,25
2014,Armenia,ARM,Russian Federation,RUS,0,0,5,0,5
2014,Azerbaijan,AZE,Russian Federation,RUS,0,0,5,0,5
2014,Belarus,BLR,Russian Federation,RUS,0,0,5,0,5
2014,Eritrea,ERI,Russian Federation,RUS,0,0,5,0,5
2014,Palestinian,PSE,Russian Federation,RUS,0,0,10,0,10
2014,Georgia,GEO,Russian Federation,RUS,0,0,89,0,89
2014,India,IND,Russian Federation,RUS,0,0,5,0,5
2014,Iraq,IRQ,Russian Federation,RUS,0,0,10,0,10
2014,Kazakhstan,KAZ,Russian Federation,RUS,0,0,5,0,5
2014,Kyrgyzstan,KGZ,Russian Federation,RUS,0,0,23,0,23
2014,Dem. People's Rep. of Korea,PRK,Russian Federation,RUS,0,0,11,0,11
2014,Lebanon,LBN,Russian Federation,RUS,0,0,5,0,5
2014,Rep. of Moldova,MDA,Russian Federation,RUS,5,0,14,0,19
2014,Pakistan,PAK,Russian Federation,RUS,0,0,5,0,5
2014,Viet Nam,VNM,Russian Federation,RUS,0,0,5,0,5
2014,Sudan,SDN,Russian Federation,RUS,0,0,5,0,5
2014,Syrian Arab Rep.,SYR,Russian Federation,RUS,0,0,580,0,580
2014,Tajikistan,TJK,Russian Federation,RUS,0,0,18,0,18
2014,Turkmenistan,TKM,Russian Federation,RUS,0,0,5,0,5
2014,Ukraine,UKR,Russian Federation,RUS,241,0,3886,0,4127
2014,United States of America,USA,Russian Federation,RUS,0,0,5,0,5
2014,Uzbekistan,UZB,Russian Federation,RUS,0,0,57,0,57
2014,Unknown ,,Russian Federation,RUS,0,0,10,0,10
2014,Afghanistan,AFG,Rwanda,RWA,5,0,0,0,5
2014,Burundi,BDI,Rwanda,RWA,21,0,0,0,21
2014,Dem. Rep. of the Congo,COD,Rwanda,RWA,5,0,0,0,5
2014,Cuba,CUB,El Salvador,SLV,0,0,5,0,5
2014,Honduras,HND,El Salvador,SLV,5,0,0,0,5
2014,Mexico,MEX,El Salvador,SLV,5,0,0,0,5
2014,Afghanistan,AFG,Serbia and Kosovo: S/RES/1244 (1999),SRB,0,0,0,2980,2980
2014,Albania,ALB,Serbia and Kosovo: S/RES/1244 (1999),SRB,0,0,5,0,5
2014,Algeria,DZA,Serbia and Kosovo: S/RES/1244 (1999),SRB,0,0,0,17,17
2014,Egypt,EGY,Serbia and Kosovo: S/RES/1244 (1999),SRB,0,0,0,5,5
2014,Bangladesh,BGD,Serbia and Kosovo: S/RES/1244 (1999),SRB,0,0,0,129,129
2014,Burkina Faso,BFA,Serbia and Kosovo: S/RES/1244 (1999),SRB,0,0,0,10,10
2014,Central African Rep.,CAF,Serbia and Kosovo: S/RES/1244 (1999),SRB,0,0,0,10,10
2014,Cameroon,CMR,Serbia and Kosovo: S/RES/1244 (1999),SRB,0,0,0,56,56
2014,Congo,COG,Serbia and Kosovo: S/RES/1244 (1999),SRB,0,0,0,65,65
2014,Dem. Rep. of the Congo,COD,Serbia and Kosovo: S/RES/1244 (1999),SRB,0,0,0,38,38
2014,Comoros,COM,Serbia and Kosovo: S/RES/1244 (1999),SRB,0,0,0,32,32
2014,Cuba,CUB,Serbia and Kosovo: S/RES/1244 (1999),SRB,0,0,0,15,15
2014,Eritrea,ERI,Serbia and Kosovo: S/RES/1244 (1999),SRB,0,0,0,792,792
2014,Ethiopia,ETH,Serbia and Kosovo: S/RES/1244 (1999),SRB,0,5,0,5,10
2014,Gambia,GMB,Serbia and Kosovo: S/RES/1244 (1999),SRB,0,0,0,61,61
2014,Palestinian,PSE,Serbia and Kosovo: S/RES/1244 (1999),SRB,0,0,0,188,188
2014,Ghana,GHA,Serbia and Kosovo: S/RES/1244 (1999),SRB,0,0,0,167,167
2014,Guinea,GIN,Serbia and Kosovo: S/RES/1244 (1999),SRB,0,0,0,26,26
2014,Cote d'Ivoire,CIV,Serbia and Kosovo: S/RES/1244 (1999),SRB,0,0,0,54,54
2014,India,IND,Serbia and Kosovo: S/RES/1244 (1999),SRB,0,0,0,21,21
2014,Iran (Islamic Rep. of),IRN,Serbia and Kosovo: S/RES/1244 (1999),SRB,0,0,0,88,88
2014,Iraq,IRQ,Serbia and Kosovo: S/RES/1244 (1999),SRB,0,0,0,275,275
2014,Liberia,LBR,Serbia and Kosovo: S/RES/1244 (1999),SRB,0,0,0,5,5
2014,Libya,LBY,Serbia and Kosovo: S/RES/1244 (1999),SRB,0,0,0,16,16
2014,Sri Lanka,LKA,Serbia and Kosovo: S/RES/1244 (1999),SRB,0,0,0,5,5
2014,Mauritania,MRT,Serbia and Kosovo: S/RES/1244 (1999),SRB,0,0,0,5,5
2014,Mali,MLI,Serbia and Kosovo: S/RES/1244 (1999),SRB,0,0,0,183,183
2014,Morocco,MAR,Serbia and Kosovo: S/RES/1244 (1999),SRB,0,0,0,10,10
2014,Nigeria,NGA,Serbia and Kosovo: S/RES/1244 (1999),SRB,0,0,0,216,216
2014,Pakistan,PAK,Serbia and Kosovo: S/RES/1244 (1999),SRB,0,0,0,322,322
2014,Rwanda,RWA,Serbia and Kosovo: S/RES/1244 (1999),SRB,0,0,0,20,20
2014,Saudi Arabia,SAU,Serbia and Kosovo: S/RES/1244 (1999),SRB,0,0,0,5,5
2014,Senegal,SEN,Serbia and Kosovo: S/RES/1244 (1999),SRB,0,0,0,26,26
2014,Sierra Leone,SLE,Serbia and Kosovo: S/RES/1244 (1999),SRB,0,0,0,35,35
2014,Somalia,SOM,Serbia and Kosovo: S/RES/1244 (1999),SRB,0,0,0,708,708
2014,Sudan,SDN,Serbia and Kosovo: S/RES/1244 (1999),SRB,0,0,0,259,259
2014,Syrian Arab Rep.,SYR,Serbia and Kosovo: S/RES/1244 (1999),SRB,0,0,0,9603,9603
2014,Togo,TGO,Serbia and Kosovo: S/RES/1244 (1999),SRB,0,0,0,13,13
2014,Tunisia,TUN,Serbia and Kosovo: S/RES/1244 (1999),SRB,0,0,0,10,10
2014,Uganda,UGA,Serbia and Kosovo: S/RES/1244 (1999),SRB,0,0,0,13,13
2014,Ukraine,UKR,Serbia and Kosovo: S/RES/1244 (1999),SRB,0,0,0,5,5
2014,Yemen,YEM,Serbia and Kosovo: S/RES/1244 (1999),SRB,0,0,0,17,17
2014,Eritrea,ERI,Sierra Leone,SLE,0,0,0,5,5
2014,Guinea,GIN,Sierra Leone,SLE,0,0,0,10,10
2014,Cote d'Ivoire,CIV,Sierra Leone,SLE,5,0,0,5,10
2014,Afghanistan,AFG,Spain,ESP,22,10,10,0,42
2014,Albania,ALB,Spain,ESP,0,0,17,0,17
2014,Algeria,DZA,Spain,ESP,0,0,285,0,285
2014,Egypt,EGY,Spain,ESP,5,0,5,0,10
2014,Armenia,ARM,Spain,ESP,5,0,18,0,23
2014,Bangladesh,BGD,Spain,ESP,0,0,30,0,30
2014,Burkina Faso,BFA,Spain,ESP,0,0,5,0,5
2014,Belarus,BLR,Spain,ESP,5,0,10,0,15
2014,Bolivia (Plurinational State of),BOL,Spain,ESP,0,0,10,0,10
2014,Brazil,BRA,Spain,ESP,0,0,10,0,10
2014,Central African Rep.,CAF,Spain,ESP,0,0,5,0,5
2014,Chad,TCD,Spain,ESP,0,0,5,0,5
2014,China,CHN,Spain,ESP,5,0,5,0,10
2014,Cameroon,CMR,Spain,ESP,5,0,34,0,39
2014,Congo,COG,Spain,ESP,0,0,5,0,5
2014,Dem. Rep. of the Congo,COD,Spain,ESP,0,5,39,0,44
2014,Colombia,COL,Spain,ESP,14,0,71,0,85
2014,Cuba,CUB,Spain,ESP,5,5,10,0,20
2014,Dominican Rep.,DOM,Spain,ESP,0,0,14,0,14
2014,Ecuador,ECU,Spain,ESP,0,0,13,0,13
2014,Equatorial Guinea,GNQ,Spain,ESP,0,0,5,0,5
2014,Eritrea,ERI,Spain,ESP,0,5,0,0,5
2014,Ethiopia,ETH,Spain,ESP,0,5,0,0,5
2014,Gambia,GMB,Spain,ESP,0,0,35,0,35
2014,Palestinian,PSE,Spain,ESP,68,18,18,0,104
2014,Georgia,GEO,Spain,ESP,0,0,20,0,20
2014,Ghana,GHA,Spain,ESP,0,0,11,0,11
2014,Guinea-Bissau,GNB,Spain,ESP,0,0,10,0,10
2014,Guatemala,GTM,Spain,ESP,0,5,0,0,5
2014,Guinea,GIN,Spain,ESP,0,0,77,0,77
2014,Honduras,HND,Spain,ESP,5,0,22,0,27
2014,Cote d'Ivoire,CIV,Spain,ESP,0,10,328,0,338
2014,India,IND,Spain,ESP,0,0,5,0,5
2014,Iran (Islamic Rep. of),IRN,Spain,ESP,17,0,26,0,43
2014,Kenya,KEN,Spain,ESP,0,0,5,0,5
2014,Liberia,LBR,Spain,ESP,0,0,16,0,16
2014,Libya,LBY,Spain,ESP,0,0,10,0,10
2014,Sri Lanka,LKA,Spain,ESP,0,5,5,0,10
2014,Mexico,MEX,Spain,ESP,5,0,13,0,18
2014,Mali,MLI,Spain,ESP,0,0,131,0,131
2014,Morocco,MAR,Spain,ESP,5,0,75,0,80
2014,Mauritius,MUS,Spain,ESP,0,0,10,0,10
2014,Nigeria,NGA,Spain,ESP,0,0,199,0,199
2014,Pakistan,PAK,Spain,ESP,48,5,52,0,105
2014,Peru,PER,Spain,ESP,0,0,5,0,5
2014,Philippines,PHL,Spain,ESP,0,0,5,0,5
2014,Russian Federation,RUS,Spain,ESP,22,0,19,0,41
2014,Rwanda,RWA,Spain,ESP,0,0,14,0,14
2014,El Salvador,SLV,Spain,ESP,0,0,35,0,35
2014,Senegal,SEN,Spain,ESP,0,0,42,0,42
2014,Sierra Leone,SLE,Spain,ESP,5,0,10,0,15
2014,Somalia,SOM,Spain,ESP,5,86,27,0,118
2014,Sudan,SDN,Spain,ESP,5,0,13,0,18
2014,Syrian Arab Rep.,SYR,Spain,ESP,122,1040,10,0,1172
2014,Tunisia,TUN,Spain,ESP,0,0,5,0,5
2014,Uganda,UGA,Spain,ESP,0,0,10,0,10
2014,Ukraine,UKR,Spain,ESP,0,0,78,0,78
2014,Uzbekistan,UZB,Spain,ESP,0,0,5,0,5
2014,Venezuela (Bolivarian Republic of),VEN,Spain,ESP,0,0,20,0,20
2014,Western Sahara,ESH,Spain,ESP,0,0,24,0,24
2014,Unknown ,,Spain,ESP,0,0,5,0,5
2014,Central African Rep.,CAF,Sudan,SDN,53,0,0,0,53
2014,Dem. Rep. of the Congo,COD,Sudan,SDN,25,0,0,809,834
2014,Eritrea,ERI,Sudan,SDN,3533,0,14,2497,6044
2014,Ethiopia,ETH,Sudan,SDN,209,0,0,2646,2855
2014,Palestinian,PSE,Sudan,SDN,5,0,0,0,5
2014,Somalia,SOM,Sudan,SDN,20,0,0,92,112
2014,Syrian Arab Rep.,SYR,Sudan,SDN,59,0,0,0,59
2014,Unknown ,,Sudan,SDN,0,0,0,234,234
2014,Afghanistan,AFG,Slovakia,SVK,5,46,5,53,109
2014,Algeria,DZA,Slovakia,SVK,0,0,0,10,10
2014,Armenia,ARM,Slovakia,SVK,0,0,5,5,10
2014,Cameroon,CMR,Slovakia,SVK,5,0,0,0,5
2014,Dem. Rep. of the Congo,COD,Slovakia,SVK,0,0,5,5,10
2014,Eritrea,ERI,Slovakia,SVK,0,10,0,0,10
2014,Palestinian,PSE,Slovakia,SVK,0,0,0,5,5
2014,Georgia,GEO,Slovakia,SVK,0,0,5,15,20
2014,India,IND,Slovakia,SVK,0,0,5,5,10
2014,Iran (Islamic Rep. of),IRN,Slovakia,SVK,0,5,5,0,10
2014,Iraq,IRQ,Slovakia,SVK,0,5,0,5,10
2014,Libya,LBY,Slovakia,SVK,0,5,0,0,5
2014,Rep. of Moldova,MDA,Slovakia,SVK,0,0,0,5,5
2014,Mongolia,MNG,Slovakia,SVK,0,0,5,0,5
2014,Morocco,MAR,Slovakia,SVK,0,0,0,5,5
2014,Pakistan,PAK,Slovakia,SVK,0,0,5,10,15
2014,Russian Federation,RUS,Slovakia,SVK,0,0,0,10,10
2014,Somalia,SOM,Slovakia,SVK,0,16,0,10,26
2014,Viet Nam,VNM,Slovakia,SVK,0,0,18,5,23
2014,Syrian Arab Rep.,SYR,Slovakia,SVK,0,14,17,11,42
2014,Ukraine,UKR,Slovakia,SVK,0,0,5,0,5
2014,Afghanistan,AFG,Slovenia,SVN,0,0,5,58,63
2014,Algeria,DZA,Slovenia,SVN,0,0,0,5,5
2014,Egypt,EGY,Slovenia,SVN,0,0,5,5,10
2014,Bangladesh,BGD,Slovenia,SVN,0,0,5,5,10
2014,Bosnia and Herzegovina,BIH,Slovenia,SVN,0,0,5,0,5
2014,China,CHN,Slovenia,SVN,0,0,0,5,5
2014,Cuba,CUB,Slovenia,SVN,0,0,5,0,5
2014,Ghana,GHA,Slovenia,SVN,0,0,5,0,5
2014,Iran (Islamic Rep. of),IRN,Slovenia,SVN,5,0,5,5,15
2014,Iraq,IRQ,Slovenia,SVN,0,0,0,5,5
2014,Morocco,MAR,Slovenia,SVN,0,0,5,0,5
2014,Nigeria,NGA,Slovenia,SVN,0,0,10,5,15
2014,Pakistan,PAK,Slovenia,SVN,0,0,10,14,24
2014,Russian Federation,RUS,Slovenia,SVN,0,0,5,0,5
2014,Serbia and Kosovo: S/RES/1244 (1999),SRB,Slovenia,SVN,0,0,16,13,29
2014,Somalia,SOM,Slovenia,SVN,18,0,0,0,18
2014,Syrian Arab Rep.,SYR,Slovenia,SVN,5,10,0,72,87
2014,Turkey,TUR,Slovenia,SVN,0,0,0,10,10
2014,Ukraine,UKR,Slovenia,SVN,0,0,10,0,10
2014,Burundi,BDI,Eswatini,SWZ,47,0,0,10,57
2014,Dem. Rep. of the Congo,COD,Eswatini,SWZ,51,0,0,112,163
2014,Ethiopia,ETH,Eswatini,SWZ,0,0,0,10,10
2014,Rwanda,RWA,Eswatini,SWZ,48,0,0,29,77
2014,Somalia,SOM,Eswatini,SWZ,20,0,0,41,61
2014,Afghanistan,AFG,Sweden,SWE,621,877,511,494,2503
2014,Albania,ALB,Sweden,SWE,5,16,1062,318,1401
2014,Algeria,DZA,Sweden,SWE,0,10,81,330,421
2014,Angola,AGO,Sweden,SWE,0,5,0,15,20
2014,Egypt,EGY,Sweden,SWE,48,17,170,64,299
2014,Argentina,ARG,Sweden,SWE,0,0,5,0,5
2014,Armenia,ARM,Sweden,SWE,5,43,184,77,309
2014,Australia,AUS,Sweden,SWE,0,0,0,5,5
2014,Azerbaijan,AZE,Sweden,SWE,28,20,148,99,295
2014,Bahrain,BHR,Sweden,SWE,12,0,0,0,12
2014,Burundi,BDI,Sweden,SWE,0,0,5,10,15
2014,Bangladesh,BGD,Sweden,SWE,10,10,109,17,146
2014,Burkina Faso,BFA,Sweden,SWE,0,0,0,5,5
2014,Belarus,BLR,Sweden,SWE,10,10,92,148,260
2014,Bolivia (Plurinational State of),BOL,Sweden,SWE,0,10,26,10,46
2014,Brazil,BRA,Sweden,SWE,0,0,5,0,5
2014,Bosnia and Herzegovina,BIH,Sweden,SWE,0,13,285,138,436
2014,Bulgaria,BGR,Sweden,SWE,0,0,15,0,15
2014,Canada,CAN,Sweden,SWE,0,0,5,0,5
2014,Central African Rep.,CAF,Sweden,SWE,0,0,0,5,5
2014,Chad,TCD,Sweden,SWE,0,0,0,10,10
2014,China,CHN,Sweden,SWE,17,5,10,22,54
2014,Chile,CHL,Sweden,SWE,0,0,5,5,10
2014,Cameroon,CMR,Sweden,SWE,12,5,15,16,48
2014,Congo,COG,Sweden,SWE,0,0,5,10,15
2014,Dem. Rep. of the Congo,COD,Sweden,SWE,12,10,17,19,58
2014,Colombia,COL,Sweden,SWE,0,0,10,0,10
2014,Cuba,CUB,Sweden,SWE,0,0,27,10,37
2014,Djibouti,DJI,Sweden,SWE,0,0,10,42,52
2014,Ecuador,ECU,Sweden,SWE,0,5,0,0,5
2014,Equatorial Guinea,GNQ,Sweden,SWE,0,0,5,0,5
2014,Eritrea,ERI,Sweden,SWE,5131,125,10,1315,6581
2014,Ethiopia,ETH,Sweden,SWE,120,28,145,160,453
2014,Gambia,GMB,Sweden,SWE,15,5,57,70,147
2014,Palestinian,PSE,Sweden,SWE,5,0,10,0,15
2014,Georgia,GEO,Sweden,SWE,5,12,341,302,660
2014,Germany,DEU,Sweden,SWE,0,0,0,5,5
2014,Ghana,GHA,Sweden,SWE,5,0,17,29,51
2014,Guinea-Bissau,GNB,Sweden,SWE,0,0,5,5,10
2014,Greece,GRC,Sweden,SWE,0,5,15,10,30
2014,Guatemala,GTM,Sweden,SWE,0,0,10,0,10
2014,Guinea,GIN,Sweden,SWE,5,0,13,22,40
2014,Honduras,HND,Sweden,SWE,0,0,5,0,5
2014,Croatia,HRV,Sweden,SWE,0,0,13,20,33
2014,Hungary,HUN,Sweden,SWE,0,0,5,0,5
2014,Cote d'Ivoire,CIV,Sweden,SWE,0,5,10,20,35
2014,India,IND,Sweden,SWE,0,0,29,10,39
2014,Iran (Islamic Rep. of),IRN,Sweden,SWE,328,44,190,201,763
2014,Iraq,IRQ,Sweden,SWE,117,321,406,538,1382
2014,Israel,ISR,Sweden,SWE,0,5,5,5,15
2014,Jordan,JOR,Sweden,SWE,35,27,42,87,191
2014,Kazakhstan,KAZ,Sweden,SWE,5,24,117,74,220
2014,Kenya,KEN,Sweden,SWE,5,5,15,37,62
2014,Kyrgyzstan,KGZ,Sweden,SWE,5,5,104,71,185
2014,Kuwait,KWT,Sweden,SWE,0,0,5,5,10
2014,Liberia,LBR,Sweden,SWE,0,5,5,10,20
2014,Libya,LBY,Sweden,SWE,22,14,37,345,418
2014,Lebanon,LBN,Sweden,SWE,16,44,197,145,402
2014,Sri Lanka,LKA,Sweden,SWE,0,0,10,5,15
2014,Lithuania,LTU,Sweden,SWE,0,0,0,5,5
2014,Mauritania,MRT,Sweden,SWE,5,0,5,5,15
2014,North Macedonia,MKD,Sweden,SWE,5,5,230,131,371
2014,Rep. of Moldova,MDA,Sweden,SWE,0,5,5,10,20
2014,Mexico,MEX,Sweden,SWE,0,0,13,5,18
2014,Mali,MLI,Sweden,SWE,5,0,11,20,36
2014,Mongolia,MNG,Sweden,SWE,5,41,284,101,431
2014,Morocco,MAR,Sweden,SWE,16,26,272,500,814
2014,Montenegro,MNE,Sweden,SWE,0,5,63,25,93
2014,Myanmar,MMR,Sweden,SWE,0,0,0,5,5
2014,Nepal,NPL,Sweden,SWE,0,0,5,5,10
2014,Netherlands,NLD,Sweden,SWE,0,0,0,5,5
2014,Niger,NER,Sweden,SWE,0,0,0,10,10
2014,Nicaragua,NIC,Sweden,SWE,0,0,13,5,18
2014,Nigeria,NGA,Sweden,SWE,49,37,155,198,439
2014,Norway,NOR,Sweden,SWE,0,0,0,5,5
2014,Pakistan,PAK,Sweden,SWE,47,5,119,98,269
2014,Peru,PER,Sweden,SWE,0,0,10,5,15
2014,Philippines,PHL,Sweden,SWE,0,0,5,5,10
2014,Poland,POL,Sweden,SWE,0,0,5,0,5
2014,Romania,ROU,Sweden,SWE,0,20,37,5,62
2014,South Africa,ZAF,Sweden,SWE,0,0,5,5,10
2014,Russian Federation,RUS,Sweden,SWE,175,51,334,281,841
2014,Rwanda,RWA,Sweden,SWE,0,0,5,5,10
2014,El Salvador,SLV,Sweden,SWE,0,0,32,5,37
2014,Saudi Arabia,SAU,Sweden,SWE,0,0,0,5,5
2014,Serbia and Kosovo: S/RES/1244 (1999),SRB,Sweden,SWE,5,98,1342,955,2400
2014,Senegal,SEN,Sweden,SWE,10,0,19,19,48
2014,Sierra Leone,SLE,Sweden,SWE,13,5,10,20,48
2014,Somalia,SOM,Sweden,SWE,761,400,492,1493,3146
2014,Spain,ESP,Sweden,SWE,0,0,10,5,15
2014,Viet Nam,VNM,Sweden,SWE,0,0,21,11,32
2014,Sudan,SDN,Sweden,SWE,38,10,31,153,232
2014,Slovakia,SVK,Sweden,SWE,0,0,5,0,5
2014,Slovenia,SVN,Sweden,SWE,0,0,0,5,5
2014,Eswatini,SWZ,Sweden,SWE,0,0,0,10,10
2014,Syrian Arab Rep.,SYR,Sweden,SWE,1759,14627,27,1791,18204
2014,United Rep. of Tanzania,TZA,Sweden,SWE,0,0,15,19,34
2014,Tajikistan,TJK,Sweden,SWE,5,0,18,16,39
2014,Turkmenistan,TKM,Sweden,SWE,0,0,5,0,5
2014,Togo,TGO,Sweden,SWE,0,0,5,0,5
2014,Tunisia,TUN,Sweden,SWE,0,0,48,174,222
2014,Turkey,TUR,Sweden,SWE,0,10,114,28,152
2014,United Arab Emirates,ARE,Sweden,SWE,0,0,0,10,10
2014,Uganda,UGA,Sweden,SWE,103,10,33,72,218
2014,Ukraine,UKR,Sweden,SWE,10,23,163,234,430
2014,United States of America,USA,Sweden,SWE,0,5,18,10,33
2014,Uzbekistan,UZB,Sweden,SWE,32,20,152,71,275
2014,Venezuela (Bolivarian Republic of),VEN,Sweden,SWE,0,0,14,0,14
2014,Yemen,YEM,Sweden,SWE,20,15,37,54,126
2014,Zambia,ZMB,Sweden,SWE,5,0,0,0,5
2014,Zimbabwe,ZWE,Sweden,SWE,0,0,5,5,10
2014,Stateless,XXA,Sweden,SWE,566,3758,342,726,5392
2014,Unknown ,,Sweden,SWE,10,22,227,68,327
2014,Afghanistan,AFG,Switzerland,CHE,289,1566,308,38,2201
2014,Albania,ALB,Switzerland,CHE,5,10,118,24,157
2014,Algeria,DZA,Switzerland,CHE,5,5,363,97,470
2014,Angola,AGO,Switzerland,CHE,0,45,34,0,79
2014,Egypt,EGY,Switzerland,CHE,5,5,114,53,177
2014,Armenia,ARM,Switzerland,CHE,0,16,101,10,127
2014,Azerbaijan,AZE,Switzerland,CHE,13,0,20,0,33
2014,Bahrain,BHR,Switzerland,CHE,0,5,0,0,5
2014,Burundi,BDI,Switzerland,CHE,0,0,5,0,5
2014,Belgium,BEL,Switzerland,CHE,0,0,0,5,5
2014,Benin,BEN,Switzerland,CHE,0,0,40,10,50
2014,Bangladesh,BGD,Switzerland,CHE,5,0,59,5,69
2014,Burkina Faso,BFA,Switzerland,CHE,0,0,21,5,26
2014,Belarus,BLR,Switzerland,CHE,5,0,51,34,90
2014,Bosnia and Herzegovina,BIH,Switzerland,CHE,10,28,105,43,186
2014,Bulgaria,BGR,Switzerland,CHE,0,0,20,0,20
2014,Central African Rep.,CAF,Switzerland,CHE,0,0,5,0,5
2014,Chad,TCD,Switzerland,CHE,0,0,22,10,32
2014,China,CHN,Switzerland,CHE,181,965,248,11,1405
2014,Cameroon,CMR,Switzerland,CHE,0,10,47,5,62
2014,Congo,COG,Switzerland,CHE,0,0,5,0,5
2014,Dem. Rep. of the Congo,COD,Switzerland,CHE,23,100,138,12,273
2014,Colombia,COL,Switzerland,CHE,11,0,5,0,16
2014,Cuba,CUB,Switzerland,CHE,5,0,5,0,10
2014,Czechia,CZE,Switzerland,CHE,0,0,0,5,5
2014,Djibouti,DJI,Switzerland,CHE,0,0,5,0,5
2014,Equatorial Guinea,GNQ,Switzerland,CHE,0,0,10,0,10
2014,Eritrea,ERI,Switzerland,CHE,2272,1359,697,54,4382
2014,Ethiopia,ETH,Switzerland,CHE,85,136,293,14,528
2014,France,FRA,Switzerland,CHE,0,0,0,5,5
2014,Gabon,GAB,Switzerland,CHE,0,0,5,0,5
2014,Gambia,GMB,Switzerland,CHE,0,10,372,74,456
2014,Georgia,GEO,Switzerland,CHE,0,10,371,115,496
2014,Germany,DEU,Switzerland,CHE,0,0,10,5,15
2014,Ghana,GHA,Switzerland,CHE,0,0,91,37,128
2014,Guinea-Bissau,GNB,Switzerland,CHE,0,10,171,56,237
2014,Guinea,GIN,Switzerland,CHE,5,12,216,47,280
2014,Croatia,HRV,Switzerland,CHE,0,0,5,0,5
2014,Hungary,HUN,Switzerland,CHE,0,0,10,77,87
2014,Cote d'Ivoire,CIV,Switzerland,CHE,12,19,83,22,136
2014,India,IND,Switzerland,CHE,0,5,31,0,36
2014,Iran (Islamic Rep. of),IRN,Switzerland,CHE,127,109,221,26,483
2014,Iraq,IRQ,Switzerland,CHE,126,184,154,56,520
2014,Israel,ISR,Switzerland,CHE,0,0,5,5,10
2014,Italy,ITA,Switzerland,CHE,0,0,18,5,23
2014,Jamaica,JAM,Switzerland,CHE,0,0,5,0,5
2014,Jordan,JOR,Switzerland,CHE,0,0,10,0,10
2014,Kazakhstan,KAZ,Switzerland,CHE,0,0,12,19,31
2014,Kenya,KEN,Switzerland,CHE,5,0,18,0,23
2014,Kyrgyzstan,KGZ,Switzerland,CHE,5,0,10,0,15
2014,Liberia,LBR,Switzerland,CHE,0,5,42,5,52
2014,Libya,LBY,Switzerland,CHE,12,42,100,44,198
2014,Lebanon,LBN,Switzerland,CHE,0,5,19,5,29
2014,Sri Lanka,LKA,Switzerland,CHE,1228,247,245,62,1782
2014,Mauritania,MRT,Switzerland,CHE,0,0,44,10,54
2014,North Macedonia,MKD,Switzerland,CHE,0,19,61,18,98
2014,Rep. of Moldova,MDA,Switzerland,CHE,0,0,0,5,5
2014,Mali,MLI,Switzerland,CHE,0,5,211,54,270
2014,Malawi,MWI,Switzerland,CHE,0,0,5,0,5
2014,Mongolia,MNG,Switzerland,CHE,0,11,63,11,85
2014,Morocco,MAR,Switzerland,CHE,5,5,541,245,796
2014,Mozambique,MOZ,Switzerland,CHE,0,0,5,0,5
2014,Montenegro,MNE,Switzerland,CHE,0,5,14,5,24
2014,Myanmar,MMR,Switzerland,CHE,0,10,5,0,15
2014,Nepal,NPL,Switzerland,CHE,0,0,23,0,23
2014,Niger,NER,Switzerland,CHE,0,0,29,15,44
2014,Nigeria,NGA,Switzerland,CHE,0,21,880,107,1008
2014,Pakistan,PAK,Switzerland,CHE,5,5,129,28,167
2014,Poland,POL,Switzerland,CHE,0,0,5,0,5
2014,Romania,ROU,Switzerland,CHE,0,0,11,24,35
2014,South Africa,ZAF,Switzerland,CHE,0,0,0,5,5
2014,Russian Federation,RUS,Switzerland,CHE,63,32,173,31,299
2014,Rwanda,RWA,Switzerland,CHE,0,0,10,0,10
2014,Serbia and Kosovo: S/RES/1244 (1999),SRB,Switzerland,CHE,14,157,575,106,852
2014,Senegal,SEN,Switzerland,CHE,0,11,146,49,206
2014,Sierra Leone,SLE,Switzerland,CHE,0,0,56,13,69
2014,Somalia,SOM,Switzerland,CHE,205,537,197,49,988
2014,Spain,ESP,Switzerland,CHE,0,0,5,0,5
2014,Viet Nam,VNM,Switzerland,CHE,5,0,10,0,15
2014,Sudan,SDN,Switzerland,CHE,34,18,81,14,147
2014,South Sudan,SSD,Switzerland,CHE,0,0,44,0,44
2014,Slovakia,SVK,Switzerland,CHE,0,0,5,5,10
2014,Syrian Arab Rep.,SYR,Switzerland,CHE,916,1905,221,174,3216
2014,United Rep. of Tanzania,TZA,Switzerland,CHE,0,0,12,0,12
2014,Togo,TGO,Switzerland,CHE,36,5,61,5,107
2014,Tunisia,TUN,Switzerland,CHE,5,0,633,272,910
2014,Turkey,TUR,Switzerland,CHE,326,73,254,45,698
2014,Uganda,UGA,Switzerland,CHE,0,0,34,5,39
2014,Ukraine,UKR,Switzerland,CHE,0,0,91,24,115
2014,United States of America,USA,Switzerland,CHE,0,0,5,0,5
2014,Uzbekistan,UZB,Switzerland,CHE,0,0,5,0,5
2014,Western Sahara,ESH,Switzerland,CHE,0,0,5,0,5
2014,Yemen,YEM,Switzerland,CHE,37,21,29,5,92
2014,Zambia,ZMB,Switzerland,CHE,0,0,5,0,5
2014,Zimbabwe,ZWE,Switzerland,CHE,0,0,5,0,5
2014,Stateless,XXA,Switzerland,CHE,5,5,20,5,35
2014,Unknown ,,Switzerland,CHE,92,158,299,52,601
2014,Burundi,BDI,United Rep. of Tanzania,TZA,5,0,23,0,28
2014,Dem. Rep. of the Congo,COD,United Rep. of Tanzania,TZA,183,0,299,0,482
2014,Unknown ,,United Rep. of Tanzania,TZA,18,0,21,0,39
2014,Myanmar,MMR,Thailand,THA,740,0,0,310,1050
2014,Central African Rep.,CAF,Togo,TGO,310,0,0,0,310
2014,Dem. Rep. of the Congo,COD,Togo,TGO,15,0,0,0,15
2014,Afghanistan,AFG,Ukraine,UKR,61,16,112,37,226
2014,Egypt,EGY,Ukraine,UKR,0,0,5,0,5
2014,Armenia,ARM,Ukraine,UKR,0,0,5,0,5
2014,Bangladesh,BGD,Ukraine,UKR,0,0,5,0,5
2014,Belarus,BLR,Ukraine,UKR,0,0,5,0,5
2014,Cameroon,CMR,Ukraine,UKR,0,0,5,0,5
2014,Dem. Rep. of the Congo,COD,Ukraine,UKR,0,0,15,0,15
2014,Eritrea,ERI,Ukraine,UKR,0,0,5,5,10
2014,Palestinian,PSE,Ukraine,UKR,0,0,0,5,5
2014,Georgia,GEO,Ukraine,UKR,0,5,5,0,10
2014,Guinea,GIN,Ukraine,UKR,0,0,5,10,15
2014,Cote d'Ivoire,CIV,Ukraine,UKR,0,0,10,0,10
2014,Iran (Islamic Rep. of),IRN,Ukraine,UKR,5,0,11,10,26
2014,Iraq,IRQ,Ukraine,UKR,0,5,14,5,24
2014,Kyrgyzstan,KGZ,Ukraine,UKR,0,0,0,5,5
2014,Sri Lanka,LKA,Ukraine,UKR,0,0,0,10,10
2014,Nigeria,NGA,Ukraine,UKR,0,0,5,0,5
2014,Pakistan,PAK,Ukraine,UKR,5,0,5,0,10
2014,Russian Federation,RUS,Ukraine,UKR,5,0,34,31,70
2014,Somalia,SOM,Ukraine,UKR,0,0,19,12,31
2014,Viet Nam,VNM,Ukraine,UKR,5,0,0,0,5
2014,Sudan,SDN,Ukraine,UKR,0,5,13,11,29
2014,Syrian Arab Rep.,SYR,Ukraine,UKR,12,166,42,14,234
2014,Uzbekistan,UZB,Ukraine,UKR,0,0,12,5,17
2014,Stateless,XXA,Ukraine,UKR,5,10,5,5,25
2014,Brazil,BRA,Uruguay,URY,0,0,0,5,5
2014,Colombia,COL,Uruguay,URY,5,0,5,10,20
2014,Mexico,MEX,Uruguay,URY,0,0,0,5,5
2014,Syrian Arab Rep.,SYR,Uruguay,URY,5,0,0,0,5
2014,Colombia,COL,Venezuela (Bolivarian Republic of),VEN,724,0,2402,0,3126
2014,Burundi,BDI,Zambia,ZMB,0,0,0,21,21
2014,Dem. Rep. of the Congo,COD,Zambia,ZMB,783,0,308,0,1091
2014,Rwanda,RWA,Zambia,ZMB,5,0,151,0,156
2014,Somalia,SOM,Zambia,ZMB,12,0,11,0,23
2014,Burundi,BDI,Zimbabwe,ZWE,14,0,30,0,44
2014,Dem. Rep. of the Congo,COD,Zimbabwe,ZWE,893,0,277,0,1170
2014,Eritrea,ERI,Zimbabwe,ZWE,5,0,0,0,5
2014,Ethiopia,ETH,Zimbabwe,ZWE,5,0,5,0,10
2014,Cote d'Ivoire,CIV,Zimbabwe,ZWE,5,0,0,0,5
2014,Rwanda,RWA,Zimbabwe,ZWE,46,0,0,0,46
2015,Afghanistan,AFG,Albania,ALB,5,0,0,0,5
2015,Azerbaijan,AZE,Albania,ALB,0,0,0,5,5
2015,Central African Rep.,CAF,Albania,ALB,0,0,0,5,5
2015,Eritrea,ERI,Albania,ALB,0,0,0,10,10
2015,Gabon,GAB,Albania,ALB,0,0,0,5,5
2015,Iran (Islamic Rep. of),IRN,Albania,ALB,39,0,0,86,125
2015,Sudan,SDN,Albania,ALB,0,0,0,5,5
2015,Syrian Arab Rep.,SYR,Albania,ALB,0,0,0,79,79
2015,Chad,TCD,Angola,AGO,10,0,0,0,10
2015,Eritrea,ERI,Angola,AGO,15,0,0,0,15
2015,Guinea,GIN,Angola,AGO,5,0,10,0,15
2015,Cote d'Ivoire,CIV,Angola,AGO,12,0,15,0,27
2015,Liberia,LBR,Angola,AGO,5,0,0,0,5
2015,Mauritania,MRT,Angola,AGO,16,0,10,5,31
2015,Rwanda,RWA,Angola,AGO,16,0,0,0,16
2015,Somalia,SOM,Angola,AGO,16,0,0,5,21
2015,Sudan,SDN,Angola,AGO,13,0,0,0,13
2015,Western Sahara,ESH,Angola,AGO,5,0,0,0,5
2015,Angola,AGO,Argentina,ARG,5,0,0,0,5
2015,Armenia,ARM,Argentina,ARG,0,0,10,5,15
2015,Bangladesh,BGD,Argentina,ARG,0,0,5,0,5
2015,China,CHN,Argentina,ARG,0,0,5,0,5
2015,Chile,CHL,Argentina,ARG,0,0,0,5,5
2015,Cameroon,CMR,Argentina,ARG,0,0,10,5,15
2015,Dem. Rep. of the Congo,COD,Argentina,ARG,0,0,0,5,5
2015,Colombia,COL,Argentina,ARG,5,0,20,60,85
2015,Cuba,CUB,Argentina,ARG,5,0,153,27,185
2015,Dominican Rep.,DOM,Argentina,ARG,0,0,35,23,58
2015,Ghana,GHA,Argentina,ARG,0,0,23,0,23
2015,Guinea,GIN,Argentina,ARG,0,0,5,0,5
2015,Haiti,HTI,Argentina,ARG,0,0,57,16,73
2015,Hungary,HUN,Argentina,ARG,0,0,5,0,5
2015,India,IND,Argentina,ARG,0,0,24,21,45
2015,Mexico,MEX,Argentina,ARG,0,0,0,5,5
2015,Nigeria,NGA,Argentina,ARG,0,0,5,5,10
2015,Pakistan,PAK,Argentina,ARG,0,0,5,5,10
2015,Peru,PER,Argentina,ARG,0,0,0,10,10
2015,Russian Federation,RUS,Argentina,ARG,12,0,0,5,17
2015,El Salvador,SLV,Argentina,ARG,0,0,0,5,5
2015,Senegal,SEN,Argentina,ARG,0,0,280,16,296
2015,Syrian Arab Rep.,SYR,Argentina,ARG,55,0,19,10,84
2015,Ukraine,UKR,Argentina,ARG,23,0,10,16,49
2015,Guinea,GIN,Armenia,ARM,0,0,5,0,5
2015,Iran (Islamic Rep. of),IRN,Armenia,ARM,0,0,10,10,20
2015,Iraq,IRQ,Armenia,ARM,40,0,5,16,61
2015,Lebanon,LBN,Armenia,ARM,0,0,5,5,10
2015,Syrian Arab Rep.,SYR,Armenia,ARM,87,0,0,14,101
2015,Ukraine,UKR,Armenia,ARM,68,0,14,36,118
2015,Yemen,YEM,Armenia,ARM,5,0,0,0,5
2015,Afghanistan,AFG,Australia,AUS,249,0,33,5,287
2015,Albania,ALB,Australia,AUS,5,0,0,5,10
2015,Egypt,EGY,Australia,AUS,124,0,10,12,146
2015,Bahrain,BHR,Australia,AUS,5,0,0,0,5
2015,Burundi,BDI,Australia,AUS,5,0,0,0,5
2015,Bangladesh,BGD,Australia,AUS,39,0,36,29,104
2015,Bhutan,BTN,Australia,AUS,5,0,0,0,5
2015,Brazil,BRA,Australia,AUS,0,0,0,5,5
2015,Cambodia,KHM,Australia,AUS,0,0,5,5,10
2015,China,CHN,Australia,AUS,147,0,111,149,407
2015,Cameroon,CMR,Australia,AUS,5,0,0,0,5
2015,Colombia,COL,Australia,AUS,5,0,10,0,15
2015,Eritrea,ERI,Australia,AUS,5,0,0,0,5
2015,Ethiopia,ETH,Australia,AUS,27,0,5,5,37
2015,Fiji,FJI,Australia,AUS,19,0,35,74,128
2015,France,FRA,Australia,AUS,0,0,5,5,10
2015,Palestinian,PSE,Australia,AUS,17,0,5,0,22
2015,United Kingdom of Great Britain and Northern Ireland,GBR,Australia,AUS,5,0,5,14,24
2015,Georgia,GEO,Australia,AUS,5,0,0,0,5
2015,Germany,DEU,Australia,AUS,0,0,0,5,5
2015,Ghana,GHA,Australia,AUS,0,0,5,5,10
2015,Greece,GRC,Australia,AUS,5,0,0,0,5
2015,Guinea,GIN,Australia,AUS,5,0,0,0,5
2015,"China, Hong Kong SAR",HKG,Australia,AUS,0,0,10,10,20
2015,Hungary,HUN,Australia,AUS,0,0,0,5,5
2015,India,IND,Australia,AUS,25,0,54,141,220
2015,Indonesia,IDN,Australia,AUS,18,0,23,29,70
2015,Ireland,IRL,Australia,AUS,0,0,5,29,34
2015,Iran (Islamic Rep. of),IRN,Australia,AUS,303,0,130,27,460
2015,Iraq,IRQ,Australia,AUS,387,0,29,19,435
2015,Israel,ISR,Australia,AUS,0,0,5,5,10
2015,Italy,ITA,Australia,AUS,5,0,0,15,20
2015,Jordan,JOR,Australia,AUS,10,0,5,10,25
2015,Japan,JPN,Australia,AUS,0,0,5,0,5
2015,Kenya,KEN,Australia,AUS,10,0,5,0,15
2015,Rep. of Korea,KOR,Australia,AUS,5,0,12,31,48
2015,Dem. People's Rep. of Korea,PRK,Australia,AUS,0,0,5,0,5
2015,Kuwait,KWT,Australia,AUS,5,0,0,0,5
2015,Lao People's Dem. Rep.,LAO,Australia,AUS,5,0,5,0,10
2015,Liberia,LBR,Australia,AUS,5,0,5,0,10
2015,Libya,LBY,Australia,AUS,142,0,5,5,152
2015,Lebanon,LBN,Australia,AUS,92,0,10,10,112
2015,Sri Lanka,LKA,Australia,AUS,171,0,753,22,946
2015,North Macedonia,MKD,Australia,AUS,5,0,0,5,10
2015,Maldives,MDV,Australia,AUS,5,0,0,0,5
2015,Mexico,MEX,Australia,AUS,0,0,5,0,5
2015,Malaysia,MYS,Australia,AUS,18,0,303,216,537
2015,Mongolia,MNG,Australia,AUS,0,0,5,0,5
2015,Morocco,MAR,Australia,AUS,5,0,0,0,5
2015,Mauritius,MUS,Australia,AUS,5,0,0,0,5
2015,Myanmar,MMR,Australia,AUS,10,0,5,0,15
2015,Nepal,NPL,Australia,AUS,10,0,18,22,50
2015,Netherlands,NLD,Australia,AUS,0,0,5,0,5
2015,Nigeria,NGA,Australia,AUS,5,0,5,12,22
2015,New Zealand,NZL,Australia,AUS,5,0,0,0,5
2015,Oman,OMN,Australia,AUS,5,0,0,0,5
2015,Pakistan,PAK,Australia,AUS,270,0,45,69,384
2015,Peru,PER,Australia,AUS,5,0,0,0,5
2015,Philippines,PHL,Australia,AUS,5,0,5,18,28
2015,Papua New Guinea,PNG,Australia,AUS,53,0,5,20,78
2015,Poland,POL,Australia,AUS,0,0,5,0,5
2015,Romania,ROU,Australia,AUS,0,0,0,5,5
2015,South Africa,ZAF,Australia,AUS,0,0,0,5,5
2015,Russian Federation,RUS,Australia,AUS,5,0,5,0,10
2015,Rwanda,RWA,Australia,AUS,5,0,5,0,10
2015,Saudi Arabia,SAU,Australia,AUS,16,0,5,5,26
2015,Sierra Leone,SLE,Australia,AUS,5,0,0,0,5
2015,Solomon Islands,SLB,Australia,AUS,5,0,5,5,15
2015,Somalia,SOM,Australia,AUS,5,0,0,0,5
2015,Viet Nam,VNM,Australia,AUS,11,0,35,23,69
2015,Sudan,SDN,Australia,AUS,5,0,10,0,15
2015,Syrian Arab Rep.,SYR,Australia,AUS,5,0,113,5,123
2015,United Rep. of Tanzania,TZA,Australia,AUS,5,0,5,0,10
2015,Thailand,THA,Australia,AUS,0,0,5,12,17
2015,Timor-Leste,TLS,Australia,AUS,5,0,0,0,5
2015,Tonga,TON,Australia,AUS,5,0,5,11,21
2015,Turkey,TUR,Australia,AUS,33,0,10,11,54
2015,Uganda,UGA,Australia,AUS,5,0,0,0,5
2015,Ukraine,UKR,Australia,AUS,5,0,5,5,15
2015,United States of America,USA,Australia,AUS,5,0,0,5,10
2015,Yemen,YEM,Australia,AUS,5,0,0,0,5
2015,Zambia,ZMB,Australia,AUS,5,0,5,0,10
2015,Zimbabwe,ZWE,Australia,AUS,10,0,5,5,20
2015,Stateless,XXA,Australia,AUS,14,0,52,5,71
2015,Tibetan,TIB,Australia,AUS,5,0,5,0,10
2015,Unknown ,,Australia,AUS,0,0,5,0,5
2015,Afghanistan,AFG,Azerbaijan,AZE,0,0,114,5,119
2015,Iran (Islamic Rep. of),IRN,Azerbaijan,AZE,0,0,17,0,17
2015,Nepal,NPL,Azerbaijan,AZE,0,0,0,5,5
2015,Pakistan,PAK,Azerbaijan,AZE,0,0,68,10,78
2015,Syrian Arab Rep.,SYR,Azerbaijan,AZE,0,0,5,0,5
2015,Ukraine,UKR,Azerbaijan,AZE,0,0,24,10,34
2015,Yemen,YEM,Azerbaijan,AZE,0,0,5,0,5
2015,Dem. Rep. of the Congo,COD,Burundi,BDI,2826,0,0,472,3298
2015,Comoros,COM,Burundi,BDI,0,0,0,5,5
2015,Mali,MLI,Burundi,BDI,5,0,0,0,5
2015,Rwanda,RWA,Burundi,BDI,13,0,0,14,27
2015,Somalia,SOM,Burundi,BDI,0,0,0,5,5
2015,Afghanistan,AFG,Belgium,BEL,583,407,249,10,1249
2015,Albania,ALB,Belgium,BEL,50,5,454,56,565
2015,Algeria,DZA,Belgium,BEL,18,0,45,14,77
2015,Angola,AGO,Belgium,BEL,5,0,47,0,52
2015,Egypt,EGY,Belgium,BEL,22,0,42,10,74
2015,Armenia,ARM,Belgium,BEL,14,10,134,12,170
2015,Azerbaijan,AZE,Belgium,BEL,30,0,19,5,54
2015,Burundi,BDI,Belgium,BEL,112,5,23,0,140
2015,Benin,BEN,Belgium,BEL,0,0,19,0,19
2015,Bangladesh,BGD,Belgium,BEL,5,0,33,0,38
2015,Burkina Faso,BFA,Belgium,BEL,31,0,35,0,66
2015,Belarus,BLR,Belgium,BEL,5,0,5,5,15
2015,Bosnia and Herzegovina,BIH,Belgium,BEL,0,0,51,5,56
2015,Bulgaria,BGR,Belgium,BEL,0,0,5,0,5
2015,Central African Rep.,CAF,Belgium,BEL,10,10,5,0,25
2015,China,CHN,Belgium,BEL,142,0,51,5,198
2015,Cameroon,CMR,Belgium,BEL,65,5,153,13,236
2015,Congo,COG,Belgium,BEL,0,0,5,0,5
2015,Dem. Rep. of the Congo,COD,Belgium,BEL,200,5,408,10,623
2015,Colombia,COL,Belgium,BEL,5,0,0,0,5
2015,Djibouti,DJI,Belgium,BEL,88,0,54,0,142
2015,Eritrea,ERI,Belgium,BEL,648,0,38,5,691
2015,Ethiopia,ETH,Belgium,BEL,18,0,41,5,64
2015,Gabon,GAB,Belgium,BEL,5,0,0,0,5
2015,Gambia,GMB,Belgium,BEL,5,0,23,5,33
2015,Palestinian,PSE,Belgium,BEL,5,0,10,5,20
2015,Georgia,GEO,Belgium,BEL,5,0,166,24,195
2015,Ghana,GHA,Belgium,BEL,5,0,15,0,20
2015,Guinea-Bissau,GNB,Belgium,BEL,0,0,5,0,5
2015,Guinea,GIN,Belgium,BEL,562,5,265,35,867
2015,Haiti,HTI,Belgium,BEL,0,0,5,0,5
2015,Croatia,HRV,Belgium,BEL,0,0,5,0,5
2015,Cote d'Ivoire,CIV,Belgium,BEL,26,0,53,0,79
2015,India,IND,Belgium,BEL,0,0,24,5,29
2015,Iran (Islamic Rep. of),IRN,Belgium,BEL,226,5,57,29,317
2015,Iraq,IRQ,Belgium,BEL,627,336,307,66,1336
2015,Jordan,JOR,Belgium,BEL,0,0,13,5,18
2015,Kazakhstan,KAZ,Belgium,BEL,0,0,25,0,25
2015,Kenya,KEN,Belgium,BEL,5,0,12,0,17
2015,Kyrgyzstan,KGZ,Belgium,BEL,5,0,16,0,21
2015,Dem. People's Rep. of Korea,PRK,Belgium,BEL,0,0,5,0,5
2015,Libya,LBY,Belgium,BEL,26,32,0,0,58
2015,Lebanon,LBN,Belgium,BEL,27,5,45,10,87
2015,Sri Lanka,LKA,Belgium,BEL,99,0,14,0,113
2015,Lithuania,LTU,Belgium,BEL,0,0,5,0,5
2015,Mauritania,MRT,Belgium,BEL,21,0,58,0,79
2015,North Macedonia,MKD,Belgium,BEL,22,0,221,22,265
2015,Rep. of Moldova,MDA,Belgium,BEL,0,0,5,0,5
2015,Mexico,MEX,Belgium,BEL,0,0,10,0,10
2015,Mali,MLI,Belgium,BEL,11,0,27,0,38
2015,Mongolia,MNG,Belgium,BEL,0,0,10,0,10
2015,Morocco,MAR,Belgium,BEL,20,0,99,14,133
2015,Montenegro,MNE,Belgium,BEL,0,0,10,0,10
2015,Myanmar,MMR,Belgium,BEL,0,0,5,0,5
2015,Nepal,NPL,Belgium,BEL,0,0,17,0,17
2015,Niger,NER,Belgium,BEL,11,0,58,0,69
2015,Nigeria,NGA,Belgium,BEL,5,0,55,0,60
2015,Pakistan,PAK,Belgium,BEL,79,0,174,13,266
2015,Philippines,PHL,Belgium,BEL,0,0,5,0,5
2015,Romania,ROU,Belgium,BEL,0,0,5,0,5
2015,Russian Federation,RUS,Belgium,BEL,326,5,476,40,847
2015,Rwanda,RWA,Belgium,BEL,79,0,180,10,269
2015,El Salvador,SLV,Belgium,BEL,0,52,5,5,62
2015,Serbia and Kosovo: S/RES/1244 (1999),SRB,Belgium,BEL,101,0,576,29,706
2015,Senegal,SEN,Belgium,BEL,67,0,109,16,192
2015,Sierra Leone,SLE,Belgium,BEL,0,0,10,0,10
2015,Somalia,SOM,Belgium,BEL,265,274,105,10,654
2015,Sudan,SDN,Belgium,BEL,54,0,32,5,91
2015,Syrian Arab Rep.,SYR,Belgium,BEL,3443,430,57,27,3957
2015,United Rep. of Tanzania,TZA,Belgium,BEL,13,0,5,0,18
2015,Tajikistan,TJK,Belgium,BEL,13,0,10,0,23
2015,Togo,TGO,Belgium,BEL,29,0,84,5,118
2015,Tunisia,TUN,Belgium,BEL,19,0,28,5,52
2015,Turkey,TUR,Belgium,BEL,38,0,104,10,152
2015,Uganda,UGA,Belgium,BEL,5,0,13,0,18
2015,Ukraine,UKR,Belgium,BEL,73,42,303,26,444
2015,United States of America,USA,Belgium,BEL,0,0,5,0,5
2015,Venezuela (Bolivarian Republic of),VEN,Belgium,BEL,5,0,0,0,5
2015,Yemen,YEM,Belgium,BEL,18,16,0,0,34
2015,Stateless,XXA,Belgium,BEL,5,0,11,0,16
2015,Unknown ,,Belgium,BEL,721,0,121,40,882
2015,Central African Rep.,CAF,Benin,BEN,114,0,0,0,114
2015,Cote d'Ivoire,CIV,Benin,BEN,10,0,0,0,10
2015,Afghanistan,AFG,Belarus,BLR,5,0,13,27,45
2015,Armenia,ARM,Belarus,BLR,0,0,5,0,5
2015,Georgia,GEO,Belarus,BLR,0,0,0,5,5
2015,Iraq,IRQ,Belarus,BLR,0,0,5,12,17
2015,Libya,LBY,Belarus,BLR,0,10,0,0,10
2015,Russian Federation,RUS,Belarus,BLR,0,0,10,0,10
2015,Syrian Arab Rep.,SYR,Belarus,BLR,16,50,22,56,144
2015,Ukraine,UKR,Belarus,BLR,0,804,31,100,935
2015,Yemen,YEM,Belarus,BLR,0,13,0,5,18
2015,Brazil,BRA,Bolivia (Plurinational State of),BOL,0,0,5,0,5
2015,Colombia,COL,Bolivia (Plurinational State of),BOL,5,0,10,0,15
2015,Ghana,GHA,Bolivia (Plurinational State of),BOL,0,0,5,0,5
2015,Nigeria,NGA,Bolivia (Plurinational State of),BOL,0,0,18,0,18
2015,Burundi,BDI,Botswana,BWA,0,0,23,0,23
2015,Dem. Rep. of the Congo,COD,Botswana,BWA,5,0,413,11,429
2015,Eritrea,ERI,Botswana,BWA,10,0,0,0,10
2015,Somalia,SOM,Botswana,BWA,0,0,25,11,36
2015,Zimbabwe,ZWE,Botswana,BWA,0,0,16,14,30
2015,Afghanistan,AFG,Brazil,BRA,24,0,0,0,24
2015,Angola,AGO,Brazil,BRA,13,0,36,0,49
2015,Egypt,EGY,Brazil,BRA,5,0,5,0,10
2015,Burundi,BDI,Brazil,BRA,5,0,0,0,5
2015,Benin,BEN,Brazil,BRA,0,0,5,0,5
2015,Bangladesh,BGD,Brazil,BRA,0,0,0,1966,1966
2015,Burkina Faso,BFA,Brazil,BRA,0,0,33,0,33
2015,Bolivia (Plurinational State of),BOL,Brazil,BRA,5,0,0,0,5
2015,Cameroon,CMR,Brazil,BRA,11,0,5,0,16
2015,Congo,COG,Brazil,BRA,5,0,0,0,5
2015,Dem. Rep. of the Congo,COD,Brazil,BRA,254,0,14,0,268
2015,Colombia,COL,Brazil,BRA,80,0,11,0,91
2015,Cuba,CUB,Brazil,BRA,10,0,13,0,23
2015,Cabo Verde,CPV,Brazil,BRA,0,0,5,0,5
2015,Dominican Rep.,DOM,Brazil,BRA,0,0,5,0,5
2015,Gambia,GMB,Brazil,BRA,0,0,13,0,13
2015,Palestinian,PSE,Brazil,BRA,70,0,0,0,70
2015,Ghana,GHA,Brazil,BRA,5,0,14,1163,1182
2015,Guinea-Bissau,GNB,Brazil,BRA,0,0,57,375,432
2015,Guinea,GIN,Brazil,BRA,20,0,10,0,30
2015,Cote d'Ivoire,CIV,Brazil,BRA,10,0,16,0,26
2015,Iran (Islamic Rep. of),IRN,Brazil,BRA,10,0,0,0,10
2015,Iraq,IRQ,Brazil,BRA,28,0,0,0,28
2015,Lebanon,LBN,Brazil,BRA,5,0,5,0,10
2015,Mexico,MEX,Brazil,BRA,5,0,0,0,5
2015,Nigeria,NGA,Brazil,BRA,11,0,79,0,90
2015,Pakistan,PAK,Brazil,BRA,65,0,24,0,89
2015,Peru,PER,Brazil,BRA,0,0,10,0,10
2015,Philippines,PHL,Brazil,BRA,0,0,5,0,5
2015,Senegal,SEN,Brazil,BRA,0,0,15,0,15
2015,Sierra Leone,SLE,Brazil,BRA,0,0,5,0,5
2015,Sudan,SDN,Brazil,BRA,10,0,0,0,10
2015,Syrian Arab Rep.,SYR,Brazil,BRA,532,0,0,0,532
2015,Togo,TGO,Brazil,BRA,10,0,15,0,25
2015,Venezuela (Bolivarian Republic of),VEN,Brazil,BRA,5,0,26,0,31
2015,Afghanistan,AFG,Bosnia and Herzegovina,BIH,0,0,0,13,13
2015,Cameroon,CMR,Bosnia and Herzegovina,BIH,0,0,0,5,5
2015,Palestinian,PSE,Bosnia and Herzegovina,BIH,0,0,0,5,5
2015,Syrian Arab Rep.,SYR,Bosnia and Herzegovina,BIH,0,5,0,0,5
2015,Afghanistan,AFG,Bulgaria,BGR,0,5,92,7351,7448
2015,Algeria,DZA,Bulgaria,BGR,0,0,0,46,46
2015,Armenia,ARM,Bulgaria,BGR,0,0,5,0,5
2015,Azerbaijan,AZE,Bulgaria,BGR,0,0,5,0,5
2015,Bangladesh,BGD,Bulgaria,BGR,0,0,0,57,57
2015,Central African Rep.,CAF,Bulgaria,BGR,0,0,0,5,5
2015,Cameroon,CMR,Bulgaria,BGR,0,0,12,16,28
2015,Congo,COG,Bulgaria,BGR,0,0,0,5,5
2015,Dem. Rep. of the Congo,COD,Bulgaria,BGR,0,0,0,5,5
2015,Dominican Rep.,DOM,Bulgaria,BGR,0,0,0,5,5
2015,Eritrea,ERI,Bulgaria,BGR,0,0,0,15,15
2015,Gambia,GMB,Bulgaria,BGR,0,0,0,11,11
2015,Ghana,GHA,Bulgaria,BGR,0,0,15,13,28
2015,Cote d'Ivoire,CIV,Bulgaria,BGR,0,0,11,10,21
2015,India,IND,Bulgaria,BGR,0,0,0,49,49
2015,Iran (Islamic Rep. of),IRN,Bulgaria,BGR,0,0,15,205,220
2015,Iraq,IRQ,Bulgaria,BGR,107,49,180,6240,6576
2015,Liberia,LBR,Bulgaria,BGR,0,0,0,5,5
2015,Libya,LBY,Bulgaria,BGR,0,0,0,5,5
2015,Lebanon,LBN,Bulgaria,BGR,0,0,11,12,23
2015,Sri Lanka,LKA,Bulgaria,BGR,0,0,0,17,17
2015,Mali,MLI,Bulgaria,BGR,0,0,10,32,42
2015,Morocco,MAR,Bulgaria,BGR,0,0,0,10,10
2015,Myanmar,MMR,Bulgaria,BGR,0,0,0,23,23
2015,Nigeria,NGA,Bulgaria,BGR,0,0,10,0,10
2015,Pakistan,PAK,Bulgaria,BGR,0,0,19,686,705
2015,Rwanda,RWA,Bulgaria,BGR,0,0,5,10,15
2015,Senegal,SEN,Bulgaria,BGR,0,0,0,10,10
2015,Sierra Leone,SLE,Bulgaria,BGR,0,0,0,5,5
2015,Somalia,SOM,Bulgaria,BGR,0,0,0,14,14
2015,Sudan,SDN,Bulgaria,BGR,0,0,5,0,5
2015,Syrian Arab Rep.,SYR,Bulgaria,BGR,4520,802,66,2042,7430
2015,Tunisia,TUN,Bulgaria,BGR,0,0,0,5,5
2015,Turkey,TUR,Bulgaria,BGR,0,0,0,5,5
2015,Uganda,UGA,Bulgaria,BGR,0,0,0,5,5
2015,Ukraine,UKR,Bulgaria,BGR,0,0,40,16,56
2015,Stateless,XXA,Bulgaria,BGR,68,26,15,63,172
2015,Viet Nam,VNM,Cambodia,KHM,13,0,0,0,13
2015,Thailand,THA,Cambodia,KHM,0,0,0,5,5
2015,Afghanistan,AFG,Canada,CAN,292,0,38,26,356
2015,Albania,ALB,Canada,CAN,31,0,41,5,77
2015,Algeria,DZA,Canada,CAN,32,0,35,0,67
2015,Angola,AGO,Canada,CAN,5,0,15,0,20
2015,Antigua and Barbuda,ATG,Canada,CAN,10,0,0,0,10
2015,Egypt,EGY,Canada,CAN,164,0,16,5,185
2015,Argentina,ARG,Canada,CAN,0,0,5,0,5
2015,Armenia,ARM,Canada,CAN,0,0,5,0,5
2015,Azerbaijan,AZE,Canada,CAN,5,0,0,0,5
2015,Bahrain,BHR,Canada,CAN,5,0,0,0,5
2015,Barbados,BRB,Canada,CAN,16,0,5,0,21
2015,Burundi,BDI,Canada,CAN,112,0,37,0,149
2015,Benin,BEN,Canada,CAN,15,0,5,0,20
2015,Bangladesh,BGD,Canada,CAN,127,0,61,12,200
2015,Bahamas,BHS,Canada,CAN,17,0,10,5,32
2015,Burkina Faso,BFA,Canada,CAN,13,0,0,0,13
2015,Belarus,BLR,Canada,CAN,0,0,5,0,5
2015,Bolivia (Plurinational State of),BOL,Canada,CAN,0,0,5,0,5
2015,Brazil,BRA,Canada,CAN,5,0,10,5,20
2015,Bosnia and Herzegovina,BIH,Canada,CAN,5,0,0,0,5
2015,Bulgaria,BGR,Canada,CAN,5,0,5,0,10
2015,Cambodia,KHM,Canada,CAN,5,0,5,0,10
2015,Central African Rep.,CAF,Canada,CAN,13,0,0,0,13
2015,Chad,TCD,Canada,CAN,59,0,24,0,83
2015,China,CHN,Canada,CAN,652,0,567,53,1272
2015,Chile,CHL,Canada,CAN,0,0,10,0,10
2015,Cameroon,CMR,Canada,CAN,145,0,48,0,193
2015,Congo,COG,Canada,CAN,20,0,14,0,34
2015,Dem. Rep. of the Congo,COD,Canada,CAN,102,0,160,5,267
2015,Colombia,COL,Canada,CAN,293,0,234,37,564
2015,Cuba,CUB,Canada,CAN,77,0,33,13,123
2015,Czechia,CZE,Canada,CAN,34,0,16,25,75
2015,Djibouti,DJI,Canada,CAN,40,0,12,0,52
2015,Dominican Rep.,DOM,Canada,CAN,5,0,12,5,22
2015,Ecuador,ECU,Canada,CAN,5,0,5,0,10
2015,Equatorial Guinea,GNQ,Canada,CAN,5,0,0,0,5
2015,Eritrea,ERI,Canada,CAN,228,0,15,5,248
2015,Ethiopia,ETH,Canada,CAN,152,0,71,5,228
2015,France,FRA,Canada,CAN,0,0,5,5,10
2015,Gabon,GAB,Canada,CAN,0,0,5,0,5
2015,Gambia,GMB,Canada,CAN,10,0,5,0,15
2015,Palestinian,PSE,Canada,CAN,78,0,29,10,117
2015,Georgia,GEO,Canada,CAN,15,0,27,5,47
2015,Ghana,GHA,Canada,CAN,30,0,48,0,78
2015,Greece,GRC,Canada,CAN,0,0,14,0,14
2015,Grenada,GRD,Canada,CAN,0,0,5,0,5
2015,Guatemala,GTM,Canada,CAN,16,0,18,5,39
2015,Guinea,GIN,Canada,CAN,23,0,23,0,46
2015,Guyana,GUY,Canada,CAN,0,0,10,0,10
2015,Haiti,HTI,Canada,CAN,134,0,178,13,325
2015,Honduras,HND,Canada,CAN,65,0,44,10,119
2015,Croatia,HRV,Canada,CAN,10,0,13,5,28
2015,Hungary,HUN,Canada,CAN,493,0,117,78,688
2015,Cote d'Ivoire,CIV,Canada,CAN,12,0,12,0,24
2015,India,IND,Canada,CAN,86,0,146,45,277
2015,Indonesia,IDN,Canada,CAN,10,0,10,0,20
2015,Iran (Islamic Rep. of),IRN,Canada,CAN,118,0,15,5,138
2015,Iraq,IRQ,Canada,CAN,524,0,41,24,589
2015,Israel,ISR,Canada,CAN,5,0,31,5,41
2015,Italy,ITA,Canada,CAN,0,0,28,0,28
2015,Jamaica,JAM,Canada,CAN,81,0,75,0,156
2015,Jordan,JOR,Canada,CAN,34,0,38,5,77
2015,Japan,JPN,Canada,CAN,0,0,0,5,5
2015,Kazakhstan,KAZ,Canada,CAN,10,0,5,0,15
2015,Kenya,KEN,Canada,CAN,25,0,16,0,41
2015,Kyrgyzstan,KGZ,Canada,CAN,14,0,10,0,24
2015,Rep. of Korea,KOR,Canada,CAN,0,0,5,0,5
2015,Kuwait,KWT,Canada,CAN,0,0,5,0,5
2015,Liberia,LBR,Canada,CAN,0,0,5,0,5
2015,Libya,LBY,Canada,CAN,361,0,52,0,413
2015,Saint Lucia,LCA,Canada,CAN,14,0,15,0,29
2015,Lebanon,LBN,Canada,CAN,58,0,72,0,130
2015,Sri Lanka,LKA,Canada,CAN,163,0,43,5,211
2015,Mauritania,MRT,Canada,CAN,18,0,10,0,28
2015,Mexico,MEX,Canada,CAN,35,0,33,11,79
2015,Mali,MLI,Canada,CAN,27,0,38,5,70
2015,Mongolia,MNG,Canada,CAN,18,0,12,0,30
2015,Morocco,MAR,Canada,CAN,10,0,17,0,27
2015,Myanmar,MMR,Canada,CAN,0,0,5,0,5
2015,Nepal,NPL,Canada,CAN,49,0,5,0,54
2015,Netherlands,NLD,Canada,CAN,0,0,10,0,10
2015,Niger,NER,Canada,CAN,5,0,0,0,5
2015,Nicaragua,NIC,Canada,CAN,0,0,5,0,5
2015,Nigeria,NGA,Canada,CAN,392,0,238,12,642
2015,Pakistan,PAK,Canada,CAN,657,0,142,12,811
2015,Panama,PAN,Canada,CAN,0,0,5,0,5
2015,Peru,PER,Canada,CAN,10,0,15,0,25
2015,Philippines,PHL,Canada,CAN,0,0,16,5,21
2015,Poland,POL,Canada,CAN,5,0,10,5,20
2015,Romania,ROU,Canada,CAN,0,0,0,10,10
2015,South Africa,ZAF,Canada,CAN,14,0,5,0,19
2015,Russian Federation,RUS,Canada,CAN,56,0,12,0,68
2015,Rwanda,RWA,Canada,CAN,32,0,19,5,56
2015,El Salvador,SLV,Canada,CAN,95,0,42,5,142
2015,Saudi Arabia,SAU,Canada,CAN,27,0,10,0,37
2015,Serbia and Kosovo: S/RES/1244 (1999),SRB,Canada,CAN,20,0,20,5,45
2015,Senegal,SEN,Canada,CAN,39,0,15,0,54
2015,Sierra Leone,SLE,Canada,CAN,5,0,5,0,10
2015,Somalia,SOM,Canada,CAN,210,0,135,26,371
2015,Spain,ESP,Canada,CAN,0,0,0,5,5
2015,Viet Nam,VNM,Canada,CAN,5,0,5,0,10
2015,Saint Kitts and Nevis,KNA,Canada,CAN,5,0,5,0,10
2015,Sudan,SDN,Canada,CAN,72,0,19,10,101
2015,Slovakia,SVK,Canada,CAN,136,0,42,91,269
2015,Eswatini,SWZ,Canada,CAN,5,0,0,0,5
2015,Switzerland,CHE,Canada,CAN,0,0,0,5,5
2015,Syrian Arab Rep.,SYR,Canada,CAN,551,0,13,5,569
2015,United Rep. of Tanzania,TZA,Canada,CAN,5,0,10,0,15
2015,Thailand,THA,Canada,CAN,0,0,5,0,5
2015,Togo,TGO,Canada,CAN,10,0,10,0,20
2015,Trinidad and Tobago,TTO,Canada,CAN,5,0,5,5,15
2015,Tunisia,TUN,Canada,CAN,19,0,14,0,33
2015,Turkey,TUR,Canada,CAN,102,0,51,10,163
2015,Uganda,UGA,Canada,CAN,44,0,14,0,58
2015,Ukraine,UKR,Canada,CAN,188,0,128,10,326
2015,United States of America,USA,Canada,CAN,5,0,109,24,138
2015,Uzbekistan,UZB,Canada,CAN,16,0,5,0,21
2015,Saint Vincent and the Grenadines,VCT,Canada,CAN,16,0,21,0,37
2015,Venezuela (Bolivarian Republic of),VEN,Canada,CAN,157,0,39,5,201
2015,Yemen,YEM,Canada,CAN,129,0,5,0,134
2015,Zimbabwe,ZWE,Canada,CAN,31,0,11,0,42
2015,Stateless,XXA,Canada,CAN,131,0,26,0,157
2015,Unknown ,,Canada,CAN,22,0,17,10,49
2015,Chad,TCD,Central African Rep.,CAF,0,0,0,5,5
2015,Dem. Rep. of the Congo,COD,Central African Rep.,CAF,0,49,0,25,74
2015,Rwanda,RWA,Central African Rep.,CAF,0,0,0,10,10
2015,Cuba,CUB,Cayman Islands,CYM,5,0,70,0,75
2015,Colombia,COL,Chile,CHL,58,0,51,10,119
2015,Dem. People's Rep. of Korea,PRK,Chile,CHL,5,0,0,0,5
2015,El Salvador,SLV,Chile,CHL,5,0,0,0,5
2015,Syrian Arab Rep.,SYR,Chile,CHL,5,0,0,0,5
2015,Angola,AGO,Dem. Rep. of the Congo,COD,5,0,0,0,5
2015,Burundi,BDI,Dem. Rep. of the Congo,COD,274,0,5,5,284
2015,Central African Rep.,CAF,Dem. Rep. of the Congo,COD,25,0,24,16,65
2015,Congo,COG,Dem. Rep. of the Congo,COD,5,0,0,5,10
2015,Cote d'Ivoire,CIV,Dem. Rep. of the Congo,COD,0,0,0,5,5
2015,Kenya,KEN,Dem. Rep. of the Congo,COD,5,0,0,0,5
2015,Liberia,LBR,Dem. Rep. of the Congo,COD,0,0,0,5,5
2015,Rwanda,RWA,Dem. Rep. of the Congo,COD,5,0,0,0,5
2015,Somalia,SOM,Dem. Rep. of the Congo,COD,5,0,0,0,5
2015,South Sudan,SSD,Dem. Rep. of the Congo,COD,5,0,0,0,5
2015,Syrian Arab Rep.,SYR,Dem. Rep. of the Congo,COD,5,0,0,0,5
2015,United Rep. of Tanzania,TZA,Dem. Rep. of the Congo,COD,0,0,5,0,5
2015,Bangladesh,BGD,Colombia,COL,0,0,0,10,10
2015,Cuba,CUB,Colombia,COL,0,0,58,233,291
2015,Eritrea,ERI,Colombia,COL,0,0,0,5,5
2015,Ethiopia,ETH,Colombia,COL,0,0,0,5,5
2015,Haiti,HTI,Colombia,COL,0,0,0,5,5
2015,India,IND,Colombia,COL,0,0,0,5,5
2015,Nepal,NPL,Colombia,COL,0,0,0,10,10
2015,Nigeria,NGA,Colombia,COL,0,0,0,5,5
2015,Pakistan,PAK,Colombia,COL,0,0,0,10,10
2015,Somalia,SOM,Colombia,COL,0,0,0,5,5
2015,Syrian Arab Rep.,SYR,Colombia,COL,5,0,0,5,10
2015,United States of America,USA,Colombia,COL,0,0,0,5,5
2015,Venezuela (Bolivarian Republic of),VEN,Colombia,COL,5,0,15,67,87
2015,Colombia,COL,Costa Rica,CRI,111,0,204,0,315
2015,Cuba,CUB,Costa Rica,CRI,10,0,58,0,68
2015,Dominican Rep.,DOM,Costa Rica,CRI,0,0,5,0,5
2015,Ghana,GHA,Costa Rica,CRI,0,0,5,0,5
2015,Guatemala,GTM,Costa Rica,CRI,0,0,5,0,5
2015,Honduras,HND,Costa Rica,CRI,11,0,34,0,45
2015,Mexico,MEX,Costa Rica,CRI,0,0,5,0,5
2015,Nicaragua,NIC,Costa Rica,CRI,10,0,5,0,15
2015,Nigeria,NGA,Costa Rica,CRI,5,0,0,0,5
2015,El Salvador,SLV,Costa Rica,CRI,74,0,149,0,223
2015,Syrian Arab Rep.,SYR,Costa Rica,CRI,5,0,0,0,5
2015,Ukraine,UKR,Costa Rica,CRI,10,0,0,0,10
2015,Venezuela (Bolivarian Republic of),VEN,Costa Rica,CRI,15,0,91,0,106
2015,Afghanistan,AFG,Cyprus,CYP,0,0,0,5,5
2015,Egypt,EGY,Cyprus,CYP,5,0,58,56,119
2015,Armenia,ARM,Cyprus,CYP,5,0,0,0,5
2015,Bangladesh,BGD,Cyprus,CYP,0,0,47,10,57
2015,China,CHN,Cyprus,CYP,0,0,5,0,5
2015,Cameroon,CMR,Cyprus,CYP,5,0,5,5,15
2015,Dem. Rep. of the Congo,COD,Cyprus,CYP,5,0,0,0,5
2015,Palestinian,PSE,Cyprus,CYP,31,12,0,11,54
2015,India,IND,Cyprus,CYP,5,0,55,30,90
2015,Iran (Islamic Rep. of),IRN,Cyprus,CYP,13,0,10,10,33
2015,Iraq,IRQ,Cyprus,CYP,26,10,0,25,61
2015,Jordan,JOR,Cyprus,CYP,0,5,13,10,28
2015,Sri Lanka,LKA,Cyprus,CYP,0,0,44,5,49
2015,Mali,MLI,Cyprus,CYP,0,0,0,5,5
2015,Nigeria,NGA,Cyprus,CYP,0,0,13,0,13
2015,Pakistan,PAK,Cyprus,CYP,0,0,63,34,97
2015,Philippines,PHL,Cyprus,CYP,0,0,42,5,47
2015,Russian Federation,RUS,Cyprus,CYP,5,0,0,5,10
2015,Rwanda,RWA,Cyprus,CYP,5,0,0,0,5
2015,Somalia,SOM,Cyprus,CYP,5,5,0,31,41
2015,Viet Nam,VNM,Cyprus,CYP,0,0,82,14,96
2015,Syrian Arab Rep.,SYR,Cyprus,CYP,33,1356,0,100,1489
2015,Turkey,TUR,Cyprus,CYP,5,0,16,5,26
2015,Ukraine,UKR,Cyprus,CYP,0,0,0,35,35
2015,Stateless,XXA,Cyprus,CYP,54,0,0,5,59
2015,Afghanistan,AFG,Czechia,CZE,0,5,0,18,23
2015,Algeria,DZA,Czechia,CZE,0,0,0,10,10
2015,Armenia,ARM,Czechia,CZE,5,0,17,25,47
2015,Azerbaijan,AZE,Czechia,CZE,5,0,0,0,5
2015,Belarus,BLR,Czechia,CZE,5,12,0,5,22
2015,China,CHN,Czechia,CZE,0,0,0,5,5
2015,Dem. Rep. of the Congo,COD,Czechia,CZE,0,0,0,5,5
2015,Cuba,CUB,Czechia,CZE,0,53,0,59,112
2015,Georgia,GEO,Czechia,CZE,0,0,10,11,21
2015,Ghana,GHA,Czechia,CZE,0,0,5,5,10
2015,India,IND,Czechia,CZE,0,0,0,10,10
2015,Iran (Islamic Rep. of),IRN,Czechia,CZE,0,0,0,5,5
2015,Iraq,IRQ,Czechia,CZE,5,12,0,5,22
2015,Kazakhstan,KAZ,Czechia,CZE,0,0,0,10,10
2015,Kyrgyzstan,KGZ,Czechia,CZE,0,0,0,5,5
2015,Libya,LBY,Czechia,CZE,0,0,0,5,5
2015,Rep. of Moldova,MDA,Czechia,CZE,5,0,10,5,20
2015,Mongolia,MNG,Czechia,CZE,0,0,5,10,15
2015,Nigeria,NGA,Czechia,CZE,5,0,12,17,34
2015,Pakistan,PAK,Czechia,CZE,0,0,0,5,5
2015,Russian Federation,RUS,Czechia,CZE,0,5,17,16,38
2015,Serbia and Kosovo: S/RES/1244 (1999),SRB,Czechia,CZE,0,0,13,14,27
2015,Viet Nam,VNM,Czechia,CZE,0,0,47,24,71
2015,Slovakia,SVK,Czechia,CZE,0,0,0,5,5
2015,Syrian Arab Rep.,SYR,Czechia,CZE,29,101,0,20,150
2015,Turkey,TUR,Czechia,CZE,0,0,5,5,10
2015,Ukraine,UKR,Czechia,CZE,5,174,277,171,627
2015,Uzbekistan,UZB,Czechia,CZE,0,5,0,0,5
2015,Stateless,XXA,Czechia,CZE,5,27,5,0,37
2015,Afghanistan,AFG,Denmark,DNK,19,48,110,0,177
2015,Albania,ALB,Denmark,DNK,0,0,69,0,69
2015,Algeria,DZA,Denmark,DNK,0,0,15,0,15
2015,Egypt,EGY,Denmark,DNK,5,0,10,0,15
2015,Armenia,ARM,Denmark,DNK,5,0,61,0,66
2015,Azerbaijan,AZE,Denmark,DNK,0,0,11,0,11
2015,Bangladesh,BGD,Denmark,DNK,0,0,15,0,15
2015,Belarus,BLR,Denmark,DNK,0,0,12,0,12
2015,Bosnia and Herzegovina,BIH,Denmark,DNK,0,0,24,0,24
2015,Bulgaria,BGR,Denmark,DNK,0,0,10,0,10
2015,China,CHN,Denmark,DNK,0,0,12,0,12
2015,Cameroon,CMR,Denmark,DNK,0,0,5,0,5
2015,Dem. Rep. of the Congo,COD,Denmark,DNK,0,0,5,0,5
2015,Eritrea,ERI,Denmark,DNK,2700,182,65,0,2947
2015,Ethiopia,ETH,Denmark,DNK,25,5,46,0,76
2015,Gambia,GMB,Denmark,DNK,0,0,5,0,5
2015,Georgia,GEO,Denmark,DNK,0,0,15,0,15
2015,Ghana,GHA,Denmark,DNK,0,0,10,0,10
2015,Haiti,HTI,Denmark,DNK,0,0,5,0,5
2015,India,IND,Denmark,DNK,0,0,13,0,13
2015,Iran (Islamic Rep. of),IRN,Denmark,DNK,96,10,40,0,146
2015,Iraq,IRQ,Denmark,DNK,5,22,43,0,70
2015,Jordan,JOR,Denmark,DNK,0,0,5,0,5
2015,Kenya,KEN,Denmark,DNK,0,0,12,0,12
2015,Rep. of Korea,KOR,Denmark,DNK,0,0,5,0,5
2015,Libya,LBY,Denmark,DNK,0,0,14,0,14
2015,Lebanon,LBN,Denmark,DNK,0,0,17,0,17
2015,Sri Lanka,LKA,Denmark,DNK,0,0,5,0,5
2015,Lithuania,LTU,Denmark,DNK,0,0,5,0,5
2015,North Macedonia,MKD,Denmark,DNK,0,0,31,0,31
2015,Rep. of Moldova,MDA,Denmark,DNK,0,0,5,0,5
2015,Morocco,MAR,Denmark,DNK,0,0,30,0,30
2015,Myanmar,MMR,Denmark,DNK,0,0,36,0,36
2015,Nigeria,NGA,Denmark,DNK,0,0,24,0,24
2015,Pakistan,PAK,Denmark,DNK,0,5,20,0,25
2015,Romania,ROU,Denmark,DNK,0,0,10,0,10
2015,Russian Federation,RUS,Denmark,DNK,10,10,198,0,218
2015,Rwanda,RWA,Denmark,DNK,0,0,5,0,5
2015,Serbia and Kosovo: S/RES/1244 (1999),SRB,Denmark,DNK,0,0,165,0,165
2015,Somalia,SOM,Denmark,DNK,5,118,159,0,282
2015,Sudan,SDN,Denmark,DNK,10,0,37,0,47
2015,Syrian Arab Rep.,SYR,Denmark,DNK,4167,1550,111,0,5828
2015,Tunisia,TUN,Denmark,DNK,0,0,10,0,10
2015,Turkey,TUR,Denmark,DNK,0,0,5,0,5
2015,Uganda,UGA,Denmark,DNK,13,0,5,0,18
2015,Ukraine,UKR,Denmark,DNK,0,0,66,0,66
2015,Stateless,XXA,Denmark,DNK,539,368,106,0,1013
2015,Unknown ,,Denmark,DNK,0,0,5,0,5
2015,Dem. Rep. of the Congo,COD,Djibouti,DJI,0,0,0,5,5
2015,Eritrea,ERI,Djibouti,DJI,82,0,0,411,493
2015,Ethiopia,ETH,Djibouti,DJI,55,0,0,795,850
2015,Palestinian,PSE,Djibouti,DJI,5,0,0,0,5
2015,Pakistan,PAK,Djibouti,DJI,5,0,0,0,5
2015,Somalia,SOM,Djibouti,DJI,177,0,0,22,199
2015,Syrian Arab Rep.,SYR,Djibouti,DJI,5,0,0,5,10
2015,Yemen,YEM,Djibouti,DJI,6157,0,0,30,6187
2015,Afghanistan,AFG,Dominican Rep.,DOM,5,0,0,0,5
2015,Cuba,CUB,Dominican Rep.,DOM,0,0,0,5,5
2015,Iraq,IRQ,Dominican Rep.,DOM,0,0,0,5,5
2015,Syrian Arab Rep.,SYR,Dominican Rep.,DOM,0,0,0,5,5
2015,Afghanistan,AFG,Estonia,EST,0,0,10,0,10
2015,Algeria,DZA,Estonia,EST,0,0,5,0,5
2015,Egypt,EGY,Estonia,EST,0,0,5,5,10
2015,Armenia,ARM,Estonia,EST,0,0,5,0,5
2015,Cameroon,CMR,Estonia,EST,0,0,5,0,5
2015,Georgia,GEO,Estonia,EST,0,0,0,5,5
2015,Mali,MLI,Estonia,EST,0,0,5,0,5
2015,Nigeria,NGA,Estonia,EST,0,0,5,0,5
2015,Russian Federation,RUS,Estonia,EST,0,0,5,5,10
2015,Sudan,SDN,Estonia,EST,12,0,0,0,12
2015,Syrian Arab Rep.,SYR,Estonia,EST,0,0,13,0,13
2015,Ukraine,UKR,Estonia,EST,5,53,18,23,99
2015,Afghanistan,AFG,Finland,FIN,36,19,43,136,234
2015,Albania,ALB,Finland,FIN,0,0,372,287,659
2015,Algeria,DZA,Finland,FIN,0,0,19,50,69
2015,Angola,AGO,Finland,FIN,0,0,0,10,10
2015,Egypt,EGY,Finland,FIN,0,0,5,5,10
2015,Azerbaijan,AZE,Finland,FIN,10,5,5,13,33
2015,Bangladesh,BGD,Finland,FIN,0,0,10,5,15
2015,Belarus,BLR,Finland,FIN,0,0,5,16,21
2015,Bosnia and Herzegovina,BIH,Finland,FIN,0,0,18,5,23
2015,China,CHN,Finland,FIN,10,0,0,5,15
2015,Cameroon,CMR,Finland,FIN,11,0,10,5,26
2015,Dem. Rep. of the Congo,COD,Finland,FIN,5,0,5,5,15
2015,Dominican Rep.,DOM,Finland,FIN,0,0,0,5,5
2015,Eritrea,ERI,Finland,FIN,5,0,0,5,10
2015,Ethiopia,ETH,Finland,FIN,5,0,5,5,15
2015,Gambia,GMB,Finland,FIN,0,0,16,16,32
2015,Georgia,GEO,Finland,FIN,0,0,17,5,22
2015,Ghana,GHA,Finland,FIN,0,0,12,10,22
2015,Guinea,GIN,Finland,FIN,0,0,10,5,15
2015,India,IND,Finland,FIN,0,0,5,0,5
2015,Iran (Islamic Rep. of),IRN,Finland,FIN,41,0,5,44,90
2015,Iraq,IRQ,Finland,FIN,426,182,110,2890,3608
2015,Jordan,JOR,Finland,FIN,0,0,0,5,5
2015,Kazakhstan,KAZ,Finland,FIN,5,0,0,0,5
2015,Kenya,KEN,Finland,FIN,0,0,0,5,5
2015,Rep. of Korea,KOR,Finland,FIN,0,0,5,0,5
2015,Libya,LBY,Finland,FIN,0,10,0,13,23
2015,Lebanon,LBN,Finland,FIN,0,0,11,5,16
2015,Sri Lanka,LKA,Finland,FIN,0,0,5,0,5
2015,Mauritania,MRT,Finland,FIN,0,0,0,5,5
2015,North Macedonia,MKD,Finland,FIN,0,0,17,0,17
2015,Mali,MLI,Finland,FIN,5,0,5,5,15
2015,Morocco,MAR,Finland,FIN,5,0,23,55,83
2015,Montenegro,MNE,Finland,FIN,0,0,5,5,10
2015,Myanmar,MMR,Finland,FIN,14,0,0,0,14
2015,Nepal,NPL,Finland,FIN,0,0,53,0,53
2015,Nigeria,NGA,Finland,FIN,0,0,55,59,114
2015,Pakistan,PAK,Finland,FIN,5,0,10,5,20
2015,Romania,ROU,Finland,FIN,0,0,5,0,5
2015,Russian Federation,RUS,Finland,FIN,56,20,63,33,172
2015,Serbia and Kosovo: S/RES/1244 (1999),SRB,Finland,FIN,0,0,139,38,177
2015,Senegal,SEN,Finland,FIN,0,0,0,10,10
2015,Sierra Leone,SLE,Finland,FIN,0,0,0,5,5
2015,Somalia,SOM,Finland,FIN,231,171,14,148,564
2015,Spain,ESP,Finland,FIN,0,0,0,5,5
2015,Sudan,SDN,Finland,FIN,5,0,0,5,10
2015,Syrian Arab Rep.,SYR,Finland,FIN,106,21,0,55,182
2015,United Rep. of Tanzania,TZA,Finland,FIN,0,0,0,5,5
2015,Tajikistan,TJK,Finland,FIN,0,0,0,5,5
2015,Togo,TGO,Finland,FIN,0,0,0,5,5
2015,Tunisia,TUN,Finland,FIN,0,0,5,20,25
2015,Turkey,TUR,Finland,FIN,0,0,30,17,47
2015,United Arab Emirates,ARE,Finland,FIN,0,0,0,5,5
2015,Uganda,UGA,Finland,FIN,5,0,0,0,5
2015,Ukraine,UKR,Finland,FIN,0,0,58,14,72
2015,United States of America,USA,Finland,FIN,0,0,0,5,5
2015,Uzbekistan,UZB,Finland,FIN,0,0,5,0,5
2015,Yemen,YEM,Finland,FIN,0,5,0,0,5
2015,Stateless,XXA,Finland,FIN,41,0,5,18,64
2015,Unknown ,,Finland,FIN,5,0,5,28,38
2015,Afghanistan,AFG,France,FRA,207,346,136,0,689
2015,Albania,ALB,France,FRA,45,207,2057,0,2309
2015,Algeria,DZA,France,FRA,66,19,1523,0,1608
2015,Angola,AGO,France,FRA,32,10,373,0,415
2015,Egypt,EGY,France,FRA,75,0,222,0,297
2015,Armenia,ARM,France,FRA,38,20,1087,0,1145
2015,Azerbaijan,AZE,France,FRA,75,5,624,0,704
2015,Burundi,BDI,France,FRA,12,0,10,0,22
2015,Benin,BEN,France,FRA,5,0,17,0,22
2015,Bangladesh,BGD,France,FRA,217,24,3045,0,3286
2015,Bhutan,BTN,France,FRA,5,0,43,0,48
2015,Burkina Faso,BFA,France,FRA,0,5,28,0,33
2015,Belarus,BLR,France,FRA,18,0,53,0,71
2015,Brazil,BRA,France,FRA,0,0,10,0,10
2015,Bosnia and Herzegovina,BIH,France,FRA,13,5,246,0,264
2015,Cambodia,KHM,France,FRA,5,0,39,0,44
2015,Central African Rep.,CAF,France,FRA,190,420,78,0,688
2015,Chad,TCD,France,FRA,42,5,265,0,312
2015,China,CHN,France,FRA,828,0,1833,0,2661
2015,Cameroon,CMR,France,FRA,31,10,157,0,198
2015,Congo,COG,France,FRA,43,5,757,0,805
2015,Dem. Rep. of the Congo,COD,France,FRA,465,68,4241,0,4774
2015,Comoros,COM,France,FRA,30,5,279,0,314
2015,Colombia,COL,France,FRA,10,5,42,0,57
2015,Cuba,CUB,France,FRA,12,0,15,0,27
2015,Cabo Verde,CPV,France,FRA,0,0,5,0,5
2015,Djibouti,DJI,France,FRA,16,0,15,0,31
2015,Dominica,DMA,France,FRA,0,0,10,0,10
2015,Dominican Rep.,DOM,France,FRA,0,10,299,0,309
2015,Eritrea,ERI,France,FRA,491,0,568,0,1059
2015,Ethiopia,ETH,France,FRA,61,0,201,0,262
2015,Gabon,GAB,France,FRA,0,0,12,0,12
2015,Gambia,GMB,France,FRA,19,0,90,0,109
2015,Palestinian,PSE,France,FRA,138,16,48,0,202
2015,Georgia,GEO,France,FRA,84,36,1402,0,1522
2015,Ghana,GHA,France,FRA,0,0,22,0,22
2015,Guinea-Bissau,GNB,France,FRA,10,0,101,0,111
2015,Guinea,GIN,France,FRA,675,96,2243,0,3014
2015,Guyana,GUY,France,FRA,5,0,19,0,24
2015,Haiti,HTI,France,FRA,33,24,2428,0,2485
2015,Cote d'Ivoire,CIV,France,FRA,150,38,846,0,1034
2015,India,IND,France,FRA,5,5,62,0,72
2015,Iran (Islamic Rep. of),IRN,France,FRA,106,0,76,0,182
2015,Iraq,IRQ,France,FRA,1822,52,41,0,1915
2015,Israel,ISR,France,FRA,0,0,5,0,5
2015,Jamaica,JAM,France,FRA,5,0,10,0,15
2015,Jordan,JOR,France,FRA,5,0,5,0,10
2015,Kazakhstan,KAZ,France,FRA,12,5,105,0,122
2015,Kenya,KEN,France,FRA,5,0,12,0,17
2015,Kyrgyzstan,KGZ,France,FRA,5,0,48,0,53
2015,Lao People's Dem. Rep.,LAO,France,FRA,5,0,0,0,5
2015,Liberia,LBR,France,FRA,0,0,5,0,5
2015,Libya,LBY,France,FRA,57,5,133,0,195
2015,Saint Lucia,LCA,France,FRA,0,0,5,0,5
2015,Lebanon,LBN,France,FRA,5,0,37,0,42
2015,Sri Lanka,LKA,France,FRA,543,45,2136,0,2724
2015,Madagascar,MDG,France,FRA,5,5,96,0,106
2015,Mauritania,MRT,France,FRA,76,0,786,0,862
2015,North Macedonia,MKD,France,FRA,5,0,188,0,193
2015,Rep. of Moldova,MDA,France,FRA,0,0,27,0,27
2015,Mexico,MEX,France,FRA,5,0,5,0,10
2015,Mali,MLI,France,FRA,184,12,974,0,1170
2015,Mongolia,MNG,France,FRA,21,10,138,0,169
2015,Morocco,MAR,France,FRA,19,0,145,0,164
2015,Montenegro,MNE,France,FRA,0,0,97,0,97
2015,Mauritius,MUS,France,FRA,0,0,5,0,5
2015,Myanmar,MMR,France,FRA,5,0,65,0,70
2015,Nepal,NPL,France,FRA,5,5,113,0,123
2015,Niger,NER,France,FRA,0,0,15,0,15
2015,Nigeria,NGA,France,FRA,75,27,1385,0,1487
2015,Pakistan,PAK,France,FRA,108,23,2458,0,2589
2015,Peru,PER,France,FRA,0,5,39,0,44
2015,South Africa,ZAF,France,FRA,5,0,10,0,15
2015,Russian Federation,RUS,France,FRA,437,66,3075,0,3578
2015,Rwanda,RWA,France,FRA,40,0,55,0,95
2015,El Salvador,SLV,France,FRA,0,0,10,0,10
2015,Serbia and Kosovo: S/RES/1244 (1999),SRB,France,FRA,195,101,3126,0,3422
2015,Senegal,SEN,France,FRA,90,5,243,0,338
2015,Sierra Leone,SLE,France,FRA,10,0,53,0,63
2015,Somalia,SOM,France,FRA,39,45,700,0,784
2015,Viet Nam,VNM,France,FRA,11,0,23,0,34
2015,Sudan,SDN,France,FRA,1163,36,2371,0,3570
2015,Suriname,SUR,France,FRA,0,0,10,0,10
2015,Slovakia,SVK,France,FRA,5,0,0,0,5
2015,Syrian Arab Rep.,SYR,France,FRA,1587,735,74,0,2396
2015,Thailand,THA,France,FRA,5,0,12,0,17
2015,Tajikistan,TJK,France,FRA,0,0,10,0,10
2015,Turkmenistan,TKM,France,FRA,0,0,5,0,5
2015,Togo,TGO,France,FRA,17,0,147,0,164
2015,Tunisia,TUN,France,FRA,25,5,186,0,216
2015,Turkey,TUR,France,FRA,120,10,1152,0,1282
2015,Uganda,UGA,France,FRA,20,0,10,0,30
2015,Ukraine,UKR,France,FRA,100,206,953,0,1259
2015,Uzbekistan,UZB,France,FRA,0,0,14,0,14
2015,Venezuela (Bolivarian Republic of),VEN,France,FRA,19,0,10,0,29
2015,Western Sahara,ESH,France,FRA,105,5,394,0,504
2015,Yemen,YEM,France,FRA,17,14,5,0,36
2015,Unknown ,,France,FRA,6215,1165,10544,0,17924
2015,Afghanistan,AFG,United Kingdom of Great Britain and Northern Ireland,GBR,592,193,1040,485,2310
2015,Albania,ALB,United Kingdom of Great Britain and Northern Ireland,GBR,10,356,1539,418,2323
2015,Algeria,DZA,United Kingdom of Great Britain and Northern Ireland,GBR,13,5,166,46,230
2015,Angola,AGO,United Kingdom of Great Britain and Northern Ireland,GBR,11,5,32,5,53
2015,Egypt,EGY,United Kingdom of Great Britain and Northern Ireland,GBR,27,61,286,86,460
2015,Argentina,ARG,United Kingdom of Great Britain and Northern Ireland,GBR,0,0,5,0,5
2015,Armenia,ARM,United Kingdom of Great Britain and Northern Ireland,GBR,5,0,42,5,52
2015,Australia,AUS,United Kingdom of Great Britain and Northern Ireland,GBR,0,0,0,5,5
2015,Azerbaijan,AZE,United Kingdom of Great Britain and Northern Ireland,GBR,5,0,19,0,24
2015,Bahrain,BHR,United Kingdom of Great Britain and Northern Ireland,GBR,20,0,5,0,25
2015,Barbados,BRB,United Kingdom of Great Britain and Northern Ireland,GBR,0,0,5,0,5
2015,Burundi,BDI,United Kingdom of Great Britain and Northern Ireland,GBR,5,0,10,0,15
2015,Belgium,BEL,United Kingdom of Great Britain and Northern Ireland,GBR,0,0,0,5,5
2015,Bangladesh,BGD,United Kingdom of Great Britain and Northern Ireland,GBR,86,31,887,192,1196
2015,Belarus,BLR,United Kingdom of Great Britain and Northern Ireland,GBR,10,0,5,0,15
2015,Bolivia (Plurinational State of),BOL,United Kingdom of Great Britain and Northern Ireland,GBR,0,0,19,0,19
2015,Botswana,BWA,United Kingdom of Great Britain and Northern Ireland,GBR,0,5,16,0,21
2015,Brazil,BRA,United Kingdom of Great Britain and Northern Ireland,GBR,0,0,16,10,26
2015,Bosnia and Herzegovina,BIH,United Kingdom of Great Britain and Northern Ireland,GBR,0,0,5,5,10
2015,Bulgaria,BGR,United Kingdom of Great Britain and Northern Ireland,GBR,0,0,5,0,5
2015,Canada,CAN,United Kingdom of Great Britain and Northern Ireland,GBR,0,0,11,0,11
2015,Central African Rep.,CAF,United Kingdom of Great Britain and Northern Ireland,GBR,0,0,5,0,5
2015,Chad,TCD,United Kingdom of Great Britain and Northern Ireland,GBR,10,0,18,5,33
2015,China,CHN,United Kingdom of Great Britain and Northern Ireland,GBR,78,32,1089,116,1315
2015,Cameroon,CMR,United Kingdom of Great Britain and Northern Ireland,GBR,48,5,111,5,169
2015,Congo,COG,United Kingdom of Great Britain and Northern Ireland,GBR,5,5,24,0,34
2015,Dem. Rep. of the Congo,COD,United Kingdom of Great Britain and Northern Ireland,GBR,80,23,204,31,338
2015,Colombia,COL,United Kingdom of Great Britain and Northern Ireland,GBR,0,0,10,5,15
2015,Cyprus,CYP,United Kingdom of Great Britain and Northern Ireland,GBR,0,0,5,0,5
2015,Czechia,CZE,United Kingdom of Great Britain and Northern Ireland,GBR,0,0,5,0,5
2015,Equatorial Guinea,GNQ,United Kingdom of Great Britain and Northern Ireland,GBR,0,0,5,0,5
2015,Eritrea,ERI,United Kingdom of Great Britain and Northern Ireland,GBR,1354,211,1600,177,3342
2015,Ethiopia,ETH,United Kingdom of Great Britain and Northern Ireland,GBR,350,14,271,39,674
2015,Gambia,GMB,United Kingdom of Great Britain and Northern Ireland,GBR,107,10,200,19,336
2015,Palestinian,PSE,United Kingdom of Great Britain and Northern Ireland,GBR,82,17,108,37,244
2015,Georgia,GEO,United Kingdom of Great Britain and Northern Ireland,GBR,0,0,72,5,77
2015,Germany,DEU,United Kingdom of Great Britain and Northern Ireland,GBR,0,0,0,5,5
2015,Ghana,GHA,United Kingdom of Great Britain and Northern Ireland,GBR,17,0,152,31,200
2015,Guinea-Bissau,GNB,United Kingdom of Great Britain and Northern Ireland,GBR,0,5,0,0,5
2015,Greece,GRC,United Kingdom of Great Britain and Northern Ireland,GBR,0,0,5,0,5
2015,Grenada,GRD,United Kingdom of Great Britain and Northern Ireland,GBR,0,0,5,0,5
2015,Guatemala,GTM,United Kingdom of Great Britain and Northern Ireland,GBR,0,0,5,0,5
2015,Guinea,GIN,United Kingdom of Great Britain and Northern Ireland,GBR,11,0,29,5,45
2015,Guyana,GUY,United Kingdom of Great Britain and Northern Ireland,GBR,0,0,5,0,5
2015,Honduras,HND,United Kingdom of Great Britain and Northern Ireland,GBR,5,0,5,0,10
2015,Hungary,HUN,United Kingdom of Great Britain and Northern Ireland,GBR,0,0,5,0,5
2015,Cote d'Ivoire,CIV,United Kingdom of Great Britain and Northern Ireland,GBR,5,0,44,5,54
2015,India,IND,United Kingdom of Great Britain and Northern Ireland,GBR,15,10,955,379,1359
2015,Indonesia,IDN,United Kingdom of Great Britain and Northern Ireland,GBR,0,0,5,0,5
2015,Ireland,IRL,United Kingdom of Great Britain and Northern Ireland,GBR,0,0,5,0,5
2015,Iran (Islamic Rep. of),IRN,United Kingdom of Great Britain and Northern Ireland,GBR,1946,52,1272,368,3638
2015,Iraq,IRQ,United Kingdom of Great Britain and Northern Ireland,GBR,215,92,896,337,1540
2015,Israel,ISR,United Kingdom of Great Britain and Northern Ireland,GBR,0,0,10,0,10
2015,Jamaica,JAM,United Kingdom of Great Britain and Northern Ireland,GBR,18,5,146,12,181
2015,Jordan,JOR,United Kingdom of Great Britain and Northern Ireland,GBR,11,0,32,5,48
2015,Kazakhstan,KAZ,United Kingdom of Great Britain and Northern Ireland,GBR,0,0,10,0,10
2015,Kenya,KEN,United Kingdom of Great Britain and Northern Ireland,GBR,10,5,97,5,117
2015,Kyrgyzstan,KGZ,United Kingdom of Great Britain and Northern Ireland,GBR,5,0,5,0,10
2015,Rep. of Korea,KOR,United Kingdom of Great Britain and Northern Ireland,GBR,0,0,16,5,21
2015,Dem. People's Rep. of Korea,PRK,United Kingdom of Great Britain and Northern Ireland,GBR,0,0,43,10,53
2015,Kuwait,KWT,United Kingdom of Great Britain and Northern Ireland,GBR,102,0,32,10,144
2015,Liberia,LBR,United Kingdom of Great Britain and Northern Ireland,GBR,5,0,5,0,10
2015,Libya,LBY,United Kingdom of Great Britain and Northern Ireland,GBR,150,45,835,60,1090
2015,Saint Lucia,LCA,United Kingdom of Great Britain and Northern Ireland,GBR,0,0,10,0,10
2015,Lebanon,LBN,United Kingdom of Great Britain and Northern Ireland,GBR,19,0,83,5,107
2015,Sri Lanka,LKA,United Kingdom of Great Britain and Northern Ireland,GBR,198,28,1908,117,2251
2015,Lithuania,LTU,United Kingdom of Great Britain and Northern Ireland,GBR,0,0,33,11,44
2015,Latvia,LVA,United Kingdom of Great Britain and Northern Ireland,GBR,0,0,20,11,31
2015,Maldives,MDV,United Kingdom of Great Britain and Northern Ireland,GBR,10,0,0,0,10
2015,Mexico,MEX,United Kingdom of Great Britain and Northern Ireland,GBR,0,0,15,5,20
2015,Mali,MLI,United Kingdom of Great Britain and Northern Ireland,GBR,0,0,10,10,20
2015,Malaysia,MYS,United Kingdom of Great Britain and Northern Ireland,GBR,15,0,41,10,66
2015,Malawi,MWI,United Kingdom of Great Britain and Northern Ireland,GBR,10,38,138,10,196
2015,Mongolia,MNG,United Kingdom of Great Britain and Northern Ireland,GBR,0,0,20,5,25
2015,Morocco,MAR,United Kingdom of Great Britain and Northern Ireland,GBR,12,5,57,22,96
2015,Mauritius,MUS,United Kingdom of Great Britain and Northern Ireland,GBR,0,0,62,11,73
2015,Myanmar,MMR,United Kingdom of Great Britain and Northern Ireland,GBR,56,0,136,13,205
2015,Namibia,NAM,United Kingdom of Great Britain and Northern Ireland,GBR,5,0,29,0,34
2015,Nepal,NPL,United Kingdom of Great Britain and Northern Ireland,GBR,0,0,64,5,69
2015,Nigeria,NGA,United Kingdom of Great Britain and Northern Ireland,GBR,132,122,1486,112,1852
2015,Oman,OMN,United Kingdom of Great Britain and Northern Ireland,GBR,0,0,11,0,11
2015,Pakistan,PAK,United Kingdom of Great Britain and Northern Ireland,GBR,718,45,3002,474,4239
2015,Philippines,PHL,United Kingdom of Great Britain and Northern Ireland,GBR,0,0,37,5,42
2015,Poland,POL,United Kingdom of Great Britain and Northern Ireland,GBR,0,0,75,34,109
2015,Portugal,PRT,United Kingdom of Great Britain and Northern Ireland,GBR,0,0,5,0,5
2015,Romania,ROU,United Kingdom of Great Britain and Northern Ireland,GBR,0,0,15,5,20
2015,South Africa,ZAF,United Kingdom of Great Britain and Northern Ireland,GBR,5,10,79,10,104
2015,Russian Federation,RUS,United Kingdom of Great Britain and Northern Ireland,GBR,50,5,88,22,165
2015,Rwanda,RWA,United Kingdom of Great Britain and Northern Ireland,GBR,5,5,14,0,24
2015,El Salvador,SLV,United Kingdom of Great Britain and Northern Ireland,GBR,5,0,23,0,28
2015,Saudi Arabia,SAU,United Kingdom of Great Britain and Northern Ireland,GBR,12,5,12,10,39
2015,Serbia and Kosovo: S/RES/1244 (1999),SRB,United Kingdom of Great Britain and Northern Ireland,GBR,0,0,36,26,62
2015,Senegal,SEN,United Kingdom of Great Britain and Northern Ireland,GBR,10,0,24,5,39
2015,Sierra Leone,SLE,United Kingdom of Great Britain and Northern Ireland,GBR,11,13,72,5,101
2015,Somalia,SOM,United Kingdom of Great Britain and Northern Ireland,GBR,214,25,298,65,602
2015,Viet Nam,VNM,United Kingdom of Great Britain and Northern Ireland,GBR,42,60,234,203,539
2015,Sudan,SDN,United Kingdom of Great Britain and Northern Ireland,GBR,2392,5,348,134,2879
2015,South Sudan,SSD,United Kingdom of Great Britain and Northern Ireland,GBR,12,0,0,0,12
2015,Slovakia,SVK,United Kingdom of Great Britain and Northern Ireland,GBR,0,0,5,12,17
2015,Eswatini,SWZ,United Kingdom of Great Britain and Northern Ireland,GBR,22,0,5,0,27
2015,Syrian Arab Rep.,SYR,United Kingdom of Great Britain and Northern Ireland,GBR,2011,42,213,250,2516
2015,United Rep. of Tanzania,TZA,United Kingdom of Great Britain and Northern Ireland,GBR,5,5,36,0,46
2015,Thailand,THA,United Kingdom of Great Britain and Northern Ireland,GBR,0,0,12,5,17
2015,Tajikistan,TJK,United Kingdom of Great Britain and Northern Ireland,GBR,0,0,5,0,5
2015,Turkmenistan,TKM,United Kingdom of Great Britain and Northern Ireland,GBR,0,0,5,5,10
2015,Togo,TGO,United Kingdom of Great Britain and Northern Ireland,GBR,0,0,5,0,5
2015,Trinidad and Tobago,TTO,United Kingdom of Great Britain and Northern Ireland,GBR,5,0,19,5,29
2015,Tunisia,TUN,United Kingdom of Great Britain and Northern Ireland,GBR,0,5,17,10,32
2015,Turkey,TUR,United Kingdom of Great Britain and Northern Ireland,GBR,35,33,216,31,315
2015,United Arab Emirates,ARE,United Kingdom of Great Britain and Northern Ireland,GBR,0,0,18,0,18
2015,Uganda,UGA,United Kingdom of Great Britain and Northern Ireland,GBR,145,5,135,12,297
2015,Ukraine,UKR,United Kingdom of Great Britain and Northern Ireland,GBR,0,0,242,71,313
2015,United States of America,USA,United Kingdom of Great Britain and Northern Ireland,GBR,12,0,36,21,69
2015,Uzbekistan,UZB,United Kingdom of Great Britain and Northern Ireland,GBR,0,5,14,0,19
2015,Saint Vincent and the Grenadines,VCT,United Kingdom of Great Britain and Northern Ireland,GBR,5,0,10,0,15
2015,Venezuela (Bolivarian Republic of),VEN,United Kingdom of Great Britain and Northern Ireland,GBR,5,0,18,5,28
2015,Yemen,YEM,United Kingdom of Great Britain and Northern Ireland,GBR,55,15,59,5,134
2015,Zambia,ZMB,United Kingdom of Great Britain and Northern Ireland,GBR,0,5,25,0,30
2015,Zimbabwe,ZWE,United Kingdom of Great Britain and Northern Ireland,GBR,56,56,449,21,582
2015,Stateless,XXA,United Kingdom of Great Britain and Northern Ireland,GBR,400,0,123,29,552
2015,Unknown ,,United Kingdom of Great Britain and Northern Ireland,GBR,11,18,11,14,54
2015,Afghanistan,AFG,Georgia,GEO,0,0,5,10,15
2015,Egypt,EGY,Georgia,GEO,0,5,15,10,30
2015,Armenia,ARM,Georgia,GEO,0,0,10,5,15
2015,Azerbaijan,AZE,Georgia,GEO,0,0,5,5,10
2015,Bangladesh,BGD,Georgia,GEO,0,0,14,14,28
2015,Cote d'Ivoire,CIV,Georgia,GEO,0,0,0,5,5
2015,India,IND,Georgia,GEO,0,0,5,0,5
2015,Iran (Islamic Rep. of),IRN,Georgia,GEO,0,0,37,5,42
2015,Iraq,IRQ,Georgia,GEO,60,397,59,473,989
2015,Kuwait,KWT,Georgia,GEO,0,0,5,0,5
2015,Lebanon,LBN,Georgia,GEO,0,5,0,0,5
2015,Morocco,MAR,Georgia,GEO,0,0,5,0,5
2015,Nigeria,NGA,Georgia,GEO,0,0,5,0,5
2015,Russian Federation,RUS,Georgia,GEO,0,5,37,5,47
2015,Syrian Arab Rep.,SYR,Georgia,GEO,5,22,10,10,47
2015,Turkey,TUR,Georgia,GEO,0,0,28,5,33
2015,Ukraine,UKR,Georgia,GEO,0,444,66,215,725
2015,Central African Rep.,CAF,Ghana,GHA,74,0,0,0,74
2015,Cameroon,CMR,Ghana,GHA,0,0,5,0,5
2015,Dem. Rep. of the Congo,COD,Ghana,GHA,10,0,5,0,15
2015,Eritrea,ERI,Ghana,GHA,5,0,0,0,5
2015,Cote d'Ivoire,CIV,Ghana,GHA,5,920,0,760,1685
2015,Pakistan,PAK,Ghana,GHA,12,0,0,0,12
2015,Somalia,SOM,Ghana,GHA,15,0,0,0,15
2015,Sudan,SDN,Ghana,GHA,48,0,0,0,48
2015,Syrian Arab Rep.,SYR,Ghana,GHA,42,0,0,0,42
2015,Togo,TGO,Ghana,GHA,10,0,15,0,25
2015,Afghanistan,AFG,Greece,GRC,177,171,261,699,1308
2015,Albania,ALB,Greece,GRC,0,0,638,80,718
2015,Algeria,DZA,Greece,GRC,0,0,123,46,169
2015,Egypt,EGY,Greece,GRC,25,0,197,33,255
2015,Armenia,ARM,Greece,GRC,0,0,27,5,32
2015,Azerbaijan,AZE,Greece,GRC,0,0,5,0,5
2015,Bangladesh,BGD,Greece,GRC,18,0,642,101,761
2015,Burkina Faso,BFA,Greece,GRC,0,0,12,5,17
2015,China,CHN,Greece,GRC,5,0,62,10,77
2015,Cameroon,CMR,Greece,GRC,16,5,179,101,301
2015,Congo,COG,Greece,GRC,0,0,14,11,25
2015,Dem. Rep. of the Congo,COD,Greece,GRC,19,5,70,66,160
2015,Comoros,COM,Greece,GRC,0,0,10,0,10
2015,Dominican Rep.,DOM,Greece,GRC,0,0,17,27,44
2015,Eritrea,ERI,Greece,GRC,68,5,23,38,134
2015,Ethiopia,ETH,Greece,GRC,20,0,29,10,59
2015,Gabon,GAB,Greece,GRC,0,0,5,0,5
2015,Gambia,GMB,Greece,GRC,0,0,10,0,10
2015,Palestinian,PSE,Greece,GRC,59,0,5,14,78
2015,Georgia,GEO,Greece,GRC,0,0,315,28,343
2015,Ghana,GHA,Greece,GRC,0,0,58,10,68
2015,Guinea,GIN,Greece,GRC,0,0,18,5,23
2015,Cote d'Ivoire,CIV,Greece,GRC,5,0,40,27,72
2015,India,IND,Greece,GRC,5,0,58,5,68
2015,Indonesia,IDN,Greece,GRC,0,0,10,0,10
2015,Iran (Islamic Rep. of),IRN,Greece,GRC,51,0,84,132,267
2015,Iraq,IRQ,Greece,GRC,56,51,52,139,298
2015,Kenya,KEN,Greece,GRC,5,0,17,0,22
2015,Liberia,LBR,Greece,GRC,0,0,5,0,5
2015,Libya,LBY,Greece,GRC,5,5,0,10,20
2015,Lebanon,LBN,Greece,GRC,0,0,5,0,5
2015,Sri Lanka,LKA,Greece,GRC,5,0,10,10,25
2015,Madagascar,MDG,Greece,GRC,0,0,5,0,5
2015,Mauritania,MRT,Greece,GRC,5,0,10,5,20
2015,Rep. of Moldova,MDA,Greece,GRC,0,0,22,5,27
2015,Mali,MLI,Greece,GRC,0,0,10,19,29
2015,Morocco,MAR,Greece,GRC,0,0,62,30,92
2015,Myanmar,MMR,Greece,GRC,5,0,10,0,15
2015,Nepal,NPL,Greece,GRC,0,0,5,0,5
2015,Nigeria,NGA,Greece,GRC,22,0,313,60,395
2015,Pakistan,PAK,Greece,GRC,28,5,1488,343,1864
2015,Philippines,PHL,Greece,GRC,0,0,5,0,5
2015,Russian Federation,RUS,Greece,GRC,0,0,39,11,50
2015,Rwanda,RWA,Greece,GRC,0,0,10,0,10
2015,El Salvador,SLV,Greece,GRC,0,0,5,0,5
2015,Senegal,SEN,Greece,GRC,0,0,81,15,96
2015,Sierra Leone,SLE,Greece,GRC,5,0,21,15,41
2015,Somalia,SOM,Greece,GRC,16,28,26,52,122
2015,Sudan,SDN,Greece,GRC,59,13,82,66,220
2015,Syrian Arab Rep.,SYR,Greece,GRC,2779,5,5,277,3066
2015,United Rep. of Tanzania,TZA,Greece,GRC,0,0,13,0,13
2015,Togo,TGO,Greece,GRC,0,0,13,5,18
2015,Tunisia,TUN,Greece,GRC,0,0,22,10,32
2015,Turkey,TUR,Greece,GRC,13,0,10,10,33
2015,Uganda,UGA,Greece,GRC,0,0,13,5,18
2015,Ukraine,UKR,Greece,GRC,0,41,130,33,204
2015,Yemen,YEM,Greece,GRC,0,0,0,5,5
2015,Stateless,XXA,Greece,GRC,157,0,13,31,201
2015,Unknown ,,Greece,GRC,16,16,120,1761,1913
2015,Cuba,CUB,Guatemala,GTM,0,0,0,31,31
2015,Honduras,HND,Guatemala,GTM,12,0,0,10,22
2015,Nepal,NPL,Guatemala,GTM,0,0,0,19,19
2015,El Salvador,SLV,Guatemala,GTM,51,0,0,5,56
2015,United States of America,USA,Guatemala,GTM,0,0,0,5,5
2015,Central African Rep.,CAF,Guinea,GIN,12,0,0,0,12
2015,Cote d'Ivoire,CIV,Guinea,GIN,58,0,14,0,72
2015,Liberia,LBR,Guinea,GIN,18,0,5,0,23
2015,Nigeria,NGA,Guinea,GIN,5,0,0,0,5
2015,Sierra Leone,SLE,Guinea,GIN,19,0,0,0,19
2015,Afghanistan,AFG,Croatia,HRV,0,0,5,10,15
2015,Algeria,DZA,Croatia,HRV,0,0,21,10,31
2015,Azerbaijan,AZE,Croatia,HRV,5,0,0,0,5
2015,Bangladesh,BGD,Croatia,HRV,0,0,5,0,5
2015,Bosnia and Herzegovina,BIH,Croatia,HRV,0,0,5,5,10
2015,Bulgaria,BGR,Croatia,HRV,0,0,5,0,5
2015,Cameroon,CMR,Croatia,HRV,0,0,5,0,5
2015,Gambia,GMB,Croatia,HRV,0,0,5,0,5
2015,India,IND,Croatia,HRV,0,0,0,5,5
2015,Iran (Islamic Rep. of),IRN,Croatia,HRV,0,0,0,5,5
2015,Iraq,IRQ,Croatia,HRV,5,0,5,0,10
2015,Morocco,MAR,Croatia,HRV,0,0,10,5,15
2015,Montenegro,MNE,Croatia,HRV,0,0,0,5,5
2015,Nigeria,NGA,Croatia,HRV,5,0,17,0,22
2015,Pakistan,PAK,Croatia,HRV,0,0,5,0,5
2015,Russian Federation,RUS,Croatia,HRV,0,5,10,0,15
2015,Serbia and Kosovo: S/RES/1244 (1999),SRB,Croatia,HRV,0,0,13,11,24
2015,Syrian Arab Rep.,SYR,Croatia,HRV,0,0,5,22,27
2015,Tunisia,TUN,Croatia,HRV,0,0,5,0,5
2015,Turkey,TUR,Croatia,HRV,5,0,5,5,15
2015,Ukraine,UKR,Croatia,HRV,0,0,11,0,11
2015,Unknown ,,Croatia,HRV,0,0,12,0,12
2015,Albania,ALB,Iceland,ISL,0,0,54,24,78
2015,Algeria,DZA,Iceland,ISL,0,0,0,5,5
2015,Azerbaijan,AZE,Iceland,ISL,0,0,5,0,5
2015,Belarus,BLR,Iceland,ISL,0,0,0,10,10
2015,Eritrea,ERI,Iceland,ISL,5,0,0,0,5
2015,Guinea,GIN,Iceland,ISL,0,0,5,0,5
2015,Iran (Islamic Rep. of),IRN,Iceland,ISL,5,0,0,0,5
2015,Iraq,IRQ,Iceland,ISL,5,0,0,10,15
2015,North Macedonia,MKD,Iceland,ISL,0,0,20,0,20
2015,Morocco,MAR,Iceland,ISL,0,0,0,5,5
2015,Nigeria,NGA,Iceland,ISL,0,0,5,5,10
2015,Pakistan,PAK,Iceland,ISL,0,0,0,5,5
2015,Russian Federation,RUS,Iceland,ISL,5,0,0,10,15
2015,Serbia and Kosovo: S/RES/1244 (1999),SRB,Iceland,ISL,0,0,5,5,10
2015,Syrian Arab Rep.,SYR,Iceland,ISL,5,11,0,12,28
2015,Ukraine,UKR,Iceland,ISL,0,5,0,0,5
2015,Uzbekistan,UZB,Iceland,ISL,0,0,0,5,5
2015,Stateless,XXA,Iceland,ISL,0,0,0,5,5
2015,Afghanistan,AFG,Ireland,IRL,5,0,10,30,45
2015,Albania,ALB,Ireland,IRL,0,0,78,51,129
2015,Algeria,DZA,Ireland,IRL,0,0,37,22,59
2015,Egypt,EGY,Ireland,IRL,0,0,0,10,10
2015,Bangladesh,BGD,Ireland,IRL,0,0,43,70,113
2015,Botswana,BWA,Ireland,IRL,0,0,5,0,5
2015,Brazil,BRA,Ireland,IRL,0,0,5,0,5
2015,China,CHN,Ireland,IRL,5,0,10,5,20
2015,Cameroon,CMR,Ireland,IRL,5,0,10,0,15
2015,Dem. Rep. of the Congo,COD,Ireland,IRL,5,0,33,5,43
2015,Eritrea,ERI,Ireland,IRL,5,0,0,0,5
2015,Palestinian,PSE,Ireland,IRL,5,0,0,0,5
2015,Georgia,GEO,Ireland,IRL,0,0,10,5,15
2015,Ghana,GHA,Ireland,IRL,0,0,5,0,5
2015,Guyana,GUY,Ireland,IRL,0,0,0,5,5
2015,India,IND,Ireland,IRL,0,0,10,21,31
2015,Iran (Islamic Rep. of),IRN,Ireland,IRL,12,0,0,5,17
2015,Iraq,IRQ,Ireland,IRL,18,0,0,10,28
2015,Kenya,KEN,Ireland,IRL,0,0,0,5,5
2015,Kuwait,KWT,Ireland,IRL,10,0,0,5,15
2015,Liberia,LBR,Ireland,IRL,0,0,5,0,5
2015,Libya,LBY,Ireland,IRL,12,0,0,0,12
2015,Rep. of Moldova,MDA,Ireland,IRL,0,0,5,0,5
2015,Malawi,MWI,Ireland,IRL,5,0,29,10,44
2015,Morocco,MAR,Ireland,IRL,0,0,0,5,5
2015,Mauritius,MUS,Ireland,IRL,0,0,10,0,10
2015,Nigeria,NGA,Ireland,IRL,0,0,87,36,123
2015,Pakistan,PAK,Ireland,IRL,5,0,140,370,515
2015,South Africa,ZAF,Ireland,IRL,5,0,30,5,40
2015,Serbia and Kosovo: S/RES/1244 (1999),SRB,Ireland,IRL,0,0,5,0,5
2015,Somalia,SOM,Ireland,IRL,5,0,5,5,15
2015,Sudan,SDN,Ireland,IRL,5,0,5,0,10
2015,Eswatini,SWZ,Ireland,IRL,0,0,0,5,5
2015,Syrian Arab Rep.,SYR,Ireland,IRL,24,0,0,10,34
2015,Ukraine,UKR,Ireland,IRL,0,0,25,12,37
2015,United States of America,USA,Ireland,IRL,0,0,0,5,5
2015,Venezuela (Bolivarian Republic of),VEN,Ireland,IRL,5,0,0,0,5
2015,Zimbabwe,ZWE,Ireland,IRL,5,0,37,10,52
2015,Afghanistan,AFG,Italy,ITA,305,2973,152,14,3444
2015,Albania,ALB,Italy,ITA,31,78,128,0,237
2015,Algeria,DZA,Italy,ITA,5,26,85,0,116
2015,Angola,AGO,Italy,ITA,0,5,0,0,5
2015,Egypt,EGY,Italy,ITA,27,225,441,0,693
2015,Argentina,ARG,Italy,ITA,0,0,5,0,5
2015,Armenia,ARM,Italy,ITA,13,36,24,0,73
2015,Azerbaijan,AZE,Italy,ITA,0,0,5,0,5
2015,Benin,BEN,Italy,ITA,5,46,64,0,115
2015,Bangladesh,BGD,Italy,ITA,102,1124,3785,0,5011
2015,Burkina Faso,BFA,Italy,ITA,10,155,227,0,392
2015,Belarus,BLR,Italy,ITA,0,5,0,0,5
2015,Brazil,BRA,Italy,ITA,0,11,5,0,16
2015,Bosnia and Herzegovina,BIH,Italy,ITA,0,103,48,0,151
2015,Central African Rep.,CAF,Italy,ITA,18,13,10,0,41
2015,Chad,TCD,Italy,ITA,0,49,24,0,73
2015,China,CHN,Italy,ITA,21,10,68,0,99
2015,Cameroon,CMR,Italy,ITA,45,86,98,0,229
2015,Congo,COG,Italy,ITA,15,50,40,0,105
2015,Dem. Rep. of the Congo,COD,Italy,ITA,42,47,22,0,111
2015,Colombia,COL,Italy,ITA,17,44,10,0,71
2015,Cuba,CUB,Italy,ITA,5,18,14,0,37
2015,Dominican Rep.,DOM,Italy,ITA,0,5,5,0,10
2015,Ecuador,ECU,Italy,ITA,0,0,10,0,10
2015,Equatorial Guinea,GNQ,Italy,ITA,0,5,5,0,10
2015,Eritrea,ERI,Italy,ITA,259,266,132,0,657
2015,Ethiopia,ETH,Italy,ITA,49,82,21,0,152
2015,Gabon,GAB,Italy,ITA,0,5,5,0,10
2015,Gambia,GMB,Italy,ITA,247,2749,5730,0,8726
2015,Palestinian,PSE,Italy,ITA,81,32,79,0,192
2015,Georgia,GEO,Italy,ITA,5,51,56,0,112
2015,Ghana,GHA,Italy,ITA,42,758,1868,5,2673
2015,Guinea-Bissau,GNB,Italy,ITA,0,153,345,0,498
2015,Guinea,GIN,Italy,ITA,36,564,572,0,1172
2015,Cote d'Ivoire,CIV,Italy,ITA,62,867,1338,10,2277
2015,India,IND,Italy,ITA,5,14,68,0,87
2015,Iran (Islamic Rep. of),IRN,Italy,ITA,129,96,120,0,345
2015,Iraq,IRQ,Italy,ITA,130,456,67,5,658
2015,Jordan,JOR,Italy,ITA,5,0,18,0,23
2015,Kenya,KEN,Italy,ITA,5,12,15,0,32
2015,Kuwait,KWT,Italy,ITA,0,0,5,0,5
2015,Liberia,LBR,Italy,ITA,0,64,38,11,113
2015,Libya,LBY,Italy,ITA,34,131,43,0,208
2015,Lebanon,LBN,Italy,ITA,12,26,44,0,82
2015,Sri Lanka,LKA,Italy,ITA,18,50,44,0,112
2015,Madagascar,MDG,Italy,ITA,0,5,5,0,10
2015,Mauritania,MRT,Italy,ITA,15,37,69,0,121
2015,North Macedonia,MKD,Italy,ITA,0,5,5,0,10
2015,Rep. of Moldova,MDA,Italy,ITA,0,11,5,0,16
2015,Mali,MLI,Italy,ITA,61,2723,5814,0,8598
2015,Morocco,MAR,Italy,ITA,10,84,233,0,327
2015,Montenegro,MNE,Italy,ITA,0,10,0,0,10
2015,Mauritius,MUS,Italy,ITA,0,0,5,0,5
2015,Myanmar,MMR,Italy,ITA,5,5,0,0,10
2015,Namibia,NAM,Italy,ITA,0,5,0,0,5
2015,Nepal,NPL,Italy,ITA,0,26,17,0,43
2015,Niger,NER,Italy,ITA,5,59,79,0,143
2015,Nicaragua,NIC,Italy,ITA,0,5,5,0,10
2015,Nigeria,NGA,Italy,ITA,342,3399,8852,0,12593
2015,Pakistan,PAK,Italy,ITA,433,3063,4423,0,7919
2015,Peru,PER,Italy,ITA,0,10,10,0,20
2015,Philippines,PHL,Italy,ITA,0,0,5,0,5
2015,Russian Federation,RUS,Italy,ITA,10,30,23,0,63
2015,El Salvador,SLV,Italy,ITA,5,39,30,0,74
2015,Serbia and Kosovo: S/RES/1244 (1999),SRB,Italy,ITA,16,98,105,0,219
2015,Senegal,SEN,Italy,ITA,89,1474,3867,0,5430
2015,Sierra Leone,SLE,Italy,ITA,5,112,71,0,188
2015,Somalia,SOM,Italy,ITA,197,875,73,0,1145
2015,Sudan,SDN,Italy,ITA,60,110,96,0,266
2015,Eswatini,SWZ,Italy,ITA,5,5,0,0,10
2015,Syrian Arab Rep.,SYR,Italy,ITA,255,73,253,0,581
2015,United Rep. of Tanzania,TZA,Italy,ITA,5,0,5,0,10
2015,Togo,TGO,Italy,ITA,17,133,139,0,289
2015,Tunisia,TUN,Italy,ITA,5,74,302,0,381
2015,Turkey,TUR,Italy,ITA,87,187,119,5,398
2015,Uganda,UGA,Italy,ITA,13,5,5,0,23
2015,Ukraine,UKR,Italy,ITA,79,1555,848,0,2482
2015,Venezuela (Bolivarian Republic of),VEN,Italy,ITA,0,15,14,0,29
2015,Yemen,YEM,Italy,ITA,10,5,0,0,15
2015,Unknown ,,Italy,ITA,45,285,355,0,685
2015,Afghanistan,AFG,Japan,JPN,5,0,5,0,10
2015,Egypt,EGY,Japan,JPN,0,0,5,0,5
2015,Bangladesh,BGD,Japan,JPN,0,0,124,0,124
2015,China,CHN,Japan,JPN,0,0,11,0,11
2015,Cameroon,CMR,Japan,JPN,0,0,42,0,42
2015,Dem. Rep. of the Congo,COD,Japan,JPN,0,0,5,0,5
2015,Ethiopia,ETH,Japan,JPN,0,0,14,0,14
2015,Gambia,GMB,Japan,JPN,0,0,5,0,5
2015,Ghana,GHA,Japan,JPN,0,0,65,0,65
2015,Guinea,GIN,Japan,JPN,0,0,12,0,12
2015,India,IND,Japan,JPN,0,0,84,0,84
2015,Indonesia,IDN,Japan,JPN,0,0,178,0,178
2015,Iran (Islamic Rep. of),IRN,Japan,JPN,0,0,48,0,48
2015,Kenya,KEN,Japan,JPN,0,0,5,0,5
2015,Liberia,LBR,Japan,JPN,0,0,5,0,5
2015,Sri Lanka,LKA,Japan,JPN,0,0,310,0,310
2015,Mali,MLI,Japan,JPN,0,0,5,0,5
2015,Myanmar,MMR,Japan,JPN,0,5,226,0,231
2015,Nepal,NPL,Japan,JPN,0,0,1007,0,1007
2015,Nigeria,NGA,Japan,JPN,0,0,67,0,67
2015,Pakistan,PAK,Japan,JPN,0,0,147,0,147
2015,Peru,PER,Japan,JPN,0,0,5,0,5
2015,Philippines,PHL,Japan,JPN,0,0,65,0,65
2015,Senegal,SEN,Japan,JPN,0,0,26,0,26
2015,Viet Nam,VNM,Japan,JPN,0,0,251,0,251
2015,Syrian Arab Rep.,SYR,Japan,JPN,5,5,0,0,10
2015,United Rep. of Tanzania,TZA,Japan,JPN,0,0,5,0,5
2015,Thailand,THA,Japan,JPN,0,0,140,0,140
2015,Tunisia,TUN,Japan,JPN,0,0,19,0,19
2015,Turkey,TUR,Japan,JPN,0,0,467,0,467
2015,Uganda,UGA,Japan,JPN,0,0,23,0,23
2015,Ukraine,UKR,Japan,JPN,0,5,0,0,5
2015,Unknown ,,Japan,JPN,0,0,5,468,473
2015,Afghanistan,AFG,Kazakhstan,KAZ,122,0,154,35,311
2015,Kyrgyzstan,KGZ,Kazakhstan,KAZ,0,0,0,5,5
2015,Syrian Arab Rep.,SYR,Kazakhstan,KAZ,5,0,10,0,15
2015,Ukraine,UKR,Kazakhstan,KAZ,0,0,15,0,15
2015,Afghanistan,AFG,Kyrgyzstan,KGZ,5,0,110,40,155
2015,Pakistan,PAK,Kyrgyzstan,KGZ,0,0,5,5,10
2015,Syrian Arab Rep.,SYR,Kyrgyzstan,KGZ,10,0,5,10,25
2015,Tajikistan,TJK,Kyrgyzstan,KGZ,0,0,5,0,5
2015,Turkmenistan,TKM,Kyrgyzstan,KGZ,0,0,0,5,5
2015,Ukraine,UKR,Kyrgyzstan,KGZ,10,0,0,15,25
2015,Albania,ALB,Liechtenstein,LIE,0,0,5,5,10
2015,Armenia,ARM,Liechtenstein,LIE,0,0,5,5,10
2015,Belarus,BLR,Liechtenstein,LIE,0,0,0,5,5
2015,Croatia,HRV,Liechtenstein,LIE,0,0,5,0,5
2015,Kyrgyzstan,KGZ,Liechtenstein,LIE,0,0,5,0,5
2015,North Macedonia,MKD,Liechtenstein,LIE,0,0,0,10,10
2015,Russian Federation,RUS,Liechtenstein,LIE,0,0,5,0,5
2015,Serbia and Kosovo: S/RES/1244 (1999),SRB,Liechtenstein,LIE,0,0,0,12,12
2015,Somalia,SOM,Liechtenstein,LIE,0,5,5,5,15
2015,Ukraine,UKR,Liechtenstein,LIE,0,0,0,5,5
2015,Afghanistan,AFG,Lithuania,LTU,0,13,0,48,61
2015,Azerbaijan,AZE,Lithuania,LTU,0,0,5,5,10
2015,Belarus,BLR,Lithuania,LTU,0,0,5,10,15
2015,Georgia,GEO,Lithuania,LTU,0,0,33,42,75
2015,India,IND,Lithuania,LTU,0,0,5,0,5
2015,Iraq,IRQ,Lithuania,LTU,0,20,0,5,25
2015,Russian Federation,RUS,Lithuania,LTU,10,5,5,20,40
2015,Viet Nam,VNM,Lithuania,LTU,0,0,5,5,10
2015,Tajikistan,TJK,Lithuania,LTU,5,0,0,0,5
2015,Ukraine,UKR,Lithuania,LTU,0,26,26,21,73
2015,Afghanistan,AFG,Luxembourg,LUX,0,0,0,5,5
2015,Albania,ALB,Luxembourg,LUX,0,13,57,23,93
2015,Algeria,DZA,Luxembourg,LUX,0,0,5,33,38
2015,Egypt,EGY,Luxembourg,LUX,0,0,0,5,5
2015,Azerbaijan,AZE,Luxembourg,LUX,0,0,10,0,10
2015,Belarus,BLR,Luxembourg,LUX,0,0,5,5,10
2015,Bosnia and Herzegovina,BIH,Luxembourg,LUX,0,0,103,5,108
2015,Cameroon,CMR,Luxembourg,LUX,5,0,0,10,15
2015,Dem. Rep. of the Congo,COD,Luxembourg,LUX,5,0,5,5,15
2015,Eritrea,ERI,Luxembourg,LUX,27,0,0,11,38
2015,Ethiopia,ETH,Luxembourg,LUX,11,0,0,5,16
2015,Gambia,GMB,Luxembourg,LUX,0,0,5,5,10
2015,Palestinian,PSE,Luxembourg,LUX,10,0,0,0,10
2015,Georgia,GEO,Luxembourg,LUX,0,0,5,20,25
2015,Ghana,GHA,Luxembourg,LUX,0,0,0,5,5
2015,Guinea,GIN,Luxembourg,LUX,0,0,5,5,10
2015,Cote d'Ivoire,CIV,Luxembourg,LUX,0,0,5,0,5
2015,Iran (Islamic Rep. of),IRN,Luxembourg,LUX,5,0,5,5,15
2015,Iraq,IRQ,Luxembourg,LUX,15,5,0,49,69
2015,Liberia,LBR,Luxembourg,LUX,0,0,0,5,5
2015,Libya,LBY,Luxembourg,LUX,0,0,5,5,10
2015,Sri Lanka,LKA,Luxembourg,LUX,5,0,0,0,5
2015,North Macedonia,MKD,Luxembourg,LUX,0,0,24,0,24
2015,Mali,MLI,Luxembourg,LUX,0,0,0,5,5
2015,Morocco,MAR,Luxembourg,LUX,0,0,0,10,10
2015,Montenegro,MNE,Luxembourg,LUX,0,0,73,5,78
2015,Nigeria,NGA,Luxembourg,LUX,0,0,18,23,41
2015,Pakistan,PAK,Luxembourg,LUX,0,0,0,5,5
2015,Russian Federation,RUS,Luxembourg,LUX,0,0,0,15,15
2015,Serbia and Kosovo: S/RES/1244 (1999),SRB,Luxembourg,LUX,5,5,142,114,266
2015,Somalia,SOM,Luxembourg,LUX,5,0,5,10,20
2015,South Sudan,SSD,Luxembourg,LUX,0,0,0,5,5
2015,Syrian Arab Rep.,SYR,Luxembourg,LUX,79,0,0,20,99
2015,Togo,TGO,Luxembourg,LUX,0,0,5,0,5
2015,Tunisia,TUN,Luxembourg,LUX,0,0,14,19,33
2015,Turkey,TUR,Luxembourg,LUX,14,0,0,5,19
2015,Uganda,UGA,Luxembourg,LUX,0,0,0,5,5
2015,Ukraine,UKR,Luxembourg,LUX,0,0,5,26,31
2015,Stateless,XXA,Luxembourg,LUX,11,0,0,0,11
2015,Afghanistan,AFG,Latvia,LVA,5,5,5,0,15
2015,Armenia,ARM,Latvia,LVA,0,0,5,0,5
2015,Azerbaijan,AZE,Latvia,LVA,0,0,0,5,5
2015,Georgia,GEO,Latvia,LVA,0,0,18,87,105
2015,Iraq,IRQ,Latvia,LVA,0,0,5,18,23
2015,Sri Lanka,LKA,Latvia,LVA,0,0,5,0,5
2015,Russian Federation,RUS,Latvia,LVA,0,0,5,5,10
2015,Viet Nam,VNM,Latvia,LVA,0,0,64,24,88
2015,Syrian Arab Rep.,SYR,Latvia,LVA,0,13,0,5,18
2015,Ukraine,UKR,Latvia,LVA,0,0,37,55,92
2015,Afghanistan,AFG,Rep. of Moldova,MDA,5,0,0,11,16
2015,Armenia,ARM,Rep. of Moldova,MDA,0,0,5,0,5
2015,Iraq,IRQ,Rep. of Moldova,MDA,0,13,0,5,18
2015,Kyrgyzstan,KGZ,Rep. of Moldova,MDA,0,0,5,0,5
2015,Lebanon,LBN,Rep. of Moldova,MDA,0,0,5,0,5
2015,Sri Lanka,LKA,Rep. of Moldova,MDA,0,0,5,0,5
2015,Russian Federation,RUS,Rep. of Moldova,MDA,0,0,5,0,5
2015,Syrian Arab Rep.,SYR,Rep. of Moldova,MDA,20,37,0,10,67
2015,Turkey,TUR,Rep. of Moldova,MDA,0,0,5,5,10
2015,Ukraine,UKR,Rep. of Moldova,MDA,0,93,29,50,172
2015,Colombia,COL,Mexico,MEX,10,0,13,5,28
2015,Cuba,CUB,Mexico,MEX,0,0,5,29,34
2015,Ecuador,ECU,Mexico,MEX,0,0,0,5,5
2015,Germany,DEU,Mexico,MEX,0,0,5,0,5
2015,Ghana,GHA,Mexico,MEX,0,0,0,5,5
2015,Guatemala,GTM,Mexico,MEX,27,5,35,33,100
2015,Haiti,HTI,Mexico,MEX,0,0,13,5,18
2015,Honduras,HND,Mexico,MEX,376,63,612,507,1558
2015,India,IND,Mexico,MEX,0,0,5,12,17
2015,Iraq,IRQ,Mexico,MEX,5,0,0,0,5
2015,Nepal,NPL,Mexico,MEX,0,0,0,5,5
2015,Nicaragua,NIC,Mexico,MEX,0,0,14,11,25
2015,Nigeria,NGA,Mexico,MEX,0,0,5,0,5
2015,Peru,PER,Mexico,MEX,0,0,5,0,5
2015,Russian Federation,RUS,Mexico,MEX,5,0,0,0,5
2015,El Salvador,SLV,Mexico,MEX,462,66,555,392,1475
2015,Syrian Arab Rep.,SYR,Mexico,MEX,5,0,0,0,5
2015,Turkey,TUR,Mexico,MEX,0,5,0,0,5
2015,Ukraine,UKR,Mexico,MEX,5,0,0,0,5
2015,United States of America,USA,Mexico,MEX,0,0,5,5,10
2015,Venezuela (Bolivarian Republic of),VEN,Mexico,MEX,19,10,26,5,60
2015,Burundi,BDI,Malawi,MWI,172,0,26,0,198
2015,Dem. Rep. of the Congo,COD,Malawi,MWI,3077,0,0,0,3077
2015,Rwanda,RWA,Malawi,MWI,90,0,78,10,178
2015,Somalia,SOM,Malawi,MWI,13,0,0,0,13
2015,Burundi,BDI,Mozambique,MOZ,0,0,0,473,473
2015,Congo,COG,Mozambique,MOZ,0,0,0,10,10
2015,Dem. Rep. of the Congo,COD,Mozambique,MOZ,0,0,0,1920,1920
2015,Ethiopia,ETH,Mozambique,MOZ,0,0,0,5,5
2015,Rwanda,RWA,Mozambique,MOZ,0,0,0,142,142
2015,Somalia,SOM,Mozambique,MOZ,0,0,0,266,266
2015,Algeria,DZA,Malta,MLT,0,0,5,5,10
2015,Egypt,EGY,Malta,MLT,0,12,10,5,27
2015,Bangladesh,BGD,Malta,MLT,5,0,0,0,5
2015,Comoros,COM,Malta,MLT,0,0,5,0,5
2015,Eritrea,ERI,Malta,MLT,0,50,0,0,50
2015,Ethiopia,ETH,Malta,MLT,5,16,0,0,21
2015,Gambia,GMB,Malta,MLT,5,5,15,5,30
2015,Palestinian,PSE,Malta,MLT,0,5,0,5,10
2015,Guinea-Bissau,GNB,Malta,MLT,0,0,12,0,12
2015,Cote d'Ivoire,CIV,Malta,MLT,0,5,15,0,20
2015,Iran (Islamic Rep. of),IRN,Malta,MLT,5,0,0,0,5
2015,Iraq,IRQ,Malta,MLT,5,0,0,0,5
2015,Libya,LBY,Malta,MLT,244,761,0,32,1037
2015,North Macedonia,MKD,Malta,MLT,5,0,10,0,15
2015,Mali,MLI,Malta,MLT,0,5,25,0,30
2015,Morocco,MAR,Malta,MLT,5,5,0,0,10
2015,Nepal,NPL,Malta,MLT,0,0,5,5,10
2015,Nigeria,NGA,Malta,MLT,5,10,11,5,31
2015,Senegal,SEN,Malta,MLT,0,0,0,27,27
2015,Somalia,SOM,Malta,MLT,5,51,5,5,66
2015,Syrian Arab Rep.,SYR,Malta,MLT,17,265,0,16,298
2015,Tunisia,TUN,Malta,MLT,0,0,5,0,5
2015,Ukraine,UKR,Malta,MLT,0,50,0,5,55
2015,Venezuela (Bolivarian Republic of),VEN,Malta,MLT,0,0,5,0,5
2015,Burundi,BDI,Namibia,NAM,18,0,0,0,18
2015,Cameroon,CMR,Namibia,NAM,0,0,0,5,5
2015,Dem. Rep. of the Congo,COD,Namibia,NAM,143,0,0,0,143
2015,Rwanda,RWA,Namibia,NAM,13,0,0,0,13
2015,Zimbabwe,ZWE,Namibia,NAM,5,0,0,0,5
2015,Afghanistan,AFG,Netherlands,NLD,210,0,183,40,433
2015,Albania,ALB,Netherlands,NLD,0,0,300,102,402
2015,Algeria,DZA,Netherlands,NLD,0,0,14,5,19
2015,Angola,AGO,Netherlands,NLD,0,0,5,0,5
2015,Egypt,EGY,Netherlands,NLD,15,0,39,10,64
2015,Armenia,ARM,Netherlands,NLD,5,0,73,14,92
2015,Azerbaijan,AZE,Netherlands,NLD,15,0,29,0,44
2015,Burundi,BDI,Netherlands,NLD,5,0,5,5,15
2015,Bangladesh,BGD,Netherlands,NLD,0,0,12,0,12
2015,Belarus,BLR,Netherlands,NLD,5,0,21,5,31
2015,Brazil,BRA,Netherlands,NLD,0,0,5,0,5
2015,Bosnia and Herzegovina,BIH,Netherlands,NLD,0,0,76,5,81
2015,Chad,TCD,Netherlands,NLD,0,0,5,0,5
2015,China,CHN,Netherlands,NLD,34,5,98,18,155
2015,Cameroon,CMR,Netherlands,NLD,0,0,14,5,19
2015,Congo,COG,Netherlands,NLD,10,0,26,5,41
2015,Colombia,COL,Netherlands,NLD,0,0,5,0,5
2015,Cuba,CUB,Netherlands,NLD,0,0,10,0,10
2015,Eritrea,ERI,Netherlands,NLD,4462,264,243,58,5027
2015,Ethiopia,ETH,Netherlands,NLD,26,0,52,5,83
2015,Gambia,GMB,Netherlands,NLD,5,0,19,0,24
2015,Palestinian,PSE,Netherlands,NLD,10,0,5,0,15
2015,Georgia,GEO,Netherlands,NLD,0,0,142,33,175
2015,Ghana,GHA,Netherlands,NLD,0,0,12,5,17
2015,Guinea,GIN,Netherlands,NLD,16,0,25,11,52
2015,Honduras,HND,Netherlands,NLD,0,0,5,0,5
2015,Cote d'Ivoire,CIV,Netherlands,NLD,0,0,10,5,15
2015,India,IND,Netherlands,NLD,0,0,5,5,10
2015,Indonesia,IDN,Netherlands,NLD,0,0,5,0,5
2015,Iran (Islamic Rep. of),IRN,Netherlands,NLD,205,5,147,66,423
2015,Iraq,IRQ,Netherlands,NLD,171,0,159,148,478
2015,Israel,ISR,Netherlands,NLD,0,0,0,5,5
2015,Jamaica,JAM,Netherlands,NLD,47,0,5,0,52
2015,Jordan,JOR,Netherlands,NLD,5,0,10,0,15
2015,Kazakhstan,KAZ,Netherlands,NLD,0,0,5,0,5
2015,Kenya,KEN,Netherlands,NLD,0,0,5,0,5
2015,Kyrgyzstan,KGZ,Netherlands,NLD,0,0,5,0,5
2015,Dem. People's Rep. of Korea,PRK,Netherlands,NLD,0,0,5,0,5
2015,Liberia,LBR,Netherlands,NLD,0,0,5,0,5
2015,Libya,LBY,Netherlands,NLD,17,0,30,15,62
2015,Lebanon,LBN,Netherlands,NLD,5,0,23,0,28
2015,Sri Lanka,LKA,Netherlands,NLD,14,0,25,5,44
2015,North Macedonia,MKD,Netherlands,NLD,0,0,59,12,71
2015,Rep. of Moldova,MDA,Netherlands,NLD,0,0,5,0,5
2015,Mali,MLI,Netherlands,NLD,0,0,12,0,12
2015,Mongolia,MNG,Netherlands,NLD,5,0,315,51,371
2015,Morocco,MAR,Netherlands,NLD,5,0,39,5,49
2015,Myanmar,MMR,Netherlands,NLD,21,0,5,0,26
2015,Nepal,NPL,Netherlands,NLD,0,0,25,5,30
2015,Niger,NER,Netherlands,NLD,0,0,5,0,5
2015,Nigeria,NGA,Netherlands,NLD,58,0,121,16,195
2015,Pakistan,PAK,Netherlands,NLD,51,0,86,17,154
2015,South Africa,ZAF,Netherlands,NLD,0,0,5,0,5
2015,Russian Federation,RUS,Netherlands,NLD,12,0,77,12,101
2015,Rwanda,RWA,Netherlands,NLD,0,0,10,0,10
2015,Serbia and Kosovo: S/RES/1244 (1999),SRB,Netherlands,NLD,0,0,210,219,429
2015,Senegal,SEN,Netherlands,NLD,0,0,10,0,10
2015,Sierra Leone,SLE,Netherlands,NLD,13,0,13,10,36
2015,Somalia,SOM,Netherlands,NLD,54,5,71,19,149
2015,Viet Nam,VNM,Netherlands,NLD,0,0,31,10,41
2015,Sudan,SDN,Netherlands,NLD,108,10,43,12,173
2015,Syrian Arab Rep.,SYR,Netherlands,NLD,7601,114,577,231,8523
2015,United Rep. of Tanzania,TZA,Netherlands,NLD,0,0,10,0,10
2015,Tajikistan,TJK,Netherlands,NLD,0,0,5,5,10
2015,Togo,TGO,Netherlands,NLD,0,0,5,0,5
2015,Trinidad and Tobago,TTO,Netherlands,NLD,5,0,0,0,5
2015,Tunisia,TUN,Netherlands,NLD,0,0,12,5,17
2015,Turkey,TUR,Netherlands,NLD,5,0,23,5,33
2015,Uganda,UGA,Netherlands,NLD,41,0,33,0,74
2015,Ukraine,UKR,Netherlands,NLD,5,0,388,60,453
2015,United States of America,USA,Netherlands,NLD,0,0,17,0,17
2015,Uzbekistan,UZB,Netherlands,NLD,0,0,5,0,5
2015,Yemen,YEM,Netherlands,NLD,13,0,13,0,26
2015,Zimbabwe,ZWE,Netherlands,NLD,0,0,5,0,5
2015,Stateless,XXA,Netherlands,NLD,1724,5,284,42,2055
2015,Unknown ,,Netherlands,NLD,68,0,88,24,180
2015,Central African Rep.,CAF,Niger,NER,18,0,13,0,31
2015,Honduras,HND,Nicaragua,NIC,16,0,0,0,16
2015,El Salvador,SLV,Nicaragua,NIC,45,0,0,0,45
2015,Burundi,BDI,Nigeria,NGA,10,0,0,0,10
2015,Central African Rep.,CAF,Nigeria,NGA,67,0,35,39,141
2015,Chad,TCD,Nigeria,NGA,0,0,5,5,10
2015,Cameroon,CMR,Nigeria,NGA,0,0,0,5,5
2015,Dem. Rep. of the Congo,COD,Nigeria,NGA,18,0,45,195,258
2015,Eritrea,ERI,Nigeria,NGA,11,0,0,5,16
2015,Cote d'Ivoire,CIV,Nigeria,NGA,5,0,14,35,54
2015,Liberia,LBR,Nigeria,NGA,5,0,0,0,5
2015,Mali,MLI,Nigeria,NGA,19,0,5,192,216
2015,Syrian Arab Rep.,SYR,Nigeria,NGA,20,0,0,0,20
2015,Togo,TGO,Nigeria,NGA,0,0,218,5,223
2015,Afghanistan,AFG,Norway,NOR,236,316,111,597,1260
2015,Albania,ALB,Norway,NOR,0,0,307,111,418
2015,Algeria,DZA,Norway,NOR,0,0,34,58,92
2015,Angola,AGO,Norway,NOR,0,0,5,5,10
2015,Egypt,EGY,Norway,NOR,0,0,46,59,105
2015,Armenia,ARM,Norway,NOR,0,0,15,5,20
2015,Azerbaijan,AZE,Norway,NOR,5,0,5,20,30
2015,Burundi,BDI,Norway,NOR,5,0,0,0,5
2015,Bangladesh,BGD,Norway,NOR,0,0,89,44,133
2015,Belarus,BLR,Norway,NOR,0,0,5,5,10
2015,Bosnia and Herzegovina,BIH,Norway,NOR,0,0,41,57,98
2015,Chad,TCD,Norway,NOR,0,0,0,5,5
2015,China,CHN,Norway,NOR,38,0,0,0,38
2015,Cameroon,CMR,Norway,NOR,0,0,5,10,15
2015,Dem. Rep. of the Congo,COD,Norway,NOR,0,5,5,0,10
2015,Djibouti,DJI,Norway,NOR,0,0,0,10,10
2015,Eritrea,ERI,Norway,NOR,2549,0,39,165,2753
2015,Ethiopia,ETH,Norway,NOR,201,0,62,48,311
2015,France,FRA,Norway,NOR,0,0,5,0,5
2015,Gambia,GMB,Norway,NOR,0,0,10,12,22
2015,Georgia,GEO,Norway,NOR,0,0,15,5,20
2015,Ghana,GHA,Norway,NOR,0,0,5,5,10
2015,Greece,GRC,Norway,NOR,0,0,5,0,5
2015,Guinea,GIN,Norway,NOR,5,0,5,14,24
2015,Honduras,HND,Norway,NOR,5,0,0,0,5
2015,Croatia,HRV,Norway,NOR,0,0,0,5,5
2015,Hungary,HUN,Norway,NOR,0,0,5,0,5
2015,Cote d'Ivoire,CIV,Norway,NOR,0,0,5,5,10
2015,India,IND,Norway,NOR,0,0,10,15,25
2015,Iran (Islamic Rep. of),IRN,Norway,NOR,41,0,32,97,170
2015,Iraq,IRQ,Norway,NOR,20,5,51,281,357
2015,Israel,ISR,Norway,NOR,0,0,5,0,5
2015,Jordan,JOR,Norway,NOR,0,0,5,11,16
2015,Liberia,LBR,Norway,NOR,0,0,0,5,5
2015,Libya,LBY,Norway,NOR,0,10,5,48,63
2015,Lebanon,LBN,Norway,NOR,0,0,13,43,56
2015,Sri Lanka,LKA,Norway,NOR,0,0,5,5,10
2015,Mauritania,MRT,Norway,NOR,0,0,0,5,5
2015,North Macedonia,MKD,Norway,NOR,0,0,35,10,45
2015,Mali,MLI,Norway,NOR,0,0,0,5,5
2015,Mongolia,MNG,Norway,NOR,0,0,17,5,22
2015,Morocco,MAR,Norway,NOR,5,0,51,72,128
2015,Montenegro,MNE,Norway,NOR,0,0,10,0,10
2015,Myanmar,MMR,Norway,NOR,5,0,0,0,5
2015,Nepal,NPL,Norway,NOR,0,0,5,25,30
2015,Nigeria,NGA,Norway,NOR,5,0,58,75,138
2015,Pakistan,PAK,Norway,NOR,5,0,60,134,199
2015,Poland,POL,Norway,NOR,0,0,5,0,5
2015,Romania,ROU,Norway,NOR,0,0,10,5,15
2015,Russian Federation,RUS,Norway,NOR,5,0,59,44,108
2015,Rwanda,RWA,Norway,NOR,0,0,0,5,5
2015,El Salvador,SLV,Norway,NOR,0,0,11,0,11
2015,Serbia and Kosovo: S/RES/1244 (1999),SRB,Norway,NOR,0,5,172,38,215
2015,Senegal,SEN,Norway,NOR,0,0,0,21,21
2015,Sierra Leone,SLE,Norway,NOR,0,0,0,5,5
2015,Somalia,SOM,Norway,NOR,139,15,185,97,436
2015,Spain,ESP,Norway,NOR,0,0,5,0,5
2015,Viet Nam,VNM,Norway,NOR,0,0,10,10,20
2015,Sudan,SDN,Norway,NOR,375,5,59,49,488
2015,Sweden,SWE,Norway,NOR,0,0,0,5,5
2015,Syrian Arab Rep.,SYR,Norway,NOR,1354,188,5,659,2206
2015,Tajikistan,TJK,Norway,NOR,0,0,5,5,10
2015,Tunisia,TUN,Norway,NOR,0,0,13,34,47
2015,Turkey,TUR,Norway,NOR,10,5,42,26,83
2015,Uganda,UGA,Norway,NOR,11,0,31,5,47
2015,Ukraine,UKR,Norway,NOR,0,0,53,34,87
2015,Uzbekistan,UZB,Norway,NOR,11,0,5,12,28
2015,Yemen,YEM,Norway,NOR,0,5,5,11,21
2015,Stateless,XXA,Norway,NOR,313,110,58,97,578
2015,Afghanistan,AFG,Nauru,NRU,38,0,12,0,50
2015,Bangladesh,BGD,Nauru,NRU,5,0,28,0,33
2015,India,IND,Nauru,NRU,5,0,10,0,15
2015,Iran (Islamic Rep. of),IRN,Nauru,NRU,85,0,57,0,142
2015,Iraq,IRQ,Nauru,NRU,28,0,0,0,28
2015,Sri Lanka,LKA,Nauru,NRU,31,0,85,0,116
2015,Myanmar,MMR,Nauru,NRU,12,0,0,0,12
2015,Nepal,NPL,Nauru,NRU,0,0,5,0,5
2015,Pakistan,PAK,Nauru,NRU,34,0,25,0,59
2015,Somalia,SOM,Nauru,NRU,26,0,0,0,26
2015,Syrian Arab Rep.,SYR,Nauru,NRU,5,0,0,0,5
2015,Stateless,XXA,Nauru,NRU,119,0,5,0,124
2015,Colombia,COL,Panama,PAN,42,0,14,158,214
2015,Cuba,CUB,Panama,PAN,0,0,0,14,14
2015,Dominican Rep.,DOM,Panama,PAN,0,0,0,5,5
2015,Nicaragua,NIC,Panama,PAN,0,0,0,14,14
2015,El Salvador,SLV,Panama,PAN,0,0,0,5,5
2015,Venezuela (Bolivarian Republic of),VEN,Panama,PAN,0,0,0,24,24
2015,Liberia,LBR,Paraguay,PRY,0,0,5,0,5
2015,Syrian Arab Rep.,SYR,Paraguay,PRY,27,0,10,0,37
2015,Bangladesh,BGD,Peru,PER,5,0,15,0,20
2015,Colombia,COL,Peru,PER,58,0,88,0,146
2015,Cuba,CUB,Peru,PER,23,0,69,0,92
2015,Dominican Rep.,DOM,Peru,PER,5,0,23,0,28
2015,Ecuador,ECU,Peru,PER,0,0,5,0,5
2015,Palestinian,PSE,Peru,PER,5,0,0,0,5
2015,Haiti,HTI,Peru,PER,5,0,0,0,5
2015,India,IND,Peru,PER,0,0,5,0,5
2015,Nigeria,NGA,Peru,PER,5,0,5,0,10
2015,Syrian Arab Rep.,SYR,Peru,PER,10,0,0,0,10
2015,Ukraine,UKR,Peru,PER,10,0,0,0,10
2015,Venezuela (Bolivarian Republic of),VEN,Peru,PER,70,0,51,0,121
2015,Palestinian,PSE,Philippines,PHL,0,0,0,5,5
2015,Iraq,IRQ,Philippines,PHL,5,0,0,0,5
2015,Pakistan,PAK,Philippines,PHL,10,0,0,5,15
2015,Rwanda,RWA,Philippines,PHL,5,0,0,0,5
2015,Somalia,SOM,Philippines,PHL,5,0,0,0,5
2015,Viet Nam,VNM,Philippines,PHL,5,0,0,0,5
2015,Syrian Arab Rep.,SYR,Philippines,PHL,17,0,0,0,17
2015,Afghanistan,AFG,Papua New Guinea,PNG,49,0,0,0,49
2015,Bangladesh,BGD,Papua New Guinea,PNG,5,0,5,0,10
2015,Iran (Islamic Rep. of),IRN,Papua New Guinea,PNG,34,0,10,0,44
2015,Iraq,IRQ,Papua New Guinea,PNG,26,0,0,0,26
2015,Sri Lanka,LKA,Papua New Guinea,PNG,5,0,0,0,5
2015,Pakistan,PAK,Papua New Guinea,PNG,34,0,0,0,34
2015,Somalia,SOM,Papua New Guinea,PNG,25,0,0,0,25
2015,Sudan,SDN,Papua New Guinea,PNG,67,0,0,0,67
2015,Stateless,XXA,Papua New Guinea,PNG,62,0,0,0,62
2015,Afghanistan,AFG,Poland,POL,10,5,5,12,32
2015,Egypt,EGY,Poland,POL,15,0,5,5,25
2015,Armenia,ARM,Poland,POL,0,0,43,146,189
2015,Azerbaijan,AZE,Poland,POL,0,0,5,12,17
2015,Bangladesh,BGD,Poland,POL,0,0,0,10,10
2015,Belarus,BLR,Poland,POL,14,0,18,13,45
2015,China,CHN,Poland,POL,0,0,5,5,10
2015,Cuba,CUB,Poland,POL,10,0,0,0,10
2015,Eritrea,ERI,Poland,POL,0,10,0,0,10
2015,Georgia,GEO,Poland,POL,0,0,121,348,469
2015,Ghana,GHA,Poland,POL,0,0,0,5,5
2015,India,IND,Poland,POL,0,0,5,0,5
2015,Iran (Islamic Rep. of),IRN,Poland,POL,5,0,5,10,20
2015,Iraq,IRQ,Poland,POL,24,24,0,19,67
2015,Jordan,JOR,Poland,POL,0,0,5,0,5
2015,Kazakhstan,KAZ,Poland,POL,0,0,24,16,40
2015,Kyrgyzstan,KGZ,Poland,POL,5,0,90,87,182
2015,Libya,LBY,Poland,POL,0,0,0,5,5
2015,Mongolia,MNG,Poland,POL,0,0,5,0,5
2015,Nepal,NPL,Poland,POL,0,0,0,5,5
2015,Nigeria,NGA,Poland,POL,0,0,5,5,10
2015,Pakistan,PAK,Poland,POL,0,0,10,18,28
2015,Russian Federation,RUS,Poland,POL,21,104,670,6566,7361
2015,Rwanda,RWA,Poland,POL,0,0,0,5,5
2015,Viet Nam,VNM,Poland,POL,0,0,28,14,42
2015,Syrian Arab Rep.,SYR,Poland,POL,203,5,0,90,298
2015,Tajikistan,TJK,Poland,POL,0,0,18,498,516
2015,Turkmenistan,TKM,Poland,POL,12,0,5,0,17
2015,Tunisia,TUN,Poland,POL,0,0,5,0,5
2015,Turkey,TUR,Poland,POL,0,0,5,0,5
2015,Ukraine,UKR,Poland,POL,0,5,1776,765,2546
2015,Uzbekistan,UZB,Poland,POL,0,0,16,13,29
2015,Yemen,YEM,Poland,POL,0,5,0,5,10
2015,Stateless,XXA,Poland,POL,20,0,5,34,59
2015,Afghanistan,AFG,Portugal,PRT,0,0,0,5,5
2015,Algeria,DZA,Portugal,PRT,0,0,0,5,5
2015,Angola,AGO,Portugal,PRT,0,0,0,5,5
2015,Bangladesh,BGD,Portugal,PRT,0,0,0,5,5
2015,Brazil,BRA,Portugal,PRT,0,0,0,5,5
2015,Cameroon,CMR,Portugal,PRT,5,0,0,5,10
2015,Congo,COG,Portugal,PRT,0,0,0,10,10
2015,Dem. Rep. of the Congo,COD,Portugal,PRT,0,5,0,11,16
2015,Ghana,GHA,Portugal,PRT,0,0,0,5,5
2015,Guinea-Bissau,GNB,Portugal,PRT,0,0,5,5,10
2015,Guinea,GIN,Portugal,PRT,0,5,15,20,40
2015,Cote d'Ivoire,CIV,Portugal,PRT,5,5,0,12,22
2015,Iran (Islamic Rep. of),IRN,Portugal,PRT,0,0,0,5,5
2015,Libya,LBY,Portugal,PRT,5,0,0,0,5
2015,Sri Lanka,LKA,Portugal,PRT,0,5,0,0,5
2015,North Macedonia,MKD,Portugal,PRT,0,0,0,5,5
2015,Mali,MLI,Portugal,PRT,0,0,0,80,80
2015,Morocco,MAR,Portugal,PRT,0,0,0,20,20
2015,Nigeria,NGA,Portugal,PRT,0,5,0,0,5
2015,Pakistan,PAK,Portugal,PRT,0,5,0,24,29
2015,Russian Federation,RUS,Portugal,PRT,0,0,0,5,5
2015,Senegal,SEN,Portugal,PRT,0,0,0,10,10
2015,Sierra Leone,SLE,Portugal,PRT,11,0,0,10,21
2015,Somalia,SOM,Portugal,PRT,0,5,0,0,5
2015,Syrian Arab Rep.,SYR,Portugal,PRT,0,0,0,5,5
2015,Togo,TGO,Portugal,PRT,0,0,0,5,5
2015,Ukraine,UKR,Portugal,PRT,0,118,0,166,284
2015,Afghanistan,AFG,Romania,ROU,10,5,85,0,100
2015,Egypt,EGY,Romania,ROU,0,0,10,0,10
2015,Bangladesh,BGD,Romania,ROU,0,0,5,5,10
2015,China,CHN,Romania,ROU,0,0,14,10,24
2015,Cameroon,CMR,Romania,ROU,0,0,5,5,10
2015,Congo,COG,Romania,ROU,0,5,0,0,5
2015,Dem. Rep. of the Congo,COD,Romania,ROU,0,0,5,0,5
2015,Cuba,CUB,Romania,ROU,0,0,0,5,5
2015,France,FRA,Romania,ROU,0,0,5,0,5
2015,Palestinian,PSE,Romania,ROU,0,0,10,0,10
2015,Georgia,GEO,Romania,ROU,0,0,15,0,15
2015,Guinea,GIN,Romania,ROU,0,0,5,0,5
2015,India,IND,Romania,ROU,0,0,5,0,5
2015,Iran (Islamic Rep. of),IRN,Romania,ROU,5,0,30,0,35
2015,Iraq,IRQ,Romania,ROU,39,22,141,11,213
2015,Lebanon,LBN,Romania,ROU,0,0,0,5,5
2015,Sri Lanka,LKA,Romania,ROU,0,0,13,0,13
2015,Rep. of Moldova,MDA,Romania,ROU,0,0,12,5,17
2015,Morocco,MAR,Romania,ROU,0,0,5,0,5
2015,Nigeria,NGA,Romania,ROU,0,0,12,5,17
2015,Pakistan,PAK,Romania,ROU,0,0,32,5,37
2015,Philippines,PHL,Romania,ROU,0,0,23,10,33
2015,Serbia and Kosovo: S/RES/1244 (1999),SRB,Romania,ROU,0,0,5,5,10
2015,Somalia,SOM,Romania,ROU,5,0,0,0,5
2015,Viet Nam,VNM,Romania,ROU,0,0,10,0,10
2015,Sudan,SDN,Romania,ROU,0,0,5,0,5
2015,Syrian Arab Rep.,SYR,Romania,ROU,144,195,229,10,578
2015,Tunisia,TUN,Romania,ROU,0,0,5,5,10
2015,Turkey,TUR,Romania,ROU,0,0,39,10,49
2015,Ukraine,UKR,Romania,ROU,17,5,16,5,43
2015,Yemen,YEM,Romania,ROU,0,0,5,0,5
2015,Stateless,XXA,Romania,ROU,5,5,5,0,15
2015,Algeria,DZA,South Africa,ZAF,0,0,82,0,82
2015,Egypt,EGY,South Africa,ZAF,0,0,168,0,168
2015,Burundi,BDI,South Africa,ZAF,5,0,963,0,968
2015,Benin,BEN,South Africa,ZAF,0,0,46,0,46
2015,Bangladesh,BGD,South Africa,ZAF,0,0,4084,0,4084
2015,Burkina Faso,BFA,South Africa,ZAF,0,0,42,0,42
2015,Botswana,BWA,South Africa,ZAF,0,0,10,0,10
2015,Bulgaria,BGR,South Africa,ZAF,0,0,5,0,5
2015,Chad,TCD,South Africa,ZAF,0,0,13,0,13
2015,China,CHN,South Africa,ZAF,0,0,677,0,677
2015,Cameroon,CMR,South Africa,ZAF,0,0,530,0,530
2015,Congo,COG,South Africa,ZAF,191,0,424,0,615
2015,Dem. Rep. of the Congo,COD,South Africa,ZAF,614,0,4417,0,5031
2015,Comoros,COM,South Africa,ZAF,0,0,5,0,5
2015,Eritrea,ERI,South Africa,ZAF,44,0,268,0,312
2015,Ethiopia,ETH,South Africa,ZAF,1001,0,8306,0,9307
2015,Gabon,GAB,South Africa,ZAF,0,0,11,0,11
2015,Gambia,GMB,South Africa,ZAF,0,0,10,0,10
2015,Palestinian,PSE,South Africa,ZAF,0,0,13,0,13
2015,Ghana,GHA,South Africa,ZAF,0,0,1810,0,1810
2015,Guinea-Bissau,GNB,South Africa,ZAF,0,0,5,0,5
2015,Guinea,GIN,South Africa,ZAF,0,0,21,0,21
2015,Cote d'Ivoire,CIV,South Africa,ZAF,0,0,54,0,54
2015,India,IND,South Africa,ZAF,0,0,2165,0,2165
2015,Jamaica,JAM,South Africa,ZAF,0,0,5,0,5
2015,Jordan,JOR,South Africa,ZAF,0,0,5,0,5
2015,Kenya,KEN,South Africa,ZAF,0,0,232,0,232
2015,Liberia,LBR,South Africa,ZAF,0,0,5,0,5
2015,Lesotho,LSO,South Africa,ZAF,0,0,478,0,478
2015,Sri Lanka,LKA,South Africa,ZAF,0,0,12,0,12
2015,Mali,MLI,South Africa,ZAF,0,0,21,0,21
2015,Malawi,MWI,South Africa,ZAF,0,0,2378,0,2378
2015,Morocco,MAR,South Africa,ZAF,0,0,10,0,10
2015,Mozambique,MOZ,South Africa,ZAF,0,0,931,0,931
2015,Mauritius,MUS,South Africa,ZAF,0,0,5,0,5
2015,Nepal,NPL,South Africa,ZAF,0,0,53,0,53
2015,Niger,NER,South Africa,ZAF,0,0,51,0,51
2015,Nigeria,NGA,South Africa,ZAF,0,0,6592,0,6592
2015,Pakistan,PAK,South Africa,ZAF,0,0,2768,0,2768
2015,Rwanda,RWA,South Africa,ZAF,5,0,109,0,114
2015,Senegal,SEN,South Africa,ZAF,0,0,252,0,252
2015,Sierra Leone,SLE,South Africa,ZAF,0,0,5,0,5
2015,Somalia,SOM,South Africa,ZAF,618,0,1112,0,1730
2015,Sudan,SDN,South Africa,ZAF,0,0,18,0,18
2015,Eswatini,SWZ,South Africa,ZAF,0,0,28,0,28
2015,Syrian Arab Rep.,SYR,South Africa,ZAF,5,0,5,0,10
2015,United Rep. of Tanzania,TZA,South Africa,ZAF,0,0,527,0,527
2015,Thailand,THA,South Africa,ZAF,0,0,29,0,29
2015,Togo,TGO,South Africa,ZAF,0,0,14,0,14
2015,Uganda,UGA,South Africa,ZAF,5,0,998,0,1003
2015,Ukraine,UKR,South Africa,ZAF,0,0,5,0,5
2015,Zambia,ZMB,South Africa,ZAF,0,0,133,0,133
2015,Zimbabwe,ZWE,South Africa,ZAF,5,0,17203,0,17208
2015,Afghanistan,AFG,Russian Federation,RUS,15,0,313,0,328
2015,Egypt,EGY,Russian Federation,RUS,0,0,13,0,13
2015,Armenia,ARM,Russian Federation,RUS,0,0,5,0,5
2015,Azerbaijan,AZE,Russian Federation,RUS,0,0,5,0,5
2015,Belarus,BLR,Russian Federation,RUS,0,0,11,0,11
2015,Dem. Rep. of the Congo,COD,Russian Federation,RUS,0,0,5,0,5
2015,Estonia,EST,Russian Federation,RUS,0,0,5,0,5
2015,Palestinian,PSE,Russian Federation,RUS,0,0,10,0,10
2015,Georgia,GEO,Russian Federation,RUS,0,0,66,0,66
2015,Cote d'Ivoire,CIV,Russian Federation,RUS,0,0,5,0,5
2015,Iran (Islamic Rep. of),IRN,Russian Federation,RUS,0,0,5,0,5
2015,Iraq,IRQ,Russian Federation,RUS,0,0,14,0,14
2015,Kazakhstan,KAZ,Russian Federation,RUS,0,0,5,0,5
2015,Kyrgyzstan,KGZ,Russian Federation,RUS,0,0,21,0,21
2015,Dem. People's Rep. of Korea,PRK,Russian Federation,RUS,0,0,19,0,19
2015,Lebanon,LBN,Russian Federation,RUS,0,0,5,0,5
2015,Lithuania,LTU,Russian Federation,RUS,0,0,5,0,5
2015,Rep. of Moldova,MDA,Russian Federation,RUS,5,0,11,0,16
2015,Nigeria,NGA,Russian Federation,RUS,0,0,5,0,5
2015,Pakistan,PAK,Russian Federation,RUS,0,0,5,0,5
2015,Sudan,SDN,Russian Federation,RUS,0,0,5,0,5
2015,Syrian Arab Rep.,SYR,Russian Federation,RUS,0,0,391,0,391
2015,Tajikistan,TJK,Russian Federation,RUS,0,0,26,0,26
2015,Turkmenistan,TKM,Russian Federation,RUS,0,0,5,0,5
2015,Ukraine,UKR,Russian Federation,RUS,84,0,1790,0,1874
2015,United States of America,USA,Russian Federation,RUS,0,0,5,0,5
2015,Uzbekistan,UZB,Russian Federation,RUS,0,0,37,0,37
2015,Yemen,YEM,Russian Federation,RUS,0,0,14,0,14
2015,Stateless,XXA,Russian Federation,RUS,0,0,5,0,5
2015,Unknown ,,Russian Federation,RUS,0,0,5,0,5
2015,Burundi,BDI,Rwanda,RWA,5,0,0,0,5
2015,Dem. Rep. of the Congo,COD,Rwanda,RWA,44,0,0,0,44
2015,Honduras,HND,El Salvador,SLV,5,0,0,0,5
2015,Iraq,IRQ,El Salvador,SLV,5,0,0,0,5
2015,Syrian Arab Rep.,SYR,El Salvador,SLV,5,0,0,5,10
2015,Afghanistan,AFG,Serbia and Kosovo: S/RES/1244 (1999),SRB,0,0,0,63,63
2015,Algeria,DZA,Serbia and Kosovo: S/RES/1244 (1999),SRB,0,0,0,5,5
2015,Cameroon,CMR,Serbia and Kosovo: S/RES/1244 (1999),SRB,0,0,0,5,5
2015,Congo,COG,Serbia and Kosovo: S/RES/1244 (1999),SRB,0,0,0,5,5
2015,Eritrea,ERI,Serbia and Kosovo: S/RES/1244 (1999),SRB,0,0,0,74,74
2015,Palestinian,PSE,Serbia and Kosovo: S/RES/1244 (1999),SRB,0,0,0,20,20
2015,Ghana,GHA,Serbia and Kosovo: S/RES/1244 (1999),SRB,0,0,0,10,10
2015,Cote d'Ivoire,CIV,Serbia and Kosovo: S/RES/1244 (1999),SRB,0,0,0,5,5
2015,Iran (Islamic Rep. of),IRN,Serbia and Kosovo: S/RES/1244 (1999),SRB,0,0,0,5,5
2015,Iraq,IRQ,Serbia and Kosovo: S/RES/1244 (1999),SRB,5,0,0,12,17
2015,Libya,LBY,Serbia and Kosovo: S/RES/1244 (1999),SRB,0,10,0,21,31
2015,North Macedonia,MKD,Serbia and Kosovo: S/RES/1244 (1999),SRB,0,0,0,5,5
2015,Mali,MLI,Serbia and Kosovo: S/RES/1244 (1999),SRB,0,0,0,10,10
2015,Nigeria,NGA,Serbia and Kosovo: S/RES/1244 (1999),SRB,0,0,0,5,5
2015,Russian Federation,RUS,Serbia and Kosovo: S/RES/1244 (1999),SRB,0,0,0,10,10
2015,Senegal,SEN,Serbia and Kosovo: S/RES/1244 (1999),SRB,0,0,0,5,5
2015,Somalia,SOM,Serbia and Kosovo: S/RES/1244 (1999),SRB,0,0,0,127,127
2015,Sudan,SDN,Serbia and Kosovo: S/RES/1244 (1999),SRB,0,0,0,51,51
2015,Syrian Arab Rep.,SYR,Serbia and Kosovo: S/RES/1244 (1999),SRB,5,0,0,475,480
2015,Uganda,UGA,Serbia and Kosovo: S/RES/1244 (1999),SRB,0,0,0,5,5
2015,Ukraine,UKR,Serbia and Kosovo: S/RES/1244 (1999),SRB,5,5,0,5,15
2015,Yemen,YEM,Serbia and Kosovo: S/RES/1244 (1999),SRB,0,0,0,16,16
2015,Afghanistan,AFG,Spain,ESP,33,17,5,0,55
2015,Albania,ALB,Spain,ESP,0,0,10,0,10
2015,Algeria,DZA,Spain,ESP,0,0,169,0,169
2015,Angola,AGO,Spain,ESP,0,0,5,0,5
2015,Egypt,EGY,Spain,ESP,0,0,33,0,33
2015,Armenia,ARM,Spain,ESP,0,0,10,0,10
2015,Benin,BEN,Spain,ESP,0,0,5,0,5
2015,Bangladesh,BGD,Spain,ESP,0,0,5,0,5
2015,Burkina Faso,BFA,Spain,ESP,0,0,5,0,5
2015,Belarus,BLR,Spain,ESP,0,0,5,0,5
2015,Bolivia (Plurinational State of),BOL,Spain,ESP,0,0,5,0,5
2015,Chad,TCD,Spain,ESP,0,0,5,0,5
2015,China,CHN,Spain,ESP,0,0,5,0,5
2015,Cameroon,CMR,Spain,ESP,0,0,48,0,48
2015,Dem. Rep. of the Congo,COD,Spain,ESP,0,0,27,0,27
2015,Colombia,COL,Spain,ESP,0,0,28,0,28
2015,Cuba,CUB,Spain,ESP,0,5,22,0,27
2015,Eritrea,ERI,Spain,ESP,5,0,0,0,5
2015,Gambia,GMB,Spain,ESP,0,0,12,0,12
2015,Palestinian,PSE,Spain,ESP,30,15,5,0,50
2015,Georgia,GEO,Spain,ESP,0,0,10,0,10
2015,Ghana,GHA,Spain,ESP,0,0,5,0,5
2015,Guinea-Bissau,GNB,Spain,ESP,0,0,11,0,11
2015,Guinea,GIN,Spain,ESP,0,0,31,0,31
2015,Honduras,HND,Spain,ESP,5,0,18,0,23
2015,Cote d'Ivoire,CIV,Spain,ESP,5,12,67,0,84
2015,Iran (Islamic Rep. of),IRN,Spain,ESP,5,0,12,0,17
2015,Iraq,IRQ,Spain,ESP,5,0,0,0,5
2015,Kazakhstan,KAZ,Spain,ESP,0,0,5,0,5
2015,Liberia,LBR,Spain,ESP,0,0,5,0,5
2015,Sri Lanka,LKA,Spain,ESP,5,0,24,0,29
2015,Mexico,MEX,Spain,ESP,0,0,5,0,5
2015,Mali,MLI,Spain,ESP,0,0,207,0,207
2015,Morocco,MAR,Spain,ESP,15,0,47,0,62
2015,Nigeria,NGA,Spain,ESP,0,0,42,0,42
2015,Pakistan,PAK,Spain,ESP,56,5,38,0,99
2015,Peru,PER,Spain,ESP,0,0,5,0,5
2015,Russian Federation,RUS,Spain,ESP,11,0,22,0,33
2015,El Salvador,SLV,Spain,ESP,0,0,16,0,16
2015,Serbia and Kosovo: S/RES/1244 (1999),SRB,Spain,ESP,0,0,5,0,5
2015,Senegal,SEN,Spain,ESP,0,0,16,0,16
2015,Singapore,SGP,Spain,ESP,0,0,5,0,5
2015,Somalia,SOM,Spain,ESP,10,102,54,0,166
2015,Sudan,SDN,Spain,ESP,5,0,5,0,10
2015,Syrian Arab Rep.,SYR,Spain,ESP,17,639,5,0,661
2015,Ukraine,UKR,Spain,ESP,0,0,5,0,5
2015,Western Sahara,ESH,Spain,ESP,5,0,23,0,28
2015,Eritrea,ERI,Sudan,SDN,4164,10,19,36,4229
2015,Ethiopia,ETH,Sudan,SDN,73,10,40,20,143
2015,Somalia,SOM,Sudan,SDN,13,0,0,0,13
2015,Syrian Arab Rep.,SYR,Sudan,SDN,0,5,0,0,5
2015,Afghanistan,AFG,Slovakia,SVK,0,5,10,52,67
2015,Cuba,CUB,Slovakia,SVK,5,0,0,0,5
2015,India,IND,Slovakia,SVK,0,0,5,5,10
2015,Iraq,IRQ,Slovakia,SVK,0,10,0,10,20
2015,Rep. of Moldova,MDA,Slovakia,SVK,0,0,0,5,5
2015,Mongolia,MNG,Slovakia,SVK,0,0,5,0,5
2015,Russian Federation,RUS,Slovakia,SVK,0,0,5,5,10
2015,Somalia,SOM,Slovakia,SVK,0,5,0,0,5
2015,Viet Nam,VNM,Slovakia,SVK,0,0,0,5,5
2015,Sudan,SDN,Slovakia,SVK,0,5,0,0,5
2015,Syrian Arab Rep.,SYR,Slovakia,SVK,0,5,5,5,15
2015,Ukraine,UKR,Slovakia,SVK,0,12,10,21,43
2015,Unknown ,,Slovakia,SVK,0,0,20,5,25
2015,Afghanistan,AFG,Slovenia,SVN,0,0,24,20,44
2015,Albania,ALB,Slovenia,SVN,0,0,5,5,10
2015,Algeria,DZA,Slovenia,SVN,0,0,5,0,5
2015,Bosnia and Herzegovina,BIH,Slovenia,SVN,0,0,5,0,5
2015,Iran (Islamic Rep. of),IRN,Slovenia,SVN,19,0,0,5,24
2015,Iraq,IRQ,Slovenia,SVN,0,0,16,21,37
2015,Morocco,MAR,Slovenia,SVN,0,0,5,0,5
2015,Nigeria,NGA,Slovenia,SVN,0,0,0,5,5
2015,Pakistan,PAK,Slovenia,SVN,0,0,5,5,10
2015,Russian Federation,RUS,Slovenia,SVN,0,0,5,0,5
2015,Serbia and Kosovo: S/RES/1244 (1999),SRB,Slovenia,SVN,0,0,35,5,40
2015,Somalia,SOM,Slovenia,SVN,5,0,0,0,5
2015,Syrian Arab Rep.,SYR,Slovenia,SVN,0,10,0,5,15
2015,Ukraine,UKR,Slovenia,SVN,0,0,17,10,27
2015,Burundi,BDI,Eswatini,SWZ,15,0,0,12,27
2015,Dem. Rep. of the Congo,COD,Eswatini,SWZ,32,0,0,32,64
2015,Rwanda,RWA,Eswatini,SWZ,10,0,0,5,15
2015,Somalia,SOM,Eswatini,SWZ,22,0,0,0,22
2015,Afghanistan,AFG,Sweden,SWE,333,689,349,1567,2938
2015,Albania,ALB,Sweden,SWE,10,19,1651,901,2581
2015,Algeria,DZA,Sweden,SWE,0,0,30,262,292
2015,Angola,AGO,Sweden,SWE,0,0,0,5,5
2015,Egypt,EGY,Sweden,SWE,40,10,121,96,267
2015,Argentina,ARG,Sweden,SWE,0,0,0,5,5
2015,Armenia,ARM,Sweden,SWE,0,25,106,51,182
2015,Azerbaijan,AZE,Sweden,SWE,17,16,66,71,170
2015,Burundi,BDI,Sweden,SWE,5,0,0,10,15
2015,Benin,BEN,Sweden,SWE,0,0,0,5,5
2015,Bangladesh,BGD,Sweden,SWE,5,0,66,25,96
2015,Burkina Faso,BFA,Sweden,SWE,0,0,0,5,5
2015,Belarus,BLR,Sweden,SWE,5,0,33,113,151
2015,Bolivia (Plurinational State of),BOL,Sweden,SWE,0,0,10,0,10
2015,Bosnia and Herzegovina,BIH,Sweden,SWE,0,0,302,215,517
2015,Bulgaria,BGR,Sweden,SWE,0,0,5,0,5
2015,Canada,CAN,Sweden,SWE,0,0,5,0,5
2015,Chad,TCD,Sweden,SWE,5,0,0,10,15
2015,China,CHN,Sweden,SWE,5,0,10,13,28
2015,Chile,CHL,Sweden,SWE,0,0,11,5,16
2015,Cameroon,CMR,Sweden,SWE,5,0,10,17,32
2015,Congo,COG,Sweden,SWE,0,0,0,12,12
2015,Dem. Rep. of the Congo,COD,Sweden,SWE,5,0,13,18,36
2015,Colombia,COL,Sweden,SWE,0,0,10,10,20
2015,Cuba,CUB,Sweden,SWE,0,0,13,13,26
2015,Cabo Verde,CPV,Sweden,SWE,0,0,5,0,5
2015,Djibouti,DJI,Sweden,SWE,0,0,10,14,24
2015,Dominican Rep.,DOM,Sweden,SWE,0,0,0,5,5
2015,Ecuador,ECU,Sweden,SWE,0,0,5,0,5
2015,Eritrea,ERI,Sweden,SWE,6159,194,5,661,7019
2015,Ethiopia,ETH,Sweden,SWE,144,16,118,150,428
2015,France,FRA,Sweden,SWE,0,0,5,0,5
2015,Gambia,GMB,Sweden,SWE,5,5,26,61,97
2015,Palestinian,PSE,Sweden,SWE,121,175,129,41,466
2015,Georgia,GEO,Sweden,SWE,5,5,146,322,478
2015,Ghana,GHA,Sweden,SWE,0,0,5,27,32
2015,Guinea-Bissau,GNB,Sweden,SWE,0,0,0,5,5
2015,Greece,GRC,Sweden,SWE,0,5,5,0,10
2015,Guinea,GIN,Sweden,SWE,5,0,5,24,34
2015,Croatia,HRV,Sweden,SWE,0,0,5,0,5
2015,Hungary,HUN,Sweden,SWE,0,0,0,5,5
2015,Cote d'Ivoire,CIV,Sweden,SWE,0,0,5,12,17
2015,India,IND,Sweden,SWE,5,0,10,17,32
2015,Iran (Islamic Rep. of),IRN,Sweden,SWE,122,10,92,341,565
2015,Iraq,IRQ,Sweden,SWE,176,124,200,1746,2246
2015,Israel,ISR,Sweden,SWE,0,0,5,5,10
2015,Italy,ITA,Sweden,SWE,0,0,0,5,5
2015,Jordan,JOR,Sweden,SWE,15,14,51,65,145
2015,Kazakhstan,KAZ,Sweden,SWE,0,0,52,77,129
2015,Kenya,KEN,Sweden,SWE,0,0,5,14,19
2015,Kyrgyzstan,KGZ,Sweden,SWE,5,5,25,51,86
2015,Kuwait,KWT,Sweden,SWE,0,0,5,0,5
2015,Liberia,LBR,Sweden,SWE,0,0,5,5,10
2015,Libya,LBY,Sweden,SWE,11,5,30,254,300
2015,Lebanon,LBN,Sweden,SWE,19,10,116,185,330
2015,Sri Lanka,LKA,Sweden,SWE,0,0,5,10,15
2015,Lithuania,LTU,Sweden,SWE,0,0,5,0,5
2015,Madagascar,MDG,Sweden,SWE,0,0,5,0,5
2015,Mauritania,MRT,Sweden,SWE,0,0,0,10,10
2015,North Macedonia,MKD,Sweden,SWE,0,5,275,194,474
2015,Rep. of Moldova,MDA,Sweden,SWE,0,0,13,18,31
2015,Mexico,MEX,Sweden,SWE,0,0,5,5,10
2015,Mali,MLI,Sweden,SWE,0,0,5,16,21
2015,Mongolia,MNG,Sweden,SWE,0,14,294,84,392
2015,Morocco,MAR,Sweden,SWE,13,12,155,408,588
2015,Montenegro,MNE,Sweden,SWE,0,0,76,58,134
2015,Nepal,NPL,Sweden,SWE,0,0,5,0,5
2015,Nicaragua,NIC,Sweden,SWE,0,0,10,5,15
2015,Nigeria,NGA,Sweden,SWE,35,5,47,164,251
2015,Pakistan,PAK,Sweden,SWE,23,5,57,75,160
2015,Peru,PER,Sweden,SWE,0,0,5,0,5
2015,Philippines,PHL,Sweden,SWE,0,0,5,5,10
2015,Poland,POL,Sweden,SWE,0,0,5,5,10
2015,Romania,ROU,Sweden,SWE,0,0,34,10,44
2015,Russian Federation,RUS,Sweden,SWE,77,17,137,153,384
2015,Rwanda,RWA,Sweden,SWE,0,0,0,10,10
2015,El Salvador,SLV,Sweden,SWE,5,0,33,10,48
2015,Saudi Arabia,SAU,Sweden,SWE,13,0,0,0,13
2015,Serbia and Kosovo: S/RES/1244 (1999),SRB,Sweden,SWE,0,19,1808,1229,3056
2015,Senegal,SEN,Sweden,SWE,5,0,10,24,39
2015,Sierra Leone,SLE,Sweden,SWE,0,0,5,11,16
2015,Somalia,SOM,Sweden,SWE,682,192,299,942,2115
2015,Spain,ESP,Sweden,SWE,0,0,5,5,10
2015,Viet Nam,VNM,Sweden,SWE,0,0,5,5,10
2015,Sudan,SDN,Sweden,SWE,49,10,47,76,182
2015,Slovakia,SVK,Sweden,SWE,0,0,5,0,5
2015,Syrian Arab Rep.,SYR,Sweden,SWE,1903,16383,37,2046,20369
2015,United Rep. of Tanzania,TZA,Sweden,SWE,0,5,5,12,22
2015,Thailand,THA,Sweden,SWE,0,0,5,5,10
2015,Tajikistan,TJK,Sweden,SWE,5,0,5,15,25
2015,Togo,TGO,Sweden,SWE,0,0,0,5,5
2015,Tunisia,TUN,Sweden,SWE,0,5,31,143,179
2015,Turkey,TUR,Sweden,SWE,0,0,62,47,109
2015,Uganda,UGA,Sweden,SWE,55,0,25,36,116
2015,Ukraine,UKR,Sweden,SWE,0,24,438,389,851
2015,United States of America,USA,Sweden,SWE,0,5,13,11,29
2015,Uzbekistan,UZB,Sweden,SWE,19,5,34,66,124
2015,Venezuela (Bolivarian Republic of),VEN,Sweden,SWE,0,0,22,5,27
2015,Yemen,YEM,Sweden,SWE,28,22,21,70,141
2015,Zambia,ZMB,Sweden,SWE,0,0,0,5,5
2015,Stateless,XXA,Sweden,SWE,2063,997,148,597,3805
2015,Unknown ,,Sweden,SWE,10,41,129,108,288
2015,Afghanistan,AFG,Switzerland,CHE,177,622,1021,82,1902
2015,Albania,ALB,Switzerland,CHE,0,12,321,79,412
2015,Algeria,DZA,Switzerland,CHE,5,0,236,73,314
2015,Angola,AGO,Switzerland,CHE,0,39,22,0,61
2015,Egypt,EGY,Switzerland,CHE,18,0,59,41,118
2015,Armenia,ARM,Switzerland,CHE,0,22,58,5,85
2015,Azerbaijan,AZE,Switzerland,CHE,10,5,10,0,25
2015,Burundi,BDI,Switzerland,CHE,0,0,10,0,10
2015,Benin,BEN,Switzerland,CHE,0,0,20,10,30
2015,Bangladesh,BGD,Switzerland,CHE,0,5,49,5,59
2015,Burkina Faso,BFA,Switzerland,CHE,0,0,15,5,20
2015,Belarus,BLR,Switzerland,CHE,0,5,30,14,49
2015,Bosnia and Herzegovina,BIH,Switzerland,CHE,0,10,98,20,128
2015,Bulgaria,BGR,Switzerland,CHE,0,0,5,0,5
2015,Chad,TCD,Switzerland,CHE,0,0,32,5,37
2015,China,CHN,Switzerland,CHE,129,406,231,5,771
2015,Cameroon,CMR,Switzerland,CHE,5,18,54,5,82
2015,Congo,COG,Switzerland,CHE,0,0,5,0,5
2015,Dem. Rep. of the Congo,COD,Switzerland,CHE,25,81,116,10,232
2015,Colombia,COL,Switzerland,CHE,0,0,5,0,5
2015,Cuba,CUB,Switzerland,CHE,0,0,5,0,5
2015,Djibouti,DJI,Switzerland,CHE,5,0,5,0,10
2015,Equatorial Guinea,GNQ,Switzerland,CHE,0,0,5,5,10
2015,Eritrea,ERI,Switzerland,CHE,2633,2325,2094,79,7131
2015,Ethiopia,ETH,Switzerland,CHE,84,124,333,18,559
2015,Gabon,GAB,Switzerland,CHE,0,0,5,0,5
2015,Gambia,GMB,Switzerland,CHE,5,0,537,352,894
2015,Georgia,GEO,Switzerland,CHE,5,21,311,110,447
2015,Ghana,GHA,Switzerland,CHE,0,0,55,35,90
2015,Guinea-Bissau,GNB,Switzerland,CHE,0,10,66,55,131
2015,Guinea,GIN,Switzerland,CHE,12,16,214,56,298
2015,Haiti,HTI,Switzerland,CHE,0,0,5,0,5
2015,Croatia,HRV,Switzerland,CHE,0,0,5,0,5
2015,Hungary,HUN,Switzerland,CHE,0,0,0,5,5
2015,Cote d'Ivoire,CIV,Switzerland,CHE,21,11,71,16,119
2015,India,IND,Switzerland,CHE,0,0,10,5,15
2015,Iran (Islamic Rep. of),IRN,Switzerland,CHE,117,79,199,20,415
2015,Iraq,IRQ,Switzerland,CHE,62,137,377,112,688
2015,Israel,ISR,Switzerland,CHE,0,0,5,0,5
2015,Italy,ITA,Switzerland,CHE,0,0,10,5,15
2015,Jordan,JOR,Switzerland,CHE,10,5,5,5,25
2015,Kazakhstan,KAZ,Switzerland,CHE,0,0,10,0,10
2015,Kenya,KEN,Switzerland,CHE,0,0,10,0,10
2015,Kyrgyzstan,KGZ,Switzerland,CHE,0,0,5,0,5
2015,Rep. of Korea,KOR,Switzerland,CHE,0,0,5,0,5
2015,Liberia,LBR,Switzerland,CHE,0,0,31,5,36
2015,Libya,LBY,Switzerland,CHE,16,38,79,46,179
2015,Lebanon,LBN,Switzerland,CHE,5,5,22,5,37
2015,Sri Lanka,LKA,Switzerland,CHE,1008,233,488,47,1776
2015,Mauritania,MRT,Switzerland,CHE,0,0,17,10,27
2015,North Macedonia,MKD,Switzerland,CHE,0,5,108,35,148
2015,Rep. of Moldova,MDA,Switzerland,CHE,0,0,10,12,22
2015,Mali,MLI,Switzerland,CHE,0,5,121,42,168
2015,Mongolia,MNG,Switzerland,CHE,0,11,83,11,105
2015,Morocco,MAR,Switzerland,CHE,5,0,288,171,464
2015,Montenegro,MNE,Switzerland,CHE,0,0,15,0,15
2015,Mauritius,MUS,Switzerland,CHE,0,0,5,0,5
2015,Nepal,NPL,Switzerland,CHE,0,5,0,5,10
2015,Niger,NER,Switzerland,CHE,0,0,20,5,25
2015,Nicaragua,NIC,Switzerland,CHE,0,0,5,0,5
2015,Nigeria,NGA,Switzerland,CHE,0,25,782,158,965
2015,Pakistan,PAK,Switzerland,CHE,5,5,134,36,180
2015,Poland,POL,Switzerland,CHE,0,0,5,0,5
2015,Romania,ROU,Switzerland,CHE,0,0,5,17,22
2015,South Africa,ZAF,Switzerland,CHE,0,5,0,0,5
2015,Russian Federation,RUS,Switzerland,CHE,55,13,164,16,248
2015,Rwanda,RWA,Switzerland,CHE,5,0,10,0,15
2015,Serbia and Kosovo: S/RES/1244 (1999),SRB,Switzerland,CHE,13,105,668,154,940
2015,Senegal,SEN,Switzerland,CHE,0,5,226,170,401
2015,Sierra Leone,SLE,Switzerland,CHE,0,5,54,10,69
2015,Somalia,SOM,Switzerland,CHE,146,364,274,84,868
2015,Viet Nam,VNM,Switzerland,CHE,5,0,0,0,5
2015,Sudan,SDN,Switzerland,CHE,11,10,140,22,183
2015,South Sudan,SSD,Switzerland,CHE,0,5,17,0,22
2015,Slovakia,SVK,Switzerland,CHE,0,0,5,0,5
2015,Syrian Arab Rep.,SYR,Switzerland,CHE,1309,1972,421,122,3824
2015,United Rep. of Tanzania,TZA,Switzerland,CHE,0,0,10,0,10
2015,Tajikistan,TJK,Switzerland,CHE,0,0,5,0,5
2015,Togo,TGO,Switzerland,CHE,15,12,39,5,71
2015,Tunisia,TUN,Switzerland,CHE,5,5,234,146,390
2015,Turkey,TUR,Switzerland,CHE,213,59,210,31,513
2015,Uganda,UGA,Switzerland,CHE,5,0,37,0,42
2015,Ukraine,UKR,Switzerland,CHE,0,0,196,41,237
2015,United States of America,USA,Switzerland,CHE,0,0,0,5,5
2015,Uzbekistan,UZB,Switzerland,CHE,0,0,10,0,10
2015,Yemen,YEM,Switzerland,CHE,41,0,12,5,58
2015,Zimbabwe,ZWE,Switzerland,CHE,0,0,5,0,5
2015,Stateless,XXA,Switzerland,CHE,10,23,0,0,33
2015,Unknown ,,Switzerland,CHE,159,217,215,37,628
2015,Burundi,BDI,United Rep. of Tanzania,TZA,0,0,36,0,36
2015,Dem. Rep. of the Congo,COD,United Rep. of Tanzania,TZA,164,0,180,0,344
2015,Unknown ,,United Rep. of Tanzania,TZA,30,0,28,0,58
2015,Myanmar,MMR,Thailand,THA,152,0,15,0,167
2015,Central African Rep.,CAF,Togo,TGO,143,0,0,0,143
2015,Dem. Rep. of the Congo,COD,Togo,TGO,5,0,0,0,5
2015,Mali,MLI,Togo,TGO,46,0,0,0,46
2015,Rwanda,RWA,Togo,TGO,5,0,0,0,5
2015,Syrian Arab Rep.,SYR,Togo,TGO,5,0,0,0,5
2015,Afghanistan,AFG,Ukraine,UKR,18,18,141,117,294
2015,Algeria,DZA,Ukraine,UKR,0,0,0,5,5
2015,Angola,AGO,Ukraine,UKR,0,0,0,5,5
2015,Egypt,EGY,Ukraine,UKR,0,0,5,0,5
2015,Azerbaijan,AZE,Ukraine,UKR,0,0,5,0,5
2015,Bangladesh,BGD,Ukraine,UKR,0,0,11,5,16
2015,Belarus,BLR,Ukraine,UKR,0,0,5,5,10
2015,Cameroon,CMR,Ukraine,UKR,0,0,5,5,10
2015,Congo,COG,Ukraine,UKR,0,0,0,5,5
2015,Dem. Rep. of the Congo,COD,Ukraine,UKR,0,5,15,5,25
2015,Eritrea,ERI,Ukraine,UKR,0,0,5,5,10
2015,Ethiopia,ETH,Ukraine,UKR,0,0,0,5,5
2015,Gambia,GMB,Ukraine,UKR,0,0,5,0,5
2015,Georgia,GEO,Ukraine,UKR,0,0,5,10,15
2015,Guinea,GIN,Ukraine,UKR,0,0,11,11,22
2015,Cote d'Ivoire,CIV,Ukraine,UKR,0,0,5,0,5
2015,Iran (Islamic Rep. of),IRN,Ukraine,UKR,0,5,10,5,20
2015,Iraq,IRQ,Ukraine,UKR,0,10,32,5,47
2015,Kyrgyzstan,KGZ,Ukraine,UKR,0,0,10,5,15
2015,Lebanon,LBN,Ukraine,UKR,0,0,5,0,5
2015,Sri Lanka,LKA,Ukraine,UKR,0,0,5,17,22
2015,Mali,MLI,Ukraine,UKR,0,0,5,0,5
2015,Morocco,MAR,Ukraine,UKR,0,0,5,0,5
2015,Nigeria,NGA,Ukraine,UKR,0,0,10,5,15
2015,Pakistan,PAK,Ukraine,UKR,5,0,5,0,10
2015,Russian Federation,RUS,Ukraine,UKR,5,5,42,20,72
2015,Sierra Leone,SLE,Ukraine,UKR,0,0,5,0,5
2015,Somalia,SOM,Ukraine,UKR,0,0,52,31,83
2015,Sudan,SDN,Ukraine,UKR,0,0,15,5,20
2015,Syrian Arab Rep.,SYR,Ukraine,UKR,5,58,134,10,207
2015,Tajikistan,TJK,Ukraine,UKR,0,5,0,5,10
2015,Tunisia,TUN,Ukraine,UKR,0,0,5,0,5
2015,Uzbekistan,UZB,Ukraine,UKR,5,0,11,10,26
2015,Stateless,XXA,Ukraine,UKR,0,10,27,5,42
2015,Colombia,COL,Uruguay,URY,11,0,0,5,16
2015,Mexico,MEX,Uruguay,URY,5,0,0,0,5
2015,El Salvador,SLV,Uruguay,URY,0,0,0,5,5
2015,Sierra Leone,SLE,Uruguay,URY,0,0,10,0,10
2015,Syrian Arab Rep.,SYR,Uruguay,URY,10,0,0,0,10
2015,Colombia,COL,Venezuela (Bolivarian Republic of),VEN,1211,0,469,0,1680
2015,Egypt,EGY,Zambia,ZMB,0,0,0,5,5
2015,Burundi,BDI,Zambia,ZMB,490,0,0,0,490
2015,Dem. Rep. of the Congo,COD,Zambia,ZMB,1458,0,617,0,2075
2015,Ethiopia,ETH,Zambia,ZMB,0,0,5,0,5
2015,Rwanda,RWA,Zambia,ZMB,0,0,5,0,5
2015,Somalia,SOM,Zambia,ZMB,89,0,5,34,128
2015,Syrian Arab Rep.,SYR,Zambia,ZMB,5,0,0,0,5
2015,United Rep. of Tanzania,TZA,Zambia,ZMB,0,0,0,10,10
2015,Uganda,UGA,Zambia,ZMB,0,0,0,5,5
2015,Egypt,EGY,Zimbabwe,ZWE,0,0,5,0,5
2015,Burundi,BDI,Zimbabwe,ZWE,0,23,10,16,49
2015,Dem. Rep. of the Congo,COD,Zimbabwe,ZWE,41,479,98,276,894
2015,Ethiopia,ETH,Zimbabwe,ZWE,0,0,0,5,5
2015,Cote d'Ivoire,CIV,Zimbabwe,ZWE,0,0,0,5,5
2015,Mali,MLI,Zimbabwe,ZWE,0,5,0,5,10
2015,Rwanda,RWA,Zimbabwe,ZWE,0,20,5,10,35
2015,Somalia,SOM,Zimbabwe,ZWE,5,0,0,0,5
2016,Afghanistan,AFG,Albania,ALB,0,0,0,64,64
2016,Dem. Rep. of the Congo,COD,Albania,ALB,0,0,0,5,5
2016,Iran (Islamic Rep. of),IRN,Albania,ALB,10,0,0,0,10
2016,Iraq,IRQ,Albania,ALB,0,19,0,10,29
2016,Pakistan,PAK,Albania,ALB,0,0,0,5,5
2016,Serbia and Kosovo: S/RES/1244 (1999),SRB,Albania,ALB,0,0,10,0,10
2016,Syrian Arab Rep.,SYR,Albania,ALB,0,0,0,127,127
2016,Tunisia,TUN,Albania,ALB,0,0,5,0,5
2016,Angola,AGO,Argentina,ARG,0,0,5,0,5
2016,Brazil,BRA,Argentina,ARG,0,0,0,5,5
2016,China,CHN,Argentina,ARG,0,0,12,5,17
2016,Chile,CHL,Argentina,ARG,0,0,0,5,5
2016,Cameroon,CMR,Argentina,ARG,0,0,5,0,5
2016,Colombia,COL,Argentina,ARG,0,0,10,18,28
2016,Cuba,CUB,Argentina,ARG,5,0,63,29,97
2016,Dominican Rep.,DOM,Argentina,ARG,0,0,21,10,31
2016,Ghana,GHA,Argentina,ARG,0,0,31,0,31
2016,Guinea,GIN,Argentina,ARG,0,0,5,0,5
2016,Haiti,HTI,Argentina,ARG,0,0,98,12,110
2016,India,IND,Argentina,ARG,0,0,10,5,15
2016,Iraq,IRQ,Argentina,ARG,5,0,0,0,5
2016,Mexico,MEX,Argentina,ARG,0,0,0,5,5
2016,Nigeria,NGA,Argentina,ARG,5,0,5,5,15
2016,Pakistan,PAK,Argentina,ARG,5,0,0,0,5
2016,Russian Federation,RUS,Argentina,ARG,5,0,10,0,15
2016,El Salvador,SLV,Argentina,ARG,5,0,0,0,5
2016,Senegal,SEN,Argentina,ARG,0,0,526,0,526
2016,Syrian Arab Rep.,SYR,Argentina,ARG,93,0,5,14,112
2016,Ukraine,UKR,Argentina,ARG,39,0,5,10,54
2016,Iran (Islamic Rep. of),IRN,Armenia,ARM,0,0,13,5,18
2016,Iraq,IRQ,Armenia,ARM,0,0,17,5,22
2016,Syrian Arab Rep.,SYR,Armenia,ARM,30,0,5,17,52
2016,Ukraine,UKR,Armenia,ARM,5,0,5,0,10
2016,Afghanistan,AFG,Australia,AUS,1415,0,76,0,1491
2016,Albania,ALB,Australia,AUS,0,0,15,0,15
2016,Algeria,DZA,Australia,AUS,0,0,5,0,5
2016,Egypt,EGY,Australia,AUS,55,0,84,0,139
2016,Azerbaijan,AZE,Australia,AUS,5,0,5,0,10
2016,Bahrain,BHR,Australia,AUS,10,0,5,0,15
2016,Burundi,BDI,Australia,AUS,23,0,0,0,23
2016,Bangladesh,BGD,Australia,AUS,45,0,256,0,301
2016,Bhutan,BTN,Australia,AUS,0,0,5,0,5
2016,Belarus,BLR,Australia,AUS,5,0,0,0,5
2016,Brazil,BRA,Australia,AUS,0,0,20,0,20
2016,Cambodia,KHM,Australia,AUS,10,0,12,0,22
2016,Chad,TCD,Australia,AUS,0,0,5,0,5
2016,China,CHN,Australia,AUS,112,0,635,0,747
2016,Cameroon,CMR,Australia,AUS,0,0,5,0,5
2016,Congo,COG,Australia,AUS,5,0,0,0,5
2016,Dem. Rep. of the Congo,COD,Australia,AUS,12,0,5,0,17
2016,Colombia,COL,Australia,AUS,0,0,18,0,18
2016,Cuba,CUB,Australia,AUS,0,0,5,0,5
2016,Cyprus,CYP,Australia,AUS,0,0,5,0,5
2016,Czechia,CZE,Australia,AUS,0,0,5,0,5
2016,Denmark,DNK,Australia,AUS,0,0,5,0,5
2016,Ecuador,ECU,Australia,AUS,0,0,5,0,5
2016,Eritrea,ERI,Australia,AUS,21,0,0,0,21
2016,Estonia,EST,Australia,AUS,0,0,5,0,5
2016,Ethiopia,ETH,Australia,AUS,41,0,15,0,56
2016,Fiji,FJI,Australia,AUS,30,0,237,0,267
2016,France,FRA,Australia,AUS,0,0,5,0,5
2016,Gambia,GMB,Australia,AUS,5,0,0,0,5
2016,Palestinian,PSE,Australia,AUS,62,0,5,0,67
2016,United Kingdom of Great Britain and Northern Ireland,GBR,Australia,AUS,0,0,23,0,23
2016,Georgia,GEO,Australia,AUS,0,0,10,0,10
2016,Germany,DEU,Australia,AUS,0,0,5,0,5
2016,Ghana,GHA,Australia,AUS,5,0,15,0,20
2016,Greece,GRC,Australia,AUS,5,0,5,0,10
2016,Guinea,GIN,Australia,AUS,5,0,5,0,10
2016,"China, Hong Kong SAR",HKG,Australia,AUS,5,0,30,0,35
2016,Honduras,HND,Australia,AUS,5,0,0,0,5
2016,Croatia,HRV,Australia,AUS,0,0,5,0,5
2016,India,IND,Australia,AUS,54,0,422,0,476
2016,Indonesia,IDN,Australia,AUS,26,0,101,0,127
2016,Ireland,IRL,Australia,AUS,0,0,17,0,17
2016,Iran (Islamic Rep. of),IRN,Australia,AUS,886,0,187,0,1073
2016,Iraq,IRQ,Australia,AUS,631,0,91,0,722
2016,Israel,ISR,Australia,AUS,0,0,12,0,12
2016,Italy,ITA,Australia,AUS,0,0,5,0,5
2016,Jamaica,JAM,Australia,AUS,5,0,0,0,5
2016,Jordan,JOR,Australia,AUS,21,0,35,0,56
2016,Japan,JPN,Australia,AUS,5,0,5,0,10
2016,Kenya,KEN,Australia,AUS,22,0,27,0,49
2016,Kyrgyzstan,KGZ,Australia,AUS,5,0,10,0,15
2016,Kiribati,KIR,Australia,AUS,0,0,5,0,5
2016,Rep. of Korea,KOR,Australia,AUS,5,0,41,0,46
2016,Kuwait,KWT,Australia,AUS,10,0,5,0,15
2016,Liberia,LBR,Australia,AUS,10,0,0,0,10
2016,Libya,LBY,Australia,AUS,246,0,12,0,258
2016,Lebanon,LBN,Australia,AUS,42,0,108,0,150
2016,Sri Lanka,LKA,Australia,AUS,804,0,616,0,1420
2016,Latvia,LVA,Australia,AUS,0,0,5,0,5
2016,"China, Macao SAR",MAC,Australia,AUS,0,0,5,0,5
2016,North Macedonia,MKD,Australia,AUS,0,0,5,0,5
2016,Rep. of Moldova,MDA,Australia,AUS,0,0,5,0,5
2016,Mexico,MEX,Australia,AUS,5,0,0,0,5
2016,Malaysia,MYS,Australia,AUS,32,0,2244,0,2276
2016,Mongolia,MNG,Australia,AUS,0,0,33,0,33
2016,Malta,MLT,Australia,AUS,0,0,5,0,5
2016,Mauritius,MUS,Australia,AUS,0,0,10,0,10
2016,Myanmar,MMR,Australia,AUS,32,0,19,0,51
2016,Nepal,NPL,Australia,AUS,17,0,156,0,173
2016,Nicaragua,NIC,Australia,AUS,0,0,5,0,5
2016,Nigeria,NGA,Australia,AUS,41,0,39,0,80
2016,Norway,NOR,Australia,AUS,0,0,5,0,5
2016,New Zealand,NZL,Australia,AUS,10,0,15,0,25
2016,Pakistan,PAK,Australia,AUS,481,0,308,0,789
2016,Peru,PER,Australia,AUS,0,0,14,0,14
2016,Philippines,PHL,Australia,AUS,10,0,38,0,48
2016,Papua New Guinea,PNG,Australia,AUS,52,0,39,0,91
2016,Poland,POL,Australia,AUS,0,0,5,0,5
2016,South Africa,ZAF,Australia,AUS,5,0,15,0,20
2016,Russian Federation,RUS,Australia,AUS,10,0,20,0,30
2016,Rwanda,RWA,Australia,AUS,22,0,5,0,27
2016,El Salvador,SLV,Australia,AUS,5,0,5,0,10
2016,Saudi Arabia,SAU,Australia,AUS,12,0,11,0,23
2016,Serbia and Kosovo: S/RES/1244 (1999),SRB,Australia,AUS,0,0,5,0,5
2016,Singapore,SGP,Australia,AUS,5,0,12,0,17
2016,Sierra Leone,SLE,Australia,AUS,5,0,0,0,5
2016,Solomon Islands,SLB,Australia,AUS,10,0,10,0,20
2016,Somalia,SOM,Australia,AUS,20,0,5,0,25
2016,Viet Nam,VNM,Australia,AUS,26,0,131,0,157
2016,Sudan,SDN,Australia,AUS,28,0,5,0,33
2016,South Sudan,SSD,Australia,AUS,5,0,0,0,5
2016,Slovenia,SVN,Australia,AUS,0,0,5,0,5
2016,Syrian Arab Rep.,SYR,Australia,AUS,77,0,5,0,82
2016,United Rep. of Tanzania,TZA,Australia,AUS,5,0,10,0,15
2016,Thailand,THA,Australia,AUS,0,0,38,0,38
2016,Tonga,TON,Australia,AUS,5,0,43,0,48
2016,Tunisia,TUN,Australia,AUS,0,0,5,0,5
2016,Turkey,TUR,Australia,AUS,33,0,24,0,57
2016,Uganda,UGA,Australia,AUS,14,0,5,0,19
2016,Ukraine,UKR,Australia,AUS,5,0,15,0,20
2016,United States of America,USA,Australia,AUS,5,0,14,0,19
2016,Uzbekistan,UZB,Australia,AUS,10,0,5,0,15
2016,Saint Vincent and the Grenadines,VCT,Australia,AUS,0,0,5,0,5
2016,Venezuela (Bolivarian Republic of),VEN,Australia,AUS,5,0,5,0,10
2016,Samoa,WSM,Australia,AUS,0,0,10,0,10
2016,Yemen,YEM,Australia,AUS,5,0,0,0,5
2016,Zambia,ZMB,Australia,AUS,0,0,18,0,18
2016,Zimbabwe,ZWE,Australia,AUS,37,0,27,0,64
2016,Stateless,XXA,Australia,AUS,301,0,27,0,328
2016,Tibetan,TIB,Australia,AUS,5,0,0,0,5
2016,Unknown ,,Australia,AUS,5,0,0,0,5
2016,Afghanistan,AFG,Azerbaijan,AZE,5,0,95,12,112
2016,Georgia,GEO,Azerbaijan,AZE,0,0,5,0,5
2016,Iran (Islamic Rep. of),IRN,Azerbaijan,AZE,0,0,5,0,5
2016,Iraq,IRQ,Azerbaijan,AZE,0,0,10,10,20
2016,Pakistan,PAK,Azerbaijan,AZE,0,0,22,5,27
2016,Russian Federation,RUS,Azerbaijan,AZE,0,0,5,0,5
2016,Angola,AGO,Burundi,BDI,0,0,0,5,5
2016,Central African Rep.,CAF,Burundi,BDI,0,0,0,5,5
2016,Dem. Rep. of the Congo,COD,Burundi,BDI,4943,0,0,775,5718
2016,Mali,MLI,Burundi,BDI,0,0,0,5,5
2016,Rwanda,RWA,Burundi,BDI,51,0,0,194,245
2016,Somalia,SOM,Burundi,BDI,5,0,0,0,5
2016,Uganda,UGA,Burundi,BDI,5,0,0,0,5
2016,Afghanistan,AFG,Belgium,BEL,656,830,583,88,2157
2016,Albania,ALB,Belgium,BEL,67,0,492,95,654
2016,Algeria,DZA,Belgium,BEL,5,0,35,5,45
2016,Angola,AGO,Belgium,BEL,0,0,31,0,31
2016,Egypt,EGY,Belgium,BEL,5,0,21,5,31
2016,Armenia,ARM,Belgium,BEL,21,0,116,11,148
2016,Azerbaijan,AZE,Belgium,BEL,15,0,13,0,28
2016,Burundi,BDI,Belgium,BEL,166,0,38,5,209
2016,Benin,BEN,Belgium,BEL,5,0,25,0,30
2016,Bangladesh,BGD,Belgium,BEL,5,0,33,0,38
2016,Burkina Faso,BFA,Belgium,BEL,13,0,19,0,32
2016,Belarus,BLR,Belgium,BEL,5,0,5,0,10
2016,Bosnia and Herzegovina,BIH,Belgium,BEL,5,0,11,10,26
2016,Bulgaria,BGR,Belgium,BEL,0,0,0,5,5
2016,Central African Rep.,CAF,Belgium,BEL,14,5,10,0,29
2016,China,CHN,Belgium,BEL,124,0,36,0,160
2016,Cameroon,CMR,Belgium,BEL,52,0,128,10,190
2016,Congo,COG,Belgium,BEL,0,0,10,0,10
2016,Dem. Rep. of the Congo,COD,Belgium,BEL,87,0,403,14,504
2016,Colombia,COL,Belgium,BEL,0,0,5,0,5
2016,Cuba,CUB,Belgium,BEL,5,0,0,0,5
2016,Djibouti,DJI,Belgium,BEL,52,0,41,0,93
2016,Dominican Rep.,DOM,Belgium,BEL,0,0,10,0,10
2016,Eritrea,ERI,Belgium,BEL,275,0,34,5,314
2016,Ethiopia,ETH,Belgium,BEL,28,0,41,0,69
2016,Gambia,GMB,Belgium,BEL,5,0,22,0,27
2016,Palestinian,PSE,Belgium,BEL,23,0,10,0,33
2016,Georgia,GEO,Belgium,BEL,0,0,43,37,80
2016,Germany,DEU,Belgium,BEL,0,0,5,5,10
2016,Ghana,GHA,Belgium,BEL,0,0,19,0,19
2016,Greece,GRC,Belgium,BEL,0,0,0,5,5
2016,Guinea,GIN,Belgium,BEL,285,0,325,20,630
2016,Haiti,HTI,Belgium,BEL,0,0,10,0,10
2016,Hungary,HUN,Belgium,BEL,0,0,0,5,5
2016,Cote d'Ivoire,CIV,Belgium,BEL,18,0,52,5,75
2016,India,IND,Belgium,BEL,0,0,25,5,30
2016,Iran (Islamic Rep. of),IRN,Belgium,BEL,67,0,26,22,115
2016,Iraq,IRQ,Belgium,BEL,2745,556,2090,567,5958
2016,Jordan,JOR,Belgium,BEL,0,0,5,0,5
2016,Kazakhstan,KAZ,Belgium,BEL,0,0,5,0,5
2016,Kenya,KEN,Belgium,BEL,0,0,5,0,5
2016,Kyrgyzstan,KGZ,Belgium,BEL,5,0,5,0,10
2016,Kuwait,KWT,Belgium,BEL,0,0,0,5,5
2016,Liberia,LBR,Belgium,BEL,0,0,5,0,5
2016,Libya,LBY,Belgium,BEL,12,26,0,0,38
2016,Lebanon,LBN,Belgium,BEL,10,0,27,21,58
2016,Sri Lanka,LKA,Belgium,BEL,45,0,13,0,58
2016,Mauritania,MRT,Belgium,BEL,31,0,41,0,72
2016,North Macedonia,MKD,Belgium,BEL,16,0,24,58,98
2016,Rep. of Moldova,MDA,Belgium,BEL,0,0,10,0,10
2016,Mali,MLI,Belgium,BEL,5,0,14,0,19
2016,Mongolia,MNG,Belgium,BEL,0,0,5,0,5
2016,Morocco,MAR,Belgium,BEL,15,0,87,15,117
2016,Montenegro,MNE,Belgium,BEL,0,0,5,0,5
2016,Myanmar,MMR,Belgium,BEL,5,0,5,0,10
2016,Nepal,NPL,Belgium,BEL,0,0,10,0,10
2016,Niger,NER,Belgium,BEL,20,0,41,5,66
2016,Nigeria,NGA,Belgium,BEL,12,0,62,10,84
2016,Pakistan,PAK,Belgium,BEL,53,0,184,18,255
2016,Russian Federation,RUS,Belgium,BEL,196,5,246,23,470
2016,Rwanda,RWA,Belgium,BEL,78,0,98,10,186
2016,El Salvador,SLV,Belgium,BEL,5,5,0,0,10
2016,Serbia and Kosovo: S/RES/1244 (1999),SRB,Belgium,BEL,39,0,111,155,305
2016,Senegal,SEN,Belgium,BEL,60,0,97,5,162
2016,Sierra Leone,SLE,Belgium,BEL,0,0,11,0,11
2016,Somalia,SOM,Belgium,BEL,767,209,341,21,1338
2016,Sudan,SDN,Belgium,BEL,79,0,23,5,107
2016,Slovakia,SVK,Belgium,BEL,0,0,0,23,23
2016,Syrian Arab Rep.,SYR,Belgium,BEL,5429,1619,76,207,7331
2016,Togo,TGO,Belgium,BEL,17,0,90,5,112
2016,Tunisia,TUN,Belgium,BEL,10,0,39,0,49
2016,Turkey,TUR,Belgium,BEL,12,0,39,5,56
2016,Uganda,UGA,Belgium,BEL,0,0,5,0,5
2016,Ukraine,UKR,Belgium,BEL,56,5,109,11,181
2016,Uzbekistan,UZB,Belgium,BEL,12,0,10,0,22
2016,Venezuela (Bolivarian Republic of),VEN,Belgium,BEL,5,0,11,0,16
2016,Yemen,YEM,Belgium,BEL,0,12,0,0,12
2016,Zimbabwe,ZWE,Belgium,BEL,0,0,5,0,5
2016,Stateless,XXA,Belgium,BEL,5,0,5,5,15
2016,Unknown ,,Belgium,BEL,517,5,94,35,651
2016,Central African Rep.,CAF,Benin,BEN,258,0,5,5,268
2016,Cote d'Ivoire,CIV,Benin,BEN,11,0,0,0,11
2016,Mali,MLI,Benin,BEN,0,0,0,5,5
2016,Afghanistan,AFG,Belarus,BLR,0,0,10,10,20
2016,Azerbaijan,AZE,Belarus,BLR,0,0,0,5,5
2016,Georgia,GEO,Belarus,BLR,0,0,5,0,5
2016,Iran (Islamic Rep. of),IRN,Belarus,BLR,0,0,5,0,5
2016,Iraq,IRQ,Belarus,BLR,0,5,10,20,35
2016,Lebanon,LBN,Belarus,BLR,0,0,0,5,5
2016,Sri Lanka,LKA,Belarus,BLR,0,0,0,5,5
2016,Pakistan,PAK,Belarus,BLR,0,0,5,0,5
2016,Russian Federation,RUS,Belarus,BLR,0,0,5,5,10
2016,Syrian Arab Rep.,SYR,Belarus,BLR,0,10,5,5,20
2016,Tajikistan,TJK,Belarus,BLR,0,0,0,12,12
2016,Ukraine,UKR,Belarus,BLR,0,559,18,83,660
2016,Yemen,YEM,Belarus,BLR,0,20,0,5,25
2016,Colombia,COL,Bolivia (Plurinational State of),BOL,0,0,5,0,5
2016,Syrian Arab Rep.,SYR,Bolivia (Plurinational State of),BOL,5,0,0,0,5
2016,Burundi,BDI,Botswana,BWA,0,0,43,10,53
2016,Dem. Rep. of the Congo,COD,Botswana,BWA,5,0,137,29,171
2016,Somalia,SOM,Botswana,BWA,0,0,5,0,5
2016,Zimbabwe,ZWE,Botswana,BWA,0,0,10,0,10
2016,Afghanistan,AFG,Brazil,BRA,17,5,0,0,22
2016,Angola,AGO,Brazil,BRA,26,5,62,0,93
2016,Egypt,EGY,Brazil,BRA,5,0,10,0,15
2016,Benin,BEN,Brazil,BRA,0,0,13,0,13
2016,Bangladesh,BGD,Brazil,BRA,5,0,33,0,38
2016,Burkina Faso,BFA,Brazil,BRA,0,0,10,0,10
2016,China,CHN,Brazil,BRA,0,0,5,0,5
2016,Cameroon,CMR,Brazil,BRA,17,0,5,0,22
2016,Congo,COG,Brazil,BRA,5,0,0,0,5
2016,Dem. Rep. of the Congo,COD,Brazil,BRA,189,30,19,0,238
2016,Colombia,COL,Brazil,BRA,12,0,5,0,17
2016,Cuba,CUB,Brazil,BRA,5,0,38,0,43
2016,Cabo Verde,CPV,Brazil,BRA,0,0,15,0,15
2016,Dominican Rep.,DOM,Brazil,BRA,0,0,24,0,24
2016,Gambia,GMB,Brazil,BRA,0,0,21,0,21
2016,Palestinian,PSE,Brazil,BRA,56,10,0,0,66
2016,Ghana,GHA,Brazil,BRA,14,0,131,0,145
2016,Guinea-Bissau,GNB,Brazil,BRA,5,0,98,0,103
2016,Guinea,GIN,Brazil,BRA,19,10,5,0,34
2016,Cote d'Ivoire,CIV,Brazil,BRA,5,0,0,0,5
2016,India,IND,Brazil,BRA,0,0,12,0,12
2016,Iran (Islamic Rep. of),IRN,Brazil,BRA,5,0,0,0,5
2016,Iraq,IRQ,Brazil,BRA,18,0,0,0,18
2016,Jordan,JOR,Brazil,BRA,0,0,5,0,5
2016,Lebanon,LBN,Brazil,BRA,10,0,12,0,22
2016,Mali,MLI,Brazil,BRA,0,0,19,0,19
2016,Morocco,MAR,Brazil,BRA,5,0,0,0,5
2016,Mozambique,MOZ,Brazil,BRA,0,0,5,0,5
2016,Nigeria,NGA,Brazil,BRA,16,0,33,0,49
2016,Pakistan,PAK,Brazil,BRA,99,5,11,0,115
2016,Philippines,PHL,Brazil,BRA,0,0,16,0,16
2016,Portugal,PRT,Brazil,BRA,0,0,5,0,5
2016,South Africa,ZAF,Brazil,BRA,0,0,5,0,5
2016,Russian Federation,RUS,Brazil,BRA,5,0,0,0,5
2016,El Salvador,SLV,Brazil,BRA,5,0,0,0,5
2016,Senegal,SEN,Brazil,BRA,5,0,175,0,180
2016,Sierra Leone,SLE,Brazil,BRA,10,0,11,0,21
2016,Sao Tome and Principe,STP,Brazil,BRA,0,0,5,0,5
2016,Sudan,SDN,Brazil,BRA,5,0,0,0,5
2016,Syrian Arab Rep.,SYR,Brazil,BRA,322,14,0,0,336
2016,Togo,TGO,Brazil,BRA,12,0,16,0,28
2016,Tunisia,TUN,Brazil,BRA,0,0,5,0,5
2016,Turkey,TUR,Brazil,BRA,5,0,0,0,5
2016,Uganda,UGA,Brazil,BRA,5,0,0,0,5
2016,Ukraine,UKR,Brazil,BRA,5,0,0,0,5
2016,Venezuela (Bolivarian Republic of),VEN,Brazil,BRA,14,0,28,0,42
2016,Stateless,XXA,Brazil,BRA,5,0,0,0,5
2016,Armenia,ARM,Bosnia and Herzegovina,BIH,0,0,0,5,5
2016,Pakistan,PAK,Bosnia and Herzegovina,BIH,0,0,0,10,10
2016,Serbia and Kosovo: S/RES/1244 (1999),SRB,Bosnia and Herzegovina,BIH,0,0,0,5,5
2016,Sierra Leone,SLE,Bosnia and Herzegovina,BIH,0,0,0,5,5
2016,Syrian Arab Rep.,SYR,Bosnia and Herzegovina,BIH,0,5,0,5,10
2016,Afghanistan,AFG,Bulgaria,BGR,0,10,430,0,440
2016,Algeria,DZA,Bulgaria,BGR,0,0,5,0,5
2016,Egypt,EGY,Bulgaria,BGR,0,0,5,0,5
2016,Armenia,ARM,Bulgaria,BGR,0,0,13,0,13
2016,Bangladesh,BGD,Bulgaria,BGR,0,0,5,0,5
2016,China,CHN,Bulgaria,BGR,0,0,5,0,5
2016,Cameroon,CMR,Bulgaria,BGR,0,0,5,0,5
2016,Iran (Islamic Rep. of),IRN,Bulgaria,BGR,5,0,38,0,43
2016,Iraq,IRQ,Bulgaria,BGR,36,38,278,0,352
2016,Kyrgyzstan,KGZ,Bulgaria,BGR,0,0,5,0,5
2016,Lebanon,LBN,Bulgaria,BGR,0,5,5,0,10
2016,Sri Lanka,LKA,Bulgaria,BGR,0,0,5,0,5
2016,Mali,MLI,Bulgaria,BGR,0,0,5,0,5
2016,Morocco,MAR,Bulgaria,BGR,0,0,10,0,10
2016,Nigeria,NGA,Bulgaria,BGR,0,0,5,0,5
2016,Pakistan,PAK,Bulgaria,BGR,0,0,61,0,61
2016,Russian Federation,RUS,Bulgaria,BGR,0,0,17,0,17
2016,Somalia,SOM,Bulgaria,BGR,5,0,5,0,10
2016,Syrian Arab Rep.,SYR,Bulgaria,BGR,689,520,67,0,1276
2016,Tunisia,TUN,Bulgaria,BGR,0,0,5,0,5
2016,Turkey,TUR,Bulgaria,BGR,5,0,5,0,10
2016,Ukraine,UKR,Bulgaria,BGR,0,0,34,0,34
2016,Yemen,YEM,Bulgaria,BGR,10,0,0,0,10
2016,Stateless,XXA,Bulgaria,BGR,13,10,5,0,28
2016,Pakistan,PAK,Cambodia,KHM,5,0,0,0,5
2016,Viet Nam,VNM,Cambodia,KHM,0,0,34,18,52
2016,Afghanistan,AFG,Canada,CAN,469,0,84,22,575
2016,Albania,ALB,Canada,CAN,77,0,79,10,166
2016,Algeria,DZA,Canada,CAN,24,0,33,5,62
2016,Angola,AGO,Canada,CAN,14,0,10,0,24
2016,Antigua and Barbuda,ATG,Canada,CAN,10,0,15,0,25
2016,Egypt,EGY,Canada,CAN,185,0,29,5,219
2016,Argentina,ARG,Canada,CAN,0,0,5,0,5
2016,Armenia,ARM,Canada,CAN,5,0,0,0,5
2016,Azerbaijan,AZE,Canada,CAN,60,0,10,0,70
2016,Bahrain,BHR,Canada,CAN,10,0,0,0,10
2016,Barbados,BRB,Canada,CAN,26,0,5,0,31
2016,Burundi,BDI,Canada,CAN,380,0,22,5,407
2016,Belgium,BEL,Canada,CAN,0,0,5,5,10
2016,Benin,BEN,Canada,CAN,10,0,5,0,15
2016,Bangladesh,BGD,Canada,CAN,134,0,67,15,216
2016,Bahamas,BHS,Canada,CAN,45,0,38,5,88
2016,Burkina Faso,BFA,Canada,CAN,20,0,14,0,34
2016,Belarus,BLR,Canada,CAN,5,0,0,0,5
2016,Bolivia (Plurinational State of),BOL,Canada,CAN,5,0,0,0,5
2016,Botswana,BWA,Canada,CAN,5,0,0,0,5
2016,Brazil,BRA,Canada,CAN,5,0,10,5,20
2016,Bosnia and Herzegovina,BIH,Canada,CAN,0,0,5,0,5
2016,Bulgaria,BGR,Canada,CAN,5,0,0,0,5
2016,Cambodia,KHM,Canada,CAN,5,0,5,0,10
2016,Central African Rep.,CAF,Canada,CAN,10,0,0,0,10
2016,Chad,TCD,Canada,CAN,75,0,28,5,108
2016,China,CHN,Canada,CAN,360,0,615,110,1085
2016,Chile,CHL,Canada,CAN,5,0,31,0,36
2016,Cameroon,CMR,Canada,CAN,119,0,54,5,178
2016,Congo,COG,Canada,CAN,49,0,14,0,63
2016,Dem. Rep. of the Congo,COD,Canada,CAN,162,0,126,10,298
2016,Colombia,COL,Canada,CAN,352,0,190,27,569
2016,Costa Rica,CRI,Canada,CAN,0,0,11,0,11
2016,Cuba,CUB,Canada,CAN,29,0,24,5,58
2016,Czechia,CZE,Canada,CAN,38,0,21,26,85
2016,Djibouti,DJI,Canada,CAN,105,0,10,0,115
2016,Dominican Rep.,DOM,Canada,CAN,17,0,11,5,33
2016,Ecuador,ECU,Canada,CAN,5,0,5,0,10
2016,Eritrea,ERI,Canada,CAN,269,0,47,15,331
2016,Ethiopia,ETH,Canada,CAN,226,0,80,10,316
2016,France,FRA,Canada,CAN,0,0,5,0,5
2016,Gambia,GMB,Canada,CAN,12,0,5,0,17
2016,Palestinian,PSE,Canada,CAN,131,0,24,5,160
2016,Georgia,GEO,Canada,CAN,31,0,28,5,64
2016,Germany,DEU,Canada,CAN,0,0,5,0,5
2016,Ghana,GHA,Canada,CAN,38,0,36,5,79
2016,Greece,GRC,Canada,CAN,0,0,5,0,5
2016,Guatemala,GTM,Canada,CAN,21,0,37,5,63
2016,Guinea,GIN,Canada,CAN,26,0,21,0,47
2016,Guyana,GUY,Canada,CAN,5,0,19,5,29
2016,Haiti,HTI,Canada,CAN,207,0,194,10,411
2016,"China, Hong Kong SAR",HKG,Canada,CAN,0,0,5,0,5
2016,Honduras,HND,Canada,CAN,87,0,50,5,142
2016,Croatia,HRV,Canada,CAN,15,0,17,29,61
2016,Hungary,HUN,Canada,CAN,567,0,223,133,923
2016,Cote d'Ivoire,CIV,Canada,CAN,24,0,10,0,34
2016,India,IND,Canada,CAN,169,0,239,128,536
2016,Indonesia,IDN,Canada,CAN,10,0,5,5,20
2016,Ireland,IRL,Canada,CAN,0,0,10,0,10
2016,Iran (Islamic Rep. of),IRN,Canada,CAN,131,0,27,16,174
2016,Iraq,IRQ,Canada,CAN,577,0,133,30,740
2016,Israel,ISR,Canada,CAN,15,0,21,10,46
2016,Italy,ITA,Canada,CAN,0,0,31,0,31
2016,Jamaica,JAM,Canada,CAN,71,0,72,5,148
2016,Jordan,JOR,Canada,CAN,36,0,41,0,77
2016,Japan,JPN,Canada,CAN,0,0,5,0,5
2016,Kazakhstan,KAZ,Canada,CAN,13,0,0,5,18
2016,Kenya,KEN,Canada,CAN,20,0,16,0,36
2016,Kyrgyzstan,KGZ,Canada,CAN,14,0,5,0,19
2016,Rep. of Korea,KOR,Canada,CAN,10,0,0,0,10
2016,Dem. People's Rep. of Korea,PRK,Canada,CAN,0,0,0,5,5
2016,Kuwait,KWT,Canada,CAN,5,0,10,0,15
2016,Liberia,LBR,Canada,CAN,5,0,0,0,5
2016,Libya,LBY,Canada,CAN,252,0,40,5,297
2016,Saint Lucia,LCA,Canada,CAN,5,0,10,5,20
2016,Lebanon,LBN,Canada,CAN,142,0,101,14,257
2016,Sri Lanka,LKA,Canada,CAN,131,0,32,13,176
2016,Mauritania,MRT,Canada,CAN,26,0,13,0,39
2016,Rep. of Moldova,MDA,Canada,CAN,5,0,5,0,10
2016,Mexico,MEX,Canada,CAN,29,0,60,48,137
2016,Mali,MLI,Canada,CAN,33,0,53,5,91
2016,Malaysia,MYS,Canada,CAN,0,0,5,0,5
2016,Mongolia,MNG,Canada,CAN,19,0,14,0,33
2016,Morocco,MAR,Canada,CAN,17,0,10,0,27
2016,Mauritius,MUS,Canada,CAN,0,0,5,0,5
2016,Myanmar,MMR,Canada,CAN,5,0,0,0,5
2016,Namibia,NAM,Canada,CAN,0,0,0,5,5
2016,Nepal,NPL,Canada,CAN,80,0,37,5,122
2016,Nigeria,NGA,Canada,CAN,389,0,475,17,881
2016,Norway,NOR,Canada,CAN,0,0,5,5,10
2016,Pakistan,PAK,Canada,CAN,542,0,166,22,730
2016,Peru,PER,Canada,CAN,10,0,22,5,37
2016,Philippines,PHL,Canada,CAN,0,0,10,0,10
2016,Poland,POL,Canada,CAN,13,0,10,10,33
2016,Portugal,PRT,Canada,CAN,0,0,0,5,5
2016,Romania,ROU,Canada,CAN,0,0,0,14,14
2016,South Africa,ZAF,Canada,CAN,12,0,16,5,33
2016,Russian Federation,RUS,Canada,CAN,58,0,13,10,81
2016,Rwanda,RWA,Canada,CAN,42,0,22,5,69
2016,El Salvador,SLV,Canada,CAN,152,0,59,5,216
2016,Saudi Arabia,SAU,Canada,CAN,73,0,19,5,97
2016,Serbia and Kosovo: S/RES/1244 (1999),SRB,Canada,CAN,11,0,22,5,38
2016,Senegal,SEN,Canada,CAN,24,0,17,0,41
2016,Seychelles,SYC,Canada,CAN,5,0,0,0,5
2016,Sierra Leone,SLE,Canada,CAN,0,0,5,5,10
2016,Somalia,SOM,Canada,CAN,323,0,120,57,500
2016,Spain,ESP,Canada,CAN,0,0,10,0,10
2016,Sudan,SDN,Canada,CAN,100,0,30,5,135
2016,South Sudan,SSD,Canada,CAN,5,0,0,0,5
2016,Slovakia,SVK,Canada,CAN,188,0,65,117,370
2016,Sweden,SWE,Canada,CAN,0,0,5,5,10
2016,Syrian Arab Rep.,SYR,Canada,CAN,751,0,25,23,799
2016,United Rep. of Tanzania,TZA,Canada,CAN,21,0,5,0,26
2016,Thailand,THA,Canada,CAN,0,0,13,0,13
2016,Tajikistan,TJK,Canada,CAN,5,0,5,0,10
2016,Togo,TGO,Canada,CAN,29,0,5,0,34
2016,Tunisia,TUN,Canada,CAN,18,0,22,5,45
2016,Turkey,TUR,Canada,CAN,392,0,71,12,475
2016,Uganda,UGA,Canada,CAN,65,0,22,0,87
2016,Ukraine,UKR,Canada,CAN,154,0,72,14,240
2016,United States of America,USA,Canada,CAN,0,0,66,29,95
2016,Uzbekistan,UZB,Canada,CAN,14,0,5,0,19
2016,Saint Vincent and the Grenadines,VCT,Canada,CAN,14,0,14,11,39
2016,Venezuela (Bolivarian Republic of),VEN,Canada,CAN,275,0,86,5,366
2016,Yemen,YEM,Canada,CAN,160,0,16,5,181
2016,Zimbabwe,ZWE,Canada,CAN,54,0,41,0,95
2016,Unknown ,,Canada,CAN,11,0,5,15,31
2016,Chad,TCD,Central African Rep.,CAF,0,0,0,28,28
2016,Cameroon,CMR,Central African Rep.,CAF,0,0,0,10,10
2016,Dem. Rep. of the Congo,COD,Central African Rep.,CAF,0,0,0,62,62
2016,Rwanda,RWA,Central African Rep.,CAF,0,0,0,5,5
2016,Sudan,SDN,Central African Rep.,CAF,0,0,0,5,5
2016,Syrian Arab Rep.,SYR,Central African Rep.,CAF,0,0,0,10,10
2016,Cuba,CUB,Cayman Islands,CYM,10,0,146,0,156
2016,Mexico,MEX,Cayman Islands,CYM,0,0,5,0,5
2016,Colombia,COL,Chile,CHL,22,0,11,63,96
2016,Dominican Rep.,DOM,Chile,CHL,0,0,16,5,21
2016,El Salvador,SLV,Chile,CHL,5,0,0,0,5
2016,Syrian Arab Rep.,SYR,Chile,CHL,5,0,0,5,10
2016,Ukraine,UKR,Chile,CHL,0,0,0,5,5
2016,Burundi,BDI,Dem. Rep. of the Congo,COD,10,0,0,0,10
2016,Central African Rep.,CAF,Dem. Rep. of the Congo,COD,5,0,0,0,5
2016,Chad,TCD,Dem. Rep. of the Congo,COD,0,0,10,15,25
2016,Cameroon,CMR,Dem. Rep. of the Congo,COD,0,0,14,10,24
2016,Guinea,GIN,Dem. Rep. of the Congo,COD,0,0,0,14,14
2016,Nigeria,NGA,Dem. Rep. of the Congo,COD,0,0,5,5,10
2016,Senegal,SEN,Dem. Rep. of the Congo,COD,0,0,0,5,5
2016,Syrian Arab Rep.,SYR,Dem. Rep. of the Congo,COD,5,0,0,0,5
2016,Afghanistan,AFG,Colombia,COL,5,0,0,0,5
2016,Cuba,CUB,Colombia,COL,10,0,0,41,51
2016,Honduras,HND,Colombia,COL,5,0,0,0,5
2016,Iraq,IRQ,Colombia,COL,5,0,0,0,5
2016,El Salvador,SLV,Colombia,COL,5,0,0,0,5
2016,Venezuela (Bolivarian Republic of),VEN,Colombia,COL,5,0,0,54,59
2016,Albania,ALB,Costa Rica,CRI,0,0,5,0,5
2016,Bangladesh,BGD,Costa Rica,CRI,0,0,0,26,26
2016,Canada,CAN,Costa Rica,CRI,0,0,0,5,5
2016,Cameroon,CMR,Costa Rica,CRI,0,0,0,5,5
2016,Dem. Rep. of the Congo,COD,Costa Rica,CRI,0,0,5,70,75
2016,Colombia,COL,Costa Rica,CRI,88,0,645,232,965
2016,Cuba,CUB,Costa Rica,CRI,5,0,37,101,143
2016,Eritrea,ERI,Costa Rica,CRI,0,0,0,17,17
2016,Ethiopia,ETH,Costa Rica,CRI,0,0,0,5,5
2016,Gambia,GMB,Costa Rica,CRI,0,0,0,5,5
2016,Ghana,GHA,Costa Rica,CRI,0,0,5,76,81
2016,Guatemala,GTM,Costa Rica,CRI,5,0,5,5,15
2016,Guinea,GIN,Costa Rica,CRI,0,0,5,16,21
2016,Haiti,HTI,Costa Rica,CRI,0,0,5,5,10
2016,Honduras,HND,Costa Rica,CRI,19,0,91,28,138
2016,Cote d'Ivoire,CIV,Costa Rica,CRI,0,0,0,10,10
2016,Iraq,IRQ,Costa Rica,CRI,0,0,0,5,5
2016,Mexico,MEX,Costa Rica,CRI,5,0,0,0,5
2016,Mali,MLI,Costa Rica,CRI,0,0,0,16,16
2016,Nepal,NPL,Costa Rica,CRI,0,0,0,60,60
2016,Niger,NER,Costa Rica,CRI,0,0,0,5,5
2016,Nicaragua,NIC,Costa Rica,CRI,10,0,40,12,62
2016,Pakistan,PAK,Costa Rica,CRI,0,0,0,26,26
2016,Panama,PAN,Costa Rica,CRI,0,0,5,0,5
2016,El Salvador,SLV,Costa Rica,CRI,268,0,1058,264,1590
2016,Senegal,SEN,Costa Rica,CRI,0,0,0,15,15
2016,Somalia,SOM,Costa Rica,CRI,0,0,0,22,22
2016,Viet Nam,VNM,Costa Rica,CRI,0,0,10,0,10
2016,Syrian Arab Rep.,SYR,Costa Rica,CRI,0,0,0,5,5
2016,Togo,TGO,Costa Rica,CRI,0,0,0,14,14
2016,United States of America,USA,Costa Rica,CRI,0,0,5,0,5
2016,Venezuela (Bolivarian Republic of),VEN,Costa Rica,CRI,134,0,401,72,607
2016,Zambia,ZMB,Costa Rica,CRI,0,0,0,5,5
2016,Afghanistan,AFG,Cyprus,CYP,0,0,0,10,10
2016,Egypt,EGY,Cyprus,CYP,5,0,70,22,97
2016,Bangladesh,BGD,Cyprus,CYP,0,0,35,34,69
2016,Cameroon,CMR,Cyprus,CYP,5,0,5,0,10
2016,Dem. Rep. of the Congo,COD,Cyprus,CYP,0,0,5,0,5
2016,Comoros,COM,Cyprus,CYP,0,0,5,0,5
2016,Eritrea,ERI,Cyprus,CYP,5,0,0,0,5
2016,Gambia,GMB,Cyprus,CYP,0,0,5,0,5
2016,Palestinian,PSE,Cyprus,CYP,75,10,57,33,175
2016,Georgia,GEO,Cyprus,CYP,0,0,0,5,5
2016,Ghana,GHA,Cyprus,CYP,0,0,0,5,5
2016,India,IND,Cyprus,CYP,0,0,96,51,147
2016,Iran (Islamic Rep. of),IRN,Cyprus,CYP,10,0,5,16,31
2016,Iraq,IRQ,Cyprus,CYP,20,23,13,10,66
2016,Jordan,JOR,Cyprus,CYP,0,0,5,0,5
2016,Lebanon,LBN,Cyprus,CYP,0,0,15,10,25
2016,Sri Lanka,LKA,Cyprus,CYP,0,0,40,10,50
2016,Nepal,NPL,Cyprus,CYP,0,0,5,10,15
2016,Nigeria,NGA,Cyprus,CYP,0,0,5,5,10
2016,Pakistan,PAK,Cyprus,CYP,0,0,123,67,190
2016,Philippines,PHL,Cyprus,CYP,0,0,23,10,33
2016,Russian Federation,RUS,Cyprus,CYP,5,0,0,0,5
2016,Sierra Leone,SLE,Cyprus,CYP,0,0,5,0,5
2016,Somalia,SOM,Cyprus,CYP,26,0,28,50,104
2016,Viet Nam,VNM,Cyprus,CYP,0,0,120,25,145
2016,Syrian Arab Rep.,SYR,Cyprus,CYP,46,1051,0,0,1097
2016,Turkey,TUR,Cyprus,CYP,0,5,5,5,15
2016,Ukraine,UKR,Cyprus,CYP,0,0,0,22,22
2016,Afghanistan,AFG,Czechia,CZE,5,16,0,12,33
2016,Algeria,DZA,Czechia,CZE,0,0,0,5,5
2016,Armenia,ARM,Czechia,CZE,5,5,40,5,55
2016,Azerbaijan,AZE,Czechia,CZE,5,0,5,10,20
2016,Belarus,BLR,Czechia,CZE,0,5,0,5,10
2016,China,CHN,Czechia,CZE,0,0,0,5,5
2016,Cameroon,CMR,Czechia,CZE,0,0,0,5,5
2016,Dem. Rep. of the Congo,COD,Czechia,CZE,0,0,5,0,5
2016,Cuba,CUB,Czechia,CZE,0,44,0,24,68
2016,Ethiopia,ETH,Czechia,CZE,0,0,0,5,5
2016,Georgia,GEO,Czechia,CZE,0,0,34,12,46
2016,Iraq,IRQ,Czechia,CZE,101,49,0,26,176
2016,Kazakhstan,KAZ,Czechia,CZE,0,5,10,0,15
2016,Kyrgyzstan,KGZ,Czechia,CZE,5,5,5,10,25
2016,Lebanon,LBN,Czechia,CZE,0,5,0,0,5
2016,Rep. of Moldova,MDA,Czechia,CZE,0,0,5,5,10
2016,Mongolia,MNG,Czechia,CZE,0,0,0,5,5
2016,Nigeria,NGA,Czechia,CZE,0,0,5,21,26
2016,Russian Federation,RUS,Czechia,CZE,5,5,27,18,55
2016,Serbia and Kosovo: S/RES/1244 (1999),SRB,Czechia,CZE,0,0,5,5,10
2016,Viet Nam,VNM,Czechia,CZE,0,0,56,16,72
2016,Slovakia,SVK,Czechia,CZE,0,0,0,5,5
2016,Syrian Arab Rep.,SYR,Czechia,CZE,5,88,0,10,103
2016,Turkmenistan,TKM,Czechia,CZE,5,0,0,0,5
2016,Tunisia,TUN,Czechia,CZE,0,0,0,5,5
2016,Turkey,TUR,Czechia,CZE,0,0,5,10,15
2016,Ukraine,UKR,Czechia,CZE,5,46,306,180,537
2016,Uzbekistan,UZB,Czechia,CZE,0,5,0,0,5
2016,Yemen,YEM,Czechia,CZE,0,10,0,0,10
2016,Stateless,XXA,Czechia,CZE,0,16,5,5,26
2016,Afghanistan,AFG,Denmark,DNK,43,187,654,0,884
2016,Albania,ALB,Denmark,DNK,0,0,59,0,59
2016,Algeria,DZA,Denmark,DNK,0,0,18,0,18
2016,Egypt,EGY,Denmark,DNK,0,0,16,0,16
2016,Armenia,ARM,Denmark,DNK,0,0,57,0,57
2016,Azerbaijan,AZE,Denmark,DNK,5,0,12,0,17
2016,Burundi,BDI,Denmark,DNK,0,0,5,0,5
2016,Bangladesh,BGD,Denmark,DNK,0,0,15,0,15
2016,Belarus,BLR,Denmark,DNK,0,0,14,0,14
2016,Bosnia and Herzegovina,BIH,Denmark,DNK,0,0,18,0,18
2016,Bulgaria,BGR,Denmark,DNK,0,0,5,0,5
2016,China,CHN,Denmark,DNK,0,0,19,0,19
2016,Dem. Rep. of the Congo,COD,Denmark,DNK,0,0,5,0,5
2016,Eritrea,ERI,Denmark,DNK,501,28,22,0,551
2016,Ethiopia,ETH,Denmark,DNK,11,0,53,0,64
2016,Gambia,GMB,Denmark,DNK,0,0,5,0,5
2016,Georgia,GEO,Denmark,DNK,0,0,15,0,15
2016,Ghana,GHA,Denmark,DNK,0,0,5,0,5
2016,Guinea,GIN,Denmark,DNK,0,0,5,0,5
2016,India,IND,Denmark,DNK,0,0,5,0,5
2016,Iran (Islamic Rep. of),IRN,Denmark,DNK,370,22,636,0,1028
2016,Iraq,IRQ,Denmark,DNK,36,23,394,0,453
2016,Jordan,JOR,Denmark,DNK,0,0,5,0,5
2016,Kenya,KEN,Denmark,DNK,0,0,5,0,5
2016,Libya,LBY,Denmark,DNK,0,0,15,0,15
2016,Lebanon,LBN,Denmark,DNK,0,0,32,0,32
2016,Sri Lanka,LKA,Denmark,DNK,0,0,10,0,10
2016,North Macedonia,MKD,Denmark,DNK,0,0,23,0,23
2016,Morocco,MAR,Denmark,DNK,0,0,38,0,38
2016,Myanmar,MMR,Denmark,DNK,0,0,10,0,10
2016,Nepal,NPL,Denmark,DNK,0,0,5,0,5
2016,Nigeria,NGA,Denmark,DNK,0,0,31,0,31
2016,Pakistan,PAK,Denmark,DNK,0,0,16,0,16
2016,Romania,ROU,Denmark,DNK,0,0,5,0,5
2016,Russian Federation,RUS,Denmark,DNK,10,0,78,0,88
2016,Rwanda,RWA,Denmark,DNK,0,0,5,0,5
2016,El Salvador,SLV,Denmark,DNK,0,0,5,0,5
2016,Serbia and Kosovo: S/RES/1244 (1999),SRB,Denmark,DNK,0,0,63,0,63
2016,Somalia,SOM,Denmark,DNK,0,38,85,0,123
2016,Viet Nam,VNM,Denmark,DNK,0,0,5,0,5
2016,Sudan,SDN,Denmark,DNK,0,0,41,0,41
2016,Syrian Arab Rep.,SYR,Denmark,DNK,3050,2195,42,0,5287
2016,Tunisia,TUN,Denmark,DNK,0,0,10,0,10
2016,Turkey,TUR,Denmark,DNK,0,0,10,0,10
2016,Uganda,UGA,Denmark,DNK,5,0,19,0,24
2016,Ukraine,UKR,Denmark,DNK,0,0,42,0,42
2016,United States of America,USA,Denmark,DNK,0,0,5,0,5
2016,Uzbekistan,UZB,Denmark,DNK,0,0,5,0,5
2016,Yemen,YEM,Denmark,DNK,0,0,11,0,11
2016,Stateless,XXA,Denmark,DNK,234,308,121,0,663
2016,Afghanistan,AFG,Estonia,EST,5,0,0,0,5
2016,Armenia,ARM,Estonia,EST,0,0,5,0,5
2016,Cameroon,CMR,Estonia,EST,0,0,5,0,5
2016,Georgia,GEO,Estonia,EST,5,0,0,0,5
2016,Iran (Islamic Rep. of),IRN,Estonia,EST,0,0,10,0,10
2016,Iraq,IRQ,Estonia,EST,14,13,0,5,32
2016,Sri Lanka,LKA,Estonia,EST,5,0,0,0,5
2016,Russian Federation,RUS,Estonia,EST,10,0,0,0,10
2016,Sudan,SDN,Estonia,EST,5,0,0,0,5
2016,Syrian Arab Rep.,SYR,Estonia,EST,31,28,0,0,59
2016,Ukraine,UKR,Estonia,EST,0,21,12,5,38
2016,Afghanistan,AFG,Finland,FIN,449,490,3448,765,5152
2016,Albania,ALB,Finland,FIN,0,0,141,45,186
2016,Algeria,DZA,Finland,FIN,0,0,28,43,71
2016,Angola,AGO,Finland,FIN,0,0,0,5,5
2016,Egypt,EGY,Finland,FIN,5,0,18,5,28
2016,Armenia,ARM,Finland,FIN,0,0,5,0,5
2016,Azerbaijan,AZE,Finland,FIN,18,0,5,0,23
2016,Bangladesh,BGD,Finland,FIN,0,0,86,53,139
2016,Belarus,BLR,Finland,FIN,5,0,12,34,51
2016,Bosnia and Herzegovina,BIH,Finland,FIN,0,0,11,5,16
2016,Bulgaria,BGR,Finland,FIN,0,0,0,5,5
2016,China,CHN,Finland,FIN,10,0,0,0,10
2016,Cameroon,CMR,Finland,FIN,28,0,73,11,112
2016,Dem. Rep. of the Congo,COD,Finland,FIN,5,5,28,5,43
2016,Colombia,COL,Finland,FIN,0,0,0,5,5
2016,Eritrea,ERI,Finland,FIN,312,0,0,10,322
2016,Ethiopia,ETH,Finland,FIN,51,5,30,10,96
2016,Gambia,GMB,Finland,FIN,5,0,38,46,89
2016,Georgia,GEO,Finland,FIN,0,0,15,16,31
2016,Ghana,GHA,Finland,FIN,5,0,29,12,46
2016,Guinea,GIN,Finland,FIN,0,0,17,10,27
2016,Honduras,HND,Finland,FIN,0,5,5,0,10
2016,Cote d'Ivoire,CIV,Finland,FIN,0,0,11,5,16
2016,India,IND,Finland,FIN,0,0,78,96,174
2016,Iran (Islamic Rep. of),IRN,Finland,FIN,220,0,137,118,475
2016,Iraq,IRQ,Finland,FIN,2014,754,9510,3875,16153
2016,Jordan,JOR,Finland,FIN,0,0,5,0,5
2016,Kazakhstan,KAZ,Finland,FIN,0,0,0,5,5
2016,Kyrgyzstan,KGZ,Finland,FIN,0,0,5,0,5
2016,Libya,LBY,Finland,FIN,5,5,5,13,28
2016,Lebanon,LBN,Finland,FIN,0,10,24,20,54
2016,Sri Lanka,LKA,Finland,FIN,5,0,35,0,40
2016,North Macedonia,MKD,Finland,FIN,0,0,19,5,24
2016,Rep. of Moldova,MDA,Finland,FIN,0,0,5,0,5
2016,Mexico,MEX,Finland,FIN,0,0,10,5,15
2016,Mali,MLI,Finland,FIN,0,0,5,10,15
2016,Morocco,MAR,Finland,FIN,14,5,59,76,154
2016,Myanmar,MMR,Finland,FIN,0,5,0,0,5
2016,Nepal,NPL,Finland,FIN,0,0,35,13,48
2016,Nigeria,NGA,Finland,FIN,10,0,135,75,220
2016,Pakistan,PAK,Finland,FIN,17,0,48,59,124
2016,Romania,ROU,Finland,FIN,0,0,5,0,5
2016,Russian Federation,RUS,Finland,FIN,52,0,102,48,202
2016,Rwanda,RWA,Finland,FIN,5,0,5,0,10
2016,El Salvador,SLV,Finland,FIN,0,5,0,0,5
2016,Serbia and Kosovo: S/RES/1244 (1999),SRB,Finland,FIN,0,0,92,33,125
2016,Senegal,SEN,Finland,FIN,0,0,5,10,15
2016,Somalia,SOM,Finland,FIN,321,105,977,139,1542
2016,Spain,ESP,Finland,FIN,0,0,5,0,5
2016,Viet Nam,VNM,Finland,FIN,0,0,0,5,5
2016,Sudan,SDN,Finland,FIN,11,0,12,11,34
2016,Slovakia,SVK,Finland,FIN,0,0,5,0,5
2016,Syrian Arab Rep.,SYR,Finland,FIN,778,336,5,123,1242
2016,United Rep. of Tanzania,TZA,Finland,FIN,0,0,5,0,5
2016,Tajikistan,TJK,Finland,FIN,0,0,0,5,5
2016,Togo,TGO,Finland,FIN,0,0,0,5,5
2016,Tunisia,TUN,Finland,FIN,0,0,10,14,24
2016,Turkey,TUR,Finland,FIN,0,0,39,24,63
2016,United Arab Emirates,ARE,Finland,FIN,0,0,0,5,5
2016,Uganda,UGA,Finland,FIN,12,0,0,0,12
2016,Ukraine,UKR,Finland,FIN,0,0,47,23,70
2016,United States of America,USA,Finland,FIN,0,0,0,5,5
2016,Yemen,YEM,Finland,FIN,30,54,0,12,96
2016,Stateless,XXA,Finland,FIN,125,0,40,23,188
2016,Unknown ,,Finland,FIN,39,5,24,42,110
2016,Afghanistan,AFG,France,FRA,741,2529,773,0,4043
2016,Albania,ALB,France,FRA,75,328,3134,0,3537
2016,Algeria,DZA,France,FRA,95,68,2072,0,2235
2016,Angola,AGO,France,FRA,53,24,357,0,434
2016,Egypt,EGY,France,FRA,53,0,267,0,320
2016,Armenia,ARM,France,FRA,29,49,1013,0,1091
2016,Azerbaijan,AZE,France,FRA,53,16,367,0,436
2016,Burundi,BDI,France,FRA,138,0,10,0,148
2016,Benin,BEN,France,FRA,0,0,13,0,13
2016,Bangladesh,BGD,France,FRA,186,81,3486,0,3753
2016,Bhutan,BTN,France,FRA,0,0,5,0,5
2016,Burkina Faso,BFA,France,FRA,5,14,77,0,96
2016,Belarus,BLR,France,FRA,10,0,34,0,44
2016,Brazil,BRA,France,FRA,0,0,5,0,5
2016,Bosnia and Herzegovina,BIH,France,FRA,16,11,285,0,312
2016,Cambodia,KHM,France,FRA,0,0,17,0,17
2016,Central African Rep.,CAF,France,FRA,315,425,485,0,1225
2016,Chad,TCD,France,FRA,55,5,305,0,365
2016,China,CHN,France,FRA,778,0,1440,0,2218
2016,Cameroon,CMR,France,FRA,64,18,422,0,504
2016,Congo,COG,France,FRA,47,18,357,0,422
2016,Dem. Rep. of the Congo,COD,France,FRA,425,90,2780,0,3295
2016,Comoros,COM,France,FRA,32,5,157,0,194
2016,Colombia,COL,France,FRA,13,5,54,0,72
2016,Cuba,CUB,France,FRA,13,0,56,0,69
2016,Cabo Verde,CPV,France,FRA,0,0,5,0,5
2016,Djibouti,DJI,France,FRA,24,5,32,0,61
2016,Dominica,DMA,France,FRA,0,0,10,0,10
2016,Dominican Rep.,DOM,France,FRA,0,10,374,0,384
2016,Equatorial Guinea,GNQ,France,FRA,0,0,13,0,13
2016,Eritrea,ERI,France,FRA,708,0,887,0,1595
2016,Ethiopia,ETH,France,FRA,128,0,161,0,289
2016,Gabon,GAB,France,FRA,5,10,40,0,55
2016,Gambia,GMB,France,FRA,14,5,162,0,181
2016,Palestinian,PSE,France,FRA,134,5,43,0,182
2016,Georgia,GEO,France,FRA,42,66,966,0,1074
2016,Germany,DEU,France,FRA,0,0,5,0,5
2016,Ghana,GHA,France,FRA,0,0,41,0,41
2016,Guinea-Bissau,GNB,France,FRA,0,0,96,0,96
2016,Guatemala,GTM,France,FRA,0,0,5,0,5
2016,Guinea,GIN,France,FRA,383,119,1256,0,1758
2016,Guyana,GUY,France,FRA,5,0,30,0,35
2016,Haiti,HTI,France,FRA,55,83,3913,0,4051
2016,Honduras,HND,France,FRA,0,5,0,0,5
2016,Croatia,HRV,France,FRA,0,0,5,0,5
2016,Cote d'Ivoire,CIV,France,FRA,170,62,1028,0,1260
2016,India,IND,France,FRA,5,5,91,0,101
2016,Iran (Islamic Rep. of),IRN,France,FRA,118,5,87,0,210
2016,Iraq,IRQ,France,FRA,1083,260,378,0,1721
2016,Israel,ISR,France,FRA,0,0,10,0,10
2016,Jamaica,JAM,France,FRA,0,0,5,0,5
2016,Jordan,JOR,France,FRA,0,0,10,0,10
2016,Japan,JPN,France,FRA,0,0,5,0,5
2016,Kazakhstan,KAZ,France,FRA,10,10,69,0,89
2016,Kenya,KEN,France,FRA,14,0,45,0,59
2016,Kyrgyzstan,KGZ,France,FRA,0,0,23,0,23
2016,Kuwait,KWT,France,FRA,33,0,5,0,38
2016,Liberia,LBR,France,FRA,10,0,17,0,27
2016,Libya,LBY,France,FRA,111,27,105,0,243
2016,Saint Lucia,LCA,France,FRA,0,0,5,0,5
2016,Lebanon,LBN,France,FRA,10,5,41,0,56
2016,Sri Lanka,LKA,France,FRA,214,29,2010,0,2253
2016,Madagascar,MDG,France,FRA,0,5,81,0,86
2016,Mauritania,MRT,France,FRA,75,10,832,0,917
2016,North Macedonia,MKD,France,FRA,5,0,199,0,204
2016,Rep. of Moldova,MDA,France,FRA,0,0,21,0,21
2016,Mexico,MEX,France,FRA,0,5,5,0,10
2016,Mali,MLI,France,FRA,223,18,1480,0,1721
2016,Mongolia,MNG,France,FRA,12,11,102,0,125
2016,Morocco,MAR,France,FRA,63,5,273,0,341
2016,Mozambique,MOZ,France,FRA,0,0,5,0,5
2016,Montenegro,MNE,France,FRA,0,5,73,0,78
2016,Mauritius,MUS,France,FRA,0,0,14,0,14
2016,Myanmar,MMR,France,FRA,0,0,44,0,44
2016,Nepal,NPL,France,FRA,0,0,43,0,43
2016,Niger,NER,France,FRA,0,0,29,0,29
2016,Nigeria,NGA,France,FRA,141,48,1585,0,1774
2016,Pakistan,PAK,France,FRA,78,41,1737,0,1856
2016,Peru,PER,France,FRA,0,0,62,0,62
2016,Philippines,PHL,France,FRA,0,0,5,0,5
2016,South Africa,ZAF,France,FRA,0,0,5,0,5
2016,Russian Federation,RUS,France,FRA,288,119,1982,0,2389
2016,Rwanda,RWA,France,FRA,97,0,46,0,143
2016,El Salvador,SLV,France,FRA,0,10,5,0,15
2016,Serbia and Kosovo: S/RES/1244 (1999),SRB,France,FRA,124,212,2890,0,3226
2016,Senegal,SEN,France,FRA,96,18,354,0,468
2016,Sierra Leone,SLE,France,FRA,21,5,75,0,101
2016,Somalia,SOM,France,FRA,86,271,692,0,1049
2016,Viet Nam,VNM,France,FRA,5,0,22,0,27
2016,Sudan,SDN,France,FRA,2115,341,3354,0,5810
2016,Suriname,SUR,France,FRA,0,0,5,0,5
2016,South Sudan,SSD,France,FRA,5,0,14,0,19
2016,Syrian Arab Rep.,SYR,France,FRA,1916,1941,107,0,3964
2016,United Rep. of Tanzania,TZA,France,FRA,0,0,10,0,10
2016,Thailand,THA,France,FRA,0,0,5,0,5
2016,Tajikistan,TJK,France,FRA,0,0,5,0,5
2016,Togo,TGO,France,FRA,10,5,113,0,128
2016,Tunisia,TUN,France,FRA,21,11,198,0,230
2016,Turkey,TUR,France,FRA,98,21,1034,0,1153
2016,Uganda,UGA,France,FRA,10,0,5,0,15
2016,Ukraine,UKR,France,FRA,143,71,847,0,1061
2016,United States of America,USA,France,FRA,0,0,5,0,5
2016,Uzbekistan,UZB,France,FRA,10,0,13,0,23
2016,Venezuela (Bolivarian Republic of),VEN,France,FRA,10,10,136,0,156
2016,Western Sahara,ESH,France,FRA,94,10,646,0,750
2016,Yemen,YEM,France,FRA,22,53,5,0,80
2016,Zimbabwe,ZWE,France,FRA,5,0,13,0,18
2016,Stateless,XXA,France,FRA,53,0,293,0,346
2016,Unknown ,,France,FRA,7181,2950,9351,0,19482
2016,Afghanistan,AFG,United Kingdom of Great Britain and Northern Ireland,GBR,512,313,1097,619,2541
2016,Albania,ALB,United Kingdom of Great Britain and Northern Ireland,GBR,17,219,800,316,1352
2016,Algeria,DZA,United Kingdom of Great Britain and Northern Ireland,GBR,11,5,102,40,158
2016,Angola,AGO,United Kingdom of Great Britain and Northern Ireland,GBR,5,5,39,5,54
2016,Egypt,EGY,United Kingdom of Great Britain and Northern Ireland,GBR,19,12,235,96,362
2016,Argentina,ARG,United Kingdom of Great Britain and Northern Ireland,GBR,0,0,5,0,5
2016,Armenia,ARM,United Kingdom of Great Britain and Northern Ireland,GBR,0,0,5,0,5
2016,Australia,AUS,United Kingdom of Great Britain and Northern Ireland,GBR,0,0,0,5,5
2016,Azerbaijan,AZE,United Kingdom of Great Britain and Northern Ireland,GBR,5,0,13,5,23
2016,Bahrain,BHR,United Kingdom of Great Britain and Northern Ireland,GBR,5,0,5,0,10
2016,Barbados,BRB,United Kingdom of Great Britain and Northern Ireland,GBR,0,0,10,0,10
2016,Burundi,BDI,United Kingdom of Great Britain and Northern Ireland,GBR,0,0,15,0,15
2016,Bangladesh,BGD,United Kingdom of Great Britain and Northern Ireland,GBR,70,11,1323,229,1633
2016,Burkina Faso,BFA,United Kingdom of Great Britain and Northern Ireland,GBR,0,0,5,0,5
2016,Belarus,BLR,United Kingdom of Great Britain and Northern Ireland,GBR,5,0,0,0,5
2016,Bolivia (Plurinational State of),BOL,United Kingdom of Great Britain and Northern Ireland,GBR,0,0,10,0,10
2016,Botswana,BWA,United Kingdom of Great Britain and Northern Ireland,GBR,0,0,5,0,5
2016,Brazil,BRA,United Kingdom of Great Britain and Northern Ireland,GBR,0,0,16,10,26
2016,Canada,CAN,United Kingdom of Great Britain and Northern Ireland,GBR,0,0,5,0,5
2016,Chad,TCD,United Kingdom of Great Britain and Northern Ireland,GBR,0,0,5,0,5
2016,China,CHN,United Kingdom of Great Britain and Northern Ireland,GBR,16,14,565,231,826
2016,Cameroon,CMR,United Kingdom of Great Britain and Northern Ireland,GBR,21,5,85,11,122
2016,Congo,COG,United Kingdom of Great Britain and Northern Ireland,GBR,5,0,17,5,27
2016,Dem. Rep. of the Congo,COD,United Kingdom of Great Britain and Northern Ireland,GBR,44,13,112,11,180
2016,Comoros,COM,United Kingdom of Great Britain and Northern Ireland,GBR,0,0,0,5,5
2016,Dominica,DMA,United Kingdom of Great Britain and Northern Ireland,GBR,0,0,5,0,5
2016,Ecuador,ECU,United Kingdom of Great Britain and Northern Ireland,GBR,0,0,0,5,5
2016,Eritrea,ERI,United Kingdom of Great Britain and Northern Ireland,GBR,1007,250,517,131,1905
2016,Ethiopia,ETH,United Kingdom of Great Britain and Northern Ireland,GBR,185,18,164,25,392
2016,France,FRA,United Kingdom of Great Britain and Northern Ireland,GBR,0,0,5,0,5
2016,Gambia,GMB,United Kingdom of Great Britain and Northern Ireland,GBR,28,5,150,10,193
2016,Palestinian,PSE,United Kingdom of Great Britain and Northern Ireland,GBR,21,0,79,23,123
2016,Georgia,GEO,United Kingdom of Great Britain and Northern Ireland,GBR,0,0,36,10,46
2016,Ghana,GHA,United Kingdom of Great Britain and Northern Ireland,GBR,10,13,196,37,256
2016,Greece,GRC,United Kingdom of Great Britain and Northern Ireland,GBR,0,0,5,0,5
2016,Grenada,GRD,United Kingdom of Great Britain and Northern Ireland,GBR,0,0,5,0,5
2016,Guinea,GIN,United Kingdom of Great Britain and Northern Ireland,GBR,11,0,12,5,28
2016,Guyana,GUY,United Kingdom of Great Britain and Northern Ireland,GBR,0,0,5,0,5
2016,Honduras,HND,United Kingdom of Great Britain and Northern Ireland,GBR,0,0,5,0,5
2016,Cote d'Ivoire,CIV,United Kingdom of Great Britain and Northern Ireland,GBR,0,5,18,0,23
2016,India,IND,United Kingdom of Great Britain and Northern Ireland,GBR,5,5,1229,413,1652
2016,Indonesia,IDN,United Kingdom of Great Britain and Northern Ireland,GBR,0,0,5,0,5
2016,Iran (Islamic Rep. of),IRN,United Kingdom of Great Britain and Northern Ireland,GBR,1583,122,2185,611,4501
2016,Iraq,IRQ,United Kingdom of Great Britain and Northern Ireland,GBR,247,128,1948,800,3123
2016,Jamaica,JAM,United Kingdom of Great Britain and Northern Ireland,GBR,15,5,188,28,236
2016,Jordan,JOR,United Kingdom of Great Britain and Northern Ireland,GBR,0,0,10,10,20
2016,Kenya,KEN,United Kingdom of Great Britain and Northern Ireland,GBR,10,10,57,10,87
2016,Kyrgyzstan,KGZ,United Kingdom of Great Britain and Northern Ireland,GBR,0,0,5,5,10
2016,Rep. of Korea,KOR,United Kingdom of Great Britain and Northern Ireland,GBR,0,0,5,0,5
2016,Dem. People's Rep. of Korea,PRK,United Kingdom of Great Britain and Northern Ireland,GBR,0,0,21,5,26
2016,Kuwait,KWT,United Kingdom of Great Britain and Northern Ireland,GBR,47,0,33,5,85
2016,Liberia,LBR,United Kingdom of Great Britain and Northern Ireland,GBR,0,0,5,0,5
2016,Libya,LBY,United Kingdom of Great Britain and Northern Ireland,GBR,60,58,444,27,589
2016,Saint Lucia,LCA,United Kingdom of Great Britain and Northern Ireland,GBR,5,0,14,5,24
2016,Lebanon,LBN,United Kingdom of Great Britain and Northern Ireland,GBR,5,5,71,0,81
2016,Sri Lanka,LKA,United Kingdom of Great Britain and Northern Ireland,GBR,41,12,1000,120,1173
2016,Lithuania,LTU,United Kingdom of Great Britain and Northern Ireland,GBR,0,0,19,5,24
2016,Latvia,LVA,United Kingdom of Great Britain and Northern Ireland,GBR,0,0,5,5,10
2016,Maldives,MDV,United Kingdom of Great Britain and Northern Ireland,GBR,5,0,0,0,5
2016,Mexico,MEX,United Kingdom of Great Britain and Northern Ireland,GBR,0,0,16,5,21
2016,Mali,MLI,United Kingdom of Great Britain and Northern Ireland,GBR,0,0,5,0,5
2016,Malaysia,MYS,United Kingdom of Great Britain and Northern Ireland,GBR,14,0,55,10,79
2016,Malawi,MWI,United Kingdom of Great Britain and Northern Ireland,GBR,5,11,75,10,101
2016,Mongolia,MNG,United Kingdom of Great Britain and Northern Ireland,GBR,0,0,13,5,18
2016,Morocco,MAR,United Kingdom of Great Britain and Northern Ireland,GBR,0,0,54,14,68
2016,Mauritius,MUS,United Kingdom of Great Britain and Northern Ireland,GBR,0,5,56,5,66
2016,Myanmar,MMR,United Kingdom of Great Britain and Northern Ireland,GBR,10,0,70,5,85
2016,Namibia,NAM,United Kingdom of Great Britain and Northern Ireland,GBR,0,5,11,0,16
2016,Nepal,NPL,United Kingdom of Great Britain and Northern Ireland,GBR,0,0,105,35,140
2016,Netherlands,NLD,United Kingdom of Great Britain and Northern Ireland,GBR,0,0,5,0,5
2016,Nigeria,NGA,United Kingdom of Great Britain and Northern Ireland,GBR,212,60,1126,111,1509
2016,New Zealand,NZL,United Kingdom of Great Britain and Northern Ireland,GBR,0,0,0,5,5
2016,Pakistan,PAK,United Kingdom of Great Britain and Northern Ireland,GBR,409,30,2236,499,3174
2016,Philippines,PHL,United Kingdom of Great Britain and Northern Ireland,GBR,0,0,52,17,69
2016,Poland,POL,United Kingdom of Great Britain and Northern Ireland,GBR,0,0,30,5,35
2016,Portugal,PRT,United Kingdom of Great Britain and Northern Ireland,GBR,0,0,5,0,5
2016,Romania,ROU,United Kingdom of Great Britain and Northern Ireland,GBR,0,0,17,0,17
2016,South Africa,ZAF,United Kingdom of Great Britain and Northern Ireland,GBR,0,11,49,5,65
2016,Russian Federation,RUS,United Kingdom of Great Britain and Northern Ireland,GBR,25,0,49,10,84
2016,Rwanda,RWA,United Kingdom of Great Britain and Northern Ireland,GBR,0,0,15,0,15
2016,El Salvador,SLV,United Kingdom of Great Britain and Northern Ireland,GBR,10,5,26,5,46
2016,Saudi Arabia,SAU,United Kingdom of Great Britain and Northern Ireland,GBR,29,0,16,10,55
2016,Serbia and Kosovo: S/RES/1244 (1999),SRB,United Kingdom of Great Britain and Northern Ireland,GBR,0,0,10,5,15
2016,Senegal,SEN,United Kingdom of Great Britain and Northern Ireland,GBR,5,0,17,5,27
2016,Sierra Leone,SLE,United Kingdom of Great Britain and Northern Ireland,GBR,13,5,39,0,57
2016,Somalia,SOM,United Kingdom of Great Britain and Northern Ireland,GBR,95,28,167,38,328
2016,Viet Nam,VNM,United Kingdom of Great Britain and Northern Ireland,GBR,73,32,181,189,475
2016,Saint Kitts and Nevis,KNA,United Kingdom of Great Britain and Northern Ireland,GBR,0,0,5,0,5
2016,Sudan,SDN,United Kingdom of Great Britain and Northern Ireland,GBR,1241,5,145,97,1488
2016,Eswatini,SWZ,United Kingdom of Great Britain and Northern Ireland,GBR,5,0,10,0,15
2016,Sweden,SWE,United Kingdom of Great Britain and Northern Ireland,GBR,0,0,5,0,5
2016,Syrian Arab Rep.,SYR,United Kingdom of Great Britain and Northern Ireland,GBR,1752,12,143,253,2160
2016,United Rep. of Tanzania,TZA,United Kingdom of Great Britain and Northern Ireland,GBR,0,0,37,10,47
2016,Thailand,THA,United Kingdom of Great Britain and Northern Ireland,GBR,0,0,5,10,15
2016,Turkmenistan,TKM,United Kingdom of Great Britain and Northern Ireland,GBR,0,0,5,0,5
2016,Trinidad and Tobago,TTO,United Kingdom of Great Britain and Northern Ireland,GBR,0,0,34,5,39
2016,Tunisia,TUN,United Kingdom of Great Britain and Northern Ireland,GBR,5,0,25,5,35
2016,Turkey,TUR,United Kingdom of Great Britain and Northern Ireland,GBR,22,14,176,28,240
2016,Uganda,UGA,United Kingdom of Great Britain and Northern Ireland,GBR,117,0,128,10,255
2016,Ukraine,UKR,United Kingdom of Great Britain and Northern Ireland,GBR,0,0,105,32,137
2016,United States of America,USA,United Kingdom of Great Britain and Northern Ireland,GBR,5,0,24,22,51
2016,Uzbekistan,UZB,United Kingdom of Great Britain and Northern Ireland,GBR,5,0,11,0,16
2016,Saint Vincent and the Grenadines,VCT,United Kingdom of Great Britain and Northern Ireland,GBR,0,0,5,5,10
2016,Venezuela (Bolivarian Republic of),VEN,United Kingdom of Great Britain and Northern Ireland,GBR,0,0,5,0,5
2016,Yemen,YEM,United Kingdom of Great Britain and Northern Ireland,GBR,32,16,37,10,95
2016,Zambia,ZMB,United Kingdom of Great Britain and Northern Ireland,GBR,0,0,22,0,22
2016,Zimbabwe,ZWE,United Kingdom of Great Britain and Northern Ireland,GBR,31,19,223,15,288
2016,Stateless,XXA,United Kingdom of Great Britain and Northern Ireland,GBR,372,5,231,42,650
2016,Unknown ,,United Kingdom of Great Britain and Northern Ireland,GBR,11,15,12,21,59
2016,Afghanistan,AFG,Georgia,GEO,0,0,5,10,15
2016,Egypt,EGY,Georgia,GEO,0,0,37,30,67
2016,Azerbaijan,AZE,Georgia,GEO,0,0,5,10,15
2016,Bangladesh,BGD,Georgia,GEO,0,0,33,84,117
2016,Burkina Faso,BFA,Georgia,GEO,0,0,0,5,5
2016,Cameroon,CMR,Georgia,GEO,0,0,10,14,24
2016,Congo,COG,Georgia,GEO,0,0,0,5,5
2016,Gambia,GMB,Georgia,GEO,0,0,0,5,5
2016,Ghana,GHA,Georgia,GEO,0,0,5,11,16
2016,Cote d'Ivoire,CIV,Georgia,GEO,0,0,25,10,35
2016,India,IND,Georgia,GEO,0,0,10,39,49
2016,Iran (Islamic Rep. of),IRN,Georgia,GEO,16,0,12,24,52
2016,Iraq,IRQ,Georgia,GEO,10,142,103,277,532
2016,Nepal,NPL,Georgia,GEO,0,0,0,5,5
2016,Nigeria,NGA,Georgia,GEO,0,0,14,59,73
2016,Pakistan,PAK,Georgia,GEO,5,0,13,5,23
2016,Russian Federation,RUS,Georgia,GEO,5,0,12,10,27
2016,Somalia,SOM,Georgia,GEO,0,0,20,24,44
2016,Syrian Arab Rep.,SYR,Georgia,GEO,0,10,0,5,15
2016,Turkey,TUR,Georgia,GEO,0,0,17,10,27
2016,Ukraine,UKR,Georgia,GEO,0,50,5,17,72
2016,Uzbekistan,UZB,Georgia,GEO,5,0,0,5,10
2016,Yemen,YEM,Georgia,GEO,0,0,0,5,5
2016,Unknown ,,Georgia,GEO,0,0,0,5,5
2016,Burundi,BDI,Ghana,GHA,10,0,0,5,15
2016,Burkina Faso,BFA,Ghana,GHA,0,0,0,5,5
2016,Central African Rep.,CAF,Ghana,GHA,42,0,0,131,173
2016,Chad,TCD,Ghana,GHA,5,0,0,20,25
2016,Congo,COG,Ghana,GHA,0,0,10,33,43
2016,Dem. Rep. of the Congo,COD,Ghana,GHA,10,0,11,48,69
2016,Eritrea,ERI,Ghana,GHA,5,0,0,13,18
2016,Ethiopia,ETH,Ghana,GHA,0,0,0,10,10
2016,Palestinian,PSE,Ghana,GHA,5,0,0,5,10
2016,Cote d'Ivoire,CIV,Ghana,GHA,109,0,0,476,585
2016,Iraq,IRQ,Ghana,GHA,0,0,0,5,5
2016,Sri Lanka,LKA,Ghana,GHA,0,0,0,10,10
2016,Mali,MLI,Ghana,GHA,0,0,0,5,5
2016,Nigeria,NGA,Ghana,GHA,0,0,13,0,13
2016,Pakistan,PAK,Ghana,GHA,5,0,0,0,5
2016,Rwanda,RWA,Ghana,GHA,5,0,0,27,32
2016,Sierra Leone,SLE,Ghana,GHA,10,0,0,0,10
2016,Somalia,SOM,Ghana,GHA,5,0,0,17,22
2016,Sudan,SDN,Ghana,GHA,109,0,0,162,271
2016,Syrian Arab Rep.,SYR,Ghana,GHA,13,0,0,36,49
2016,Togo,TGO,Ghana,GHA,10,0,15,249,274
2016,Uzbekistan,UZB,Ghana,GHA,5,0,0,0,5
2016,Afghanistan,AFG,Greece,GRC,111,93,234,282,720
2016,Albania,ALB,Greece,GRC,0,5,969,103,1077
2016,Algeria,DZA,Greece,GRC,5,0,554,169,728
2016,Egypt,EGY,Greece,GRC,13,5,320,20,358
2016,Armenia,ARM,Greece,GRC,0,0,36,5,41
2016,Burundi,BDI,Greece,GRC,5,0,0,0,5
2016,Bangladesh,BGD,Greece,GRC,18,5,691,48,762
2016,Burkina Faso,BFA,Greece,GRC,0,0,16,0,16
2016,China,CHN,Greece,GRC,10,0,62,12,84
2016,Cameroon,CMR,Greece,GRC,18,0,127,31,176
2016,Congo,COG,Greece,GRC,0,0,16,5,21
2016,Dem. Rep. of the Congo,COD,Greece,GRC,22,0,42,29,93
2016,Cuba,CUB,Greece,GRC,0,0,5,0,5
2016,Dominican Rep.,DOM,Greece,GRC,0,0,34,21,55
2016,Eritrea,ERI,Greece,GRC,48,0,25,33,106
2016,Ethiopia,ETH,Greece,GRC,21,0,36,10,67
2016,Gambia,GMB,Greece,GRC,10,0,31,0,41
2016,Palestinian,PSE,Greece,GRC,51,0,5,25,81
2016,Georgia,GEO,Greece,GRC,0,0,419,38,457
2016,Ghana,GHA,Greece,GRC,0,0,56,0,56
2016,Guinea,GIN,Greece,GRC,0,0,23,0,23
2016,Haiti,HTI,Greece,GRC,0,0,10,0,10
2016,Cote d'Ivoire,CIV,Greece,GRC,5,0,39,5,49
2016,India,IND,Greece,GRC,0,0,50,5,55
2016,Iran (Islamic Rep. of),IRN,Greece,GRC,158,0,141,200,499
2016,Iraq,IRQ,Greece,GRC,79,34,67,260,440
2016,Jordan,JOR,Greece,GRC,0,0,5,5,10
2016,Kenya,KEN,Greece,GRC,0,0,11,0,11
2016,Liberia,LBR,Greece,GRC,0,0,5,0,5
2016,Libya,LBY,Greece,GRC,5,0,5,5,15
2016,Lebanon,LBN,Greece,GRC,5,0,34,25,64
2016,Sri Lanka,LKA,Greece,GRC,0,0,5,0,5
2016,Mauritania,MRT,Greece,GRC,0,0,5,0,5
2016,Rep. of Moldova,MDA,Greece,GRC,0,0,18,16,34
2016,Mali,MLI,Greece,GRC,5,0,50,13,68
2016,Morocco,MAR,Greece,GRC,18,0,269,114,401
2016,Myanmar,MMR,Greece,GRC,5,0,5,0,10
2016,Nepal,NPL,Greece,GRC,0,0,27,5,32
2016,Niger,NER,Greece,GRC,0,0,10,0,10
2016,Nigeria,NGA,Greece,GRC,17,0,240,20,277
2016,Pakistan,PAK,Greece,GRC,49,5,2318,328,2700
2016,Philippines,PHL,Greece,GRC,0,0,5,0,5
2016,Russian Federation,RUS,Greece,GRC,0,0,14,0,14
2016,Rwanda,RWA,Greece,GRC,0,0,5,0,5
2016,Senegal,SEN,Greece,GRC,0,0,61,12,73
2016,Sierra Leone,SLE,Greece,GRC,5,0,30,5,40
2016,Somalia,SOM,Greece,GRC,27,38,15,10,90
2016,Viet Nam,VNM,Greece,GRC,0,0,5,0,5
2016,Sudan,SDN,Greece,GRC,14,0,13,5,32
2016,Syrian Arab Rep.,SYR,Greece,GRC,1660,0,20,608,2288
2016,United Rep. of Tanzania,TZA,Greece,GRC,0,0,5,0,5
2016,Togo,TGO,Greece,GRC,0,0,5,0,5
2016,Tunisia,TUN,Greece,GRC,0,0,27,12,39
2016,Turkey,TUR,Greece,GRC,5,0,42,28,75
2016,Uganda,UGA,Greece,GRC,0,0,26,0,26
2016,Ukraine,UKR,Greece,GRC,0,23,68,27,118
2016,Venezuela (Bolivarian Republic of),VEN,Greece,GRC,0,0,5,0,5
2016,Western Sahara,ESH,Greece,GRC,0,0,0,5,5
2016,Yemen,YEM,Greece,GRC,29,22,0,10,61
2016,Stateless,XXA,Greece,GRC,35,0,11,16,62
2016,Unknown ,,Greece,GRC,0,0,26,14615,14641
2016,Bangladesh,BGD,Guatemala,GTM,0,0,0,28,28
2016,Cambodia,KHM,Guatemala,GTM,0,0,0,5,5
2016,Ecuador,ECU,Guatemala,GTM,0,0,0,10,10
2016,Eritrea,ERI,Guatemala,GTM,0,0,0,5,5
2016,Ghana,GHA,Guatemala,GTM,0,0,0,20,20
2016,Honduras,HND,Guatemala,GTM,5,0,0,13,18
2016,Nepal,NPL,Guatemala,GTM,0,0,0,69,69
2016,Pakistan,PAK,Guatemala,GTM,0,0,0,10,10
2016,Russian Federation,RUS,Guatemala,GTM,0,0,5,0,5
2016,El Salvador,SLV,Guatemala,GTM,62,0,0,20,82
2016,Somalia,SOM,Guatemala,GTM,0,0,0,5,5
2016,United States of America,USA,Guatemala,GTM,0,0,0,5,5
2016,Venezuela (Bolivarian Republic of),VEN,Guatemala,GTM,5,0,0,0,5
2016,Dem. Rep. of the Congo,COD,Guinea,GIN,12,0,0,0,12
2016,Cote d'Ivoire,CIV,Guinea,GIN,17,0,22,34,73
2016,Liberia,LBR,Guinea,GIN,28,0,17,11,56
2016,Mali,MLI,Guinea,GIN,0,5,0,0,5
2016,Sierra Leone,SLE,Guinea,GIN,5,0,25,17,47
2016,Somalia,SOM,Guinea,GIN,5,0,0,0,5
2016,Afghanistan,AFG,Croatia,HRV,17,0,15,420,452
2016,Algeria,DZA,Croatia,HRV,0,0,34,89,123
2016,Bangladesh,BGD,Croatia,HRV,0,0,0,11,11
2016,Cuba,CUB,Croatia,HRV,0,0,0,5,5
2016,Eritrea,ERI,Croatia,HRV,5,0,0,0,5
2016,Palestinian,PSE,Croatia,HRV,0,0,0,14,14
2016,India,IND,Croatia,HRV,0,0,0,5,5
2016,Iran (Islamic Rep. of),IRN,Croatia,HRV,5,0,5,57,67
2016,Iraq,IRQ,Croatia,HRV,21,0,13,165,199
2016,Libya,LBY,Croatia,HRV,0,0,0,17,17
2016,Lebanon,LBN,Croatia,HRV,0,0,5,5,10
2016,Sri Lanka,LKA,Croatia,HRV,0,0,0,12,12
2016,North Macedonia,MKD,Croatia,HRV,0,0,5,0,5
2016,Morocco,MAR,Croatia,HRV,0,0,22,55,77
2016,Nigeria,NGA,Croatia,HRV,0,0,0,5,5
2016,Pakistan,PAK,Croatia,HRV,0,0,5,123,128
2016,Russian Federation,RUS,Croatia,HRV,0,0,0,5,5
2016,Serbia and Kosovo: S/RES/1244 (1999),SRB,Croatia,HRV,0,0,10,11,21
2016,Sierra Leone,SLE,Croatia,HRV,0,0,0,5,5
2016,Somalia,SOM,Croatia,HRV,5,0,5,5,15
2016,Syrian Arab Rep.,SYR,Croatia,HRV,23,14,5,142,184
2016,Tunisia,TUN,Croatia,HRV,0,0,0,5,5
2016,Turkey,TUR,Croatia,HRV,0,0,0,55,55
2016,Ukraine,UKR,Croatia,HRV,0,0,0,5,5
2016,Afghanistan,AFG,Iceland,ISL,0,5,0,19,24
2016,Albania,ALB,Iceland,ISL,0,0,186,67,253
2016,Algeria,DZA,Iceland,ISL,0,0,0,11,11
2016,Belarus,BLR,Iceland,ISL,0,0,5,5,10
2016,Colombia,COL,Iceland,ISL,0,0,0,11,11
2016,Eritrea,ERI,Iceland,ISL,0,0,0,5,5
2016,Palestinian,PSE,Iceland,ISL,0,5,0,10,15
2016,Georgia,GEO,Iceland,ISL,0,0,0,14,14
2016,Ghana,GHA,Iceland,ISL,0,0,5,16,21
2016,Iran (Islamic Rep. of),IRN,Iceland,ISL,11,0,0,5,16
2016,Iraq,IRQ,Iceland,ISL,5,20,0,49,74
2016,Kazakhstan,KAZ,Iceland,ISL,5,0,0,0,5
2016,North Macedonia,MKD,Iceland,ISL,0,0,184,110,294
2016,Morocco,MAR,Iceland,ISL,0,0,5,13,18
2016,Nigeria,NGA,Iceland,ISL,0,0,0,16,16
2016,Pakistan,PAK,Iceland,ISL,0,0,0,10,10
2016,Russian Federation,RUS,Iceland,ISL,0,0,0,5,5
2016,El Salvador,SLV,Iceland,ISL,5,0,0,0,5
2016,Serbia and Kosovo: S/RES/1244 (1999),SRB,Iceland,ISL,0,0,15,5,20
2016,Somalia,SOM,Iceland,ISL,5,0,0,11,16
2016,Syrian Arab Rep.,SYR,Iceland,ISL,11,5,0,13,29
2016,Ukraine,UKR,Iceland,ISL,0,5,5,5,15
2016,United States of America,USA,Iceland,ISL,0,0,0,5,5
2016,Afghanistan,AFG,Ireland,IRL,37,0,47,86,170
2016,Albania,ALB,Ireland,IRL,5,0,164,73,242
2016,Algeria,DZA,Ireland,IRL,0,0,46,36,82
2016,Angola,AGO,Ireland,IRL,0,0,5,5,10
2016,Egypt,EGY,Ireland,IRL,5,0,0,14,19
2016,Bangladesh,BGD,Ireland,IRL,0,0,115,124,239
2016,Brazil,BRA,Ireland,IRL,0,0,17,5,22
2016,China,CHN,Ireland,IRL,0,0,15,5,20
2016,Cameroon,CMR,Ireland,IRL,5,0,5,0,10
2016,Dem. Rep. of the Congo,COD,Ireland,IRL,12,0,51,11,74
2016,Cuba,CUB,Ireland,IRL,0,0,5,0,5
2016,Eritrea,ERI,Ireland,IRL,5,0,0,5,10
2016,Ethiopia,ETH,Ireland,IRL,5,0,0,0,5
2016,Palestinian,PSE,Ireland,IRL,10,0,0,0,10
2016,Georgia,GEO,Ireland,IRL,5,0,37,26,68
2016,Ghana,GHA,Ireland,IRL,5,0,12,5,22
2016,India,IND,Ireland,IRL,0,0,78,72,150
2016,Iran (Islamic Rep. of),IRN,Ireland,IRL,21,0,5,22,48
2016,Iraq,IRQ,Ireland,IRL,35,0,5,18,58
2016,Kyrgyzstan,KGZ,Ireland,IRL,5,0,0,0,5
2016,Kuwait,KWT,Ireland,IRL,5,0,5,5,15
2016,Libya,LBY,Ireland,IRL,53,0,5,14,72
2016,Lesotho,LSO,Ireland,IRL,0,0,5,0,5
2016,Sri Lanka,LKA,Ireland,IRL,0,0,5,5,10
2016,Rep. of Moldova,MDA,Ireland,IRL,0,0,0,5,5
2016,Malawi,MWI,Ireland,IRL,5,0,79,10,94
2016,Morocco,MAR,Ireland,IRL,0,0,0,5,5
2016,Mauritius,MUS,Ireland,IRL,0,0,15,5,20
2016,Nepal,NPL,Ireland,IRL,0,0,10,5,15
2016,Nigeria,NGA,Ireland,IRL,0,0,166,58,224
2016,Pakistan,PAK,Ireland,IRL,5,0,454,593,1052
2016,South Africa,ZAF,Ireland,IRL,0,0,70,11,81
2016,Russian Federation,RUS,Ireland,IRL,5,0,5,0,10
2016,Saudi Arabia,SAU,Ireland,IRL,0,0,0,5,5
2016,Serbia and Kosovo: S/RES/1244 (1999),SRB,Ireland,IRL,0,0,13,0,13
2016,Senegal,SEN,Ireland,IRL,0,0,5,0,5
2016,Somalia,SOM,Ireland,IRL,10,0,5,12,27
2016,Viet Nam,VNM,Ireland,IRL,0,0,5,0,5
2016,Sudan,SDN,Ireland,IRL,5,0,5,12,22
2016,Syrian Arab Rep.,SYR,Ireland,IRL,149,0,0,15,164
2016,Togo,TGO,Ireland,IRL,0,0,5,0,5
2016,Ukraine,UKR,Ireland,IRL,5,0,28,5,38
2016,United States of America,USA,Ireland,IRL,0,0,0,5,5
2016,Venezuela (Bolivarian Republic of),VEN,Ireland,IRL,5,0,10,5,20
2016,Zimbabwe,ZWE,Ireland,IRL,23,0,110,16,149
2016,Afghanistan,AFG,Italy,ITA,380,3621,124,0,4125
2016,Albania,ALB,Italy,ITA,36,66,123,0,225
2016,Algeria,DZA,Italy,ITA,5,12,105,0,122
2016,Angola,AGO,Italy,ITA,0,5,0,0,5
2016,Egypt,EGY,Italy,ITA,34,241,261,0,536
2016,Armenia,ARM,Italy,ITA,10,24,10,0,44
2016,Azerbaijan,AZE,Italy,ITA,5,5,0,0,10
2016,Burundi,BDI,Italy,ITA,0,5,0,0,5
2016,Benin,BEN,Italy,ITA,5,51,148,0,204
2016,Bangladesh,BGD,Italy,ITA,100,1510,4616,0,6226
2016,Bahamas,BHS,Italy,ITA,0,0,5,0,5
2016,Burkina Faso,BFA,Italy,ITA,5,158,369,0,532
2016,Belarus,BLR,Italy,ITA,0,5,0,0,5
2016,Bolivia (Plurinational State of),BOL,Italy,ITA,0,5,0,0,5
2016,Brazil,BRA,Italy,ITA,5,17,23,0,45
2016,Bosnia and Herzegovina,BIH,Italy,ITA,0,90,59,0,149
2016,Central African Rep.,CAF,Italy,ITA,5,5,0,0,10
2016,Chad,TCD,Italy,ITA,5,39,23,0,67
2016,China,CHN,Italy,ITA,12,14,240,0,266
2016,Cameroon,CMR,Italy,ITA,88,253,334,0,675
2016,Congo,COG,Italy,ITA,23,40,24,0,87
2016,Dem. Rep. of the Congo,COD,Italy,ITA,30,53,20,0,103
2016,Colombia,COL,Italy,ITA,12,24,13,0,49
2016,Cuba,CUB,Italy,ITA,5,19,19,0,43
2016,Dominican Rep.,DOM,Italy,ITA,0,0,13,0,13
2016,Ecuador,ECU,Italy,ITA,0,5,10,0,15
2016,Equatorial Guinea,GNQ,Italy,ITA,0,0,5,0,5
2016,Eritrea,ERI,Italy,ITA,215,188,78,0,481
2016,Ethiopia,ETH,Italy,ITA,58,63,27,0,148
2016,Gabon,GAB,Italy,ITA,0,5,5,0,10
2016,Gambia,GMB,Italy,ITA,224,2591,5866,0,8681
2016,Palestinian,PSE,Italy,ITA,64,39,10,0,113
2016,Georgia,GEO,Italy,ITA,5,66,43,0,114
2016,Ghana,GHA,Italy,ITA,57,1242,2694,0,3993
2016,Guinea-Bissau,GNB,Italy,ITA,0,202,502,0,704
2016,Guinea,GIN,Italy,ITA,40,701,1813,0,2554
2016,Honduras,HND,Italy,ITA,5,5,0,0,10
2016,Cote d'Ivoire,CIV,Italy,ITA,111,1067,2633,0,3811
2016,India,IND,Italy,ITA,5,29,221,0,255
2016,Iran (Islamic Rep. of),IRN,Italy,ITA,65,177,58,0,300
2016,Iraq,IRQ,Italy,ITA,225,653,46,0,924
2016,Jordan,JOR,Italy,ITA,5,5,0,0,10
2016,Kenya,KEN,Italy,ITA,5,11,5,0,21
2016,Kyrgyzstan,KGZ,Italy,ITA,0,0,5,0,5
2016,Liberia,LBR,Italy,ITA,0,52,97,0,149
2016,Libya,LBY,Italy,ITA,34,177,25,0,236
2016,Lebanon,LBN,Italy,ITA,5,27,19,0,51
2016,Sri Lanka,LKA,Italy,ITA,5,49,45,0,99
2016,Madagascar,MDG,Italy,ITA,0,0,5,0,5
2016,Mauritania,MRT,Italy,ITA,20,29,34,0,83
2016,North Macedonia,MKD,Italy,ITA,0,5,5,0,10
2016,Rep. of Moldova,MDA,Italy,ITA,0,35,11,0,46
2016,Mali,MLI,Italy,ITA,58,2942,3897,0,6897
2016,Morocco,MAR,Italy,ITA,16,129,311,0,456
2016,Montenegro,MNE,Italy,ITA,0,15,11,0,26
2016,Mauritius,MUS,Italy,ITA,0,5,0,0,5
2016,Myanmar,MMR,Italy,ITA,0,0,5,0,5
2016,Nepal,NPL,Italy,ITA,0,20,10,0,30
2016,Niger,NER,Italy,ITA,0,41,120,0,161
2016,Nicaragua,NIC,Italy,ITA,0,5,10,0,15
2016,Nigeria,NGA,Italy,ITA,516,4077,13795,0,18388
2016,Pakistan,PAK,Italy,ITA,461,3829,7332,0,11622
2016,Peru,PER,Italy,ITA,0,11,12,0,23
2016,Philippines,PHL,Italy,ITA,0,10,19,0,29
2016,Russian Federation,RUS,Italy,ITA,5,19,12,0,36
2016,El Salvador,SLV,Italy,ITA,47,79,32,0,158
2016,Serbia and Kosovo: S/RES/1244 (1999),SRB,Italy,ITA,31,193,219,0,443
2016,Senegal,SEN,Italy,ITA,79,1646,4900,0,6625
2016,Sierra Leone,SLE,Italy,ITA,0,86,147,0,233
2016,Somalia,SOM,Italy,ITA,308,1094,46,0,1448
2016,Sudan,SDN,Italy,ITA,62,105,58,0,225
2016,Syrian Arab Rep.,SYR,Italy,ITA,1101,67,16,0,1184
2016,United Rep. of Tanzania,TZA,Italy,ITA,0,5,0,0,5
2016,Tajikistan,TJK,Italy,ITA,5,0,0,0,5
2016,Togo,TGO,Italy,ITA,17,118,281,0,416
2016,Tunisia,TUN,Italy,ITA,5,64,147,0,216
2016,Turkey,TUR,Italy,ITA,52,201,48,0,301
2016,Uganda,UGA,Italy,ITA,10,5,5,0,20
2016,Ukraine,UKR,Italy,ITA,55,1795,1394,0,3244
2016,United States of America,USA,Italy,ITA,0,5,0,0,5
2016,Venezuela (Bolivarian Republic of),VEN,Italy,ITA,5,28,14,0,47
2016,Yemen,YEM,Italy,ITA,0,14,0,0,14
2016,Unknown ,,Italy,ITA,40,300,802,0,1142
2016,Bangladesh,BGD,Japan,JPN,0,0,250,0,250
2016,India,IND,Japan,JPN,0,0,248,0,248
2016,Indonesia,IDN,Japan,JPN,0,0,1742,0,1742
2016,Sri Lanka,LKA,Japan,JPN,0,5,464,0,469
2016,Myanmar,MMR,Japan,JPN,0,0,319,0,319
2016,Nepal,NPL,Japan,JPN,0,0,841,0,841
2016,Pakistan,PAK,Japan,JPN,0,0,241,0,241
2016,Philippines,PHL,Japan,JPN,0,0,775,0,775
2016,Viet Nam,VNM,Japan,JPN,0,0,1213,0,1213
2016,Turkey,TUR,Japan,JPN,0,5,888,0,893
2016,Unknown ,,Japan,JPN,24,58,511,675,1268
2016,Afghanistan,AFG,Kazakhstan,KAZ,67,0,135,0,202
2016,Syrian Arab Rep.,SYR,Kazakhstan,KAZ,5,0,10,0,15
2016,Afghanistan,AFG,Kyrgyzstan,KGZ,16,0,118,31,165
2016,Iraq,IRQ,Kyrgyzstan,KGZ,0,0,5,0,5
2016,Syrian Arab Rep.,SYR,Kyrgyzstan,KGZ,5,0,5,0,10
2016,Ukraine,UKR,Kyrgyzstan,KGZ,5,0,5,5,15
2016,Uzbekistan,UZB,Kyrgyzstan,KGZ,0,0,0,13,13
2016,Eritrea,ERI,Lesotho,LSO,5,0,0,0,5
2016,Ethiopia,ETH,Lesotho,LSO,10,0,0,0,10
2016,China,CHN,Liechtenstein,LIE,11,0,0,0,11
2016,Iraq,IRQ,Liechtenstein,LIE,5,0,0,0,5
2016,North Macedonia,MKD,Liechtenstein,LIE,0,0,10,0,10
2016,Serbia and Kosovo: S/RES/1244 (1999),SRB,Liechtenstein,LIE,0,0,19,0,19
2016,Ukraine,UKR,Liechtenstein,LIE,0,5,0,0,5
2016,Afghanistan,AFG,Lithuania,LTU,5,0,5,11,21
2016,Armenia,ARM,Lithuania,LTU,0,0,5,0,5
2016,Azerbaijan,AZE,Lithuania,LTU,10,0,0,10,20
2016,Belarus,BLR,Lithuania,LTU,0,0,5,11,16
2016,Georgia,GEO,Lithuania,LTU,0,0,10,5,15
2016,Iraq,IRQ,Lithuania,LTU,5,0,10,5,20
2016,Kyrgyzstan,KGZ,Lithuania,LTU,0,0,5,5,10
2016,Lebanon,LBN,Lithuania,LTU,0,0,5,0,5
2016,Russian Federation,RUS,Lithuania,LTU,5,5,18,12,40
2016,Syrian Arab Rep.,SYR,Lithuania,LTU,134,5,0,0,139
2016,Tajikistan,TJK,Lithuania,LTU,5,0,0,0,5
2016,Ukraine,UKR,Lithuania,LTU,0,0,22,13,35
2016,Stateless,XXA,Lithuania,LTU,14,0,0,0,14
2016,Afghanistan,AFG,Luxembourg,LUX,10,5,5,12,32
2016,Albania,ALB,Luxembourg,LUX,0,0,107,5,112
2016,Algeria,DZA,Luxembourg,LUX,0,0,13,40,53
2016,Angola,AGO,Luxembourg,LUX,0,0,0,5,5
2016,Egypt,EGY,Luxembourg,LUX,0,0,0,5,5
2016,Armenia,ARM,Luxembourg,LUX,5,0,0,0,5
2016,Azerbaijan,AZE,Luxembourg,LUX,5,0,0,0,5
2016,Burundi,BDI,Luxembourg,LUX,0,0,0,5,5
2016,Belarus,BLR,Luxembourg,LUX,0,0,10,5,15
2016,Bosnia and Herzegovina,BIH,Luxembourg,LUX,0,0,38,0,38
2016,Cameroon,CMR,Luxembourg,LUX,0,0,5,14,19
2016,Dem. Rep. of the Congo,COD,Luxembourg,LUX,5,0,0,5,10
2016,Eritrea,ERI,Luxembourg,LUX,23,5,0,5,33
2016,Ethiopia,ETH,Luxembourg,LUX,5,0,0,0,5
2016,Gabon,GAB,Luxembourg,LUX,5,0,0,0,5
2016,Gambia,GMB,Luxembourg,LUX,0,0,0,5,5
2016,Palestinian,PSE,Luxembourg,LUX,19,0,0,5,24
2016,Georgia,GEO,Luxembourg,LUX,0,0,0,10,10
2016,Guinea,GIN,Luxembourg,LUX,0,0,0,10,10
2016,Cote d'Ivoire,CIV,Luxembourg,LUX,0,0,5,10,15
2016,Iran (Islamic Rep. of),IRN,Luxembourg,LUX,15,5,0,5,25
2016,Iraq,IRQ,Luxembourg,LUX,93,10,27,26,156
2016,Dem. People's Rep. of Korea,PRK,Luxembourg,LUX,5,0,0,10,15
2016,Liberia,LBR,Luxembourg,LUX,0,0,0,13,13
2016,Libya,LBY,Luxembourg,LUX,0,0,0,5,5
2016,North Macedonia,MKD,Luxembourg,LUX,0,0,5,13,18
2016,Mexico,MEX,Luxembourg,LUX,5,0,0,0,5
2016,Morocco,MAR,Luxembourg,LUX,0,0,10,13,23
2016,Montenegro,MNE,Luxembourg,LUX,0,5,29,0,34
2016,Nigeria,NGA,Luxembourg,LUX,5,0,10,25,40
2016,Russian Federation,RUS,Luxembourg,LUX,0,0,0,10,10
2016,Serbia and Kosovo: S/RES/1244 (1999),SRB,Luxembourg,LUX,0,0,135,29,164
2016,Senegal,SEN,Luxembourg,LUX,0,0,5,0,5
2016,Sierra Leone,SLE,Luxembourg,LUX,0,0,0,5,5
2016,Somalia,SOM,Luxembourg,LUX,5,0,0,14,19
2016,Sudan,SDN,Luxembourg,LUX,0,0,0,5,5
2016,Syrian Arab Rep.,SYR,Luxembourg,LUX,538,0,5,19,562
2016,Togo,TGO,Luxembourg,LUX,5,0,5,10,20
2016,Tunisia,TUN,Luxembourg,LUX,0,0,10,25,35
2016,Ukraine,UKR,Luxembourg,LUX,0,0,10,0,10
2016,Afghanistan,AFG,Latvia,LVA,5,5,24,26,60
2016,Armenia,ARM,Latvia,LVA,0,0,0,5,5
2016,Dem. Rep. of the Congo,COD,Latvia,LVA,0,0,5,0,5
2016,Eritrea,ERI,Latvia,LVA,0,10,0,0,10
2016,Georgia,GEO,Latvia,LVA,0,0,0,35,35
2016,India,IND,Latvia,LVA,0,0,12,10,22
2016,Iran (Islamic Rep. of),IRN,Latvia,LVA,5,0,0,0,5
2016,Iraq,IRQ,Latvia,LVA,23,5,33,12,73
2016,Kazakhstan,KAZ,Latvia,LVA,0,5,0,0,5
2016,Nepal,NPL,Latvia,LVA,0,0,5,5,10
2016,Pakistan,PAK,Latvia,LVA,0,0,18,5,23
2016,Russian Federation,RUS,Latvia,LVA,10,0,10,5,25
2016,Viet Nam,VNM,Latvia,LVA,0,0,0,5,5
2016,Syrian Arab Rep.,SYR,Latvia,LVA,5,68,0,0,73
2016,Tajikistan,TJK,Latvia,LVA,0,0,0,5,5
2016,Ukraine,UKR,Latvia,LVA,0,0,10,0,10
2016,Afghanistan,AFG,Rep. of Moldova,MDA,0,0,10,0,10
2016,Armenia,ARM,Rep. of Moldova,MDA,0,0,5,0,5
2016,Iraq,IRQ,Rep. of Moldova,MDA,0,5,0,0,5
2016,Sri Lanka,LKA,Rep. of Moldova,MDA,0,0,13,0,13
2016,Syrian Arab Rep.,SYR,Rep. of Moldova,MDA,0,18,5,5,28
2016,Tajikistan,TJK,Rep. of Moldova,MDA,5,0,0,0,5
2016,Ukraine,UKR,Rep. of Moldova,MDA,0,5,28,18,51
2016,Albania,ALB,Mexico,MEX,5,0,0,0,5
2016,Cameroon,CMR,Mexico,MEX,0,0,5,10,15
2016,Colombia,COL,Mexico,MEX,12,0,21,5,38
2016,Cuba,CUB,Mexico,MEX,5,0,5,30,40
2016,Ecuador,ECU,Mexico,MEX,0,0,0,16,16
2016,Ghana,GHA,Mexico,MEX,0,0,5,0,5
2016,Guatemala,GTM,Mexico,MEX,151,0,126,102,379
2016,Haiti,HTI,Mexico,MEX,5,0,5,5,15
2016,Honduras,HND,Mexico,MEX,1399,0,1050,1129,3578
2016,Iran (Islamic Rep. of),IRN,Mexico,MEX,0,0,0,5,5
2016,Iraq,IRQ,Mexico,MEX,10,0,0,0,10
2016,Nicaragua,NIC,Mexico,MEX,10,0,30,21,61
2016,Nigeria,NGA,Mexico,MEX,5,0,0,0,5
2016,Russian Federation,RUS,Mexico,MEX,5,0,0,0,5
2016,El Salvador,SLV,Mexico,MEX,1423,0,661,914,2998
2016,Syrian Arab Rep.,SYR,Mexico,MEX,5,0,0,0,5
2016,Togo,TGO,Mexico,MEX,0,0,5,0,5
2016,United States of America,USA,Mexico,MEX,0,0,10,0,10
2016,Venezuela (Bolivarian Republic of),VEN,Mexico,MEX,241,0,0,10,251
2016,Central African Rep.,CAF,Mali,MLI,95,0,5,121,221
2016,Chad,TCD,Mali,MLI,5,0,0,0,5
2016,Congo,COG,Mali,MLI,10,0,0,0,10
2016,Dem. Rep. of the Congo,COD,Mali,MLI,0,0,0,5,5
2016,Syrian Arab Rep.,SYR,Mali,MLI,0,0,0,5,5
2016,Burundi,BDI,Malawi,MWI,87,0,26,979,1092
2016,Dem. Rep. of the Congo,COD,Malawi,MWI,705,0,0,1243,1948
2016,Ethiopia,ETH,Malawi,MWI,0,0,0,5,5
2016,Mozambique,MOZ,Malawi,MWI,0,0,0,6618,6618
2016,Rwanda,RWA,Malawi,MWI,74,0,0,224,298
2016,Somalia,SOM,Malawi,MWI,5,0,0,0,5
2016,Sudan,SDN,Malawi,MWI,0,0,0,5,5
2016,Angola,AGO,Mozambique,MOZ,0,0,0,5,5
2016,Burundi,BDI,Mozambique,MOZ,0,0,0,1231,1231
2016,Dem. Rep. of the Congo,COD,Mozambique,MOZ,0,0,0,184,184
2016,Ethiopia,ETH,Mozambique,MOZ,0,0,0,11,11
2016,Cote d'Ivoire,CIV,Mozambique,MOZ,0,0,0,5,5
2016,Rwanda,RWA,Mozambique,MOZ,0,0,0,261,261
2016,Sierra Leone,SLE,Mozambique,MOZ,0,0,0,5,5
2016,Somalia,SOM,Mozambique,MOZ,0,0,0,1339,1339
2016,Sudan,SDN,Mozambique,MOZ,0,0,0,10,10
2016,Uganda,UGA,Mozambique,MOZ,0,0,0,15,15
2016,Algeria,DZA,Malta,MLT,0,0,5,5,10
2016,Egypt,EGY,Malta,MLT,0,22,12,0,34
2016,Eritrea,ERI,Malta,MLT,5,95,17,5,122
2016,Ethiopia,ETH,Malta,MLT,5,16,0,0,21
2016,Gambia,GMB,Malta,MLT,0,5,0,0,5
2016,Palestinian,PSE,Malta,MLT,0,5,5,5,15
2016,Ghana,GHA,Malta,MLT,0,0,0,5,5
2016,Cote d'Ivoire,CIV,Malta,MLT,0,5,0,0,5
2016,Iran (Islamic Rep. of),IRN,Malta,MLT,5,0,5,0,10
2016,Iraq,IRQ,Malta,MLT,15,0,0,5,20
2016,Libya,LBY,Malta,MLT,92,486,10,88,676
2016,North Macedonia,MKD,Malta,MLT,0,0,5,0,5
2016,Mali,MLI,Malta,MLT,0,0,5,0,5
2016,Nigeria,NGA,Malta,MLT,10,19,5,0,34
2016,Pakistan,PAK,Malta,MLT,0,0,5,0,5
2016,Serbia and Kosovo: S/RES/1244 (1999),SRB,Malta,MLT,0,0,5,0,5
2016,Somalia,SOM,Malta,MLT,10,84,10,5,109
2016,Sudan,SDN,Malta,MLT,0,5,0,0,5
2016,Syrian Arab Rep.,SYR,Malta,MLT,23,317,0,22,362
2016,Ukraine,UKR,Malta,MLT,0,31,0,11,42
2016,United States of America,USA,Malta,MLT,0,0,0,5,5
2016,Venezuela (Bolivarian Republic of),VEN,Malta,MLT,0,0,5,0,5
2016,Afghanistan,AFG,Netherlands,NLD,426,0,838,400,1664
2016,Albania,ALB,Netherlands,NLD,0,0,621,1493,2114
2016,Algeria,DZA,Netherlands,NLD,0,0,158,534,692
2016,Angola,AGO,Netherlands,NLD,0,0,10,11,21
2016,Egypt,EGY,Netherlands,NLD,0,0,0,38,38
2016,Argentina,ARG,Netherlands,NLD,5,0,39,0,44
2016,Armenia,ARM,Netherlands,NLD,0,0,15,25,40
2016,Azerbaijan,AZE,Netherlands,NLD,5,0,10,26,41
2016,Burundi,BDI,Netherlands,NLD,5,0,5,12,22
2016,Bangladesh,BGD,Netherlands,NLD,5,0,16,5,26
2016,Burkina Faso,BFA,Netherlands,NLD,0,0,0,5,5
2016,Belarus,BLR,Netherlands,NLD,0,0,5,40,45
2016,Bosnia and Herzegovina,BIH,Netherlands,NLD,0,0,186,149,335
2016,Chad,TCD,Netherlands,NLD,0,0,5,0,5
2016,China,CHN,Netherlands,NLD,22,0,31,13,66
2016,Cameroon,CMR,Netherlands,NLD,5,0,5,5,15
2016,Congo,COG,Netherlands,NLD,5,0,21,11,37
2016,Colombia,COL,Netherlands,NLD,0,0,15,0,15
2016,Cuba,CUB,Netherlands,NLD,0,0,13,5,18
2016,Djibouti,DJI,Netherlands,NLD,0,0,0,5,5
2016,Eritrea,ERI,Netherlands,NLD,2812,0,145,335,3292
2016,Ethiopia,ETH,Netherlands,NLD,40,0,45,22,107
2016,Gabon,GAB,Netherlands,NLD,0,0,5,5,10
2016,Gambia,GMB,Netherlands,NLD,5,0,19,54,78
2016,Palestinian,PSE,Netherlands,NLD,21,0,5,5,31
2016,Georgia,GEO,Netherlands,NLD,5,0,109,364,478
2016,Ghana,GHA,Netherlands,NLD,0,0,10,11,21
2016,Guinea-Bissau,GNB,Netherlands,NLD,0,0,5,5,10
2016,Guinea,GIN,Netherlands,NLD,20,0,41,30,91
2016,Cote d'Ivoire,CIV,Netherlands,NLD,0,0,10,10,20
2016,India,IND,Netherlands,NLD,5,0,23,32,60
2016,Iran (Islamic Rep. of),IRN,Netherlands,NLD,355,0,349,455,1159
2016,Iraq,IRQ,Netherlands,NLD,795,0,721,839,2355
2016,Jamaica,JAM,Netherlands,NLD,31,0,10,0,41
2016,Jordan,JOR,Netherlands,NLD,5,0,13,10,28
2016,Kazakhstan,KAZ,Netherlands,NLD,0,0,0,17,17
2016,Kyrgyzstan,KGZ,Netherlands,NLD,0,0,0,5,5
2016,Liberia,LBR,Netherlands,NLD,0,0,0,5,5
2016,Libya,LBY,Netherlands,NLD,5,0,49,103,157
2016,Lebanon,LBN,Netherlands,NLD,5,0,28,36,69
2016,Sri Lanka,LKA,Netherlands,NLD,5,0,15,10,30
2016,North Macedonia,MKD,Netherlands,NLD,0,0,172,263,435
2016,Rep. of Moldova,MDA,Netherlands,NLD,0,0,0,13,13
2016,Mali,MLI,Netherlands,NLD,0,0,5,18,23
2016,Mongolia,MNG,Netherlands,NLD,0,0,331,43,374
2016,Morocco,MAR,Netherlands,NLD,18,0,224,743,985
2016,Montenegro,MNE,Netherlands,NLD,0,0,24,10,34
2016,Myanmar,MMR,Netherlands,NLD,27,0,5,0,32
2016,Nepal,NPL,Netherlands,NLD,5,0,15,5,25
2016,Nigeria,NGA,Netherlands,NLD,26,0,103,85,214
2016,Pakistan,PAK,Netherlands,NLD,31,0,59,76,166
2016,South Africa,ZAF,Netherlands,NLD,0,0,10,0,10
2016,Russian Federation,RUS,Netherlands,NLD,18,0,48,87,153
2016,Rwanda,RWA,Netherlands,NLD,0,0,0,5,5
2016,El Salvador,SLV,Netherlands,NLD,0,0,5,5,10
2016,Saudi Arabia,SAU,Netherlands,NLD,0,0,0,5,5
2016,Serbia and Kosovo: S/RES/1244 (1999),SRB,Netherlands,NLD,0,0,657,1093,1750
2016,Senegal,SEN,Netherlands,NLD,0,0,11,34,45
2016,Sierra Leone,SLE,Netherlands,NLD,5,0,21,17,43
2016,Somalia,SOM,Netherlands,NLD,58,0,78,73,209
2016,Viet Nam,VNM,Netherlands,NLD,0,0,32,0,32
2016,Sudan,SDN,Netherlands,NLD,104,0,72,40,216
2016,Suriname,SUR,Netherlands,NLD,0,0,5,0,5
2016,Syrian Arab Rep.,SYR,Netherlands,NLD,12312,0,576,1018,13906
2016,United Rep. of Tanzania,TZA,Netherlands,NLD,0,0,5,0,5
2016,Tajikistan,TJK,Netherlands,NLD,0,0,5,19,24
2016,Trinidad and Tobago,TTO,Netherlands,NLD,18,0,0,0,18
2016,Tunisia,TUN,Netherlands,NLD,0,0,37,105,142
2016,Turkey,TUR,Netherlands,NLD,5,0,33,26,64
2016,Uganda,UGA,Netherlands,NLD,38,0,21,11,70
2016,Ukraine,UKR,Netherlands,NLD,5,0,171,361,537
2016,United States of America,USA,Netherlands,NLD,0,0,0,5,5
2016,Venezuela (Bolivarian Republic of),VEN,Netherlands,NLD,0,0,12,0,12
2016,Yemen,YEM,Netherlands,NLD,5,0,0,21,26
2016,Zimbabwe,ZWE,Netherlands,NLD,0,0,10,0,10
2016,Stateless,XXA,Netherlands,NLD,1654,0,86,132,1872
2016,Unknown ,,Netherlands,NLD,295,0,104,121,520
2016,Central African Rep.,CAF,Niger,NER,32,0,0,0,32
2016,Dem. Rep. of the Congo,COD,Niger,NER,5,0,0,0,5
2016,Libya,LBY,Niger,NER,5,0,0,0,5
2016,Nigeria,NGA,Niger,NER,0,0,0,10,10
2016,Central African Rep.,CAF,Nigeria,NGA,15,0,0,0,15
2016,Chad,TCD,Nigeria,NGA,0,0,0,10,10
2016,Dem. Rep. of the Congo,COD,Nigeria,NGA,15,0,0,0,15
2016,Eritrea,ERI,Nigeria,NGA,10,0,0,0,10
2016,Palestinian,PSE,Nigeria,NGA,5,0,0,0,5
2016,Cote d'Ivoire,CIV,Nigeria,NGA,0,0,10,0,10
2016,Mali,MLI,Nigeria,NGA,0,0,5,5,10
2016,Sudan,SDN,Nigeria,NGA,5,0,0,0,5
2016,Syrian Arab Rep.,SYR,Nigeria,NGA,54,0,0,0,54
2016,Togo,TGO,Nigeria,NGA,0,0,5,0,5
2016,Afghanistan,AFG,Norway,NOR,552,324,2775,727,4378
2016,Albania,ALB,Norway,NOR,0,0,103,30,133
2016,Algeria,DZA,Norway,NOR,0,0,13,39,52
2016,Angola,AGO,Norway,NOR,0,0,0,5,5
2016,Egypt,EGY,Norway,NOR,27,0,127,113,267
2016,Armenia,ARM,Norway,NOR,0,0,0,5,5
2016,Azerbaijan,AZE,Norway,NOR,5,0,5,11,21
2016,Burundi,BDI,Norway,NOR,5,0,5,5,15
2016,Bangladesh,BGD,Norway,NOR,0,0,26,60,86
2016,Belarus,BLR,Norway,NOR,0,0,5,10,15
2016,Bosnia and Herzegovina,BIH,Norway,NOR,0,0,5,5,10
2016,China,CHN,Norway,NOR,24,0,5,11,40
2016,Cameroon,CMR,Norway,NOR,5,0,10,0,15
2016,Congo,COG,Norway,NOR,0,0,0,5,5
2016,Dem. Rep. of the Congo,COD,Norway,NOR,5,0,0,5,10
2016,Colombia,COL,Norway,NOR,0,0,5,0,5
2016,Djibouti,DJI,Norway,NOR,0,0,5,5,10
2016,Eritrea,ERI,Norway,NOR,1558,0,25,73,1656
2016,Ethiopia,ETH,Norway,NOR,217,0,278,40,535
2016,Gambia,GMB,Norway,NOR,0,0,25,13,38
2016,United Kingdom of Great Britain and Northern Ireland,GBR,Norway,NOR,0,0,5,0,5
2016,Georgia,GEO,Norway,NOR,0,0,5,5,10
2016,Germany,DEU,Norway,NOR,0,0,5,0,5
2016,Ghana,GHA,Norway,NOR,0,0,5,5,10
2016,Guinea,GIN,Norway,NOR,0,0,12,5,17
2016,Cote d'Ivoire,CIV,Norway,NOR,0,0,5,0,5
2016,India,IND,Norway,NOR,0,0,12,36,48
2016,Iran (Islamic Rep. of),IRN,Norway,NOR,490,0,269,188,947
2016,Iraq,IRQ,Norway,NOR,187,34,1060,930,2211
2016,Israel,ISR,Norway,NOR,0,0,5,0,5
2016,Jordan,JOR,Norway,NOR,0,0,10,12,22
2016,Kazakhstan,KAZ,Norway,NOR,0,0,0,5,5
2016,Kenya,KEN,Norway,NOR,0,0,5,0,5
2016,Kyrgyzstan,KGZ,Norway,NOR,0,0,0,10,10
2016,Libya,LBY,Norway,NOR,0,5,5,27,37
2016,Lebanon,LBN,Norway,NOR,10,0,69,43,122
2016,Sri Lanka,LKA,Norway,NOR,0,0,12,5,17
2016,Mauritania,MRT,Norway,NOR,0,0,0,5,5
2016,North Macedonia,MKD,Norway,NOR,0,0,16,11,27
2016,Rep. of Moldova,MDA,Norway,NOR,0,0,5,0,5
2016,Mali,MLI,Norway,NOR,0,0,0,5,5
2016,Mongolia,MNG,Norway,NOR,0,0,10,0,10
2016,Morocco,MAR,Norway,NOR,0,0,30,71,101
2016,Nepal,NPL,Norway,NOR,0,0,5,25,30
2016,Nigeria,NGA,Norway,NOR,5,0,25,37,67
2016,Pakistan,PAK,Norway,NOR,12,0,91,181,284
2016,Philippines,PHL,Norway,NOR,0,0,5,0,5
2016,Romania,ROU,Norway,NOR,0,0,10,0,10
2016,Russian Federation,RUS,Norway,NOR,0,0,35,33,68
2016,El Salvador,SLV,Norway,NOR,0,0,5,0,5
2016,Saudi Arabia,SAU,Norway,NOR,0,0,0,10,10
2016,Serbia and Kosovo: S/RES/1244 (1999),SRB,Norway,NOR,0,0,43,12,55
2016,Senegal,SEN,Norway,NOR,0,0,18,5,23
2016,Somalia,SOM,Norway,NOR,61,11,223,54,349
2016,Viet Nam,VNM,Norway,NOR,0,0,5,0,5
2016,Sudan,SDN,Norway,NOR,347,0,67,33,447
2016,Syrian Arab Rep.,SYR,Norway,NOR,7393,0,11,1133,8537
2016,Tajikistan,TJK,Norway,NOR,0,0,14,5,19
2016,Tunisia,TUN,Norway,NOR,0,0,5,10,15
2016,Turkey,TUR,Norway,NOR,5,0,18,23,46
2016,Uganda,UGA,Norway,NOR,5,0,5,5,15
2016,Ukraine,UKR,Norway,NOR,0,0,14,31,45
2016,Uzbekistan,UZB,Norway,NOR,12,5,10,10,37
2016,Venezuela (Bolivarian Republic of),VEN,Norway,NOR,0,0,5,0,5
2016,Yemen,YEM,Norway,NOR,5,10,0,18,33
2016,Zimbabwe,ZWE,Norway,NOR,0,0,0,5,5
2016,Stateless,XXA,Norway,NOR,528,5,184,219,936
2016,Afghanistan,AFG,New Zealand,NZL,0,0,5,0,5
2016,Egypt,EGY,New Zealand,NZL,0,0,5,0,5
2016,Bangladesh,BGD,New Zealand,NZL,0,0,14,0,14
2016,Bulgaria,BGR,New Zealand,NZL,0,0,5,0,5
2016,China,CHN,New Zealand,NZL,14,0,13,0,27
2016,Chile,CHL,New Zealand,NZL,5,0,0,0,5
2016,Dem. Rep. of the Congo,COD,New Zealand,NZL,0,0,5,0,5
2016,Colombia,COL,New Zealand,NZL,0,0,5,0,5
2016,Fiji,FJI,New Zealand,NZL,5,0,20,0,25
2016,Georgia,GEO,New Zealand,NZL,0,0,5,0,5
2016,India,IND,New Zealand,NZL,0,0,22,0,22
2016,Iran (Islamic Rep. of),IRN,New Zealand,NZL,10,0,17,0,27
2016,Iraq,IRQ,New Zealand,NZL,18,0,5,0,23
2016,Sri Lanka,LKA,New Zealand,NZL,0,0,20,0,20
2016,Maldives,MDV,New Zealand,NZL,5,0,0,0,5
2016,Malaysia,MYS,New Zealand,NZL,5,0,5,0,10
2016,Nepal,NPL,New Zealand,NZL,0,0,5,0,5
2016,Pakistan,PAK,New Zealand,NZL,11,0,11,0,22
2016,Philippines,PHL,New Zealand,NZL,0,0,5,0,5
2016,South Africa,ZAF,New Zealand,NZL,0,0,16,0,16
2016,Saudi Arabia,SAU,New Zealand,NZL,5,0,10,0,15
2016,Somalia,SOM,New Zealand,NZL,0,0,5,0,5
2016,Syrian Arab Rep.,SYR,New Zealand,NZL,10,0,0,0,10
2016,Tonga,TON,New Zealand,NZL,0,0,5,0,5
2016,Turkey,TUR,New Zealand,NZL,10,0,5,0,15
2016,Tuvalu,TUV,New Zealand,NZL,0,0,5,0,5
2016,Uganda,UGA,New Zealand,NZL,0,0,5,0,5
2016,Angola,AGO,Panama,PAN,0,0,0,5,5
2016,Congo,COG,Panama,PAN,0,0,0,5,5
2016,Colombia,COL,Panama,PAN,23,0,5,648,676
2016,Cuba,CUB,Panama,PAN,0,0,0,137,137
2016,Dominican Rep.,DOM,Panama,PAN,0,0,0,27,27
2016,Ethiopia,ETH,Panama,PAN,0,0,0,5,5
2016,Ghana,GHA,Panama,PAN,0,0,0,5,5
2016,Guatemala,GTM,Panama,PAN,0,0,0,5,5
2016,Haiti,HTI,Panama,PAN,5,0,0,42,47
2016,Honduras,HND,Panama,PAN,0,0,0,35,35
2016,Nicaragua,NIC,Panama,PAN,0,0,0,417,417
2016,Pakistan,PAK,Panama,PAN,0,0,0,5,5
2016,El Salvador,SLV,Panama,PAN,0,0,0,117,117
2016,Syrian Arab Rep.,SYR,Panama,PAN,0,0,0,5,5
2016,Venezuela (Bolivarian Republic of),VEN,Panama,PAN,0,0,0,449,449
2016,Dem. Rep. of the Congo,COD,Paraguay,PRY,0,0,0,5,5
2016,Cuba,CUB,Paraguay,PRY,0,0,5,5,10
2016,Syrian Arab Rep.,SYR,Paraguay,PRY,22,0,0,5,27
2016,Turkey,TUR,Paraguay,PRY,5,0,0,0,5
2016,Venezuela (Bolivarian Republic of),VEN,Paraguay,PRY,5,0,0,0,5
2016,Bangladesh,BGD,Peru,PER,0,0,5,0,5
2016,Dem. Rep. of the Congo,COD,Peru,PER,5,0,0,0,5
2016,Colombia,COL,Peru,PER,32,0,32,13,77
2016,Cuba,CUB,Peru,PER,18,0,33,5,56
2016,Dominican Rep.,DOM,Peru,PER,5,0,12,0,17
2016,Palestinian,PSE,Peru,PER,5,0,0,0,5
2016,Ghana,GHA,Peru,PER,0,0,5,0,5
2016,Haiti,HTI,Peru,PER,20,0,0,0,20
2016,India,IND,Peru,PER,5,0,0,0,5
2016,Philippines,PHL,Peru,PER,0,0,5,0,5
2016,Syrian Arab Rep.,SYR,Peru,PER,5,0,0,0,5
2016,Ukraine,UKR,Peru,PER,5,0,0,0,5
2016,Venezuela (Bolivarian Republic of),VEN,Peru,PER,64,0,69,28,161
2016,Bangladesh,BGD,Papua New Guinea,PNG,0,0,5,0,5
2016,India,IND,Papua New Guinea,PNG,0,0,5,0,5
2016,Iran (Islamic Rep. of),IRN,Papua New Guinea,PNG,14,0,93,0,107
2016,Iraq,IRQ,Papua New Guinea,PNG,0,0,5,0,5
2016,Lebanon,LBN,Papua New Guinea,PNG,0,0,5,0,5
2016,Pakistan,PAK,Papua New Guinea,PNG,5,0,5,0,10
2016,Somalia,SOM,Papua New Guinea,PNG,5,0,0,0,5
2016,Afghanistan,AFG,Poland,POL,0,0,5,11,16
2016,Algeria,DZA,Poland,POL,0,0,0,5,5
2016,Egypt,EGY,Poland,POL,5,0,5,10,20
2016,Armenia,ARM,Poland,POL,0,0,14,296,310
2016,Azerbaijan,AZE,Poland,POL,0,0,5,5,10
2016,Belarus,BLR,Poland,POL,5,0,10,16,31
2016,China,CHN,Poland,POL,5,0,0,10,15
2016,Congo,COG,Poland,POL,0,0,0,5,5
2016,Georgia,GEO,Poland,POL,0,0,36,99,135
2016,Iran (Islamic Rep. of),IRN,Poland,POL,0,0,0,20,20
2016,Iraq,IRQ,Poland,POL,5,15,5,5,30
2016,Kazakhstan,KAZ,Poland,POL,0,0,15,17,32
2016,Kyrgyzstan,KGZ,Poland,POL,0,0,31,54,85
2016,Libya,LBY,Poland,POL,0,5,0,5,10
2016,Lebanon,LBN,Poland,POL,0,0,0,5,5
2016,Sri Lanka,LKA,Poland,POL,0,0,0,5,5
2016,Rep. of Moldova,MDA,Poland,POL,0,0,5,0,5
2016,Morocco,MAR,Poland,POL,0,0,0,5,5
2016,Nigeria,NGA,Poland,POL,0,0,5,5,10
2016,Pakistan,PAK,Poland,POL,0,0,10,16,26
2016,Russian Federation,RUS,Poland,POL,10,57,1125,7701,8893
2016,Viet Nam,VNM,Poland,POL,0,0,51,29,80
2016,Syrian Arab Rep.,SYR,Poland,POL,40,5,0,20,65
2016,Tajikistan,TJK,Poland,POL,5,5,109,649,768
2016,Turkmenistan,TKM,Poland,POL,10,0,0,0,10
2016,Turkey,TUR,Poland,POL,0,0,26,37,63
2016,Ukraine,UKR,Poland,POL,16,51,696,434,1197
2016,Uzbekistan,UZB,Poland,POL,0,0,11,16,27
2016,Stateless,XXA,Poland,POL,5,0,0,10,15
2016,Afghanistan,AFG,Portugal,PRT,0,0,0,5,5
2016,Algeria,DZA,Portugal,PRT,0,0,0,10,10
2016,Angola,AGO,Portugal,PRT,0,0,5,19,24
2016,Bangladesh,BGD,Portugal,PRT,0,0,0,11,11
2016,Belarus,BLR,Portugal,PRT,0,0,0,5,5
2016,Brazil,BRA,Portugal,PRT,0,0,0,10,10
2016,China,CHN,Portugal,PRT,0,0,39,0,39
2016,Cameroon,CMR,Portugal,PRT,0,0,0,5,5
2016,Congo,COG,Portugal,PRT,0,0,5,25,30
2016,Dem. Rep. of the Congo,COD,Portugal,PRT,0,0,0,35,35
2016,Comoros,COM,Portugal,PRT,0,0,0,5,5
2016,Colombia,COL,Portugal,PRT,0,0,0,5,5
2016,Eritrea,ERI,Portugal,PRT,30,0,0,123,153
2016,Gambia,GMB,Portugal,PRT,0,0,0,17,17
2016,Ghana,GHA,Portugal,PRT,0,0,0,5,5
2016,Guinea-Bissau,GNB,Portugal,PRT,0,0,0,5,5
2016,Guinea,GIN,Portugal,PRT,5,0,5,43,53
2016,Cote d'Ivoire,CIV,Portugal,PRT,0,0,5,0,5
2016,India,IND,Portugal,PRT,0,0,0,5,5
2016,Iran (Islamic Rep. of),IRN,Portugal,PRT,10,0,0,5,15
2016,Iraq,IRQ,Portugal,PRT,0,12,0,34,46
2016,Sri Lanka,LKA,Portugal,PRT,0,0,0,5,5
2016,Mauritania,MRT,Portugal,PRT,0,0,0,5,5
2016,Mali,MLI,Portugal,PRT,0,0,0,21,21
2016,Morocco,MAR,Portugal,PRT,0,0,5,0,5
2016,Nigeria,NGA,Portugal,PRT,0,0,0,5,5
2016,Pakistan,PAK,Portugal,PRT,10,10,25,27,72
2016,Russian Federation,RUS,Portugal,PRT,0,0,5,5,10
2016,Serbia and Kosovo: S/RES/1244 (1999),SRB,Portugal,PRT,0,0,0,5,5
2016,Senegal,SEN,Portugal,PRT,0,0,0,26,26
2016,Sierra Leone,SLE,Portugal,PRT,0,0,0,13,13
2016,Syrian Arab Rep.,SYR,Portugal,PRT,31,34,0,96,161
2016,Ukraine,UKR,Portugal,PRT,5,190,5,60,260
2016,Venezuela (Bolivarian Republic of),VEN,Portugal,PRT,0,0,0,11,11
2016,Afghanistan,AFG,Romania,ROU,14,0,32,44,90
2016,Albania,ALB,Romania,ROU,0,0,0,10,10
2016,Algeria,DZA,Romania,ROU,0,0,0,5,5
2016,Egypt,EGY,Romania,ROU,0,5,5,0,10
2016,Burundi,BDI,Romania,ROU,5,0,0,0,5
2016,Bangladesh,BGD,Romania,ROU,0,0,10,5,15
2016,Central African Rep.,CAF,Romania,ROU,5,0,0,0,5
2016,China,CHN,Romania,ROU,0,0,5,0,5
2016,Cameroon,CMR,Romania,ROU,0,0,10,0,10
2016,Dem. Rep. of the Congo,COD,Romania,ROU,0,0,5,0,5
2016,Eritrea,ERI,Romania,ROU,42,0,0,0,42
2016,Ethiopia,ETH,Romania,ROU,5,0,0,0,5
2016,Palestinian,PSE,Romania,ROU,5,5,0,0,10
2016,India,IND,Romania,ROU,0,0,5,0,5
2016,Iran (Islamic Rep. of),IRN,Romania,ROU,0,0,5,12,17
2016,Iraq,IRQ,Romania,ROU,92,40,37,95,264
2016,Jordan,JOR,Romania,ROU,0,0,5,0,5
2016,Libya,LBY,Romania,ROU,0,0,0,5,5
2016,Sri Lanka,LKA,Romania,ROU,0,0,5,0,5
2016,Rep. of Moldova,MDA,Romania,ROU,0,0,5,0,5
2016,Morocco,MAR,Romania,ROU,0,0,0,5,5
2016,Nigeria,NGA,Romania,ROU,0,0,0,5,5
2016,Pakistan,PAK,Romania,ROU,0,0,39,14,53
2016,Philippines,PHL,Romania,ROU,0,0,10,0,10
2016,Serbia and Kosovo: S/RES/1244 (1999),SRB,Romania,ROU,0,0,5,17,22
2016,Somalia,SOM,Romania,ROU,13,0,0,5,18
2016,Viet Nam,VNM,Romania,ROU,0,0,5,5,10
2016,Syrian Arab Rep.,SYR,Romania,ROU,358,143,5,149,655
2016,Turkey,TUR,Romania,ROU,0,0,20,13,33
2016,Ukraine,UKR,Romania,ROU,5,0,0,5,10
2016,Yemen,YEM,Romania,ROU,14,5,5,0,24
2016,Stateless,XXA,Romania,ROU,31,0,5,0,36
2016,Algeria,DZA,South Africa,ZAF,0,0,19,0,19
2016,Angola,AGO,South Africa,ZAF,0,0,5,0,5
2016,Egypt,EGY,South Africa,ZAF,0,0,113,0,113
2016,Burundi,BDI,South Africa,ZAF,80,0,1547,0,1627
2016,Benin,BEN,South Africa,ZAF,0,0,21,0,21
2016,Bangladesh,BGD,South Africa,ZAF,17,0,2575,0,2592
2016,China,CHN,South Africa,ZAF,0,0,148,0,148
2016,Cameroon,CMR,South Africa,ZAF,5,0,152,0,157
2016,Congo,COG,South Africa,ZAF,196,0,747,0,943
2016,Dem. Rep. of the Congo,COD,South Africa,ZAF,1130,0,5875,0,7005
2016,Eritrea,ERI,South Africa,ZAF,78,0,181,0,259
2016,Ethiopia,ETH,South Africa,ZAF,323,0,7460,0,7783
2016,Gabon,GAB,South Africa,ZAF,0,0,13,0,13
2016,Gambia,GMB,South Africa,ZAF,0,0,5,0,5
2016,Palestinian,PSE,South Africa,ZAF,0,0,5,0,5
2016,Ghana,GHA,South Africa,ZAF,0,0,984,0,984
2016,Guinea-Bissau,GNB,South Africa,ZAF,0,0,5,0,5
2016,Guinea,GIN,South Africa,ZAF,0,0,12,0,12
2016,Cote d'Ivoire,CIV,South Africa,ZAF,5,0,26,0,31
2016,India,IND,South Africa,ZAF,0,0,653,0,653
2016,Iraq,IRQ,South Africa,ZAF,0,0,5,0,5
2016,Jordan,JOR,South Africa,ZAF,0,0,5,0,5
2016,Kenya,KEN,South Africa,ZAF,5,0,179,0,184
2016,Liberia,LBR,South Africa,ZAF,0,0,25,0,25
2016,Libya,LBY,South Africa,ZAF,0,0,5,0,5
2016,Lesotho,LSO,South Africa,ZAF,0,0,22,0,22
2016,Sri Lanka,LKA,South Africa,ZAF,0,0,5,0,5
2016,Mali,MLI,South Africa,ZAF,0,0,18,0,18
2016,Malawi,MWI,South Africa,ZAF,0,0,1642,0,1642
2016,Morocco,MAR,South Africa,ZAF,0,0,5,0,5
2016,Mozambique,MOZ,South Africa,ZAF,0,0,470,0,470
2016,Nepal,NPL,South Africa,ZAF,0,0,62,0,62
2016,Niger,NER,South Africa,ZAF,0,0,18,0,18
2016,Nigeria,NGA,South Africa,ZAF,0,0,3096,0,3096
2016,Pakistan,PAK,South Africa,ZAF,0,0,1195,0,1195
2016,Rwanda,RWA,South Africa,ZAF,48,0,139,0,187
2016,Senegal,SEN,South Africa,ZAF,0,0,189,0,189
2016,Somalia,SOM,South Africa,ZAF,1169,0,904,0,2073
2016,Sudan,SDN,South Africa,ZAF,5,0,10,0,15
2016,Eswatini,SWZ,South Africa,ZAF,0,0,22,0,22
2016,Syrian Arab Rep.,SYR,South Africa,ZAF,12,0,12,0,24
2016,United Rep. of Tanzania,TZA,South Africa,ZAF,0,0,335,0,335
2016,Thailand,THA,South Africa,ZAF,0,0,41,0,41
2016,Togo,TGO,South Africa,ZAF,0,0,5,0,5
2016,Tunisia,TUN,South Africa,ZAF,0,0,5,0,5
2016,Turkey,TUR,South Africa,ZAF,5,0,0,0,5
2016,Uganda,UGA,South Africa,ZAF,5,0,851,0,856
2016,Yemen,YEM,South Africa,ZAF,0,0,5,0,5
2016,Zambia,ZMB,South Africa,ZAF,0,0,114,0,114
2016,Zimbabwe,ZWE,South Africa,ZAF,73,0,7869,0,7942
2016,Unknown ,,South Africa,ZAF,0,0,260,254801,255061
2016,Afghanistan,AFG,Russian Federation,RUS,0,0,0,276,276
2016,Egypt,EGY,Russian Federation,RUS,0,0,0,5,5
2016,Armenia,ARM,Russian Federation,RUS,0,0,0,5,5
2016,Azerbaijan,AZE,Russian Federation,RUS,0,0,0,11,11
2016,Belarus,BLR,Russian Federation,RUS,0,0,0,20,20
2016,Cameroon,CMR,Russian Federation,RUS,0,0,0,5,5
2016,Dem. Rep. of the Congo,COD,Russian Federation,RUS,0,0,0,12,12
2016,Palestinian,PSE,Russian Federation,RUS,0,0,0,10,10
2016,Georgia,GEO,Russian Federation,RUS,0,0,0,39,39
2016,India,IND,Russian Federation,RUS,0,0,0,5,5
2016,Iran (Islamic Rep. of),IRN,Russian Federation,RUS,0,0,0,5,5
2016,Iraq,IRQ,Russian Federation,RUS,0,0,0,22,22
2016,Kazakhstan,KAZ,Russian Federation,RUS,0,0,0,5,5
2016,Kyrgyzstan,KGZ,Russian Federation,RUS,0,0,0,14,14
2016,Dem. People's Rep. of Korea,PRK,Russian Federation,RUS,0,0,0,31,31
2016,Lebanon,LBN,Russian Federation,RUS,0,0,0,5,5
2016,Rep. of Moldova,MDA,Russian Federation,RUS,0,0,0,10,10
2016,Pakistan,PAK,Russian Federation,RUS,0,0,0,10,10
2016,Sudan,SDN,Russian Federation,RUS,0,0,0,5,5
2016,Syrian Arab Rep.,SYR,Russian Federation,RUS,0,0,0,362,362
2016,Tajikistan,TJK,Russian Federation,RUS,0,0,0,19,19
2016,Turkmenistan,TKM,Russian Federation,RUS,0,0,0,5,5
2016,Turkey,TUR,Russian Federation,RUS,0,0,0,5,5
2016,Ukraine,UKR,Russian Federation,RUS,33,0,0,302,335
2016,United States of America,USA,Russian Federation,RUS,0,0,0,10,10
2016,Uzbekistan,UZB,Russian Federation,RUS,0,0,0,34,34
2016,Yemen,YEM,Russian Federation,RUS,0,0,0,21,21
2016,Stateless,XXA,Russian Federation,RUS,0,0,0,5,5
2016,Afghanistan,AFG,El Salvador,SLV,0,0,0,5,5
2016,Afghanistan,AFG,Serbia and Kosovo: S/RES/1244 (1999),SRB,0,5,0,368,373
2016,Bangladesh,BGD,Serbia and Kosovo: S/RES/1244 (1999),SRB,0,0,0,5,5
2016,Bosnia and Herzegovina,BIH,Serbia and Kosovo: S/RES/1244 (1999),SRB,0,0,0,5,5
2016,Cameroon,CMR,Serbia and Kosovo: S/RES/1244 (1999),SRB,0,0,0,5,5
2016,Cuba,CUB,Serbia and Kosovo: S/RES/1244 (1999),SRB,5,0,0,0,5
2016,Palestinian,PSE,Serbia and Kosovo: S/RES/1244 (1999),SRB,0,0,0,12,12
2016,Ghana,GHA,Serbia and Kosovo: S/RES/1244 (1999),SRB,0,0,0,5,5
2016,Croatia,HRV,Serbia and Kosovo: S/RES/1244 (1999),SRB,0,0,0,5,5
2016,Iran (Islamic Rep. of),IRN,Serbia and Kosovo: S/RES/1244 (1999),SRB,0,0,0,19,19
2016,Iraq,IRQ,Serbia and Kosovo: S/RES/1244 (1999),SRB,0,0,0,149,149
2016,Libya,LBY,Serbia and Kosovo: S/RES/1244 (1999),SRB,5,10,25,10,50
2016,North Macedonia,MKD,Serbia and Kosovo: S/RES/1244 (1999),SRB,0,0,5,5,10
2016,Morocco,MAR,Serbia and Kosovo: S/RES/1244 (1999),SRB,0,0,0,5,5
2016,Pakistan,PAK,Serbia and Kosovo: S/RES/1244 (1999),SRB,0,0,5,65,70
2016,Russian Federation,RUS,Serbia and Kosovo: S/RES/1244 (1999),SRB,0,0,5,10,15
2016,Sudan,SDN,Serbia and Kosovo: S/RES/1244 (1999),SRB,5,0,0,5,10
2016,Syrian Arab Rep.,SYR,Serbia and Kosovo: S/RES/1244 (1999),SRB,0,5,0,157,162
2016,Ukraine,UKR,Serbia and Kosovo: S/RES/1244 (1999),SRB,0,5,0,0,5
2016,Stateless,XXA,Serbia and Kosovo: S/RES/1244 (1999),SRB,0,0,0,5,5
2016,Sudan,SDN,Sierra Leone,SLE,0,0,0,5,5
2016,Afghanistan,AFG,Spain,ESP,14,27,5,0,46
2016,Algeria,DZA,Spain,ESP,5,0,401,0,406
2016,Egypt,EGY,Spain,ESP,0,0,13,0,13
2016,Armenia,ARM,Spain,ESP,0,0,10,0,10
2016,Benin,BEN,Spain,ESP,5,0,0,0,5
2016,Bangladesh,BGD,Spain,ESP,5,0,0,0,5
2016,Burkina Faso,BFA,Spain,ESP,0,0,5,0,5
2016,Brazil,BRA,Spain,ESP,0,0,5,0,5
2016,Central African Rep.,CAF,Spain,ESP,0,16,0,0,16
2016,China,CHN,Spain,ESP,5,0,0,0,5
2016,Cameroon,CMR,Spain,ESP,23,0,19,0,42
2016,Dem. Rep. of the Congo,COD,Spain,ESP,0,0,17,0,17
2016,Colombia,COL,Spain,ESP,5,0,93,0,98
2016,Cuba,CUB,Spain,ESP,0,5,16,0,21
2016,Ecuador,ECU,Spain,ESP,0,0,5,0,5
2016,Eritrea,ERI,Spain,ESP,42,5,0,0,47
2016,Ethiopia,ETH,Spain,ESP,0,5,0,0,5
2016,Gambia,GMB,Spain,ESP,5,0,10,0,15
2016,Palestinian,PSE,Spain,ESP,29,63,19,0,111
2016,Georgia,GEO,Spain,ESP,0,0,10,0,10
2016,Guinea-Bissau,GNB,Spain,ESP,0,0,5,0,5
2016,Guinea,GIN,Spain,ESP,0,0,32,0,32
2016,Honduras,HND,Spain,ESP,0,0,5,0,5
2016,Cote d'Ivoire,CIV,Spain,ESP,0,5,10,0,15
2016,Iran (Islamic Rep. of),IRN,Spain,ESP,10,5,17,0,32
2016,Iraq,IRQ,Spain,ESP,27,57,0,0,84
2016,Israel,ISR,Spain,ESP,0,0,5,0,5
2016,Lebanon,LBN,Spain,ESP,0,5,5,0,10
2016,Sri Lanka,LKA,Spain,ESP,0,0,5,0,5
2016,Mexico,MEX,Spain,ESP,5,0,0,0,5
2016,Mali,MLI,Spain,ESP,0,0,1016,0,1016
2016,Morocco,MAR,Spain,ESP,10,0,76,0,86
2016,Nigeria,NGA,Spain,ESP,22,0,21,0,43
2016,Pakistan,PAK,Spain,ESP,43,0,46,0,89
2016,Peru,PER,Spain,ESP,0,0,10,0,10
2016,Russian Federation,RUS,Spain,ESP,13,0,24,0,37
2016,El Salvador,SLV,Spain,ESP,0,0,10,0,10
2016,Serbia and Kosovo: S/RES/1244 (1999),SRB,Spain,ESP,0,0,10,0,10
2016,Senegal,SEN,Spain,ESP,0,0,5,0,5
2016,Sierra Leone,SLE,Spain,ESP,0,0,5,0,5
2016,Somalia,SOM,Spain,ESP,10,91,10,0,111
2016,Sudan,SDN,Spain,ESP,0,0,5,0,5
2016,Syrian Arab Rep.,SYR,Spain,ESP,53,6160,59,0,6272
2016,Togo,TGO,Spain,ESP,0,0,5,0,5
2016,Tunisia,TUN,Spain,ESP,0,0,12,0,12
2016,Ukraine,UKR,Spain,ESP,16,50,345,0,411
2016,Venezuela (Bolivarian Republic of),VEN,Spain,ESP,5,0,0,0,5
2016,Western Sahara,ESH,Spain,ESP,0,0,5,0,5
2016,Yemen,YEM,Spain,ESP,5,0,0,0,5
2016,Tibetan,TIB,Spain,ESP,5,0,0,0,5
2016,United States of America,USA,Saint Kitts and Nevis,KNA,0,0,5,0,5
2016,Egypt,EGY,Sudan,SDN,0,0,0,5,5
2016,Burundi,BDI,Sudan,SDN,5,0,0,0,5
2016,Cameroon,CMR,Sudan,SDN,5,0,0,0,5
2016,Dem. Rep. of the Congo,COD,Sudan,SDN,5,0,0,0,5
2016,Eritrea,ERI,Sudan,SDN,4273,5,5,37,4320
2016,Ethiopia,ETH,Sudan,SDN,308,10,76,43,437
2016,Somalia,SOM,Sudan,SDN,28,0,0,0,28
2016,Syrian Arab Rep.,SYR,Sudan,SDN,5,0,0,5,10
2016,Afghanistan,AFG,Slovakia,SVK,5,5,5,5,20
2016,Algeria,DZA,Slovakia,SVK,0,0,5,0,5
2016,India,IND,Slovakia,SVK,0,0,5,5,10
2016,Iran (Islamic Rep. of),IRN,Slovakia,SVK,0,0,0,5,5
2016,Iraq,IRQ,Slovakia,SVK,152,0,0,0,152
2016,Nigeria,NGA,Slovakia,SVK,0,0,5,0,5
2016,Pakistan,PAK,Slovakia,SVK,0,0,11,0,11
2016,Syrian Arab Rep.,SYR,Slovakia,SVK,5,5,0,5,15
2016,Ukraine,UKR,Slovakia,SVK,0,0,11,5,16
2016,Afghanistan,AFG,Slovenia,SVN,0,12,82,248,342
2016,Albania,ALB,Slovenia,SVN,0,0,0,5,5
2016,Algeria,DZA,Slovenia,SVN,0,0,15,19,34
2016,Egypt,EGY,Slovenia,SVN,0,0,5,0,5
2016,Cuba,CUB,Slovenia,SVN,0,0,0,5,5
2016,Eritrea,ERI,Slovenia,SVN,22,0,0,5,27
2016,Iran (Islamic Rep. of),IRN,Slovenia,SVN,12,0,22,26,60
2016,Iraq,IRQ,Slovenia,SVN,29,0,26,70,125
2016,Kazakhstan,KAZ,Slovenia,SVN,5,0,0,0,5
2016,Libya,LBY,Slovenia,SVN,0,0,5,10,15
2016,Morocco,MAR,Slovenia,SVN,0,0,16,20,36
2016,Nigeria,NGA,Slovenia,SVN,0,0,5,0,5
2016,Pakistan,PAK,Slovenia,SVN,0,0,53,43,96
2016,Russian Federation,RUS,Slovenia,SVN,0,0,5,0,5
2016,Serbia and Kosovo: S/RES/1244 (1999),SRB,Slovenia,SVN,0,0,5,21,26
2016,Syrian Arab Rep.,SYR,Slovenia,SVN,68,20,61,115,264
2016,Tunisia,TUN,Slovenia,SVN,0,0,0,5,5
2016,Turkey,TUR,Slovenia,SVN,0,0,11,13,24
2016,Burundi,BDI,Eswatini,SWZ,5,0,0,0,5
2016,Dem. Rep. of the Congo,COD,Eswatini,SWZ,15,0,0,0,15
2016,Rwanda,RWA,Eswatini,SWZ,10,0,0,0,10
2016,Afghanistan,AFG,Sweden,SWE,1352,2013,4031,4394,11790
2016,Albania,ALB,Sweden,SWE,12,23,867,318,1220
2016,Algeria,DZA,Sweden,SWE,0,5,49,178,232
2016,Angola,AGO,Sweden,SWE,0,0,0,10,10
2016,Egypt,EGY,Sweden,SWE,39,21,284,87,431
2016,Argentina,ARG,Sweden,SWE,0,0,5,0,5
2016,Armenia,ARM,Sweden,SWE,5,21,221,122,369
2016,Azerbaijan,AZE,Sweden,SWE,69,13,155,161,398
2016,Burundi,BDI,Sweden,SWE,24,5,16,21,66
2016,Bangladesh,BGD,Sweden,SWE,16,0,126,79,221
2016,Belarus,BLR,Sweden,SWE,10,5,82,124,221
2016,Bolivia (Plurinational State of),BOL,Sweden,SWE,5,0,14,5,24
2016,Brazil,BRA,Sweden,SWE,0,0,14,10,24
2016,Bosnia and Herzegovina,BIH,Sweden,SWE,0,0,195,54,249
2016,Bulgaria,BGR,Sweden,SWE,0,0,11,0,11
2016,Canada,CAN,Sweden,SWE,0,0,0,5,5
2016,Chad,TCD,Sweden,SWE,5,0,5,5,15
2016,China,CHN,Sweden,SWE,33,0,47,38,118
2016,Chile,CHL,Sweden,SWE,0,0,20,5,25
2016,Cameroon,CMR,Sweden,SWE,14,5,28,23,70
2016,Congo,COG,Sweden,SWE,5,0,5,13,23
2016,Dem. Rep. of the Congo,COD,Sweden,SWE,18,5,13,13,49
2016,Colombia,COL,Sweden,SWE,0,5,57,10,72
2016,Cuba,CUB,Sweden,SWE,0,0,21,21,42
2016,Djibouti,DJI,Sweden,SWE,5,0,19,10,34
2016,Equatorial Guinea,GNQ,Sweden,SWE,0,0,0,5,5
2016,Eritrea,ERI,Sweden,SWE,2680,2723,38,373,5814
2016,Ethiopia,ETH,Sweden,SWE,583,42,376,155,1156
2016,Gambia,GMB,Sweden,SWE,24,5,59,121,209
2016,Palestinian,PSE,Sweden,SWE,220,287,279,75,861
2016,United Kingdom of Great Britain and Northern Ireland,GBR,Sweden,SWE,0,0,5,0,5
2016,Georgia,GEO,Sweden,SWE,5,5,565,486,1061
2016,Ghana,GHA,Sweden,SWE,5,5,32,38,80
2016,Guinea-Bissau,GNB,Sweden,SWE,0,0,5,5,10
2016,Greece,GRC,Sweden,SWE,0,5,5,0,10
2016,Guinea,GIN,Sweden,SWE,10,0,14,23,47
2016,Honduras,HND,Sweden,SWE,0,5,10,5,20
2016,Hungary,HUN,Sweden,SWE,0,0,5,0,5
2016,Cote d'Ivoire,CIV,Sweden,SWE,0,0,13,17,30
2016,India,IND,Sweden,SWE,0,0,44,36,80
2016,Indonesia,IDN,Sweden,SWE,5,0,5,0,10
2016,Iran (Islamic Rep. of),IRN,Sweden,SWE,478,24,332,1148,1982
2016,Iraq,IRQ,Sweden,SWE,926,593,1781,6018,9318
2016,Israel,ISR,Sweden,SWE,0,5,17,0,22
2016,Italy,ITA,Sweden,SWE,0,0,5,0,5
2016,Jamaica,JAM,Sweden,SWE,0,0,0,5,5
2016,Jordan,JOR,Sweden,SWE,10,37,95,83,225
2016,Kazakhstan,KAZ,Sweden,SWE,0,16,98,160,274
2016,Kenya,KEN,Sweden,SWE,5,0,17,12,34
2016,Kyrgyzstan,KGZ,Sweden,SWE,5,0,82,131,218
2016,Rep. of Korea,KOR,Sweden,SWE,0,0,0,5,5
2016,Kuwait,KWT,Sweden,SWE,0,0,5,30,35
2016,Liberia,LBR,Sweden,SWE,0,0,0,10,10
2016,Libya,LBY,Sweden,SWE,32,16,66,137,251
2016,Lebanon,LBN,Sweden,SWE,14,64,220,261,559
2016,Sri Lanka,LKA,Sweden,SWE,5,0,10,5,20
2016,Mauritania,MRT,Sweden,SWE,0,0,0,13,13
2016,North Macedonia,MKD,Sweden,SWE,0,5,116,94,215
2016,Rep. of Moldova,MDA,Sweden,SWE,0,5,23,16,44
2016,Mexico,MEX,Sweden,SWE,0,0,0,5,5
2016,Mali,MLI,Sweden,SWE,0,0,5,14,19
2016,Malaysia,MYS,Sweden,SWE,0,0,5,0,5
2016,Mongolia,MNG,Sweden,SWE,5,33,937,161,1136
2016,Morocco,MAR,Sweden,SWE,17,15,215,349,596
2016,Mozambique,MOZ,Sweden,SWE,0,0,0,5,5
2016,Montenegro,MNE,Sweden,SWE,0,0,23,5,28
2016,Nepal,NPL,Sweden,SWE,0,0,20,24,44
2016,Niger,NER,Sweden,SWE,0,0,0,5,5
2016,Nicaragua,NIC,Sweden,SWE,0,5,28,0,33
2016,Nigeria,NGA,Sweden,SWE,57,14,205,182,458
2016,Norway,NOR,Sweden,SWE,0,0,5,0,5
2016,Pakistan,PAK,Sweden,SWE,66,5,219,189,479
2016,Peru,PER,Sweden,SWE,0,0,11,0,11
2016,Philippines,PHL,Sweden,SWE,0,0,25,5,30
2016,Romania,ROU,Sweden,SWE,0,5,10,5,20
2016,South Africa,ZAF,Sweden,SWE,0,0,0,5,5
2016,Russian Federation,RUS,Sweden,SWE,106,29,235,159,529
2016,Rwanda,RWA,Sweden,SWE,5,0,5,5,15
2016,El Salvador,SLV,Sweden,SWE,10,17,178,19,224
2016,Saudi Arabia,SAU,Sweden,SWE,10,5,10,11,36
2016,Serbia and Kosovo: S/RES/1244 (1999),SRB,Sweden,SWE,5,22,494,247,768
2016,Senegal,SEN,Sweden,SWE,11,0,13,32,56
2016,Sierra Leone,SLE,Sweden,SWE,10,0,10,5,25
2016,Somalia,SOM,Sweden,SWE,1211,373,1009,586,3179
2016,Spain,ESP,Sweden,SWE,0,0,5,5,10
2016,Viet Nam,VNM,Sweden,SWE,0,0,14,5,19
2016,Saint Kitts and Nevis,KNA,Sweden,SWE,0,0,5,0,5
2016,Sudan,SDN,Sweden,SWE,194,20,130,53,397
2016,Syrian Arab Rep.,SYR,Sweden,SWE,2504,40971,136,4035,47646
2016,United Rep. of Tanzania,TZA,Sweden,SWE,5,0,20,11,36
2016,Thailand,THA,Sweden,SWE,0,0,5,0,5
2016,Tajikistan,TJK,Sweden,SWE,10,5,26,38,79
2016,Turkmenistan,TKM,Sweden,SWE,0,0,0,5,5
2016,Togo,TGO,Sweden,SWE,0,0,5,0,5
2016,Tunisia,TUN,Sweden,SWE,5,10,61,61,137
2016,Turkey,TUR,Sweden,SWE,5,14,146,102,267
2016,Uganda,UGA,Sweden,SWE,59,5,27,23,114
2016,Ukraine,UKR,Sweden,SWE,15,47,1213,367,1642
2016,United States of America,USA,Sweden,SWE,0,0,15,15,30
2016,Uzbekistan,UZB,Sweden,SWE,61,22,142,84,309
2016,Venezuela (Bolivarian Republic of),VEN,Sweden,SWE,0,0,60,15,75
2016,Yemen,YEM,Sweden,SWE,101,158,22,40,321
2016,Zambia,ZMB,Sweden,SWE,0,0,0,5,5
2016,Zimbabwe,ZWE,Sweden,SWE,0,0,5,15,20
2016,Stateless,XXA,Sweden,SWE,4733,989,292,745,6759
2016,Unknown ,,Sweden,SWE,17,37,141,152,347
2016,Afghanistan,AFG,Switzerland,CHE,215,1180,166,1436,2997
2016,Albania,ALB,Switzerland,CHE,0,0,96,73,169
2016,Algeria,DZA,Switzerland,CHE,5,11,113,463,592
2016,Angola,AGO,Switzerland,CHE,0,20,14,20,54
2016,Egypt,EGY,Switzerland,CHE,13,0,13,38,64
2016,Armenia,ARM,Switzerland,CHE,0,10,20,25,55
2016,Azerbaijan,AZE,Switzerland,CHE,19,0,14,5,38
2016,Burundi,BDI,Switzerland,CHE,5,5,0,5,15
2016,Benin,BEN,Switzerland,CHE,5,0,0,12,17
2016,Bangladesh,BGD,Switzerland,CHE,0,5,15,16,36
2016,Burkina Faso,BFA,Switzerland,CHE,0,0,5,26,31
2016,Belarus,BLR,Switzerland,CHE,0,0,11,54,65
2016,Bosnia and Herzegovina,BIH,Switzerland,CHE,0,16,46,35,97
2016,Central African Rep.,CAF,Switzerland,CHE,0,0,0,13,13
2016,Chad,TCD,Switzerland,CHE,0,0,0,19,19
2016,China,CHN,Switzerland,CHE,62,175,190,52,479
2016,Cameroon,CMR,Switzerland,CHE,0,10,14,194,218
2016,Congo,COG,Switzerland,CHE,0,0,0,5,5
2016,Dem. Rep. of the Congo,COD,Switzerland,CHE,32,51,51,62,196
2016,Colombia,COL,Switzerland,CHE,0,0,5,5,10
2016,Cuba,CUB,Switzerland,CHE,0,0,5,0,5
2016,Cabo Verde,CPV,Switzerland,CHE,0,0,5,0,5
2016,Djibouti,DJI,Switzerland,CHE,0,0,0,5,5
2016,Eritrea,ERI,Switzerland,CHE,3187,2565,719,1463,7934
2016,Ethiopia,ETH,Switzerland,CHE,83,138,168,505,894
2016,France,FRA,Switzerland,CHE,0,0,5,0,5
2016,Gambia,GMB,Switzerland,CHE,0,5,54,1141,1200
2016,Georgia,GEO,Switzerland,CHE,0,20,92,392,504
2016,Germany,DEU,Switzerland,CHE,0,0,5,5,10
2016,Ghana,GHA,Switzerland,CHE,0,0,14,88,102
2016,Guinea-Bissau,GNB,Switzerland,CHE,0,5,10,89,104
2016,Guinea,GIN,Switzerland,CHE,0,10,70,753,833
2016,Haiti,HTI,Switzerland,CHE,0,0,0,5,5
2016,Cote d'Ivoire,CIV,Switzerland,CHE,10,10,16,298,334
2016,India,IND,Switzerland,CHE,0,5,14,27,46
2016,Iran (Islamic Rep. of),IRN,Switzerland,CHE,51,42,105,222,420
2016,Iraq,IRQ,Switzerland,CHE,115,240,243,909,1507
2016,Israel,ISR,Switzerland,CHE,0,0,5,5,10
2016,Italy,ITA,Switzerland,CHE,0,0,5,5,10
2016,Jordan,JOR,Switzerland,CHE,0,5,10,5,20
2016,Kazakhstan,KAZ,Switzerland,CHE,0,0,0,5,5
2016,Kenya,KEN,Switzerland,CHE,0,0,0,5,5
2016,Liberia,LBR,Switzerland,CHE,5,0,5,25,35
2016,Libya,LBY,Switzerland,CHE,16,29,29,150,224
2016,Lebanon,LBN,Switzerland,CHE,0,5,5,39,49
2016,Sri Lanka,LKA,Switzerland,CHE,610,102,289,318,1319
2016,Madagascar,MDG,Switzerland,CHE,0,0,0,5,5
2016,Mauritania,MRT,Switzerland,CHE,0,0,5,16,21
2016,North Macedonia,MKD,Switzerland,CHE,0,13,95,55,163
2016,Rep. of Moldova,MDA,Switzerland,CHE,0,0,19,10,29
2016,Mali,MLI,Switzerland,CHE,0,5,16,196,217
2016,Mongolia,MNG,Switzerland,CHE,0,5,60,66,131
2016,Morocco,MAR,Switzerland,CHE,5,5,168,657,835
2016,Montenegro,MNE,Switzerland,CHE,0,5,5,5,15
2016,Myanmar,MMR,Switzerland,CHE,0,0,5,5,10
2016,Nepal,NPL,Switzerland,CHE,0,0,11,0,11
2016,Niger,NER,Switzerland,CHE,0,0,0,29,29
2016,Nigeria,NGA,Switzerland,CHE,5,5,115,1137,1262
2016,Pakistan,PAK,Switzerland,CHE,16,10,36,112,174
2016,Poland,POL,Switzerland,CHE,0,0,5,0,5
2016,Romania,ROU,Switzerland,CHE,0,0,0,5,5
2016,Russian Federation,RUS,Switzerland,CHE,38,15,32,119,204
2016,Rwanda,RWA,Switzerland,CHE,5,0,0,5,10
2016,Serbia and Kosovo: S/RES/1244 (1999),SRB,Switzerland,CHE,12,102,239,276,629
2016,Senegal,SEN,Switzerland,CHE,0,0,26,325,351
2016,Sierra Leone,SLE,Switzerland,CHE,0,0,10,110,120
2016,Somalia,SOM,Switzerland,CHE,136,454,108,683,1381
2016,Viet Nam,VNM,Switzerland,CHE,10,0,5,0,15
2016,Sudan,SDN,Switzerland,CHE,19,36,38,166,259
2016,South Sudan,SSD,Switzerland,CHE,0,0,0,13,13
2016,Syrian Arab Rep.,SYR,Switzerland,CHE,1054,1278,89,602,3023
2016,United Rep. of Tanzania,TZA,Switzerland,CHE,0,0,5,0,5
2016,Tajikistan,TJK,Switzerland,CHE,0,0,0,5,5
2016,Togo,TGO,Switzerland,CHE,12,0,14,31,57
2016,Tunisia,TUN,Switzerland,CHE,5,5,77,227,314
2016,Turkey,TUR,Switzerland,CHE,127,35,98,156,416
2016,Uganda,UGA,Switzerland,CHE,0,0,5,10,15
2016,Ukraine,UKR,Switzerland,CHE,5,19,88,74,186
2016,United States of America,USA,Switzerland,CHE,0,0,5,0,5
2016,Uzbekistan,UZB,Switzerland,CHE,0,0,0,5,5
2016,Western Sahara,ESH,Switzerland,CHE,0,0,0,5,5
2016,Yemen,YEM,Switzerland,CHE,10,26,0,26,62
2016,Stateless,XXA,Switzerland,CHE,0,5,0,0,5
2016,Unknown ,,Switzerland,CHE,82,153,123,111,469
2016,Burundi,BDI,United Rep. of Tanzania,TZA,14,0,0,0,14
2016,Dem. Rep. of the Congo,COD,United Rep. of Tanzania,TZA,98,0,145,0,243
2016,Unknown ,,United Rep. of Tanzania,TZA,13,0,5,0,18
2016,Myanmar,MMR,Thailand,THA,525,0,14,0,539
2016,Afghanistan,AFG,Ukraine,UKR,5,10,109,81,205
2016,Azerbaijan,AZE,Ukraine,UKR,0,0,0,5,5
2016,Bangladesh,BGD,Ukraine,UKR,0,0,14,5,19
2016,Belarus,BLR,Ukraine,UKR,0,0,5,5,10
2016,Cameroon,CMR,Ukraine,UKR,0,0,0,5,5
2016,Congo,COG,Ukraine,UKR,0,0,5,0,5
2016,Dem. Rep. of the Congo,COD,Ukraine,UKR,0,0,5,5,10
2016,Palestinian,PSE,Ukraine,UKR,0,0,15,0,15
2016,Georgia,GEO,Ukraine,UKR,0,0,0,11,11
2016,Guinea,GIN,Ukraine,UKR,0,0,12,11,23
2016,India,IND,Ukraine,UKR,0,0,5,10,15
2016,Iran (Islamic Rep. of),IRN,Ukraine,UKR,0,0,17,5,22
2016,Iraq,IRQ,Ukraine,UKR,0,0,26,19,45
2016,Jordan,JOR,Ukraine,UKR,0,0,5,5,10
2016,Libya,LBY,Ukraine,UKR,0,0,5,0,5
2016,Saint Lucia,LCA,Ukraine,UKR,0,0,0,5,5
2016,Sri Lanka,LKA,Ukraine,UKR,0,0,0,14,14
2016,Rep. of Moldova,MDA,Ukraine,UKR,0,0,0,5,5
2016,Nigeria,NGA,Ukraine,UKR,0,0,0,5,5
2016,Pakistan,PAK,Ukraine,UKR,0,0,10,10,20
2016,Russian Federation,RUS,Ukraine,UKR,10,10,43,37,100
2016,Senegal,SEN,Ukraine,UKR,0,0,0,5,5
2016,Somalia,SOM,Ukraine,UKR,0,0,28,14,42
2016,Viet Nam,VNM,Ukraine,UKR,0,0,0,5,5
2016,Sudan,SDN,Ukraine,UKR,0,0,5,5,10
2016,Syrian Arab Rep.,SYR,Ukraine,UKR,0,22,95,30,147
2016,Tajikistan,TJK,Ukraine,UKR,0,0,5,10,15
2016,Turkey,TUR,Ukraine,UKR,0,0,0,10,10
2016,Uzbekistan,UZB,Ukraine,UKR,0,0,19,10,29
2016,Stateless,XXA,Ukraine,UKR,0,0,0,5,5
2016,Austria,AUT,Uruguay,URY,0,0,0,5,5
2016,Colombia,COL,Uruguay,URY,5,0,0,5,10
2016,Cuba,CUB,Uruguay,URY,5,0,10,48,63
2016,Libya,LBY,Uruguay,URY,5,0,0,0,5
2016,Syrian Arab Rep.,SYR,Uruguay,URY,0,0,0,5,5
2016,Ukraine,UKR,Uruguay,URY,0,0,0,5,5
2016,Bolivia (Plurinational State of),BOL,Venezuela (Bolivarian Republic of),VEN,0,0,0,5,5
2016,Chile,CHL,Venezuela (Bolivarian Republic of),VEN,5,0,0,0,5
2016,Colombia,COL,Venezuela (Bolivarian Republic of),VEN,1270,0,773,0,2043
2016,Cuba,CUB,Venezuela (Bolivarian Republic of),VEN,0,0,0,14,14
2016,Ecuador,ECU,Venezuela (Bolivarian Republic of),VEN,0,0,0,13,13
2016,Ethiopia,ETH,Venezuela (Bolivarian Republic of),VEN,0,0,0,5,5
2016,Gambia,GMB,Venezuela (Bolivarian Republic of),VEN,0,0,0,5,5
2016,Palestinian,PSE,Venezuela (Bolivarian Republic of),VEN,5,0,0,0,5
2016,Ghana,GHA,Venezuela (Bolivarian Republic of),VEN,0,0,0,5,5
2016,Haiti,HTI,Venezuela (Bolivarian Republic of),VEN,0,0,0,10,10
2016,Cote d'Ivoire,CIV,Venezuela (Bolivarian Republic of),VEN,0,0,0,5,5
2016,Iran (Islamic Rep. of),IRN,Venezuela (Bolivarian Republic of),VEN,0,0,0,18,18
2016,Iraq,IRQ,Venezuela (Bolivarian Republic of),VEN,10,0,0,0,10
2016,Liberia,LBR,Venezuela (Bolivarian Republic of),VEN,5,0,0,0,5
2016,Nigeria,NGA,Venezuela (Bolivarian Republic of),VEN,5,0,0,12,17
2016,Peru,PER,Venezuela (Bolivarian Republic of),VEN,0,0,0,14,14
2016,Somalia,SOM,Venezuela (Bolivarian Republic of),VEN,0,0,0,15,15
2016,Turkey,TUR,Venezuela (Bolivarian Republic of),VEN,5,0,0,0,5
2016,Stateless,XXA,Venezuela (Bolivarian Republic of),VEN,0,0,0,5,5
2016,Egypt,EGY,Zambia,ZMB,0,0,0,5,5
2016,Burundi,BDI,Zambia,ZMB,502,0,100,43,645
2016,Dem. Rep. of the Congo,COD,Zambia,ZMB,1601,0,337,267,2205
2016,Rwanda,RWA,Zambia,ZMB,5,0,0,0,5
2016,Somalia,SOM,Zambia,ZMB,17,0,23,110,150
2016,Syrian Arab Rep.,SYR,Zambia,ZMB,0,0,0,10,10
2016,Uganda,UGA,Zambia,ZMB,0,0,0,5,5
2016,Egypt,EGY,Zimbabwe,ZWE,0,0,0,13,13
2016,Burundi,BDI,Zimbabwe,ZWE,0,33,10,24,67
2016,Dem. Rep. of the Congo,COD,Zimbabwe,ZWE,0,493,101,66,660
2016,Ethiopia,ETH,Zimbabwe,ZWE,0,0,0,22,22
2016,Kenya,KEN,Zimbabwe,ZWE,0,0,5,0,5
2016,Rwanda,RWA,Zimbabwe,ZWE,0,0,0,15,15
2016,Somalia,SOM,Zimbabwe,ZWE,0,0,0,15,15
2017,Afghanistan,AFG,Albania,ALB,0,0,0,28,28
2017,Algeria,DZA,Albania,ALB,0,0,0,60,60
2017,Palestinian,PSE,Albania,ALB,0,0,0,10,10
2017,Iran (Islamic Rep. of),IRN,Albania,ALB,0,0,0,2751,2751
2017,Iraq,IRQ,Albania,ALB,0,0,0,5,5
2017,Libya,LBY,Albania,ALB,0,0,0,15,15
2017,Morocco,MAR,Albania,ALB,0,0,0,11,11
2017,Pakistan,PAK,Albania,ALB,0,0,0,16,16
2017,Syrian Arab Rep.,SYR,Albania,ALB,0,0,0,89,89
2017,Tunisia,TUN,Albania,ALB,0,0,0,5,5
2017,Turkey,TUR,Albania,ALB,0,0,0,5,5
2017,Venezuela (Bolivarian Republic of),VEN,Albania,ALB,0,5,0,0,5
2017,Armenia,ARM,Argentina,ARG,0,0,5,19,24
2017,Bangladesh,BGD,Argentina,ARG,0,0,5,0,5
2017,China,CHN,Argentina,ARG,0,0,20,0,20
2017,Colombia,COL,Argentina,ARG,5,0,10,20,35
2017,Cuba,CUB,Argentina,ARG,0,0,67,23,90
2017,Dominican Rep.,DOM,Argentina,ARG,0,0,45,5,50
2017,Gambia,GMB,Argentina,ARG,0,0,5,0,5
2017,Palestinian,PSE,Argentina,ARG,5,0,0,0,5
2017,Ghana,GHA,Argentina,ARG,0,0,13,0,13
2017,Haiti,HTI,Argentina,ARG,0,0,121,73,194
2017,India,IND,Argentina,ARG,0,0,22,5,27
2017,Iraq,IRQ,Argentina,ARG,0,0,0,5,5
2017,Nigeria,NGA,Argentina,ARG,0,0,0,5,5
2017,Peru,PER,Argentina,ARG,0,0,0,5,5
2017,Russian Federation,RUS,Argentina,ARG,0,0,5,5,10
2017,El Salvador,SLV,Argentina,ARG,5,0,0,0,5
2017,Senegal,SEN,Argentina,ARG,0,0,365,18,383
2017,Syrian Arab Rep.,SYR,Argentina,ARG,16,0,5,14,35
2017,Ukraine,UKR,Argentina,ARG,13,0,5,36,54
2017,Venezuela (Bolivarian Republic of),VEN,Argentina,ARG,0,0,5,10,15
2017,Unknown ,,Argentina,ARG,41,0,0,0,41
2017,Azerbaijan,AZE,Armenia,ARM,5,0,0,0,5
2017,Cuba,CUB,Armenia,ARM,0,0,0,5,5
2017,Iran (Islamic Rep. of),IRN,Armenia,ARM,0,0,5,5,10
2017,Iraq,IRQ,Armenia,ARM,32,0,0,5,37
2017,Syrian Arab Rep.,SYR,Armenia,ARM,55,0,0,5,60
2017,Ukraine,UKR,Armenia,ARM,10,0,0,5,15
2017,Yemen,YEM,Armenia,ARM,0,0,0,5,5
2017,Afghanistan,AFG,Australia,AUS,1681,0,208,0,1889
2017,Albania,ALB,Australia,AUS,5,0,21,0,26
2017,Algeria,DZA,Australia,AUS,0,0,12,0,12
2017,Egypt,EGY,Australia,AUS,22,0,83,0,105
2017,Azerbaijan,AZE,Australia,AUS,5,0,5,0,10
2017,Bahrain,BHR,Australia,AUS,5,0,5,0,10
2017,Burundi,BDI,Australia,AUS,0,0,5,0,5
2017,Bangladesh,BGD,Australia,AUS,33,0,218,0,251
2017,Bahamas,BHS,Australia,AUS,0,0,5,0,5
2017,Brazil,BRA,Australia,AUS,0,0,18,0,18
2017,Cambodia,KHM,Australia,AUS,0,0,15,0,15
2017,Canada,CAN,Australia,AUS,0,0,5,0,5
2017,China,CHN,Australia,AUS,53,0,2781,0,2834
2017,Cameroon,CMR,Australia,AUS,0,0,5,0,5
2017,Congo,COG,Australia,AUS,5,0,0,0,5
2017,Dem. Rep. of the Congo,COD,Australia,AUS,5,0,15,0,20
2017,Colombia,COL,Australia,AUS,5,0,56,0,61
2017,Cuba,CUB,Australia,AUS,0,0,5,0,5
2017,Czechia,CZE,Australia,AUS,0,0,10,0,10
2017,Eritrea,ERI,Australia,AUS,30,0,0,0,30
2017,Estonia,EST,Australia,AUS,0,0,5,0,5
2017,Ethiopia,ETH,Australia,AUS,23,0,43,0,66
2017,Fiji,FJI,Australia,AUS,15,0,229,0,244
2017,France,FRA,Australia,AUS,0,0,5,0,5
2017,Gambia,GMB,Australia,AUS,0,0,5,0,5
2017,Palestinian,PSE,Australia,AUS,85,0,5,0,90
2017,United Kingdom of Great Britain and Northern Ireland,GBR,Australia,AUS,0,0,14,0,14
2017,Georgia,GEO,Australia,AUS,5,0,12,0,17
2017,Germany,DEU,Australia,AUS,0,0,5,0,5
2017,Ghana,GHA,Australia,AUS,5,0,15,0,20
2017,Greece,GRC,Australia,AUS,0,0,10,0,10
2017,India,IND,Australia,AUS,15,0,292,0,307
2017,Indonesia,IDN,Australia,AUS,24,0,197,0,221
2017,Ireland,IRL,Australia,AUS,0,0,5,0,5
2017,Iran (Islamic Rep. of),IRN,Australia,AUS,1878,0,538,0,2416
2017,Iraq,IRQ,Australia,AUS,769,0,426,0,1195
2017,Israel,ISR,Australia,AUS,0,0,12,0,12
2017,Italy,ITA,Australia,AUS,0,0,5,0,5
2017,Jordan,JOR,Australia,AUS,11,0,40,0,51
2017,Japan,JPN,Australia,AUS,0,0,5,0,5
2017,Kazakhstan,KAZ,Australia,AUS,5,0,0,0,5
2017,Kenya,KEN,Australia,AUS,12,0,27,0,39
2017,Kyrgyzstan,KGZ,Australia,AUS,5,0,5,0,10
2017,Rep. of Korea,KOR,Australia,AUS,0,0,45,0,45
2017,Kuwait,KWT,Australia,AUS,5,0,5,0,10
2017,Lao People's Dem. Rep.,LAO,Australia,AUS,0,0,5,0,5
2017,Liberia,LBR,Australia,AUS,5,0,5,0,10
2017,Libya,LBY,Australia,AUS,110,0,99,0,209
2017,Lebanon,LBN,Australia,AUS,27,0,110,0,137
2017,Sri Lanka,LKA,Australia,AUS,625,0,1318,0,1943
2017,Latvia,LVA,Australia,AUS,0,0,5,0,5
2017,North Macedonia,MKD,Australia,AUS,0,0,5,0,5
2017,Rep. of Moldova,MDA,Australia,AUS,0,0,5,0,5
2017,Mexico,MEX,Australia,AUS,0,0,13,0,13
2017,Malaysia,MYS,Australia,AUS,12,0,7964,0,7976
2017,Mongolia,MNG,Australia,AUS,5,0,5,0,10
2017,Morocco,MAR,Australia,AUS,5,0,10,0,15
2017,Mauritius,MUS,Australia,AUS,0,0,22,0,22
2017,Myanmar,MMR,Australia,AUS,47,0,18,0,65
2017,Namibia,NAM,Australia,AUS,0,0,5,0,5
2017,Nepal,NPL,Australia,AUS,0,0,71,0,71
2017,Netherlands,NLD,Australia,AUS,0,0,10,0,10
2017,Nigeria,NGA,Australia,AUS,10,0,50,0,60
2017,New Zealand,NZL,Australia,AUS,10,0,5,0,15
2017,Oman,OMN,Australia,AUS,0,0,5,0,5
2017,Pakistan,PAK,Australia,AUS,669,0,500,0,1169
2017,Peru,PER,Australia,AUS,5,0,18,0,23
2017,Philippines,PHL,Australia,AUS,5,0,42,0,47
2017,Papua New Guinea,PNG,Australia,AUS,11,0,71,0,82
2017,Poland,POL,Australia,AUS,0,0,5,0,5
2017,South Africa,ZAF,Australia,AUS,5,0,25,0,30
2017,Russian Federation,RUS,Australia,AUS,10,0,5,0,15
2017,Rwanda,RWA,Australia,AUS,5,0,5,0,10
2017,El Salvador,SLV,Australia,AUS,0,0,10,0,10
2017,Saudi Arabia,SAU,Australia,AUS,17,0,10,0,27
2017,Serbia and Kosovo: S/RES/1244 (1999),SRB,Australia,AUS,0,0,5,0,5
2017,Singapore,SGP,Australia,AUS,5,0,10,0,15
2017,Sierra Leone,SLE,Australia,AUS,0,0,5,0,5
2017,Solomon Islands,SLB,Australia,AUS,0,0,11,0,11
2017,Somalia,SOM,Australia,AUS,52,0,5,0,57
2017,Viet Nam,VNM,Australia,AUS,62,0,719,0,781
2017,Sudan,SDN,Australia,AUS,163,0,15,0,178
2017,South Sudan,SSD,Australia,AUS,0,0,5,0,5
2017,Syrian Arab Rep.,SYR,Australia,AUS,100,0,5,0,105
2017,United Rep. of Tanzania,TZA,Australia,AUS,0,0,5,0,5
2017,Thailand,THA,Australia,AUS,5,0,202,0,207
2017,Timor-Leste,TLS,Australia,AUS,0,0,5,0,5
2017,Tonga,TON,Australia,AUS,10,0,36,0,46
2017,Tunisia,TUN,Australia,AUS,0,0,5,0,5
2017,Turkey,TUR,Australia,AUS,35,0,42,0,77
2017,United Arab Emirates,ARE,Australia,AUS,5,0,0,0,5
2017,Uganda,UGA,Australia,AUS,5,0,11,0,16
2017,Ukraine,UKR,Australia,AUS,0,0,18,0,18
2017,United States of America,USA,Australia,AUS,0,0,18,0,18
2017,Uzbekistan,UZB,Australia,AUS,5,0,0,0,5
2017,Venezuela (Bolivarian Republic of),VEN,Australia,AUS,10,0,5,0,15
2017,Samoa,WSM,Australia,AUS,0,0,10,0,10
2017,Yemen,YEM,Australia,AUS,10,0,5,0,15
2017,Zambia,ZMB,Australia,AUS,0,0,12,0,12
2017,Zimbabwe,ZWE,Australia,AUS,10,0,45,0,55
2017,Stateless,XXA,Australia,AUS,564,0,48,0,612
2017,Unknown ,,Australia,AUS,24,0,384,0,408
2017,Afghanistan,AFG,Azerbaijan,AZE,5,0,104,5,114
2017,Iran (Islamic Rep. of),IRN,Azerbaijan,AZE,5,0,5,0,10
2017,Iraq,IRQ,Azerbaijan,AZE,0,0,10,5,15
2017,Pakistan,PAK,Azerbaijan,AZE,0,0,13,0,13
2017,Russian Federation,RUS,Azerbaijan,AZE,0,0,5,0,5
2017,Syrian Arab Rep.,SYR,Azerbaijan,AZE,0,0,5,0,5
2017,Tajikistan,TJK,Azerbaijan,AZE,0,0,5,0,5
2017,Turkey,TUR,Azerbaijan,AZE,0,0,43,0,43
2017,Yemen,YEM,Azerbaijan,AZE,0,0,5,0,5
2017,Dem. Rep. of the Congo,COD,Burundi,BDI,5414,0,0,1173,6587
2017,Mali,MLI,Burundi,BDI,10,0,0,0,10
2017,Rwanda,RWA,Burundi,BDI,35,0,0,161,196
2017,Turkey,TUR,Burundi,BDI,21,0,0,0,21
2017,Afghanistan,AFG,Belgium,BEL,1310,1720,2130,0,5160
2017,Albania,ALB,Belgium,BEL,55,0,815,0,870
2017,Algeria,DZA,Belgium,BEL,25,0,85,0,110
2017,Angola,AGO,Belgium,BEL,10,0,95,0,105
2017,Egypt,EGY,Belgium,BEL,25,0,80,0,105
2017,Armenia,ARM,Belgium,BEL,30,10,155,0,195
2017,Azerbaijan,AZE,Belgium,BEL,5,0,30,0,35
2017,Burundi,BDI,Belgium,BEL,255,0,115,0,370
2017,Benin,BEN,Belgium,BEL,5,0,25,0,30
2017,Bangladesh,BGD,Belgium,BEL,5,0,85,0,90
2017,Bhutan,BTN,Belgium,BEL,0,0,5,0,5
2017,Burkina Faso,BFA,Belgium,BEL,35,0,40,0,75
2017,Belarus,BLR,Belgium,BEL,5,0,10,0,15
2017,Brazil,BRA,Belgium,BEL,0,0,10,0,10
2017,Bosnia and Herzegovina,BIH,Belgium,BEL,0,0,20,0,20
2017,Central African Rep.,CAF,Belgium,BEL,10,0,5,0,15
2017,Chad,TCD,Belgium,BEL,10,0,10,0,20
2017,China,CHN,Belgium,BEL,140,0,145,0,285
2017,Cameroon,CMR,Belgium,BEL,80,0,230,0,310
2017,Congo,COG,Belgium,BEL,0,0,20,0,20
2017,Dem. Rep. of the Congo,COD,Belgium,BEL,160,5,500,0,665
2017,Colombia,COL,Belgium,BEL,10,0,5,0,15
2017,Djibouti,DJI,Belgium,BEL,75,0,60,0,135
2017,Equatorial Guinea,GNQ,Belgium,BEL,0,0,5,0,5
2017,Eritrea,ERI,Belgium,BEL,450,0,60,0,510
2017,Ethiopia,ETH,Belgium,BEL,20,0,65,0,85
2017,Gabon,GAB,Belgium,BEL,0,0,5,0,5
2017,Gambia,GMB,Belgium,BEL,5,0,40,0,45
2017,Palestinian,PSE,Belgium,BEL,225,0,35,0,260
2017,Georgia,GEO,Belgium,BEL,15,0,105,0,120
2017,Ghana,GHA,Belgium,BEL,0,0,35,0,35
2017,Guinea-Bissau,GNB,Belgium,BEL,0,0,5,0,5
2017,Guatemala,GTM,Belgium,BEL,10,0,0,0,10
2017,Guinea,GIN,Belgium,BEL,460,0,410,0,870
2017,Haiti,HTI,Belgium,BEL,0,0,10,0,10
2017,Honduras,HND,Belgium,BEL,0,0,5,0,5
2017,Cote d'Ivoire,CIV,Belgium,BEL,35,0,80,0,115
2017,India,IND,Belgium,BEL,0,0,30,0,30
2017,Iran (Islamic Rep. of),IRN,Belgium,BEL,460,0,100,0,560
2017,Iraq,IRQ,Belgium,BEL,920,180,1650,0,2750
2017,Israel,ISR,Belgium,BEL,0,0,5,0,5
2017,Jordan,JOR,Belgium,BEL,10,0,20,0,30
2017,Kazakhstan,KAZ,Belgium,BEL,5,0,15,0,20
2017,Kenya,KEN,Belgium,BEL,5,0,10,0,15
2017,Kyrgyzstan,KGZ,Belgium,BEL,10,0,30,0,40
2017,Liberia,LBR,Belgium,BEL,0,0,10,0,10
2017,Libya,LBY,Belgium,BEL,15,40,5,0,60
2017,Lebanon,LBN,Belgium,BEL,15,5,115,0,135
2017,Sri Lanka,LKA,Belgium,BEL,35,0,85,0,120
2017,Madagascar,MDG,Belgium,BEL,0,0,5,0,5
2017,Mauritania,MRT,Belgium,BEL,25,0,105,0,130
2017,North Macedonia,MKD,Belgium,BEL,20,0,165,0,185
2017,Mali,MLI,Belgium,BEL,25,0,40,0,65
2017,Mongolia,MNG,Belgium,BEL,0,0,5,0,5
2017,Morocco,MAR,Belgium,BEL,40,0,190,0,230
2017,Montenegro,MNE,Belgium,BEL,5,0,10,0,15
2017,Nepal,NPL,Belgium,BEL,5,0,30,0,35
2017,Netherlands,NLD,Belgium,BEL,0,0,5,0,5
2017,Niger,NER,Belgium,BEL,15,0,55,0,70
2017,Nigeria,NGA,Belgium,BEL,10,0,105,0,115
2017,Norway,NOR,Belgium,BEL,0,0,5,0,5
2017,Pakistan,PAK,Belgium,BEL,60,0,205,0,265
2017,Philippines,PHL,Belgium,BEL,0,0,5,0,5
2017,Romania,ROU,Belgium,BEL,0,0,5,0,5
2017,Russian Federation,RUS,Belgium,BEL,210,0,420,0,630
2017,Rwanda,RWA,Belgium,BEL,95,0,280,0,375
2017,El Salvador,SLV,Belgium,BEL,15,0,0,0,15
2017,Serbia and Kosovo: S/RES/1244 (1999),SRB,Belgium,BEL,45,0,400,0,445
2017,Senegal,SEN,Belgium,BEL,40,0,120,0,160
2017,Sierra Leone,SLE,Belgium,BEL,5,0,30,0,35
2017,Somalia,SOM,Belgium,BEL,525,155,440,0,1120
2017,Viet Nam,VNM,Belgium,BEL,0,0,15,0,15
2017,Sudan,SDN,Belgium,BEL,60,0,65,0,125
2017,Suriname,SUR,Belgium,BEL,0,0,10,0,10
2017,South Sudan,SSD,Belgium,BEL,0,5,0,0,5
2017,Syrian Arab Rep.,SYR,Belgium,BEL,2110,770,240,0,3120
2017,United Rep. of Tanzania,TZA,Belgium,BEL,5,0,15,0,20
2017,Togo,TGO,Belgium,BEL,25,0,90,0,115
2017,Tunisia,TUN,Belgium,BEL,5,0,40,0,45
2017,Turkey,TUR,Belgium,BEL,570,0,265,0,835
2017,Uganda,UGA,Belgium,BEL,5,0,10,0,15
2017,Ukraine,UKR,Belgium,BEL,30,15,200,0,245
2017,Uzbekistan,UZB,Belgium,BEL,0,0,5,0,5
2017,Venezuela (Bolivarian Republic of),VEN,Belgium,BEL,15,0,0,0,15
2017,Yemen,YEM,Belgium,BEL,20,5,0,0,25
2017,Zimbabwe,ZWE,Belgium,BEL,0,0,5,0,5
2017,Stateless,XXA,Belgium,BEL,25,0,10,0,35
2017,Unknown ,,Belgium,BEL,700,10,265,0,975
2017,Burundi,BDI,Benin,BEN,5,0,0,0,5
2017,Central African Rep.,CAF,Benin,BEN,227,0,0,0,227
2017,Dem. Rep. of the Congo,COD,Benin,BEN,5,0,0,0,5
2017,Syrian Arab Rep.,SYR,Benin,BEN,5,0,0,0,5
2017,Turkey,TUR,Benin,BEN,5,0,0,0,5
2017,Afghanistan,AFG,Belarus,BLR,0,5,0,5,10
2017,Armenia,ARM,Belarus,BLR,0,0,0,5,5
2017,Bangladesh,BGD,Belarus,BLR,0,0,0,5,5
2017,Georgia,GEO,Belarus,BLR,0,0,5,5,10
2017,Iran (Islamic Rep. of),IRN,Belarus,BLR,0,0,5,5,10
2017,Iraq,IRQ,Belarus,BLR,0,0,5,5,10
2017,Rep. of Moldova,MDA,Belarus,BLR,0,0,5,0,5
2017,Pakistan,PAK,Belarus,BLR,0,0,5,11,16
2017,Russian Federation,RUS,Belarus,BLR,0,0,16,5,21
2017,Syrian Arab Rep.,SYR,Belarus,BLR,0,14,0,5,19
2017,Tajikistan,TJK,Belarus,BLR,0,0,10,0,10
2017,Ukraine,UKR,Belarus,BLR,0,517,15,16,548
2017,Yemen,YEM,Belarus,BLR,0,10,0,0,10
2017,Burundi,BDI,Botswana,BWA,0,0,11,0,11
2017,Dem. Rep. of the Congo,COD,Botswana,BWA,31,0,18,0,49
2017,Somalia,SOM,Botswana,BWA,5,0,0,0,5
2017,Angola,AGO,Brazil,BRA,5,0,120,0,125
2017,Egypt,EGY,Brazil,BRA,15,0,5,0,20
2017,Benin,BEN,Brazil,BRA,0,0,5,0,5
2017,Bangladesh,BGD,Brazil,BRA,0,0,81,0,81
2017,Burkina Faso,BFA,Brazil,BRA,0,0,5,0,5
2017,Cameroon,CMR,Brazil,BRA,5,0,5,0,10
2017,Dem. Rep. of the Congo,COD,Brazil,BRA,106,0,12,0,118
2017,Colombia,COL,Brazil,BRA,5,0,0,0,5
2017,Cuba,CUB,Brazil,BRA,5,0,0,0,5
2017,Cabo Verde,CPV,Brazil,BRA,0,0,5,0,5
2017,Denmark,DNK,Brazil,BRA,0,0,5,0,5
2017,Dominican Rep.,DOM,Brazil,BRA,0,0,5,0,5
2017,Ethiopia,ETH,Brazil,BRA,5,0,0,0,5
2017,Gambia,GMB,Brazil,BRA,0,0,19,0,19
2017,Palestinian,PSE,Brazil,BRA,42,0,0,0,42
2017,Ghana,GHA,Brazil,BRA,0,0,14,0,14
2017,Guinea-Bissau,GNB,Brazil,BRA,0,0,60,0,60
2017,Guinea,GIN,Brazil,BRA,5,0,0,0,5
2017,Haiti,HTI,Brazil,BRA,5,0,0,0,5
2017,India,IND,Brazil,BRA,0,0,5,0,5
2017,Iran (Islamic Rep. of),IRN,Brazil,BRA,5,0,0,0,5
2017,Iraq,IRQ,Brazil,BRA,10,0,0,0,10
2017,Jordan,JOR,Brazil,BRA,5,0,0,0,5
2017,Lebanon,LBN,Brazil,BRA,5,0,58,0,63
2017,Mali,MLI,Brazil,BRA,5,0,52,0,57
2017,Mozambique,MOZ,Brazil,BRA,0,0,5,0,5
2017,Nigeria,NGA,Brazil,BRA,5,0,52,0,57
2017,Pakistan,PAK,Brazil,BRA,24,0,11,0,35
2017,Philippines,PHL,Brazil,BRA,0,0,5,0,5
2017,El Salvador,SLV,Brazil,BRA,5,0,0,0,5
2017,Senegal,SEN,Brazil,BRA,0,0,156,0,156
2017,Sierra Leone,SLE,Brazil,BRA,0,0,5,0,5
2017,Sudan,SDN,Brazil,BRA,5,0,0,0,5
2017,Syrian Arab Rep.,SYR,Brazil,BRA,314,0,0,0,314
2017,Togo,TGO,Brazil,BRA,0,0,5,0,5
2017,Ukraine,UKR,Brazil,BRA,5,0,0,0,5
2017,Afghanistan,AFG,Bosnia and Herzegovina,BIH,0,0,0,35,35
2017,Algeria,DZA,Bosnia and Herzegovina,BIH,0,0,0,5,5
2017,Iran (Islamic Rep. of),IRN,Bosnia and Herzegovina,BIH,0,0,0,5,5
2017,Iraq,IRQ,Bosnia and Herzegovina,BIH,0,0,0,12,12
2017,Lebanon,LBN,Bosnia and Herzegovina,BIH,0,0,0,5,5
2017,Morocco,MAR,Bosnia and Herzegovina,BIH,0,0,0,5,5
2017,Pakistan,PAK,Bosnia and Herzegovina,BIH,0,0,5,31,36
2017,Serbia and Kosovo: S/RES/1244 (1999),SRB,Bosnia and Herzegovina,BIH,0,0,0,5,5
2017,Syrian Arab Rep.,SYR,Bosnia and Herzegovina,BIH,0,0,0,39,39
2017,Turkey,TUR,Bosnia and Herzegovina,BIH,0,5,0,12,17
2017,Stateless,XXA,Bosnia and Herzegovina,BIH,0,0,0,5,5
2017,Viet Nam,VNM,Cambodia,KHM,5,0,0,119,124
2017,Afghanistan,AFG,Canada,CAN,294,0,44,179,517
2017,Albania,ALB,Canada,CAN,72,0,76,21,169
2017,Algeria,DZA,Canada,CAN,44,0,30,13,87
2017,Angola,AGO,Canada,CAN,23,0,14,10,47
2017,Antigua and Barbuda,ATG,Canada,CAN,12,0,11,0,23
2017,Egypt,EGY,Canada,CAN,183,0,41,153,377
2017,Argentina,ARG,Canada,CAN,0,0,5,0,5
2017,Armenia,ARM,Canada,CAN,5,0,0,0,5
2017,Azerbaijan,AZE,Canada,CAN,145,0,58,15,218
2017,Bahrain,BHR,Canada,CAN,11,0,10,0,21
2017,Barbados,BRB,Canada,CAN,29,0,5,5,39
2017,Burundi,BDI,Canada,CAN,497,0,31,255,783
2017,Belgium,BEL,Canada,CAN,0,0,5,0,5
2017,Benin,BEN,Canada,CAN,5,0,5,0,10
2017,Bangladesh,BGD,Canada,CAN,151,0,50,27,228
2017,Bahamas,BHS,Canada,CAN,70,0,26,5,101
2017,Burkina Faso,BFA,Canada,CAN,5,0,10,0,15
2017,Belarus,BLR,Canada,CAN,5,0,0,0,5
2017,Bolivia (Plurinational State of),BOL,Canada,CAN,5,0,0,5,10
2017,Botswana,BWA,Canada,CAN,10,0,10,5,25
2017,Brazil,BRA,Canada,CAN,5,0,36,20,61
2017,Bulgaria,BGR,Canada,CAN,10,0,0,0,10
2017,Belize,BLZ,Canada,CAN,5,0,0,0,5
2017,Cambodia,KHM,Canada,CAN,10,0,0,5,15
2017,Central African Rep.,CAF,Canada,CAN,5,0,0,0,5
2017,Chad,TCD,Canada,CAN,103,0,47,5,155
2017,China,CHN,Canada,CAN,543,0,600,119,1262
2017,Chile,CHL,Canada,CAN,5,0,20,5,30
2017,Cameroon,CMR,Canada,CAN,89,0,47,5,141
2017,Congo,COG,Canada,CAN,39,0,13,5,57
2017,Dem. Rep. of the Congo,COD,Canada,CAN,136,0,138,15,289
2017,Colombia,COL,Canada,CAN,547,0,194,65,806
2017,Costa Rica,CRI,Canada,CAN,0,0,10,0,10
2017,Cuba,CUB,Canada,CAN,33,0,35,5,73
2017,Czechia,CZE,Canada,CAN,36,0,10,56,102
2017,Djibouti,DJI,Canada,CAN,219,0,93,5,317
2017,Dominican Rep.,DOM,Canada,CAN,23,0,12,5,40
2017,Ecuador,ECU,Canada,CAN,11,0,10,5,26
2017,Eritrea,ERI,Canada,CAN,409,0,40,454,903
2017,Ethiopia,ETH,Canada,CAN,279,0,87,11,377
2017,Finland,FIN,Canada,CAN,0,0,5,0,5
2017,France,FRA,Canada,CAN,0,0,13,0,13
2017,Gabon,GAB,Canada,CAN,14,0,10,0,24
2017,Gambia,GMB,Canada,CAN,10,0,10,0,20
2017,Palestinian,PSE,Canada,CAN,299,0,72,18,389
2017,Georgia,GEO,Canada,CAN,38,0,44,16,98
2017,Ghana,GHA,Canada,CAN,33,0,59,19,111
2017,Greece,GRC,Canada,CAN,0,0,5,5,10
2017,Guatemala,GTM,Canada,CAN,18,0,30,10,58
2017,Guinea,GIN,Canada,CAN,44,0,20,5,69
2017,Guyana,GUY,Canada,CAN,5,0,13,5,23
2017,Haiti,HTI,Canada,CAN,221,0,543,201,965
2017,"China, Hong Kong SAR",HKG,Canada,CAN,0,0,0,5,5
2017,Honduras,HND,Canada,CAN,93,0,43,10,146
2017,Croatia,HRV,Canada,CAN,47,0,27,23,97
2017,Hungary,HUN,Canada,CAN,334,0,193,155,682
2017,Cote d'Ivoire,CIV,Canada,CAN,11,0,0,0,11
2017,India,IND,Canada,CAN,175,0,287,128,590
2017,Indonesia,IDN,Canada,CAN,10,0,10,5,25
2017,Ireland,IRL,Canada,CAN,0,0,5,14,19
2017,Iran (Islamic Rep. of),IRN,Canada,CAN,293,0,54,29,376
2017,Iraq,IRQ,Canada,CAN,399,0,142,196,737
2017,Israel,ISR,Canada,CAN,11,0,12,14,37
2017,Italy,ITA,Canada,CAN,0,0,30,5,35
2017,Jamaica,JAM,Canada,CAN,84,0,54,15,153
2017,Jordan,JOR,Canada,CAN,65,0,52,10,127
2017,Japan,JPN,Canada,CAN,0,0,0,5,5
2017,Kazakhstan,KAZ,Canada,CAN,22,0,5,0,27
2017,Kenya,KEN,Canada,CAN,37,0,34,0,71
2017,Kyrgyzstan,KGZ,Canada,CAN,5,0,5,0,10
2017,Rep. of Korea,KOR,Canada,CAN,5,0,5,5,15
2017,Dem. People's Rep. of Korea,PRK,Canada,CAN,0,0,5,26,31
2017,Kuwait,KWT,Canada,CAN,5,0,0,5,10
2017,Liberia,LBR,Canada,CAN,11,0,5,0,16
2017,Libya,LBY,Canada,CAN,242,0,16,10,268
2017,Saint Lucia,LCA,Canada,CAN,20,0,14,19,53
2017,Lebanon,LBN,Canada,CAN,123,0,74,19,216
2017,Sri Lanka,LKA,Canada,CAN,236,0,73,40,349
2017,Lithuania,LTU,Canada,CAN,0,0,5,0,5
2017,Latvia,LVA,Canada,CAN,5,0,0,5,10
2017,Mauritania,MRT,Canada,CAN,35,0,14,5,54
2017,Mexico,MEX,Canada,CAN,120,0,215,121,456
2017,Mali,MLI,Canada,CAN,18,0,31,0,49
2017,Malaysia,MYS,Canada,CAN,0,0,0,5,5
2017,Malawi,MWI,Canada,CAN,0,0,5,0,5
2017,Mongolia,MNG,Canada,CAN,10,0,0,5,15
2017,Morocco,MAR,Canada,CAN,10,0,17,5,32
2017,Mozambique,MOZ,Canada,CAN,0,0,5,0,5
2017,Montenegro,MNE,Canada,CAN,0,0,5,0,5
2017,Mauritius,MUS,Canada,CAN,5,0,5,0,10
2017,Myanmar,MMR,Canada,CAN,5,0,0,0,5
2017,Namibia,NAM,Canada,CAN,5,0,0,0,5
2017,Nepal,NPL,Canada,CAN,50,0,33,5,88
2017,Netherlands,NLD,Canada,CAN,0,0,5,5,10
2017,Niger,NER,Canada,CAN,5,0,0,0,5
2017,Nicaragua,NIC,Canada,CAN,0,0,5,0,5
2017,Nigeria,NGA,Canada,CAN,835,0,949,87,1871
2017,Pakistan,PAK,Canada,CAN,595,0,152,44,791
2017,Peru,PER,Canada,CAN,5,0,18,0,23
2017,Philippines,PHL,Canada,CAN,5,0,10,5,20
2017,Poland,POL,Canada,CAN,0,0,11,5,16
2017,Portugal,PRT,Canada,CAN,0,0,11,0,11
2017,Romania,ROU,Canada,CAN,13,0,5,94,112
2017,South Africa,ZAF,Canada,CAN,5,0,13,5,23
2017,Russian Federation,RUS,Canada,CAN,96,0,28,13,137
2017,Rwanda,RWA,Canada,CAN,64,0,23,5,92
2017,El Salvador,SLV,Canada,CAN,182,0,69,17,268
2017,Saudi Arabia,SAU,Canada,CAN,87,0,12,34,133
2017,Serbia and Kosovo: S/RES/1244 (1999),SRB,Canada,CAN,20,0,5,15,40
2017,Senegal,SEN,Canada,CAN,23,0,16,5,44
2017,Sierra Leone,SLE,Canada,CAN,5,0,5,0,10
2017,Somalia,SOM,Canada,CAN,341,0,184,129,654
2017,Spain,ESP,Canada,CAN,0,0,17,5,22
2017,Viet Nam,VNM,Canada,CAN,5,0,5,0,10
2017,Saint Kitts and Nevis,KNA,Canada,CAN,0,0,5,0,5
2017,Sudan,SDN,Canada,CAN,361,0,37,15,413
2017,South Sudan,SSD,Canada,CAN,5,0,0,0,5
2017,Slovakia,SVK,Canada,CAN,130,0,5,43,178
2017,Eswatini,SWZ,Canada,CAN,5,0,5,0,10
2017,Sweden,SWE,Canada,CAN,0,0,0,5,5
2017,Syrian Arab Rep.,SYR,Canada,CAN,343,0,13,442,798
2017,United Rep. of Tanzania,TZA,Canada,CAN,16,0,12,5,33
2017,Turks and Caicos Islands,TCA,Canada,CAN,0,0,5,0,5
2017,Tajikistan,TJK,Canada,CAN,10,0,0,0,10
2017,Turkmenistan,TKM,Canada,CAN,10,0,0,0,10
2017,Togo,TGO,Canada,CAN,10,0,5,0,15
2017,Trinidad and Tobago,TTO,Canada,CAN,5,0,5,0,10
2017,Tunisia,TUN,Canada,CAN,17,0,10,0,27
2017,Turkey,TUR,Canada,CAN,1244,0,156,54,1454
2017,Uganda,UGA,Canada,CAN,83,0,56,0,139
2017,Ukraine,UKR,Canada,CAN,102,0,48,12,162
2017,Uruguay,URY,Canada,CAN,0,0,5,0,5
2017,United States of America,USA,Canada,CAN,5,0,320,109,434
2017,Uzbekistan,UZB,Canada,CAN,13,0,13,0,26
2017,Saint Vincent and the Grenadines,VCT,Canada,CAN,11,0,10,13,34
2017,Venezuela (Bolivarian Republic of),VEN,Canada,CAN,404,0,95,16,515
2017,Yemen,YEM,Canada,CAN,262,0,12,126,400
2017,Zambia,ZMB,Canada,CAN,5,0,0,0,5
2017,Zimbabwe,ZWE,Canada,CAN,66,0,48,0,114
2017,Stateless,XXA,Canada,CAN,144,0,55,17,216
2017,Unknown ,,Canada,CAN,5,0,5,0,10
2017,Cuba,CUB,Cayman Islands,CYM,11,0,11,10,32
2017,Colombia,COL,Chile,CHL,75,0,57,225,357
2017,Cuba,CUB,Chile,CHL,0,0,33,11,44
2017,Dominican Rep.,DOM,Chile,CHL,0,0,5,5,10
2017,Ecuador,ECU,Chile,CHL,5,0,0,0,5
2017,Palestinian,PSE,Chile,CHL,5,0,0,5,10
2017,Mexico,MEX,Chile,CHL,0,0,0,5,5
2017,Turkey,TUR,Chile,CHL,5,0,0,0,5
2017,Venezuela (Bolivarian Republic of),VEN,Chile,CHL,0,0,0,18,18
2017,Central African Rep.,CAF,Congo,COG,1542,0,0,0,1542
2017,Dem. Rep. of the Congo,COD,Congo,COG,21,0,0,0,21
2017,Mali,MLI,Congo,COG,0,0,0,5,5
2017,Sudan,SDN,Congo,COG,5,0,0,0,5
2017,Syrian Arab Rep.,SYR,Congo,COG,5,0,0,0,5
2017,Burundi,BDI,Dem. Rep. of the Congo,COD,61,62,20,156,299
2017,Central African Rep.,CAF,Dem. Rep. of the Congo,COD,10,0,0,0,10
2017,Cote d'Ivoire,CIV,Dem. Rep. of the Congo,COD,0,0,10,0,10
2017,Rwanda,RWA,Dem. Rep. of the Congo,COD,28,0,5,181,214
2017,Somalia,SOM,Dem. Rep. of the Congo,COD,0,0,46,90,136
2017,Cuba,CUB,Colombia,COL,0,0,0,14,14
2017,Turkey,TUR,Colombia,COL,0,0,0,12,12
2017,Venezuela (Bolivarian Republic of),VEN,Colombia,COL,18,0,5,412,435
2017,Angola,AGO,Costa Rica,CRI,0,0,5,0,5
2017,China,CHN,Costa Rica,CRI,0,0,5,0,5
2017,Dem. Rep. of the Congo,COD,Costa Rica,CRI,5,0,14,25,44
2017,Colombia,COL,Costa Rica,CRI,37,0,167,218,422
2017,Cuba,CUB,Costa Rica,CRI,5,0,14,39,58
2017,Gambia,GMB,Costa Rica,CRI,0,0,5,0,5
2017,Ghana,GHA,Costa Rica,CRI,0,0,17,5,22
2017,Guatemala,GTM,Costa Rica,CRI,0,0,0,5,5
2017,Haiti,HTI,Costa Rica,CRI,0,0,10,55,65
2017,Honduras,HND,Costa Rica,CRI,24,0,10,33,67
2017,Nicaragua,NIC,Costa Rica,CRI,5,0,19,21,45
2017,Nigeria,NGA,Costa Rica,CRI,0,0,5,0,5
2017,El Salvador,SLV,Costa Rica,CRI,104,0,241,242,587
2017,Somalia,SOM,Costa Rica,CRI,0,0,0,5,5
2017,Ukraine,UKR,Costa Rica,CRI,5,0,0,0,5
2017,Venezuela (Bolivarian Republic of),VEN,Costa Rica,CRI,69,0,701,209,979
2017,Unknown ,,Costa Rica,CRI,0,0,5,10,15
2017,Afghanistan,AFG,Cyprus,CYP,5,0,0,0,5
2017,Egypt,EGY,Cyprus,CYP,5,5,42,47,99
2017,Bangladesh,BGD,Cyprus,CYP,0,0,199,37,236
2017,China,CHN,Cyprus,CYP,0,0,0,5,5
2017,Cameroon,CMR,Cyprus,CYP,5,0,24,10,39
2017,Congo,COG,Cyprus,CYP,5,0,0,10,15
2017,Dem. Rep. of the Congo,COD,Cyprus,CYP,0,0,5,0,5
2017,Eritrea,ERI,Cyprus,CYP,45,0,0,0,45
2017,Gambia,GMB,Cyprus,CYP,0,0,10,0,10
2017,Palestinian,PSE,Cyprus,CYP,25,14,10,11,60
2017,Georgia,GEO,Cyprus,CYP,0,0,32,5,37
2017,Cote d'Ivoire,CIV,Cyprus,CYP,0,0,5,5,10
2017,India,IND,Cyprus,CYP,0,0,277,32,309
2017,Iran (Islamic Rep. of),IRN,Cyprus,CYP,0,5,10,22,37
2017,Iraq,IRQ,Cyprus,CYP,19,13,18,22,72
2017,Jordan,JOR,Cyprus,CYP,5,0,0,5,10
2017,Lebanon,LBN,Cyprus,CYP,0,5,5,0,10
2017,Sri Lanka,LKA,Cyprus,CYP,0,0,37,11,48
2017,Nepal,NPL,Cyprus,CYP,0,0,10,11,21
2017,Nigeria,NGA,Cyprus,CYP,0,0,23,12,35
2017,Pakistan,PAK,Cyprus,CYP,0,0,140,22,162
2017,Philippines,PHL,Cyprus,CYP,5,0,34,10,49
2017,Russian Federation,RUS,Cyprus,CYP,5,0,0,10,15
2017,Somalia,SOM,Cyprus,CYP,56,25,21,121,223
2017,Viet Nam,VNM,Cyprus,CYP,0,0,207,34,241
2017,Syrian Arab Rep.,SYR,Cyprus,CYP,16,958,0,105,1079
2017,Turkey,TUR,Cyprus,CYP,18,0,0,5,23
2017,Ukraine,UKR,Cyprus,CYP,0,0,86,22,108
2017,Yemen,YEM,Cyprus,CYP,5,0,0,0,5
2017,Afghanistan,AFG,Czechia,CZE,0,0,16,12,28
2017,Algeria,DZA,Czechia,CZE,0,0,10,5,15
2017,Egypt,EGY,Czechia,CZE,0,0,5,5,10
2017,Armenia,ARM,Czechia,CZE,0,0,26,59,85
2017,Azerbaijan,AZE,Czechia,CZE,5,0,34,57,96
2017,Belarus,BLR,Czechia,CZE,0,0,0,10,10
2017,China,CHN,Czechia,CZE,0,0,5,19,24
2017,Cameroon,CMR,Czechia,CZE,0,0,0,5,5
2017,Cuba,CUB,Czechia,CZE,0,5,23,58,86
2017,Ethiopia,ETH,Czechia,CZE,0,0,11,5,16
2017,Georgia,GEO,Czechia,CZE,0,0,34,73,107
2017,Ghana,GHA,Czechia,CZE,0,0,5,5,10
2017,Iraq,IRQ,Czechia,CZE,0,13,0,18,31
2017,Jordan,JOR,Czechia,CZE,0,0,5,0,5
2017,Kazakhstan,KAZ,Czechia,CZE,0,0,16,26,42
2017,Kyrgyzstan,KGZ,Czechia,CZE,0,0,10,10,20
2017,Libya,LBY,Czechia,CZE,0,5,0,5,10
2017,Lebanon,LBN,Czechia,CZE,0,0,0,5,5
2017,Rep. of Moldova,MDA,Czechia,CZE,0,0,5,5,10
2017,Mongolia,MNG,Czechia,CZE,0,0,10,5,15
2017,Myanmar,MMR,Czechia,CZE,5,0,0,0,5
2017,Nigeria,NGA,Czechia,CZE,0,0,10,25,35
2017,Pakistan,PAK,Czechia,CZE,0,0,0,5,5
2017,Russian Federation,RUS,Czechia,CZE,0,0,35,35,70
2017,Serbia and Kosovo: S/RES/1244 (1999),SRB,Czechia,CZE,0,0,5,5,10
2017,Viet Nam,VNM,Czechia,CZE,0,0,51,22,73
2017,Syrian Arab Rep.,SYR,Czechia,CZE,5,34,0,17,56
2017,Togo,TGO,Czechia,CZE,0,5,0,0,5
2017,Tunisia,TUN,Czechia,CZE,0,0,5,0,5
2017,Turkey,TUR,Czechia,CZE,5,0,16,12,33
2017,Ukraine,UKR,Czechia,CZE,10,25,277,197,509
2017,Uzbekistan,UZB,Czechia,CZE,0,13,0,5,18
2017,Yemen,YEM,Czechia,CZE,0,5,0,0,5
2017,Stateless,XXA,Czechia,CZE,0,10,5,5,20
2017,Afghanistan,AFG,Denmark,DNK,46,157,1051,0,1254
2017,Albania,ALB,Denmark,DNK,0,0,57,0,57
2017,Algeria,DZA,Denmark,DNK,0,0,25,0,25
2017,Egypt,EGY,Denmark,DNK,10,0,5,0,15
2017,Armenia,ARM,Denmark,DNK,0,0,32,0,32
2017,Bangladesh,BGD,Denmark,DNK,5,0,10,0,15
2017,Belarus,BLR,Denmark,DNK,0,0,5,0,5
2017,Bosnia and Herzegovina,BIH,Denmark,DNK,0,0,10,0,10
2017,Cameroon,CMR,Denmark,DNK,0,0,10,0,10
2017,Dem. Rep. of the Congo,COD,Denmark,DNK,5,0,14,0,19
2017,Colombia,COL,Denmark,DNK,5,0,0,0,5
2017,Eritrea,ERI,Denmark,DNK,241,20,5,0,266
2017,Ethiopia,ETH,Denmark,DNK,10,0,52,0,62
2017,Gambia,GMB,Denmark,DNK,5,0,10,0,15
2017,Georgia,GEO,Denmark,DNK,0,0,5,0,5
2017,Ghana,GHA,Denmark,DNK,0,0,12,0,12
2017,Guinea,GIN,Denmark,DNK,0,0,5,0,5
2017,India,IND,Denmark,DNK,0,0,5,0,5
2017,Iran (Islamic Rep. of),IRN,Denmark,DNK,537,14,837,0,1388
2017,Iraq,IRQ,Denmark,DNK,23,26,591,0,640
2017,Jordan,JOR,Denmark,DNK,0,0,5,0,5
2017,Kenya,KEN,Denmark,DNK,0,0,5,0,5
2017,Kuwait,KWT,Denmark,DNK,0,0,103,0,103
2017,Libya,LBY,Denmark,DNK,0,0,10,0,10
2017,Lebanon,LBN,Denmark,DNK,0,5,29,0,34
2017,Sri Lanka,LKA,Denmark,DNK,0,0,5,0,5
2017,North Macedonia,MKD,Denmark,DNK,0,0,10,0,10
2017,Morocco,MAR,Denmark,DNK,0,0,40,0,40
2017,Myanmar,MMR,Denmark,DNK,0,0,5,0,5
2017,Nigeria,NGA,Denmark,DNK,0,0,36,0,36
2017,Pakistan,PAK,Denmark,DNK,0,0,26,0,26
2017,Russian Federation,RUS,Denmark,DNK,0,0,20,0,20
2017,Serbia and Kosovo: S/RES/1244 (1999),SRB,Denmark,DNK,0,0,61,0,61
2017,Sierra Leone,SLE,Denmark,DNK,0,0,5,0,5
2017,Somalia,SOM,Denmark,DNK,5,5,105,0,115
2017,Spain,ESP,Denmark,DNK,0,0,5,0,5
2017,Viet Nam,VNM,Denmark,DNK,0,0,5,0,5
2017,Sudan,SDN,Denmark,DNK,0,0,10,0,10
2017,Syrian Arab Rep.,SYR,Denmark,DNK,349,673,39,0,1061
2017,Tunisia,TUN,Denmark,DNK,0,0,5,0,5
2017,Turkey,TUR,Denmark,DNK,0,0,20,0,20
2017,Uganda,UGA,Denmark,DNK,0,5,30,0,35
2017,Ukraine,UKR,Denmark,DNK,0,0,29,0,29
2017,Venezuela (Bolivarian Republic of),VEN,Denmark,DNK,0,0,5,0,5
2017,Zimbabwe,ZWE,Denmark,DNK,5,0,5,0,10
2017,Stateless,XXA,Denmark,DNK,35,132,761,0,928
2017,Unknown ,,Denmark,DNK,0,0,5,0,5
2017,Albania,ALB,Estonia,EST,0,0,10,0,10
2017,Egypt,EGY,Estonia,EST,0,0,0,5,5
2017,Cameroon,CMR,Estonia,EST,0,0,5,0,5
2017,Eritrea,ERI,Estonia,EST,0,5,0,0,5
2017,Georgia,GEO,Estonia,EST,0,0,0,5,5
2017,Iran (Islamic Rep. of),IRN,Estonia,EST,0,0,5,0,5
2017,Iraq,IRQ,Estonia,EST,0,5,0,0,5
2017,Russian Federation,RUS,Estonia,EST,0,0,10,0,10
2017,Syrian Arab Rep.,SYR,Estonia,EST,41,30,0,0,71
2017,Ukraine,UKR,Estonia,EST,0,10,10,5,25
2017,Afghanistan,AFG,France,FRA,689,5001,1154,28,6872
2017,Albania,ALB,France,FRA,135,527,9702,170,10534
2017,Algeria,DZA,France,FRA,85,50,2143,79,2357
2017,Angola,AGO,France,FRA,45,14,512,5,576
2017,Egypt,EGY,France,FRA,39,5,404,10,458
2017,Armenia,ARM,France,FRA,32,62,1540,23,1657
2017,Azerbaijan,AZE,France,FRA,48,18,320,5,391
2017,Burundi,BDI,France,FRA,114,0,12,5,131
2017,Bangladesh,BGD,France,FRA,151,102,3514,5,3772
2017,Burkina Faso,BFA,France,FRA,45,12,181,0,238
2017,Bosnia and Herzegovina,BIH,France,FRA,23,20,411,18,472
2017,Central African Rep.,CAF,France,FRA,165,158,399,5,727
2017,Chad,TCD,France,FRA,62,10,319,13,404
2017,China,CHN,France,FRA,606,0,1323,5,1934
2017,Cameroon,CMR,France,FRA,61,26,377,11,475
2017,Congo,COG,France,FRA,103,19,861,19,1002
2017,Dem. Rep. of the Congo,COD,France,FRA,485,103,2996,22,3606
2017,Comoros,COM,France,FRA,36,5,213,10,264
2017,Colombia,COL,France,FRA,14,18,86,5,123
2017,Djibouti,DJI,France,FRA,45,10,77,0,132
2017,Dominican Rep.,DOM,France,FRA,0,5,295,5,305
2017,Eritrea,ERI,France,FRA,651,0,241,20,912
2017,Ethiopia,ETH,France,FRA,295,5,305,74,679
2017,Gabon,GAB,France,FRA,22,10,191,15,238
2017,Gambia,GMB,France,FRA,27,5,171,5,208
2017,Palestinian,PSE,France,FRA,104,10,61,5,180
2017,Georgia,GEO,France,FRA,41,33,981,28,1083
2017,Guinea,GIN,France,FRA,733,121,3150,15,4019
2017,Haiti,HTI,France,FRA,70,106,6225,29,6430
2017,Cote d'Ivoire,CIV,France,FRA,308,67,2008,35,2418
2017,India,IND,France,FRA,10,5,166,0,181
2017,Iran (Islamic Rep. of),IRN,France,FRA,139,5,299,5,448
2017,Iraq,IRQ,France,FRA,1065,257,249,14,1585
2017,Libya,LBY,France,FRA,105,108,345,19,577
2017,Sri Lanka,LKA,France,FRA,189,49,1875,10,2123
2017,Mauritania,MRT,France,FRA,107,19,761,10,897
2017,North Macedonia,MKD,France,FRA,0,5,525,46,576
2017,Mali,MLI,France,FRA,234,21,1297,17,1569
2017,Mongolia,MNG,France,FRA,5,5,170,5,185
2017,Morocco,MAR,France,FRA,78,15,499,16,608
2017,Nigeria,NGA,France,FRA,145,85,1889,18,2137
2017,Pakistan,PAK,France,FRA,109,48,1994,17,2168
2017,Russian Federation,RUS,France,FRA,245,96,1506,27,1874
2017,Rwanda,RWA,France,FRA,93,0,83,5,181
2017,Serbia and Kosovo: S/RES/1244 (1999),SRB,France,FRA,122,166,3090,43,3421
2017,Senegal,SEN,France,FRA,145,15,853,17,1030
2017,Sierra Leone,SLE,France,FRA,20,5,133,0,158
2017,Somalia,SOM,France,FRA,95,268,525,27,915
2017,Sudan,SDN,France,FRA,3244,450,2518,78,6290
2017,Syrian Arab Rep.,SYR,France,FRA,1051,2446,175,89,3761
2017,Togo,TGO,France,FRA,15,5,141,0,161
2017,Turkey,TUR,France,FRA,148,19,1094,16,1277
2017,Ukraine,UKR,France,FRA,42,118,460,5,625
2017,Venezuela (Bolivarian Republic of),VEN,France,FRA,42,33,198,5,278
2017,Western Sahara,ESH,France,FRA,56,20,1321,5,1402
2017,Unknown ,,France,FRA,7140,4331,15840,432,27743
2017,Cote d'Ivoire,CIV,Gambia,GMB,5,0,0,0,5
2017,Afghanistan,AFG,United Kingdom of Great Britain and Northern Ireland,GBR,512,178,919,400,2009
2017,Albania,ALB,United Kingdom of Great Britain and Northern Ireland,GBR,30,64,706,278,1078
2017,Algeria,DZA,United Kingdom of Great Britain and Northern Ireland,GBR,5,5,120,43,173
2017,Angola,AGO,United Kingdom of Great Britain and Northern Ireland,GBR,5,0,41,10,56
2017,Egypt,EGY,United Kingdom of Great Britain and Northern Ireland,GBR,53,10,299,112,474
2017,Armenia,ARM,United Kingdom of Great Britain and Northern Ireland,GBR,5,0,30,5,40
2017,Australia,AUS,United Kingdom of Great Britain and Northern Ireland,GBR,0,0,0,5,5
2017,Azerbaijan,AZE,United Kingdom of Great Britain and Northern Ireland,GBR,5,0,32,0,37
2017,Burundi,BDI,United Kingdom of Great Britain and Northern Ireland,GBR,5,0,12,0,17
2017,Benin,BEN,United Kingdom of Great Britain and Northern Ireland,GBR,0,0,5,0,5
2017,Bangladesh,BGD,United Kingdom of Great Britain and Northern Ireland,GBR,55,10,1557,281,1903
2017,Burkina Faso,BFA,United Kingdom of Great Britain and Northern Ireland,GBR,0,0,5,0,5
2017,Belarus,BLR,United Kingdom of Great Britain and Northern Ireland,GBR,5,0,5,0,10
2017,Bolivia (Plurinational State of),BOL,United Kingdom of Great Britain and Northern Ireland,GBR,0,0,5,0,5
2017,Botswana,BWA,United Kingdom of Great Britain and Northern Ireland,GBR,0,0,13,0,13
2017,Brazil,BRA,United Kingdom of Great Britain and Northern Ireland,GBR,0,0,13,17,30
2017,Canada,CAN,United Kingdom of Great Britain and Northern Ireland,GBR,0,0,5,5,10
2017,China,CHN,United Kingdom of Great Britain and Northern Ireland,GBR,13,5,511,411,940
2017,Cameroon,CMR,United Kingdom of Great Britain and Northern Ireland,GBR,38,5,143,14,200
2017,Congo,COG,United Kingdom of Great Britain and Northern Ireland,GBR,5,0,20,5,30
2017,Dem. Rep. of the Congo,COD,United Kingdom of Great Britain and Northern Ireland,GBR,27,5,126,11,169
2017,Colombia,COL,United Kingdom of Great Britain and Northern Ireland,GBR,0,0,12,0,12
2017,Cuba,CUB,United Kingdom of Great Britain and Northern Ireland,GBR,0,0,5,0,5
2017,Czechia,CZE,United Kingdom of Great Britain and Northern Ireland,GBR,0,0,5,0,5
2017,Djibouti,DJI,United Kingdom of Great Britain and Northern Ireland,GBR,0,0,5,0,5
2017,Dominica,DMA,United Kingdom of Great Britain and Northern Ireland,GBR,5,0,0,0,5
2017,Eritrea,ERI,United Kingdom of Great Britain and Northern Ireland,GBR,1194,5,159,138,1496
2017,Ethiopia,ETH,United Kingdom of Great Britain and Northern Ireland,GBR,155,10,135,30,330
2017,Gabon,GAB,United Kingdom of Great Britain and Northern Ireland,GBR,0,0,5,0,5
2017,Gambia,GMB,United Kingdom of Great Britain and Northern Ireland,GBR,13,10,99,13,135
2017,Palestinian,PSE,United Kingdom of Great Britain and Northern Ireland,GBR,19,0,54,21,94
2017,Georgia,GEO,United Kingdom of Great Britain and Northern Ireland,GBR,0,0,40,21,61
2017,Ghana,GHA,United Kingdom of Great Britain and Northern Ireland,GBR,10,17,200,41,268
2017,Grenada,GRD,United Kingdom of Great Britain and Northern Ireland,GBR,0,0,10,5,15
2017,Guatemala,GTM,United Kingdom of Great Britain and Northern Ireland,GBR,0,0,5,0,5
2017,Guinea,GIN,United Kingdom of Great Britain and Northern Ireland,GBR,5,0,13,5,23
2017,Guyana,GUY,United Kingdom of Great Britain and Northern Ireland,GBR,0,0,0,5,5
2017,Honduras,HND,United Kingdom of Great Britain and Northern Ireland,GBR,0,0,0,5,5
2017,Hungary,HUN,United Kingdom of Great Britain and Northern Ireland,GBR,0,0,5,0,5
2017,Cote d'Ivoire,CIV,United Kingdom of Great Britain and Northern Ireland,GBR,0,0,34,5,39
2017,India,IND,United Kingdom of Great Britain and Northern Ireland,GBR,0,26,1280,472,1778
2017,Indonesia,IDN,United Kingdom of Great Britain and Northern Ireland,GBR,0,0,5,0,5
2017,Iran (Islamic Rep. of),IRN,United Kingdom of Great Britain and Northern Ireland,GBR,1496,63,1324,451,3334
2017,Iraq,IRQ,United Kingdom of Great Britain and Northern Ireland,GBR,310,180,1470,673,2633
2017,Israel,ISR,United Kingdom of Great Britain and Northern Ireland,GBR,0,0,14,5,19
2017,Jamaica,JAM,United Kingdom of Great Britain and Northern Ireland,GBR,10,5,172,32,219
2017,Jordan,JOR,United Kingdom of Great Britain and Northern Ireland,GBR,0,0,26,10,36
2017,Japan,JPN,United Kingdom of Great Britain and Northern Ireland,GBR,0,0,0,5,5
2017,Kazakhstan,KAZ,United Kingdom of Great Britain and Northern Ireland,GBR,0,0,15,0,15
2017,Kenya,KEN,United Kingdom of Great Britain and Northern Ireland,GBR,5,0,74,5,84
2017,Kyrgyzstan,KGZ,United Kingdom of Great Britain and Northern Ireland,GBR,0,0,5,0,5
2017,Rep. of Korea,KOR,United Kingdom of Great Britain and Northern Ireland,GBR,0,0,5,0,5
2017,Dem. People's Rep. of Korea,PRK,United Kingdom of Great Britain and Northern Ireland,GBR,0,0,10,0,10
2017,Kuwait,KWT,United Kingdom of Great Britain and Northern Ireland,GBR,37,0,28,26,91
2017,Liberia,LBR,United Kingdom of Great Britain and Northern Ireland,GBR,0,0,5,0,5
2017,Libya,LBY,United Kingdom of Great Britain and Northern Ireland,GBR,128,145,227,37,537
2017,Saint Lucia,LCA,United Kingdom of Great Britain and Northern Ireland,GBR,0,0,13,5,18
2017,Lebanon,LBN,United Kingdom of Great Britain and Northern Ireland,GBR,12,0,70,13,95
2017,Sri Lanka,LKA,United Kingdom of Great Britain and Northern Ireland,GBR,48,10,870,95,1023
2017,Lithuania,LTU,United Kingdom of Great Britain and Northern Ireland,GBR,0,0,15,0,15
2017,Latvia,LVA,United Kingdom of Great Britain and Northern Ireland,GBR,0,0,5,0,5
2017,North Macedonia,MKD,United Kingdom of Great Britain and Northern Ireland,GBR,0,0,5,0,5
2017,Maldives,MDV,United Kingdom of Great Britain and Northern Ireland,GBR,5,0,5,0,10
2017,Mexico,MEX,United Kingdom of Great Britain and Northern Ireland,GBR,0,0,10,5,15
2017,Mali,MLI,United Kingdom of Great Britain and Northern Ireland,GBR,5,0,5,0,10
2017,Malaysia,MYS,United Kingdom of Great Britain and Northern Ireland,GBR,15,0,49,17,81
2017,Malawi,MWI,United Kingdom of Great Britain and Northern Ireland,GBR,0,11,62,0,73
2017,Mongolia,MNG,United Kingdom of Great Britain and Northern Ireland,GBR,0,0,17,0,17
2017,Morocco,MAR,United Kingdom of Great Britain and Northern Ireland,GBR,5,5,55,27,92
2017,Mozambique,MOZ,United Kingdom of Great Britain and Northern Ireland,GBR,0,0,5,0,5
2017,Mauritius,MUS,United Kingdom of Great Britain and Northern Ireland,GBR,0,0,54,15,69
2017,Myanmar,MMR,United Kingdom of Great Britain and Northern Ireland,GBR,5,0,25,5,35
2017,Namibia,NAM,United Kingdom of Great Britain and Northern Ireland,GBR,0,0,37,13,50
2017,Nepal,NPL,United Kingdom of Great Britain and Northern Ireland,GBR,0,0,145,45,190
2017,Netherlands,NLD,United Kingdom of Great Britain and Northern Ireland,GBR,0,0,5,0,5
2017,Nigeria,NGA,United Kingdom of Great Britain and Northern Ireland,GBR,86,68,1179,148,1481
2017,Oman,OMN,United Kingdom of Great Britain and Northern Ireland,GBR,0,0,14,0,14
2017,Pakistan,PAK,United Kingdom of Great Britain and Northern Ireland,GBR,346,38,2258,502,3144
2017,Peru,PER,United Kingdom of Great Britain and Northern Ireland,GBR,0,0,5,0,5
2017,Philippines,PHL,United Kingdom of Great Britain and Northern Ireland,GBR,0,0,63,21,84
2017,Poland,POL,United Kingdom of Great Britain and Northern Ireland,GBR,0,0,17,0,17
2017,Portugal,PRT,United Kingdom of Great Britain and Northern Ireland,GBR,0,0,5,0,5
2017,Romania,ROU,United Kingdom of Great Britain and Northern Ireland,GBR,0,0,10,0,10
2017,South Africa,ZAF,United Kingdom of Great Britain and Northern Ireland,GBR,0,5,54,5,64
2017,Russian Federation,RUS,United Kingdom of Great Britain and Northern Ireland,GBR,49,5,107,11,172
2017,Rwanda,RWA,United Kingdom of Great Britain and Northern Ireland,GBR,0,0,23,0,23
2017,El Salvador,SLV,United Kingdom of Great Britain and Northern Ireland,GBR,38,5,38,5,86
2017,Saudi Arabia,SAU,United Kingdom of Great Britain and Northern Ireland,GBR,22,0,21,5,48
2017,Serbia and Kosovo: S/RES/1244 (1999),SRB,United Kingdom of Great Britain and Northern Ireland,GBR,0,0,23,5,28
2017,Senegal,SEN,United Kingdom of Great Britain and Northern Ireland,GBR,5,0,20,0,25
2017,Seychelles,SYC,United Kingdom of Great Britain and Northern Ireland,GBR,0,0,5,0,5
2017,Sierra Leone,SLE,United Kingdom of Great Britain and Northern Ireland,GBR,10,0,25,5,40
2017,Somalia,SOM,United Kingdom of Great Britain and Northern Ireland,GBR,152,10,146,41,349
2017,Viet Nam,VNM,United Kingdom of Great Britain and Northern Ireland,GBR,134,61,324,204,723
2017,Saint Kitts and Nevis,KNA,United Kingdom of Great Britain and Northern Ireland,GBR,0,0,0,5,5
2017,Sudan,SDN,United Kingdom of Great Britain and Northern Ireland,GBR,924,10,298,262,1494
2017,South Sudan,SSD,United Kingdom of Great Britain and Northern Ireland,GBR,5,0,0,0,5
2017,Sweden,SWE,United Kingdom of Great Britain and Northern Ireland,GBR,0,0,5,0,5
2017,Syrian Arab Rep.,SYR,United Kingdom of Great Britain and Northern Ireland,GBR,839,5,97,110,1051
2017,United Rep. of Tanzania,TZA,United Kingdom of Great Britain and Northern Ireland,GBR,5,5,30,0,40
2017,Thailand,THA,United Kingdom of Great Britain and Northern Ireland,GBR,0,0,16,5,21
2017,Tajikistan,TJK,United Kingdom of Great Britain and Northern Ireland,GBR,5,0,0,0,5
2017,Togo,TGO,United Kingdom of Great Britain and Northern Ireland,GBR,0,0,5,0,5
2017,Trinidad and Tobago,TTO,United Kingdom of Great Britain and Northern Ireland,GBR,12,0,29,5,46
2017,Tunisia,TUN,United Kingdom of Great Britain and Northern Ireland,GBR,5,0,30,10,45
2017,Turkey,TUR,United Kingdom of Great Britain and Northern Ireland,GBR,36,10,181,28,255
2017,Uganda,UGA,United Kingdom of Great Britain and Northern Ireland,GBR,61,5,65,5,136
2017,Ukraine,UKR,United Kingdom of Great Britain and Northern Ireland,GBR,12,5,107,44,168
2017,United States of America,USA,United Kingdom of Great Britain and Northern Ireland,GBR,0,0,22,14,36
2017,Uzbekistan,UZB,United Kingdom of Great Britain and Northern Ireland,GBR,0,0,5,10,15
2017,Saint Vincent and the Grenadines,VCT,United Kingdom of Great Britain and Northern Ireland,GBR,0,0,10,0,10
2017,Venezuela (Bolivarian Republic of),VEN,United Kingdom of Great Britain and Northern Ireland,GBR,0,0,24,0,24
2017,Yemen,YEM,United Kingdom of Great Britain and Northern Ireland,GBR,54,33,39,10,136
2017,Zambia,ZMB,United Kingdom of Great Britain and Northern Ireland,GBR,5,0,16,0,21
2017,Zimbabwe,ZWE,United Kingdom of Great Britain and Northern Ireland,GBR,19,11,240,16,286
2017,Stateless,XXA,United Kingdom of Great Britain and Northern Ireland,GBR,313,0,184,42,539
2017,Unknown ,,United Kingdom of Great Britain and Northern Ireland,GBR,53,15,19,10,97
2017,Afghanistan,AFG,Georgia,GEO,0,0,36,10,46
2017,Egypt,EGY,Georgia,GEO,11,0,36,18,65
2017,Armenia,ARM,Georgia,GEO,0,0,0,5,5
2017,Azerbaijan,AZE,Georgia,GEO,5,0,10,12,27
2017,Bangladesh,BGD,Georgia,GEO,0,0,11,5,16
2017,Cameroon,CMR,Georgia,GEO,0,0,5,0,5
2017,India,IND,Georgia,GEO,0,0,22,29,51
2017,Iran (Islamic Rep. of),IRN,Georgia,GEO,20,0,33,24,77
2017,Iraq,IRQ,Georgia,GEO,0,10,80,56,146
2017,Jordan,JOR,Georgia,GEO,0,0,0,5,5
2017,Lebanon,LBN,Georgia,GEO,0,0,5,0,5
2017,Sri Lanka,LKA,Georgia,GEO,0,0,5,0,5
2017,Morocco,MAR,Georgia,GEO,0,0,5,0,5
2017,Nepal,NPL,Georgia,GEO,0,0,0,5,5
2017,Nigeria,NGA,Georgia,GEO,0,0,26,5,31
2017,Pakistan,PAK,Georgia,GEO,5,0,17,5,27
2017,Russian Federation,RUS,Georgia,GEO,5,0,16,13,34
2017,Somalia,SOM,Georgia,GEO,0,0,0,5,5
2017,Sudan,SDN,Georgia,GEO,5,0,0,0,5
2017,Syrian Arab Rep.,SYR,Georgia,GEO,0,5,20,5,30
2017,Turkey,TUR,Georgia,GEO,0,0,36,5,41
2017,Ukraine,UKR,Georgia,GEO,0,17,5,10,32
2017,Yemen,YEM,Georgia,GEO,0,0,5,0,5
2017,Stateless,XXA,Georgia,GEO,0,0,5,0,5
2017,Unknown ,,Georgia,GEO,0,0,10,0,10
2017,Central African Rep.,CAF,Ghana,GHA,0,0,0,10,10
2017,Chad,TCD,Ghana,GHA,17,0,0,5,22
2017,Cameroon,CMR,Ghana,GHA,0,0,0,5,5
2017,Dem. Rep. of the Congo,COD,Ghana,GHA,0,0,0,32,32
2017,Cote d'Ivoire,CIV,Ghana,GHA,118,0,0,10,128
2017,Liberia,LBR,Ghana,GHA,0,0,0,5,5
2017,Libya,LBY,Ghana,GHA,0,0,0,5,5
2017,Mali,MLI,Ghana,GHA,0,0,0,5,5
2017,Nigeria,NGA,Ghana,GHA,0,0,0,12,12
2017,Rwanda,RWA,Ghana,GHA,0,0,0,10,10
2017,Sierra Leone,SLE,Ghana,GHA,12,0,0,13,25
2017,Somalia,SOM,Ghana,GHA,0,0,0,33,33
2017,Sudan,SDN,Ghana,GHA,17,0,0,0,17
2017,South Sudan,SSD,Ghana,GHA,0,0,0,5,5
2017,Syrian Arab Rep.,SYR,Ghana,GHA,14,0,0,5,19
2017,Togo,TGO,Ghana,GHA,31,0,0,5,36
2017,Cote d'Ivoire,CIV,Guinea-Bissau,GNB,0,0,0,5,5
2017,Liberia,LBR,Guinea-Bissau,GNB,0,0,0,5,5
2017,Nigeria,NGA,Guinea-Bissau,GNB,5,0,0,0,5
2017,Afghanistan,AFG,Greece,GRC,1152,455,492,1343,3442
2017,Albania,ALB,Greece,GRC,5,0,1596,290,1891
2017,Algeria,DZA,Greece,GRC,19,0,435,338,792
2017,Egypt,EGY,Greece,GRC,29,0,410,92,531
2017,Armenia,ARM,Greece,GRC,0,0,51,10,61
2017,Burundi,BDI,Greece,GRC,11,0,0,0,11
2017,Bangladesh,BGD,Greece,GRC,26,0,799,104,929
2017,Burkina Faso,BFA,Greece,GRC,0,0,5,5,10
2017,Bolivia (Plurinational State of),BOL,Greece,GRC,0,0,0,5,5
2017,China,CHN,Greece,GRC,10,0,88,25,123
2017,Cameroon,CMR,Greece,GRC,53,0,85,110,248
2017,Congo,COG,Greece,GRC,18,5,29,31,83
2017,Dem. Rep. of the Congo,COD,Greece,GRC,153,10,201,182,546
2017,Comoros,COM,Greece,GRC,0,0,5,5,10
2017,Dominican Rep.,DOM,Greece,GRC,5,0,34,44,83
2017,Eritrea,ERI,Greece,GRC,272,5,10,116,403
2017,Ethiopia,ETH,Greece,GRC,86,0,31,18,135
2017,Gabon,GAB,Greece,GRC,0,0,5,0,5
2017,Gambia,GMB,Greece,GRC,0,0,11,5,16
2017,Palestinian,PSE,Greece,GRC,442,5,15,134,596
2017,Georgia,GEO,Greece,GRC,0,0,557,97,654
2017,Ghana,GHA,Greece,GRC,0,0,23,12,35
2017,Guinea,GIN,Greece,GRC,11,0,33,16,60
2017,Haiti,HTI,Greece,GRC,5,0,11,5,21
2017,Cote d'Ivoire,CIV,Greece,GRC,5,0,12,17,34
2017,India,IND,Greece,GRC,0,0,60,26,86
2017,Indonesia,IDN,Greece,GRC,0,0,11,0,11
2017,Iran (Islamic Rep. of),IRN,Greece,GRC,360,10,249,333,952
2017,Iraq,IRQ,Greece,GRC,1245,428,521,838,3032
2017,Jordan,JOR,Greece,GRC,5,0,0,5,10
2017,Kuwait,KWT,Greece,GRC,42,0,0,5,47
2017,Libya,LBY,Greece,GRC,5,0,0,14,19
2017,Lebanon,LBN,Greece,GRC,14,0,51,27,92
2017,Sri Lanka,LKA,Greece,GRC,5,0,10,14,29
2017,Mauritania,MRT,Greece,GRC,5,0,0,0,5
2017,Rep. of Moldova,MDA,Greece,GRC,0,0,25,18,43
2017,Mali,MLI,Greece,GRC,5,10,21,19,55
2017,Morocco,MAR,Greece,GRC,42,0,187,134,363
2017,Myanmar,MMR,Greece,GRC,14,0,10,0,24
2017,Nepal,NPL,Greece,GRC,0,0,42,12,54
2017,Niger,NER,Greece,GRC,5,0,10,0,15
2017,Nigeria,NGA,Greece,GRC,21,5,103,26,155
2017,Pakistan,PAK,Greece,GRC,111,16,5613,705,6445
2017,Russian Federation,RUS,Greece,GRC,0,0,11,5,16
2017,Saudi Arabia,SAU,Greece,GRC,5,0,0,5,10
2017,Serbia and Kosovo: S/RES/1244 (1999),SRB,Greece,GRC,0,0,5,5,10
2017,Senegal,SEN,Greece,GRC,0,0,23,11,34
2017,Sierra Leone,SLE,Greece,GRC,5,0,25,11,41
2017,Somalia,SOM,Greece,GRC,32,27,5,29,93
2017,Sudan,SDN,Greece,GRC,27,0,15,5,47
2017,Syrian Arab Rep.,SYR,Greece,GRC,4806,0,20,1409,6235
2017,Tunisia,TUN,Greece,GRC,10,0,28,27,65
2017,Turkey,TUR,Greece,GRC,53,0,52,209,314
2017,Uganda,UGA,Greece,GRC,5,0,10,0,15
2017,Ukraine,UKR,Greece,GRC,0,16,50,23,89
2017,Uzbekistan,UZB,Greece,GRC,0,0,5,5,10
2017,Venezuela (Bolivarian Republic of),VEN,Greece,GRC,0,0,5,0,5
2017,Yemen,YEM,Greece,GRC,63,38,0,13,114
2017,Zimbabwe,ZWE,Greece,GRC,0,0,5,10,15
2017,Stateless,XXA,Greece,GRC,128,0,10,23,161
2017,Unknown ,,Greece,GRC,0,0,0,22578,22578
2017,Cuba,CUB,Guatemala,GTM,0,0,5,0,5
2017,Honduras,HND,Guatemala,GTM,5,0,0,5,10
2017,Nicaragua,NIC,Guatemala,GTM,0,0,0,5,5
2017,El Salvador,SLV,Guatemala,GTM,56,0,5,27,88
2017,Venezuela (Bolivarian Republic of),VEN,Guatemala,GTM,5,0,0,5,10
2017,Dem. Rep. of the Congo,COD,Guinea,GIN,5,0,0,0,5
2017,Cote d'Ivoire,CIV,Guinea,GIN,51,0,5,10,66
2017,Liberia,LBR,Guinea,GIN,5,0,0,10,15
2017,Sierra Leone,SLE,Guinea,GIN,29,0,0,18,47
2017,El Salvador,SLV,Honduras,HND,5,0,0,0,5
2017,Venezuela (Bolivarian Republic of),VEN,Honduras,HND,5,0,0,0,5
2017,Afghanistan,AFG,Croatia,HRV,5,0,56,595,656
2017,Albania,ALB,Croatia,HRV,0,0,0,5,5
2017,Algeria,DZA,Croatia,HRV,0,0,15,60,75
2017,Bangladesh,BGD,Croatia,HRV,0,0,0,33,33
2017,Bosnia and Herzegovina,BIH,Croatia,HRV,0,0,5,5,10
2017,Cameroon,CMR,Croatia,HRV,0,0,0,10,10
2017,Cuba,CUB,Croatia,HRV,0,0,0,31,31
2017,Eritrea,ERI,Croatia,HRV,11,0,0,10,21
2017,India,IND,Croatia,HRV,0,0,0,5,5
2017,Iran (Islamic Rep. of),IRN,Croatia,HRV,0,0,30,78,108
2017,Iraq,IRQ,Croatia,HRV,23,0,44,66,133
2017,Libya,LBY,Croatia,HRV,0,0,0,31,31
2017,Sri Lanka,LKA,Croatia,HRV,0,0,0,5,5
2017,North Macedonia,MKD,Croatia,HRV,0,0,5,5,10
2017,Morocco,MAR,Croatia,HRV,0,0,5,24,29
2017,Nigeria,NGA,Croatia,HRV,0,0,0,5,5
2017,Pakistan,PAK,Croatia,HRV,0,0,0,232,232
2017,Serbia and Kosovo: S/RES/1244 (1999),SRB,Croatia,HRV,0,0,5,26,31
2017,Somalia,SOM,Croatia,HRV,0,0,0,5,5
2017,Syrian Arab Rep.,SYR,Croatia,HRV,111,19,27,113,270
2017,Tunisia,TUN,Croatia,HRV,0,0,5,19,24
2017,Turkey,TUR,Croatia,HRV,5,0,5,186,196
2017,Uzbekistan,UZB,Croatia,HRV,0,0,0,5,5
2017,Yemen,YEM,Croatia,HRV,5,0,0,0,5
2017,Unknown ,,Croatia,HRV,0,0,0,5,5
2017,Afghanistan,AFG,Hungary,HUN,20,509,1220,847,2596
2017,Algeria,DZA,Hungary,HUN,0,0,91,36,127
2017,Egypt,EGY,Hungary,HUN,0,0,19,10,29
2017,Armenia,ARM,Hungary,HUN,0,0,10,18,28
2017,Azerbaijan,AZE,Hungary,HUN,0,5,0,0,5
2017,Bangladesh,BGD,Hungary,HUN,0,0,10,11,21
2017,China,CHN,Hungary,HUN,0,0,5,5,10
2017,Cameroon,CMR,Hungary,HUN,0,0,5,0,5
2017,Congo,COG,Hungary,HUN,5,0,5,0,10
2017,Cuba,CUB,Hungary,HUN,0,10,28,0,38
2017,Eritrea,ERI,Hungary,HUN,0,0,5,0,5
2017,Palestinian,PSE,Hungary,HUN,5,5,14,15,39
2017,India,IND,Hungary,HUN,0,0,10,5,15
2017,Indonesia,IDN,Hungary,HUN,0,0,87,0,87
2017,Iran (Islamic Rep. of),IRN,Hungary,HUN,30,5,510,73,618
2017,Iraq,IRQ,Hungary,HUN,10,168,0,418,596
2017,Kyrgyzstan,KGZ,Hungary,HUN,0,0,5,0,5
2017,Libya,LBY,Hungary,HUN,0,0,5,5,10
2017,Lebanon,LBN,Hungary,HUN,0,0,5,0,5
2017,Sri Lanka,LKA,Hungary,HUN,0,0,0,5,5
2017,Mongolia,MNG,Hungary,HUN,0,0,0,5,5
2017,Morocco,MAR,Hungary,HUN,0,0,41,15,56
2017,Nepal,NPL,Hungary,HUN,0,0,5,5,10
2017,Nigeria,NGA,Hungary,HUN,0,0,16,10,26
2017,Pakistan,PAK,Hungary,HUN,10,0,154,143,307
2017,Russian Federation,RUS,Hungary,HUN,0,0,5,0,5
2017,Serbia and Kosovo: S/RES/1244 (1999),SRB,Hungary,HUN,0,0,0,20,20
2017,Somalia,SOM,Hungary,HUN,0,11,5,14,30
2017,Sudan,SDN,Hungary,HUN,0,0,575,0,575
2017,Syrian Arab Rep.,SYR,Hungary,HUN,10,374,0,351,735
2017,Tajikistan,TJK,Hungary,HUN,0,0,5,5,10
2017,Tunisia,TUN,Hungary,HUN,0,0,5,0,5
2017,Turkey,TUR,Hungary,HUN,0,0,19,15,34
2017,Ukraine,UKR,Hungary,HUN,0,0,5,5,10
2017,Stateless,XXA,Hungary,HUN,5,0,0,0,5
2017,Unknown ,,Hungary,HUN,10,13,0,0,23
2017,Afghanistan,AFG,Iceland,ISL,0,5,0,19,24
2017,Albania,ALB,Iceland,ISL,5,0,73,194,272
2017,Algeria,DZA,Iceland,ISL,0,0,0,10,10
2017,Egypt,EGY,Iceland,ISL,0,0,0,11,11
2017,Belarus,BLR,Iceland,ISL,0,0,0,5,5
2017,Eritrea,ERI,Iceland,ISL,0,0,0,5,5
2017,Palestinian,PSE,Iceland,ISL,5,0,0,5,10
2017,Georgia,GEO,Iceland,ISL,0,5,73,196,274
2017,Ghana,GHA,Iceland,ISL,0,0,0,5,5
2017,India,IND,Iceland,ISL,0,0,0,5,5
2017,Iran (Islamic Rep. of),IRN,Iceland,ISL,0,0,0,15,15
2017,Iraq,IRQ,Iceland,ISL,18,5,0,54,77
2017,Israel,ISR,Iceland,ISL,0,0,5,0,5
2017,Kazakhstan,KAZ,Iceland,ISL,0,0,5,5,10
2017,North Macedonia,MKD,Iceland,ISL,0,0,81,149,230
2017,Morocco,MAR,Iceland,ISL,0,0,0,10,10
2017,Nigeria,NGA,Iceland,ISL,0,0,5,10,15
2017,Pakistan,PAK,Iceland,ISL,5,0,0,21,26
2017,Poland,POL,Iceland,ISL,0,0,0,5,5
2017,Romania,ROU,Iceland,ISL,0,0,0,5,5
2017,Russian Federation,RUS,Iceland,ISL,0,0,5,5,10
2017,Serbia and Kosovo: S/RES/1244 (1999),SRB,Iceland,ISL,0,0,26,12,38
2017,Somalia,SOM,Iceland,ISL,0,0,0,28,28
2017,Syrian Arab Rep.,SYR,Iceland,ISL,10,5,0,18,33
2017,United States of America,USA,Iceland,ISL,0,0,0,5,5
2017,Afghanistan,AFG,Ireland,IRL,5,14,5,0,24
2017,Albania,ALB,Ireland,IRL,0,0,33,10,43
2017,Algeria,DZA,Ireland,IRL,0,0,27,0,27
2017,Egypt,EGY,Ireland,IRL,0,0,5,0,5
2017,Australia,AUS,Ireland,IRL,0,0,0,5,5
2017,Bangladesh,BGD,Ireland,IRL,0,0,26,5,31
2017,Botswana,BWA,Ireland,IRL,0,0,5,0,5
2017,Brazil,BRA,Ireland,IRL,0,0,5,5,10
2017,China,CHN,Ireland,IRL,0,0,12,5,17
2017,Cameroon,CMR,Ireland,IRL,0,0,5,0,5
2017,Dem. Rep. of the Congo,COD,Ireland,IRL,0,17,24,0,41
2017,Palestinian,PSE,Ireland,IRL,5,0,0,0,5
2017,Georgia,GEO,Ireland,IRL,0,0,51,10,61
2017,Ghana,GHA,Ireland,IRL,0,0,17,0,17
2017,India,IND,Ireland,IRL,0,0,26,10,36
2017,Iran (Islamic Rep. of),IRN,Ireland,IRL,5,0,0,0,5
2017,Iraq,IRQ,Ireland,IRL,62,5,5,0,72
2017,Kuwait,KWT,Ireland,IRL,0,0,5,0,5
2017,Liberia,LBR,Ireland,IRL,0,0,5,0,5
2017,Libya,LBY,Ireland,IRL,23,12,0,0,35
2017,Lesotho,LSO,Ireland,IRL,0,0,5,0,5
2017,Malaysia,MYS,Ireland,IRL,0,0,5,0,5
2017,Malawi,MWI,Ireland,IRL,0,10,67,0,77
2017,Mongolia,MNG,Ireland,IRL,0,0,5,0,5
2017,Mauritius,MUS,Ireland,IRL,0,0,19,0,19
2017,Nepal,NPL,Ireland,IRL,0,0,10,0,10
2017,Nigeria,NGA,Ireland,IRL,0,0,200,17,217
2017,Pakistan,PAK,Ireland,IRL,0,0,191,20,211
2017,South Africa,ZAF,Ireland,IRL,0,0,72,5,77
2017,Russian Federation,RUS,Ireland,IRL,0,0,5,0,5
2017,Rwanda,RWA,Ireland,IRL,0,0,5,0,5
2017,Sierra Leone,SLE,Ireland,IRL,0,0,5,0,5
2017,Somalia,SOM,Ireland,IRL,5,5,0,0,10
2017,Viet Nam,VNM,Ireland,IRL,0,0,5,0,5
2017,Sudan,SDN,Ireland,IRL,0,0,5,0,5
2017,Eswatini,SWZ,Ireland,IRL,0,0,5,0,5
2017,Syrian Arab Rep.,SYR,Ireland,IRL,541,0,0,0,541
2017,Uganda,UGA,Ireland,IRL,0,0,5,0,5
2017,Ukraine,UKR,Ireland,IRL,0,0,17,12,29
2017,Venezuela (Bolivarian Republic of),VEN,Ireland,IRL,0,0,5,0,5
2017,Zimbabwe,ZWE,Ireland,IRL,10,5,130,0,145
2017,Afghanistan,AFG,Italy,ITA,361,1442,169,184,2156
2017,Albania,ALB,Italy,ITA,25,83,124,44,276
2017,Algeria,DZA,Italy,ITA,10,22,44,36,112
2017,Egypt,EGY,Italy,ITA,31,300,296,138,765
2017,Armenia,ARM,Italy,ITA,0,20,10,5,35
2017,Azerbaijan,AZE,Italy,ITA,0,5,0,0,5
2017,Burundi,BDI,Italy,ITA,0,5,0,0,5
2017,Benin,BEN,Italy,ITA,5,56,108,21,190
2017,Bangladesh,BGD,Italy,ITA,81,1802,3894,690,6467
2017,Burkina Faso,BFA,Italy,ITA,11,160,326,57,554
2017,Belarus,BLR,Italy,ITA,0,5,5,0,10
2017,Bolivia (Plurinational State of),BOL,Italy,ITA,0,0,5,5,10
2017,Brazil,BRA,Italy,ITA,13,26,16,5,60
2017,Bosnia and Herzegovina,BIH,Italy,ITA,5,59,21,10,95
2017,Central African Rep.,CAF,Italy,ITA,10,10,5,10,35
2017,Chad,TCD,Italy,ITA,5,27,20,27,79
2017,China,CHN,Italy,ITA,5,29,322,42,398
2017,Cameroon,CMR,Italy,ITA,156,324,493,374,1347
2017,Congo,COG,Italy,ITA,23,45,20,15,103
2017,Dem. Rep. of the Congo,COD,Italy,ITA,24,68,14,13,119
2017,Comoros,COM,Italy,ITA,0,0,0,11,11
2017,Colombia,COL,Italy,ITA,21,30,25,5,81
2017,Cuba,CUB,Italy,ITA,5,33,17,5,60
2017,Dominican Rep.,DOM,Italy,ITA,0,10,5,0,15
2017,Ecuador,ECU,Italy,ITA,0,10,0,0,10
2017,Equatorial Guinea,GNQ,Italy,ITA,0,0,5,5,10
2017,Eritrea,ERI,Italy,ITA,164,111,108,302,685
2017,Ethiopia,ETH,Italy,ITA,106,84,33,72,295
2017,Gabon,GAB,Italy,ITA,0,0,5,0,5
2017,Gambia,GMB,Italy,ITA,136,2469,3825,627,7057
2017,Palestinian,PSE,Italy,ITA,153,26,75,51,305
2017,Georgia,GEO,Italy,ITA,0,83,45,28,156
2017,Ghana,GHA,Italy,ITA,52,1220,2187,402,3861
2017,Guinea-Bissau,GNB,Italy,ITA,0,184,377,47,608
2017,Guinea,GIN,Italy,ITA,54,1147,2407,1300,4908
2017,Honduras,HND,Italy,ITA,15,10,5,5,35
2017,Cote d'Ivoire,CIV,Italy,ITA,197,1294,2845,1696,6032
2017,India,IND,Italy,ITA,10,78,189,117,394
2017,Iran (Islamic Rep. of),IRN,Italy,ITA,83,63,83,62,291
2017,Iraq,IRQ,Italy,ITA,341,930,138,141,1550
2017,Israel,ISR,Italy,ITA,0,5,0,0,5
2017,Jordan,JOR,Italy,ITA,0,0,5,0,5
2017,Kenya,KEN,Italy,ITA,5,5,5,5,20
2017,Kyrgyzstan,KGZ,Italy,ITA,5,17,0,0,22
2017,Liberia,LBR,Italy,ITA,5,62,126,28,221
2017,Libya,LBY,Italy,ITA,63,172,32,55,322
2017,Lebanon,LBN,Italy,ITA,12,29,17,18,76
2017,Sri Lanka,LKA,Italy,ITA,10,36,47,17,110
2017,Mauritania,MRT,Italy,ITA,11,22,27,14,74
2017,North Macedonia,MKD,Italy,ITA,0,11,13,0,24
2017,Rep. of Moldova,MDA,Italy,ITA,0,16,21,5,42
2017,Mali,MLI,Italy,ITA,75,1839,2575,780,5269
2017,Morocco,MAR,Italy,ITA,56,222,1004,608,1890
2017,Montenegro,MNE,Italy,ITA,0,5,0,0,5
2017,Mauritius,MUS,Italy,ITA,0,5,0,0,5
2017,Nepal,NPL,Italy,ITA,5,17,13,5,40
2017,Niger,NER,Italy,ITA,10,76,103,40,229
2017,Nicaragua,NIC,Italy,ITA,0,5,10,5,20
2017,Nigeria,NGA,Italy,ITA,787,3557,12441,2418,19203
2017,Pakistan,PAK,Italy,ITA,337,2438,6140,1574,10489
2017,Peru,PER,Italy,ITA,0,13,12,5,30
2017,Philippines,PHL,Italy,ITA,0,12,40,38,90
2017,South Africa,ZAF,Italy,ITA,0,5,0,0,5
2017,Russian Federation,RUS,Italy,ITA,22,24,5,5,56
2017,Rwanda,RWA,Italy,ITA,0,5,0,0,5
2017,El Salvador,SLV,Italy,ITA,149,239,49,47,484
2017,Serbia and Kosovo: S/RES/1244 (1999),SRB,Italy,ITA,10,115,194,87,406
2017,Senegal,SEN,Italy,ITA,79,1387,3700,757,5923
2017,Sierra Leone,SLE,Italy,ITA,23,125,253,139,540
2017,Somalia,SOM,Italy,ITA,812,1248,66,192,2318
2017,Viet Nam,VNM,Italy,ITA,0,5,0,0,5
2017,Sudan,SDN,Italy,ITA,78,114,80,184,456
2017,Syrian Arab Rep.,SYR,Italy,ITA,1009,22,82,77,1190
2017,United Rep. of Tanzania,TZA,Italy,ITA,5,0,5,0,10
2017,Togo,TGO,Italy,ITA,25,127,250,54,456
2017,Tunisia,TUN,Italy,ITA,11,57,211,114,393
2017,Turkey,TUR,Italy,ITA,65,179,58,24,326
2017,Uganda,UGA,Italy,ITA,10,0,5,0,15
2017,Ukraine,UKR,Italy,ITA,42,1222,460,109,1833
2017,Venezuela (Bolivarian Republic of),VEN,Italy,ITA,35,75,5,5,120
2017,Yemen,YEM,Italy,ITA,19,20,5,5,49
2017,Zimbabwe,ZWE,Italy,ITA,0,0,5,0,5
2017,Stateless,XXA,Italy,ITA,0,5,0,0,5
2017,Unknown ,,Italy,ITA,10,92,104,35,241
2017,Egypt,EGY,Japan,JPN,5,0,0,0,5
2017,Bangladesh,BGD,Japan,JPN,0,0,180,36,216
2017,Cambodia,KHM,Japan,JPN,0,0,63,27,90
2017,China,CHN,Japan,JPN,0,0,80,41,121
2017,Cameroon,CMR,Japan,JPN,0,0,0,13,13
2017,Ghana,GHA,Japan,JPN,0,5,79,15,99
2017,India,IND,Japan,JPN,0,5,66,82,153
2017,Indonesia,IDN,Japan,JPN,0,0,1315,144,1459
2017,Iran (Islamic Rep. of),IRN,Japan,JPN,0,0,77,18,95
2017,Sri Lanka,LKA,Japan,JPN,0,5,384,98,487
2017,Mongolia,MNG,Japan,JPN,0,0,0,14,14
2017,Myanmar,MMR,Japan,JPN,0,5,475,156,636
2017,Nepal,NPL,Japan,JPN,0,0,1644,140,1784
2017,Nigeria,NGA,Japan,JPN,0,0,93,10,103
2017,Pakistan,PAK,Japan,JPN,0,0,136,37,173
2017,Philippines,PHL,Japan,JPN,0,0,1794,284,2078
2017,Russian Federation,RUS,Japan,JPN,0,0,0,10,10
2017,Senegal,SEN,Japan,JPN,0,0,0,10,10
2017,Viet Nam,VNM,Japan,JPN,0,0,2295,218,2513
2017,Syrian Arab Rep.,SYR,Japan,JPN,5,5,0,0,10
2017,Tunisia,TUN,Japan,JPN,0,0,0,5,5
2017,Turkey,TUR,Japan,JPN,0,5,675,187,867
2017,Unknown ,,Japan,JPN,0,0,380,69,449
2017,Afghanistan,AFG,Kazakhstan,KAZ,57,0,169,20,246
2017,Syrian Arab Rep.,SYR,Kazakhstan,KAZ,5,0,0,0,5
2017,Turkey,TUR,Kazakhstan,KAZ,0,0,10,5,15
2017,Afghanistan,AFG,Kyrgyzstan,KGZ,5,0,82,17,104
2017,Iran (Islamic Rep. of),IRN,Kyrgyzstan,KGZ,0,0,5,0,5
2017,Iraq,IRQ,Kyrgyzstan,KGZ,0,0,0,5,5
2017,Pakistan,PAK,Kyrgyzstan,KGZ,0,0,5,0,5
2017,Syrian Arab Rep.,SYR,Kyrgyzstan,KGZ,5,0,0,0,5
2017,Ukraine,UKR,Kyrgyzstan,KGZ,5,0,0,0,5
2017,Uzbekistan,UZB,Kyrgyzstan,KGZ,0,0,5,5,10
2017,Dem. Rep. of the Congo,COD,Lesotho,LSO,5,0,0,0,5
2017,Uganda,UGA,Lesotho,LSO,5,0,0,0,5
2017,Afghanistan,AFG,Liechtenstein,LIE,0,5,0,5,10
2017,Azerbaijan,AZE,Liechtenstein,LIE,0,0,0,5,5
2017,Belarus,BLR,Liechtenstein,LIE,0,0,0,10,10
2017,China,CHN,Liechtenstein,LIE,5,0,0,5,10
2017,Eritrea,ERI,Liechtenstein,LIE,0,0,0,5,5
2017,Georgia,GEO,Liechtenstein,LIE,0,0,0,5,5
2017,North Macedonia,MKD,Liechtenstein,LIE,0,0,0,11,11
2017,Serbia and Kosovo: S/RES/1244 (1999),SRB,Liechtenstein,LIE,0,0,10,20,30
2017,Somalia,SOM,Liechtenstein,LIE,0,0,0,12,12
2017,Syrian Arab Rep.,SYR,Liechtenstein,LIE,10,0,0,0,10
2017,Ukraine,UKR,Liechtenstein,LIE,0,0,0,12,12
2017,Afghanistan,AFG,Lithuania,LTU,5,0,0,24,29
2017,Armenia,ARM,Lithuania,LTU,0,0,11,5,16
2017,Belarus,BLR,Lithuania,LTU,0,0,10,5,15
2017,Cuba,CUB,Lithuania,LTU,0,0,5,0,5
2017,Eritrea,ERI,Lithuania,LTU,16,10,0,0,26
2017,Georgia,GEO,Lithuania,LTU,0,0,0,10,10
2017,Iraq,IRQ,Lithuania,LTU,13,0,10,0,23
2017,Sri Lanka,LKA,Lithuania,LTU,0,0,5,0,5
2017,Pakistan,PAK,Lithuania,LTU,0,0,0,5,5
2017,Russian Federation,RUS,Lithuania,LTU,5,0,20,41,66
2017,Syrian Arab Rep.,SYR,Lithuania,LTU,201,0,0,0,201
2017,Tajikistan,TJK,Lithuania,LTU,12,0,5,13,30
2017,Turkey,TUR,Lithuania,LTU,12,0,5,0,17
2017,Ukraine,UKR,Lithuania,LTU,0,0,0,12,12
2017,Stateless,XXA,Lithuania,LTU,12,0,0,0,12
2017,Afghanistan,AFG,Luxembourg,LUX,160,20,5,0,185
2017,Albania,ALB,Luxembourg,LUX,0,0,130,0,130
2017,Algeria,DZA,Luxembourg,LUX,0,0,15,0,15
2017,Bosnia and Herzegovina,BIH,Luxembourg,LUX,0,0,60,0,60
2017,Cameroon,CMR,Luxembourg,LUX,0,0,5,0,5
2017,Eritrea,ERI,Luxembourg,LUX,95,5,0,0,100
2017,Ethiopia,ETH,Luxembourg,LUX,5,0,0,0,5
2017,Guinea,GIN,Luxembourg,LUX,0,0,5,0,5
2017,Iran (Islamic Rep. of),IRN,Luxembourg,LUX,25,0,5,0,30
2017,Iraq,IRQ,Luxembourg,LUX,290,5,120,0,415
2017,Libya,LBY,Luxembourg,LUX,0,0,5,0,5
2017,North Macedonia,MKD,Luxembourg,LUX,0,0,20,0,20
2017,Morocco,MAR,Luxembourg,LUX,0,0,15,0,15
2017,Montenegro,MNE,Luxembourg,LUX,0,0,20,0,20
2017,Nigeria,NGA,Luxembourg,LUX,0,0,10,0,10
2017,Russian Federation,RUS,Luxembourg,LUX,0,0,5,0,5
2017,Serbia and Kosovo: S/RES/1244 (1999),SRB,Luxembourg,LUX,0,0,120,0,120
2017,Slovakia,SVK,Luxembourg,LUX,0,0,5,0,5
2017,Syrian Arab Rep.,SYR,Luxembourg,LUX,450,0,5,0,455
2017,Tunisia,TUN,Luxembourg,LUX,0,0,10,0,10
2017,Turkey,TUR,Luxembourg,LUX,0,0,10,0,10
2017,Ukraine,UKR,Luxembourg,LUX,0,0,10,0,10
2017,Stateless,XXA,Luxembourg,LUX,15,0,0,0,15
2017,Unknown ,,Luxembourg,LUX,20,0,0,0,20
2017,Afghanistan,AFG,Latvia,LVA,13,0,0,0,13
2017,Armenia,ARM,Latvia,LVA,0,0,10,0,10
2017,Azerbaijan,AZE,Latvia,LVA,0,0,5,5,10
2017,Bangladesh,BGD,Latvia,LVA,0,0,5,5,10
2017,Belarus,BLR,Latvia,LVA,0,0,5,5,10
2017,Eritrea,ERI,Latvia,LVA,0,19,0,0,19
2017,Georgia,GEO,Latvia,LVA,0,0,0,10,10
2017,India,IND,Latvia,LVA,0,0,5,0,5
2017,Iraq,IRQ,Latvia,LVA,0,0,0,5,5
2017,Kyrgyzstan,KGZ,Latvia,LVA,0,0,5,0,5
2017,Lebanon,LBN,Latvia,LVA,0,0,5,0,5
2017,Sri Lanka,LKA,Latvia,LVA,0,0,5,0,5
2017,Pakistan,PAK,Latvia,LVA,0,0,0,5,5
2017,Philippines,PHL,Latvia,LVA,0,0,0,5,5
2017,Russian Federation,RUS,Latvia,LVA,0,0,13,5,18
2017,Viet Nam,VNM,Latvia,LVA,0,0,12,23,35
2017,Syrian Arab Rep.,SYR,Latvia,LVA,0,210,0,5,215
2017,Tajikistan,TJK,Latvia,LVA,5,0,11,5,21
2017,Turkey,TUR,Latvia,LVA,12,0,0,0,12
2017,Ukraine,UKR,Latvia,LVA,0,0,5,5,10
2017,Armenia,ARM,Rep. of Moldova,MDA,0,0,0,5,5
2017,Georgia,GEO,Rep. of Moldova,MDA,0,0,5,0,5
2017,Russian Federation,RUS,Rep. of Moldova,MDA,0,0,5,5,10
2017,Syrian Arab Rep.,SYR,Rep. of Moldova,MDA,0,10,0,0,10
2017,Turkey,TUR,Rep. of Moldova,MDA,0,0,5,0,5
2017,Ukraine,UKR,Rep. of Moldova,MDA,0,0,25,5,30
2017,Brazil,BRA,Mexico,MEX,0,0,0,5,5
2017,Canada,CAN,Mexico,MEX,0,0,0,17,17
2017,Cameroon,CMR,Mexico,MEX,0,0,5,48,53
2017,Congo,COG,Mexico,MEX,0,0,0,5,5
2017,Colombia,COL,Mexico,MEX,10,0,20,5,35
2017,Cuba,CUB,Mexico,MEX,23,0,130,519,672
2017,Ecuador,ECU,Mexico,MEX,0,0,5,10,15
2017,Ghana,GHA,Mexico,MEX,0,0,0,10,10
2017,Guatemala,GTM,Mexico,MEX,123,0,116,132,371
2017,Haiti,HTI,Mexico,MEX,0,0,15,48,63
2017,Honduras,HND,Mexico,MEX,770,0,767,774,2311
2017,Iran (Islamic Rep. of),IRN,Mexico,MEX,10,0,0,0,10
2017,Israel,ISR,Mexico,MEX,0,0,5,75,80
2017,Nicaragua,NIC,Mexico,MEX,0,0,18,20,38
2017,Nigeria,NGA,Mexico,MEX,0,0,5,0,5
2017,Russian Federation,RUS,Mexico,MEX,0,0,5,5,10
2017,El Salvador,SLV,Mexico,MEX,966,0,543,545,2054
2017,Somalia,SOM,Mexico,MEX,0,0,5,5,10
2017,Syrian Arab Rep.,SYR,Mexico,MEX,0,0,0,5,5
2017,Ukraine,UKR,Mexico,MEX,5,0,0,0,5
2017,United States of America,USA,Mexico,MEX,0,0,0,101,101
2017,Venezuela (Bolivarian Republic of),VEN,Mexico,MEX,907,0,5,63,975
2017,Yemen,YEM,Mexico,MEX,5,0,0,0,5
2017,Central African Rep.,CAF,Mali,MLI,436,0,0,0,436
2017,Dem. Rep. of the Congo,COD,Mali,MLI,5,0,0,5,10
2017,Cote d'Ivoire,CIV,Mali,MLI,0,0,0,79,79
2017,Syrian Arab Rep.,SYR,Mali,MLI,5,0,0,0,5
2017,Turkey,TUR,Mali,MLI,0,0,0,162,162
2017,Burundi,BDI,Malawi,MWI,5,12,0,20,37
2017,Dem. Rep. of the Congo,COD,Malawi,MWI,5,26,0,108,139
2017,Mozambique,MOZ,Malawi,MWI,0,0,0,1743,1743
2017,Rwanda,RWA,Malawi,MWI,0,29,0,10,39
2017,Angola,AGO,Mozambique,MOZ,0,0,0,5,5
2017,Dem. Rep. of the Congo,COD,Mozambique,MOZ,0,0,0,31,31
2017,Ethiopia,ETH,Mozambique,MOZ,0,0,0,5,5
2017,Somalia,SOM,Mozambique,MOZ,0,0,0,244,244
2017,Uganda,UGA,Mozambique,MOZ,0,0,0,10,10
2017,Afghanistan,AFG,Malta,MLT,0,0,0,5,5
2017,Egypt,EGY,Malta,MLT,0,5,5,0,10
2017,Chad,TCD,Malta,MLT,0,5,0,0,5
2017,Eritrea,ERI,Malta,MLT,5,89,10,38,142
2017,Ethiopia,ETH,Malta,MLT,5,10,5,5,25
2017,Palestinian,PSE,Malta,MLT,0,13,0,5,18
2017,Ghana,GHA,Malta,MLT,0,0,0,5,5
2017,Iraq,IRQ,Malta,MLT,27,0,5,10,42
2017,Liberia,LBR,Malta,MLT,0,5,0,0,5
2017,Libya,LBY,Malta,MLT,51,278,0,81,410
2017,North Macedonia,MKD,Malta,MLT,0,0,0,5,5
2017,Mali,MLI,Malta,MLT,0,0,0,5,5
2017,Morocco,MAR,Malta,MLT,0,0,0,5,5
2017,Nigeria,NGA,Malta,MLT,5,15,17,5,42
2017,Pakistan,PAK,Malta,MLT,0,0,0,5,5
2017,Russian Federation,RUS,Malta,MLT,0,0,5,0,5
2017,Senegal,SEN,Malta,MLT,0,0,0,5,5
2017,Somalia,SOM,Malta,MLT,5,46,5,103,159
2017,Sudan,SDN,Malta,MLT,0,5,5,5,15
2017,Syrian Arab Rep.,SYR,Malta,MLT,50,152,0,67,269
2017,Ukraine,UKR,Malta,MLT,0,10,81,18,109
2017,Venezuela (Bolivarian Republic of),VEN,Malta,MLT,0,0,5,0,5
2017,Burundi,BDI,Namibia,NAM,26,0,12,0,38
2017,Dem. Rep. of the Congo,COD,Namibia,NAM,172,0,130,0,302
2017,Nigeria,NGA,Namibia,NAM,0,0,5,0,5
2017,Rwanda,RWA,Namibia,NAM,0,0,13,0,13
2017,United Rep. of Tanzania,TZA,Namibia,NAM,0,0,5,0,5
2017,Uganda,UGA,Namibia,NAM,0,0,5,0,5
2017,Zimbabwe,ZWE,Namibia,NAM,10,0,5,0,15
2017,Afghanistan,AFG,Netherlands,NLD,428,127,917,76,1548
2017,Albania,ALB,Netherlands,NLD,0,0,336,122,458
2017,Algeria,DZA,Netherlands,NLD,0,0,250,128,378
2017,Angola,AGO,Netherlands,NLD,0,0,5,0,5
2017,Egypt,EGY,Netherlands,NLD,25,0,77,11,113
2017,Armenia,ARM,Netherlands,NLD,0,0,41,10,51
2017,Azerbaijan,AZE,Netherlands,NLD,0,0,28,26,54
2017,Burundi,BDI,Netherlands,NLD,0,0,20,0,20
2017,Bangladesh,BGD,Netherlands,NLD,0,0,13,0,13
2017,Belarus,BLR,Netherlands,NLD,0,0,5,0,5
2017,Brazil,BRA,Netherlands,NLD,0,0,5,0,5
2017,Bosnia and Herzegovina,BIH,Netherlands,NLD,0,0,61,0,61
2017,China,CHN,Netherlands,NLD,104,0,61,5,170
2017,Cameroon,CMR,Netherlands,NLD,10,0,10,0,20
2017,Congo,COG,Netherlands,NLD,5,0,31,0,36
2017,Colombia,COL,Netherlands,NLD,0,0,29,0,29
2017,Cuba,CUB,Netherlands,NLD,0,0,71,10,81
2017,Eritrea,ERI,Netherlands,NLD,879,12,132,25,1048
2017,Ethiopia,ETH,Netherlands,NLD,38,0,60,0,98
2017,Gambia,GMB,Netherlands,NLD,0,0,51,11,62
2017,Georgia,GEO,Netherlands,NLD,0,0,221,64,285
2017,Ghana,GHA,Netherlands,NLD,0,0,12,0,12
2017,Guinea,GIN,Netherlands,NLD,5,0,77,5,87
2017,Honduras,HND,Netherlands,NLD,0,0,5,0,5
2017,Cote d'Ivoire,CIV,Netherlands,NLD,0,0,5,0,5
2017,India,IND,Netherlands,NLD,0,0,29,18,47
2017,Iran (Islamic Rep. of),IRN,Netherlands,NLD,594,91,721,59,1465
2017,Iraq,IRQ,Netherlands,NLD,360,62,779,167,1368
2017,Jamaica,JAM,Netherlands,NLD,10,0,0,0,10
2017,Jordan,JOR,Netherlands,NLD,0,0,15,0,15
2017,Libya,LBY,Netherlands,NLD,5,0,90,52,147
2017,Lebanon,LBN,Netherlands,NLD,5,0,26,5,36
2017,Sri Lanka,LKA,Netherlands,NLD,5,0,22,5,32
2017,Mauritania,MRT,Netherlands,NLD,0,0,5,0,5
2017,North Macedonia,MKD,Netherlands,NLD,0,0,101,12,113
2017,Rep. of Moldova,MDA,Netherlands,NLD,0,0,150,14,164
2017,Mali,MLI,Netherlands,NLD,0,0,10,5,15
2017,Mongolia,MNG,Netherlands,NLD,0,0,10,5,15
2017,Morocco,MAR,Netherlands,NLD,11,0,273,121,405
2017,Myanmar,MMR,Netherlands,NLD,5,0,13,0,18
2017,Nigeria,NGA,Netherlands,NLD,14,0,111,5,130
2017,Pakistan,PAK,Netherlands,NLD,43,5,75,5,128
2017,Russian Federation,RUS,Netherlands,NLD,18,0,29,10,57
2017,El Salvador,SLV,Netherlands,NLD,0,0,10,0,10
2017,Serbia and Kosovo: S/RES/1244 (1999),SRB,Netherlands,NLD,0,0,232,15,247
2017,Senegal,SEN,Netherlands,NLD,0,0,5,10,15
2017,Sierra Leone,SLE,Netherlands,NLD,5,0,18,0,23
2017,Somalia,SOM,Netherlands,NLD,60,0,98,5,163
2017,Viet Nam,VNM,Netherlands,NLD,0,0,36,29,65
2017,Sudan,SDN,Netherlands,NLD,73,0,62,14,149
2017,Syrian Arab Rep.,SYR,Netherlands,NLD,1722,5,420,116,2263
2017,United Rep. of Tanzania,TZA,Netherlands,NLD,0,0,5,0,5
2017,Tajikistan,TJK,Netherlands,NLD,0,0,0,10,10
2017,Trinidad and Tobago,TTO,Netherlands,NLD,16,0,0,0,16
2017,Tunisia,TUN,Netherlands,NLD,0,0,36,20,56
2017,Turkey,TUR,Netherlands,NLD,204,142,79,21,446
2017,Uganda,UGA,Netherlands,NLD,32,0,45,0,77
2017,Ukraine,UKR,Netherlands,NLD,0,0,71,15,86
2017,United States of America,USA,Netherlands,NLD,0,0,5,0,5
2017,Venezuela (Bolivarian Republic of),VEN,Netherlands,NLD,0,0,35,0,35
2017,Yemen,YEM,Netherlands,NLD,157,0,10,5,172
2017,Zimbabwe,ZWE,Netherlands,NLD,0,0,10,0,10
2017,Stateless,XXA,Netherlands,NLD,199,5,91,5,300
2017,Unknown ,,Netherlands,NLD,511,130,734,323,1698
2017,Central African Rep.,CAF,Niger,NER,0,0,0,29,29
2017,Dem. Rep. of the Congo,COD,Niger,NER,0,0,5,5,10
2017,Cote d'Ivoire,CIV,Niger,NER,0,0,5,13,18
2017,Nigeria,NGA,Niger,NER,0,0,5,0,5
2017,Turkey,TUR,Niger,NER,0,0,0,16,16
2017,Honduras,HND,Nicaragua,NIC,0,0,0,5,5
2017,El Salvador,SLV,Nicaragua,NIC,0,0,0,37,37
2017,Central African Rep.,CAF,Nigeria,NGA,10,211,5,34,260
2017,Chad,TCD,Nigeria,NGA,0,0,5,0,5
2017,Cameroon,CMR,Nigeria,NGA,67,0,5,0,72
2017,Dem. Rep. of the Congo,COD,Nigeria,NGA,15,0,0,0,15
2017,Eritrea,ERI,Nigeria,NGA,5,0,0,5,10
2017,Cote d'Ivoire,CIV,Nigeria,NGA,5,0,0,5,10
2017,Mali,MLI,Nigeria,NGA,0,0,0,11,11
2017,Syrian Arab Rep.,SYR,Nigeria,NGA,55,0,0,21,76
2017,Turkey,TUR,Nigeria,NGA,139,0,0,0,139
2017,Afghanistan,AFG,Norway,NOR,134,57,1260,83,1534
2017,Albania,ALB,Norway,NOR,5,0,63,20,88
2017,Algeria,DZA,Norway,NOR,0,0,5,15,20
2017,Angola,AGO,Norway,NOR,0,0,0,11,11
2017,Egypt,EGY,Norway,NOR,0,0,5,5,10
2017,Armenia,ARM,Norway,NOR,0,0,10,0,10
2017,Australia,AUS,Norway,NOR,0,0,5,0,5
2017,Azerbaijan,AZE,Norway,NOR,0,0,5,0,5
2017,Bangladesh,BGD,Norway,NOR,0,0,5,5,10
2017,Belarus,BLR,Norway,NOR,0,0,0,5,5
2017,Bosnia and Herzegovina,BIH,Norway,NOR,0,0,5,104,109
2017,China,CHN,Norway,NOR,15,0,5,10,30
2017,Cameroon,CMR,Norway,NOR,0,0,5,0,5
2017,Dem. Rep. of the Congo,COD,Norway,NOR,5,0,5,5,15
2017,Colombia,COL,Norway,NOR,0,0,16,0,16
2017,Eritrea,ERI,Norway,NOR,746,0,19,40,805
2017,Ethiopia,ETH,Norway,NOR,59,0,69,20,148
2017,Gambia,GMB,Norway,NOR,0,0,0,5,5
2017,Georgia,GEO,Norway,NOR,0,0,31,5,36
2017,Ghana,GHA,Norway,NOR,5,0,5,0,10
2017,Guinea,GIN,Norway,NOR,0,0,0,5,5
2017,Cote d'Ivoire,CIV,Norway,NOR,0,0,0,5,5
2017,India,IND,Norway,NOR,0,0,5,0,5
2017,Iran (Islamic Rep. of),IRN,Norway,NOR,194,0,148,46,388
2017,Iraq,IRQ,Norway,NOR,338,5,381,56,780
2017,Israel,ISR,Norway,NOR,0,0,5,0,5
2017,Jordan,JOR,Norway,NOR,0,0,5,10,15
2017,Kazakhstan,KAZ,Norway,NOR,0,0,5,0,5
2017,Rep. of Korea,KOR,Norway,NOR,0,0,5,0,5
2017,Libya,LBY,Norway,NOR,5,10,5,5,25
2017,Lebanon,LBN,Norway,NOR,0,0,5,5,10
2017,Sri Lanka,LKA,Norway,NOR,0,0,10,0,10
2017,Mauritania,MRT,Norway,NOR,0,0,0,5,5
2017,Mexico,MEX,Norway,NOR,0,0,5,0,5
2017,Mongolia,MNG,Norway,NOR,0,0,12,0,12
2017,Morocco,MAR,Norway,NOR,0,0,27,30,57
2017,Mozambique,MOZ,Norway,NOR,0,0,0,5,5
2017,Myanmar,MMR,Norway,NOR,5,0,5,0,10
2017,Nigeria,NGA,Norway,NOR,5,0,10,14,29
2017,Pakistan,PAK,Norway,NOR,0,0,15,14,29
2017,Peru,PER,Norway,NOR,0,0,5,0,5
2017,Philippines,PHL,Norway,NOR,0,0,5,0,5
2017,Romania,ROU,Norway,NOR,0,0,5,0,5
2017,Russian Federation,RUS,Norway,NOR,5,0,27,30,62
2017,Rwanda,RWA,Norway,NOR,0,0,0,5,5
2017,El Salvador,SLV,Norway,NOR,0,0,10,5,15
2017,Serbia and Kosovo: S/RES/1244 (1999),SRB,Norway,NOR,0,0,20,10,30
2017,Senegal,SEN,Norway,NOR,0,0,0,5,5
2017,Somalia,SOM,Norway,NOR,45,14,46,12,117
2017,Sudan,SDN,Norway,NOR,13,0,12,25,50
2017,South Sudan,SSD,Norway,NOR,10,0,0,0,10
2017,Slovakia,SVK,Norway,NOR,0,0,19,0,19
2017,Syrian Arab Rep.,SYR,Norway,NOR,1818,10,32,97,1957
2017,United Rep. of Tanzania,TZA,Norway,NOR,0,0,0,5,5
2017,Tunisia,TUN,Norway,NOR,0,0,5,0,5
2017,Turkey,TUR,Norway,NOR,119,0,20,26,165
2017,Uganda,UGA,Norway,NOR,5,0,0,5,10
2017,Ukraine,UKR,Norway,NOR,0,0,21,12,33
2017,United States of America,USA,Norway,NOR,0,0,5,0,5
2017,Uzbekistan,UZB,Norway,NOR,0,0,0,5,5
2017,Venezuela (Bolivarian Republic of),VEN,Norway,NOR,0,0,12,0,12
2017,Yemen,YEM,Norway,NOR,12,39,0,0,51
2017,Stateless,XXA,Norway,NOR,218,5,45,47,315
2017,Afghanistan,AFG,New Zealand,NZL,0,0,11,0,11
2017,Bangladesh,BGD,New Zealand,NZL,0,0,14,0,14
2017,Brazil,BRA,New Zealand,NZL,0,0,5,0,5
2017,China,CHN,New Zealand,NZL,35,0,20,0,55
2017,Colombia,COL,New Zealand,NZL,0,0,5,0,5
2017,Czechia,CZE,New Zealand,NZL,0,0,5,0,5
2017,Hungary,HUN,New Zealand,NZL,0,0,10,10,20
2017,India,IND,New Zealand,NZL,5,0,15,5,25
2017,Indonesia,IDN,New Zealand,NZL,5,0,0,0,5
2017,Iran (Islamic Rep. of),IRN,New Zealand,NZL,10,0,5,0,15
2017,Iraq,IRQ,New Zealand,NZL,10,0,10,0,20
2017,Jordan,JOR,New Zealand,NZL,5,0,0,0,5
2017,Rep. of Korea,KOR,New Zealand,NZL,0,0,5,0,5
2017,Libya,LBY,New Zealand,NZL,5,0,0,0,5
2017,Sri Lanka,LKA,New Zealand,NZL,0,0,20,0,20
2017,Malaysia,MYS,New Zealand,NZL,0,0,10,0,10
2017,Oman,OMN,New Zealand,NZL,0,0,5,0,5
2017,Pakistan,PAK,New Zealand,NZL,0,0,10,0,10
2017,Philippines,PHL,New Zealand,NZL,0,0,5,0,5
2017,South Africa,ZAF,New Zealand,NZL,0,0,11,0,11
2017,Russian Federation,RUS,New Zealand,NZL,0,0,10,0,10
2017,Saudi Arabia,SAU,New Zealand,NZL,10,0,5,5,20
2017,Syrian Arab Rep.,SYR,New Zealand,NZL,5,0,0,0,5
2017,Thailand,THA,New Zealand,NZL,0,0,5,0,5
2017,Turkey,TUR,New Zealand,NZL,5,0,13,0,18
2017,United States of America,USA,New Zealand,NZL,0,0,5,0,5
2017,Samoa,WSM,New Zealand,NZL,0,0,5,0,5
2017,Zimbabwe,ZWE,New Zealand,NZL,0,0,5,0,5
2017,Colombia,COL,Panama,PAN,52,0,28,544,624
2017,Cuba,CUB,Panama,PAN,0,0,0,109,109
2017,Dominican Rep.,DOM,Panama,PAN,0,0,0,11,11
2017,Ecuador,ECU,Panama,PAN,0,0,0,5,5
2017,Guatemala,GTM,Panama,PAN,0,0,5,5,10
2017,Haiti,HTI,Panama,PAN,0,0,0,10,10
2017,Honduras,HND,Panama,PAN,0,0,0,22,22
2017,Jamaica,JAM,Panama,PAN,0,0,0,5,5
2017,Nicaragua,NIC,Panama,PAN,0,0,0,369,369
2017,Russian Federation,RUS,Panama,PAN,0,0,0,5,5
2017,El Salvador,SLV,Panama,PAN,29,0,5,108,142
2017,Venezuela (Bolivarian Republic of),VEN,Panama,PAN,5,0,0,1434,1439
2017,Yemen,YEM,Panama,PAN,0,0,0,23,23
2017,Cuba,CUB,Paraguay,PRY,5,0,5,0,10
2017,Syrian Arab Rep.,SYR,Paraguay,PRY,0,0,0,5,5
2017,Bangladesh,BGD,Peru,PER,5,0,0,0,5
2017,Cameroon,CMR,Peru,PER,5,0,0,0,5
2017,Colombia,COL,Peru,PER,13,0,15,26,54
2017,Cuba,CUB,Peru,PER,36,0,78,48,162
2017,Dominican Rep.,DOM,Peru,PER,0,0,0,5,5
2017,Ecuador,ECU,Peru,PER,0,0,0,5,5
2017,Haiti,HTI,Peru,PER,0,0,10,0,10
2017,Nepal,NPL,Peru,PER,0,0,5,0,5
2017,Senegal,SEN,Peru,PER,0,0,0,5,5
2017,Syrian Arab Rep.,SYR,Peru,PER,5,0,0,0,5
2017,Venezuela (Bolivarian Republic of),VEN,Peru,PER,102,0,412,155,669
2017,Afghanistan,AFG,Poland,POL,0,5,5,16,26
2017,Algeria,DZA,Poland,POL,0,0,5,5,10
2017,Egypt,EGY,Poland,POL,5,0,0,0,5
2017,Armenia,ARM,Poland,POL,0,0,61,32,93
2017,Azerbaijan,AZE,Poland,POL,0,0,20,5,25
2017,Bangladesh,BGD,Poland,POL,0,0,5,5,10
2017,Burkina Faso,BFA,Poland,POL,0,0,5,0,5
2017,Belarus,BLR,Poland,POL,5,0,17,26,48
2017,Bulgaria,BGR,Poland,POL,0,0,0,5,5
2017,Central African Rep.,CAF,Poland,POL,5,0,0,0,5
2017,China,CHN,Poland,POL,0,0,5,5,10
2017,Dem. Rep. of the Congo,COD,Poland,POL,0,0,5,0,5
2017,Cuba,CUB,Poland,POL,0,0,5,0,5
2017,Eritrea,ERI,Poland,POL,0,0,0,10,10
2017,Ethiopia,ETH,Poland,POL,0,0,5,0,5
2017,Georgia,GEO,Poland,POL,0,0,22,33,55
2017,India,IND,Poland,POL,0,0,5,10,15
2017,Iran (Islamic Rep. of),IRN,Poland,POL,5,0,10,10,25
2017,Iraq,IRQ,Poland,POL,13,10,5,30,58
2017,Jamaica,JAM,Poland,POL,0,0,0,5,5
2017,Kazakhstan,KAZ,Poland,POL,0,0,25,0,25
2017,Kyrgyzstan,KGZ,Poland,POL,0,0,24,15,39
2017,Libya,LBY,Poland,POL,0,5,0,0,5
2017,Lebanon,LBN,Poland,POL,0,0,5,0,5
2017,Rep. of Moldova,MDA,Poland,POL,0,0,5,0,5
2017,Mongolia,MNG,Poland,POL,0,0,10,0,10
2017,Nigeria,NGA,Poland,POL,0,0,0,5,5
2017,Pakistan,PAK,Poland,POL,5,0,14,10,29
2017,Russian Federation,RUS,Poland,POL,14,72,1260,2142,3488
2017,Viet Nam,VNM,Poland,POL,0,0,20,16,36
2017,Syrian Arab Rep.,SYR,Poland,POL,17,12,0,21,50
2017,Tajikistan,TJK,Poland,POL,5,28,153,60,246
2017,Turkey,TUR,Poland,POL,0,0,19,18,37
2017,Ukraine,UKR,Poland,POL,56,199,354,248,857
2017,Uzbekistan,UZB,Poland,POL,0,0,10,0,10
2017,Stateless,XXA,Poland,POL,5,0,0,5,10
2017,Afghanistan,AFG,Portugal,PRT,5,0,0,0,5
2017,Algeria,DZA,Portugal,PRT,0,0,15,0,15
2017,Angola,AGO,Portugal,PRT,0,0,60,0,60
2017,Brazil,BRA,Portugal,PRT,0,0,5,0,5
2017,Central African Rep.,CAF,Portugal,PRT,0,5,5,0,10
2017,Cameroon,CMR,Portugal,PRT,0,0,20,0,20
2017,Congo,COG,Portugal,PRT,0,5,45,0,50
2017,Dem. Rep. of the Congo,COD,Portugal,PRT,0,10,115,0,125
2017,Eritrea,ERI,Portugal,PRT,85,0,0,0,85
2017,Gambia,GMB,Portugal,PRT,0,0,15,0,15
2017,Ghana,GHA,Portugal,PRT,0,0,5,0,5
2017,Guinea-Bissau,GNB,Portugal,PRT,0,0,5,0,5
2017,Guinea,GIN,Portugal,PRT,0,10,10,0,20
2017,Cote d'Ivoire,CIV,Portugal,PRT,0,0,10,0,10
2017,Iran (Islamic Rep. of),IRN,Portugal,PRT,5,0,0,0,5
2017,Iraq,IRQ,Portugal,PRT,5,35,0,0,40
2017,Sri Lanka,LKA,Portugal,PRT,5,5,0,0,10
2017,Mauritania,MRT,Portugal,PRT,0,0,10,0,10
2017,Mali,MLI,Portugal,PRT,0,5,10,0,15
2017,Morocco,MAR,Portugal,PRT,0,0,10,0,10
2017,Nigeria,NGA,Portugal,PRT,0,0,5,0,5
2017,Pakistan,PAK,Portugal,PRT,0,10,0,0,10
2017,Russian Federation,RUS,Portugal,PRT,0,0,5,0,5
2017,Senegal,SEN,Portugal,PRT,0,0,20,0,20
2017,Sierra Leone,SLE,Portugal,PRT,0,5,25,0,30
2017,Syrian Arab Rep.,SYR,Portugal,PRT,0,225,5,0,230
2017,United Rep. of Tanzania,TZA,Portugal,PRT,0,0,5,0,5
2017,Togo,TGO,Portugal,PRT,0,0,5,0,5
2017,Ukraine,UKR,Portugal,PRT,5,40,10,0,55
2017,Venezuela (Bolivarian Republic of),VEN,Portugal,PRT,0,0,10,0,10
2017,Zimbabwe,ZWE,Portugal,PRT,0,0,5,0,5
2017,Stateless,XXA,Portugal,PRT,0,15,0,0,15
2017,Afghanistan,AFG,Romania,ROU,23,29,84,55,191
2017,Albania,ALB,Romania,ROU,0,0,5,0,5
2017,Algeria,DZA,Romania,ROU,0,0,5,0,5
2017,Angola,AGO,Romania,ROU,0,5,0,0,5
2017,Egypt,EGY,Romania,ROU,5,0,10,0,15
2017,Bangladesh,BGD,Romania,ROU,0,0,25,0,25
2017,China,CHN,Romania,ROU,0,0,5,0,5
2017,Cameroon,CMR,Romania,ROU,0,0,5,0,5
2017,Cuba,CUB,Romania,ROU,0,0,11,0,11
2017,Eritrea,ERI,Romania,ROU,14,0,0,0,14
2017,Ethiopia,ETH,Romania,ROU,0,0,5,0,5
2017,Palestinian,PSE,Romania,ROU,5,5,14,0,24
2017,Ghana,GHA,Romania,ROU,0,0,5,0,5
2017,India,IND,Romania,ROU,0,0,30,5,35
2017,Iran (Islamic Rep. of),IRN,Romania,ROU,10,0,53,31,94
2017,Iraq,IRQ,Romania,ROU,325,106,331,527,1289
2017,Israel,ISR,Romania,ROU,0,0,5,0,5
2017,Jordan,JOR,Romania,ROU,0,0,5,0,5
2017,Libya,LBY,Romania,ROU,0,5,10,0,15
2017,Sri Lanka,LKA,Romania,ROU,0,0,5,0,5
2017,Rep. of Moldova,MDA,Romania,ROU,0,0,10,0,10
2017,Morocco,MAR,Romania,ROU,0,0,5,0,5
2017,Myanmar,MMR,Romania,ROU,5,0,0,0,5
2017,Nigeria,NGA,Romania,ROU,0,0,5,0,5
2017,Pakistan,PAK,Romania,ROU,0,5,241,65,311
2017,Philippines,PHL,Romania,ROU,0,0,5,0,5
2017,Serbia and Kosovo: S/RES/1244 (1999),SRB,Romania,ROU,0,0,11,0,11
2017,Somalia,SOM,Romania,ROU,12,0,11,0,23
2017,Syrian Arab Rep.,SYR,Romania,ROU,432,195,13,52,692
2017,Tunisia,TUN,Romania,ROU,0,0,10,0,10
2017,Turkey,TUR,Romania,ROU,10,0,24,5,39
2017,Ukraine,UKR,Romania,ROU,0,0,10,0,10
2017,Yemen,YEM,Romania,ROU,0,10,0,0,10
2017,Stateless,XXA,Romania,ROU,15,14,11,0,40
2017,Unknown ,,Romania,ROU,0,0,5,1542,1547
2017,Algeria,DZA,South Africa,ZAF,0,0,71,0,71
2017,Egypt,EGY,South Africa,ZAF,0,0,89,0,89
2017,Burundi,BDI,South Africa,ZAF,29,0,877,0,906
2017,Bangladesh,BGD,South Africa,ZAF,0,0,3644,0,3644
2017,Cameroon,CMR,South Africa,ZAF,0,0,353,0,353
2017,Congo,COG,South Africa,ZAF,42,0,270,0,312
2017,Dem. Rep. of the Congo,COD,South Africa,ZAF,970,0,4297,0,5267
2017,Eritrea,ERI,South Africa,ZAF,105,0,124,0,229
2017,Ethiopia,ETH,South Africa,ZAF,356,0,3341,0,3697
2017,Ghana,GHA,South Africa,ZAF,0,0,593,0,593
2017,Cote d'Ivoire,CIV,South Africa,ZAF,5,0,0,0,5
2017,India,IND,South Africa,ZAF,0,0,747,0,747
2017,Kenya,KEN,South Africa,ZAF,0,0,124,0,124
2017,Malawi,MWI,South Africa,ZAF,0,0,885,0,885
2017,Mozambique,MOZ,South Africa,ZAF,0,0,237,0,237
2017,Nepal,NPL,South Africa,ZAF,0,0,29,0,29
2017,Nigeria,NGA,South Africa,ZAF,0,0,1645,0,1645
2017,Pakistan,PAK,South Africa,ZAF,0,0,1946,0,1946
2017,Rwanda,RWA,South Africa,ZAF,5,0,100,0,105
2017,Senegal,SEN,South Africa,ZAF,0,0,205,0,205
2017,Somalia,SOM,South Africa,ZAF,732,0,1500,0,2232
2017,Syrian Arab Rep.,SYR,South Africa,ZAF,5,0,0,0,5
2017,United Rep. of Tanzania,TZA,South Africa,ZAF,0,0,151,0,151
2017,Uganda,UGA,South Africa,ZAF,0,0,784,0,784
2017,Zimbabwe,ZWE,South Africa,ZAF,12,0,3230,0,3242
2017,Unknown ,,South Africa,ZAF,0,0,471,0,471
2017,Afghanistan,AFG,Russian Federation,RUS,10,0,0,181,191
2017,Egypt,EGY,Russian Federation,RUS,0,0,0,5,5
2017,Azerbaijan,AZE,Russian Federation,RUS,0,0,0,5,5
2017,Bangladesh,BGD,Russian Federation,RUS,0,0,0,5,5
2017,Belarus,BLR,Russian Federation,RUS,0,0,0,5,5
2017,Dem. Rep. of the Congo,COD,Russian Federation,RUS,0,0,0,5,5
2017,Palestinian,PSE,Russian Federation,RUS,0,0,0,5,5
2017,Georgia,GEO,Russian Federation,RUS,0,0,0,5,5
2017,Iraq,IRQ,Russian Federation,RUS,0,0,0,5,5
2017,Kazakhstan,KAZ,Russian Federation,RUS,0,0,0,5,5
2017,Kyrgyzstan,KGZ,Russian Federation,RUS,0,0,0,10,10
2017,Dem. People's Rep. of Korea,PRK,Russian Federation,RUS,0,0,0,12,12
2017,Rep. of Moldova,MDA,Russian Federation,RUS,5,0,0,0,5
2017,Sudan,SDN,Russian Federation,RUS,0,0,0,5,5
2017,Syrian Arab Rep.,SYR,Russian Federation,RUS,0,0,0,163,163
2017,Tajikistan,TJK,Russian Federation,RUS,0,0,0,11,11
2017,Turkmenistan,TKM,Russian Federation,RUS,0,0,0,5,5
2017,Ukraine,UKR,Russian Federation,RUS,14,0,0,91,105
2017,Uzbekistan,UZB,Russian Federation,RUS,0,0,0,21,21
2017,Venezuela (Bolivarian Republic of),VEN,Russian Federation,RUS,0,0,0,5,5
2017,Yemen,YEM,Russian Federation,RUS,0,0,0,13,13
2017,Stateless,XXA,Russian Federation,RUS,0,0,0,5,5
2017,Unknown ,,Russian Federation,RUS,0,0,0,5,5
2017,Burundi,BDI,Rwanda,RWA,0,0,0,12,12
2017,Dem. Rep. of the Congo,COD,Rwanda,RWA,10,0,0,10,20
2017,Afghanistan,AFG,Serbia and Kosovo: S/RES/1244 (1999),SRB,0,0,0,109,109
2017,Algeria,DZA,Serbia and Kosovo: S/RES/1244 (1999),SRB,0,0,5,15,20
2017,Bulgaria,BGR,Serbia and Kosovo: S/RES/1244 (1999),SRB,0,0,0,10,10
2017,Cuba,CUB,Serbia and Kosovo: S/RES/1244 (1999),SRB,0,0,0,29,29
2017,Palestinian,PSE,Serbia and Kosovo: S/RES/1244 (1999),SRB,0,0,0,5,5
2017,Ghana,GHA,Serbia and Kosovo: S/RES/1244 (1999),SRB,0,0,0,5,5
2017,Iran (Islamic Rep. of),IRN,Serbia and Kosovo: S/RES/1244 (1999),SRB,0,0,0,5,5
2017,Iraq,IRQ,Serbia and Kosovo: S/RES/1244 (1999),SRB,0,0,0,38,38
2017,Libya,LBY,Serbia and Kosovo: S/RES/1244 (1999),SRB,0,10,0,22,32
2017,Morocco,MAR,Serbia and Kosovo: S/RES/1244 (1999),SRB,0,0,0,5,5
2017,Pakistan,PAK,Serbia and Kosovo: S/RES/1244 (1999),SRB,0,0,5,35,40
2017,Russian Federation,RUS,Serbia and Kosovo: S/RES/1244 (1999),SRB,0,0,0,5,5
2017,Somalia,SOM,Serbia and Kosovo: S/RES/1244 (1999),SRB,0,0,5,0,5
2017,Syrian Arab Rep.,SYR,Serbia and Kosovo: S/RES/1244 (1999),SRB,0,0,0,41,41
2017,Mali,MLI,Sierra Leone,SLE,0,0,5,0,5
2017,Afghanistan,AFG,Spain,ESP,15,37,19,5,76
2017,Albania,ALB,Spain,ESP,0,0,13,0,13
2017,Algeria,DZA,Spain,ESP,10,0,416,58,484
2017,Egypt,EGY,Spain,ESP,5,0,20,0,25
2017,Argentina,ARG,Spain,ESP,0,0,13,0,13
2017,Armenia,ARM,Spain,ESP,5,0,32,0,37
2017,Azerbaijan,AZE,Spain,ESP,5,0,5,0,10
2017,Benin,BEN,Spain,ESP,0,0,5,0,5
2017,Bangladesh,BGD,Spain,ESP,0,5,46,5,56
2017,Burkina Faso,BFA,Spain,ESP,0,0,16,0,16
2017,Belarus,BLR,Spain,ESP,0,0,5,0,5
2017,Bolivia (Plurinational State of),BOL,Spain,ESP,0,0,5,0,5
2017,Brazil,BRA,Spain,ESP,0,0,12,5,17
2017,Central African Rep.,CAF,Spain,ESP,0,26,5,16,47
2017,Chad,TCD,Spain,ESP,0,0,5,0,5
2017,Chile,CHL,Spain,ESP,0,0,10,0,10
2017,Cameroon,CMR,Spain,ESP,5,0,45,12,62
2017,Congo,COG,Spain,ESP,0,0,5,5,10
2017,Dem. Rep. of the Congo,COD,Spain,ESP,0,0,5,0,5
2017,Colombia,COL,Spain,ESP,10,0,198,12,220
2017,Cuba,CUB,Spain,ESP,0,5,30,0,35
2017,Dominican Rep.,DOM,Spain,ESP,0,0,50,49,99
2017,Ecuador,ECU,Spain,ESP,0,0,5,0,5
2017,Equatorial Guinea,GNQ,Spain,ESP,5,0,17,5,27
2017,Eritrea,ERI,Spain,ESP,119,5,0,0,124
2017,Ethiopia,ETH,Spain,ESP,0,0,5,0,5
2017,Gambia,GMB,Spain,ESP,0,0,93,5,98
2017,Palestinian,PSE,Spain,ESP,126,141,65,363,695
2017,Georgia,GEO,Spain,ESP,0,0,39,5,44
2017,Ghana,GHA,Spain,ESP,0,0,13,5,18
2017,Guinea-Bissau,GNB,Spain,ESP,0,0,5,0,5
2017,Guatemala,GTM,Spain,ESP,0,0,5,0,5
2017,Guinea,GIN,Spain,ESP,5,0,30,5,40
2017,Haiti,HTI,Spain,ESP,0,0,5,0,5
2017,Honduras,HND,Spain,ESP,0,0,27,5,32
2017,Cote d'Ivoire,CIV,Spain,ESP,0,0,47,5,52
2017,India,IND,Spain,ESP,5,0,0,0,5
2017,Iran (Islamic Rep. of),IRN,Spain,ESP,11,0,101,12,124
2017,Iraq,IRQ,Spain,ESP,26,83,41,106,256
2017,Jordan,JOR,Spain,ESP,5,0,11,10,26
2017,Kazakhstan,KAZ,Spain,ESP,0,0,5,0,5
2017,Kenya,KEN,Spain,ESP,0,0,5,0,5
2017,Liberia,LBR,Spain,ESP,0,0,5,0,5
2017,Libya,LBY,Spain,ESP,10,10,56,5,81
2017,Lebanon,LBN,Spain,ESP,11,5,30,5,51
2017,Sri Lanka,LKA,Spain,ESP,0,0,0,10,10
2017,Mauritania,MRT,Spain,ESP,0,0,11,0,11
2017,Mali,MLI,Spain,ESP,10,20,455,71,556
2017,Mongolia,MNG,Spain,ESP,0,0,5,0,5
2017,Morocco,MAR,Spain,ESP,60,0,114,17,191
2017,Niger,NER,Spain,ESP,0,0,5,0,5
2017,Nicaragua,NIC,Spain,ESP,0,0,5,0,5
2017,Nigeria,NGA,Spain,ESP,13,0,46,5,64
2017,Pakistan,PAK,Spain,ESP,45,0,22,5,72
2017,Peru,PER,Spain,ESP,0,0,72,0,72
2017,Russian Federation,RUS,Spain,ESP,23,0,61,5,89
2017,El Salvador,SLV,Spain,ESP,0,0,56,5,61
2017,Serbia and Kosovo: S/RES/1244 (1999),SRB,Spain,ESP,0,0,10,0,10
2017,Senegal,SEN,Spain,ESP,0,0,14,5,19
2017,Sierra Leone,SLE,Spain,ESP,0,0,5,0,5
2017,Somalia,SOM,Spain,ESP,0,36,18,0,54
2017,Sudan,SDN,Spain,ESP,0,5,0,0,5
2017,Syrian Arab Rep.,SYR,Spain,ESP,19,3529,102,243,3893
2017,Tajikistan,TJK,Spain,ESP,5,0,0,0,5
2017,Togo,TGO,Spain,ESP,0,0,5,0,5
2017,Tunisia,TUN,Spain,ESP,0,0,13,5,18
2017,Turkey,TUR,Spain,ESP,10,0,13,0,23
2017,Uganda,UGA,Spain,ESP,0,0,5,0,5
2017,Ukraine,UKR,Spain,ESP,27,273,3017,82,3399
2017,United States of America,USA,Spain,ESP,0,0,5,0,5
2017,Venezuela (Bolivarian Republic of),VEN,Spain,ESP,16,0,1502,5,1523
2017,Western Sahara,ESH,Spain,ESP,0,0,5,0,5
2017,Yemen,YEM,Spain,ESP,10,5,0,5,20
2017,Eritrea,ERI,Sudan,SDN,11,0,0,0,11
2017,Ethiopia,ETH,Sudan,SDN,5,0,0,315,320
2017,Syrian Arab Rep.,SYR,Sudan,SDN,0,0,0,47,47
2017,Congo,COG,Eswatini,SWZ,5,0,0,0,5
2017,Dem. Rep. of the Congo,COD,Eswatini,SWZ,18,0,0,0,18
2017,Rwanda,RWA,Eswatini,SWZ,12,0,0,0,12
2017,Somalia,SOM,Eswatini,SWZ,17,0,0,0,17
2017,Afghanistan,AFG,Sweden,SWE,4476,4110,15560,659,24805
2017,Albania,ALB,Sweden,SWE,5,0,460,279,744
2017,Algeria,DZA,Sweden,SWE,5,0,38,107,150
2017,Angola,AGO,Sweden,SWE,0,0,0,15,15
2017,Egypt,EGY,Sweden,SWE,15,0,129,82,226
2017,Armenia,ARM,Sweden,SWE,0,0,112,42,154
2017,Azerbaijan,AZE,Sweden,SWE,16,0,77,74,167
2017,Burundi,BDI,Sweden,SWE,21,0,16,5,42
2017,Bangladesh,BGD,Sweden,SWE,19,0,108,23,150
2017,Belarus,BLR,Sweden,SWE,5,0,39,86,130
2017,Bolivia (Plurinational State of),BOL,Sweden,SWE,0,0,5,0,5
2017,Brazil,BRA,Sweden,SWE,0,0,12,0,12
2017,Bosnia and Herzegovina,BIH,Sweden,SWE,0,0,94,46,140
2017,Bulgaria,BGR,Sweden,SWE,0,0,5,5,10
2017,Canada,CAN,Sweden,SWE,0,0,5,0,5
2017,Chad,TCD,Sweden,SWE,0,0,0,5,5
2017,China,CHN,Sweden,SWE,5,0,19,13,37
2017,Chile,CHL,Sweden,SWE,0,0,21,5,26
2017,Cameroon,CMR,Sweden,SWE,5,0,24,19,48
2017,Congo,COG,Sweden,SWE,0,0,13,10,23
2017,Dem. Rep. of the Congo,COD,Sweden,SWE,12,0,12,11,35
2017,Colombia,COL,Sweden,SWE,0,0,136,18,154
2017,Cuba,CUB,Sweden,SWE,0,0,11,23,34
2017,Denmark,DNK,Sweden,SWE,0,0,0,5,5
2017,Djibouti,DJI,Sweden,SWE,0,0,14,10,24
2017,Ecuador,ECU,Sweden,SWE,0,0,5,0,5
2017,Eritrea,ERI,Sweden,SWE,1200,331,76,106,1713
2017,Estonia,EST,Sweden,SWE,0,0,5,0,5
2017,Ethiopia,ETH,Sweden,SWE,420,15,488,66,989
2017,Gambia,GMB,Sweden,SWE,5,0,54,73,132
2017,Palestinian,PSE,Sweden,SWE,88,5,177,71,341
2017,Georgia,GEO,Sweden,SWE,0,0,509,355,864
2017,Ghana,GHA,Sweden,SWE,0,0,15,15,30
2017,Greece,GRC,Sweden,SWE,0,0,5,5,10
2017,Guinea,GIN,Sweden,SWE,5,0,5,17,27
2017,Honduras,HND,Sweden,SWE,0,0,11,0,11
2017,Croatia,HRV,Sweden,SWE,0,0,5,0,5
2017,Cote d'Ivoire,CIV,Sweden,SWE,0,0,5,10,15
2017,India,IND,Sweden,SWE,0,0,37,27,64
2017,Iran (Islamic Rep. of),IRN,Sweden,SWE,1039,22,954,252,2267
2017,Iraq,IRQ,Sweden,SWE,1909,1389,5264,990,9552
2017,Israel,ISR,Sweden,SWE,0,0,10,5,15
2017,Jordan,JOR,Sweden,SWE,10,0,112,67,189
2017,Japan,JPN,Sweden,SWE,0,0,5,0,5
2017,Kazakhstan,KAZ,Sweden,SWE,0,0,87,126,213
2017,Kenya,KEN,Sweden,SWE,0,0,10,14,24
2017,Kyrgyzstan,KGZ,Sweden,SWE,5,0,49,88,142
2017,Kuwait,KWT,Sweden,SWE,5,0,25,5,35
2017,Liberia,LBR,Sweden,SWE,0,0,0,5,5
2017,Libya,LBY,Sweden,SWE,5,5,27,76,113
2017,Lebanon,LBN,Sweden,SWE,5,5,228,63,301
2017,Sri Lanka,LKA,Sweden,SWE,0,0,15,10,25
2017,North Macedonia,MKD,Sweden,SWE,0,0,109,90,199
2017,Rep. of Moldova,MDA,Sweden,SWE,0,0,16,5,21
2017,Mexico,MEX,Sweden,SWE,0,0,10,0,10
2017,Mali,MLI,Sweden,SWE,0,0,5,5,10
2017,Mongolia,MNG,Sweden,SWE,0,5,245,59,309
2017,Morocco,MAR,Sweden,SWE,23,0,158,283,464
2017,Montenegro,MNE,Sweden,SWE,0,0,21,5,26
2017,Nepal,NPL,Sweden,SWE,0,0,18,0,18
2017,Netherlands,NLD,Sweden,SWE,0,0,5,0,5
2017,Nicaragua,NIC,Sweden,SWE,0,0,52,5,57
2017,Nigeria,NGA,Sweden,SWE,28,0,105,138,271
2017,Pakistan,PAK,Sweden,SWE,63,0,202,72,337
2017,Paraguay,PRY,Sweden,SWE,0,0,5,0,5
2017,Peru,PER,Sweden,SWE,0,0,37,5,42
2017,Philippines,PHL,Sweden,SWE,0,0,12,5,17
2017,Romania,ROU,Sweden,SWE,0,0,0,5,5
2017,South Africa,ZAF,Sweden,SWE,0,0,5,0,5
2017,Russian Federation,RUS,Sweden,SWE,23,10,142,134,309
2017,Rwanda,RWA,Sweden,SWE,0,0,5,5,10
2017,El Salvador,SLV,Sweden,SWE,0,0,168,16,184
2017,Saudi Arabia,SAU,Sweden,SWE,0,0,10,10,20
2017,Serbia and Kosovo: S/RES/1244 (1999),SRB,Sweden,SWE,0,0,367,136,503
2017,Senegal,SEN,Sweden,SWE,0,0,10,14,24
2017,Sierra Leone,SLE,Sweden,SWE,5,0,5,10,20
2017,Somalia,SOM,Sweden,SWE,771,125,858,245,1999
2017,Spain,ESP,Sweden,SWE,0,0,5,5,10
2017,Viet Nam,VNM,Sweden,SWE,0,0,11,5,16
2017,Sudan,SDN,Sweden,SWE,133,0,76,29,238
2017,Syrian Arab Rep.,SYR,Sweden,SWE,932,5573,143,539,7187
2017,United Rep. of Tanzania,TZA,Sweden,SWE,5,0,5,15,25
2017,Thailand,THA,Sweden,SWE,0,0,11,5,16
2017,Tajikistan,TJK,Sweden,SWE,5,0,16,19,40
2017,Togo,TGO,Sweden,SWE,0,0,0,5,5
2017,Tunisia,TUN,Sweden,SWE,0,0,42,43,85
2017,Turkey,TUR,Sweden,SWE,5,0,150,158,313
2017,Uganda,UGA,Sweden,SWE,29,0,16,20,65
2017,Ukraine,UKR,Sweden,SWE,5,5,401,211,622
2017,Uruguay,URY,Sweden,SWE,0,0,5,0,5
2017,United States of America,USA,Sweden,SWE,0,0,5,14,19
2017,Uzbekistan,UZB,Sweden,SWE,30,10,126,72,238
2017,Venezuela (Bolivarian Republic of),VEN,Sweden,SWE,0,0,63,5,68
2017,Yemen,YEM,Sweden,SWE,52,119,5,53,229
2017,Zambia,ZMB,Sweden,SWE,0,0,0,5,5
2017,Stateless,XXA,Sweden,SWE,1281,205,617,200,2303
2017,Unknown ,,Sweden,SWE,11,12,199,66,288
2017,Afghanistan,AFG,Switzerland,CHE,402,2568,274,380,3624
2017,Albania,ALB,Switzerland,CHE,5,5,94,41,145
2017,Algeria,DZA,Switzerland,CHE,12,5,101,456,574
2017,Angola,AGO,Switzerland,CHE,0,28,5,49,82
2017,Egypt,EGY,Switzerland,CHE,12,0,12,42,66
2017,Armenia,ARM,Switzerland,CHE,0,13,32,22,67
2017,Azerbaijan,AZE,Switzerland,CHE,5,0,11,17,33
2017,Burundi,BDI,Switzerland,CHE,17,5,0,0,22
2017,Benin,BEN,Switzerland,CHE,0,0,0,12,12
2017,Bangladesh,BGD,Switzerland,CHE,5,0,35,11,51
2017,Burkina Faso,BFA,Switzerland,CHE,0,5,0,32,37
2017,Belarus,BLR,Switzerland,CHE,0,0,15,58,73
2017,Bosnia and Herzegovina,BIH,Switzerland,CHE,0,5,22,27,54
2017,Bulgaria,BGR,Switzerland,CHE,0,0,5,0,5
2017,Central African Rep.,CAF,Switzerland,CHE,0,0,0,13,13
2017,Chad,TCD,Switzerland,CHE,0,0,5,10,15
2017,China,CHN,Switzerland,CHE,60,181,127,21,389
2017,Cameroon,CMR,Switzerland,CHE,5,5,13,210,233
2017,Congo,COG,Switzerland,CHE,0,5,0,5,10
2017,Dem. Rep. of the Congo,COD,Switzerland,CHE,15,50,30,76,171
2017,Colombia,COL,Switzerland,CHE,13,0,5,5,23
2017,Cuba,CUB,Switzerland,CHE,0,0,0,5,5
2017,Czechia,CZE,Switzerland,CHE,0,0,5,0,5
2017,Eritrea,ERI,Switzerland,CHE,3464,1860,1093,539,6956
2017,Ethiopia,ETH,Switzerland,CHE,112,162,181,191,646
2017,France,FRA,Switzerland,CHE,0,0,5,5,10
2017,Gabon,GAB,Switzerland,CHE,0,0,0,5,5
2017,Gambia,GMB,Switzerland,CHE,0,5,22,378,405
2017,Georgia,GEO,Switzerland,CHE,0,31,164,411,606
2017,Ghana,GHA,Switzerland,CHE,0,0,5,55,60
2017,Guinea-Bissau,GNB,Switzerland,CHE,0,5,10,55,70
2017,Guinea,GIN,Switzerland,CHE,5,30,112,786,933
2017,Cote d'Ivoire,CIV,Switzerland,CHE,0,5,10,347,362
2017,India,IND,Switzerland,CHE,0,0,15,27,42
2017,Iran (Islamic Rep. of),IRN,Switzerland,CHE,83,48,126,112,369
2017,Iraq,IRQ,Switzerland,CHE,220,543,191,448,1402
2017,Italy,ITA,Switzerland,CHE,0,0,5,5,10
2017,Kazakhstan,KAZ,Switzerland,CHE,0,0,14,5,19
2017,Kenya,KEN,Switzerland,CHE,0,0,0,5,5
2017,Kyrgyzstan,KGZ,Switzerland,CHE,0,0,10,0,10
2017,Rep. of Korea,KOR,Switzerland,CHE,0,0,5,0,5
2017,Liberia,LBR,Switzerland,CHE,0,0,0,31,31
2017,Libya,LBY,Switzerland,CHE,19,5,22,140,186
2017,Lebanon,LBN,Switzerland,CHE,5,0,5,12,22
2017,Sri Lanka,LKA,Switzerland,CHE,320,88,393,252,1053
2017,Mauritania,MRT,Switzerland,CHE,0,0,5,16,21
2017,North Macedonia,MKD,Switzerland,CHE,0,10,57,42,109
2017,Rep. of Moldova,MDA,Switzerland,CHE,0,0,10,5,15
2017,Mali,MLI,Switzerland,CHE,0,5,5,114,124
2017,Mongolia,MNG,Switzerland,CHE,0,5,17,16,38
2017,Morocco,MAR,Switzerland,CHE,0,11,69,418,498
2017,Montenegro,MNE,Switzerland,CHE,0,0,12,5,17
2017,Nepal,NPL,Switzerland,CHE,0,0,5,0,5
2017,Niger,NER,Switzerland,CHE,0,0,0,19,19
2017,Nigeria,NGA,Switzerland,CHE,0,15,47,673,735
2017,Pakistan,PAK,Switzerland,CHE,16,19,50,88,173
2017,Romania,ROU,Switzerland,CHE,0,0,5,5,10
2017,South Africa,ZAF,Switzerland,CHE,0,0,5,0,5
2017,Russian Federation,RUS,Switzerland,CHE,33,13,32,116,194
2017,El Salvador,SLV,Switzerland,CHE,0,5,10,0,15
2017,Serbia and Kosovo: S/RES/1244 (1999),SRB,Switzerland,CHE,0,72,122,167,361
2017,Senegal,SEN,Switzerland,CHE,0,0,11,113,124
2017,Sierra Leone,SLE,Switzerland,CHE,0,5,0,133,138
2017,Somalia,SOM,Switzerland,CHE,146,480,87,510,1223
2017,Spain,ESP,Switzerland,CHE,0,0,5,0,5
2017,Viet Nam,VNM,Switzerland,CHE,0,0,5,0,5
2017,Sudan,SDN,Switzerland,CHE,26,30,38,75,169
2017,South Sudan,SSD,Switzerland,CHE,5,0,0,10,15
2017,Syrian Arab Rep.,SYR,Switzerland,CHE,1070,1296,89,278,2733
2017,United Rep. of Tanzania,TZA,Switzerland,CHE,0,5,0,0,5
2017,Tajikistan,TJK,Switzerland,CHE,5,0,0,0,5
2017,Togo,TGO,Switzerland,CHE,21,0,13,40,74
2017,Tunisia,TUN,Switzerland,CHE,0,5,51,140,196
2017,Turkey,TUR,Switzerland,CHE,165,33,177,201,576
2017,Uganda,UGA,Switzerland,CHE,5,0,5,5,15
2017,Ukraine,UKR,Switzerland,CHE,0,5,43,57,105
2017,United States of America,USA,Switzerland,CHE,0,0,0,5,5
2017,Uzbekistan,UZB,Switzerland,CHE,0,0,0,5,5
2017,Venezuela (Bolivarian Republic of),VEN,Switzerland,CHE,0,0,5,5,10
2017,Western Sahara,ESH,Switzerland,CHE,0,0,0,10,10
2017,Yemen,YEM,Switzerland,CHE,5,10,10,24,49
2017,Zimbabwe,ZWE,Switzerland,CHE,0,0,0,5,5
2017,Stateless,XXA,Switzerland,CHE,5,5,5,10,25
2017,Unknown ,,Switzerland,CHE,57,137,102,77,373
2017,Burundi,BDI,United Rep. of Tanzania,TZA,26,0,0,0,26
2017,Dem. Rep. of the Congo,COD,United Rep. of Tanzania,TZA,687,0,145,0,832
2017,Unknown ,,United Rep. of Tanzania,TZA,5,0,5,0,10
2017,Myanmar,MMR,Thailand,THA,674,0,5,0,679
2017,Afghanistan,AFG,Ukraine,UKR,5,23,27,57,112
2017,Algeria,DZA,Ukraine,UKR,0,0,0,5,5
2017,Armenia,ARM,Ukraine,UKR,0,0,0,5,5
2017,Azerbaijan,AZE,Ukraine,UKR,0,0,0,5,5
2017,Bangladesh,BGD,Ukraine,UKR,0,0,10,60,70
2017,Belarus,BLR,Ukraine,UKR,0,0,5,5,10
2017,China,CHN,Ukraine,UKR,0,0,0,5,5
2017,Cameroon,CMR,Ukraine,UKR,0,0,0,15,15
2017,Congo,COG,Ukraine,UKR,0,0,0,5,5
2017,Dem. Rep. of the Congo,COD,Ukraine,UKR,0,0,5,5,10
2017,Eritrea,ERI,Ukraine,UKR,0,0,0,5,5
2017,Guinea,GIN,Ukraine,UKR,0,0,0,5,5
2017,India,IND,Ukraine,UKR,0,0,0,12,12
2017,Iran (Islamic Rep. of),IRN,Ukraine,UKR,0,0,5,10,15
2017,Iraq,IRQ,Ukraine,UKR,0,5,16,24,45
2017,Israel,ISR,Ukraine,UKR,0,0,0,5,5
2017,Kyrgyzstan,KGZ,Ukraine,UKR,0,0,5,10,15
2017,Sri Lanka,LKA,Ukraine,UKR,0,0,0,5,5
2017,Lithuania,LTU,Ukraine,UKR,0,0,0,5,5
2017,Nigeria,NGA,Ukraine,UKR,0,0,0,5,5
2017,Pakistan,PAK,Ukraine,UKR,0,0,5,10,15
2017,Russian Federation,RUS,Ukraine,UKR,10,10,37,50,107
2017,Senegal,SEN,Ukraine,UKR,0,0,0,5,5
2017,Somalia,SOM,Ukraine,UKR,0,0,10,10,20
2017,Viet Nam,VNM,Ukraine,UKR,0,0,0,5,5
2017,Sudan,SDN,Ukraine,UKR,0,0,0,10,10
2017,Syrian Arab Rep.,SYR,Ukraine,UKR,0,27,50,20,97
2017,Tajikistan,TJK,Ukraine,UKR,0,0,10,5,15
2017,Turkey,TUR,Ukraine,UKR,0,0,5,5,10
2017,Uzbekistan,UZB,Ukraine,UKR,0,0,18,21,39
2017,Yemen,YEM,Ukraine,UKR,0,0,5,0,5
2017,Zimbabwe,ZWE,Ukraine,UKR,0,0,0,5,5
2017,Stateless,XXA,Ukraine,UKR,0,0,10,10,20
2017,Colombia,COL,Uruguay,URY,10,0,0,0,10
2017,Cuba,CUB,Uruguay,URY,0,0,19,596,615
2017,Paraguay,PRY,Uruguay,URY,5,0,0,0,5
2017,Syrian Arab Rep.,SYR,Uruguay,URY,0,0,0,5,5
2017,Turkey,TUR,Uruguay,URY,5,0,0,0,5
2017,United States of America,USA,Uruguay,URY,0,0,0,5,5
2017,Venezuela (Bolivarian Republic of),VEN,Uruguay,URY,0,0,0,5,5
2017,Burundi,BDI,Zambia,ZMB,228,0,17,258,503
2017,Dem. Rep. of the Congo,COD,Zambia,ZMB,15232,0,155,663,16050
2017,Palestinian,PSE,Zambia,ZMB,0,0,0,5,5
2017,Cote d'Ivoire,CIV,Zambia,ZMB,0,0,0,5,5
2017,Nigeria,NGA,Zambia,ZMB,0,0,0,5,5
2017,Rwanda,RWA,Zambia,ZMB,5,0,0,0,5
2017,Somalia,SOM,Zambia,ZMB,98,0,10,131,239
2017,Syrian Arab Rep.,SYR,Zambia,ZMB,5,0,0,5,10
2017,Turkey,TUR,Zambia,ZMB,12,0,0,0,12
2017,Burundi,BDI,Zimbabwe,ZWE,5,0,107,10,122
2017,Central African Rep.,CAF,Zimbabwe,ZWE,0,0,0,5,5
2017,Dem. Rep. of the Congo,COD,Zimbabwe,ZWE,644,0,90,154,888
2017,Eritrea,ERI,Zimbabwe,ZWE,0,0,0,5,5
2017,Cote d'Ivoire,CIV,Zimbabwe,ZWE,0,0,0,5,5
2017,Mali,MLI,Zimbabwe,ZWE,0,0,5,61,66
2017,Rwanda,RWA,Zimbabwe,ZWE,0,0,34,0,34
2017,Somalia,SOM,Zimbabwe,ZWE,0,0,0,10,10
2017,Sudan,SDN,Zimbabwe,ZWE,10,0,10,10,30
2017,Uganda,UGA,Zimbabwe,ZWE,0,0,0,5,5
2018,Afghanistan,AFG,Albania,ALB,0,0,0,36,36
2018,Algeria,DZA,Albania,ALB,0,0,0,212,212
2018,Egypt,EGY,Albania,ALB,0,0,0,23,23
2018,Eritrea,ERI,Albania,ALB,0,0,0,14,14
2018,Palestinian,PSE,Albania,ALB,0,10,0,272,282
2018,India,IND,Albania,ALB,0,0,0,5,5
2018,Iran (Islamic Rep. of),IRN,Albania,ALB,0,0,0,42,42
2018,Iraq,IRQ,Albania,ALB,0,0,0,426,426
2018,Kuwait,KWT,Albania,ALB,0,0,0,5,5
2018,Libya,LBY,Albania,ALB,0,0,0,126,126
2018,Morocco,MAR,Albania,ALB,0,0,0,199,199
2018,Myanmar,MMR,Albania,ALB,0,0,0,10,10
2018,Pakistan,PAK,Albania,ALB,0,0,0,644,644
2018,Somalia,SOM,Albania,ALB,0,0,0,5,5
2018,Syrian Arab Rep.,SYR,Albania,ALB,0,0,0,2110,2110
2018,Tunisia,TUN,Albania,ALB,0,0,0,15,15
2018,Turkey,TUR,Albania,ALB,0,0,0,22,22
2018,Western Sahara,ESH,Albania,ALB,0,0,0,5,5
2018,Yemen,YEM,Albania,ALB,0,0,0,54,54
2018,Armenia,ARM,Argentina,ARG,0,0,10,34,44
2018,Bangladesh,BGD,Argentina,ARG,0,0,5,0,5
2018,China,CHN,Argentina,ARG,0,0,23,5,28
2018,Dem. Rep. of the Congo,COD,Argentina,ARG,0,0,18,0,18
2018,Colombia,COL,Argentina,ARG,5,0,5,28,38
2018,Cuba,CUB,Argentina,ARG,0,0,47,32,79
2018,Dominican Rep.,DOM,Argentina,ARG,0,0,16,24,40
2018,Palestinian,PSE,Argentina,ARG,5,0,0,0,5
2018,Ghana,GHA,Argentina,ARG,0,0,5,0,5
2018,Haiti,HTI,Argentina,ARG,0,0,56,71,127
2018,India,IND,Argentina,ARG,0,0,5,5,10
2018,Jamaica,JAM,Argentina,ARG,5,0,0,0,5
2018,Morocco,MAR,Argentina,ARG,0,0,0,5,5
2018,Nigeria,NGA,Argentina,ARG,0,0,0,5,5
2018,Pakistan,PAK,Argentina,ARG,0,0,0,5,5
2018,Peru,PER,Argentina,ARG,0,0,0,5,5
2018,Russian Federation,RUS,Argentina,ARG,5,0,5,5,15
2018,Senegal,SEN,Argentina,ARG,0,0,235,5,240
2018,Syrian Arab Rep.,SYR,Argentina,ARG,15,0,5,5,25
2018,Ukraine,UKR,Argentina,ARG,12,0,0,34,46
2018,Venezuela (Bolivarian Republic of),VEN,Argentina,ARG,14,0,0,37,51
2018,Stateless,XXA,Argentina,ARG,5,0,0,0,5
2018,Unknown ,,Argentina,ARG,61,0,0,16,77
2018,Afghanistan,AFG,Armenia,ARM,0,0,5,5,10
2018,Bangladesh,BGD,Armenia,ARM,0,0,5,5,10
2018,Iran (Islamic Rep. of),IRN,Armenia,ARM,0,0,12,16,28
2018,Iraq,IRQ,Armenia,ARM,25,0,0,21,46
2018,Syrian Arab Rep.,SYR,Armenia,ARM,21,0,0,5,26
2018,Turkey,TUR,Armenia,ARM,0,0,5,0,5
2018,Ukraine,UKR,Armenia,ARM,0,0,0,5,5
2018,Uzbekistan,UZB,Armenia,ARM,0,0,5,0,5
2018,Yemen,YEM,Armenia,ARM,17,0,0,5,22
2018,Afghanistan,AFG,Australia,AUS,1009,0,295,0,1304
2018,Egypt,EGY,Australia,AUS,36,0,106,0,142
2018,Bangladesh,BGD,Australia,AUS,5,0,218,0,223
2018,Cambodia,KHM,Australia,AUS,0,0,18,0,18
2018,China,CHN,Australia,AUS,107,0,3080,720,3907
2018,Cameroon,CMR,Australia,AUS,0,0,5,0,5
2018,Dem. Rep. of the Congo,COD,Australia,AUS,10,0,0,0,10
2018,Ethiopia,ETH,Australia,AUS,54,0,66,10,130
2018,Fiji,FJI,Australia,AUS,0,0,235,24,259
2018,Palestinian,PSE,Australia,AUS,94,0,0,0,94
2018,United Kingdom of Great Britain and Northern Ireland,GBR,Australia,AUS,0,0,39,0,39
2018,Ghana,GHA,Australia,AUS,0,0,83,0,83
2018,India,IND,Australia,AUS,22,0,401,237,660
2018,Indonesia,IDN,Australia,AUS,55,0,543,44,642
2018,Iran (Islamic Rep. of),IRN,Australia,AUS,2581,0,1350,25,3956
2018,Iraq,IRQ,Australia,AUS,942,0,421,70,1433
2018,Jordan,JOR,Australia,AUS,10,0,0,0,10
2018,Japan,JPN,Australia,AUS,0,0,0,5,5
2018,Rep. of Korea,KOR,Australia,AUS,0,0,61,0,61
2018,Liberia,LBR,Australia,AUS,10,0,0,0,10
2018,Libya,LBY,Australia,AUS,59,0,0,5,64
2018,Lebanon,LBN,Australia,AUS,18,0,193,20,231
2018,Sri Lanka,LKA,Australia,AUS,562,0,1801,14,2377
2018,Malaysia,MYS,Australia,AUS,113,0,9310,1038,10461
2018,Mongolia,MNG,Australia,AUS,0,0,14,0,14
2018,Mauritius,MUS,Australia,AUS,0,0,0,5,5
2018,Myanmar,MMR,Australia,AUS,88,0,5,0,93
2018,Nepal,NPL,Australia,AUS,0,0,80,15,95
2018,Nigeria,NGA,Australia,AUS,17,0,23,13,53
2018,Pakistan,PAK,Australia,AUS,676,0,536,39,1251
2018,Philippines,PHL,Australia,AUS,0,0,13,5,18
2018,Papua New Guinea,PNG,Australia,AUS,28,0,5,0,33
2018,Rwanda,RWA,Australia,AUS,12,0,0,0,12
2018,Saudi Arabia,SAU,Australia,AUS,0,0,5,0,5
2018,Sierra Leone,SLE,Australia,AUS,0,0,94,0,94
2018,Somalia,SOM,Australia,AUS,340,0,0,5,345
2018,Viet Nam,VNM,Australia,AUS,53,0,1532,131,1716
2018,Sudan,SDN,Australia,AUS,245,0,0,0,245
2018,Eswatini,SWZ,Australia,AUS,0,0,0,5,5
2018,Syrian Arab Rep.,SYR,Australia,AUS,110,0,5,0,115
2018,Thailand,THA,Australia,AUS,0,0,403,97,500
2018,Turkey,TUR,Australia,AUS,153,0,52,5,210
2018,Stateless,XXA,Australia,AUS,1699,0,216,5,1920
2018,Unknown ,,Australia,AUS,443,0,1154,510,2107
2018,Afghanistan,AFG,Azerbaijan,AZE,10,0,269,5,284
2018,Egypt,EGY,Azerbaijan,AZE,0,0,5,0,5
2018,Bangladesh,BGD,Azerbaijan,AZE,0,0,5,0,5
2018,India,IND,Azerbaijan,AZE,0,0,5,0,5
2018,Iran (Islamic Rep. of),IRN,Azerbaijan,AZE,0,0,13,10,23
2018,Iraq,IRQ,Azerbaijan,AZE,0,0,16,0,16
2018,Libya,LBY,Azerbaijan,AZE,5,0,0,0,5
2018,Sri Lanka,LKA,Azerbaijan,AZE,0,0,5,0,5
2018,Nepal,NPL,Azerbaijan,AZE,0,0,5,0,5
2018,Pakistan,PAK,Azerbaijan,AZE,0,0,165,22,187
2018,Russian Federation,RUS,Azerbaijan,AZE,0,0,5,0,5
2018,Syrian Arab Rep.,SYR,Azerbaijan,AZE,0,0,28,0,28
2018,Turkey,TUR,Azerbaijan,AZE,0,0,16,0,16
2018,Uzbekistan,UZB,Azerbaijan,AZE,0,0,5,0,5
2018,Central African Rep.,CAF,Burundi,BDI,5,0,0,0,5
2018,Dem. Rep. of the Congo,COD,Burundi,BDI,10507,0,0,1177,11684
2018,Rwanda,RWA,Burundi,BDI,46,0,0,142,188
2018,United Rep. of Tanzania,TZA,Burundi,BDI,5,0,0,0,5
2018,Uganda,UGA,Burundi,BDI,5,0,0,0,5
2018,Afghanistan,AFG,Belgium,BEL,820,1080,1850,0,3750
2018,Albania,ALB,Belgium,BEL,50,0,575,0,625
2018,Algeria,DZA,Belgium,BEL,10,0,80,0,90
2018,Angola,AGO,Belgium,BEL,5,0,55,0,60
2018,Egypt,EGY,Belgium,BEL,10,0,55,0,65
2018,Armenia,ARM,Belgium,BEL,25,0,125,0,150
2018,Azerbaijan,AZE,Belgium,BEL,20,5,30,0,55
2018,Burundi,BDI,Belgium,BEL,330,0,35,0,365
2018,Benin,BEN,Belgium,BEL,5,0,25,0,30
2018,Bangladesh,BGD,Belgium,BEL,0,0,50,0,50
2018,Bhutan,BTN,Belgium,BEL,0,0,5,0,5
2018,Burkina Faso,BFA,Belgium,BEL,10,0,30,0,40
2018,Belarus,BLR,Belgium,BEL,5,0,15,0,20
2018,Brazil,BRA,Belgium,BEL,5,0,10,0,15
2018,Bosnia and Herzegovina,BIH,Belgium,BEL,5,0,20,0,25
2018,Central African Rep.,CAF,Belgium,BEL,5,0,5,0,10
2018,China,CHN,Belgium,BEL,95,0,95,0,190
2018,Chile,CHL,Belgium,BEL,0,0,5,0,5
2018,Cameroon,CMR,Belgium,BEL,65,0,190,0,255
2018,Congo,COG,Belgium,BEL,5,0,10,0,15
2018,Dem. Rep. of the Congo,COD,Belgium,BEL,155,10,445,0,610
2018,Colombia,COL,Belgium,BEL,25,5,40,0,70
2018,Cuba,CUB,Belgium,BEL,5,0,5,0,10
2018,Djibouti,DJI,Belgium,BEL,35,0,45,0,80
2018,Equatorial Guinea,GNQ,Belgium,BEL,0,0,5,0,5
2018,Eritrea,ERI,Belgium,BEL,520,0,45,0,565
2018,Ethiopia,ETH,Belgium,BEL,20,0,40,0,60
2018,Gabon,GAB,Belgium,BEL,0,0,10,0,10
2018,Gambia,GMB,Belgium,BEL,5,0,25,0,30
2018,Georgia,GEO,Belgium,BEL,20,0,145,0,165
2018,Ghana,GHA,Belgium,BEL,0,0,35,0,35
2018,Guinea-Bissau,GNB,Belgium,BEL,0,0,5,0,5
2018,Guatemala,GTM,Belgium,BEL,25,0,0,0,25
2018,Guinea,GIN,Belgium,BEL,260,5,415,0,680
2018,Honduras,HND,Belgium,BEL,20,0,0,0,20
2018,Hungary,HUN,Belgium,BEL,0,0,5,0,5
2018,Cote d'Ivoire,CIV,Belgium,BEL,25,0,65,0,90
2018,India,IND,Belgium,BEL,0,0,65,0,65
2018,Iran (Islamic Rep. of),IRN,Belgium,BEL,265,0,80,0,345
2018,Iraq,IRQ,Belgium,BEL,375,90,1005,0,1470
2018,Israel,ISR,Belgium,BEL,0,0,5,0,5
2018,Jordan,JOR,Belgium,BEL,0,0,20,0,20
2018,Kazakhstan,KAZ,Belgium,BEL,15,0,10,0,25
2018,Kenya,KEN,Belgium,BEL,0,0,5,0,5
2018,Kyrgyzstan,KGZ,Belgium,BEL,20,0,10,0,30
2018,Liberia,LBR,Belgium,BEL,0,0,10,0,10
2018,Libya,LBY,Belgium,BEL,5,20,5,0,30
2018,Lebanon,LBN,Belgium,BEL,10,0,85,0,95
2018,Sri Lanka,LKA,Belgium,BEL,15,0,115,0,130
2018,Mauritania,MRT,Belgium,BEL,25,0,65,0,90
2018,North Macedonia,MKD,Belgium,BEL,15,0,155,0,170
2018,Mali,MLI,Belgium,BEL,5,0,20,0,25
2018,Mongolia,MNG,Belgium,BEL,0,0,10,0,10
2018,Morocco,MAR,Belgium,BEL,20,0,170,0,190
2018,Montenegro,MNE,Belgium,BEL,5,0,5,0,10
2018,Nepal,NPL,Belgium,BEL,0,0,10,0,10
2018,Niger,NER,Belgium,BEL,10,0,30,0,40
2018,Nigeria,NGA,Belgium,BEL,5,0,65,0,70
2018,Peru,PER,Belgium,BEL,0,0,5,0,5
2018,Spain,ESP,Belgium,BEL,0,0,5,0,5
2018,Central African Rep.,CAF,Benin,BEN,110,0,0,0,110
2018,Chad,TCD,Benin,BEN,5,0,0,0,5
2018,Dem. Rep. of the Congo,COD,Benin,BEN,5,0,0,0,5
2018,Cote d'Ivoire,CIV,Benin,BEN,5,0,5,0,10
2018,Mali,MLI,Benin,BEN,15,0,0,0,15
2018,Syrian Arab Rep.,SYR,Benin,BEN,5,0,0,0,5
2018,Turkey,TUR,Benin,BEN,5,0,0,0,5
2018,Yemen,YEM,Benin,BEN,10,0,0,0,10
2018,Central African Rep.,CAF,Burkina Faso,BFA,31,0,0,5,36
2018,Chad,TCD,Burkina Faso,BFA,5,0,0,0,5
2018,Turkey,TUR,Burkina Faso,BFA,5,0,0,0,5
2018,Bangladesh,BGD,Belarus,BLR,0,0,5,5,10
2018,Bulgaria,BGR,Belarus,BLR,0,0,0,5,5
2018,India,IND,Belarus,BLR,0,0,5,0,5
2018,Iraq,IRQ,Belarus,BLR,0,0,5,14,19
2018,Russian Federation,RUS,Belarus,BLR,0,0,5,5,10
2018,Syrian Arab Rep.,SYR,Belarus,BLR,0,5,0,5,10
2018,Turkey,TUR,Belarus,BLR,5,0,0,5,10
2018,Ukraine,UKR,Belarus,BLR,0,835,17,30,882
2018,Uzbekistan,UZB,Belarus,BLR,0,0,0,5,5
2018,Yemen,YEM,Belarus,BLR,0,5,0,0,5
2018,Burundi,BDI,Botswana,BWA,5,0,0,0,5
2018,Dem. Rep. of the Congo,COD,Botswana,BWA,65,0,5,10,80
2018,Somalia,SOM,Botswana,BWA,0,0,5,0,5
2018,Zimbabwe,ZWE,Botswana,BWA,0,0,0,5,5
2018,Afghanistan,AFG,Brazil,BRA,22,0,5,0,27
2018,Angola,AGO,Brazil,BRA,21,0,277,357,655
2018,Egypt,EGY,Brazil,BRA,5,0,0,14,19
2018,Argentina,ARG,Brazil,BRA,0,0,0,5,5
2018,Burundi,BDI,Brazil,BRA,5,0,0,0,5
2018,Benin,BEN,Brazil,BRA,0,0,17,10,27
2018,Bangladesh,BGD,Brazil,BRA,0,0,201,30,231
2018,Burkina Faso,BFA,Brazil,BRA,0,0,10,0,10
2018,Bolivia (Plurinational State of),BOL,Brazil,BRA,0,0,0,5,5
2018,China,CHN,Brazil,BRA,5,0,5,314,324
2018,Cameroon,CMR,Brazil,BRA,5,0,10,10,25
2018,Dem. Rep. of the Congo,COD,Brazil,BRA,184,0,60,30,274
2018,Colombia,COL,Brazil,BRA,10,0,5,45,60
2018,Cuba,CUB,Brazil,BRA,47,0,55,308,410
2018,Cabo Verde,CPV,Brazil,BRA,0,0,10,10,20
2018,Dominican Rep.,DOM,Brazil,BRA,0,0,107,17,124
2018,Gambia,GMB,Brazil,BRA,0,0,38,5,43
2018,Palestinian,PSE,Brazil,BRA,55,0,0,5,60
2018,Ghana,GHA,Brazil,BRA,0,0,74,88,162
2018,Guinea-Bissau,GNB,Brazil,BRA,0,0,253,32,285
2018,Guinea,GIN,Brazil,BRA,10,0,28,22,60
2018,Guyana,GUY,Brazil,BRA,5,0,0,0,5
2018,Haiti,HTI,Brazil,BRA,0,0,1375,1198,2573
2018,Cote d'Ivoire,CIV,Brazil,BRA,5,0,10,0,15
2018,India,IND,Brazil,BRA,5,0,10,14,29
2018,Iran (Islamic Rep. of),IRN,Brazil,BRA,5,0,5,5,15
2018,Iraq,IRQ,Brazil,BRA,15,0,5,5,25
2018,Israel,ISR,Brazil,BRA,0,0,0,5,5
2018,Jordan,JOR,Brazil,BRA,0,0,5,5,10
2018,Rep. of Korea,KOR,Brazil,BRA,0,0,5,10,15
2018,Libya,LBY,Brazil,BRA,0,0,0,5,5
2018,Lebanon,LBN,Brazil,BRA,5,0,54,62,121
2018,Mauritania,MRT,Brazil,BRA,0,0,5,5,10
2018,Mali,MLI,Brazil,BRA,5,0,22,5,32
2018,Morocco,MAR,Brazil,BRA,5,0,12,22,39
2018,Mozambique,MOZ,Brazil,BRA,0,0,5,5,10
2018,Nepal,NPL,Brazil,BRA,5,0,0,5,10
2018,Nigeria,NGA,Brazil,BRA,14,0,128,88,230
2018,Pakistan,PAK,Brazil,BRA,56,0,98,40,194
2018,Peru,PER,Brazil,BRA,0,0,5,10,15
2018,Philippines,PHL,Brazil,BRA,0,0,5,5,10
2018,Portugal,PRT,Brazil,BRA,0,0,5,5,10
2018,South Africa,ZAF,Brazil,BRA,0,0,5,5,10
2018,Russian Federation,RUS,Brazil,BRA,0,0,0,5,5
2018,El Salvador,SLV,Brazil,BRA,0,0,0,5,5
2018,Senegal,SEN,Brazil,BRA,0,0,2830,196,3026
2018,Sierra Leone,SLE,Brazil,BRA,5,0,69,10,84
2018,Somalia,SOM,Brazil,BRA,0,0,11,0,11
2018,Sudan,SDN,Brazil,BRA,5,0,0,0,5
2018,Syrian Arab Rep.,SYR,Brazil,BRA,555,0,0,104,659
2018,United Rep. of Tanzania,TZA,Brazil,BRA,0,0,5,0,5
2018,Togo,TGO,Brazil,BRA,5,0,20,22,47
2018,Turkey,TUR,Brazil,BRA,0,0,0,18,18
2018,Ukraine,UKR,Brazil,BRA,5,0,0,5,10
2018,Uruguay,URY,Brazil,BRA,0,0,5,0,5
2018,Venezuela (Bolivarian Republic of),VEN,Brazil,BRA,5,0,0,2929,2934
2018,Unknown ,,Brazil,BRA,0,0,5,0,5
2018,Afghanistan,AFG,Bosnia and Herzegovina,BIH,0,0,0,95,95
2018,Algeria,DZA,Bosnia and Herzegovina,BIH,0,0,10,79,89
2018,Egypt,EGY,Bosnia and Herzegovina,BIH,0,0,0,5,5
2018,Palestinian,PSE,Bosnia and Herzegovina,BIH,0,0,0,30,30
2018,India,IND,Bosnia and Herzegovina,BIH,0,0,0,5,5
2018,Iran (Islamic Rep. of),IRN,Bosnia and Herzegovina,BIH,0,0,0,52,52
2018,Iraq,IRQ,Bosnia and Herzegovina,BIH,0,0,0,51,51
2018,Libya,LBY,Bosnia and Herzegovina,BIH,0,0,0,49,49
2018,Morocco,MAR,Bosnia and Herzegovina,BIH,0,0,5,32,37
2018,Nepal,NPL,Bosnia and Herzegovina,BIH,0,0,0,10,10
2018,Pakistan,PAK,Bosnia and Herzegovina,BIH,0,0,5,182,187
2018,Russian Federation,RUS,Bosnia and Herzegovina,BIH,0,0,16,5,21
2018,Syrian Arab Rep.,SYR,Bosnia and Herzegovina,BIH,0,5,0,129,134
2018,Tunisia,TUN,Bosnia and Herzegovina,BIH,0,0,0,5,5
2018,Turkey,TUR,Bosnia and Herzegovina,BIH,0,5,5,5,15
2018,Yemen,YEM,Bosnia and Herzegovina,BIH,0,0,0,5,5
2018,Stateless,XXA,Bosnia and Herzegovina,BIH,0,0,0,5,5
2018,Honduras,HND,Belize,BLZ,5,0,13,10,28
2018,El Salvador,SLV,Belize,BLZ,24,0,59,67,150
2018,Afghanistan,AFG,Canada,CAN,469,0,80,41,590
2018,Albania,ALB,Canada,CAN,68,0,61,14,143
2018,Algeria,DZA,Canada,CAN,69,0,22,11,102
2018,Angola,AGO,Canada,CAN,43,0,29,13,85
2018,Antigua and Barbuda,ATG,Canada,CAN,5,0,17,0,22
2018,Egypt,EGY,Canada,CAN,443,0,45,35,523
2018,Argentina,ARG,Canada,CAN,0,0,10,0,10
2018,Armenia,ARM,Canada,CAN,5,0,0,0,5
2018,Austria,AUT,Canada,CAN,0,0,5,5,10
2018,Azerbaijan,AZE,Canada,CAN,132,0,80,14,226
2018,Bahrain,BHR,Canada,CAN,11,0,0,0,11
2018,Barbados,BRB,Canada,CAN,35,0,5,5,45
2018,Burundi,BDI,Canada,CAN,383,0,10,24,417
2018,Benin,BEN,Canada,CAN,12,0,5,0,17
2018,Bangladesh,BGD,Canada,CAN,152,0,90,73,315
2018,Bahamas,BHS,Canada,CAN,37,0,38,20,95
2018,Burkina Faso,BFA,Canada,CAN,5,0,0,0,5
2018,Belarus,BLR,Canada,CAN,14,0,0,0,14
2018,Bolivia (Plurinational State of),BOL,Canada,CAN,5,0,5,0,10
2018,Botswana,BWA,Canada,CAN,13,0,0,5,18
2018,Brazil,BRA,Canada,CAN,17,0,78,26,121
2018,Bosnia and Herzegovina,BIH,Canada,CAN,0,0,5,0,5
2018,Bulgaria,BGR,Canada,CAN,11,0,0,10,21
2018,Belize,BLZ,Canada,CAN,5,0,0,0,5
2018,Cambodia,KHM,Canada,CAN,5,0,5,5,15
2018,Central African Rep.,CAF,Canada,CAN,5,0,0,0,5
2018,Chad,TCD,Canada,CAN,70,0,26,10,106
2018,China,CHN,Canada,CAN,607,0,743,213,1563
2018,Chile,CHL,Canada,CAN,12,0,42,5,59
2018,Cameroon,CMR,Canada,CAN,106,0,47,10,163
2018,Congo,COG,Canada,CAN,29,0,10,5,44
2018,Dem. Rep. of the Congo,COD,Canada,CAN,169,0,95,30,294
2018,Colombia,COL,Canada,CAN,528,0,315,115,958
2018,Cuba,CUB,Canada,CAN,23,0,17,11,51
2018,Cyprus,CYP,Canada,CAN,5,0,0,0,5
2018,Czechia,CZE,Canada,CAN,77,0,5,78,160
2018,Djibouti,DJI,Canada,CAN,272,0,50,12,334
2018,Dominica,DMA,Canada,CAN,5,0,0,0,5
2018,Dominican Rep.,DOM,Canada,CAN,5,0,5,5,15
2018,Ecuador,ECU,Canada,CAN,5,0,16,0,21
2018,Equatorial Guinea,GNQ,Canada,CAN,5,0,0,0,5
2018,Eritrea,ERI,Canada,CAN,632,0,47,53,732
2018,Ethiopia,ETH,Canada,CAN,324,0,109,42,475
2018,Finland,FIN,Canada,CAN,0,0,5,0,5
2018,France,FRA,Canada,CAN,0,0,5,12,17
2018,Gambia,GMB,Canada,CAN,12,0,11,10,33
2018,Palestinian,PSE,Canada,CAN,345,0,90,16,451
2018,Georgia,GEO,Canada,CAN,84,0,55,35,174
2018,Germany,DEU,Canada,CAN,0,0,0,11,11
2018,Ghana,GHA,Canada,CAN,57,0,82,14,153
2018,Greece,GRC,Canada,CAN,0,0,5,17,22
2018,Grenada,GRD,Canada,CAN,5,0,5,5,15
2018,Guatemala,GTM,Canada,CAN,63,0,34,31,128
2018,Guinea,GIN,Canada,CAN,37,0,10,5,52
2018,Guyana,GUY,Canada,CAN,12,0,34,5,51
2018,Haiti,HTI,Canada,CAN,555,0,1349,133,2037
2018,"China, Hong Kong SAR",HKG,Canada,CAN,0,0,5,15,20
2018,Honduras,HND,Canada,CAN,90,0,56,23,169
2018,Croatia,HRV,Canada,CAN,78,0,63,32,173
2018,Hungary,HUN,Canada,CAN,634,0,262,267,1163
2018,Cote d'Ivoire,CIV,Canada,CAN,18,0,12,5,35
2018,India,IND,Canada,CAN,264,0,234,323,821
2018,Indonesia,IDN,Canada,CAN,16,0,10,0,26
2018,Ireland,IRL,Canada,CAN,0,0,5,0,5
2018,Iran (Islamic Rep. of),IRN,Canada,CAN,429,0,96,58,583
2018,Iraq,IRQ,Canada,CAN,369,0,125,43,537
2018,Israel,ISR,Canada,CAN,37,0,23,10,70
2018,Italy,ITA,Canada,CAN,0,0,28,5,33
2018,Jamaica,JAM,Canada,CAN,66,0,49,59,174
2018,Jordan,JOR,Canada,CAN,110,0,68,32,210
2018,Japan,JPN,Canada,CAN,0,0,0,5,5
2018,Kazakhstan,KAZ,Canada,CAN,51,0,11,0,62
2018,Kenya,KEN,Canada,CAN,50,0,43,5,98
2018,Kyrgyzstan,KGZ,Canada,CAN,10,0,5,0,15
2018,Rep. of Korea,KOR,Canada,CAN,5,0,12,5,22
2018,Dem. People's Rep. of Korea,PRK,Canada,CAN,0,0,5,36,41
2018,Liberia,LBR,Canada,CAN,5,0,5,0,10
2018,Libya,LBY,Canada,CAN,225,0,12,5,242
2018,Saint Lucia,LCA,Canada,CAN,53,0,35,31,119
2018,Lebanon,LBN,Canada,CAN,111,0,122,19,252
2018,Sri Lanka,LKA,Canada,CAN,407,0,72,59,538
2018,Lithuania,LTU,Canada,CAN,0,0,5,5,10
2018,Luxembourg,LUX,Canada,CAN,0,0,5,0,5
2018,Latvia,LVA,Canada,CAN,5,0,0,0,5
2018,Madagascar,MDG,Canada,CAN,5,0,5,0,10
2018,Mauritania,MRT,Canada,CAN,17,0,5,5,27
2018,North Macedonia,MKD,Canada,CAN,5,0,0,0,5
2018,Rep. of Moldova,MDA,Canada,CAN,11,0,0,5,16
2018,Mexico,MEX,Canada,CAN,209,0,369,312,890
2018,Mali,MLI,Canada,CAN,21,0,15,5,41
2018,Malaysia,MYS,Canada,CAN,0,0,0,5,5
2018,Mongolia,MNG,Canada,CAN,20,0,5,5,30
2018,Morocco,MAR,Canada,CAN,16,0,5,5,26
2018,Malta,MLT,Canada,CAN,5,0,0,0,5
2018,Mauritius,MUS,Canada,CAN,5,0,0,0,5
2018,Namibia,NAM,Canada,CAN,18,0,10,10,38
2018,Nepal,NPL,Canada,CAN,101,0,37,5,143
2018,Netherlands,NLD,Canada,CAN,0,0,5,0,5
2018,Niger,NER,Canada,CAN,5,0,5,0,10
2018,Nicaragua,NIC,Canada,CAN,5,0,5,10,20
2018,Nigeria,NGA,Canada,CAN,826,0,1791,206,2823
2018,Pakistan,PAK,Canada,CAN,782,0,311,99,1192
2018,Panama,PAN,Canada,CAN,5,0,5,0,10
2018,Peru,PER,Canada,CAN,13,0,16,5,34
2018,Philippines,PHL,Canada,CAN,10,0,42,0,52
2018,Poland,POL,Canada,CAN,13,0,29,24,66
2018,Portugal,PRT,Canada,CAN,0,0,5,0,5
2018,Romania,ROU,Canada,CAN,39,0,23,496,558
2018,South Africa,ZAF,Canada,CAN,10,0,42,0,52
2018,Russian Federation,RUS,Canada,CAN,86,0,16,13,115
2018,Rwanda,RWA,Canada,CAN,69,0,16,5,90
2018,El Salvador,SLV,Canada,CAN,298,0,103,34,435
2018,Saudi Arabia,SAU,Canada,CAN,100,0,10,10,120
2018,Serbia and Kosovo: S/RES/1244 (1999),SRB,Canada,CAN,35,0,26,26,87
2018,Senegal,SEN,Canada,CAN,16,0,5,10,31
2018,Singapore,SGP,Canada,CAN,0,0,5,0,5
2018,Sierra Leone,SLE,Canada,CAN,11,0,5,5,21
2018,Somalia,SOM,Canada,CAN,338,0,208,126,672
2018,Spain,ESP,Canada,CAN,0,0,11,5,16
2018,Viet Nam,VNM,Canada,CAN,11,0,10,0,21
2018,Sudan,SDN,Canada,CAN,383,0,95,45,523
2018,Slovakia,SVK,Canada,CAN,312,0,40,100,452
2018,Slovenia,SVN,Canada,CAN,5,0,5,0,10
2018,Eswatini,SWZ,Canada,CAN,5,0,5,5,15
2018,Syrian Arab Rep.,SYR,Canada,CAN,474,0,20,86,580
2018,United Rep. of Tanzania,TZA,Canada,CAN,17,0,37,5,59
2018,Tajikistan,TJK,Canada,CAN,10,0,5,5,20
2018,Turkmenistan,TKM,Canada,CAN,5,0,0,0,5
2018,Togo,TGO,Canada,CAN,14,0,5,0,19
2018,Trinidad and Tobago,TTO,Canada,CAN,5,0,5,10,20
2018,Tunisia,TUN,Canada,CAN,11,0,5,0,16
2018,Turkey,TUR,Canada,CAN,1439,0,128,67,1634
2018,United Arab Emirates,ARE,Canada,CAN,5,0,0,0,5
2018,Uganda,UGA,Canada,CAN,79,0,28,5,112
2018,Ukraine,UKR,Canada,CAN,246,0,45,16,307
2018,United States of America,USA,Canada,CAN,19,0,685,166,870
2018,Uzbekistan,UZB,Canada,CAN,23,0,21,5,49
2018,Saint Vincent and the Grenadines,VCT,Canada,CAN,25,0,31,28,84
2018,Venezuela (Bolivarian Republic of),VEN,Canada,CAN,529,0,128,27,684
2018,Yemen,YEM,Canada,CAN,452,0,21,5,478
2018,Zambia,ZMB,Canada,CAN,5,0,0,0,5
2018,Zimbabwe,ZWE,Canada,CAN,59,0,29,11,99
2018,Stateless,XXA,Canada,CAN,106,0,36,10,152
2018,Unknown ,,Canada,CAN,0,0,11,0,11
2018,Cuba,CUB,Cayman Islands,CYM,5,0,10,0,15
2018,Colombia,COL,Chile,CHL,103,0,80,670,853
2018,Cuba,CUB,Chile,CHL,0,0,190,934,1124
2018,Dominican Rep.,DOM,Chile,CHL,0,0,5,34,39
2018,Palestinian,PSE,Chile,CHL,5,0,0,5,10
2018,Haiti,HTI,Chile,CHL,0,0,0,5,5
2018,Honduras,HND,Chile,CHL,5,0,0,0,5
2018,Peru,PER,Chile,CHL,0,0,0,5,5
2018,Russian Federation,RUS,Chile,CHL,5,0,0,0,5
2018,Syrian Arab Rep.,SYR,Chile,CHL,22,0,0,5,27
2018,Turkey,TUR,Chile,CHL,25,0,0,0,25
2018,Venezuela (Bolivarian Republic of),VEN,Chile,CHL,10,0,0,142,152
2018,Burundi,BDI,Dem. Rep. of the Congo,COD,26,0,5,0,31
2018,Central African Rep.,CAF,Dem. Rep. of the Congo,COD,24,0,34,0,58
2018,Congo,COG,Dem. Rep. of the Congo,COD,0,0,13,0,13
2018,Cote d'Ivoire,CIV,Dem. Rep. of the Congo,COD,0,0,11,0,11
2018,Rwanda,RWA,Dem. Rep. of the Congo,COD,11,0,5,0,16
2018,Somalia,SOM,Dem. Rep. of the Congo,COD,0,0,5,0,5
2018,Sudan,SDN,Dem. Rep. of the Congo,COD,5,0,0,0,5
2018,South Sudan,SSD,Dem. Rep. of the Congo,COD,5,0,0,0,5
2018,Dem. Rep. of the Congo,COD,Colombia,COL,0,0,0,5,5
2018,Cuba,CUB,Colombia,COL,5,0,0,0,5
2018,Pakistan,PAK,Colombia,COL,0,0,0,5,5
2018,Turkey,TUR,Colombia,COL,0,0,0,5,5
2018,Venezuela (Bolivarian Republic of),VEN,Colombia,COL,33,0,5,289,327
2018,Congo,COG,Costa Rica,CRI,0,0,5,0,5
2018,Colombia,COL,Costa Rica,CRI,11,0,58,248,317
2018,Cuba,CUB,Costa Rica,CRI,5,0,33,15,53
2018,Ghana,GHA,Costa Rica,CRI,0,0,5,17,22
2018,Guatemala,GTM,Costa Rica,CRI,0,0,11,5,16
2018,Guinea,GIN,Costa Rica,CRI,0,0,0,5,5
2018,Haiti,HTI,Costa Rica,CRI,0,0,10,19,29
2018,Honduras,HND,Costa Rica,CRI,12,0,17,64,93
2018,Mexico,MEX,Costa Rica,CRI,0,0,0,10,10
2018,Nicaragua,NIC,Costa Rica,CRI,5,0,212,293,510
2018,Peru,PER,Costa Rica,CRI,0,0,0,5,5
2018,El Salvador,SLV,Costa Rica,CRI,111,0,401,293,805
2018,United States of America,USA,Costa Rica,CRI,0,0,0,5,5
2018,Venezuela (Bolivarian Republic of),VEN,Costa Rica,CRI,24,0,514,406,944
2018,Egypt,EGY,Cyprus,CYP,12,0,95,70,177
2018,Bangladesh,BGD,Cyprus,CYP,0,0,207,25,232
2018,Cameroon,CMR,Cyprus,CYP,25,0,27,0,52
2018,Congo,COG,Cyprus,CYP,0,0,0,10,10
2018,Dem. Rep. of the Congo,COD,Cyprus,CYP,5,0,0,0,5
2018,Ethiopia,ETH,Cyprus,CYP,5,0,5,5,15
2018,Gambia,GMB,Cyprus,CYP,0,0,16,0,16
2018,Palestinian,PSE,Cyprus,CYP,23,10,0,0,33
2018,Georgia,GEO,Cyprus,CYP,0,0,5,13,18
2018,Guinea,GIN,Cyprus,CYP,0,0,0,5,5
2018,Cote d'Ivoire,CIV,Cyprus,CYP,0,0,5,0,5
2018,India,IND,Cyprus,CYP,0,0,265,48,313
2018,Iran (Islamic Rep. of),IRN,Cyprus,CYP,22,5,17,17,61
2018,Iraq,IRQ,Cyprus,CYP,12,17,46,64,139
2018,Jordan,JOR,Cyprus,CYP,0,0,0,5,5
2018,Lebanon,LBN,Cyprus,CYP,0,5,0,5,10
2018,Sri Lanka,LKA,Cyprus,CYP,0,0,110,33,143
2018,Morocco,MAR,Cyprus,CYP,0,0,0,5,5
2018,Nepal,NPL,Cyprus,CYP,0,0,64,39,103
2018,Nigeria,NGA,Cyprus,CYP,0,0,5,5,10
2018,Pakistan,PAK,Cyprus,CYP,0,0,137,65,202
2018,Philippines,PHL,Cyprus,CYP,0,0,5,21,26
2018,Somalia,SOM,Cyprus,CYP,14,22,0,0,36
2018,Viet Nam,VNM,Cyprus,CYP,0,0,196,31,227
2018,Sudan,SDN,Cyprus,CYP,0,5,0,0,5
2018,Syrian Arab Rep.,SYR,Cyprus,CYP,45,937,0,0,982
2018,Turkey,TUR,Cyprus,CYP,17,0,12,5,34
2018,Ukraine,UKR,Cyprus,CYP,0,0,0,17,17
2018,Uzbekistan,UZB,Cyprus,CYP,0,0,0,5,5
2018,Yemen,YEM,Cyprus,CYP,5,5,0,0,10
2018,Zimbabwe,ZWE,Cyprus,CYP,0,0,5,0,5
2018,Afghanistan,AFG,Czechia,CZE,0,0,0,16,16
2018,Algeria,DZA,Czechia,CZE,0,0,10,5,15
2018,Armenia,ARM,Czechia,CZE,0,0,45,75,120
2018,Azerbaijan,AZE,Czechia,CZE,0,0,56,35,91
2018,Belarus,BLR,Czechia,CZE,0,0,5,5,10
2018,China,CHN,Czechia,CZE,10,0,71,5,86
2018,Cameroon,CMR,Czechia,CZE,0,0,5,0,5
2018,Dem. Rep. of the Congo,COD,Czechia,CZE,0,0,5,5,10
2018,Cuba,CUB,Czechia,CZE,0,0,31,148,179
2018,Palestinian,PSE,Czechia,CZE,0,0,0,5,5
2018,Georgia,GEO,Czechia,CZE,0,0,47,114,161
2018,India,IND,Czechia,CZE,0,0,0,5,5
2018,Iran (Islamic Rep. of),IRN,Czechia,CZE,0,0,0,15,15
2018,Iraq,IRQ,Czechia,CZE,0,32,13,33,78
2018,Kazakhstan,KAZ,Czechia,CZE,0,0,14,5,19
2018,Kyrgyzstan,KGZ,Czechia,CZE,0,0,0,5,5
2018,Libya,LBY,Czechia,CZE,0,0,0,5,5
2018,Rep. of Moldova,MDA,Czechia,CZE,0,0,15,5,20
2018,Mongolia,MNG,Czechia,CZE,0,0,12,10,22
2018,Morocco,MAR,Czechia,CZE,0,0,0,5,5
2018,Myanmar,MMR,Czechia,CZE,5,0,0,0,5
2018,Nigeria,NGA,Czechia,CZE,0,0,5,13,18
2018,Pakistan,PAK,Czechia,CZE,0,0,0,5,5
2018,Russian Federation,RUS,Czechia,CZE,0,0,27,39,66
2018,Serbia and Kosovo: S/RES/1244 (1999),SRB,Czechia,CZE,0,0,10,5,15
2018,Viet Nam,VNM,Czechia,CZE,0,0,73,29,102
2018,Slovakia,SVK,Czechia,CZE,0,0,0,5,5
2018,Syrian Arab Rep.,SYR,Czechia,CZE,5,52,0,10,67
2018,Tunisia,TUN,Czechia,CZE,0,0,10,0,10
2018,Turkey,TUR,Czechia,CZE,0,0,24,19,43
2018,Ukraine,UKR,Czechia,CZE,5,12,222,137,376
2018,Uzbekistan,UZB,Czechia,CZE,0,0,38,20,58
2018,Stateless,XXA,Czechia,CZE,0,5,5,5,15
2018,Afghanistan,AFG,Denmark,DNK,5,19,130,0,154
2018,Albania,ALB,Denmark,DNK,0,0,40,0,40
2018,Algeria,DZA,Denmark,DNK,0,0,10,0,10
2018,Egypt,EGY,Denmark,DNK,0,0,5,0,5
2018,Armenia,ARM,Denmark,DNK,0,0,13,0,13
2018,Azerbaijan,AZE,Denmark,DNK,0,0,17,0,17
2018,Burundi,BDI,Denmark,DNK,0,0,5,0,5
2018,Bangladesh,BGD,Denmark,DNK,0,0,5,0,5
2018,Belarus,BLR,Denmark,DNK,0,0,18,0,18
2018,Bosnia and Herzegovina,BIH,Denmark,DNK,0,0,5,0,5
2018,Cameroon,CMR,Denmark,DNK,0,0,5,0,5
2018,Colombia,COL,Denmark,DNK,0,0,19,0,19
2018,Eritrea,ERI,Denmark,DNK,586,21,5,0,612
2018,Ethiopia,ETH,Denmark,DNK,0,0,5,0,5
2018,Gambia,GMB,Denmark,DNK,0,0,5,0,5
2018,Georgia,GEO,Denmark,DNK,0,0,190,0,190
2018,Ghana,GHA,Denmark,DNK,0,0,5,0,5
2018,Guinea,GIN,Denmark,DNK,0,0,5,0,5
2018,India,IND,Denmark,DNK,0,0,5,0,5
2018,Indonesia,IDN,Denmark,DNK,0,0,5,0,5
2018,Iran (Islamic Rep. of),IRN,Denmark,DNK,60,5,64,0,129
2018,Iraq,IRQ,Denmark,DNK,0,0,47,0,47
2018,Kenya,KEN,Denmark,DNK,0,0,5,0,5
2018,Libya,LBY,Denmark,DNK,0,0,5,0,5
2018,Lebanon,LBN,Denmark,DNK,0,0,5,0,5
2018,Sri Lanka,LKA,Denmark,DNK,0,0,19,0,19
2018,Lithuania,LTU,Denmark,DNK,0,0,5,0,5
2018,North Macedonia,MKD,Denmark,DNK,0,0,11,0,11
2018,Morocco,MAR,Denmark,DNK,0,0,42,0,42
2018,Myanmar,MMR,Denmark,DNK,0,0,5,0,5
2018,Nepal,NPL,Denmark,DNK,0,0,5,0,5
2018,Nigeria,NGA,Denmark,DNK,0,0,17,0,17
2018,Pakistan,PAK,Denmark,DNK,0,0,10,0,10
2018,Poland,POL,Denmark,DNK,0,0,5,0,5
2018,Russian Federation,RUS,Denmark,DNK,0,0,34,0,34
2018,Rwanda,RWA,Denmark,DNK,5,0,0,0,5
2018,El Salvador,SLV,Denmark,DNK,0,0,10,0,10
2018,Serbia and Kosovo: S/RES/1244 (1999),SRB,Denmark,DNK,0,0,19,0,19
2018,Senegal,SEN,Denmark,DNK,0,0,5,0,5
2018,Somalia,SOM,Denmark,DNK,0,0,54,0,54
2018,Syrian Arab Rep.,SYR,Denmark,DNK,152,378,5,0,535
2018,Tunisia,TUN,Denmark,DNK,0,0,5,0,5
2018,Turkey,TUR,Denmark,DNK,5,0,13,0,18
2018,Uganda,UGA,Denmark,DNK,0,0,10,0,10
2018,Ukraine,UKR,Denmark,DNK,0,0,25,0,25
2018,United States of America,USA,Denmark,DNK,0,0,5,0,5
2018,Venezuela (Bolivarian Republic of),VEN,Denmark,DNK,0,0,13,0,13
2018,Yemen,YEM,Denmark,DNK,0,0,5,0,5
2018,Zambia,ZMB,Denmark,DNK,0,0,5,0,5
2018,Stateless,XXA,Denmark,DNK,10,28,27,0,65
2018,Unknown ,,Denmark,DNK,0,0,5,0,5
2018,Albania,ALB,Estonia,EST,0,0,5,0,5
2018,Egypt,EGY,Estonia,EST,0,0,5,0,5
2018,Azerbaijan,AZE,Estonia,EST,5,0,0,0,5
2018,Bangladesh,BGD,Estonia,EST,0,0,5,0,5
2018,Belarus,BLR,Estonia,EST,0,0,5,0,5
2018,India,IND,Estonia,EST,0,0,5,0,5
2018,Iran (Islamic Rep. of),IRN,Estonia,EST,0,0,5,0,5
2018,Iraq,IRQ,Estonia,EST,5,0,0,0,5
2018,Morocco,MAR,Estonia,EST,0,0,5,0,5
2018,Pakistan,PAK,Estonia,EST,0,0,5,0,5
2018,Russian Federation,RUS,Estonia,EST,5,0,10,0,15
2018,Ukraine,UKR,Estonia,EST,0,0,5,0,5
2018,Venezuela (Bolivarian Republic of),VEN,Estonia,EST,0,0,0,5,5
2018,Afghanistan,AFG,Finland,FIN,256,136,363,29,784
2018,Albania,ALB,Finland,FIN,0,0,32,5,37
2018,Algeria,DZA,Finland,FIN,0,0,5,14,19
2018,Angola,AGO,Finland,FIN,0,0,0,37,37
2018,Egypt,EGY,Finland,FIN,0,0,5,0,5
2018,Armenia,ARM,Finland,FIN,0,0,5,5,10
2018,Azerbaijan,AZE,Finland,FIN,0,0,0,10,10
2018,Bangladesh,BGD,Finland,FIN,0,0,15,0,15
2018,Belarus,BLR,Finland,FIN,0,0,5,25,30
2018,China,CHN,Finland,FIN,38,0,31,5,74
2018,Cameroon,CMR,Finland,FIN,5,0,19,10,34
2018,Dem. Rep. of the Congo,COD,Finland,FIN,5,0,12,5,22
2018,Cuba,CUB,Finland,FIN,0,0,5,5,10
2018,Eritrea,ERI,Finland,FIN,277,0,0,0,277
2018,Ethiopia,ETH,Finland,FIN,13,0,12,5,30
2018,Gambia,GMB,Finland,FIN,0,0,10,18,28
2018,Georgia,GEO,Finland,FIN,0,0,40,52,92
2018,Ghana,GHA,Finland,FIN,0,0,5,5,10
2018,India,IND,Finland,FIN,0,0,11,5,16
2018,Indonesia,IDN,Finland,FIN,0,0,10,0,10
2018,Iran (Islamic Rep. of),IRN,Finland,FIN,28,5,41,56,130
2018,Iraq,IRQ,Finland,FIN,676,165,615,88,1544
2018,Kazakhstan,KAZ,Finland,FIN,0,0,0,5,5
2018,Libya,LBY,Finland,FIN,0,0,0,13,13
2018,Sri Lanka,LKA,Finland,FIN,0,0,19,5,24
2018,North Macedonia,MKD,Finland,FIN,0,0,5,5,10
2018,Morocco,MAR,Finland,FIN,0,0,5,27,32
2018,Nigeria,NGA,Finland,FIN,5,0,26,38,69
2018,Pakistan,PAK,Finland,FIN,5,0,23,15,43
2018,Russian Federation,RUS,Finland,FIN,11,0,123,46,180
2018,Rwanda,RWA,Finland,FIN,0,0,5,0,5
2018,El Salvador,SLV,Finland,FIN,0,0,5,0,5
2018,Serbia and Kosovo: S/RES/1244 (1999),SRB,Finland,FIN,0,0,5,5,10
2018,Senegal,SEN,Finland,FIN,0,0,5,5,10
2018,Somalia,SOM,Finland,FIN,164,26,123,34,347
2018,South Sudan,SSD,Finland,FIN,0,5,0,5,10
2018,Syrian Arab Rep.,SYR,Finland,FIN,97,34,0,32,163
2018,Tunisia,TUN,Finland,FIN,0,0,5,5,10
2018,Turkey,TUR,Finland,FIN,51,0,41,13,105
2018,Uganda,UGA,Finland,FIN,5,0,0,0,5
2018,Ukraine,UKR,Finland,FIN,0,0,18,5,23
2018,Venezuela (Bolivarian Republic of),VEN,Finland,FIN,0,0,10,0,10
2018,Yemen,YEM,Finland,FIN,11,30,0,15,56
2018,Zambia,ZMB,Finland,FIN,0,0,5,0,5
2018,Stateless,XXA,Finland,FIN,27,0,10,5,42
2018,Unknown ,,Finland,FIN,5,0,5,5,15
2018,Afghanistan,AFG,France,FRA,402,4542,2616,64,7624
2018,Albania,ALB,France,FRA,74,453,5742,67,6336
2018,Algeria,DZA,France,FRA,98,79,2471,72,2720
2018,Angola,AGO,France,FRA,49,33,668,10,760
2018,Egypt,EGY,France,FRA,32,5,436,5,478
2018,Armenia,ARM,France,FRA,39,87,1845,16,1987
2018,Azerbaijan,AZE,France,FRA,26,10,271,5,312
2018,Bahrain,BHR,France,FRA,5,0,0,0,5
2018,Burundi,BDI,France,FRA,243,0,57,5,305
2018,Benin,BEN,France,FRA,5,5,75,5,90
2018,Bangladesh,BGD,France,FRA,146,110,3353,5,3614
2018,Burkina Faso,BFA,France,FRA,21,10,121,0,152
2018,Belarus,BLR,France,FRA,5,0,35,0,40
2018,Bolivia (Plurinational State of),BOL,France,FRA,0,0,5,0,5
2018,Brazil,BRA,France,FRA,0,0,43,0,43
2018,Bosnia and Herzegovina,BIH,France,FRA,19,21,471,22,533
2018,Cambodia,KHM,France,FRA,10,0,40,0,50
2018,Central African Rep.,CAF,France,FRA,185,109,239,16,549
2018,Chad,TCD,France,FRA,133,14,646,5,798
2018,China,CHN,France,FRA,1283,0,1412,10,2705
2018,Chile,CHL,France,FRA,5,0,0,0,5
2018,Cameroon,CMR,France,FRA,122,35,664,5,826
2018,Congo,COG,France,FRA,108,31,942,11,1092
2018,Dem. Rep. of the Congo,COD,France,FRA,511,104,2857,25,3497
2018,Comoros,COM,France,FRA,15,5,204,5,229
2018,Colombia,COL,France,FRA,17,35,143,5,200
2018,Costa Rica,CRI,France,FRA,0,5,0,0,5
2018,Cuba,CUB,France,FRA,19,0,64,5,88
2018,Djibouti,DJI,France,FRA,23,10,61,0,94
2018,Dominican Rep.,DOM,France,FRA,0,5,490,14,509
2018,Eritrea,ERI,France,FRA,1215,0,264,5,1484
2018,Ethiopia,ETH,France,FRA,273,10,458,0,741
2018,Gabon,GAB,France,FRA,46,26,306,10,388
2018,Gambia,GMB,France,FRA,21,10,170,0,201
2018,Palestinian,PSE,France,FRA,105,10,64,5,184
2018,Georgia,GEO,France,FRA,68,104,3579,59,3810
2018,Ghana,GHA,France,FRA,0,0,47,0,47
2018,Guinea-Bissau,GNB,France,FRA,18,0,118,0,136
2018,Guinea,GIN,France,FRA,908,177,3904,34,5023
2018,Guyana,GUY,France,FRA,0,0,12,0,12
2018,Haiti,HTI,France,FRA,59,60,3297,23,3439
2018,Honduras,HND,France,FRA,0,5,18,0,23
2018,Cote d'Ivoire,CIV,France,FRA,741,125,3828,41,4735
2018,India,IND,France,FRA,10,5,129,5,149
2018,Iran (Islamic Rep. of),IRN,France,FRA,99,10,315,10,434
2018,Iraq,IRQ,France,FRA,811,118,374,16,1319
2018,Jamaica,JAM,France,FRA,0,0,5,0,5
2018,Jordan,JOR,France,FRA,0,0,5,0,5
2018,Kazakhstan,KAZ,France,FRA,13,12,162,5,192
2018,Kenya,KEN,France,FRA,10,5,37,0,52
2018,Kyrgyzstan,KGZ,France,FRA,5,0,13,0,18
2018,Kuwait,KWT,France,FRA,44,0,27,0,71
2018,Liberia,LBR,France,FRA,5,0,39,0,44
2018,Libya,LBY,France,FRA,53,96,275,11,435
2018,Saint Lucia,LCA,France,FRA,0,0,5,0,5
2018,Lebanon,LBN,France,FRA,5,5,35,0,45
2018,Sri Lanka,LKA,France,FRA,180,71,1627,11,1889
2018,Madagascar,MDG,France,FRA,5,5,103,0,113
2018,Mauritania,MRT,France,FRA,86,10,764,10,870
2018,North Macedonia,MKD,France,FRA,10,5,912,57,984
2018,Rep. of Moldova,MDA,France,FRA,0,0,93,10,103
2018,Maldives,MDV,France,FRA,5,0,0,0,5
2018,Mexico,MEX,France,FRA,0,0,13,0,13
2018,Mali,MLI,France,FRA,420,23,1845,38,2326
2018,Malaysia,MYS,France,FRA,0,0,5,0,5
2018,Mongolia,MNG,France,FRA,12,13,156,0,181
2018,Morocco,MAR,France,FRA,87,32,448,11,578
2018,Montenegro,MNE,France,FRA,0,0,103,0,103
2018,Mauritius,MUS,France,FRA,5,5,5,0,15
2018,Myanmar,MMR,France,FRA,5,0,30,0,35
2018,Nepal,NPL,France,FRA,5,5,79,0,89
2018,Niger,NER,France,FRA,14,5,58,0,77
2018,Nicaragua,NIC,France,FRA,5,0,10,0,15
2018,Nigeria,NGA,France,FRA,146,36,2769,24,2975
2018,Pakistan,PAK,France,FRA,47,47,2554,10,2658
2018,Peru,PER,France,FRA,0,16,78,0,94
2018,Philippines,PHL,France,FRA,0,0,5,0,5
2018,South Africa,ZAF,France,FRA,10,5,10,0,25
2018,Russian Federation,RUS,France,FRA,205,56,1462,46,1769
2018,Rwanda,RWA,France,FRA,136,0,133,0,269
2018,El Salvador,SLV,France,FRA,0,15,24,0,39
2018,Serbia and Kosovo: S/RES/1244 (1999),SRB,France,FRA,103,219,3151,78,3551
2018,Senegal,SEN,France,FRA,165,27,1339,26,1557
2018,Sierra Leone,SLE,France,FRA,13,5,139,0,157
2018,Somalia,SOM,France,FRA,182,390,1029,5,1606
2018,Viet Nam,VNM,France,FRA,5,0,34,0,39
2018,Sudan,SDN,France,FRA,2368,410,1672,33,4483
2018,South Sudan,SSD,France,FRA,10,0,15,0,25
2018,Syrian Arab Rep.,SYR,France,FRA,926,2497,302,38,3763
2018,Togo,TGO,France,FRA,27,5,192,5,229
2018,Tunisia,TUN,France,FRA,32,5,246,18,301
2018,Turkey,TUR,France,FRA,371,11,1385,17,1784
2018,Uganda,UGA,France,FRA,11,0,22,0,33
2018,Ukraine,UKR,France,FRA,41,54,373,15,483
2018,Uzbekistan,UZB,France,FRA,5,0,13,0,18
2018,Venezuela (Bolivarian Republic of),VEN,France,FRA,133,36,182,5,356
2018,Western Sahara,ESH,France,FRA,32,0,656,0,688
2018,Yemen,YEM,France,FRA,48,71,22,0,141
2018,Zimbabwe,ZWE,France,FRA,0,0,10,0,10
2018,Stateless,XXA,France,FRA,71,0,256,15,342
2018,Unknown ,,France,FRA,8984,4642,14543,356,28525
2018,Afghanistan,AFG,United Kingdom of Great Britain and Northern Ireland,GBR,639,142,806,323,1910
2018,Albania,ALB,United Kingdom of Great Britain and Northern Ireland,GBR,28,54,1085,394,1561
2018,Algeria,DZA,United Kingdom of Great Britain and Northern Ireland,GBR,12,13,148,66,239
2018,Angola,AGO,United Kingdom of Great Britain and Northern Ireland,GBR,0,5,45,5,55
2018,Antigua and Barbuda,ATG,United Kingdom of Great Britain and Northern Ireland,GBR,0,0,5,0,5
2018,Egypt,EGY,United Kingdom of Great Britain and Northern Ireland,GBR,33,10,328,88,459
2018,Argentina,ARG,United Kingdom of Great Britain and Northern Ireland,GBR,0,0,5,0,5
2018,Armenia,ARM,United Kingdom of Great Britain and Northern Ireland,GBR,0,0,36,5,41
2018,Australia,AUS,United Kingdom of Great Britain and Northern Ireland,GBR,0,0,5,0,5
2018,Azerbaijan,AZE,United Kingdom of Great Britain and Northern Ireland,GBR,46,5,51,10,112
2018,Bahrain,BHR,United Kingdom of Great Britain and Northern Ireland,GBR,11,0,11,5,27
2018,Barbados,BRB,United Kingdom of Great Britain and Northern Ireland,GBR,5,5,5,0,15
2018,Burundi,BDI,United Kingdom of Great Britain and Northern Ireland,GBR,5,0,19,0,24
2018,Benin,BEN,United Kingdom of Great Britain and Northern Ireland,GBR,0,0,5,0,5
2018,Bangladesh,BGD,United Kingdom of Great Britain and Northern Ireland,GBR,84,29,1316,175,1604
2018,Burkina Faso,BFA,United Kingdom of Great Britain and Northern Ireland,GBR,0,0,5,0,5
2018,Belarus,BLR,United Kingdom of Great Britain and Northern Ireland,GBR,0,0,14,0,14
2018,Bolivia (Plurinational State of),BOL,United Kingdom of Great Britain and Northern Ireland,GBR,0,0,5,0,5
2018,Botswana,BWA,United Kingdom of Great Britain and Northern Ireland,GBR,0,0,15,0,15
2018,Brazil,BRA,United Kingdom of Great Britain and Northern Ireland,GBR,5,0,29,19,53
2018,Canada,CAN,United Kingdom of Great Britain and Northern Ireland,GBR,0,0,5,0,5
2018,Chad,TCD,United Kingdom of Great Britain and Northern Ireland,GBR,5,0,5,5,15
2018,China,CHN,United Kingdom of Great Britain and Northern Ireland,GBR,19,10,488,562,1079
2018,Chile,CHL,United Kingdom of Great Britain and Northern Ireland,GBR,0,0,5,0,5
2018,Cameroon,CMR,United Kingdom of Great Britain and Northern Ireland,GBR,63,15,171,5,254
2018,Congo,COG,United Kingdom of Great Britain and Northern Ireland,GBR,5,5,18,0,28
2018,Dem. Rep. of the Congo,COD,United Kingdom of Great Britain and Northern Ireland,GBR,48,15,182,10,255
2018,Comoros,COM,United Kingdom of Great Britain and Northern Ireland,GBR,0,0,5,0,5
2018,Colombia,COL,United Kingdom of Great Britain and Northern Ireland,GBR,0,0,18,0,18
2018,Dominica,DMA,United Kingdom of Great Britain and Northern Ireland,GBR,5,0,5,5,15
2018,Ecuador,ECU,United Kingdom of Great Britain and Northern Ireland,GBR,0,0,5,0,5
2018,Eritrea,ERI,United Kingdom of Great Britain and Northern Ireland,GBR,838,5,62,421,1326
2018,Ethiopia,ETH,United Kingdom of Great Britain and Northern Ireland,GBR,170,15,190,153,528
2018,France,FRA,United Kingdom of Great Britain and Northern Ireland,GBR,0,0,5,0,5
2018,Gambia,GMB,United Kingdom of Great Britain and Northern Ireland,GBR,24,5,83,11,123
2018,Palestinian,PSE,United Kingdom of Great Britain and Northern Ireland,GBR,52,14,73,72,211
2018,Georgia,GEO,United Kingdom of Great Britain and Northern Ireland,GBR,13,0,41,22,76
2018,Ghana,GHA,United Kingdom of Great Britain and Northern Ireland,GBR,13,12,174,35,234
2018,Grenada,GRD,United Kingdom of Great Britain and Northern Ireland,GBR,0,0,10,0,10
2018,Guatemala,GTM,United Kingdom of Great Britain and Northern Ireland,GBR,0,0,10,0,10
2018,Guinea,GIN,United Kingdom of Great Britain and Northern Ireland,GBR,18,0,18,10,46
2018,Guyana,GUY,United Kingdom of Great Britain and Northern Ireland,GBR,5,0,5,0,10
2018,"China, Hong Kong SAR",HKG,United Kingdom of Great Britain and Northern Ireland,GBR,0,0,0,5,5
2018,Honduras,HND,United Kingdom of Great Britain and Northern Ireland,GBR,5,0,14,12,31
2018,Croatia,HRV,United Kingdom of Great Britain and Northern Ireland,GBR,0,0,5,0,5
2018,Hungary,HUN,United Kingdom of Great Britain and Northern Ireland,GBR,0,0,5,0,5
2018,Cote d'Ivoire,CIV,United Kingdom of Great Britain and Northern Ireland,GBR,5,5,36,0,46
2018,India,IND,United Kingdom of Great Britain and Northern Ireland,GBR,0,33,772,386,1191
2018,Indonesia,IDN,United Kingdom of Great Britain and Northern Ireland,GBR,5,0,14,5,24
2018,Iran (Islamic Rep. of),IRN,United Kingdom of Great Britain and Northern Ireland,GBR,1118,91,1187,421,2817
2018,Iraq,IRQ,United Kingdom of Great Britain and Northern Ireland,GBR,359,241,1650,735,2985
2018,Italy,ITA,United Kingdom of Great Britain and Northern Ireland,GBR,0,0,5,0,5
2018,Jamaica,JAM,United Kingdom of Great Britain and Northern Ireland,GBR,14,10,111,17,152
2018,Jordan,JOR,United Kingdom of Great Britain and Northern Ireland,GBR,5,0,22,5,32
2018,Japan,JPN,United Kingdom of Great Britain and Northern Ireland,GBR,0,0,5,0,5
2018,Kazakhstan,KAZ,United Kingdom of Great Britain and Northern Ireland,GBR,5,0,16,0,21
2018,Kenya,KEN,United Kingdom of Great Britain and Northern Ireland,GBR,5,11,88,5,109
2018,Kyrgyzstan,KGZ,United Kingdom of Great Britain and Northern Ireland,GBR,5,0,10,0,15
2018,Rep. of Korea,KOR,United Kingdom of Great Britain and Northern Ireland,GBR,0,0,5,5,10
2018,Dem. People's Rep. of Korea,PRK,United Kingdom of Great Britain and Northern Ireland,GBR,0,5,10,0,15
2018,Kuwait,KWT,United Kingdom of Great Britain and Northern Ireland,GBR,132,0,31,72,235
2018,Liberia,LBR,United Kingdom of Great Britain and Northern Ireland,GBR,0,0,5,0,5
2018,Libya,LBY,United Kingdom of Great Britain and Northern Ireland,GBR,218,1033,5,44,1300
2018,Saint Lucia,LCA,United Kingdom of Great Britain and Northern Ireland,GBR,0,0,11,5,16
2018,Lebanon,LBN,United Kingdom of Great Britain and Northern Ireland,GBR,21,0,56,15,92
2018,Lesotho,LSO,United Kingdom of Great Britain and Northern Ireland,GBR,0,0,5,0,5
2018,Sri Lanka,LKA,United Kingdom of Great Britain and Northern Ireland,GBR,60,10,670,108,848
2018,Lithuania,LTU,United Kingdom of Great Britain and Northern Ireland,GBR,0,0,5,0,5
2018,Latvia,LVA,United Kingdom of Great Britain and Northern Ireland,GBR,0,0,5,0,5
2018,Maldives,MDV,United Kingdom of Great Britain and Northern Ireland,GBR,5,0,0,0,5
2018,Mexico,MEX,United Kingdom of Great Britain and Northern Ireland,GBR,0,0,14,5,19
2018,Mali,MLI,United Kingdom of Great Britain and Northern Ireland,GBR,0,0,5,5,10
2018,Malaysia,MYS,United Kingdom of Great Britain and Northern Ireland,GBR,66,0,87,31,184
2018,Malawi,MWI,United Kingdom of Great Britain and Northern Ireland,GBR,0,5,62,0,67
2018,Mongolia,MNG,United Kingdom of Great Britain and Northern Ireland,GBR,0,0,12,5,17
2018,Morocco,MAR,United Kingdom of Great Britain and Northern Ireland,GBR,13,10,72,26,121
2018,Mozambique,MOZ,United Kingdom of Great Britain and Northern Ireland,GBR,0,0,10,0,10
2018,Mauritius,MUS,United Kingdom of Great Britain and Northern Ireland,GBR,0,0,29,10,39
2018,Myanmar,MMR,United Kingdom of Great Britain and Northern Ireland,GBR,5,0,39,5,49
2018,Namibia,NAM,United Kingdom of Great Britain and Northern Ireland,GBR,10,10,100,74,194
2018,Nepal,NPL,United Kingdom of Great Britain and Northern Ireland,GBR,0,5,80,32,117
2018,Nigeria,NGA,United Kingdom of Great Britain and Northern Ireland,GBR,117,199,984,85,1385
2018,Oman,OMN,United Kingdom of Great Britain and Northern Ireland,GBR,0,0,10,0,10
2018,Pakistan,PAK,United Kingdom of Great Britain and Northern Ireland,GBR,416,38,1791,418,2663
2018,Philippines,PHL,United Kingdom of Great Britain and Northern Ireland,GBR,0,5,67,13,85
2018,Poland,POL,United Kingdom of Great Britain and Northern Ireland,GBR,0,0,24,0,24
2018,Romania,ROU,United Kingdom of Great Britain and Northern Ireland,GBR,0,0,11,5,16
2018,South Africa,ZAF,United Kingdom of Great Britain and Northern Ireland,GBR,0,5,63,5,73
2018,Russian Federation,RUS,United Kingdom of Great Britain and Northern Ireland,GBR,97,0,88,20,205
2018,Rwanda,RWA,United Kingdom of Great Britain and Northern Ireland,GBR,5,0,29,0,34
2018,El Salvador,SLV,United Kingdom of Great Britain and Northern Ireland,GBR,17,0,69,5,91
2018,Saudi Arabia,SAU,United Kingdom of Great Britain and Northern Ireland,GBR,27,5,23,11,66
2018,Serbia and Kosovo: S/RES/1244 (1999),SRB,United Kingdom of Great Britain and Northern Ireland,GBR,0,5,10,5,20
2018,Senegal,SEN,United Kingdom of Great Britain and Northern Ireland,GBR,5,12,27,5,49
2018,Singapore,SGP,United Kingdom of Great Britain and Northern Ireland,GBR,0,0,11,0,11
2018,Sierra Leone,SLE,United Kingdom of Great Britain and Northern Ireland,GBR,19,5,40,10,74
2018,Somalia,SOM,United Kingdom of Great Britain and Northern Ireland,GBR,120,10,97,40,267
2018,Viet Nam,VNM,United Kingdom of Great Britain and Northern Ireland,GBR,233,59,404,225,921
2018,Sudan,SDN,United Kingdom of Great Britain and Northern Ireland,GBR,608,23,308,483,1422
2018,South Sudan,SSD,United Kingdom of Great Britain and Northern Ireland,GBR,10,0,10,5,25
2018,Slovakia,SVK,United Kingdom of Great Britain and Northern Ireland,GBR,0,0,5,0,5
2018,Eswatini,SWZ,United Kingdom of Great Britain and Northern Ireland,GBR,5,0,0,0,5
2018,Syrian Arab Rep.,SYR,United Kingdom of Great Britain and Northern Ireland,GBR,651,0,50,78,779
2018,United Rep. of Tanzania,TZA,United Kingdom of Great Britain and Northern Ireland,GBR,5,0,40,5,50
2018,Thailand,THA,United Kingdom of Great Britain and Northern Ireland,GBR,5,0,27,0,32
2018,Togo,TGO,United Kingdom of Great Britain and Northern Ireland,GBR,0,0,5,0,5
2018,Trinidad and Tobago,TTO,United Kingdom of Great Britain and Northern Ireland,GBR,12,0,28,0,40
2018,Tunisia,TUN,United Kingdom of Great Britain and Northern Ireland,GBR,5,5,28,10,48
2018,Turkey,TUR,United Kingdom of Great Britain and Northern Ireland,GBR,368,10,334,53,765
2018,Uganda,UGA,United Kingdom of Great Britain and Northern Ireland,GBR,67,11,69,5,152
2018,Ukraine,UKR,United Kingdom of Great Britain and Northern Ireland,GBR,5,10,152,62,229
2018,United States of America,USA,United Kingdom of Great Britain and Northern Ireland,GBR,10,0,23,20,53
2018,Uzbekistan,UZB,United Kingdom of Great Britain and Northern Ireland,GBR,5,0,21,5,31
2018,Saint Vincent and the Grenadines,VCT,United Kingdom of Great Britain and Northern Ireland,GBR,5,0,10,0,15
2018,Venezuela (Bolivarian Republic of),VEN,United Kingdom of Great Britain and Northern Ireland,GBR,5,0,28,5,38
2018,Yemen,YEM,United Kingdom of Great Britain and Northern Ireland,GBR,82,92,32,5,211
2018,Zambia,ZMB,United Kingdom of Great Britain and Northern Ireland,GBR,0,10,16,5,31
2018,Zimbabwe,ZWE,United Kingdom of Great Britain and Northern Ireland,GBR,14,5,155,27,201
2018,Stateless,XXA,United Kingdom of Great Britain and Northern Ireland,GBR,285,5,163,118,571
2018,Unknown ,,United Kingdom of Great Britain and Northern Ireland,GBR,211,70,20,12,313
2018,Afghanistan,AFG,Georgia,GEO,0,0,20,0,20
2018,Egypt,EGY,Georgia,GEO,25,0,65,24,114
2018,Azerbaijan,AZE,Georgia,GEO,0,0,5,5,10
2018,Bangladesh,BGD,Georgia,GEO,0,0,34,18,52
2018,Congo,COG,Georgia,GEO,0,0,5,0,5
2018,Eritrea,ERI,Georgia,GEO,0,0,59,12,71
2018,India,IND,Georgia,GEO,0,0,15,10,25
2018,Iran (Islamic Rep. of),IRN,Georgia,GEO,5,0,23,50,78
2018,Iraq,IRQ,Georgia,GEO,17,5,33,16,71
2018,Jordan,JOR,Georgia,GEO,0,0,5,0,5
2018,Kazakhstan,KAZ,Georgia,GEO,0,0,5,0,5
2018,Nigeria,NGA,Georgia,GEO,0,0,10,5,15
2018,Pakistan,PAK,Georgia,GEO,0,0,58,30,88
2018,Russian Federation,RUS,Georgia,GEO,0,0,31,12,43
2018,Saudi Arabia,SAU,Georgia,GEO,0,0,0,5,5
2018,Somalia,SOM,Georgia,GEO,0,0,11,5,16
2018,Sudan,SDN,Georgia,GEO,0,0,5,5,10
2018,Syrian Arab Rep.,SYR,Georgia,GEO,0,0,25,5,30
2018,Turkey,TUR,Georgia,GEO,0,0,25,10,35
2018,Ukraine,UKR,Georgia,GEO,0,5,5,5,15
2018,Yemen,YEM,Georgia,GEO,5,18,64,5,92
2018,Stateless,XXA,Georgia,GEO,0,0,13,0,13
2018,Central African Rep.,CAF,Ghana,GHA,11,0,0,0,11
2018,Dem. Rep. of the Congo,COD,Ghana,GHA,5,0,0,5,10
2018,Eritrea,ERI,Ghana,GHA,75,0,0,0,75
2018,Cote d'Ivoire,CIV,Ghana,GHA,155,0,0,20,175
2018,Sierra Leone,SLE,Ghana,GHA,5,0,0,0,5
2018,Sudan,SDN,Ghana,GHA,120,0,0,0,120
2018,Syrian Arab Rep.,SYR,Ghana,GHA,117,0,0,0,117
2018,Afghanistan,AFG,Greece,GRC,1570,963,842,1955,5330
2018,Albania,ALB,Greece,GRC,5,0,2448,483,2936
2018,Algeria,DZA,Greece,GRC,21,0,249,344,614
2018,Angola,AGO,Greece,GRC,0,0,5,0,5
2018,Egypt,EGY,Greece,GRC,71,0,463,128,662
2018,Armenia,ARM,Greece,GRC,0,0,45,20,65
2018,Burundi,BDI,Greece,GRC,11,0,0,0,11
2018,Bangladesh,BGD,Greece,GRC,23,5,977,163,1168
2018,Burkina Faso,BFA,Greece,GRC,0,0,14,5,19
2018,Belarus,BLR,Greece,GRC,0,0,5,0,5
2018,China,CHN,Greece,GRC,13,0,176,56,245
2018,Cameroon,CMR,Greece,GRC,120,5,210,141,476
2018,Congo,COG,Greece,GRC,31,5,49,21,106
2018,Dem. Rep. of the Congo,COD,Greece,GRC,204,14,348,231,797
2018,Comoros,COM,Greece,GRC,5,0,10,0,15
2018,Cuba,CUB,Greece,GRC,0,0,5,5,10
2018,Dominican Rep.,DOM,Greece,GRC,0,0,5,24,29
2018,Equatorial Guinea,GNQ,Greece,GRC,5,0,5,0,10
2018,Eritrea,ERI,Greece,GRC,152,0,10,51,213
2018,Ethiopia,ETH,Greece,GRC,66,0,97,18,181
2018,Gambia,GMB,Greece,GRC,5,0,20,0,25
2018,Palestinian,PSE,Greece,GRC,676,10,11,170,867
2018,Georgia,GEO,Greece,GRC,0,0,851,246,1097
2018,Ghana,GHA,Greece,GRC,0,0,63,21,84
2018,Guinea,GIN,Greece,GRC,19,5,50,21,95
2018,Haiti,HTI,Greece,GRC,5,0,5,5,15
2018,Cote d'Ivoire,CIV,Greece,GRC,5,0,15,10,30
2018,India,IND,Greece,GRC,0,0,98,35,133
2018,Indonesia,IDN,Greece,GRC,5,0,16,5,26
2018,Iran (Islamic Rep. of),IRN,Greece,GRC,438,22,219,379,1058
2018,Iraq,IRQ,Greece,GRC,2235,1257,1720,1623,6835
2018,Jordan,JOR,Greece,GRC,11,0,0,10,21
2018,Kazakhstan,KAZ,Greece,GRC,0,0,5,5,10
2018,Kenya,KEN,Greece,GRC,0,0,5,0,5
2018,Kuwait,KWT,Greece,GRC,43,0,0,18,61
2018,Libya,LBY,Greece,GRC,0,10,10,24,44
2018,Lebanon,LBN,Greece,GRC,11,0,31,15,57
2018,Sri Lanka,LKA,Greece,GRC,5,0,16,26,47
2018,Mauritania,MRT,Greece,GRC,5,0,0,0,5
2018,North Macedonia,MKD,Greece,GRC,0,0,5,5,10
2018,Rep. of Moldova,MDA,Greece,GRC,0,0,27,13,40
2018,Mali,MLI,Greece,GRC,5,5,29,5,44
2018,Morocco,MAR,Greece,GRC,38,0,131,170,339
2018,Myanmar,MMR,Greece,GRC,20,0,21,5,46
2018,Nepal,NPL,Greece,GRC,5,0,14,26,45
2018,Niger,NER,Greece,GRC,0,0,0,5,5
2018,Nigeria,NGA,Greece,GRC,12,0,72,26,110
2018,Pakistan,PAK,Greece,GRC,148,10,5826,1162,7146
2018,Philippines,PHL,Greece,GRC,0,0,5,0,5
2018,Russian Federation,RUS,Greece,GRC,0,0,30,14,44
2018,El Salvador,SLV,Greece,GRC,5,0,0,0,5
2018,Serbia and Kosovo: S/RES/1244 (1999),SRB,Greece,GRC,0,0,5,5,10
2018,Senegal,SEN,Greece,GRC,0,0,16,5,21
2018,Sierra Leone,SLE,Greece,GRC,5,0,20,5,30
2018,Somalia,SOM,Greece,GRC,50,133,11,37,231
2018,Viet Nam,VNM,Greece,GRC,0,0,5,11,16
2018,Sudan,SDN,Greece,GRC,43,0,16,5,64
2018,South Sudan,SSD,Greece,GRC,5,0,0,0,5
2018,Syrian Arab Rep.,SYR,Greece,GRC,5976,5,18,1488,7487
2018,United Rep. of Tanzania,TZA,Greece,GRC,0,0,5,0,5
2018,Tajikistan,TJK,Greece,GRC,5,0,0,0,5
2018,Togo,TGO,Greece,GRC,5,0,16,5,26
2018,Tunisia,TUN,Greece,GRC,5,0,32,31,68
2018,Turkey,TUR,Greece,GRC,258,0,42,1228,1528
2018,Uganda,UGA,Greece,GRC,0,0,11,0,11
2018,Ukraine,UKR,Greece,GRC,0,10,47,28,85
2018,Venezuela (Bolivarian Republic of),VEN,Greece,GRC,5,0,15,5,25
2018,Western Sahara,ESH,Greece,GRC,5,0,0,0,5
2018,Yemen,YEM,Greece,GRC,100,109,0,27,236
2018,Zimbabwe,ZWE,Greece,GRC,0,0,5,5,10
2018,Stateless,XXA,Greece,GRC,135,0,5,23,163
2018,Unknown ,,Greece,GRC,5,0,0,4834,4839
2018,Colombia,COL,Guatemala,GTM,0,0,0,5,5
2018,Honduras,HND,Guatemala,GTM,5,0,0,5,10
2018,Mexico,MEX,Guatemala,GTM,0,0,0,5,5
2018,Nicaragua,NIC,Guatemala,GTM,0,0,0,16,16
2018,El Salvador,SLV,Guatemala,GTM,10,0,0,5,15
2018,Venezuela (Bolivarian Republic of),VEN,Guatemala,GTM,5,0,0,0,5
2018,Congo,COG,Guinea,GIN,12,0,0,0,12
2018,Dem. Rep. of the Congo,COD,Guinea,GIN,10,0,0,0,10
2018,Gambia,GMB,Guinea,GIN,5,0,0,0,5
2018,Cote d'Ivoire,CIV,Guinea,GIN,43,0,0,0,43
2018,Liberia,LBR,Guinea,GIN,5,0,0,0,5
2018,Sierra Leone,SLE,Guinea,GIN,43,0,0,0,43
2018,Cuba,CUB,Honduras,HND,0,0,0,12,12
2018,Nicaragua,NIC,Honduras,HND,0,0,0,33,33
2018,El Salvador,SLV,Honduras,HND,0,0,0,16,16
2018,Afghanistan,AFG,Croatia,HRV,5,0,5,210,220
2018,Albania,ALB,Croatia,HRV,0,0,0,5,5
2018,Algeria,DZA,Croatia,HRV,0,0,35,31,66
2018,Egypt,EGY,Croatia,HRV,5,0,0,5,10
2018,Bangladesh,BGD,Croatia,HRV,0,0,5,13,18
2018,Cuba,CUB,Croatia,HRV,0,0,0,5,5
2018,Palestinian,PSE,Croatia,HRV,5,0,0,5,10
2018,India,IND,Croatia,HRV,0,0,0,21,21
2018,Iran (Islamic Rep. of),IRN,Croatia,HRV,0,0,17,109,126
2018,Iraq,IRQ,Croatia,HRV,28,0,10,17,55
2018,Libya,LBY,Croatia,HRV,0,0,5,18,23
2018,Morocco,MAR,Croatia,HRV,0,0,11,16,27
2018,Pakistan,PAK,Croatia,HRV,0,0,5,47,52
2018,Russian Federation,RUS,Croatia,HRV,0,0,0,5,5
2018,Serbia and Kosovo: S/RES/1244 (1999),SRB,Croatia,HRV,0,0,5,0,5
2018,Syrian Arab Rep.,SYR,Croatia,HRV,166,19,10,31,226
2018,Tunisia,TUN,Croatia,HRV,0,0,13,18,31
2018,Turkey,TUR,Croatia,HRV,0,0,0,16,16
2018,Yemen,YEM,Croatia,HRV,5,0,0,0,5
2018,Unknown ,,Croatia,HRV,0,0,0,5,5
2018,Afghanistan,AFG,Hungary,HUN,12,128,230,48,418
2018,Egypt,EGY,Hungary,HUN,0,0,5,0,5
2018,Cameroon,CMR,Hungary,HUN,5,0,0,0,5
2018,Ethiopia,ETH,Hungary,HUN,5,0,0,0,5
2018,Palestinian,PSE,Hungary,HUN,0,5,0,0,5
2018,Georgia,GEO,Hungary,HUN,0,0,5,0,5
2018,Germany,DEU,Hungary,HUN,0,0,5,0,5
2018,Iran (Islamic Rep. of),IRN,Hungary,HUN,24,10,28,5,67
2018,Iraq,IRQ,Hungary,HUN,0,74,257,28,359
2018,Morocco,MAR,Hungary,HUN,0,0,0,5,5
2018,Pakistan,PAK,Hungary,HUN,5,0,21,21,47
2018,Russian Federation,RUS,Hungary,HUN,0,0,5,0,5
2018,Serbia and Kosovo: S/RES/1244 (1999),SRB,Hungary,HUN,0,0,0,21,21
2018,Somalia,SOM,Hungary,HUN,0,5,5,0,10
2018,Syrian Arab Rep.,SYR,Hungary,HUN,0,46,16,21,83
2018,Turkey,TUR,Hungary,HUN,0,0,5,0,5
2018,Unknown ,,Hungary,HUN,10,10,0,0,20
2018,Afghanistan,AFG,Iceland,ISL,5,0,0,21,26
2018,Albania,ALB,Iceland,ISL,0,0,52,62,114
2018,Algeria,DZA,Iceland,ISL,0,0,0,5,5
2018,Azerbaijan,AZE,Iceland,ISL,0,0,5,0,5
2018,Bangladesh,BGD,Iceland,ISL,0,0,0,5,5
2018,Bosnia and Herzegovina,BIH,Iceland,ISL,0,0,5,0,5
2018,Palestinian,PSE,Iceland,ISL,0,5,0,22,27
2018,Georgia,GEO,Iceland,ISL,0,0,63,19,82
2018,Cote d'Ivoire,CIV,Iceland,ISL,0,0,0,5,5
2018,India,IND,Iceland,ISL,0,0,0,10,10
2018,Iran (Islamic Rep. of),IRN,Iceland,ISL,5,0,0,15,20
2018,Iraq,IRQ,Iceland,ISL,35,5,16,39,95
2018,Libya,LBY,Iceland,ISL,0,0,0,5,5
2018,North Macedonia,MKD,Iceland,ISL,0,0,15,0,15
2018,Rep. of Moldova,MDA,Iceland,ISL,0,0,0,5,5
2018,Mongolia,MNG,Iceland,ISL,0,0,5,0,5
2018,Morocco,MAR,Iceland,ISL,0,0,5,10,15
2018,Nigeria,NGA,Iceland,ISL,0,0,0,5,5
2018,Pakistan,PAK,Iceland,ISL,5,0,0,28,33
2018,Poland,POL,Iceland,ISL,0,0,0,5,5
2018,Russian Federation,RUS,Iceland,ISL,5,0,0,5,10
2018,El Salvador,SLV,Iceland,ISL,5,0,0,0,5
2018,Serbia and Kosovo: S/RES/1244 (1999),SRB,Iceland,ISL,0,0,14,5,19
2018,Senegal,SEN,Iceland,ISL,0,0,5,0,5
2018,Somalia,SOM,Iceland,ISL,5,0,0,23,28
2018,South Sudan,SSD,Iceland,ISL,5,0,0,0,5
2018,Syrian Arab Rep.,SYR,Iceland,ISL,5,5,0,13,23
2018,Ukraine,UKR,Iceland,ISL,0,0,12,5,17
2018,United States of America,USA,Iceland,ISL,0,0,0,5,5
2018,Venezuela (Bolivarian Republic of),VEN,Iceland,ISL,0,5,0,0,5
2018,Afghanistan,AFG,Ireland,IRL,37,64,10,20,131
2018,Albania,ALB,Ireland,IRL,0,5,372,85,462
2018,Algeria,DZA,Ireland,IRL,5,0,73,15,93
2018,Angola,AGO,Ireland,IRL,0,0,10,0,10
2018,Egypt,EGY,Ireland,IRL,5,0,13,5,23
2018,Armenia,ARM,Ireland,IRL,5,0,0,0,5
2018,Bahrain,BHR,Ireland,IRL,5,0,0,0,5
2018,Burundi,BDI,Ireland,IRL,0,0,5,0,5
2018,Bangladesh,BGD,Ireland,IRL,5,5,141,5,156
2018,Botswana,BWA,Ireland,IRL,0,0,10,5,15
2018,Brazil,BRA,Ireland,IRL,0,0,39,5,44
2018,China,CHN,Ireland,IRL,5,5,10,0,20
2018,Cameroon,CMR,Ireland,IRL,0,0,14,5,19
2018,Congo,COG,Ireland,IRL,0,0,5,0,5
2018,Dem. Rep. of the Congo,COD,Ireland,IRL,12,11,83,5,111
2018,Eritrea,ERI,Ireland,IRL,5,0,0,0,5
2018,Ethiopia,ETH,Ireland,IRL,0,0,5,0,5
2018,Gambia,GMB,Ireland,IRL,0,0,5,0,5
2018,Palestinian,PSE,Ireland,IRL,24,0,0,5,29
2018,Georgia,GEO,Ireland,IRL,5,0,240,17,262
2018,Ghana,GHA,Ireland,IRL,0,0,16,5,21
2018,India,IND,Ireland,IRL,0,0,26,14,40
2018,Iran (Islamic Rep. of),IRN,Ireland,IRL,11,0,0,5,16
2018,Iraq,IRQ,Ireland,IRL,27,5,23,13,68
2018,Jordan,JOR,Ireland,IRL,5,0,0,0,5
2018,Dem. People's Rep. of Korea,PRK,Ireland,IRL,5,0,0,0,5
2018,Kuwait,KWT,Ireland,IRL,5,0,5,0,10
2018,Libya,LBY,Ireland,IRL,24,28,0,12,64
2018,Lebanon,LBN,Ireland,IRL,0,0,5,0,5
2018,Sri Lanka,LKA,Ireland,IRL,0,5,5,0,10
2018,Rep. of Moldova,MDA,Ireland,IRL,0,0,5,0,5
2018,Mexico,MEX,Ireland,IRL,0,0,5,0,5
2018,Malawi,MWI,Ireland,IRL,5,10,61,5,81
2018,Mongolia,MNG,Ireland,IRL,0,0,5,0,5
2018,Morocco,MAR,Ireland,IRL,0,0,10,5,15
2018,Mauritius,MUS,Ireland,IRL,0,0,10,0,10
2018,Nepal,NPL,Ireland,IRL,5,0,0,5,10
2018,Nigeria,NGA,Ireland,IRL,10,0,162,57,229
2018,Pakistan,PAK,Ireland,IRL,16,15,317,41,389
2018,South Africa,ZAF,Ireland,IRL,5,0,85,10,100
2018,Russian Federation,RUS,Ireland,IRL,0,0,10,0,10
2018,Rwanda,RWA,Ireland,IRL,0,0,5,0,5
2018,Serbia and Kosovo: S/RES/1244 (1999),SRB,Ireland,IRL,0,0,20,0,20
2018,Senegal,SEN,Ireland,IRL,0,0,5,0,5
2018,Sierra Leone,SLE,Ireland,IRL,0,0,11,0,11
2018,Somalia,SOM,Ireland,IRL,13,5,5,13,36
2018,Sudan,SDN,Ireland,IRL,5,0,10,10,25
2018,Eswatini,SWZ,Ireland,IRL,0,0,5,0,5
2018,Syrian Arab Rep.,SYR,Ireland,IRL,389,0,5,13,407
2018,Tunisia,TUN,Ireland,IRL,0,0,10,0,10
2018,Uganda,UGA,Ireland,IRL,0,0,5,0,5
2018,Ukraine,UKR,Ireland,IRL,5,0,25,0,30
2018,United States of America,USA,Ireland,IRL,0,0,5,0,5
2018,Venezuela (Bolivarian Republic of),VEN,Ireland,IRL,10,5,12,0,27
2018,Yemen,YEM,Ireland,IRL,5,5,0,0,10
2018,Zimbabwe,ZWE,Ireland,IRL,23,5,129,5,162
2018,Afghanistan,AFG,Italy,ITA,307,640,131,45,1123
2018,Albania,ALB,Italy,ITA,42,115,362,0,519
2018,Algeria,DZA,Italy,ITA,5,16,109,0,130
2018,Angola,AGO,Italy,ITA,0,0,5,0,5
2018,Egypt,EGY,Italy,ITA,41,248,507,0,796
2018,Argentina,ARG,Italy,ITA,0,5,5,0,10
2018,Armenia,ARM,Italy,ITA,20,24,26,0,70
2018,Azerbaijan,AZE,Italy,ITA,5,5,10,0,20
2018,Burundi,BDI,Italy,ITA,5,5,0,0,10
2018,Benin,BEN,Italy,ITA,5,50,120,0,175
2018,Bangladesh,BGD,Italy,ITA,158,2669,7710,0,10537
2018,Burkina Faso,BFA,Italy,ITA,10,196,572,0,778
2018,Belarus,BLR,Italy,ITA,0,5,5,0,10
2018,Bolivia (Plurinational State of),BOL,Italy,ITA,0,0,5,0,5
2018,Brazil,BRA,Italy,ITA,23,27,38,0,88
2018,Bosnia and Herzegovina,BIH,Italy,ITA,0,45,35,0,80
2018,Central African Rep.,CAF,Italy,ITA,10,10,5,0,25
2018,Chad,TCD,Italy,ITA,5,29,31,0,65
2018,China,CHN,Italy,ITA,10,18,308,0,336
2018,Cameroon,CMR,Italy,ITA,223,307,728,0,1258
2018,Congo,COG,Italy,ITA,10,5,15,0,30
2018,Dem. Rep. of the Congo,COD,Italy,ITA,22,40,24,0,86
2018,Comoros,COM,Italy,ITA,0,0,5,0,5
2018,Colombia,COL,Italy,ITA,56,53,58,0,167
2018,Costa Rica,CRI,Italy,ITA,5,0,0,0,5
2018,Cuba,CUB,Italy,ITA,10,18,57,0,85
2018,Dominican Rep.,DOM,Italy,ITA,0,0,10,0,10
2018,Ecuador,ECU,Italy,ITA,0,5,5,0,10
2018,Eritrea,ERI,Italy,ITA,249,27,173,5,454
2018,Ethiopia,ETH,Italy,ITA,79,69,51,0,199
2018,Gabon,GAB,Italy,ITA,0,5,5,0,10
2018,Gambia,GMB,Italy,ITA,137,2181,4654,0,6972
2018,Palestinian,PSE,Italy,ITA,73,27,37,0,137
2018,Georgia,GEO,Italy,ITA,12,183,235,0,430
2018,Ghana,GHA,Italy,ITA,62,933,2992,0,3987
2018,Guinea-Bissau,GNB,Italy,ITA,10,152,447,0,609
2018,Guinea,GIN,Italy,ITA,129,1200,3473,5,4807
2018,Honduras,HND,Italy,ITA,19,55,10,0,84
2018,Cote d'Ivoire,CIV,Italy,ITA,235,1085,3952,5,5277
2018,India,IND,Italy,ITA,24,96,422,0,542
2018,Iran (Islamic Rep. of),IRN,Italy,ITA,84,66,65,0,215
2018,Iraq,IRQ,Italy,ITA,341,890,177,10,1418
2018,Jordan,JOR,Italy,ITA,5,0,0,0,5
2018,Kazakhstan,KAZ,Italy,ITA,5,10,5,0,20
2018,Kenya,KEN,Italy,ITA,0,5,14,0,19
2018,Kyrgyzstan,KGZ,Italy,ITA,10,54,58,0,122
2018,Kuwait,KWT,Italy,ITA,0,5,5,0,10
2018,Liberia,LBR,Italy,ITA,5,51,155,13,224
2018,Libya,LBY,Italy,ITA,90,215,78,5,388
2018,Lebanon,LBN,Italy,ITA,26,24,25,0,75
2018,Sri Lanka,LKA,Italy,ITA,15,77,114,0,206
2018,Madagascar,MDG,Italy,ITA,0,5,0,0,5
2018,Mauritania,MRT,Italy,ITA,14,5,25,0,44
2018,North Macedonia,MKD,Italy,ITA,0,13,21,0,34
2018,Rep. of Moldova,MDA,Italy,ITA,0,10,19,0,29
2018,Mali,MLI,Italy,ITA,114,1714,3812,20,5660
2018,Malaysia,MYS,Italy,ITA,0,0,5,0,5
2018,Morocco,MAR,Italy,ITA,66,281,1054,0,1401
2018,Mauritius,MUS,Italy,ITA,0,0,5,0,5
2018,Myanmar,MMR,Italy,ITA,12,0,5,0,17
2018,Nepal,NPL,Italy,ITA,5,13,74,0,92
2018,Niger,NER,Italy,ITA,14,144,259,0,417
2018,Nicaragua,NIC,Italy,ITA,5,0,5,0,10
2018,Nigeria,NGA,Italy,ITA,1335,3365,15152,16,19868
2018,Pakistan,PAK,Italy,ITA,437,2000,7320,38,9795
2018,Paraguay,PRY,Italy,ITA,0,5,0,0,5
2018,Peru,PER,Italy,ITA,12,18,43,0,73
2018,Philippines,PHL,Italy,ITA,0,36,66,0,102
2018,Russian Federation,RUS,Italy,ITA,13,51,48,0,112
2018,El Salvador,SLV,Italy,ITA,293,670,182,0,1145
2018,Saudi Arabia,SAU,Italy,ITA,5,0,5,0,10
2018,Serbia and Kosovo: S/RES/1244 (1999),SRB,Italy,ITA,13,81,181,0,275
2018,Senegal,SEN,Italy,ITA,110,1366,5063,0,6539
2018,Sierra Leone,SLE,Italy,ITA,29,164,504,0,697
2018,Somalia,SOM,Italy,ITA,622,616,140,0,1378
2018,Sudan,SDN,Italy,ITA,97,70,138,5,310
2018,South Sudan,SSD,Italy,ITA,5,0,5,0,10
2018,Syrian Arab Rep.,SYR,Italy,ITA,367,5,35,0,407
2018,Tajikistan,TJK,Italy,ITA,5,0,0,0,5
2018,Togo,TGO,Italy,ITA,13,107,379,0,499
2018,Tunisia,TUN,Italy,ITA,15,57,650,0,722
2018,Turkey,TUR,Italy,ITA,85,130,61,5,281
2018,Uganda,UGA,Italy,ITA,5,0,0,0,5
2018,Ukraine,UKR,Italy,ITA,41,874,1034,0,1949
2018,Uzbekistan,UZB,Italy,ITA,10,0,0,0,10
2018,Venezuela (Bolivarian Republic of),VEN,Italy,ITA,112,274,22,0,408
2018,Yemen,YEM,Italy,ITA,13,10,0,0,23
2018,Zimbabwe,ZWE,Italy,ITA,5,0,5,0,10
2018,Unknown ,,Italy,ITA,23,113,159,0,295
2018,Afghanistan,AFG,Japan,JPN,5,0,0,0,5
2018,Cambodia,KHM,Japan,JPN,0,0,273,0,273
2018,China,CHN,Japan,JPN,5,0,244,140,389
2018,Dem. Rep. of the Congo,COD,Japan,JPN,13,0,0,0,13
2018,Ethiopia,ETH,Japan,JPN,5,0,0,0,5
2018,India,IND,Japan,JPN,0,0,214,144,358
2018,Indonesia,IDN,Japan,JPN,0,0,1480,210,1690
2018,Sri Lanka,LKA,Japan,JPN,0,0,1080,194,1274
2018,Myanmar,MMR,Japan,JPN,0,0,325,140,465
2018,Nepal,NPL,Japan,JPN,0,0,1759,411,2170
2018,Pakistan,PAK,Japan,JPN,0,0,0,108,108
2018,Philippines,PHL,Japan,JPN,0,0,2664,902,3566
2018,Viet Nam,VNM,Japan,JPN,0,0,981,207,1188
2018,Syrian Arab Rep.,SYR,Japan,JPN,5,0,0,0,5
2018,Turkey,TUR,Japan,JPN,0,0,769,150,919
2018,Unknown ,,Japan,JPN,5,27,725,317,1074
2018,Afghanistan,AFG,Kenya,KEN,0,0,0,5,5
2018,Angola,AGO,Kenya,KEN,0,0,0,5,5
2018,Burundi,BDI,Kenya,KEN,0,3071,0,1099,4170
2018,Congo,COG,Kenya,KEN,0,10,0,36,46
2018,Dem. Rep. of the Congo,COD,Kenya,KEN,0,10739,0,787,11526
2018,Eritrea,ERI,Kenya,KEN,0,23,0,26,49
2018,Ethiopia,ETH,Kenya,KEN,5,1520,0,5019,6544
2018,Cote d'Ivoire,CIV,Kenya,KEN,0,0,0,5,5
2018,Nigeria,NGA,Kenya,KEN,0,5,0,0,5
2018,Pakistan,PAK,Kenya,KEN,0,0,0,5,5
2018,Rwanda,RWA,Kenya,KEN,0,59,0,142,201
2018,Somalia,SOM,Kenya,KEN,0,11,0,469,480
2018,Sudan,SDN,Kenya,KEN,0,856,0,115,971
2018,South Sudan,SSD,Kenya,KEN,0,0,0,37,37
2018,United Rep. of Tanzania,TZA,Kenya,KEN,0,0,0,5,5
2018,Uganda,UGA,Kenya,KEN,0,277,0,353,630
2018,Yemen,YEM,Kenya,KEN,0,0,0,10,10
2018,Zimbabwe,ZWE,Kenya,KEN,0,5,0,5,10
2018,Afghanistan,AFG,Kyrgyzstan,KGZ,5,0,44,5,54
2018,Iraq,IRQ,Kyrgyzstan,KGZ,5,0,0,0,5
2018,Syrian Arab Rep.,SYR,Kyrgyzstan,KGZ,11,0,0,0,11
2018,Tajikistan,TJK,Kyrgyzstan,KGZ,5,0,0,0,5
2018,Ukraine,UKR,Kyrgyzstan,KGZ,10,0,0,0,10
2018,Syrian Arab Rep.,SYR,Liberia,LBR,5,0,0,0,5
2018,Dem. Rep. of the Congo,COD,Lesotho,LSO,14,0,0,0,14
2018,Afghanistan,AFG,Liechtenstein,LIE,0,0,0,5,5
2018,Belarus,BLR,Liechtenstein,LIE,0,0,5,14,19
2018,Georgia,GEO,Liechtenstein,LIE,0,0,0,5,5
2018,Morocco,MAR,Liechtenstein,LIE,0,0,0,5,5
2018,Serbia and Kosovo: S/RES/1244 (1999),SRB,Liechtenstein,LIE,0,0,17,0,17
2018,Somalia,SOM,Liechtenstein,LIE,0,0,0,5,5
2018,Ukraine,UKR,Liechtenstein,LIE,0,0,0,5,5
2018,Afghanistan,AFG,Lithuania,LTU,5,5,0,0,10
2018,Armenia,ARM,Lithuania,LTU,0,0,10,12,22
2018,Azerbaijan,AZE,Lithuania,LTU,0,0,10,0,10
2018,Belarus,BLR,Lithuania,LTU,0,0,24,10,34
2018,Iran (Islamic Rep. of),IRN,Lithuania,LTU,0,0,0,5,5
2018,Iraq,IRQ,Lithuania,LTU,0,0,5,10,15
2018,Kyrgyzstan,KGZ,Lithuania,LTU,0,0,10,5,15
2018,Sri Lanka,LKA,Lithuania,LTU,0,0,5,10,15
2018,Pakistan,PAK,Lithuania,LTU,0,0,5,0,5
2018,Russian Federation,RUS,Lithuania,LTU,18,5,19,31,73
2018,Syrian Arab Rep.,SYR,Lithuania,LTU,73,0,0,0,73
2018,Tajikistan,TJK,Lithuania,LTU,28,0,23,30,81
2018,Turkey,TUR,Lithuania,LTU,13,0,0,0,13
2018,Ukraine,UKR,Lithuania,LTU,0,0,18,10,28
2018,Afghanistan,AFG,Luxembourg,LUX,45,35,5,0,85
2018,Albania,ALB,Luxembourg,LUX,0,0,40,0,40
2018,Algeria,DZA,Luxembourg,LUX,0,0,20,0,20
2018,Egypt,EGY,Luxembourg,LUX,0,0,5,0,5
2018,Armenia,ARM,Luxembourg,LUX,0,0,5,0,5
2018,Azerbaijan,AZE,Luxembourg,LUX,0,0,5,0,5
2018,Benin,BEN,Luxembourg,LUX,0,0,5,0,5
2018,Belarus,BLR,Luxembourg,LUX,0,0,5,0,5
2018,Bosnia and Herzegovina,BIH,Luxembourg,LUX,0,0,5,0,5
2018,Dem. Rep. of the Congo,COD,Luxembourg,LUX,5,0,5,0,10
2018,Eritrea,ERI,Luxembourg,LUX,305,5,10,0,320
2018,Ethiopia,ETH,Luxembourg,LUX,20,0,10,0,30
2018,Gabon,GAB,Luxembourg,LUX,0,0,5,0,5
2018,Georgia,GEO,Luxembourg,LUX,0,0,70,0,70
2018,Guinea,GIN,Luxembourg,LUX,0,0,5,0,5
2018,Cote d'Ivoire,CIV,Luxembourg,LUX,0,0,5,0,5
2018,India,IND,Luxembourg,LUX,0,0,5,0,5
2018,Iran (Islamic Rep. of),IRN,Luxembourg,LUX,60,0,0,0,60
2018,Iraq,IRQ,Luxembourg,LUX,140,5,20,0,165
2018,Mali,MLI,Luxembourg,LUX,0,0,5,0,5
2018,Morocco,MAR,Luxembourg,LUX,0,0,15,0,15
2018,Nigeria,NGA,Luxembourg,LUX,0,0,10,0,10
2018,Afghanistan,AFG,Latvia,LVA,5,0,5,5,15
2018,Egypt,EGY,Latvia,LVA,0,0,5,0,5
2018,Azerbaijan,AZE,Latvia,LVA,0,0,11,0,11
2018,Eritrea,ERI,Latvia,LVA,0,5,0,0,5
2018,Georgia,GEO,Latvia,LVA,0,0,5,5,10
2018,India,IND,Latvia,LVA,0,0,0,5,5
2018,Iraq,IRQ,Latvia,LVA,0,0,12,5,17
2018,Kazakhstan,KAZ,Latvia,LVA,0,0,11,0,11
2018,Russian Federation,RUS,Latvia,LVA,12,0,18,14,44
2018,Viet Nam,VNM,Latvia,LVA,0,0,5,12,17
2018,Syrian Arab Rep.,SYR,Latvia,LVA,0,15,0,0,15
2018,Tajikistan,TJK,Latvia,LVA,0,0,5,5,10
2018,Turkey,TUR,Latvia,LVA,5,0,5,0,10
2018,Uzbekistan,UZB,Latvia,LVA,0,0,5,0,5
2018,India,IND,"China, Macao SAR",MAC,0,0,0,5,5
2018,Armenia,ARM,Rep. of Moldova,MDA,0,0,5,5,10
2018,Cote d'Ivoire,CIV,Rep. of Moldova,MDA,0,0,5,0,5
2018,Russian Federation,RUS,Rep. of Moldova,MDA,0,0,5,5,10
2018,Syrian Arab Rep.,SYR,Rep. of Moldova,MDA,0,15,0,0,15
2018,Turkey,TUR,Rep. of Moldova,MDA,10,0,17,0,27
2018,Ukraine,UKR,Rep. of Moldova,MDA,0,0,5,5,10
2018,Argentina,ARG,Mexico,MEX,0,0,5,0,5
2018,Brazil,BRA,Mexico,MEX,0,0,0,5,5
2018,Cambodia,KHM,Mexico,MEX,0,0,0,39,39
2018,Congo,COG,Mexico,MEX,0,0,0,5,5
2018,Colombia,COL,Mexico,MEX,13,0,16,46,75
2018,Cuba,CUB,Mexico,MEX,5,0,5,229,239
2018,Dominican Rep.,DOM,Mexico,MEX,0,0,0,5,5
2018,Ecuador,ECU,Mexico,MEX,0,0,0,10,10
2018,Ghana,GHA,Mexico,MEX,0,0,0,5,5
2018,Guatemala,GTM,Mexico,MEX,59,65,111,312,547
2018,Haiti,HTI,Mexico,MEX,0,0,10,57,67
2018,Honduras,HND,Mexico,MEX,506,660,717,2605,4488
2018,India,IND,Mexico,MEX,0,0,0,5,5
2018,Nicaragua,NIC,Mexico,MEX,26,45,12,104,187
2018,Nigeria,NGA,Mexico,MEX,0,0,0,5,5
2018,Panama,PAN,Mexico,MEX,5,0,0,0,5
2018,Portugal,PRT,Mexico,MEX,5,0,0,0,5
2018,Russian Federation,RUS,Mexico,MEX,5,0,0,0,5
2018,El Salvador,SLV,Mexico,MEX,557,674,391,1172,2794
2018,Somalia,SOM,Mexico,MEX,0,0,0,5,5
2018,Uganda,UGA,Mexico,MEX,0,0,0,5,5
2018,United States of America,USA,Mexico,MEX,0,0,5,5,10
2018,Uzbekistan,UZB,Mexico,MEX,0,0,0,5,5
2018,Venezuela (Bolivarian Republic of),VEN,Mexico,MEX,3248,14,41,442,3745
2018,Yemen,YEM,Mexico,MEX,10,0,0,0,10
2018,Burkina Faso,BFA,Mali,MLI,8457,0,0,0,8457
2018,Central African Rep.,CAF,Mali,MLI,0,0,0,91,91
2018,Niger,NER,Mali,MLI,1024,0,0,0,1024
2018,Burundi,BDI,Malawi,MWI,824,0,0,35,859
2018,Dem. Rep. of the Congo,COD,Malawi,MWI,3930,0,0,118,4048
2018,Cote d'Ivoire,CIV,Malawi,MWI,5,0,0,0,5
2018,Mozambique,MOZ,Malawi,MWI,0,0,0,3364,3364
2018,Rwanda,RWA,Malawi,MWI,27,0,0,13,40
2018,Somalia,SOM,Malawi,MWI,10,0,0,0,10
2018,Dem. Rep. of the Congo,COD,Mozambique,MOZ,0,0,0,171,171
2018,Kenya,KEN,Mozambique,MOZ,0,0,0,5,5
2018,Afghanistan,AFG,Malta,MLT,0,0,5,0,5
2018,Egypt,EGY,Malta,MLT,0,0,11,5,16
2018,Bangladesh,BGD,Malta,MLT,0,0,70,16,86
2018,Chad,TCD,Malta,MLT,0,0,5,0,5
2018,China,CHN,Malta,MLT,0,0,0,5,5
2018,Colombia,COL,Malta,MLT,0,0,5,0,5
2018,Eritrea,ERI,Malta,MLT,5,77,5,45,132
2018,Ethiopia,ETH,Malta,MLT,5,5,0,26,36
2018,Gambia,GMB,Malta,MLT,0,0,0,15,15
2018,Palestinian,PSE,Malta,MLT,0,0,5,5,10
2018,Georgia,GEO,Malta,MLT,0,0,11,0,11
2018,Ghana,GHA,Malta,MLT,0,5,0,5,10
2018,Guinea,GIN,Malta,MLT,0,0,0,5,5
2018,Cote d'Ivoire,CIV,Malta,MLT,0,0,5,5,10
2018,Iran (Islamic Rep. of),IRN,Malta,MLT,0,0,0,5,5
2018,Iraq,IRQ,Malta,MLT,5,0,10,30,45
2018,Libya,LBY,Malta,MLT,20,207,5,104,336
2018,North Macedonia,MKD,Malta,MLT,0,0,5,0,5
2018,Mali,MLI,Malta,MLT,0,0,0,5,5
2018,Mongolia,MNG,Malta,MLT,0,0,0,5,5
2018,Morocco,MAR,Malta,MLT,0,0,11,0,11
2018,Nigeria,NGA,Malta,MLT,5,13,14,5,37
2018,Pakistan,PAK,Malta,MLT,5,0,14,11,30
2018,Russian Federation,RUS,Malta,MLT,5,0,0,0,5
2018,Senegal,SEN,Malta,MLT,0,0,0,5,5
2018,Sierra Leone,SLE,Malta,MLT,0,0,0,5,5
2018,Somalia,SOM,Malta,MLT,5,37,5,449,496
2018,Sudan,SDN,Malta,MLT,5,0,5,10,20
2018,Syrian Arab Rep.,SYR,Malta,MLT,57,150,0,144,351
2018,Turkey,TUR,Malta,MLT,0,0,0,5,5
2018,Ukraine,UKR,Malta,MLT,0,10,32,20,62
2018,Venezuela (Bolivarian Republic of),VEN,Malta,MLT,0,0,24,5,29
2018,Burundi,BDI,Namibia,NAM,5,0,0,96,101
2018,Dem. Rep. of the Congo,COD,Namibia,NAM,354,0,0,637,991
2018,Nigeria,NGA,Namibia,NAM,0,0,0,5,5
2018,Rwanda,RWA,Namibia,NAM,0,0,0,15,15
2018,Somalia,SOM,Namibia,NAM,0,0,0,5,5
2018,Sudan,SDN,Namibia,NAM,5,0,0,0,5
2018,United Rep. of Tanzania,TZA,Namibia,NAM,0,0,0,5,5
2018,Uganda,UGA,Namibia,NAM,0,0,0,5,5
2018,Zimbabwe,ZWE,Namibia,NAM,0,0,0,40,40
2018,Afghanistan,AFG,Netherlands,NLD,63,15,196,0,274
2018,Albania,ALB,Netherlands,NLD,0,0,495,46,541
2018,Algeria,DZA,Netherlands,NLD,0,0,315,22,337
2018,Angola,AGO,Netherlands,NLD,0,0,5,0,5
2018,Egypt,EGY,Netherlands,NLD,26,0,61,0,87
2018,Armenia,ARM,Netherlands,NLD,0,0,5,5,10
2018,Azerbaijan,AZE,Netherlands,NLD,0,0,18,80,98
2018,Bahrain,BHR,Netherlands,NLD,5,0,0,0,5
2018,Burundi,BDI,Netherlands,NLD,0,0,13,0,13
2018,Belarus,BLR,Netherlands,NLD,0,0,5,0,5
2018,Bosnia and Herzegovina,BIH,Netherlands,NLD,0,0,52,0,52
2018,China,CHN,Netherlands,NLD,52,0,24,0,76
2018,Cameroon,CMR,Netherlands,NLD,0,0,12,0,12
2018,Congo,COG,Netherlands,NLD,0,0,17,0,17
2018,Colombia,COL,Netherlands,NLD,0,0,14,0,14
2018,Cuba,CUB,Netherlands,NLD,5,0,286,31,322
2018,Eritrea,ERI,Netherlands,NLD,255,12,199,5,471
2018,Ethiopia,ETH,Netherlands,NLD,5,0,29,0,34
2018,Gambia,GMB,Netherlands,NLD,0,0,25,5,30
2018,Palestinian,PSE,Netherlands,NLD,0,0,10,0,10
2018,Georgia,GEO,Netherlands,NLD,0,0,334,5,339
2018,Ghana,GHA,Netherlands,NLD,0,0,11,0,11
2018,Guinea,GIN,Netherlands,NLD,11,0,43,0,54
2018,Cote d'Ivoire,CIV,Netherlands,NLD,0,0,5,0,5
2018,India,IND,Netherlands,NLD,0,0,28,5,33
2018,Iran (Islamic Rep. of),IRN,Netherlands,NLD,223,53,233,22,531
2018,Iraq,IRQ,Netherlands,NLD,65,13,196,31,305
2018,Jamaica,JAM,Netherlands,NLD,10,0,0,0,10
2018,Jordan,JOR,Netherlands,NLD,0,0,16,0,16
2018,Liberia,LBR,Netherlands,NLD,0,0,5,0,5
2018,Libya,LBY,Netherlands,NLD,13,0,80,10,103
2018,Lebanon,LBN,Netherlands,NLD,5,0,10,0,15
2018,Sri Lanka,LKA,Netherlands,NLD,0,0,10,0,10
2018,North Macedonia,MKD,Netherlands,NLD,0,0,94,0,94
2018,Rep. of Moldova,MDA,Netherlands,NLD,0,0,200,68,268
2018,Mali,MLI,Netherlands,NLD,0,0,5,0,5
2018,Mongolia,MNG,Netherlands,NLD,0,0,5,0,5
2018,Morocco,MAR,Netherlands,NLD,0,0,292,26,318
2018,Myanmar,MMR,Netherlands,NLD,0,0,12,0,12
2018,Nigeria,NGA,Netherlands,NLD,10,0,66,5,81
2018,Pakistan,PAK,Netherlands,NLD,52,0,28,0,80
2018,Russian Federation,RUS,Netherlands,NLD,40,0,34,10,84
2018,Serbia and Kosovo: S/RES/1244 (1999),SRB,Netherlands,NLD,0,0,154,0,154
2018,Senegal,SEN,Netherlands,NLD,0,0,5,0,5
2018,Sierra Leone,SLE,Netherlands,NLD,0,0,5,0,5
2018,Somalia,SOM,Netherlands,NLD,10,0,39,0,49
2018,Viet Nam,VNM,Netherlands,NLD,0,0,30,0,30
2018,Sudan,SDN,Netherlands,NLD,27,0,42,5,74
2018,Suriname,SUR,Netherlands,NLD,0,0,5,0,5
2018,Syrian Arab Rep.,SYR,Netherlands,NLD,1240,10,368,15,1633
2018,Tajikistan,TJK,Netherlands,NLD,0,0,0,63,63
2018,Togo,TGO,Netherlands,NLD,0,0,5,0,5
2018,Trinidad and Tobago,TTO,Netherlands,NLD,19,0,10,0,29
2018,Tunisia,TUN,Netherlands,NLD,0,0,55,0,55
2018,Turkey,TUR,Netherlands,NLD,202,137,106,20,465
2018,Uganda,UGA,Netherlands,NLD,23,0,25,5,53
2018,Ukraine,UKR,Netherlands,NLD,0,0,202,16,218
2018,United States of America,USA,Netherlands,NLD,0,5,0,0,5
2018,Uzbekistan,UZB,Netherlands,NLD,0,0,5,0,5
2018,Venezuela (Bolivarian Republic of),VEN,Netherlands,NLD,0,0,70,0,70
2018,Yemen,YEM,Netherlands,NLD,128,0,10,0,138
2018,Stateless,XXA,Netherlands,NLD,39,0,25,0,64
2018,Unknown ,,Netherlands,NLD,388,54,562,248,1252
2018,Central African Rep.,CAF,Nigeria,NGA,36,0,0,0,36
2018,Cameroon,CMR,Nigeria,NGA,64,0,0,0,64
2018,Dem. Rep. of the Congo,COD,Nigeria,NGA,14,0,36,0,50
2018,Eritrea,ERI,Nigeria,NGA,5,0,0,0,5
2018,Mali,MLI,Nigeria,NGA,0,0,5,0,5
2018,Niger,NER,Nigeria,NGA,5,0,0,0,5
2018,Syrian Arab Rep.,SYR,Nigeria,NGA,73,0,0,0,73
2018,Turkey,TUR,Nigeria,NGA,23,0,0,0,23
2018,Afghanistan,AFG,Norway,NOR,25,15,73,19,132
2018,Albania,ALB,Norway,NOR,0,0,32,11,43
2018,Algeria,DZA,Norway,NOR,0,0,0,10,10
2018,Angola,AGO,Norway,NOR,0,0,0,25,25
2018,Egypt,EGY,Norway,NOR,0,0,5,5,10
2018,Azerbaijan,AZE,Norway,NOR,0,0,0,5,5
2018,Bangladesh,BGD,Norway,NOR,0,0,5,5,10
2018,Belarus,BLR,Norway,NOR,0,0,0,5,5
2018,Bosnia and Herzegovina,BIH,Norway,NOR,0,0,5,0,5
2018,China,CHN,Norway,NOR,5,0,5,5,15
2018,Cameroon,CMR,Norway,NOR,0,0,5,5,10
2018,Dem. Rep. of the Congo,COD,Norway,NOR,5,0,0,10,15
2018,Cuba,CUB,Norway,NOR,0,0,0,5,5
2018,Eritrea,ERI,Norway,NOR,438,24,22,40,524
2018,Ethiopia,ETH,Norway,NOR,21,0,60,22,103
2018,Georgia,GEO,Norway,NOR,0,0,20,10,30
2018,Guinea,GIN,Norway,NOR,0,0,5,11,16
2018,Cote d'Ivoire,CIV,Norway,NOR,0,0,0,5,5
2018,India,IND,Norway,NOR,0,0,5,5,10
2018,Iran (Islamic Rep. of),IRN,Norway,NOR,38,0,65,36,139
2018,Iraq,IRQ,Norway,NOR,20,0,34,46,100
2018,Kazakhstan,KAZ,Norway,NOR,0,0,0,5,5
2018,Liberia,LBR,Norway,NOR,0,0,0,5,5
2018,Libya,LBY,Norway,NOR,0,0,0,5,5
2018,Lebanon,LBN,Norway,NOR,0,0,0,5,5
2018,Sri Lanka,LKA,Norway,NOR,0,0,5,0,5
2018,North Macedonia,MKD,Norway,NOR,0,0,10,0,10
2018,Mongolia,MNG,Norway,NOR,0,0,5,0,5
2018,Morocco,MAR,Norway,NOR,0,0,5,16,21
2018,Myanmar,MMR,Norway,NOR,0,0,0,5,5
2018,Nigeria,NGA,Norway,NOR,0,0,15,13,28
2018,Pakistan,PAK,Norway,NOR,0,0,10,17,27
2018,Philippines,PHL,Norway,NOR,0,0,5,0,5
2018,Romania,ROU,Norway,NOR,0,0,5,0,5
2018,Russian Federation,RUS,Norway,NOR,5,0,10,14,29
2018,Saudi Arabia,SAU,Norway,NOR,5,0,0,5,10
2018,Serbia and Kosovo: S/RES/1244 (1999),SRB,Norway,NOR,0,0,19,11,30
2018,Senegal,SEN,Norway,NOR,0,0,0,5,5
2018,Somalia,SOM,Norway,NOR,16,0,36,10,62
2018,Sudan,SDN,Norway,NOR,10,0,5,13,28
2018,Syrian Arab Rep.,SYR,Norway,NOR,567,0,0,84,651
2018,Tunisia,TUN,Norway,NOR,0,0,0,5,5
2018,Turkey,TUR,Norway,NOR,71,0,10,37,118
2018,Uganda,UGA,Norway,NOR,5,0,5,0,10
2018,Ukraine,UKR,Norway,NOR,0,0,28,10,38
2018,United States of America,USA,Norway,NOR,0,0,5,0,5
2018,Uzbekistan,UZB,Norway,NOR,0,0,5,5,10
2018,Venezuela (Bolivarian Republic of),VEN,Norway,NOR,0,0,5,0,5
2018,Yemen,YEM,Norway,NOR,5,10,0,0,15
2018,Zimbabwe,ZWE,Norway,NOR,0,0,0,10,10
2018,Stateless,XXA,Norway,NOR,53,0,18,20,91
2018,Afghanistan,AFG,New Zealand,NZL,10,0,13,0,23
2018,Bangladesh,BGD,New Zealand,NZL,5,0,15,0,20
2018,China,CHN,New Zealand,NZL,49,0,39,5,93
2018,Colombia,COL,New Zealand,NZL,0,0,5,0,5
2018,Ethiopia,ETH,New Zealand,NZL,0,0,5,0,5
2018,Fiji,FJI,New Zealand,NZL,0,0,5,0,5
2018,India,IND,New Zealand,NZL,5,0,29,10,44
2018,Iran (Islamic Rep. of),IRN,New Zealand,NZL,5,0,12,0,17
2018,Iraq,IRQ,New Zealand,NZL,0,0,5,0,5
2018,Jordan,JOR,New Zealand,NZL,0,0,10,0,10
2018,Sri Lanka,LKA,New Zealand,NZL,0,0,22,5,27
2018,Malaysia,MYS,New Zealand,NZL,0,0,5,10,15
2018,Myanmar,MMR,New Zealand,NZL,0,0,10,0,10
2018,Nigeria,NGA,New Zealand,NZL,0,0,10,0,10
2018,Pakistan,PAK,New Zealand,NZL,5,0,20,0,25
2018,Philippines,PHL,New Zealand,NZL,0,0,10,0,10
2018,Russian Federation,RUS,New Zealand,NZL,14,0,0,0,14
2018,Saudi Arabia,SAU,New Zealand,NZL,5,0,10,0,15
2018,Singapore,SGP,New Zealand,NZL,0,0,5,0,5
2018,Syrian Arab Rep.,SYR,New Zealand,NZL,5,0,0,0,5
2018,Turkey,TUR,New Zealand,NZL,13,0,10,0,23
2018,Yemen,YEM,New Zealand,NZL,5,0,0,0,5
2018,Angola,AGO,Panama,PAN,0,0,0,5,5
2018,Colombia,COL,Panama,PAN,31,0,5,428,464
2018,Cuba,CUB,Panama,PAN,0,0,0,424,424
2018,Dominican Rep.,DOM,Panama,PAN,0,0,0,13,13
2018,Ecuador,ECU,Panama,PAN,0,0,0,5,5
2018,Haiti,HTI,Panama,PAN,0,0,0,5,5
2018,Honduras,HND,Panama,PAN,0,0,0,18,18
2018,Jamaica,JAM,Panama,PAN,0,0,0,5,5
2018,Nicaragua,NIC,Panama,PAN,0,0,0,213,213
2018,Peru,PER,Panama,PAN,0,0,0,5,5
2018,El Salvador,SLV,Panama,PAN,40,0,0,78,118
2018,Venezuela (Bolivarian Republic of),VEN,Panama,PAN,13,0,0,3155,3168
2018,Bangladesh,BGD,Peru,PER,0,0,5,5,10
2018,Bolivia (Plurinational State of),BOL,Peru,PER,5,0,0,0,5
2018,Brazil,BRA,Peru,PER,5,0,0,0,5
2018,Cameroon,CMR,Peru,PER,10,0,0,0,10
2018,Colombia,COL,Peru,PER,10,0,5,67,82
2018,Cuba,CUB,Peru,PER,70,0,96,24,190
2018,Dominican Rep.,DOM,Peru,PER,5,0,0,5,10
2018,Ghana,GHA,Peru,PER,0,0,5,5,10
2018,Haiti,HTI,Peru,PER,17,0,0,5,22
2018,Romania,ROU,Peru,PER,0,0,5,0,5
2018,El Salvador,SLV,Peru,PER,0,0,5,0,5
2018,Senegal,SEN,Peru,PER,0,0,0,5,5
2018,Syrian Arab Rep.,SYR,Peru,PER,5,0,0,0,5
2018,Turkey,TUR,Peru,PER,39,0,0,0,39
2018,Venezuela (Bolivarian Republic of),VEN,Peru,PER,390,0,191,1430,2011
2018,Iran (Islamic Rep. of),IRN,Papua New Guinea,PNG,5,0,5,0,10
2018,Afghanistan,AFG,Poland,POL,10,5,5,20,40
2018,Algeria,DZA,Poland,POL,0,0,5,10,15
2018,Egypt,EGY,Poland,POL,10,0,5,10,25
2018,Armenia,ARM,Poland,POL,0,0,52,36,88
2018,Azerbaijan,AZE,Poland,POL,0,5,27,10,42
2018,Bangladesh,BGD,Poland,POL,0,0,20,5,25
2018,Belarus,BLR,Poland,POL,5,5,20,10,40
2018,Bulgaria,BGR,Poland,POL,0,0,0,5,5
2018,China,CHN,Poland,POL,0,0,5,0,5
2018,Cuba,CUB,Poland,POL,0,0,5,0,5
2018,Ethiopia,ETH,Poland,POL,0,0,5,0,5
2018,Palestinian,PSE,Poland,POL,0,0,0,5,5
2018,Georgia,GEO,Poland,POL,0,0,49,12,61
2018,Guinea,GIN,Poland,POL,0,0,5,0,5
2018,India,IND,Poland,POL,0,0,12,5,17
2018,Iran (Islamic Rep. of),IRN,Poland,POL,10,0,12,5,27
2018,Iraq,IRQ,Poland,POL,19,10,11,23,63
2018,Kazakhstan,KAZ,Poland,POL,0,0,10,5,15
2018,Kyrgyzstan,KGZ,Poland,POL,0,0,43,5,48
2018,Libya,LBY,Poland,POL,0,10,0,0,10
2018,Lebanon,LBN,Poland,POL,0,0,5,0,5
2018,Rep. of Moldova,MDA,Poland,POL,0,0,5,0,5
2018,Nigeria,NGA,Poland,POL,0,0,10,5,15
2018,Pakistan,PAK,Poland,POL,14,0,26,14,54
2018,Russian Federation,RUS,Poland,POL,10,61,1211,1587,2869
2018,Viet Nam,VNM,Poland,POL,0,0,17,10,27
2018,Syrian Arab Rep.,SYR,Poland,POL,16,5,0,0,21
2018,Tajikistan,TJK,Poland,POL,10,14,77,34,135
2018,Turkmenistan,TKM,Poland,POL,10,0,0,0,10
2018,Turkey,TUR,Poland,POL,26,0,20,15,61
2018,Ukraine,UKR,Poland,POL,11,74,443,89,617
2018,Uzbekistan,UZB,Poland,POL,0,0,0,5,5
2018,Yemen,YEM,Poland,POL,0,5,0,0,5
2018,Stateless,XXA,Poland,POL,5,5,0,5,15
2018,Unknown ,,Poland,POL,0,0,5,0,5
2018,Afghanistan,AFG,Portugal,PRT,0,0,0,5,5
2018,Albania,ALB,Portugal,PRT,0,0,0,10,10
2018,Algeria,DZA,Portugal,PRT,0,0,5,0,5
2018,Angola,AGO,Portugal,PRT,0,0,65,150,215
2018,Armenia,ARM,Portugal,PRT,0,0,0,5,5
2018,Azerbaijan,AZE,Portugal,PRT,0,0,0,5,5
2018,Bangladesh,BGD,Portugal,PRT,0,0,5,0,5
2018,Burkina Faso,BFA,Portugal,PRT,0,0,0,5,5
2018,Brazil,BRA,Portugal,PRT,0,0,15,5,20
2018,China,CHN,Portugal,PRT,0,0,0,25,25
2018,Cameroon,CMR,Portugal,PRT,0,0,15,10,25
2018,Congo,COG,Portugal,PRT,0,0,5,5,10
2018,Dem. Rep. of the Congo,COD,Portugal,PRT,0,5,100,25,130
2018,Comoros,COM,Portugal,PRT,0,0,25,0,25
2018,Colombia,COL,Portugal,PRT,0,5,10,5,20
2018,Eritrea,ERI,Portugal,PRT,55,0,0,0,55
2018,Ethiopia,ETH,Portugal,PRT,5,0,0,0,5
2018,Gambia,GMB,Portugal,PRT,0,0,0,15,15
2018,Georgia,GEO,Portugal,PRT,0,0,0,5,5
2018,Ghana,GHA,Portugal,PRT,0,0,5,5,10
2018,Guinea-Bissau,GNB,Portugal,PRT,0,0,10,35,45
2018,Guinea,GIN,Portugal,PRT,0,0,20,60,80
2018,Haiti,HTI,Portugal,PRT,0,0,5,0,5
2018,Cote d'Ivoire,CIV,Portugal,PRT,0,0,5,15,20
2018,Iran (Islamic Rep. of),IRN,Portugal,PRT,0,0,0,15,15
2018,Iraq,IRQ,Portugal,PRT,20,85,5,0,110
2018,Kenya,KEN,Portugal,PRT,0,0,0,5,5
2018,Sri Lanka,LKA,Portugal,PRT,0,0,0,10,10
2018,Mauritania,MRT,Portugal,PRT,0,0,5,0,5
2018,Mali,MLI,Portugal,PRT,0,0,5,5,10
2018,Morocco,MAR,Portugal,PRT,0,0,10,20,30
2018,Nigeria,NGA,Portugal,PRT,0,0,10,10,20
2018,Pakistan,PAK,Portugal,PRT,0,5,20,20,45
2018,Russian Federation,RUS,Portugal,PRT,0,0,5,10,15
2018,Senegal,SEN,Portugal,PRT,0,0,10,10,20
2018,Sierra Leone,SLE,Portugal,PRT,0,0,5,15,20
2018,Somalia,SOM,Portugal,PRT,5,0,0,30,35
2018,Sudan,SDN,Portugal,PRT,20,0,0,5,25
2018,Syrian Arab Rep.,SYR,Portugal,PRT,65,230,0,0,295
2018,United Rep. of Tanzania,TZA,Portugal,PRT,0,0,0,5,5
2018,Tajikistan,TJK,Portugal,PRT,0,0,0,5,5
2018,Togo,TGO,Portugal,PRT,0,0,10,0,10
2018,Turkey,TUR,Portugal,PRT,0,0,0,25,25
2018,Ukraine,UKR,Portugal,PRT,0,50,20,35,105
2018,Venezuela (Bolivarian Republic of),VEN,Portugal,PRT,0,0,10,30,40
2018,Yemen,YEM,Portugal,PRT,0,5,0,0,5
2018,Zimbabwe,ZWE,Portugal,PRT,0,0,0,5,5
2018,Stateless,XXA,Portugal,PRT,0,10,0,0,10
2018,Afghanistan,AFG,Romania,ROU,10,5,55,44,114
2018,Algeria,DZA,Romania,ROU,0,0,0,5,5
2018,Egypt,EGY,Romania,ROU,0,0,5,0,5
2018,Bangladesh,BGD,Romania,ROU,0,0,70,16,86
2018,China,CHN,Romania,ROU,0,0,5,0,5
2018,Cameroon,CMR,Romania,ROU,0,0,10,0,10
2018,Congo,COG,Romania,ROU,0,0,5,0,5
2018,Dem. Rep. of the Congo,COD,Romania,ROU,0,0,10,0,10
2018,Palestinian,PSE,Romania,ROU,10,0,12,18,40
2018,Guinea,GIN,Romania,ROU,0,0,5,0,5
2018,India,IND,Romania,ROU,0,0,47,11,58
2018,Iran (Islamic Rep. of),IRN,Romania,ROU,21,0,71,134,226
2018,Iraq,IRQ,Romania,ROU,93,56,313,982,1444
2018,Lebanon,LBN,Romania,ROU,0,0,0,5,5
2018,Sri Lanka,LKA,Romania,ROU,0,0,26,0,26
2018,Rep. of Moldova,MDA,Romania,ROU,0,0,13,10,23
2018,Morocco,MAR,Romania,ROU,0,0,5,0,5
2018,Nigeria,NGA,Romania,ROU,0,0,15,0,15
2018,Pakistan,PAK,Romania,ROU,5,5,44,10,64
2018,Philippines,PHL,Romania,ROU,0,0,5,0,5
2018,Russian Federation,RUS,Romania,ROU,0,0,5,0,5
2018,Serbia and Kosovo: S/RES/1244 (1999),SRB,Romania,ROU,0,0,12,5,17
2018,Somalia,SOM,Romania,ROU,20,5,5,0,30
2018,Syrian Arab Rep.,SYR,Romania,ROU,117,209,5,62,393
2018,Tunisia,TUN,Romania,ROU,0,0,5,5,10
2018,Turkey,TUR,Romania,ROU,10,0,55,35,100
2018,Ukraine,UKR,Romania,ROU,0,0,16,5,21
2018,Venezuela (Bolivarian Republic of),VEN,Romania,ROU,0,0,5,0,5
2018,Yemen,YEM,Romania,ROU,5,0,5,0,10
2018,Stateless,XXA,Romania,ROU,5,5,5,0,15
2018,Algeria,DZA,South Africa,ZAF,0,0,5,0,5
2018,Egypt,EGY,South Africa,ZAF,0,0,43,0,43
2018,Burundi,BDI,South Africa,ZAF,31,0,418,0,449
2018,Benin,BEN,South Africa,ZAF,0,0,5,0,5
2018,Bangladesh,BGD,South Africa,ZAF,0,0,1224,0,1224
2018,Cameroon,CMR,South Africa,ZAF,0,0,124,0,124
2018,Congo,COG,South Africa,ZAF,12,0,52,0,64
2018,Dem. Rep. of the Congo,COD,South Africa,ZAF,262,0,1549,0,1811
2018,Eritrea,ERI,South Africa,ZAF,17,0,152,0,169
2018,Ethiopia,ETH,South Africa,ZAF,167,0,1402,0,1569
2018,Gambia,GMB,South Africa,ZAF,0,0,5,0,5
2018,Ghana,GHA,South Africa,ZAF,0,0,166,0,166
2018,India,IND,South Africa,ZAF,0,0,156,0,156
2018,Kenya,KEN,South Africa,ZAF,0,0,30,0,30
2018,Liberia,LBR,South Africa,ZAF,0,0,5,0,5
2018,Mali,MLI,South Africa,ZAF,0,0,5,0,5
2018,Malawi,MWI,South Africa,ZAF,0,0,253,0,253
2018,Mozambique,MOZ,South Africa,ZAF,0,0,52,0,52
2018,Nepal,NPL,South Africa,ZAF,0,0,11,0,11
2018,Nigeria,NGA,South Africa,ZAF,0,0,413,0,413
2018,Pakistan,PAK,South Africa,ZAF,0,0,385,0,385
2018,Rwanda,RWA,South Africa,ZAF,0,0,41,0,41
2018,Senegal,SEN,South Africa,ZAF,0,0,83,0,83
2018,Somalia,SOM,South Africa,ZAF,136,0,281,0,417
2018,Syrian Arab Rep.,SYR,South Africa,ZAF,0,0,5,0,5
2018,United Rep. of Tanzania,TZA,South Africa,ZAF,0,0,52,0,52
2018,Thailand,THA,South Africa,ZAF,0,0,10,0,10
2018,Uganda,UGA,South Africa,ZAF,0,0,271,0,271
2018,Zambia,ZMB,South Africa,ZAF,0,0,19,0,19
2018,Zimbabwe,ZWE,South Africa,ZAF,5,0,790,0,795
2018,Unknown ,,South Africa,ZAF,0,0,132,0,132
2018,Afghanistan,AFG,Russian Federation,RUS,0,0,0,180,180
2018,Argentina,ARG,Russian Federation,RUS,0,0,0,5,5
2018,Azerbaijan,AZE,Russian Federation,RUS,0,0,0,10,10
2018,Cameroon,CMR,Russian Federation,RUS,0,0,0,5,5
2018,Dem. Rep. of the Congo,COD,Russian Federation,RUS,0,0,0,5,5
2018,Georgia,GEO,Russian Federation,RUS,0,0,0,5,5
2018,Germany,DEU,Russian Federation,RUS,0,0,0,5,5
2018,Kazakhstan,KAZ,Russian Federation,RUS,0,0,0,5,5
2018,Kyrgyzstan,KGZ,Russian Federation,RUS,0,0,0,5,5
2018,Dem. People's Rep. of Korea,PRK,Russian Federation,RUS,0,0,0,5,5
2018,Rep. of Moldova,MDA,Russian Federation,RUS,5,0,0,5,10
2018,Pakistan,PAK,Russian Federation,RUS,0,0,0,5,5
2018,Sudan,SDN,Russian Federation,RUS,0,0,0,5,5
2018,Syrian Arab Rep.,SYR,Russian Federation,RUS,0,0,0,123,123
2018,Tajikistan,TJK,Russian Federation,RUS,0,0,0,18,18
2018,Turkmenistan,TKM,Russian Federation,RUS,0,0,0,5,5
2018,Ukraine,UKR,Russian Federation,RUS,21,0,0,70,91
2018,Uzbekistan,UZB,Russian Federation,RUS,0,0,0,16,16
2018,Yemen,YEM,Russian Federation,RUS,0,0,0,22,22
2018,Unknown ,,Russian Federation,RUS,0,0,0,5,5
2018,Burundi,BDI,Rwanda,RWA,25,0,0,44,69
2018,Dem. Rep. of the Congo,COD,Rwanda,RWA,5,0,0,150,155
2018,Eritrea,ERI,Rwanda,RWA,0,0,0,5,5
2018,South Sudan,SSD,Rwanda,RWA,5,0,0,0,5
2018,Honduras,HND,El Salvador,SLV,5,0,0,0,5
2018,Nicaragua,NIC,El Salvador,SLV,0,0,5,5,10
2018,Afghanistan,AFG,Serbia and Kosovo: S/RES/1244 (1999),SRB,5,0,5,52,62
2018,Algeria,DZA,Serbia and Kosovo: S/RES/1244 (1999),SRB,0,0,0,42,42
2018,Cuba,CUB,Serbia and Kosovo: S/RES/1244 (1999),SRB,0,0,0,10,10
2018,Palestinian,PSE,Serbia and Kosovo: S/RES/1244 (1999),SRB,0,0,0,76,76
2018,Ghana,GHA,Serbia and Kosovo: S/RES/1244 (1999),SRB,0,0,0,10,10
2018,Iran (Islamic Rep. of),IRN,Serbia and Kosovo: S/RES/1244 (1999),SRB,5,0,5,80,90
2018,Iraq,IRQ,Serbia and Kosovo: S/RES/1244 (1999),SRB,0,0,0,49,49
2018,Libya,LBY,Serbia and Kosovo: S/RES/1244 (1999),SRB,0,10,0,31,41
2018,Morocco,MAR,Serbia and Kosovo: S/RES/1244 (1999),SRB,0,0,0,40,40
2018,Nigeria,NGA,Serbia and Kosovo: S/RES/1244 (1999),SRB,0,0,0,5,5
2018,Pakistan,PAK,Serbia and Kosovo: S/RES/1244 (1999),SRB,0,0,5,73,78
2018,Syrian Arab Rep.,SYR,Serbia and Kosovo: S/RES/1244 (1999),SRB,0,0,0,247,247
2018,Turkey,TUR,Serbia and Kosovo: S/RES/1244 (1999),SRB,61,0,0,12,73
2018,Afghanistan,AFG,Spain,ESP,15,45,14,0,74
2018,Albania,ALB,Spain,ESP,0,0,15,0,15
2018,Algeria,DZA,Spain,ESP,0,0,209,0,209
2018,Egypt,EGY,Spain,ESP,0,0,22,0,22
2018,Argentina,ARG,Spain,ESP,0,0,10,0,10
2018,Armenia,ARM,Spain,ESP,5,0,53,0,58
2018,Azerbaijan,AZE,Spain,ESP,14,0,0,0,14
2018,Benin,BEN,Spain,ESP,0,0,5,0,5
2018,Bangladesh,BGD,Spain,ESP,0,0,71,0,71
2018,Burkina Faso,BFA,Spain,ESP,0,0,13,0,13
2018,Belarus,BLR,Spain,ESP,0,0,5,0,5
2018,Brazil,BRA,Spain,ESP,0,0,5,0,5
2018,Bosnia and Herzegovina,BIH,Spain,ESP,0,0,5,0,5
2018,Bulgaria,BGR,Spain,ESP,0,0,5,0,5
2018,Central African Rep.,CAF,Spain,ESP,0,29,0,0,29
2018,Chad,TCD,Spain,ESP,0,0,5,0,5
2018,China,CHN,Spain,ESP,0,0,218,0,218
2018,Cameroon,CMR,Spain,ESP,17,0,43,0,60
2018,Dem. Rep. of the Congo,COD,Spain,ESP,0,0,14,0,14
2018,Colombia,COL,Spain,ESP,50,0,690,0,740
2018,Costa Rica,CRI,Spain,ESP,0,0,15,0,15
2018,Cuba,CUB,Spain,ESP,0,5,13,0,18
2018,Dominican Rep.,DOM,Spain,ESP,0,0,29,0,29
2018,Ecuador,ECU,Spain,ESP,0,0,10,0,10
2018,Eritrea,ERI,Spain,ESP,51,0,0,0,51
2018,Ethiopia,ETH,Spain,ESP,0,0,10,0,10
2018,Gambia,GMB,Spain,ESP,5,0,65,0,70
2018,Palestinian,PSE,Spain,ESP,87,122,41,0,250
2018,Georgia,GEO,Spain,ESP,0,0,65,0,65
2018,Ghana,GHA,Spain,ESP,0,0,20,0,20
2018,Guinea-Bissau,GNB,Spain,ESP,0,0,5,0,5
2018,Guatemala,GTM,Spain,ESP,5,0,24,0,29
2018,Guinea,GIN,Spain,ESP,5,0,132,0,137
2018,Haiti,HTI,Spain,ESP,0,0,5,0,5
2018,Honduras,HND,Spain,ESP,10,0,105,0,115
2018,Cote d'Ivoire,CIV,Spain,ESP,5,5,81,0,91
2018,India,IND,Spain,ESP,0,0,28,0,28
2018,Iran (Islamic Rep. of),IRN,Spain,ESP,5,0,14,0,19
2018,Iraq,IRQ,Spain,ESP,13,54,19,0,86
2018,Italy,ITA,Spain,ESP,0,0,5,0,5
2018,Lebanon,LBN,Spain,ESP,0,0,45,0,45
2018,Sri Lanka,LKA,Spain,ESP,5,5,0,0,10
2018,Rep. of Moldova,MDA,Spain,ESP,0,0,21,0,21
2018,Mexico,MEX,Spain,ESP,5,0,40,0,45
2018,Mali,MLI,Spain,ESP,5,5,179,0,189
2018,Mongolia,MNG,Spain,ESP,5,0,0,0,5
2018,Morocco,MAR,Spain,ESP,64,0,132,0,196
2018,Niger,NER,Spain,ESP,0,0,5,0,5
2018,Nicaragua,NIC,Spain,ESP,5,0,19,0,24
2018,Nigeria,NGA,Spain,ESP,10,0,13,0,23
2018,Pakistan,PAK,Spain,ESP,25,5,58,0,88
2018,Panama,PAN,Spain,ESP,0,0,10,0,10
2018,Peru,PER,Spain,ESP,0,0,30,0,30
2018,Romania,ROU,Spain,ESP,0,0,5,0,5
2018,Russian Federation,RUS,Spain,ESP,31,0,74,0,105
2018,Rwanda,RWA,Spain,ESP,0,0,5,0,5
2018,El Salvador,SLV,Spain,ESP,0,0,114,0,114
2018,Serbia and Kosovo: S/RES/1244 (1999),SRB,Spain,ESP,0,0,11,0,11
2018,Senegal,SEN,Spain,ESP,0,0,45,0,45
2018,Sierra Leone,SLE,Spain,ESP,0,0,19,0,19
2018,Somalia,SOM,Spain,ESP,0,89,31,0,120
2018,Sudan,SDN,Spain,ESP,0,0,11,0,11
2018,Syrian Arab Rep.,SYR,Spain,ESP,31,1996,135,0,2162
2018,Tunisia,TUN,Spain,ESP,0,0,11,0,11
2018,Turkey,TUR,Spain,ESP,15,0,5,0,20
2018,Ukraine,UKR,Spain,ESP,73,122,2681,0,2876
2018,United States of America,USA,Spain,ESP,0,0,5,0,5
2018,Uzbekistan,UZB,Spain,ESP,5,0,0,0,5
2018,Venezuela (Bolivarian Republic of),VEN,Spain,ESP,29,0,1630,0,1659
2018,Western Sahara,ESH,Spain,ESP,0,0,10,0,10
2018,Yemen,YEM,Spain,ESP,10,72,0,0,82
2018,Unknown ,,Spain,ESP,0,0,5,0,5
2018,Cuba,CUB,Saint Kitts and Nevis,KNA,5,0,0,0,5
2018,Egypt,EGY,Sudan,SDN,0,0,0,16,16
2018,Congo,COG,Sudan,SDN,0,0,0,5,5
2018,Dem. Rep. of the Congo,COD,Sudan,SDN,10,0,0,0,10
2018,Eritrea,ERI,Sudan,SDN,2672,0,5,0,2677
2018,Ethiopia,ETH,Sudan,SDN,898,0,467,0,1365
2018,Palestinian,PSE,Sudan,SDN,0,0,0,30,30
2018,Iraq,IRQ,Sudan,SDN,0,0,0,5,5
2018,Nigeria,NGA,Sudan,SDN,0,0,0,10,10
2018,Somalia,SOM,Sudan,SDN,166,0,0,0,166
2018,Syrian Arab Rep.,SYR,Sudan,SDN,5,0,0,254,259
2018,Yemen,YEM,Sudan,SDN,0,0,0,2472,2472
2018,Unknown ,,Sudan,SDN,5,0,0,20,25
2018,Burundi,BDI,South Sudan,SSD,0,10,0,0,10
2018,Eritrea,ERI,South Sudan,SSD,0,40,0,0,40
2018,Ethiopia,ETH,South Sudan,SSD,0,11,0,0,11
2018,Afghanistan,AFG,Slovenia,SVN,5,0,105,369,479
2018,Albania,ALB,Slovenia,SVN,0,0,0,16,16
2018,Algeria,DZA,Slovenia,SVN,0,0,102,420,522
2018,Egypt,EGY,Slovenia,SVN,0,0,5,12,17
2018,Azerbaijan,AZE,Slovenia,SVN,0,0,0,10,10
2018,Bangladesh,BGD,Slovenia,SVN,0,0,0,60,60
2018,China,CHN,Slovenia,SVN,0,0,0,5,5
2018,Dem. Rep. of the Congo,COD,Slovenia,SVN,0,0,5,0,5
2018,Eritrea,ERI,Slovenia,SVN,26,0,0,19,45
2018,Gambia,GMB,Slovenia,SVN,0,0,5,0,5
2018,Palestinian,PSE,Slovenia,SVN,0,0,0,17,17
2018,India,IND,Slovenia,SVN,0,0,5,32,37
2018,Iran (Islamic Rep. of),IRN,Slovenia,SVN,5,0,27,121,153
2018,Iraq,IRQ,Slovenia,SVN,5,0,16,64,85
2018,Libya,LBY,Slovenia,SVN,0,0,10,23,33
2018,Sri Lanka,LKA,Slovenia,SVN,0,0,0,5,5
2018,Morocco,MAR,Slovenia,SVN,0,0,35,145,180
2018,Myanmar,MMR,Slovenia,SVN,0,0,0,5,5
2018,Nepal,NPL,Slovenia,SVN,0,0,0,26,26
2018,Nigeria,NGA,Slovenia,SVN,0,0,5,0,5
2018,Pakistan,PAK,Slovenia,SVN,0,0,16,782,798
2018,Russian Federation,RUS,Slovenia,SVN,0,0,5,15,20
2018,Serbia and Kosovo: S/RES/1244 (1999),SRB,Slovenia,SVN,0,0,15,38,53
2018,Syrian Arab Rep.,SYR,Slovenia,SVN,41,0,21,88,150
2018,Tunisia,TUN,Slovenia,SVN,0,0,17,27,44
2018,Turkey,TUR,Slovenia,SVN,12,0,15,62,89
2018,Burundi,BDI,Eswatini,SWZ,18,0,0,0,18
2018,Congo,COG,Eswatini,SWZ,10,0,0,0,10
2018,Dem. Rep. of the Congo,COD,Eswatini,SWZ,14,0,0,0,14
2018,Ethiopia,ETH,Eswatini,SWZ,5,0,0,0,5
2018,Rwanda,RWA,Eswatini,SWZ,11,0,0,0,11
2018,Somalia,SOM,Eswatini,SWZ,15,0,0,0,15
2018,Afghanistan,AFG,Sweden,SWE,1286,714,4549,185,6734
2018,Albania,ALB,Sweden,SWE,0,5,396,172,573
2018,Algeria,DZA,Sweden,SWE,0,0,44,70,114
2018,Angola,AGO,Sweden,SWE,0,0,16,24,40
2018,Egypt,EGY,Sweden,SWE,17,0,175,68,260
2018,Armenia,ARM,Sweden,SWE,0,0,113,36,149
2018,Azerbaijan,AZE,Sweden,SWE,27,5,156,105,293
2018,Bahrain,BHR,Sweden,SWE,0,0,5,0,5
2018,Burundi,BDI,Sweden,SWE,14,0,18,19,51
2018,Benin,BEN,Sweden,SWE,5,0,0,0,5
2018,Bangladesh,BGD,Sweden,SWE,21,0,130,32,183
2018,Burkina Faso,BFA,Sweden,SWE,0,0,0,5,5
2018,Belarus,BLR,Sweden,SWE,5,0,53,67,125
2018,Bolivia (Plurinational State of),BOL,Sweden,SWE,0,0,23,10,33
2018,Brazil,BRA,Sweden,SWE,0,0,5,5,10
2018,Bosnia and Herzegovina,BIH,Sweden,SWE,0,0,62,24,86
2018,Canada,CAN,Sweden,SWE,0,0,5,0,5
2018,Central African Rep.,CAF,Sweden,SWE,0,0,0,5,5
2018,Chad,TCD,Sweden,SWE,0,0,0,5,5
2018,China,CHN,Sweden,SWE,10,0,20,12,42
2018,Chile,CHL,Sweden,SWE,0,0,27,5,32
2018,Cameroon,CMR,Sweden,SWE,10,0,54,27,91
2018,Congo,COG,Sweden,SWE,0,0,5,0,5
2018,Dem. Rep. of the Congo,COD,Sweden,SWE,0,0,20,17,37
2018,Colombia,COL,Sweden,SWE,5,0,198,31,234
2018,Cuba,CUB,Sweden,SWE,0,0,20,32,52
2018,Djibouti,DJI,Sweden,SWE,0,0,5,0,5
2018,Dominica,DMA,Sweden,SWE,0,0,0,5,5
2018,Ecuador,ECU,Sweden,SWE,0,0,19,0,19
2018,Eritrea,ERI,Sweden,SWE,585,46,75,130,836
2018,Ethiopia,ETH,Sweden,SWE,160,10,282,64,516
2018,Gambia,GMB,Sweden,SWE,13,0,58,54,125
2018,Palestinian,PSE,Sweden,SWE,47,10,217,75,349
2018,United Kingdom of Great Britain and Northern Ireland,GBR,Sweden,SWE,0,0,5,0,5
2018,Georgia,GEO,Sweden,SWE,0,0,751,386,1137
2018,Ghana,GHA,Sweden,SWE,5,0,20,24,49
2018,Guinea-Bissau,GNB,Sweden,SWE,0,0,0,5,5
2018,Guatemala,GTM,Sweden,SWE,0,0,5,0,5
2018,Guinea,GIN,Sweden,SWE,0,0,12,17,29
2018,Honduras,HND,Sweden,SWE,0,0,20,5,25
2018,Croatia,HRV,Sweden,SWE,0,0,0,5,5
2018,Hungary,HUN,Sweden,SWE,0,0,5,0,5
2018,Cote d'Ivoire,CIV,Sweden,SWE,0,0,5,12,17
2018,India,IND,Sweden,SWE,0,0,34,24,58
2018,Iran (Islamic Rep. of),IRN,Sweden,SWE,655,11,1004,217,1887
2018,Iraq,IRQ,Sweden,SWE,616,187,2621,330,3754
2018,Israel,ISR,Sweden,SWE,0,0,5,0,5
2018,Italy,ITA,Sweden,SWE,0,0,0,5,5
2018,Jordan,JOR,Sweden,SWE,10,0,109,25,144
2018,Kazakhstan,KAZ,Sweden,SWE,5,5,86,98,194
2018,Kenya,KEN,Sweden,SWE,10,0,14,10,34
2018,Kyrgyzstan,KGZ,Sweden,SWE,0,0,78,67,145
2018,Rep. of Korea,KOR,Sweden,SWE,0,0,5,0,5
2018,Kuwait,KWT,Sweden,SWE,0,0,40,5,45
2018,Liberia,LBR,Sweden,SWE,0,0,5,0,5
2018,Libya,LBY,Sweden,SWE,5,0,18,70,93
2018,Lebanon,LBN,Sweden,SWE,14,0,191,87,292
2018,Sri Lanka,LKA,Sweden,SWE,0,0,11,16,27
2018,Mauritania,MRT,Sweden,SWE,0,0,0,5,5
2018,North Macedonia,MKD,Sweden,SWE,0,0,55,19,74
2018,Rep. of Moldova,MDA,Sweden,SWE,0,0,10,5,15
2018,Mexico,MEX,Sweden,SWE,0,0,5,0,5
2018,Mali,MLI,Sweden,SWE,0,0,5,5,10
2018,Mongolia,MNG,Sweden,SWE,0,0,317,54,371
2018,Morocco,MAR,Sweden,SWE,10,0,163,206,379
2018,Montenegro,MNE,Sweden,SWE,0,0,20,5,25
2018,Nepal,NPL,Sweden,SWE,0,0,13,0,13
2018,Nicaragua,NIC,Sweden,SWE,0,0,124,14,138
2018,Nigeria,NGA,Sweden,SWE,27,0,183,141,351
2018,Norway,NOR,Sweden,SWE,0,0,0,5,5
2018,Pakistan,PAK,Sweden,SWE,44,0,142,83,269
2018,Peru,PER,Sweden,SWE,0,0,90,24,114
2018,Philippines,PHL,Sweden,SWE,0,0,21,5,26
2018,Poland,POL,Sweden,SWE,0,0,5,0,5
2018,Romania,ROU,Sweden,SWE,0,0,0,5,5
2018,South Africa,ZAF,Sweden,SWE,0,0,0,11,11
2018,Russian Federation,RUS,Sweden,SWE,43,0,167,112,322
2018,Rwanda,RWA,Sweden,SWE,0,0,10,5,15
2018,El Salvador,SLV,Sweden,SWE,0,5,171,17,193
2018,Saudi Arabia,SAU,Sweden,SWE,5,0,5,5,15
2018,Serbia and Kosovo: S/RES/1244 (1999),SRB,Sweden,SWE,0,0,182,113,295
2018,Senegal,SEN,Sweden,SWE,0,0,12,16,28
2018,Sierra Leone,SLE,Sweden,SWE,0,0,10,10,20
2018,Somalia,SOM,Sweden,SWE,379,55,550,190,1174
2018,Spain,ESP,Sweden,SWE,0,0,5,5,10
2018,Viet Nam,VNM,Sweden,SWE,0,0,37,13,50
2018,Sudan,SDN,Sweden,SWE,50,0,57,14,121
2018,Slovakia,SVK,Sweden,SWE,0,0,5,0,5
2018,Syrian Arab Rep.,SYR,Sweden,SWE,330,2493,186,440,3449
2018,United Rep. of Tanzania,TZA,Sweden,SWE,5,0,17,5,27
2018,Thailand,THA,Sweden,SWE,0,0,13,0,13
2018,Tajikistan,TJK,Sweden,SWE,0,0,35,17,52
2018,Tunisia,TUN,Sweden,SWE,0,0,56,54,110
2018,Turkey,TUR,Sweden,SWE,588,0,379,88,1055
2018,Uganda,UGA,Sweden,SWE,16,0,24,17,57
2018,Ukraine,UKR,Sweden,SWE,5,0,349,126,480
2018,United States of America,USA,Sweden,SWE,0,0,12,5,17
2018,Uzbekistan,UZB,Sweden,SWE,14,0,180,181,375
2018,Venezuela (Bolivarian Republic of),VEN,Sweden,SWE,0,0,76,13,89
2018,Yemen,YEM,Sweden,SWE,75,150,5,27,257
2018,Zambia,ZMB,Sweden,SWE,0,0,5,0,5
2018,Stateless,XXA,Sweden,SWE,278,114,312,161,865
2018,Unknown ,,Sweden,SWE,10,10,206,59,285
2018,Afghanistan,AFG,Switzerland,CHE,741,3942,194,353,5230
2018,Albania,ALB,Switzerland,CHE,5,5,70,32,112
2018,Algeria,DZA,Switzerland,CHE,5,5,129,623,762
2018,Angola,AGO,Switzerland,CHE,0,22,10,42,74
2018,Egypt,EGY,Switzerland,CHE,5,5,5,27,42
2018,Armenia,ARM,Switzerland,CHE,0,17,39,31,87
2018,Azerbaijan,AZE,Switzerland,CHE,11,5,14,29,59
2018,Burundi,BDI,Switzerland,CHE,21,5,0,0,26
2018,Benin,BEN,Switzerland,CHE,0,0,5,5,10
2018,Bangladesh,BGD,Switzerland,CHE,0,0,5,5,10
2018,Burkina Faso,BFA,Switzerland,CHE,0,0,5,5,10
2018,Belarus,BLR,Switzerland,CHE,0,0,20,40,60
2018,Bosnia and Herzegovina,BIH,Switzerland,CHE,0,5,25,31,61
2018,Central African Rep.,CAF,Switzerland,CHE,0,5,0,0,5
2018,Chad,TCD,Switzerland,CHE,0,5,5,5,15
2018,China,CHN,Switzerland,CHE,62,211,138,15,426
2018,Cameroon,CMR,Switzerland,CHE,0,5,18,61,84
2018,Dem. Rep. of the Congo,COD,Switzerland,CHE,10,33,39,26,108
2018,Colombia,COL,Switzerland,CHE,0,5,48,5,58
2018,Cuba,CUB,Switzerland,CHE,0,0,0,5,5
2018,Czechia,CZE,Switzerland,CHE,0,0,5,0,5
2018,Djibouti,DJI,Switzerland,CHE,0,0,0,5,5
2018,Equatorial Guinea,GNQ,Switzerland,CHE,0,5,0,0,5
2018,Eritrea,ERI,Switzerland,CHE,2981,908,943,284,5116
2018,Ethiopia,ETH,Switzerland,CHE,89,133,208,124,554
2018,France,FRA,Switzerland,CHE,0,0,0,5,5
2018,Gambia,GMB,Switzerland,CHE,0,5,18,206,229
2018,Georgia,GEO,Switzerland,CHE,0,28,414,508,950
2018,Germany,DEU,Switzerland,CHE,0,0,10,0,10
2018,Ghana,GHA,Switzerland,CHE,0,0,12,42,54
2018,Guinea-Bissau,GNB,Switzerland,CHE,0,0,5,30,35
2018,Guinea,GIN,Switzerland,CHE,5,14,71,221,311
2018,Honduras,HND,Switzerland,CHE,0,0,5,0,5
2018,Cote d'Ivoire,CIV,Switzerland,CHE,5,14,5,73,97
2018,India,IND,Switzerland,CHE,0,0,23,16,39
2018,Iran (Islamic Rep. of),IRN,Switzerland,CHE,107,86,237,122,552
2018,Iraq,IRQ,Switzerland,CHE,215,615,342,246,1418
2018,Israel,ISR,Switzerland,CHE,0,0,0,5,5
2018,Italy,ITA,Switzerland,CHE,0,0,0,5,5
2018,Jordan,JOR,Switzerland,CHE,0,0,0,5,5
2018,Kenya,KEN,Switzerland,CHE,0,0,0,5,5
2018,Liberia,LBR,Switzerland,CHE,0,0,0,5,5
2018,Libya,LBY,Switzerland,CHE,10,11,13,134,168
2018,Lebanon,LBN,Switzerland,CHE,0,0,5,18,23
2018,Sri Lanka,LKA,Switzerland,CHE,322,99,586,148,1155
2018,Mauritania,MRT,Switzerland,CHE,0,5,0,10,15
2018,North Macedonia,MKD,Switzerland,CHE,5,0,46,29,80
2018,Rep. of Moldova,MDA,Switzerland,CHE,0,0,5,5,10
2018,Mexico,MEX,Switzerland,CHE,0,0,5,0,5
2018,Mali,MLI,Switzerland,CHE,0,5,5,51,61
2018,Mongolia,MNG,Switzerland,CHE,0,16,14,42,72
2018,Morocco,MAR,Switzerland,CHE,5,0,65,438,508
2018,Mozambique,MOZ,Switzerland,CHE,0,0,0,5,5
2018,Myanmar,MMR,Switzerland,CHE,0,0,0,5,5
2018,Niger,NER,Switzerland,CHE,0,0,0,10,10
2018,Nigeria,NGA,Switzerland,CHE,5,29,31,506,571
2018,Pakistan,PAK,Switzerland,CHE,29,31,99,74,233
2018,Poland,POL,Switzerland,CHE,0,0,0,5,5
2018,Romania,ROU,Switzerland,CHE,0,0,10,5,15
2018,South Africa,ZAF,Switzerland,CHE,0,0,0,5,5
2018,Russian Federation,RUS,Switzerland,CHE,25,28,34,118,205
2018,El Salvador,SLV,Switzerland,CHE,0,0,5,0,5
2018,Saudi Arabia,SAU,Switzerland,CHE,0,5,0,5,10
2018,Serbia and Kosovo: S/RES/1244 (1999),SRB,Switzerland,CHE,5,40,128,109,282
2018,Senegal,SEN,Switzerland,CHE,5,5,11,57,78
2018,Sierra Leone,SLE,Switzerland,CHE,0,0,5,27,32
2018,Somalia,SOM,Switzerland,CHE,159,355,84,362,960
2018,Spain,ESP,Switzerland,CHE,0,0,0,5,5
2018,Sudan,SDN,Switzerland,CHE,14,21,38,27,100
2018,South Sudan,SSD,Switzerland,CHE,0,0,0,5,5
2018,Syrian Arab Rep.,SYR,Switzerland,CHE,1070,1563,180,181,2994
2018,United Rep. of Tanzania,TZA,Switzerland,CHE,0,0,0,5,5
2018,Tajikistan,TJK,Switzerland,CHE,5,0,0,10,15
2018,Togo,TGO,Switzerland,CHE,12,5,19,16,52
2018,Tunisia,TUN,Switzerland,CHE,0,0,49,277,326
2018,Turkey,TUR,Switzerland,CHE,280,45,184,130,639
2018,Uganda,UGA,Switzerland,CHE,0,0,10,10,20
2018,Ukraine,UKR,Switzerland,CHE,5,5,41,36,87
2018,United States of America,USA,Switzerland,CHE,0,0,5,5,10
2018,Uzbekistan,UZB,Switzerland,CHE,0,5,0,0,5
2018,Venezuela (Bolivarian Republic of),VEN,Switzerland,CHE,0,0,28,5,33
2018,Yemen,YEM,Switzerland,CHE,17,17,5,14,53
2018,Stateless,XXA,Switzerland,CHE,5,5,5,5,20
2018,Unknown ,,Switzerland,CHE,88,184,116,65,453
2018,Burundi,BDI,United Rep. of Tanzania,TZA,0,0,0,6074,6074
2018,Dem. Rep. of the Congo,COD,United Rep. of Tanzania,TZA,5,0,0,195,200
2018,Unknown ,,United Rep. of Tanzania,TZA,5,0,0,17,22
2018,Myanmar,MMR,Thailand,THA,10,0,0,0,10
2018,Central African Rep.,CAF,Togo,TGO,10,0,67,0,77
2018,Cameroon,CMR,Togo,TGO,5,0,0,0,5
2018,Dem. Rep. of the Congo,COD,Togo,TGO,10,0,0,0,10
2018,Cote d'Ivoire,CIV,Togo,TGO,11,0,22,0,33
2018,Mali,MLI,Togo,TGO,0,0,5,0,5
2018,Rwanda,RWA,Togo,TGO,5,0,0,0,5
2018,Turkey,TUR,Togo,TGO,27,0,0,0,27
2018,Burundi,BDI,Uganda,UGA,1271,0,52,976,2299
2018,Central African Rep.,CAF,Uganda,UGA,0,0,0,5,5
2018,Dem. Rep. of the Congo,COD,Uganda,UGA,11677,0,895,2885,15457
2018,Eritrea,ERI,Uganda,UGA,530,0,896,5932,7358
2018,Ethiopia,ETH,Uganda,UGA,307,0,102,554,963
2018,Palestinian,PSE,Uganda,UGA,0,0,0,5,5
2018,Kenya,KEN,Uganda,UGA,5,0,0,5,10
2018,Pakistan,PAK,Uganda,UGA,0,0,100,100,200
2018,Rwanda,RWA,Uganda,UGA,289,0,137,296,722
2018,Somalia,SOM,Uganda,UGA,5771,0,0,5330,11101
2018,Sudan,SDN,Uganda,UGA,10,0,5,588,603
2018,South Sudan,SSD,Uganda,UGA,5,0,0,289,294
2018,Syrian Arab Rep.,SYR,Uganda,UGA,0,0,0,5,5
2018,Turkey,TUR,Uganda,UGA,12,0,5,5,22
2018,Afghanistan,AFG,Ukraine,UKR,11,20,26,79,136
2018,Algeria,DZA,Ukraine,UKR,0,0,0,5,5
2018,Azerbaijan,AZE,Ukraine,UKR,0,0,0,5,5
2018,Bangladesh,BGD,Ukraine,UKR,0,0,12,61,73
2018,Belarus,BLR,Ukraine,UKR,0,0,0,10,10
2018,Cameroon,CMR,Ukraine,UKR,0,0,0,10,10
2018,Congo,COG,Ukraine,UKR,0,0,0,5,5
2018,Dem. Rep. of the Congo,COD,Ukraine,UKR,0,0,5,0,5
2018,Eritrea,ERI,Ukraine,UKR,0,0,0,5,5
2018,Palestinian,PSE,Ukraine,UKR,0,0,0,5,5
2018,Georgia,GEO,Ukraine,UKR,0,0,0,5,5
2018,Ghana,GHA,Ukraine,UKR,0,0,0,5,5
2018,Guinea,GIN,Ukraine,UKR,0,0,0,10,10
2018,Cote d'Ivoire,CIV,Ukraine,UKR,0,0,0,5,5
2018,India,IND,Ukraine,UKR,0,5,5,16,26
2018,Iran (Islamic Rep. of),IRN,Ukraine,UKR,0,0,11,5,16
2018,Iraq,IRQ,Ukraine,UKR,0,5,5,29,39
2018,Jordan,JOR,Ukraine,UKR,0,0,5,5,10
2018,Kazakhstan,KAZ,Ukraine,UKR,0,0,5,0,5
2018,Kyrgyzstan,KGZ,Ukraine,UKR,0,0,0,5,5
2018,Libya,LBY,Ukraine,UKR,0,0,5,0,5
2018,Lebanon,LBN,Ukraine,UKR,0,0,5,5,10
2018,Sri Lanka,LKA,Ukraine,UKR,0,0,0,5,5
2018,Nigeria,NGA,Ukraine,UKR,0,0,0,29,29
2018,Pakistan,PAK,Ukraine,UKR,0,0,5,15,20
2018,Russian Federation,RUS,Ukraine,UKR,0,14,45,49,108
2018,Senegal,SEN,Ukraine,UKR,0,0,0,5,5
2018,Somalia,SOM,Ukraine,UKR,0,0,5,36,41
2018,Sudan,SDN,Ukraine,UKR,0,0,0,5,5
2018,Syrian Arab Rep.,SYR,Ukraine,UKR,0,26,59,44,129
2018,Tajikistan,TJK,Ukraine,UKR,0,0,30,5,35
2018,Turkey,TUR,Ukraine,UKR,0,0,5,10,15
2018,Uzbekistan,UZB,Ukraine,UKR,5,0,10,20,35
2018,Yemen,YEM,Ukraine,UKR,0,0,12,5,17
2018,Stateless,XXA,Ukraine,UKR,0,5,12,0,17
2018,Angola,AGO,Uruguay,URY,10,0,5,0,15
2018,Brazil,BRA,Uruguay,URY,0,0,0,5,5
2018,Colombia,COL,Uruguay,URY,10,0,0,10,20
2018,Cuba,CUB,Uruguay,URY,5,0,40,2319,2364
2018,France,FRA,Uruguay,URY,0,0,5,0,5
2018,Nigeria,NGA,Uruguay,URY,5,0,0,5,10
2018,El Salvador,SLV,Uruguay,URY,10,0,0,0,10
2018,Venezuela (Bolivarian Republic of),VEN,Uruguay,URY,12,0,5,5,22
2018,Colombia,COL,Venezuela (Bolivarian Republic of),VEN,615,0,1400,86,2101
2018,Burundi,BDI,Zambia,ZMB,1170,0,5,13,1188
2018,Congo,COG,Zambia,ZMB,5,0,0,0,5
2018,Dem. Rep. of the Congo,COD,Zambia,ZMB,10478,0,33,164,10675
2018,Eritrea,ERI,Zambia,ZMB,11,0,0,0,11
2018,Ethiopia,ETH,Zambia,ZMB,5,0,0,0,5
2018,Rwanda,RWA,Zambia,ZMB,19,0,0,26,45
2018,Sierra Leone,SLE,Zambia,ZMB,0,0,0,5,5
2018,Somalia,SOM,Zambia,ZMB,666,0,0,38,704
2018,Syrian Arab Rep.,SYR,Zambia,ZMB,5,0,0,0,5
2018,Turkey,TUR,Zambia,ZMB,24,0,0,0,24
2018,Burundi,BDI,Zimbabwe,ZWE,0,0,0,20,20
2018,Dem. Rep. of the Congo,COD,Zimbabwe,ZWE,209,0,10,354,573
2018,Eritrea,ERI,Zimbabwe,ZWE,0,0,0,5,5
2018,Ethiopia,ETH,Zimbabwe,ZWE,0,0,0,11,11
2018,Cote d'Ivoire,CIV,Zimbabwe,ZWE,0,0,0,10,10
2018,Mozambique,MOZ,Zimbabwe,ZWE,0,0,0,335,335
2018,South Africa,ZAF,Zimbabwe,ZWE,0,0,0,5,5
2018,Somalia,SOM,Zimbabwe,ZWE,0,0,0,5,5
2018,Sudan,SDN,Zimbabwe,ZWE,0,10,0,0,10
2019,Afghanistan,AFG,Albania,ALB,0,0,0,5,5
2019,Algeria,DZA,Albania,ALB,0,0,0,17,17
2019,Palestinian,PSE,Albania,ALB,0,0,0,5,5
2019,Iran (Islamic Rep. of),IRN,Albania,ALB,0,0,0,5,5
2019,Iraq,IRQ,Albania,ALB,13,0,0,23,36
2019,Libya,LBY,Albania,ALB,0,0,0,28,28
2019,Morocco,MAR,Albania,ALB,0,0,0,36,36
2019,Serbia and Kosovo: S/RES/1244 (1999),SRB,Albania,ALB,0,0,0,5,5
2019,Syrian Arab Rep.,SYR,Albania,ALB,10,0,0,70,80
2019,Afghanistan,AFG,Argentina,ARG,5,0,0,0,5
2019,Angola,AGO,Argentina,ARG,0,0,5,0,5
2019,Armenia,ARM,Argentina,ARG,0,0,27,29,56
2019,Bangladesh,BGD,Argentina,ARG,0,0,0,5,5
2019,Brazil,BRA,Argentina,ARG,0,0,0,5,5
2019,China,CHN,Argentina,ARG,0,0,12,0,12
2019,Cameroon,CMR,Argentina,ARG,0,0,0,5,5
2019,Dem. Rep. of the Congo,COD,Argentina,ARG,5,0,0,0,5
2019,Colombia,COL,Argentina,ARG,11,0,0,59,70
2019,Cuba,CUB,Argentina,ARG,5,0,45,75,125
2019,Dominican Rep.,DOM,Argentina,ARG,0,0,64,41,105
2019,France,FRA,Argentina,ARG,0,0,0,5,5
2019,Ghana,GHA,Argentina,ARG,0,0,5,5,10
2019,Guatemala,GTM,Argentina,ARG,5,0,0,0,5
2019,Haiti,HTI,Argentina,ARG,5,0,221,101,327
2019,Honduras,HND,Argentina,ARG,0,0,0,5,5
2019,India,IND,Argentina,ARG,0,0,22,10,32
2019,Iraq,IRQ,Argentina,ARG,0,0,0,5,5
2019,Jamaica,JAM,Argentina,ARG,5,0,0,0,5
2019,Nicaragua,NIC,Argentina,ARG,5,0,0,0,5
2019,Nigeria,NGA,Argentina,ARG,0,0,0,17,17
2019,Pakistan,PAK,Argentina,ARG,5,0,5,5,15
2019,Peru,PER,Argentina,ARG,0,0,0,5,5
2019,Russian Federation,RUS,Argentina,ARG,10,0,5,14,29
2019,El Salvador,SLV,Argentina,ARG,10,0,0,5,15
2019,Senegal,SEN,Argentina,ARG,0,0,173,37,210
2019,Syrian Arab Rep.,SYR,Argentina,ARG,21,0,5,10,36
2019,Ukraine,UKR,Argentina,ARG,11,0,5,31,47
2019,Venezuela (Bolivarian Republic of),VEN,Argentina,ARG,294,0,5,160,459
2019,Yemen,YEM,Argentina,ARG,5,0,0,0,5
2019,Unknown ,,Argentina,ARG,17,0,0,5,22
2019,Afghanistan,AFG,Armenia,ARM,0,0,0,5,5
2019,Egypt,EGY,Armenia,ARM,5,0,0,0,5
2019,Cuba,CUB,Armenia,ARM,0,0,18,15,33
2019,India,IND,Armenia,ARM,0,0,0,5,5
2019,Iran (Islamic Rep. of),IRN,Armenia,ARM,33,0,13,24,70
2019,Iraq,IRQ,Armenia,ARM,5,0,0,20,25
2019,Lebanon,LBN,Armenia,ARM,5,0,0,0,5
2019,Pakistan,PAK,Armenia,ARM,0,0,0,5,5
2019,Syrian Arab Rep.,SYR,Armenia,ARM,29,0,0,0,29
2019,Turkey,TUR,Armenia,ARM,5,0,0,5,10
2019,Afghanistan,AFG,Australia,AUS,529,0,42,0,571
2019,Albania,ALB,Australia,AUS,0,0,5,0,5
2019,Egypt,EGY,Australia,AUS,26,0,39,10,75
2019,Bangladesh,BGD,Australia,AUS,11,0,215,20,246
2019,Cambodia,KHM,Australia,AUS,10,0,0,0,10
2019,China,CHN,Australia,AUS,89,0,2702,509,3300
2019,Cameroon,CMR,Australia,AUS,5,0,0,0,5
2019,Dem. Rep. of the Congo,COD,Australia,AUS,5,0,0,0,5
2019,Ethiopia,ETH,Australia,AUS,16,0,58,0,74
2019,Fiji,FJI,Australia,AUS,0,0,636,91,727
2019,Palestinian,PSE,Australia,AUS,65,0,5,0,70
2019,United Kingdom of Great Britain and Northern Ireland,GBR,Australia,AUS,0,0,10,10,20
2019,Ghana,GHA,Australia,AUS,0,0,43,0,43
2019,Greece,GRC,Australia,AUS,0,0,5,0,5
2019,India,IND,Australia,AUS,29,0,876,267,1172
2019,Indonesia,IDN,Australia,AUS,16,0,57,35,108
2019,Ireland,IRL,Australia,AUS,0,0,5,0,5
2019,Iran (Islamic Rep. of),IRN,Australia,AUS,1313,0,441,20,1774
2019,Iraq,IRQ,Australia,AUS,260,0,250,14,524
2019,Kenya,KEN,Australia,AUS,0,0,5,0,5
2019,Rep. of Korea,KOR,Australia,AUS,0,0,16,10,26
2019,Libya,LBY,Australia,AUS,65,0,0,0,65
2019,Lebanon,LBN,Australia,AUS,12,0,263,36,311
2019,Sri Lanka,LKA,Australia,AUS,181,0,384,42,607
2019,Maldives,MDV,Australia,AUS,5,0,0,0,5
2019,Malaysia,MYS,Australia,AUS,42,0,6639,549,7230
2019,Myanmar,MMR,Australia,AUS,31,0,16,0,47
2019,Nepal,NPL,Australia,AUS,0,0,22,5,27
2019,Nigeria,NGA,Australia,AUS,5,0,49,5,59
2019,Pakistan,PAK,Australia,AUS,336,0,531,47,914
2019,Peru,PER,Australia,AUS,5,0,0,0,5
2019,Philippines,PHL,Australia,AUS,0,0,12,20,32
2019,Papua New Guinea,PNG,Australia,AUS,64,0,169,5,238
2019,South Africa,ZAF,Australia,AUS,0,0,136,10,146
2019,Saudi Arabia,SAU,Australia,AUS,40,0,20,5,65
2019,Sierra Leone,SLE,Australia,AUS,0,0,16,0,16
2019,Somalia,SOM,Australia,AUS,63,0,0,0,63
2019,Viet Nam,VNM,Australia,AUS,12,0,362,97,471
2019,Sudan,SDN,Australia,AUS,60,0,12,0,72
2019,Syrian Arab Rep.,SYR,Australia,AUS,39,0,0,0,39
2019,Thailand,THA,Australia,AUS,0,0,1113,88,1201
2019,Tonga,TON,Australia,AUS,0,0,10,5,15
2019,Turkey,TUR,Australia,AUS,169,0,67,0,236
2019,Tuvalu,TUV,Australia,AUS,0,0,0,10,10
2019,Venezuela (Bolivarian Republic of),VEN,Australia,AUS,45,0,44,5,94
2019,Yemen,YEM,Australia,AUS,32,0,0,0,32
2019,Zambia,ZMB,Australia,AUS,0,0,5,0,5
2019,Stateless,XXA,Australia,AUS,397,0,70,5,472
2019,Unknown ,,Australia,AUS,377,0,477,500,1354
2019,Afghanistan,AFG,Azerbaijan,AZE,10,0,402,35,447
2019,Egypt,EGY,Azerbaijan,AZE,0,0,12,10,22
2019,Bangladesh,BGD,Azerbaijan,AZE,0,0,5,0,5
2019,Iran (Islamic Rep. of),IRN,Azerbaijan,AZE,0,0,16,10,26
2019,Iraq,IRQ,Azerbaijan,AZE,5,0,5,5,15
2019,Nepal,NPL,Azerbaijan,AZE,0,0,5,0,5
2019,Pakistan,PAK,Azerbaijan,AZE,0,0,122,25,147
2019,Syrian Arab Rep.,SYR,Azerbaijan,AZE,0,0,20,0,20
2019,Turkey,TUR,Azerbaijan,AZE,0,0,5,0,5
2019,Yemen,YEM,Azerbaijan,AZE,0,0,5,0,5
2019,Dem. Rep. of the Congo,COD,Burundi,BDI,8617,68,150,297,9132
2019,Rwanda,RWA,Burundi,BDI,64,0,0,0,64
2019,Afghanistan,AFG,Belgium,BEL,154,171,287,366,978
2019,Albania,ALB,Belgium,BEL,10,0,189,55,254
2019,Algeria,DZA,Belgium,BEL,5,0,32,5,42
2019,Angola,AGO,Belgium,BEL,0,0,40,5,45
2019,Egypt,EGY,Belgium,BEL,20,0,5,10,35
2019,Armenia,ARM,Belgium,BEL,5,5,27,19,56
2019,Azerbaijan,AZE,Belgium,BEL,0,0,10,5,15
2019,Burundi,BDI,Belgium,BEL,125,0,26,5,156
2019,Benin,BEN,Belgium,BEL,0,0,5,0,5
2019,Bangladesh,BGD,Belgium,BEL,0,0,5,10,15
2019,Burkina Faso,BFA,Belgium,BEL,5,0,10,0,15
2019,Brazil,BRA,Belgium,BEL,0,0,11,0,11
2019,Bosnia and Herzegovina,BIH,Belgium,BEL,0,0,5,0,5
2019,Central African Rep.,CAF,Belgium,BEL,5,0,5,0,10
2019,China,CHN,Belgium,BEL,42,0,13,12,67
2019,Cameroon,CMR,Belgium,BEL,35,0,72,30,137
2019,Congo,COG,Belgium,BEL,0,0,5,5,10
2019,Dem. Rep. of the Congo,COD,Belgium,BEL,54,5,95,37,191
2019,Colombia,COL,Belgium,BEL,17,5,92,0,114
2019,Cuba,CUB,Belgium,BEL,0,0,5,0,5
2019,Djibouti,DJI,Belgium,BEL,10,0,0,5,15
2019,Ecuador,ECU,Belgium,BEL,0,0,5,0,5
2019,Eritrea,ERI,Belgium,BEL,192,0,5,13,210
2019,Ethiopia,ETH,Belgium,BEL,0,0,14,18,32
2019,Gabon,GAB,Belgium,BEL,5,0,5,0,10
2019,Gambia,GMB,Belgium,BEL,0,0,10,0,10
2019,Palestinian,PSE,Belgium,BEL,96,0,182,21,299
2019,Georgia,GEO,Belgium,BEL,14,0,36,15,65
2019,Ghana,GHA,Belgium,BEL,5,0,10,5,20
2019,Guatemala,GTM,Belgium,BEL,5,0,0,0,5
2019,Guinea,GIN,Belgium,BEL,98,0,184,53,335
2019,Honduras,HND,Belgium,BEL,5,0,0,0,5
2019,Cote d'Ivoire,CIV,Belgium,BEL,13,0,24,10,47
2019,India,IND,Belgium,BEL,0,0,14,12,26
2019,Iran (Islamic Rep. of),IRN,Belgium,BEL,208,0,49,14,271
2019,Iraq,IRQ,Belgium,BEL,177,63,301,313,854
2019,Kazakhstan,KAZ,Belgium,BEL,0,0,5,0,5
2019,Kenya,KEN,Belgium,BEL,0,0,5,0,5
2019,Kyrgyzstan,KGZ,Belgium,BEL,0,5,13,0,18
2019,Liberia,LBR,Belgium,BEL,0,0,5,5,10
2019,Libya,LBY,Belgium,BEL,0,35,0,0,35
2019,Lebanon,LBN,Belgium,BEL,0,0,38,10,48
2019,Sri Lanka,LKA,Belgium,BEL,0,0,21,40,61
2019,Mauritania,MRT,Belgium,BEL,15,0,24,5,44
2019,North Macedonia,MKD,Belgium,BEL,0,0,48,14,62
2019,Rep. of Moldova,MDA,Belgium,BEL,0,0,5,0,5
2019,Mexico,MEX,Belgium,BEL,0,0,10,0,10
2019,Mali,MLI,Belgium,BEL,5,0,5,0,10
2019,Mongolia,MNG,Belgium,BEL,0,0,5,0,5
2019,Morocco,MAR,Belgium,BEL,16,0,62,28,106
2019,Montenegro,MNE,Belgium,BEL,0,0,5,0,5
2019,Nepal,NPL,Belgium,BEL,0,0,0,5,5
2019,Niger,NER,Belgium,BEL,10,0,12,5,27
2019,Nicaragua,NIC,Belgium,BEL,10,0,10,0,20
2019,Nigeria,NGA,Belgium,BEL,10,0,24,5,39
2019,Pakistan,PAK,Belgium,BEL,10,0,21,25,56
2019,Romania,ROU,Belgium,BEL,0,0,5,0,5
2019,Russian Federation,RUS,Belgium,BEL,81,0,135,71,287
2019,Rwanda,RWA,Belgium,BEL,37,0,27,26,90
2019,El Salvador,SLV,Belgium,BEL,94,0,0,0,94
2019,Serbia and Kosovo: S/RES/1244 (1999),SRB,Belgium,BEL,12,0,100,40,152
2019,Senegal,SEN,Belgium,BEL,10,0,18,5,33
2019,Sierra Leone,SLE,Belgium,BEL,0,0,15,5,20
2019,Somalia,SOM,Belgium,BEL,73,17,57,69,216
2019,Viet Nam,VNM,Belgium,BEL,0,0,5,5,10
2019,Sudan,SDN,Belgium,BEL,10,0,24,5,39
2019,Suriname,SUR,Belgium,BEL,0,0,5,0,5
2019,Syrian Arab Rep.,SYR,Belgium,BEL,713,163,199,65,1140
2019,Tajikistan,TJK,Belgium,BEL,0,0,5,0,5
2019,Togo,TGO,Belgium,BEL,12,0,21,5,38
2019,Tunisia,TUN,Belgium,BEL,0,0,11,0,11
2019,Turkey,TUR,Belgium,BEL,367,0,104,42,513
2019,Ukraine,UKR,Belgium,BEL,15,0,39,17,71
2019,Venezuela (Bolivarian Republic of),VEN,Belgium,BEL,83,5,180,5,273
2019,Yemen,YEM,Belgium,BEL,0,12,5,0,17
2019,Unknown ,,Belgium,BEL,147,5,136,25,313
2019,Central African Rep.,CAF,Benin,BEN,38,0,0,0,38
2019,Cameroon,CMR,Benin,BEN,5,0,0,0,5
2019,Cote d'Ivoire,CIV,Benin,BEN,0,0,5,0,5
2019,Togo,TGO,Benin,BEN,0,0,18,0,18
2019,Yemen,YEM,Benin,BEN,5,0,0,0,5
2019,Central African Rep.,CAF,Burkina Faso,BFA,19,0,0,5,24
2019,Turkey,TUR,Burkina Faso,BFA,10,0,0,0,10
2019,Afghanistan,AFG,Belarus,BLR,10,5,20,0,35
2019,Armenia,ARM,Belarus,BLR,0,0,5,0,5
2019,Cuba,CUB,Belarus,BLR,0,0,5,0,5
2019,India,IND,Belarus,BLR,0,0,0,5,5
2019,Kyrgyzstan,KGZ,Belarus,BLR,0,0,0,5,5
2019,Russian Federation,RUS,Belarus,BLR,0,0,10,0,10
2019,Syrian Arab Rep.,SYR,Belarus,BLR,0,11,0,0,11
2019,Turkey,TUR,Belarus,BLR,0,0,5,0,5
2019,Ukraine,UKR,Belarus,BLR,0,587,0,14,601
2019,Yemen,YEM,Belarus,BLR,0,5,0,0,5
2019,Argentina,ARG,Bolivia (Plurinational State of),BOL,0,0,5,0,5
2019,Colombia,COL,Bolivia (Plurinational State of),BOL,0,0,5,13,18
2019,Cuba,CUB,Bolivia (Plurinational State of),BOL,0,0,5,10,15
2019,Venezuela (Bolivarian Republic of),VEN,Bolivia (Plurinational State of),BOL,0,0,480,194,674
2019,Burundi,BDI,Botswana,BWA,26,0,0,10,36
2019,Dem. Rep. of the Congo,COD,Botswana,BWA,49,0,0,11,60
2019,Namibia,NAM,Botswana,BWA,0,0,0,15,15
2019,Zimbabwe,ZWE,Botswana,BWA,0,0,0,5,5
2019,Afghanistan,AFG,Brazil,BRA,11,0,0,0,11
2019,Angola,AGO,Brazil,BRA,5,0,176,48,229
2019,Egypt,EGY,Brazil,BRA,10,0,5,5,20
2019,Benin,BEN,Brazil,BRA,0,0,5,5,10
2019,Bangladesh,BGD,Brazil,BRA,5,0,47,13,65
2019,China,CHN,Brazil,BRA,0,0,5,28,33
2019,Cameroon,CMR,Brazil,BRA,5,0,5,5,15
2019,Dem. Rep. of the Congo,COD,Brazil,BRA,86,0,11,39,136
2019,Colombia,COL,Brazil,BRA,0,0,0,10,10
2019,Cuba,CUB,Brazil,BRA,39,0,10,230,279
2019,Dominican Rep.,DOM,Brazil,BRA,0,0,5,5,10
2019,Gambia,GMB,Brazil,BRA,0,0,16,5,21
2019,Palestinian,PSE,Brazil,BRA,20,0,0,0,20
2019,Ghana,GHA,Brazil,BRA,0,0,10,15,25
2019,Guinea-Bissau,GNB,Brazil,BRA,0,0,58,16,74
2019,Guinea,GIN,Brazil,BRA,10,0,10,5,25
2019,Haiti,HTI,Brazil,BRA,0,0,12,259,271
2019,Honduras,HND,Brazil,BRA,5,0,0,0,5
2019,Cote d'Ivoire,CIV,Brazil,BRA,5,0,0,0,5
2019,India,IND,Brazil,BRA,0,0,0,5,5
2019,Iran (Islamic Rep. of),IRN,Brazil,BRA,5,0,0,0,5
2019,Iraq,IRQ,Brazil,BRA,5,0,0,5,10
2019,Jordan,JOR,Brazil,BRA,0,0,5,0,5
2019,Kenya,KEN,Brazil,BRA,5,0,5,0,10
2019,Lebanon,LBN,Brazil,BRA,0,0,43,5,48
2019,Mauritania,MRT,Brazil,BRA,19,0,0,0,19
2019,Mali,MLI,Brazil,BRA,13,0,10,0,23
2019,Morocco,MAR,Brazil,BRA,0,0,5,5,10
2019,Nigeria,NGA,Brazil,BRA,0,0,16,31,47
2019,Pakistan,PAK,Brazil,BRA,15,0,11,14,40
2019,Peru,PER,Brazil,BRA,0,0,0,5,5
2019,Philippines,PHL,Brazil,BRA,0,0,0,5,5
2019,South Africa,ZAF,Brazil,BRA,0,0,5,0,5
2019,El Salvador,SLV,Brazil,BRA,28,0,0,0,28
2019,Senegal,SEN,Brazil,BRA,0,0,94,12,106
2019,Sierra Leone,SLE,Brazil,BRA,0,0,5,5,10
2019,Syrian Arab Rep.,SYR,Brazil,BRA,324,0,0,11,335
2019,Togo,TGO,Brazil,BRA,5,0,10,5,20
2019,Tunisia,TUN,Brazil,BRA,0,0,0,5,5
2019,Turkey,TUR,Brazil,BRA,0,0,0,5,5
2019,Ukraine,UKR,Brazil,BRA,5,0,0,0,5
2019,Venezuela (Bolivarian Republic of),VEN,Brazil,BRA,20907,0,0,4892,25799
2019,Yemen,YEM,Brazil,BRA,0,0,0,5,5
2019,Afghanistan,AFG,Bosnia and Herzegovina,BIH,0,0,14,177,191
2019,Palestinian,PSE,Bosnia and Herzegovina,BIH,0,0,0,15,15
2019,India,IND,Bosnia and Herzegovina,BIH,0,0,0,11,11
2019,Iran (Islamic Rep. of),IRN,Bosnia and Herzegovina,BIH,5,0,5,315,325
2019,Iraq,IRQ,Bosnia and Herzegovina,BIH,0,0,0,186,186
2019,Libya,LBY,Bosnia and Herzegovina,BIH,0,0,5,5,10
2019,Morocco,MAR,Bosnia and Herzegovina,BIH,0,0,0,10,10
2019,Nepal,NPL,Bosnia and Herzegovina,BIH,0,0,0,5,5
2019,Pakistan,PAK,Bosnia and Herzegovina,BIH,0,0,5,163,168
2019,Somalia,SOM,Bosnia and Herzegovina,BIH,0,0,0,5,5
2019,Syrian Arab Rep.,SYR,Bosnia and Herzegovina,BIH,0,12,0,66,78
2019,Turkey,TUR,Bosnia and Herzegovina,BIH,0,29,0,15,44
2019,Yemen,YEM,Bosnia and Herzegovina,BIH,0,0,0,5,5
2019,Cuba,CUB,Belize,BLZ,0,0,0,5,5
2019,Guatemala,GTM,Belize,BLZ,0,0,0,51,51
2019,Honduras,HND,Belize,BLZ,0,0,10,268,278
2019,Nicaragua,NIC,Belize,BLZ,0,0,0,50,50
2019,El Salvador,SLV,Belize,BLZ,0,0,23,1286,1309
2019,Afghanistan,AFG,Canada,CAN,507,0,78,21,606
2019,Albania,ALB,Canada,CAN,68,0,33,5,106
2019,Algeria,DZA,Canada,CAN,72,0,70,28,170
2019,Angola,AGO,Canada,CAN,113,0,94,18,225
2019,Antigua and Barbuda,ATG,Canada,CAN,5,0,5,0,10
2019,Egypt,EGY,Canada,CAN,1030,0,102,29,1161
2019,Argentina,ARG,Canada,CAN,0,0,5,0,5
2019,Armenia,ARM,Canada,CAN,10,0,5,0,15
2019,Azerbaijan,AZE,Canada,CAN,133,0,39,14,186
2019,Bahrain,BHR,Canada,CAN,5,0,5,0,10
2019,Barbados,BRB,Canada,CAN,37,0,14,5,56
2019,Burundi,BDI,Canada,CAN,861,0,15,16,892
2019,Belgium,BEL,Canada,CAN,0,0,10,5,15
2019,Benin,BEN,Canada,CAN,5,0,5,0,10
2019,Bangladesh,BGD,Canada,CAN,253,0,155,49,457
2019,Bahamas,BHS,Canada,CAN,102,0,61,18,181
2019,Burkina Faso,BFA,Canada,CAN,13,0,5,5,23
2019,Bolivia (Plurinational State of),BOL,Canada,CAN,0,0,5,0,5
2019,Botswana,BWA,Canada,CAN,0,0,5,0,5
2019,Brazil,BRA,Canada,CAN,32,0,111,19,162
2019,Bulgaria,BGR,Canada,CAN,31,0,0,20,51
2019,Cambodia,KHM,Canada,CAN,11,0,5,0,16
2019,Central African Rep.,CAF,Canada,CAN,5,0,0,0,5
2019,Chad,TCD,Canada,CAN,96,0,10,13,119
2019,China,CHN,Canada,CAN,492,0,477,85,1054
2019,Chile,CHL,Canada,CAN,23,0,43,5,71
2019,Cameroon,CMR,Canada,CAN,143,0,53,21,217
2019,Congo,COG,Canada,CAN,21,0,19,5,45
2019,Dem. Rep. of the Congo,COD,Canada,CAN,220,0,226,78,524
2019,Colombia,COL,Canada,CAN,937,0,398,176,1511
2019,Costa Rica,CRI,Canada,CAN,0,0,5,0,5
2019,Cuba,CUB,Canada,CAN,18,0,13,10,41
2019,Cyprus,CYP,Canada,CAN,0,0,5,0,5
2019,Czechia,CZE,Canada,CAN,55,0,10,43,108
2019,Denmark,DNK,Canada,CAN,5,0,5,0,10
2019,Djibouti,DJI,Canada,CAN,150,0,32,14,196
2019,Dominica,DMA,Canada,CAN,0,0,5,5,10
2019,Dominican Rep.,DOM,Canada,CAN,16,0,18,11,45
2019,Ecuador,ECU,Canada,CAN,5,0,14,5,24
2019,Equatorial Guinea,GNQ,Canada,CAN,0,0,5,0,5
2019,Eritrea,ERI,Canada,CAN,516,0,57,53,626
2019,Ethiopia,ETH,Canada,CAN,308,0,129,25,462
2019,Fiji,FJI,Canada,CAN,5,0,0,0,5
2019,France,FRA,Canada,CAN,0,0,10,5,15
2019,Gabon,GAB,Canada,CAN,5,0,5,0,10
2019,Gambia,GMB,Canada,CAN,5,0,13,5,23
2019,Palestinian,PSE,Canada,CAN,432,0,148,26,606
2019,Georgia,GEO,Canada,CAN,51,0,29,11,91
2019,Germany,DEU,Canada,CAN,5,0,5,12,22
2019,Ghana,GHA,Canada,CAN,39,0,71,10,120
2019,Greece,GRC,Canada,CAN,5,0,5,0,10
2019,Guatemala,GTM,Canada,CAN,60,0,19,25,104
2019,Guinea,GIN,Canada,CAN,45,0,21,13,79
2019,Guyana,GUY,Canada,CAN,11,0,18,0,29
2019,Haiti,HTI,Canada,CAN,1226,0,1774,116,3116
2019,Honduras,HND,Canada,CAN,88,0,26,18,132
2019,Hungary,HUN,Canada,CAN,134,0,61,140,335
2019,Cote d'Ivoire,CIV,Canada,CAN,11,0,13,5,29
2019,India,IND,Canada,CAN,359,0,503,331,1193
2019,Indonesia,IDN,Canada,CAN,23,0,5,0,28
2019,Ireland,IRL,Canada,CAN,0,0,0,15,15
2019,Iran (Islamic Rep. of),IRN,Canada,CAN,2674,0,169,83,2926
2019,Iraq,IRQ,Canada,CAN,468,0,119,41,628
2019,Israel,ISR,Canada,CAN,24,0,18,5,47
2019,Italy,ITA,Canada,CAN,5,0,20,20,45
2019,Jamaica,JAM,Canada,CAN,80,0,67,20,167
2019,Jordan,JOR,Canada,CAN,141,0,155,27,323
2019,Japan,JPN,Canada,CAN,0,0,5,0,5
2019,Kazakhstan,KAZ,Canada,CAN,5,0,5,0,10
2019,Kenya,KEN,Canada,CAN,74,0,44,18,136
2019,Rep. of Korea,KOR,Canada,CAN,0,0,5,5,10
2019,Kuwait,KWT,Canada,CAN,16,0,0,0,16
2019,Liberia,LBR,Canada,CAN,10,0,5,5,20
2019,Libya,LBY,Canada,CAN,331,0,40,21,392
2019,Saint Lucia,LCA,Canada,CAN,5,0,10,5,20
2019,Lebanon,LBN,Canada,CAN,158,0,81,14,253
2019,Sri Lanka,LKA,Canada,CAN,230,0,78,21,329
2019,Mauritania,MRT,Canada,CAN,14,0,5,5,24
2019,Rep. of Moldova,MDA,Canada,CAN,5,0,0,0,5
2019,Mexico,MEX,Canada,CAN,601,0,1013,679,2293
2019,Mali,MLI,Canada,CAN,11,0,0,5,16
2019,Malaysia,MYS,Canada,CAN,10,0,5,0,15
2019,Malawi,MWI,Canada,CAN,5,0,5,0,10
2019,Mongolia,MNG,Canada,CAN,17,0,0,5,22
2019,Morocco,MAR,Canada,CAN,5,0,10,5,20
2019,Mozambique,MOZ,Canada,CAN,0,0,5,0,5
2019,Mauritius,MUS,Canada,CAN,5,0,0,0,5
2019,Myanmar,MMR,Canada,CAN,14,0,5,0,19
2019,Nepal,NPL,Canada,CAN,71,0,18,10,99
2019,Netherlands,NLD,Canada,CAN,5,0,10,5,20
2019,Niger,NER,Canada,CAN,14,0,11,5,30
2019,Nicaragua,NIC,Canada,CAN,145,0,5,12,162
2019,Nigeria,NGA,Canada,CAN,1698,0,3835,133,5666
2019,Norway,NOR,Canada,CAN,0,0,5,0,5
2019,Pakistan,PAK,Canada,CAN,1376,0,456,69,1901
2019,Panama,PAN,Canada,CAN,5,0,10,0,15
2019,Paraguay,PRY,Canada,CAN,5,0,0,0,5
2019,Peru,PER,Canada,CAN,42,0,30,11,83
2019,Philippines,PHL,Canada,CAN,10,0,5,5,20
2019,Poland,POL,Canada,CAN,11,0,17,15,43
2019,Portugal,PRT,Canada,CAN,0,0,0,5,5
2019,Romania,ROU,Canada,CAN,170,0,73,526,769
2019,South Africa,ZAF,Canada,CAN,28,0,61,10,99
2019,Russian Federation,RUS,Canada,CAN,105,0,14,11,130
2019,Rwanda,RWA,Canada,CAN,269,0,20,13,302
2019,El Salvador,SLV,Canada,CAN,253,0,138,17,408
2019,Saudi Arabia,SAU,Canada,CAN,200,0,24,29,253
2019,Serbia and Kosovo: S/RES/1244 (1999),SRB,Canada,CAN,23,0,10,18,51
2019,Senegal,SEN,Canada,CAN,11,0,18,5,34
2019,Somalia,SOM,Canada,CAN,225,0,84,39,348
2019,Spain,ESP,Canada,CAN,5,0,13,5,23
2019,Viet Nam,VNM,Canada,CAN,15,0,5,5,25
2019,Sudan,SDN,Canada,CAN,633,0,26,34,693
2019,South Sudan,SSD,Canada,CAN,10,0,0,0,10
2019,Slovakia,SVK,Canada,CAN,141,0,15,42,198
2019,Sweden,SWE,Canada,CAN,0,0,0,10,10
2019,Syrian Arab Rep.,SYR,Canada,CAN,646,0,42,56,744
2019,United Rep. of Tanzania,TZA,Canada,CAN,32,0,10,10,52
2019,Thailand,THA,Canada,CAN,0,0,5,0,5
2019,Tajikistan,TJK,Canada,CAN,5,0,0,0,5
2019,Turkmenistan,TKM,Canada,CAN,5,0,0,0,5
2019,Togo,TGO,Canada,CAN,10,0,5,5,20
2019,Trinidad and Tobago,TTO,Canada,CAN,10,0,5,0,15
2019,Tunisia,TUN,Canada,CAN,21,0,12,5,38
2019,Turkey,TUR,Canada,CAN,1967,0,51,57,2075
2019,United Arab Emirates,ARE,Canada,CAN,0,0,5,5,10
2019,Uganda,UGA,Canada,CAN,175,0,47,13,235
2019,Ukraine,UKR,Canada,CAN,59,0,36,12,107
2019,Uruguay,URY,Canada,CAN,0,0,5,0,5
2019,United States of America,USA,Canada,CAN,29,0,1136,127,1292
2019,Uzbekistan,UZB,Canada,CAN,13,0,5,0,18
2019,Saint Vincent and the Grenadines,VCT,Canada,CAN,5,0,11,0,16
2019,Venezuela (Bolivarian Republic of),VEN,Canada,CAN,1305,0,123,41,1469
2019,Yemen,YEM,Canada,CAN,686,0,29,13,728
2019,Zambia,ZMB,Canada,CAN,5,0,0,0,5
2019,Zimbabwe,ZWE,Canada,CAN,72,0,30,5,107
2019,Unknown ,,Canada,CAN,1004,0,519,237,1760
2019,Cuba,CUB,Cayman Islands,CYM,5,0,5,5,15
2019,Mexico,MEX,Cayman Islands,CYM,0,0,5,0,5
2019,Angola,AGO,Chile,CHL,0,0,0,5,5
2019,Colombia,COL,Chile,CHL,10,0,191,1257,1458
2019,Cuba,CUB,Chile,CHL,0,0,318,1793,2111
2019,Dominican Rep.,DOM,Chile,CHL,0,0,13,46,59
2019,Palestinian,PSE,Chile,CHL,0,0,5,5,10
2019,Haiti,HTI,Chile,CHL,0,0,0,5,5
2019,Peru,PER,Chile,CHL,0,0,0,5,5
2019,Syrian Arab Rep.,SYR,Chile,CHL,5,0,0,5,10
2019,Venezuela (Bolivarian Republic of),VEN,Chile,CHL,5,0,29,526,560
2019,Yemen,YEM,Chile,CHL,0,0,0,5,5
2019,Algeria,DZA,Congo,COG,0,0,0,5,5
2019,Angola,AGO,Congo,COG,0,0,0,32,32
2019,Burundi,BDI,Congo,COG,0,0,0,5,5
2019,Central African Rep.,CAF,Congo,COG,29,0,0,1691,1720
2019,Chad,TCD,Congo,COG,0,0,0,14,14
2019,Cameroon,CMR,Congo,COG,0,0,0,10,10
2019,Dem. Rep. of the Congo,COD,Congo,COG,0,0,110,1559,1669
2019,Guinea,GIN,Congo,COG,0,0,0,5,5
2019,Cote d'Ivoire,CIV,Congo,COG,0,0,0,28,28
2019,Liberia,LBR,Congo,COG,0,0,0,10,10
2019,Mauritania,MRT,Congo,COG,0,0,0,49,49
2019,Mali,MLI,Congo,COG,0,0,0,11,11
2019,Niger,NER,Congo,COG,0,0,0,5,5
2019,Rwanda,RWA,Congo,COG,0,0,53,85,138
2019,Sudan,SDN,Congo,COG,0,0,0,26,26
2019,South Sudan,SSD,Congo,COG,0,0,0,11,11
2019,Syrian Arab Rep.,SYR,Congo,COG,0,0,0,5,5
2019,Turkey,TUR,Congo,COG,0,0,0,5,5
2019,Burundi,BDI,Dem. Rep. of the Congo,COD,2725,0,0,0,2725
2019,Central African Rep.,CAF,Dem. Rep. of the Congo,COD,1254,0,0,0,1254
2019,Cameroon,CMR,Dem. Rep. of the Congo,COD,0,0,0,10,10
2019,Congo,COG,Dem. Rep. of the Congo,COD,0,0,10,0,10
2019,Cote d'Ivoire,CIV,Dem. Rep. of the Congo,COD,5,0,0,0,5
2019,Liberia,LBR,Dem. Rep. of the Congo,COD,5,0,0,0,5
2019,Mali,MLI,Dem. Rep. of the Congo,COD,0,0,0,5,5
2019,Nepal,NPL,Dem. Rep. of the Congo,COD,0,0,0,5,5
2019,Rwanda,RWA,Dem. Rep. of the Congo,COD,38,0,0,0,38
2019,South Sudan,SSD,Dem. Rep. of the Congo,COD,7121,0,0,0,7121
2019,Turkey,TUR,Colombia,COL,5,0,0,0,5
2019,Venezuela (Bolivarian Republic of),VEN,Colombia,COL,332,0,0,4052,4384
2019,Angola,AGO,Costa Rica,CRI,0,0,5,0,5
2019,Argentina,ARG,Costa Rica,CRI,0,0,0,5,5
2019,Burkina Faso,BFA,Costa Rica,CRI,0,0,5,0,5
2019,China,CHN,Costa Rica,CRI,0,0,0,10,10
2019,Dem. Rep. of the Congo,COD,Costa Rica,CRI,5,0,5,0,10
2019,Colombia,COL,Costa Rica,CRI,10,0,105,318,433
2019,Cuba,CUB,Costa Rica,CRI,5,0,26,95,126
2019,Guatemala,GTM,Costa Rica,CRI,5,0,5,10,20
2019,Haiti,HTI,Costa Rica,CRI,0,0,10,20,30
2019,Honduras,HND,Costa Rica,CRI,15,0,10,76,101
2019,India,IND,Costa Rica,CRI,0,0,5,0,5
2019,Mexico,MEX,Costa Rica,CRI,0,0,0,5,5
2019,Nicaragua,NIC,Costa Rica,CRI,943,0,2948,7053,10944
2019,Russian Federation,RUS,Costa Rica,CRI,5,0,0,0,5
2019,El Salvador,SLV,Costa Rica,CRI,207,0,1436,673,2316
2019,Spain,ESP,Costa Rica,CRI,0,0,0,5,5
2019,United States of America,USA,Costa Rica,CRI,5,0,0,5,10
2019,Venezuela (Bolivarian Republic of),VEN,Costa Rica,CRI,135,0,282,741,1158
2019,Egypt,EGY,Cyprus,CYP,5,0,169,76,250
2019,Bangladesh,BGD,Cyprus,CYP,0,0,327,109,436
2019,China,CHN,Cyprus,CYP,0,0,0,5,5
2019,Cameroon,CMR,Cyprus,CYP,10,0,15,17,42
2019,Congo,COG,Cyprus,CYP,5,0,5,0,10
2019,Dem. Rep. of the Congo,COD,Cyprus,CYP,0,0,12,0,12
2019,Gambia,GMB,Cyprus,CYP,0,0,0,5,5
2019,Palestinian,PSE,Cyprus,CYP,36,22,0,0,58
2019,Georgia,GEO,Cyprus,CYP,0,0,319,197,516
2019,Guinea,GIN,Cyprus,CYP,0,0,0,5,5
2019,India,IND,Cyprus,CYP,0,0,419,304,723
2019,Iran (Islamic Rep. of),IRN,Cyprus,CYP,13,0,29,35,77
2019,Iraq,IRQ,Cyprus,CYP,23,5,70,83,181
2019,Jordan,JOR,Cyprus,CYP,0,0,0,26,26
2019,Libya,LBY,Cyprus,CYP,0,10,0,0,10
2019,Lebanon,LBN,Cyprus,CYP,0,0,0,16,16
2019,Sri Lanka,LKA,Cyprus,CYP,0,0,84,42,126
2019,Nepal,NPL,Cyprus,CYP,0,0,102,47,149
2019,Nigeria,NGA,Cyprus,CYP,0,0,18,25,43
2019,Pakistan,PAK,Cyprus,CYP,0,0,241,225,466
2019,Philippines,PHL,Cyprus,CYP,0,0,48,37,85
2019,Russian Federation,RUS,Cyprus,CYP,0,0,0,10,10
2019,Somalia,SOM,Cyprus,CYP,10,26,5,10,51
2019,Viet Nam,VNM,Cyprus,CYP,0,0,170,110,280
2019,Syrian Arab Rep.,SYR,Cyprus,CYP,38,1074,0,0,1112
2019,Turkey,TUR,Cyprus,CYP,0,5,0,10,15
2019,Ukraine,UKR,Cyprus,CYP,0,0,0,5,5
2019,Yemen,YEM,Cyprus,CYP,0,5,0,0,5
2019,Afghanistan,AFG,Czechia,CZE,0,0,5,21,26
2019,Albania,ALB,Czechia,CZE,0,0,5,0,5
2019,Algeria,DZA,Czechia,CZE,0,0,12,5,17
2019,Egypt,EGY,Czechia,CZE,5,0,0,5,10
2019,Armenia,ARM,Czechia,CZE,0,0,66,363,429
2019,Azerbaijan,AZE,Czechia,CZE,0,0,25,34,59
2019,Belarus,BLR,Czechia,CZE,0,5,15,5,25
2019,China,CHN,Czechia,CZE,0,10,0,14,24
2019,Comoros,COM,Czechia,CZE,0,0,0,5,5
2019,Cuba,CUB,Czechia,CZE,5,0,15,17,37
2019,Ethiopia,ETH,Czechia,CZE,0,0,5,0,5
2019,Georgia,GEO,Czechia,CZE,0,0,149,79,228
2019,India,IND,Czechia,CZE,0,0,5,10,15
2019,Iran (Islamic Rep. of),IRN,Czechia,CZE,0,0,16,24,40
2019,Iraq,IRQ,Czechia,CZE,0,0,21,13,34
2019,Kazakhstan,KAZ,Czechia,CZE,0,0,28,49,77
2019,Kyrgyzstan,KGZ,Czechia,CZE,5,5,18,13,41
2019,Libya,LBY,Czechia,CZE,0,11,0,10,21
2019,Rep. of Moldova,MDA,Czechia,CZE,0,0,37,10,47
2019,Mongolia,MNG,Czechia,CZE,0,0,12,19,31
2019,Nigeria,NGA,Czechia,CZE,0,0,5,11,16
2019,Pakistan,PAK,Czechia,CZE,0,0,10,10,20
2019,Poland,POL,Czechia,CZE,0,0,0,5,5
2019,Russian Federation,RUS,Czechia,CZE,26,0,35,36,97
2019,Saudi Arabia,SAU,Czechia,CZE,0,5,0,0,5
2019,Serbia and Kosovo: S/RES/1244 (1999),SRB,Czechia,CZE,0,0,10,5,15
2019,Somalia,SOM,Czechia,CZE,0,5,0,0,5
2019,Viet Nam,VNM,Czechia,CZE,0,0,100,37,137
2019,Syrian Arab Rep.,SYR,Czechia,CZE,0,22,0,10,32
2019,Tunisia,TUN,Czechia,CZE,0,0,5,5,10
2019,Turkey,TUR,Czechia,CZE,5,0,17,15,37
2019,Ukraine,UKR,Czechia,CZE,5,10,272,148,435
2019,Uzbekistan,UZB,Czechia,CZE,0,0,57,22,79
2019,Venezuela (Bolivarian Republic of),VEN,Czechia,CZE,0,0,0,5,5
2019,Yemen,YEM,Czechia,CZE,0,5,0,5,10
2019,Stateless,XXA,Czechia,CZE,0,10,0,5,15
2019,Afghanistan,AFG,Denmark,DNK,5,12,57,0,74
2019,Albania,ALB,Denmark,DNK,0,0,53,0,53
2019,Algeria,DZA,Denmark,DNK,0,0,13,0,13
2019,Egypt,EGY,Denmark,DNK,0,0,5,0,5
2019,Armenia,ARM,Denmark,DNK,0,0,17,0,17
2019,Burundi,BDI,Denmark,DNK,0,0,5,0,5
2019,Bangladesh,BGD,Denmark,DNK,0,0,5,0,5
2019,Bosnia and Herzegovina,BIH,Denmark,DNK,0,0,5,0,5
2019,Bulgaria,BGR,Denmark,DNK,0,0,5,0,5
2019,China,CHN,Denmark,DNK,5,0,5,0,10
2019,Cameroon,CMR,Denmark,DNK,0,0,12,0,12
2019,Dem. Rep. of the Congo,COD,Denmark,DNK,0,0,13,0,13
2019,Colombia,COL,Denmark,DNK,0,0,24,0,24
2019,Eritrea,ERI,Denmark,DNK,207,498,26,0,731
2019,Georgia,GEO,Denmark,DNK,0,0,133,0,133
2019,Guinea,GIN,Denmark,DNK,0,0,5,0,5
2019,India,IND,Denmark,DNK,0,0,11,0,11
2019,Indonesia,IDN,Denmark,DNK,0,0,5,0,5
2019,Iran (Islamic Rep. of),IRN,Denmark,DNK,47,10,96,0,153
2019,Iraq,IRQ,Denmark,DNK,0,11,72,0,83
2019,Jordan,JOR,Denmark,DNK,0,0,17,0,17
2019,Kenya,KEN,Denmark,DNK,0,0,5,0,5
2019,Kuwait,KWT,Denmark,DNK,0,0,5,0,5
2019,Libya,LBY,Denmark,DNK,0,0,5,0,5
2019,Lebanon,LBN,Denmark,DNK,0,0,5,0,5
2019,Sri Lanka,LKA,Denmark,DNK,0,0,10,0,10
2019,Lithuania,LTU,Denmark,DNK,0,0,11,0,11
2019,Latvia,LVA,Denmark,DNK,0,0,5,0,5
2019,Morocco,MAR,Denmark,DNK,0,0,37,0,37
2019,Myanmar,MMR,Denmark,DNK,5,0,10,0,15
2019,Nicaragua,NIC,Denmark,DNK,0,0,22,0,22
2019,Nigeria,NGA,Denmark,DNK,0,0,17,0,17
2019,Pakistan,PAK,Denmark,DNK,5,0,14,0,19
2019,Poland,POL,Denmark,DNK,0,0,5,0,5
2019,Romania,ROU,Denmark,DNK,0,0,10,0,10
2019,Russian Federation,RUS,Denmark,DNK,5,0,39,0,44
2019,Rwanda,RWA,Denmark,DNK,0,0,5,0,5
2019,Serbia and Kosovo: S/RES/1244 (1999),SRB,Denmark,DNK,0,0,21,0,21
2019,Senegal,SEN,Denmark,DNK,0,0,5,0,5
2019,Somalia,SOM,Denmark,DNK,5,13,121,0,139
2019,Sudan,SDN,Denmark,DNK,0,0,5,0,5
2019,Sweden,SWE,Denmark,DNK,0,0,5,0,5
2019,Syrian Arab Rep.,SYR,Denmark,DNK,137,336,28,0,501
2019,Tunisia,TUN,Denmark,DNK,0,0,10,0,10
2019,Turkey,TUR,Denmark,DNK,5,0,14,0,19
2019,Uganda,UGA,Denmark,DNK,0,0,5,0,5
2019,Ukraine,UKR,Denmark,DNK,0,0,20,0,20
2019,United States of America,USA,Denmark,DNK,0,0,5,0,5
2019,Venezuela (Bolivarian Republic of),VEN,Denmark,DNK,0,0,5,0,5
2019,Stateless,XXA,Denmark,DNK,214,5,94,0,313
2019,Unknown ,,Denmark,DNK,0,0,5,0,5
2019,Eritrea,ERI,Djibouti,DJI,50,0,0,49,99
2019,Ethiopia,ETH,Djibouti,DJI,0,0,0,59,59
2019,Somalia,SOM,Djibouti,DJI,0,0,0,11,11
2019,Egypt,EGY,Estonia,EST,5,0,0,0,5
2019,Armenia,ARM,Estonia,EST,0,0,5,0,5
2019,Georgia,GEO,Estonia,EST,0,0,5,0,5
2019,Pakistan,PAK,Estonia,EST,5,0,0,0,5
2019,Russian Federation,RUS,Estonia,EST,11,0,13,0,24
2019,Syrian Arab Rep.,SYR,Estonia,EST,5,5,0,0,10
2019,Turkey,TUR,Estonia,EST,16,0,0,0,16
2019,Ukraine,UKR,Estonia,EST,5,0,10,0,15
2019,Afghanistan,AFG,Fiji,FJI,5,0,0,0,5
2019,Pakistan,PAK,Fiji,FJI,5,0,0,0,5
2019,Afghanistan,AFG,France,FRA,495,4037,3093,41,7666
2019,Albania,ALB,France,FRA,114,304,7166,147,7731
2019,Algeria,DZA,France,FRA,110,54,1985,62,2211
2019,Angola,AGO,France,FRA,48,25,536,5,614
2019,Egypt,EGY,France,FRA,40,5,312,5,362
2019,Armenia,ARM,France,FRA,27,41,1339,35,1442
2019,Austria,AUT,France,FRA,0,0,5,0,5
2019,Azerbaijan,AZE,France,FRA,36,5,181,5,227
2019,Burundi,BDI,France,FRA,256,0,102,0,358
2019,Benin,BEN,France,FRA,17,5,72,5,99
2019,Bangladesh,BGD,France,FRA,182,79,3437,10,3708
2019,Burkina Faso,BFA,France,FRA,16,5,98,0,119
2019,Belarus,BLR,France,FRA,10,0,37,10,57
2019,Bolivia (Plurinational State of),BOL,France,FRA,0,0,12,0,12
2019,Brazil,BRA,France,FRA,5,0,44,5,54
2019,Bosnia and Herzegovina,BIH,France,FRA,22,10,375,10,417
2019,Bulgaria,BGR,France,FRA,0,0,5,0,5
2019,Cambodia,KHM,France,FRA,0,0,42,0,42
2019,Canada,CAN,France,FRA,0,0,5,0,5
2019,Central African Rep.,CAF,France,FRA,241,84,212,0,537
2019,Chad,TCD,France,FRA,121,17,592,10,740
2019,China,CHN,France,FRA,1180,0,1530,5,2715
2019,Chile,CHL,France,FRA,0,0,5,0,5
2019,Cameroon,CMR,France,FRA,102,24,416,13,555
2019,Congo,COG,France,FRA,77,14,507,10,608
2019,Dem. Rep. of the Congo,COD,France,FRA,663,97,2234,13,3007
2019,Comoros,COM,France,FRA,36,10,471,28,545
2019,Colombia,COL,France,FRA,13,35,148,12,208
2019,Cuba,CUB,France,FRA,10,0,68,0,78
2019,Djibouti,DJI,France,FRA,5,0,24,0,29
2019,Dominica,DMA,France,FRA,0,0,5,0,5
2019,Dominican Rep.,DOM,France,FRA,5,15,352,13,385
2019,Equatorial Guinea,GNQ,France,FRA,0,0,5,0,5
2019,Eritrea,ERI,France,FRA,1153,5,249,5,1412
2019,Ethiopia,ETH,France,FRA,187,5,241,5,438
2019,Gabon,GAB,France,FRA,16,5,130,10,161
2019,Gambia,GMB,France,FRA,25,5,142,0,172
2019,Palestinian,PSE,France,FRA,135,5,129,5,274
2019,United Kingdom of Great Britain and Northern Ireland,GBR,France,FRA,0,0,5,0,5
2019,Georgia,GEO,France,FRA,101,118,7058,101,7378
2019,Germany,DEU,France,FRA,0,0,5,0,5
2019,Ghana,GHA,France,FRA,5,0,81,0,86
2019,Guinea-Bissau,GNB,France,FRA,5,5,56,0,66
2019,Greece,GRC,France,FRA,0,0,10,0,10
2019,Guinea,GIN,France,FRA,910,124,5452,22,6508
2019,Guyana,GUY,France,FRA,0,0,17,0,17
2019,Haiti,HTI,France,FRA,163,98,3884,27,4172
2019,Honduras,HND,France,FRA,0,5,10,0,15
2019,Croatia,HRV,France,FRA,0,0,5,0,5
2019,Hungary,HUN,France,FRA,0,0,5,0,5
2019,Cote d'Ivoire,CIV,France,FRA,673,131,2968,51,3823
2019,India,IND,France,FRA,5,5,276,19,305
2019,Iran (Islamic Rep. of),IRN,France,FRA,105,5,366,14,490
2019,Iraq,IRQ,France,FRA,676,33,379,31,1119
2019,Italy,ITA,France,FRA,0,0,5,0,5
2019,Jamaica,JAM,France,FRA,5,0,5,0,10
2019,Jordan,JOR,France,FRA,5,0,5,0,10
2019,Japan,JPN,France,FRA,0,0,5,0,5
2019,Kazakhstan,KAZ,France,FRA,5,5,137,12,159
2019,Kenya,KEN,France,FRA,5,0,19,0,24
2019,Kyrgyzstan,KGZ,France,FRA,5,0,16,5,26
2019,Kuwait,KWT,France,FRA,23,0,14,0,37
2019,Lao People's Dem. Rep.,LAO,France,FRA,0,0,5,0,5
2019,Liberia,LBR,France,FRA,5,5,19,0,29
2019,Libya,LBY,France,FRA,62,113,244,5,424
2019,Saint Lucia,LCA,France,FRA,0,0,5,0,5
2019,Lebanon,LBN,France,FRA,5,5,95,5,110
2019,Sri Lanka,LKA,France,FRA,214,29,1308,10,1561
2019,Madagascar,MDG,France,FRA,0,0,42,5,47
2019,Mauritania,MRT,France,FRA,136,5,1089,11,1241
2019,North Macedonia,MKD,France,FRA,5,5,521,60,591
2019,Rep. of Moldova,MDA,France,FRA,0,0,433,34,467
2019,Mali,MLI,France,FRA,328,20,3207,33,3588
2019,Malaysia,MYS,France,FRA,0,0,5,0,5
2019,Mongolia,MNG,France,FRA,10,13,142,5,170
2019,Morocco,MAR,France,FRA,72,15,416,19,522
2019,Montenegro,MNE,France,FRA,0,0,70,5,75
2019,Myanmar,MMR,France,FRA,5,0,13,0,18
2019,Nepal,NPL,France,FRA,0,0,75,0,75
2019,Niger,NER,France,FRA,5,5,33,0,43
2019,Nicaragua,NIC,France,FRA,23,0,5,5,33
2019,Nigeria,NGA,France,FRA,187,31,2488,15,2721
2019,Pakistan,PAK,France,FRA,48,17,1969,28,2062
2019,Peru,PER,France,FRA,0,10,57,0,67
2019,Romania,ROU,France,FRA,0,0,5,0,5
2019,South Africa,ZAF,France,FRA,5,0,14,0,19
2019,Russian Federation,RUS,France,FRA,232,53,1492,34,1811
2019,Rwanda,RWA,France,FRA,135,0,104,0,239
2019,El Salvador,SLV,France,FRA,0,5,13,0,18
2019,Saudi Arabia,SAU,France,FRA,5,0,0,0,5
2019,Serbia and Kosovo: S/RES/1244 (1999),SRB,France,FRA,132,111,2454,71,2768
2019,Senegal,SEN,France,FRA,143,23,1483,21,1670
2019,Sierra Leone,SLE,France,FRA,33,10,149,0,192
2019,Somalia,SOM,France,FRA,164,310,1338,10,1822
2019,Viet Nam,VNM,France,FRA,10,0,41,5,56
2019,Sudan,SDN,France,FRA,2397,199,1359,28,3983
2019,Suriname,SUR,France,FRA,0,0,5,0,5
2019,South Sudan,SSD,France,FRA,24,5,20,0,49
2019,Syrian Arab Rep.,SYR,France,FRA,869,1604,553,26,3052
2019,United Rep. of Tanzania,TZA,France,FRA,0,0,16,0,16
2019,Tajikistan,TJK,France,FRA,0,0,52,0,52
2019,Togo,TGO,France,FRA,5,5,109,0,119
2019,Tunisia,TUN,France,FRA,18,13,278,13,322
2019,Turkey,TUR,France,FRA,393,10,1570,37,2010
2019,Uganda,UGA,France,FRA,12,0,12,0,24
2019,Ukraine,UKR,France,FRA,50,32,450,79,611
2019,United States of America,USA,France,FRA,0,0,10,0,10
2019,Uzbekistan,UZB,France,FRA,0,0,10,0,10
2019,Venezuela (Bolivarian Republic of),VEN,France,FRA,169,49,245,23,486
2019,Western Sahara,ESH,France,FRA,28,14,229,0,271
2019,Yemen,YEM,France,FRA,32,69,71,5,177
2019,Zimbabwe,ZWE,France,FRA,0,0,5,0,5
2019,Stateless,XXA,France,FRA,56,0,308,16,380
2019,Unknown ,,France,FRA,6672,3178,14815,575,25240
2019,Afghanistan,AFG,United Kingdom of Great Britain and Northern Ireland,GBR,993,156,517,195,1861
2019,Albania,ALB,United Kingdom of Great Britain and Northern Ireland,GBR,279,55,1249,495,2078
2019,Algeria,DZA,United Kingdom of Great Britain and Northern Ireland,GBR,5,5,88,73,171
2019,Angola,AGO,United Kingdom of Great Britain and Northern Ireland,GBR,12,0,31,0,43
2019,Egypt,EGY,United Kingdom of Great Britain and Northern Ireland,GBR,58,5,161,26,250
2019,Armenia,ARM,United Kingdom of Great Britain and Northern Ireland,GBR,5,0,5,0,10
2019,Australia,AUS,United Kingdom of Great Britain and Northern Ireland,GBR,0,0,0,5,5
2019,Azerbaijan,AZE,United Kingdom of Great Britain and Northern Ireland,GBR,18,5,20,5,48
2019,Bahrain,BHR,United Kingdom of Great Britain and Northern Ireland,GBR,10,0,5,0,15
2019,Burundi,BDI,United Kingdom of Great Britain and Northern Ireland,GBR,5,0,0,0,5
2019,Benin,BEN,United Kingdom of Great Britain and Northern Ireland,GBR,0,0,5,5,10
2019,Bangladesh,BGD,United Kingdom of Great Britain and Northern Ireland,GBR,88,45,578,112,823
2019,Bahamas,BHS,United Kingdom of Great Britain and Northern Ireland,GBR,0,0,5,0,5
2019,Burkina Faso,BFA,United Kingdom of Great Britain and Northern Ireland,GBR,0,0,5,0,5
2019,Belarus,BLR,United Kingdom of Great Britain and Northern Ireland,GBR,5,0,0,0,5
2019,Bolivia (Plurinational State of),BOL,United Kingdom of Great Britain and Northern Ireland,GBR,5,0,25,11,41
2019,Botswana,BWA,United Kingdom of Great Britain and Northern Ireland,GBR,10,0,13,0,23
2019,Brazil,BRA,United Kingdom of Great Britain and Northern Ireland,GBR,0,5,55,54,114
2019,Bulgaria,BGR,United Kingdom of Great Britain and Northern Ireland,GBR,0,0,5,0,5
2019,Canada,CAN,United Kingdom of Great Britain and Northern Ireland,GBR,0,0,0,5,5
2019,Chad,TCD,United Kingdom of Great Britain and Northern Ireland,GBR,12,0,0,5,17
2019,China,CHN,United Kingdom of Great Britain and Northern Ireland,GBR,37,31,380,405,853
2019,Chile,CHL,United Kingdom of Great Britain and Northern Ireland,GBR,0,0,0,5,5
2019,Cameroon,CMR,United Kingdom of Great Britain and Northern Ireland,GBR,53,5,58,10,126
2019,Congo,COG,United Kingdom of Great Britain and Northern Ireland,GBR,0,0,5,0,5
2019,Dem. Rep. of the Congo,COD,United Kingdom of Great Britain and Northern Ireland,GBR,42,5,76,5,128
2019,Colombia,COL,United Kingdom of Great Britain and Northern Ireland,GBR,0,0,5,0,5
2019,Dominica,DMA,United Kingdom of Great Britain and Northern Ireland,GBR,5,0,5,0,10
2019,Ecuador,ECU,United Kingdom of Great Britain and Northern Ireland,GBR,0,0,10,0,10
2019,Eritrea,ERI,United Kingdom of Great Britain and Northern Ireland,GBR,1785,5,83,193,2066
2019,Ethiopia,ETH,United Kingdom of Great Britain and Northern Ireland,GBR,86,19,233,59,397
2019,Gambia,GMB,United Kingdom of Great Britain and Northern Ireland,GBR,20,5,44,10,79
2019,Palestinian,PSE,United Kingdom of Great Britain and Northern Ireland,GBR,57,17,74,23,171
2019,Georgia,GEO,United Kingdom of Great Britain and Northern Ireland,GBR,5,0,41,66,112
2019,Ghana,GHA,United Kingdom of Great Britain and Northern Ireland,GBR,10,22,127,53,212
2019,Guinea-Bissau,GNB,United Kingdom of Great Britain and Northern Ireland,GBR,0,0,5,0,5
2019,Grenada,GRD,United Kingdom of Great Britain and Northern Ireland,GBR,0,0,5,0,5
2019,Guinea,GIN,United Kingdom of Great Britain and Northern Ireland,GBR,17,0,14,5,36
2019,Honduras,HND,United Kingdom of Great Britain and Northern Ireland,GBR,5,5,42,17,69
2019,Hungary,HUN,United Kingdom of Great Britain and Northern Ireland,GBR,0,0,5,0,5
2019,Cote d'Ivoire,CIV,United Kingdom of Great Britain and Northern Ireland,GBR,17,0,27,0,44
2019,India,IND,United Kingdom of Great Britain and Northern Ireland,GBR,5,60,803,695,1563
2019,Indonesia,IDN,United Kingdom of Great Britain and Northern Ireland,GBR,5,0,5,5,15
2019,Iran (Islamic Rep. of),IRN,United Kingdom of Great Britain and Northern Ireland,GBR,2723,14,877,570,4184
2019,Iraq,IRQ,United Kingdom of Great Britain and Northern Ireland,GBR,573,287,1789,495,3144
2019,Italy,ITA,United Kingdom of Great Britain and Northern Ireland,GBR,0,0,5,0,5
2019,Jamaica,JAM,United Kingdom of Great Britain and Northern Ireland,GBR,5,5,61,10,81
2019,Jordan,JOR,United Kingdom of Great Britain and Northern Ireland,GBR,11,0,37,5,53
2019,Japan,JPN,United Kingdom of Great Britain and Northern Ireland,GBR,0,0,5,0,5
2019,Kazakhstan,KAZ,United Kingdom of Great Britain and Northern Ireland,GBR,0,0,17,5,22
2019,Kenya,KEN,United Kingdom of Great Britain and Northern Ireland,GBR,18,13,78,10,119
2019,Kyrgyzstan,KGZ,United Kingdom of Great Britain and Northern Ireland,GBR,0,0,11,0,11
2019,Dem. People's Rep. of Korea,PRK,United Kingdom of Great Britain and Northern Ireland,GBR,0,0,12,0,12
2019,Kuwait,KWT,United Kingdom of Great Britain and Northern Ireland,GBR,104,0,35,14,153
2019,Liberia,LBR,United Kingdom of Great Britain and Northern Ireland,GBR,0,0,0,5,5
2019,Libya,LBY,United Kingdom of Great Britain and Northern Ireland,GBR,80,699,5,36,820
2019,Saint Lucia,LCA,United Kingdom of Great Britain and Northern Ireland,GBR,0,0,11,5,16
2019,Lebanon,LBN,United Kingdom of Great Britain and Northern Ireland,GBR,5,0,24,5,34
2019,Sri Lanka,LKA,United Kingdom of Great Britain and Northern Ireland,GBR,94,45,217,61,417
2019,Lithuania,LTU,United Kingdom of Great Britain and Northern Ireland,GBR,0,0,5,5,10
2019,Latvia,LVA,United Kingdom of Great Britain and Northern Ireland,GBR,0,0,5,0,5
2019,Maldives,MDV,United Kingdom of Great Britain and Northern Ireland,GBR,5,0,0,5,10
2019,Mexico,MEX,United Kingdom of Great Britain and Northern Ireland,GBR,0,0,5,5,10
2019,Mali,MLI,United Kingdom of Great Britain and Northern Ireland,GBR,0,0,5,0,5
2019,Malaysia,MYS,United Kingdom of Great Britain and Northern Ireland,GBR,29,0,40,25,94
2019,Malawi,MWI,United Kingdom of Great Britain and Northern Ireland,GBR,5,18,24,0,47
2019,Mongolia,MNG,United Kingdom of Great Britain and Northern Ireland,GBR,0,5,18,0,23
2019,Morocco,MAR,United Kingdom of Great Britain and Northern Ireland,GBR,19,0,29,28,76
2019,Mozambique,MOZ,United Kingdom of Great Britain and Northern Ireland,GBR,0,0,5,0,5
2019,Mauritius,MUS,United Kingdom of Great Britain and Northern Ireland,GBR,0,5,56,5,66
2019,Myanmar,MMR,United Kingdom of Great Britain and Northern Ireland,GBR,5,0,10,0,15
2019,Namibia,NAM,United Kingdom of Great Britain and Northern Ireland,GBR,14,0,185,35,234
2019,Nepal,NPL,United Kingdom of Great Britain and Northern Ireland,GBR,0,5,55,15,75
2019,Niger,NER,United Kingdom of Great Britain and Northern Ireland,GBR,183,0,5,0,188
2019,Nicaragua,NIC,United Kingdom of Great Britain and Northern Ireland,GBR,10,0,26,5,41
2019,Nigeria,NGA,United Kingdom of Great Britain and Northern Ireland,GBR,0,249,750,92,1091
2019,Oman,OMN,United Kingdom of Great Britain and Northern Ireland,GBR,5,0,5,5,15
2019,Pakistan,PAK,United Kingdom of Great Britain and Northern Ireland,GBR,401,99,821,267,1588
2019,Philippines,PHL,United Kingdom of Great Britain and Northern Ireland,GBR,0,5,34,10,49
2019,Poland,POL,United Kingdom of Great Britain and Northern Ireland,GBR,0,0,13,0,13
2019,Portugal,PRT,United Kingdom of Great Britain and Northern Ireland,GBR,0,0,5,0,5
2019,Romania,ROU,United Kingdom of Great Britain and Northern Ireland,GBR,0,0,5,0,5
2019,South Africa,ZAF,United Kingdom of Great Britain and Northern Ireland,GBR,0,10,67,12,89
2019,Russian Federation,RUS,United Kingdom of Great Britain and Northern Ireland,GBR,153,0,79,22,254
2019,Rwanda,RWA,United Kingdom of Great Britain and Northern Ireland,GBR,5,0,10,0,15
2019,El Salvador,SLV,United Kingdom of Great Britain and Northern Ireland,GBR,108,44,304,50,506
2019,Saudi Arabia,SAU,United Kingdom of Great Britain and Northern Ireland,GBR,52,0,17,14,83
2019,Serbia and Kosovo: S/RES/1244 (1999),SRB,United Kingdom of Great Britain and Northern Ireland,GBR,5,5,12,5,27
2019,Senegal,SEN,United Kingdom of Great Britain and Northern Ireland,GBR,0,0,10,0,10
2019,Sierra Leone,SLE,United Kingdom of Great Britain and Northern Ireland,GBR,21,5,26,5,57
2019,Somalia,SOM,United Kingdom of Great Britain and Northern Ireland,GBR,154,13,78,18,263
2019,Viet Nam,VNM,United Kingdom of Great Britain and Northern Ireland,GBR,266,84,336,115,801
2019,Saint Kitts and Nevis,KNA,United Kingdom of Great Britain and Northern Ireland,GBR,0,0,5,0,5
2019,Sudan,SDN,United Kingdom of Great Britain and Northern Ireland,GBR,1625,18,144,160,1947
2019,South Sudan,SSD,United Kingdom of Great Britain and Northern Ireland,GBR,5,0,5,5,15
2019,Syrian Arab Rep.,SYR,United Kingdom of Great Britain and Northern Ireland,GBR,711,5,28,82,826
2019,United Rep. of Tanzania,TZA,United Kingdom of Great Britain and Northern Ireland,GBR,5,5,32,5,47
2019,Thailand,THA,United Kingdom of Great Britain and Northern Ireland,GBR,0,0,13,5,18
2019,Tajikistan,TJK,United Kingdom of Great Britain and Northern Ireland,GBR,0,0,5,5,10
2019,Togo,TGO,United Kingdom of Great Britain and Northern Ireland,GBR,0,0,5,0,5
2019,Trinidad and Tobago,TTO,United Kingdom of Great Britain and Northern Ireland,GBR,5,0,13,5,23
2019,Tunisia,TUN,United Kingdom of Great Britain and Northern Ireland,GBR,0,0,16,10,26
2019,Turkey,TUR,United Kingdom of Great Britain and Northern Ireland,GBR,660,10,193,52,915
2019,United Arab Emirates,ARE,United Kingdom of Great Britain and Northern Ireland,GBR,5,0,0,5,10
2019,Uganda,UGA,United Kingdom of Great Britain and Northern Ireland,GBR,32,5,26,5,68
2019,Ukraine,UKR,United Kingdom of Great Britain and Northern Ireland,GBR,5,10,136,49,200
2019,United States of America,USA,United Kingdom of Great Britain and Northern Ireland,GBR,10,0,10,21,41
2019,Uzbekistan,UZB,United Kingdom of Great Britain and Northern Ireland,GBR,5,0,5,0,10
2019,Saint Vincent and the Grenadines,VCT,United Kingdom of Great Britain and Northern Ireland,GBR,5,5,0,0,10
2019,Venezuela (Bolivarian Republic of),VEN,United Kingdom of Great Britain and Northern Ireland,GBR,0,5,10,0,15
2019,Yemen,YEM,United Kingdom of Great Britain and Northern Ireland,GBR,88,128,11,17,244
2019,Zambia,ZMB,United Kingdom of Great Britain and Northern Ireland,GBR,5,5,5,0,15
2019,Zimbabwe,ZWE,United Kingdom of Great Britain and Northern Ireland,GBR,23,10,79,13,125
2019,Stateless,XXA,United Kingdom of Great Britain and Northern Ireland,GBR,329,10,66,143,548
2019,Unknown ,,United Kingdom of Great Britain and Northern Ireland,GBR,323,54,26,17,420
2019,Afghanistan,AFG,Georgia,GEO,10,0,29,5,44
2019,Egypt,EGY,Georgia,GEO,18,0,20,24,62
2019,Armenia,ARM,Georgia,GEO,0,0,5,0,5
2019,Azerbaijan,AZE,Georgia,GEO,0,0,10,10,20
2019,Bangladesh,BGD,Georgia,GEO,0,0,17,5,22
2019,Dem. Rep. of the Congo,COD,Georgia,GEO,5,0,0,5,10
2019,Cuba,CUB,Georgia,GEO,0,0,0,5,5
2019,Ethiopia,ETH,Georgia,GEO,0,0,0,5,5
2019,Ghana,GHA,Georgia,GEO,0,0,5,0,5
2019,Cote d'Ivoire,CIV,Georgia,GEO,0,0,0,5,5
2019,India,IND,Georgia,GEO,0,0,24,45,69
2019,Iran (Islamic Rep. of),IRN,Georgia,GEO,0,0,71,119,190
2019,Iraq,IRQ,Georgia,GEO,5,5,22,11,43
2019,Jordan,JOR,Georgia,GEO,0,0,0,10,10
2019,Lebanon,LBN,Georgia,GEO,0,0,5,0,5
2019,Nigeria,NGA,Georgia,GEO,0,0,15,5,20
2019,Pakistan,PAK,Georgia,GEO,0,0,5,5,10
2019,South Africa,ZAF,Georgia,GEO,0,0,0,5,5
2019,Russian Federation,RUS,Georgia,GEO,5,0,38,10,53
2019,Saudi Arabia,SAU,Georgia,GEO,0,0,0,5,5
2019,Sierra Leone,SLE,Georgia,GEO,0,0,5,0,5
2019,Somalia,SOM,Georgia,GEO,0,0,5,5,10
2019,Sudan,SDN,Georgia,GEO,0,0,0,5,5
2019,Syrian Arab Rep.,SYR,Georgia,GEO,0,0,16,0,16
2019,Turkey,TUR,Georgia,GEO,0,0,79,24,103
2019,Ukraine,UKR,Georgia,GEO,0,0,5,5,10
2019,Yemen,YEM,Georgia,GEO,0,24,5,16,45
2019,Unknown ,,Georgia,GEO,0,5,19,5,29
2019,Congo,COG,Ghana,GHA,0,0,0,11,11
2019,Dem. Rep. of the Congo,COD,Ghana,GHA,0,0,0,16,16
2019,Eritrea,ERI,Ghana,GHA,0,0,0,20,20
2019,Ethiopia,ETH,Ghana,GHA,0,0,0,5,5
2019,Cote d'Ivoire,CIV,Ghana,GHA,69,0,0,62,131
2019,Nigeria,NGA,Ghana,GHA,0,0,0,10,10
2019,Sierra Leone,SLE,Ghana,GHA,0,0,0,5,5
2019,Sudan,SDN,Ghana,GHA,62,0,0,5,67
2019,Syrian Arab Rep.,SYR,Ghana,GHA,5,0,0,10,15
2019,Togo,TGO,Ghana,GHA,5,0,0,10,15
2019,Afghanistan,AFG,Greece,GRC,1692,2257,1462,3697,9108
2019,Albania,ALB,Greece,GRC,10,0,1887,721,2618
2019,Algeria,DZA,Greece,GRC,12,0,140,438,590
2019,Angola,AGO,Greece,GRC,0,0,5,10,15
2019,Egypt,EGY,Greece,GRC,78,0,638,472,1188
2019,Armenia,ARM,Greece,GRC,0,0,43,26,69
2019,Burundi,BDI,Greece,GRC,5,0,5,5,15
2019,Bangladesh,BGD,Greece,GRC,22,0,1044,332,1398
2019,Burkina Faso,BFA,Greece,GRC,0,0,11,10,21
2019,Belarus,BLR,Greece,GRC,0,0,11,0,11
2019,Brazil,BRA,Greece,GRC,0,0,0,5,5
2019,China,CHN,Greece,GRC,14,0,148,168,330
2019,Cameroon,CMR,Greece,GRC,155,10,232,227,624
2019,Congo,COG,Greece,GRC,32,0,34,23,89
2019,Dem. Rep. of the Congo,COD,Greece,GRC,156,26,347,407,936
2019,Comoros,COM,Greece,GRC,0,0,5,5,10
2019,Cuba,CUB,Greece,GRC,0,0,5,10,15
2019,Dominican Rep.,DOM,Greece,GRC,0,0,5,14,19
2019,Eritrea,ERI,Greece,GRC,267,0,5,51,323
2019,Ethiopia,ETH,Greece,GRC,53,0,28,21,102
2019,Gabon,GAB,Greece,GRC,0,0,0,5,5
2019,Gambia,GMB,Greece,GRC,5,0,28,18,51
2019,Palestinian,PSE,Greece,GRC,1379,87,18,374,1858
2019,Georgia,GEO,Greece,GRC,0,0,779,388,1167
2019,Ghana,GHA,Greece,GRC,5,0,97,38,140
2019,Guinea,GIN,Greece,GRC,14,0,38,24,76
2019,Haiti,HTI,Greece,GRC,0,0,0,5,5
2019,Cote d'Ivoire,CIV,Greece,GRC,0,0,13,10,23
2019,India,IND,Greece,GRC,0,0,108,43,151
2019,Indonesia,IDN,Greece,GRC,0,0,11,5,16
2019,Iran (Islamic Rep. of),IRN,Greece,GRC,389,11,251,637,1288
2019,Iraq,IRQ,Greece,GRC,1808,967,1285,2197,6257
2019,Jordan,JOR,Greece,GRC,5,0,10,21,36
2019,Kazakhstan,KAZ,Greece,GRC,0,0,5,5,10
2019,Kenya,KEN,Greece,GRC,0,0,0,5,5
2019,Kuwait,KWT,Greece,GRC,19,0,0,30,49
2019,Libya,LBY,Greece,GRC,0,0,10,33,43
2019,Lebanon,LBN,Greece,GRC,14,0,21,13,48
2019,Sri Lanka,LKA,Greece,GRC,0,0,18,38,56
2019,Mauritania,MRT,Greece,GRC,0,0,0,5,5
2019,Rep. of Moldova,MDA,Greece,GRC,0,0,14,17,31
2019,Mali,MLI,Greece,GRC,5,5,14,16,40
2019,Morocco,MAR,Greece,GRC,24,0,89,162,275
2019,Myanmar,MMR,Greece,GRC,24,0,5,5,34
2019,Nepal,NPL,Greece,GRC,0,0,54,35,89
2019,Nigeria,NGA,Greece,GRC,12,0,63,79,154
2019,Pakistan,PAK,Greece,GRC,106,12,4342,1724,6184
2019,Paraguay,PRY,Greece,GRC,0,0,5,0,5
2019,Philippines,PHL,Greece,GRC,0,0,5,0,5
2019,Russian Federation,RUS,Greece,GRC,5,0,15,17,37
2019,Serbia and Kosovo: S/RES/1244 (1999),SRB,Greece,GRC,0,0,0,5,5
2019,Senegal,SEN,Greece,GRC,0,0,16,17,33
2019,Sierra Leone,SLE,Greece,GRC,5,0,18,13,36
2019,Somalia,SOM,Greece,GRC,239,298,17,91,645
2019,Viet Nam,VNM,Greece,GRC,0,0,0,13,13
2019,Sudan,SDN,Greece,GRC,17,5,17,15,54
2019,South Sudan,SSD,Greece,GRC,5,5,0,0,10
2019,Syrian Arab Rep.,SYR,Greece,GRC,6565,0,37,2384,8986
2019,Turkmenistan,TKM,Greece,GRC,5,0,0,0,5
2019,Togo,TGO,Greece,GRC,18,0,44,10,72
2019,Tunisia,TUN,Greece,GRC,0,0,11,25,36
2019,Turkey,TUR,Greece,GRC,168,0,45,3299,3512
2019,Uganda,UGA,Greece,GRC,5,0,12,10,27
2019,Ukraine,UKR,Greece,GRC,0,5,71,27,103
2019,Uzbekistan,UZB,Greece,GRC,0,0,0,5,5
2019,Venezuela (Bolivarian Republic of),VEN,Greece,GRC,0,0,10,5,15
2019,Yemen,YEM,Greece,GRC,55,150,0,37,242
2019,Stateless,XXA,Greece,GRC,87,0,5,165,257
2019,Unknown ,,Greece,GRC,5,0,0,10,15
2019,Honduras,HND,Guatemala,GTM,5,0,5,5,15
2019,Nicaragua,NIC,Guatemala,GTM,0,0,5,43,48
2019,Russian Federation,RUS,Guatemala,GTM,5,0,0,0,5
2019,El Salvador,SLV,Guatemala,GTM,14,0,10,11,35
2019,Venezuela (Bolivarian Republic of),VEN,Guatemala,GTM,5,0,0,0,5
2019,Cameroon,CMR,Guinea,GIN,5,0,0,0,5
2019,Dem. Rep. of the Congo,COD,Guinea,GIN,0,0,0,5,5
2019,Eritrea,ERI,Guinea,GIN,10,0,0,0,10
2019,Cote d'Ivoire,CIV,Guinea,GIN,27,0,0,0,27
2019,Liberia,LBR,Guinea,GIN,10,0,0,42,52
2019,Sierra Leone,SLE,Guinea,GIN,283,0,5,0,288
2019,Syrian Arab Rep.,SYR,Guinea,GIN,11,0,0,0,11
2019,Nicaragua,NIC,Honduras,HND,35,0,0,41,76
2019,El Salvador,SLV,Honduras,HND,10,0,0,0,10
2019,Afghanistan,AFG,Croatia,HRV,0,0,10,136,146
2019,Algeria,DZA,Croatia,HRV,0,0,81,10,91
2019,Egypt,EGY,Croatia,HRV,0,0,0,5,5
2019,Cuba,CUB,Croatia,HRV,0,0,5,10,15
2019,Palestinian,PSE,Croatia,HRV,0,0,0,26,26
2019,Iran (Islamic Rep. of),IRN,Croatia,HRV,5,0,21,110,136
2019,Iraq,IRQ,Croatia,HRV,10,0,5,175,190
2019,Libya,LBY,Croatia,HRV,0,0,5,25,30
2019,Morocco,MAR,Croatia,HRV,0,0,15,5,20
2019,Pakistan,PAK,Croatia,HRV,0,0,5,16,21
2019,Serbia and Kosovo: S/RES/1244 (1999),SRB,Croatia,HRV,0,0,5,0,5
2019,Somalia,SOM,Croatia,HRV,0,0,0,5,5
2019,Syrian Arab Rep.,SYR,Croatia,HRV,128,0,5,0,133
2019,Tunisia,TUN,Croatia,HRV,0,0,15,5,20
2019,Turkey,TUR,Croatia,HRV,0,0,10,30,40
2019,Ukraine,UKR,Croatia,HRV,0,0,5,0,5
2019,Yemen,YEM,Croatia,HRV,0,0,0,5,5
2019,Stateless,XXA,Croatia,HRV,0,0,0,16,16
2019,Afghanistan,AFG,Hungary,HUN,0,5,315,15,335
2019,Eritrea,ERI,Hungary,HUN,5,0,0,0,5
2019,Ghana,GHA,Hungary,HUN,0,0,5,0,5
2019,Iran (Islamic Rep. of),IRN,Hungary,HUN,5,13,21,0,39
2019,Iraq,IRQ,Hungary,HUN,0,0,260,19,279
2019,Pakistan,PAK,Hungary,HUN,5,0,5,0,10
2019,Somalia,SOM,Hungary,HUN,0,0,5,0,5
2019,Syrian Arab Rep.,SYR,Hungary,HUN,0,0,12,10,22
2019,Tajikistan,TJK,Hungary,HUN,0,0,10,0,10
2019,Turkey,TUR,Hungary,HUN,0,0,5,0,5
2019,Unknown ,,Hungary,HUN,5,5,0,0,10
2019,Afghanistan,AFG,Iceland,ISL,10,10,0,47,67
2019,Albania,ALB,Iceland,ISL,0,0,22,18,40
2019,Algeria,DZA,Iceland,ISL,0,0,0,5,5
2019,Egypt,EGY,Iceland,ISL,5,0,5,5,15
2019,Azerbaijan,AZE,Iceland,ISL,0,0,0,5,5
2019,China,CHN,Iceland,ISL,0,0,0,5,5
2019,Colombia,COL,Iceland,ISL,0,0,10,0,10
2019,Eritrea,ERI,Iceland,ISL,0,0,0,5,5
2019,Palestinian,PSE,Iceland,ISL,5,10,0,5,20
2019,Georgia,GEO,Iceland,ISL,0,0,14,14,28
2019,Ghana,GHA,Iceland,ISL,0,0,5,10,15
2019,India,IND,Iceland,ISL,0,0,0,5,5
2019,Iran (Islamic Rep. of),IRN,Iceland,ISL,16,0,0,27,43
2019,Iraq,IRQ,Iceland,ISL,23,10,33,115,181
2019,Libya,LBY,Iceland,ISL,0,0,0,5,5
2019,North Macedonia,MKD,Iceland,ISL,0,0,5,0,5
2019,Rep. of Moldova,MDA,Iceland,ISL,0,0,46,12,58
2019,Morocco,MAR,Iceland,ISL,0,0,5,10,15
2019,Mozambique,MOZ,Iceland,ISL,0,0,0,5,5
2019,Nigeria,NGA,Iceland,ISL,5,0,5,49,59
2019,Pakistan,PAK,Iceland,ISL,0,0,12,14,26
2019,Romania,ROU,Iceland,ISL,0,0,0,5,5
2019,Russian Federation,RUS,Iceland,ISL,0,0,5,12,17
2019,El Salvador,SLV,Iceland,ISL,0,5,0,0,5
2019,Serbia and Kosovo: S/RES/1244 (1999),SRB,Iceland,ISL,0,0,21,0,21
2019,Somalia,SOM,Iceland,ISL,5,10,5,39,59
2019,Sudan,SDN,Iceland,ISL,0,0,0,5,5
2019,Syrian Arab Rep.,SYR,Iceland,ISL,5,10,0,21,36
2019,Tunisia,TUN,Iceland,ISL,0,0,0,5,5
2019,Turkey,TUR,Iceland,ISL,5,0,0,0,5
2019,Ukraine,UKR,Iceland,ISL,0,0,22,5,27
2019,Venezuela (Bolivarian Republic of),VEN,Iceland,ISL,5,150,0,0,155
2019,Yemen,YEM,Iceland,ISL,0,0,0,5,5
2019,Afghanistan,AFG,Ireland,IRL,32,26,5,46,109
2019,Albania,ALB,Ireland,IRL,5,0,405,826,1236
2019,Algeria,DZA,Ireland,IRL,5,5,80,31,121
2019,Angola,AGO,Ireland,IRL,0,0,11,0,11
2019,Egypt,EGY,Ireland,IRL,5,0,23,15,43
2019,Armenia,ARM,Ireland,IRL,0,0,5,0,5
2019,Burundi,BDI,Ireland,IRL,5,0,0,0,5
2019,Bangladesh,BGD,Ireland,IRL,5,10,95,10,120
2019,Belarus,BLR,Ireland,IRL,0,0,5,0,5
2019,Bolivia (Plurinational State of),BOL,Ireland,IRL,5,0,5,5,15
2019,Botswana,BWA,Ireland,IRL,0,0,5,5,10
2019,Brazil,BRA,Ireland,IRL,5,0,69,11,85
2019,China,CHN,Ireland,IRL,11,0,11,50,72
2019,Chile,CHL,Ireland,IRL,0,0,0,5,5
2019,Cameroon,CMR,Ireland,IRL,5,5,12,0,22
2019,Dem. Rep. of the Congo,COD,Ireland,IRL,51,12,78,5,146
2019,Eritrea,ERI,Ireland,IRL,27,0,0,5,32
2019,Ethiopia,ETH,Ireland,IRL,5,0,0,5,10
2019,Palestinian,PSE,Ireland,IRL,26,0,10,5,41
2019,Georgia,GEO,Ireland,IRL,5,0,341,68,414
2019,Ghana,GHA,Ireland,IRL,5,0,14,0,19
2019,Guatemala,GTM,Ireland,IRL,5,0,0,0,5
2019,Cote d'Ivoire,CIV,Ireland,IRL,0,0,5,0,5
2019,India,IND,Ireland,IRL,0,0,34,21,55
2019,Iran (Islamic Rep. of),IRN,Ireland,IRL,13,0,5,14,32
2019,Iraq,IRQ,Ireland,IRL,17,5,16,27,65
2019,Israel,ISR,Ireland,IRL,5,0,5,0,10
2019,Kenya,KEN,Ireland,IRL,5,0,5,0,10
2019,Kyrgyzstan,KGZ,Ireland,IRL,0,0,5,0,5
2019,Rep. of Korea,KOR,Ireland,IRL,0,0,0,5,5
2019,Kuwait,KWT,Ireland,IRL,0,0,5,5,10
2019,Libya,LBY,Ireland,IRL,49,20,0,5,74
2019,Lebanon,LBN,Ireland,IRL,0,0,5,0,5
2019,Sri Lanka,LKA,Ireland,IRL,0,0,0,5,5
2019,Malaysia,MYS,Ireland,IRL,5,0,11,0,16
2019,Malawi,MWI,Ireland,IRL,10,5,82,5,102
2019,Mongolia,MNG,Ireland,IRL,0,0,10,5,15
2019,Morocco,MAR,Ireland,IRL,0,0,10,10,20
2019,Mauritius,MUS,Ireland,IRL,5,5,11,5,26
2019,Myanmar,MMR,Ireland,IRL,5,0,0,0,5
2019,Nepal,NPL,Ireland,IRL,5,0,5,0,10
2019,Nicaragua,NIC,Ireland,IRL,5,0,0,0,5
2019,Nigeria,NGA,Ireland,IRL,22,0,151,40,213
2019,Pakistan,PAK,Ireland,IRL,41,5,344,51,441
2019,Philippines,PHL,Ireland,IRL,0,0,5,0,5
2019,South Africa,ZAF,Ireland,IRL,0,0,126,43,169
2019,Russian Federation,RUS,Ireland,IRL,10,0,5,0,15
2019,Rwanda,RWA,Ireland,IRL,5,0,0,0,5
2019,El Salvador,SLV,Ireland,IRL,5,0,0,0,5
2019,Saudi Arabia,SAU,Ireland,IRL,5,0,0,0,5
2019,Serbia and Kosovo: S/RES/1244 (1999),SRB,Ireland,IRL,0,0,5,5,10
2019,Sierra Leone,SLE,Ireland,IRL,14,0,5,0,19
2019,Somalia,SOM,Ireland,IRL,22,16,0,25,63
2019,Viet Nam,VNM,Ireland,IRL,0,0,5,0,5
2019,Sudan,SDN,Ireland,IRL,41,5,5,5,56
2019,Eswatini,SWZ,Ireland,IRL,0,0,13,0,13
2019,Syrian Arab Rep.,SYR,Ireland,IRL,83,0,0,26,109
2019,Turkey,TUR,Ireland,IRL,5,0,0,0,5
2019,Uganda,UGA,Ireland,IRL,5,0,5,0,10
2019,Ukraine,UKR,Ireland,IRL,5,0,13,0,18
2019,United States of America,USA,Ireland,IRL,0,0,5,5,10
2019,Venezuela (Bolivarian Republic of),VEN,Ireland,IRL,34,5,10,0,49
2019,Yemen,YEM,Ireland,IRL,5,0,0,0,5
2019,Zambia,ZMB,Ireland,IRL,0,0,5,0,5
2019,Zimbabwe,ZWE,Ireland,IRL,71,10,247,10,338
2019,Afghanistan,AFG,Italy,ITA,276,632,61,38,1007
2019,Albania,ALB,Italy,ITA,96,29,1452,5,1582
2019,Algeria,DZA,Italy,ITA,22,5,155,0,182
2019,Angola,AGO,Italy,ITA,0,0,5,0,5
2019,Egypt,EGY,Italy,ITA,64,26,824,0,914
2019,Argentina,ARG,Italy,ITA,0,0,13,0,13
2019,Armenia,ARM,Italy,ITA,27,30,101,5,163
2019,Azerbaijan,AZE,Italy,ITA,21,0,19,0,40
2019,Burundi,BDI,Italy,ITA,0,5,0,0,5
2019,Benin,BEN,Italy,ITA,23,5,89,0,117
2019,Bangladesh,BGD,Italy,ITA,280,256,7752,5,8293
2019,Burkina Faso,BFA,Italy,ITA,28,63,361,0,452
2019,Belarus,BLR,Italy,ITA,0,0,29,0,29
2019,Bolivia (Plurinational State of),BOL,Italy,ITA,5,0,18,0,23
2019,Brazil,BRA,Italy,ITA,64,5,185,0,254
2019,Bosnia and Herzegovina,BIH,Italy,ITA,5,5,61,0,71
2019,Central African Rep.,CAF,Italy,ITA,5,5,0,0,10
2019,Chad,TCD,Italy,ITA,5,10,43,0,58
2019,China,CHN,Italy,ITA,50,5,696,0,751
2019,Chile,CHL,Italy,ITA,0,0,10,0,10
2019,Cameroon,CMR,Italy,ITA,277,138,658,0,1073
2019,Dem. Rep. of the Congo,COD,Italy,ITA,41,15,65,0,121
2019,Comoros,COM,Italy,ITA,0,0,20,0,20
2019,Colombia,COL,Italy,ITA,161,79,443,0,683
2019,Cuba,CUB,Italy,ITA,23,10,159,0,192
2019,Cabo Verde,CPV,Italy,ITA,0,0,5,0,5
2019,Dominican Rep.,DOM,Italy,ITA,5,0,34,0,39
2019,Ecuador,ECU,Italy,ITA,0,0,23,0,23
2019,Equatorial Guinea,GNQ,Italy,ITA,0,0,5,0,5
2019,Eritrea,ERI,Italy,ITA,116,27,93,0,236
2019,Ethiopia,ETH,Italy,ITA,37,11,31,0,79
2019,Gabon,GAB,Italy,ITA,0,0,5,0,5
2019,Gambia,GMB,Italy,ITA,280,139,3973,5,4397
2019,Palestinian,PSE,Italy,ITA,32,5,18,0,55
2019,Georgia,GEO,Italy,ITA,168,54,1144,0,1366
2019,Germany,DEU,Italy,ITA,0,0,5,0,5
2019,Ghana,GHA,Italy,ITA,134,96,2626,0,2856
2019,Guinea-Bissau,GNB,Italy,ITA,15,24,535,0,574
2019,Guatemala,GTM,Italy,ITA,5,5,10,0,20
2019,Guinea,GIN,Italy,ITA,212,85,2760,0,3057
2019,Honduras,HND,Italy,ITA,87,83,186,0,356
2019,Cote d'Ivoire,CIV,Italy,ITA,344,141,3258,5,3748
2019,India,IND,Italy,ITA,59,15,1124,0,1198
2019,Indonesia,IDN,Italy,ITA,0,5,5,0,10
2019,Iran (Islamic Rep. of),IRN,Italy,ITA,180,5,81,0,266
2019,Iraq,IRQ,Italy,ITA,326,494,250,15,1085
2019,Jordan,JOR,Italy,ITA,5,0,5,0,10
2019,Kazakhstan,KAZ,Italy,ITA,0,5,26,0,31
2019,Kenya,KEN,Italy,ITA,5,5,28,0,38
2019,Kyrgyzstan,KGZ,Italy,ITA,13,0,122,0,135
2019,Kuwait,KWT,Italy,ITA,5,0,0,0,5
2019,Liberia,LBR,Italy,ITA,16,15,192,13,236
2019,Libya,LBY,Italy,ITA,116,178,96,0,390
2019,Lebanon,LBN,Italy,ITA,42,0,21,0,63
2019,Liechtenstein,LIE,Italy,ITA,0,0,5,0,5
2019,Sri Lanka,LKA,Italy,ITA,35,23,554,0,612
2019,Madagascar,MDG,Italy,ITA,0,0,10,0,10
2019,Mauritania,MRT,Italy,ITA,5,0,25,0,30
2019,North Macedonia,MKD,Italy,ITA,10,0,43,0,53
2019,Rep. of Moldova,MDA,Italy,ITA,11,5,68,0,84
2019,Mexico,MEX,Italy,ITA,5,0,10,0,15
2019,Mali,MLI,Italy,ITA,167,672,3346,17,4202
2019,Malaysia,MYS,Italy,ITA,0,0,5,0,5
2019,Morocco,MAR,Italy,ITA,153,55,2347,0,2555
2019,Montenegro,MNE,Italy,ITA,0,0,5,0,5
2019,Mauritius,MUS,Italy,ITA,0,0,11,0,11
2019,Myanmar,MMR,Italy,ITA,5,0,10,0,15
2019,Nepal,NPL,Italy,ITA,14,0,100,0,114
2019,Niger,NER,Italy,ITA,19,84,154,0,257
2019,Nicaragua,NIC,Italy,ITA,23,5,31,0,59
2019,Nigeria,NGA,Italy,ITA,2474,448,13721,26,16669
2019,Pakistan,PAK,Italy,ITA,718,1096,10156,46,12016
2019,Paraguay,PRY,Italy,ITA,0,0,5,0,5
2019,Peru,PER,Italy,ITA,118,30,1155,0,1303
2019,Philippines,PHL,Italy,ITA,15,10,164,0,189
2019,South Africa,ZAF,Italy,ITA,0,5,5,0,10
2019,Russian Federation,RUS,Italy,ITA,57,31,189,0,277
2019,Rwanda,RWA,Italy,ITA,5,0,5,0,10
2019,El Salvador,SLV,Italy,ITA,704,956,1577,0,3237
2019,Saudi Arabia,SAU,Italy,ITA,11,5,0,0,16
2019,Serbia and Kosovo: S/RES/1244 (1999),SRB,Italy,ITA,10,12,64,0,86
2019,Senegal,SEN,Italy,ITA,213,134,5327,5,5679
2019,Sierra Leone,SLE,Italy,ITA,66,12,438,0,516
2019,Somalia,SOM,Italy,ITA,362,294,52,5,713
2019,Viet Nam,VNM,Italy,ITA,0,0,5,0,5
2019,Sudan,SDN,Italy,ITA,103,36,99,0,238
2019,South Sudan,SSD,Italy,ITA,5,5,0,0,10
2019,Syrian Arab Rep.,SYR,Italy,ITA,113,16,25,0,154
2019,United Rep. of Tanzania,TZA,Italy,ITA,0,0,5,0,5
2019,Thailand,THA,Italy,ITA,0,0,5,0,5
2019,Tajikistan,TJK,Italy,ITA,0,0,5,0,5
2019,Togo,TGO,Italy,ITA,24,26,338,0,388
2019,Tunisia,TUN,Italy,ITA,34,5,837,0,876
2019,Turkey,TUR,Italy,ITA,271,77,253,5,606
2019,Uganda,UGA,Italy,ITA,10,0,5,0,15
2019,Ukraine,UKR,Italy,ITA,105,387,3515,0,4007
2019,United States of America,USA,Italy,ITA,0,0,5,0,5
2019,Uzbekistan,UZB,Italy,ITA,0,5,5,0,10
2019,Venezuela (Bolivarian Republic of),VEN,Italy,ITA,445,980,136,0,1561
2019,Yemen,YEM,Italy,ITA,10,0,5,0,15
2019,Zimbabwe,ZWE,Italy,ITA,5,0,0,0,5
2019,Unknown ,,Italy,ITA,91,102,393,5,591
2019,Afghanistan,AFG,Japan,JPN,16,0,0,0,16
2019,Bangladesh,BGD,Japan,JPN,0,0,52,52,104
2019,Cambodia,KHM,Japan,JPN,0,0,0,156,156
2019,China,CHN,Japan,JPN,0,0,60,60,120
2019,India,IND,Japan,JPN,0,0,126,126,252
2019,Sri Lanka,LKA,Japan,JPN,0,5,1002,267,1274
2019,Myanmar,MMR,Japan,JPN,0,0,129,130,259
2019,Nepal,NPL,Japan,JPN,0,0,761,536,1297
2019,Nigeria,NGA,Japan,JPN,0,5,0,0,5
2019,Pakistan,PAK,Japan,JPN,0,0,0,141,141
2019,Philippines,PHL,Japan,JPN,0,0,846,181,1027
2019,Turkey,TUR,Japan,JPN,0,12,424,182,618
2019,Unknown ,,Japan,JPN,22,16,1499,321,1858
2019,Afghanistan,AFG,Kazakhstan,KAZ,10,0,142,14,166
2019,China,CHN,Kazakhstan,KAZ,0,0,5,0,5
2019,Syrian Arab Rep.,SYR,Kazakhstan,KAZ,0,0,11,0,11
2019,Afghanistan,AFG,Kenya,KEN,0,0,0,5,5
2019,Angola,AGO,Kenya,KEN,0,0,0,5,5
2019,Burundi,BDI,Kenya,KEN,994,0,0,823,1817
2019,Cameroon,CMR,Kenya,KEN,0,0,0,5,5
2019,Congo,COG,Kenya,KEN,10,0,0,20,30
2019,Dem. Rep. of the Congo,COD,Kenya,KEN,3744,0,32,1895,5671
2019,Eritrea,ERI,Kenya,KEN,99,0,0,369,468
2019,Ethiopia,ETH,Kenya,KEN,974,0,31,910,1915
2019,Rwanda,RWA,Kenya,KEN,44,0,0,158,202
2019,Somalia,SOM,Kenya,KEN,38,0,0,645,683
2019,Sudan,SDN,Kenya,KEN,188,0,0,315,503
2019,South Sudan,SSD,Kenya,KEN,0,0,0,16,16
2019,Syrian Arab Rep.,SYR,Kenya,KEN,5,0,0,5,10
2019,United Rep. of Tanzania,TZA,Kenya,KEN,0,0,0,5,5
2019,Turkey,TUR,Kenya,KEN,41,0,0,0,41
2019,Uganda,UGA,Kenya,KEN,111,0,0,227,338
2019,Yemen,YEM,Kenya,KEN,17,0,0,34,51
2019,Afghanistan,AFG,Kyrgyzstan,KGZ,5,0,27,25,57
2019,China,CHN,Kyrgyzstan,KGZ,0,0,0,5,5
2019,Iraq,IRQ,Kyrgyzstan,KGZ,5,0,0,0,5
2019,Syrian Arab Rep.,SYR,Kyrgyzstan,KGZ,13,0,0,0,13
2019,Turkey,TUR,Kyrgyzstan,KGZ,0,0,0,23,23
2019,Ukraine,UKR,Kyrgyzstan,KGZ,5,0,0,0,5
2019,Dem. Rep. of the Congo,COD,Liberia,LBR,10,0,0,0,10
2019,Iraq,IRQ,Liberia,LBR,0,0,0,5,5
2019,Nigeria,NGA,Liberia,LBR,0,0,0,5,5
2019,Rwanda,RWA,Liberia,LBR,0,0,0,5,5
2019,Turkey,TUR,Liberia,LBR,0,0,0,5,5
2019,Dem. Rep. of the Congo,COD,Lesotho,LSO,53,0,0,0,53
2019,Eritrea,ERI,Lesotho,LSO,20,0,0,0,20
2019,Ethiopia,ETH,Lesotho,LSO,0,5,0,0,5
2019,Iran (Islamic Rep. of),IRN,Liechtenstein,LIE,0,5,0,0,5
2019,Serbia and Kosovo: S/RES/1244 (1999),SRB,Liechtenstein,LIE,0,0,5,0,5
2019,Afghanistan,AFG,Lithuania,LTU,14,0,5,5,24
2019,Armenia,ARM,Lithuania,LTU,0,0,0,10,10
2019,Azerbaijan,AZE,Lithuania,LTU,5,0,5,17,27
2019,Belarus,BLR,Lithuania,LTU,0,0,5,5,10
2019,Iran (Islamic Rep. of),IRN,Lithuania,LTU,5,0,5,5,15
2019,Iraq,IRQ,Lithuania,LTU,0,5,0,17,22
2019,Kyrgyzstan,KGZ,Lithuania,LTU,0,0,11,0,11
2019,Sri Lanka,LKA,Lithuania,LTU,0,0,0,14,14
2019,Nigeria,NGA,Lithuania,LTU,0,0,5,5,10
2019,Russian Federation,RUS,Lithuania,LTU,5,0,72,44,121
2019,Syrian Arab Rep.,SYR,Lithuania,LTU,18,0,0,5,23
2019,Tajikistan,TJK,Lithuania,LTU,16,5,93,34,148
2019,Turkey,TUR,Lithuania,LTU,17,0,0,0,17
2019,Ukraine,UKR,Lithuania,LTU,0,0,14,0,14
2019,Uzbekistan,UZB,Lithuania,LTU,0,0,5,0,5
2019,Afghanistan,AFG,Luxembourg,LUX,50,5,15,0,70
2019,Albania,ALB,Luxembourg,LUX,0,0,50,0,50
2019,Algeria,DZA,Luxembourg,LUX,0,0,30,0,30
2019,Egypt,EGY,Luxembourg,LUX,0,0,5,0,5
2019,Benin,BEN,Luxembourg,LUX,0,0,10,0,10
2019,Belarus,BLR,Luxembourg,LUX,0,0,5,0,5
2019,Cameroon,CMR,Luxembourg,LUX,0,0,10,0,10
2019,Eritrea,ERI,Luxembourg,LUX,180,0,20,0,200
2019,Ethiopia,ETH,Luxembourg,LUX,5,0,10,0,15
2019,Georgia,GEO,Luxembourg,LUX,0,0,20,0,20
2019,Guinea,GIN,Luxembourg,LUX,0,0,25,0,25
2019,Cote d'Ivoire,CIV,Luxembourg,LUX,0,0,10,0,10
2019,Iran (Islamic Rep. of),IRN,Luxembourg,LUX,20,5,5,0,30
2019,Iraq,IRQ,Luxembourg,LUX,55,0,75,0,130
2019,Libya,LBY,Luxembourg,LUX,0,0,5,0,5
2019,Lebanon,LBN,Luxembourg,LUX,0,0,5,0,5
2019,North Macedonia,MKD,Luxembourg,LUX,0,0,10,0,10
2019,Morocco,MAR,Luxembourg,LUX,0,0,15,0,15
2019,Montenegro,MNE,Luxembourg,LUX,0,0,10,0,10
2019,Nigeria,NGA,Luxembourg,LUX,0,0,5,0,5
2019,Russian Federation,RUS,Luxembourg,LUX,0,0,10,0,10
2019,Serbia and Kosovo: S/RES/1244 (1999),SRB,Luxembourg,LUX,0,0,30,0,30
2019,Senegal,SEN,Luxembourg,LUX,0,0,5,0,5
2019,Somalia,SOM,Luxembourg,LUX,0,0,15,0,15
2019,Sudan,SDN,Luxembourg,LUX,5,0,15,0,20
2019,Syrian Arab Rep.,SYR,Luxembourg,LUX,265,0,30,0,295
2019,Togo,TGO,Luxembourg,LUX,0,0,5,0,5
2019,Tunisia,TUN,Luxembourg,LUX,0,0,20,0,20
2019,Turkey,TUR,Luxembourg,LUX,10,0,15,0,25
2019,Ukraine,UKR,Luxembourg,LUX,0,0,15,0,15
2019,Venezuela (Bolivarian Republic of),VEN,Luxembourg,LUX,0,15,0,0,15
2019,Yemen,YEM,Luxembourg,LUX,10,0,5,0,15
2019,Stateless,XXA,Luxembourg,LUX,5,0,0,0,5
2019,Unknown ,,Luxembourg,LUX,15,0,5,0,20
2019,Afghanistan,AFG,Latvia,LVA,0,0,0,5,5
2019,Egypt,EGY,Latvia,LVA,0,0,10,0,10
2019,Azerbaijan,AZE,Latvia,LVA,5,0,15,5,25
2019,Bangladesh,BGD,Latvia,LVA,0,0,5,0,5
2019,Cuba,CUB,Latvia,LVA,0,0,5,0,5
2019,Georgia,GEO,Latvia,LVA,0,0,10,5,15
2019,India,IND,Latvia,LVA,0,0,12,0,12
2019,Iraq,IRQ,Latvia,LVA,0,0,0,5,5
2019,Mongolia,MNG,Latvia,LVA,0,0,5,0,5
2019,Nigeria,NGA,Latvia,LVA,0,0,10,0,10
2019,Russian Federation,RUS,Latvia,LVA,18,0,15,5,38
2019,Syrian Arab Rep.,SYR,Latvia,LVA,0,0,0,5,5
2019,Ukraine,UKR,Latvia,LVA,0,0,10,0,10
2019,Afghanistan,AFG,Rep. of Moldova,MDA,0,5,0,0,5
2019,Armenia,ARM,Rep. of Moldova,MDA,0,0,5,5,10
2019,Azerbaijan,AZE,Rep. of Moldova,MDA,0,0,10,0,10
2019,Bangladesh,BGD,Rep. of Moldova,MDA,0,0,28,0,28
2019,India,IND,Rep. of Moldova,MDA,0,0,0,5,5
2019,Russian Federation,RUS,Rep. of Moldova,MDA,0,0,5,0,5
2019,Syrian Arab Rep.,SYR,Rep. of Moldova,MDA,0,5,0,0,5
2019,Turkey,TUR,Rep. of Moldova,MDA,14,0,5,0,19
2019,Ukraine,UKR,Rep. of Moldova,MDA,0,0,5,0,5
2019,Uzbekistan,UZB,Rep. of Moldova,MDA,0,0,5,0,5
2019,Yemen,YEM,Rep. of Moldova,MDA,0,5,0,0,5
2019,Angola,AGO,Mexico,MEX,0,0,0,5,5
2019,Argentina,ARG,Mexico,MEX,0,0,0,5,5
2019,Bolivia (Plurinational State of),BOL,Mexico,MEX,0,0,5,0,5
2019,Brazil,BRA,Mexico,MEX,0,0,5,5,10
2019,Belize,BLZ,Mexico,MEX,5,0,0,0,5
2019,Chile,CHL,Mexico,MEX,0,0,16,5,21
2019,Cameroon,CMR,Mexico,MEX,0,0,0,32,32
2019,Colombia,COL,Mexico,MEX,36,5,22,54,117
2019,Cuba,CUB,Mexico,MEX,200,46,960,946,2152
2019,Ecuador,ECU,Mexico,MEX,5,0,0,10,15
2019,Eritrea,ERI,Mexico,MEX,0,0,0,5,5
2019,Ghana,GHA,Mexico,MEX,5,5,0,0,10
2019,Guatemala,GTM,Mexico,MEX,300,113,262,511,1186
2019,Guinea,GIN,Mexico,MEX,0,0,0,5,5
2019,Haiti,HTI,Mexico,MEX,22,12,179,145,358
2019,Honduras,HND,Mexico,MEX,4250,394,1088,5423,11155
2019,Iran (Islamic Rep. of),IRN,Mexico,MEX,0,0,0,5,5
2019,Jamaica,JAM,Mexico,MEX,5,0,0,0,5
2019,Nicaragua,NIC,Mexico,MEX,263,182,52,503,1000
2019,Nigeria,NGA,Mexico,MEX,5,0,0,0,5
2019,Panama,PAN,Mexico,MEX,0,0,0,5,5
2019,Peru,PER,Mexico,MEX,5,0,0,0,5
2019,Russian Federation,RUS,Mexico,MEX,10,0,0,0,10
2019,El Salvador,SLV,Mexico,MEX,1623,488,379,1473,3963
2019,Uganda,UGA,Mexico,MEX,0,0,0,12,12
2019,Ukraine,UKR,Mexico,MEX,0,0,0,5,5
2019,United States of America,USA,Mexico,MEX,11,0,5,12,28
2019,Venezuela (Bolivarian Republic of),VEN,Mexico,MEX,4080,0,51,443,4574
2019,Yemen,YEM,Mexico,MEX,0,0,0,5,5
2019,Central African Rep.,CAF,Mali,MLI,127,0,0,10,137
2019,Cameroon,CMR,Mali,MLI,5,0,0,0,5
2019,Dem. Rep. of the Congo,COD,Mali,MLI,15,0,0,0,15
2019,Cote d'Ivoire,CIV,Mali,MLI,0,0,0,5,5
2019,Pakistan,PAK,Mali,MLI,10,0,0,0,10
2019,Togo,TGO,Mali,MLI,5,0,0,5,10
2019,Burundi,BDI,Malawi,MWI,34,0,0,5,39
2019,Dem. Rep. of the Congo,COD,Malawi,MWI,254,0,0,13,267
2019,Rwanda,RWA,Malawi,MWI,110,0,0,0,110
2019,Somalia,SOM,Malawi,MWI,0,0,0,5,5
2019,Rwanda,RWA,Mozambique,MOZ,0,0,0,190,190
2019,Somalia,SOM,Mozambique,MOZ,0,0,0,758,758
2019,Algeria,DZA,Malta,MLT,0,0,0,5,5
2019,Egypt,EGY,Malta,MLT,0,0,15,5,20
2019,Benin,BEN,Malta,MLT,0,0,0,5,5
2019,Bangladesh,BGD,Malta,MLT,0,5,103,36,144
2019,Cameroon,CMR,Malta,MLT,0,0,0,18,18
2019,Eritrea,ERI,Malta,MLT,0,19,0,25,44
2019,Ethiopia,ETH,Malta,MLT,0,0,5,5,10
2019,Gambia,GMB,Malta,MLT,0,0,0,175,175
2019,Ghana,GHA,Malta,MLT,0,0,0,20,20
2019,Guinea-Bissau,GNB,Malta,MLT,0,0,0,5,5
2019,Guinea,GIN,Malta,MLT,0,0,0,21,21
2019,Cote d'Ivoire,CIV,Malta,MLT,0,0,0,60,60
2019,Iran (Islamic Rep. of),IRN,Malta,MLT,0,0,0,5,5
2019,Iraq,IRQ,Malta,MLT,5,0,0,5,10
2019,Libya,LBY,Malta,MLT,10,43,0,75,128
2019,North Macedonia,MKD,Malta,MLT,0,0,5,0,5
2019,Mali,MLI,Malta,MLT,0,0,0,25,25
2019,Morocco,MAR,Malta,MLT,0,0,32,17,49
2019,Nigeria,NGA,Malta,MLT,0,0,10,104,114
2019,Pakistan,PAK,Malta,MLT,0,0,0,17,17
2019,Senegal,SEN,Malta,MLT,0,0,0,26,26
2019,Sierra Leone,SLE,Malta,MLT,0,0,0,5,5
2019,Somalia,SOM,Malta,MLT,0,10,0,200,210
2019,Sudan,SDN,Malta,MLT,5,0,0,87,92
2019,South Sudan,SSD,Malta,MLT,0,0,0,11,11
2019,Syrian Arab Rep.,SYR,Malta,MLT,5,203,0,71,279
2019,Turkey,TUR,Malta,MLT,0,0,5,0,5
2019,Ukraine,UKR,Malta,MLT,0,5,0,5,10
2019,Venezuela (Bolivarian Republic of),VEN,Malta,MLT,0,0,12,0,12
2019,Burundi,BDI,Namibia,NAM,23,0,0,0,23
2019,Central African Rep.,CAF,Namibia,NAM,5,0,0,5,10
2019,Cameroon,CMR,Namibia,NAM,14,0,0,0,14
2019,Dem. Rep. of the Congo,COD,Namibia,NAM,725,0,0,0,725
2019,Afghanistan,AFG,Netherlands,NLD,29,28,92,32,181
2019,Albania,ALB,Netherlands,NLD,0,0,143,59,202
2019,Algeria,DZA,Netherlands,NLD,0,0,305,194,499
2019,Angola,AGO,Netherlands,NLD,0,0,12,5,17
2019,Egypt,EGY,Netherlands,NLD,21,0,26,17,64
2019,Armenia,ARM,Netherlands,NLD,5,0,10,12,27
2019,Azerbaijan,AZE,Netherlands,NLD,5,5,11,133,154
2019,Burundi,BDI,Netherlands,NLD,0,0,5,0,5
2019,Bangladesh,BGD,Netherlands,NLD,0,0,12,5,17
2019,Belarus,BLR,Netherlands,NLD,0,0,5,27,32
2019,Brazil,BRA,Netherlands,NLD,0,0,5,0,5
2019,Bosnia and Herzegovina,BIH,Netherlands,NLD,0,0,59,10,69
2019,Chad,TCD,Netherlands,NLD,0,0,0,5,5
2019,China,CHN,Netherlands,NLD,82,0,12,5,99
2019,Cameroon,CMR,Netherlands,NLD,0,0,10,5,15
2019,Congo,COG,Netherlands,NLD,0,0,28,5,33
2019,Dem. Rep. of the Congo,COD,Netherlands,NLD,0,0,10,0,10
2019,Colombia,COL,Netherlands,NLD,5,0,24,21,50
2019,Cuba,CUB,Netherlands,NLD,0,0,16,5,21
2019,Dominican Rep.,DOM,Netherlands,NLD,0,0,0,5,5
2019,Ecuador,ECU,Netherlands,NLD,0,0,5,0,5
2019,Eritrea,ERI,Netherlands,NLD,361,29,139,25,554
2019,Ethiopia,ETH,Netherlands,NLD,0,0,10,5,15
2019,Gambia,GMB,Netherlands,NLD,5,0,29,14,48
2019,Palestinian,PSE,Netherlands,NLD,0,0,5,5,10
2019,Georgia,GEO,Netherlands,NLD,0,0,298,41,339
2019,Ghana,GHA,Netherlands,NLD,0,0,28,5,33
2019,Guinea,GIN,Netherlands,NLD,5,0,53,15,73
2019,Haiti,HTI,Netherlands,NLD,0,0,5,0,5
2019,Cote d'Ivoire,CIV,Netherlands,NLD,0,0,10,5,15
2019,India,IND,Netherlands,NLD,0,0,14,23,37
2019,Iran (Islamic Rep. of),IRN,Netherlands,NLD,207,82,268,101,658
2019,Iraq,IRQ,Netherlands,NLD,69,5,163,68,305
2019,Jamaica,JAM,Netherlands,NLD,10,0,5,0,15
2019,Jordan,JOR,Netherlands,NLD,0,0,26,17,43
2019,Kazakhstan,KAZ,Netherlands,NLD,5,0,0,0,5
2019,Kenya,KEN,Netherlands,NLD,0,0,5,0,5
2019,Liberia,LBR,Netherlands,NLD,0,0,10,0,10
2019,Libya,LBY,Netherlands,NLD,5,5,43,68,121
2019,Lebanon,LBN,Netherlands,NLD,14,0,11,10,35
2019,Sri Lanka,LKA,Netherlands,NLD,0,0,19,5,24
2019,North Macedonia,MKD,Netherlands,NLD,0,0,272,10,282
2019,Rep. of Moldova,MDA,Netherlands,NLD,0,0,343,148,491
2019,Mali,MLI,Netherlands,NLD,0,0,5,5,10
2019,Mongolia,MNG,Netherlands,NLD,0,0,5,0,5
2019,Morocco,MAR,Netherlands,NLD,10,0,295,269,574
2019,Montenegro,MNE,Netherlands,NLD,0,0,13,10,23
2019,Myanmar,MMR,Netherlands,NLD,5,0,5,0,10
2019,Niger,NER,Netherlands,NLD,0,0,5,0,5
2019,Nicaragua,NIC,Netherlands,NLD,0,0,10,0,10
2019,Nigeria,NGA,Netherlands,NLD,5,0,112,57,174
2019,Pakistan,PAK,Netherlands,NLD,58,10,51,16,135
2019,Philippines,PHL,Netherlands,NLD,0,0,5,0,5
2019,South Africa,ZAF,Netherlands,NLD,0,0,5,0,5
2019,Russian Federation,RUS,Netherlands,NLD,43,5,25,13,86
2019,El Salvador,SLV,Netherlands,NLD,0,0,10,0,10
2019,Saudi Arabia,SAU,Netherlands,NLD,5,0,0,5,10
2019,Serbia and Kosovo: S/RES/1244 (1999),SRB,Netherlands,NLD,0,0,345,28,373
2019,Senegal,SEN,Netherlands,NLD,0,0,20,5,25
2019,Sierra Leone,SLE,Netherlands,NLD,10,0,14,5,29
2019,Somalia,SOM,Netherlands,NLD,17,0,40,19,76
2019,Viet Nam,VNM,Netherlands,NLD,0,0,17,23,40
2019,Sudan,SDN,Netherlands,NLD,26,0,38,25,89
2019,Suriname,SUR,Netherlands,NLD,0,0,5,0,5
2019,Syrian Arab Rep.,SYR,Netherlands,NLD,1667,14,322,74,2077
2019,United Rep. of Tanzania,TZA,Netherlands,NLD,0,0,5,0,5
2019,Tajikistan,TJK,Netherlands,NLD,0,0,5,68,73
2019,Turkmenistan,TKM,Netherlands,NLD,0,0,5,0,5
2019,Trinidad and Tobago,TTO,Netherlands,NLD,5,0,5,0,10
2019,Tunisia,TUN,Netherlands,NLD,5,0,68,29,102
2019,Turkey,TUR,Netherlands,NLD,631,284,45,32,992
2019,Uganda,UGA,Netherlands,NLD,10,0,45,0,55
2019,Ukraine,UKR,Netherlands,NLD,0,0,48,20,68
2019,United States of America,USA,Netherlands,NLD,5,10,5,0,20
2019,Venezuela (Bolivarian Republic of),VEN,Netherlands,NLD,5,5,57,28,95
2019,Yemen,YEM,Netherlands,NLD,420,5,28,5,458
2019,Zimbabwe,ZWE,Netherlands,NLD,0,0,5,0,5
2019,Stateless,XXA,Netherlands,NLD,78,0,34,0,112
2019,Unknown ,,Netherlands,NLD,142,13,124,65,344
2019,Central African Rep.,CAF,Niger,NER,103,0,0,5,108
2019,Chad,TCD,Niger,NER,0,0,0,5,5
2019,Cameroon,CMR,Niger,NER,0,0,5,5,10
2019,Dem. Rep. of the Congo,COD,Niger,NER,5,0,5,0,10
2019,Eritrea,ERI,Niger,NER,5,0,0,0,5
2019,Guinea,GIN,Niger,NER,0,0,5,5,10
2019,Cote d'Ivoire,CIV,Niger,NER,0,0,0,5,5
2019,Nigeria,NGA,Niger,NER,0,0,5,7251,7256
2019,Sudan,SDN,Niger,NER,358,0,36,148,542
2019,Togo,TGO,Niger,NER,5,0,5,0,10
2019,Benin,BEN,Nigeria,NGA,5,0,0,0,5
2019,Central African Rep.,CAF,Nigeria,NGA,16,0,0,0,16
2019,Chad,TCD,Nigeria,NGA,0,0,0,14,14
2019,Cameroon,CMR,Nigeria,NGA,19315,0,0,0,19315
2019,Dem. Rep. of the Congo,COD,Nigeria,NGA,5,0,0,138,143
2019,Guinea,GIN,Nigeria,NGA,0,0,0,5,5
2019,Cote d'Ivoire,CIV,Nigeria,NGA,0,0,0,19,19
2019,Liberia,LBR,Nigeria,NGA,0,0,0,5,5
2019,Lebanon,LBN,Nigeria,NGA,0,0,0,5,5
2019,Mali,MLI,Nigeria,NGA,0,0,0,16,16
2019,Syrian Arab Rep.,SYR,Nigeria,NGA,28,0,0,0,28
2019,Togo,TGO,Nigeria,NGA,0,0,0,10,10
2019,Turkey,TUR,Nigeria,NGA,5,0,0,0,5
2019,Afghanistan,AFG,Norway,NOR,33,20,70,14,137
2019,Albania,ALB,Norway,NOR,0,0,61,13,74
2019,Algeria,DZA,Norway,NOR,0,0,0,16,16
2019,Angola,AGO,Norway,NOR,0,0,5,13,18
2019,Egypt,EGY,Norway,NOR,0,0,0,5,5
2019,Armenia,ARM,Norway,NOR,5,0,0,0,5
2019,Azerbaijan,AZE,Norway,NOR,0,0,0,5,5
2019,Bosnia and Herzegovina,BIH,Norway,NOR,0,0,5,0,5
2019,China,CHN,Norway,NOR,14,0,5,5,24
2019,Cameroon,CMR,Norway,NOR,0,0,5,5,10
2019,Dem. Rep. of the Congo,COD,Norway,NOR,5,0,0,5,10
2019,Colombia,COL,Norway,NOR,5,0,10,10,25
2019,Eritrea,ERI,Norway,NOR,157,10,5,26,198
2019,Ethiopia,ETH,Norway,NOR,11,0,17,15,43
2019,Gambia,GMB,Norway,NOR,0,0,0,5,5
2019,Georgia,GEO,Norway,NOR,0,0,16,10,26
2019,Germany,DEU,Norway,NOR,0,0,10,0,10
2019,Greece,GRC,Norway,NOR,0,0,5,0,5
2019,Guinea,GIN,Norway,NOR,0,0,5,0,5
2019,India,IND,Norway,NOR,0,0,5,0,5
2019,Iran (Islamic Rep. of),IRN,Norway,NOR,20,0,37,32,89
2019,Iraq,IRQ,Norway,NOR,13,0,27,24,64
2019,Kazakhstan,KAZ,Norway,NOR,5,0,5,0,10
2019,Kenya,KEN,Norway,NOR,5,0,0,5,10
2019,Libya,LBY,Norway,NOR,0,0,0,10,10
2019,Lebanon,LBN,Norway,NOR,0,0,0,5,5
2019,Sri Lanka,LKA,Norway,NOR,0,0,10,5,15
2019,North Macedonia,MKD,Norway,NOR,0,0,5,0,5
2019,Rep. of Moldova,MDA,Norway,NOR,0,0,5,0,5
2019,Mali,MLI,Norway,NOR,0,0,0,5,5
2019,Malaysia,MYS,Norway,NOR,0,0,5,0,5
2019,Mongolia,MNG,Norway,NOR,0,0,5,0,5
2019,Morocco,MAR,Norway,NOR,0,0,10,13,23
2019,Myanmar,MMR,Norway,NOR,0,0,5,0,5
2019,Nicaragua,NIC,Norway,NOR,0,0,5,0,5
2019,Nigeria,NGA,Norway,NOR,5,0,5,10,20
2019,Pakistan,PAK,Norway,NOR,5,0,10,16,31
2019,Peru,PER,Norway,NOR,0,0,11,0,11
2019,Poland,POL,Norway,NOR,0,0,5,0,5
2019,Russian Federation,RUS,Norway,NOR,11,0,61,17,89
2019,El Salvador,SLV,Norway,NOR,5,0,0,0,5
2019,Saudi Arabia,SAU,Norway,NOR,0,0,0,5,5
2019,Serbia and Kosovo: S/RES/1244 (1999),SRB,Norway,NOR,0,0,14,16,30
2019,Somalia,SOM,Norway,NOR,13,0,20,13,46
2019,Viet Nam,VNM,Norway,NOR,0,0,5,0,5
2019,Sudan,SDN,Norway,NOR,19,0,5,5,29
2019,South Sudan,SSD,Norway,NOR,5,0,0,5,10
2019,Sweden,SWE,Norway,NOR,0,0,5,0,5
2019,Syrian Arab Rep.,SYR,Norway,NOR,437,0,5,61,503
2019,Turkmenistan,TKM,Norway,NOR,5,0,0,5,10
2019,Tunisia,TUN,Norway,NOR,0,0,0,5,5
2019,Turkey,TUR,Norway,NOR,770,0,28,14,812
2019,Uganda,UGA,Norway,NOR,5,0,0,5,10
2019,Ukraine,UKR,Norway,NOR,0,0,21,0,21
2019,United States of America,USA,Norway,NOR,0,0,5,5,10
2019,Uzbekistan,UZB,Norway,NOR,0,0,5,5,10
2019,Venezuela (Bolivarian Republic of),VEN,Norway,NOR,5,0,20,0,25
2019,Yemen,YEM,Norway,NOR,0,5,0,5,10
2019,Stateless,XXA,Norway,NOR,53,0,68,31,152
2019,Bangladesh,BGD,Nauru,NRU,5,0,0,0,5
2019,Iran (Islamic Rep. of),IRN,Nauru,NRU,11,0,0,0,11
2019,Sri Lanka,LKA,Nauru,NRU,5,0,0,0,5
2019,Afghanistan,AFG,New Zealand,NZL,0,0,5,0,5
2019,Egypt,EGY,New Zealand,NZL,10,0,0,0,10
2019,Bangladesh,BGD,New Zealand,NZL,0,0,5,0,5
2019,China,CHN,New Zealand,NZL,50,0,38,5,93
2019,Colombia,COL,New Zealand,NZL,5,0,5,0,10
2019,Czechia,CZE,New Zealand,NZL,5,0,0,0,5
2019,Fiji,FJI,New Zealand,NZL,0,0,0,5,5
2019,India,IND,New Zealand,NZL,5,0,36,5,46
2019,Iran (Islamic Rep. of),IRN,New Zealand,NZL,12,0,0,0,12
2019,Sri Lanka,LKA,New Zealand,NZL,5,0,18,5,28
2019,Malaysia,MYS,New Zealand,NZL,5,0,15,0,20
2019,Myanmar,MMR,New Zealand,NZL,5,0,0,0,5
2019,Nigeria,NGA,New Zealand,NZL,0,0,5,0,5
2019,Pakistan,PAK,New Zealand,NZL,5,0,13,0,18
2019,Philippines,PHL,New Zealand,NZL,5,0,0,0,5
2019,South Africa,ZAF,New Zealand,NZL,0,0,5,5,10
2019,Russian Federation,RUS,New Zealand,NZL,10,0,0,0,10
2019,Saudi Arabia,SAU,New Zealand,NZL,11,0,10,0,21
2019,Sudan,SDN,New Zealand,NZL,5,0,0,0,5
2019,Syrian Arab Rep.,SYR,New Zealand,NZL,5,0,0,0,5
2019,Turkey,TUR,New Zealand,NZL,0,0,5,0,5
2019,Uruguay,URY,New Zealand,NZL,0,0,5,0,5
2019,Zimbabwe,ZWE,New Zealand,NZL,0,0,10,0,10
2019,Colombia,COL,Panama,PAN,22,0,10,595,627
2019,Cuba,CUB,Panama,PAN,0,0,0,1215,1215
2019,Dominican Rep.,DOM,Panama,PAN,0,0,0,22,22
2019,Ecuador,ECU,Panama,PAN,0,0,0,10,10
2019,Guatemala,GTM,Panama,PAN,0,0,0,5,5
2019,Haiti,HTI,Panama,PAN,0,0,0,5,5
2019,Honduras,HND,Panama,PAN,0,0,0,23,23
2019,Nicaragua,NIC,Panama,PAN,5,0,0,1076,1081
2019,Nigeria,NGA,Panama,PAN,0,0,0,5,5
2019,Peru,PER,Panama,PAN,0,0,0,5,5
2019,El Salvador,SLV,Panama,PAN,5,0,0,252,257
2019,Syrian Arab Rep.,SYR,Panama,PAN,0,0,0,5,5
2019,Venezuela (Bolivarian Republic of),VEN,Panama,PAN,15,0,0,2386,2401
2019,Cuba,CUB,Paraguay,PRY,12,0,0,0,12
2019,Peru,PER,Paraguay,PRY,5,0,0,0,5
2019,El Salvador,SLV,Paraguay,PRY,5,0,0,0,5
2019,Venezuela (Bolivarian Republic of),VEN,Paraguay,PRY,723,0,0,0,723
2019,Cameroon,CMR,Peru,PER,5,0,5,0,10
2019,Colombia,COL,Peru,PER,10,0,0,5,15
2019,Cuba,CUB,Peru,PER,79,0,59,18,156
2019,Haiti,HTI,Peru,PER,10,0,5,0,15
2019,Nicaragua,NIC,Peru,PER,5,0,0,0,5
2019,Philippines,PHL,Peru,PER,0,0,5,5,10
2019,Venezuela (Bolivarian Republic of),VEN,Peru,PER,578,0,171,2641,3390
2019,Iran (Islamic Rep. of),IRN,Papua New Guinea,PNG,10,0,0,5,15
2019,Afghanistan,AFG,Poland,POL,5,10,0,51,66
2019,Algeria,DZA,Poland,POL,0,0,12,0,12
2019,Angola,AGO,Poland,POL,0,0,5,5,10
2019,Egypt,EGY,Poland,POL,5,0,5,12,22
2019,Armenia,ARM,Poland,POL,0,0,28,37,65
2019,Azerbaijan,AZE,Poland,POL,0,5,19,5,29
2019,Bangladesh,BGD,Poland,POL,0,0,10,0,10
2019,Belarus,BLR,Poland,POL,5,0,31,10,46
2019,China,CHN,Poland,POL,5,0,0,10,15
2019,Cuba,CUB,Poland,POL,0,0,5,15,20
2019,Ethiopia,ETH,Poland,POL,0,0,5,0,5
2019,Finland,FIN,Poland,POL,0,0,0,5,5
2019,Gambia,GMB,Poland,POL,0,0,0,5,5
2019,Georgia,GEO,Poland,POL,0,0,39,28,67
2019,India,IND,Poland,POL,0,0,10,5,15
2019,Iran (Islamic Rep. of),IRN,Poland,POL,19,0,20,12,51
2019,Iraq,IRQ,Poland,POL,14,5,14,15,48
2019,Jordan,JOR,Poland,POL,0,0,0,5,5
2019,Kazakhstan,KAZ,Poland,POL,0,0,29,10,39
2019,Kyrgyzstan,KGZ,Poland,POL,0,0,34,5,39
2019,Lebanon,LBN,Poland,POL,0,0,0,10,10
2019,Rep. of Moldova,MDA,Poland,POL,0,0,0,5,5
2019,Nigeria,NGA,Poland,POL,0,0,5,5,10
2019,Pakistan,PAK,Poland,POL,0,0,15,10,25
2019,Russian Federation,RUS,Poland,POL,10,68,961,1543,2582
2019,Viet Nam,VNM,Poland,POL,0,0,23,17,40
2019,Syrian Arab Rep.,SYR,Poland,POL,5,5,0,10,20
2019,Tajikistan,TJK,Poland,POL,10,21,61,32,124
2019,Turkey,TUR,Poland,POL,49,0,5,12,66
2019,Uganda,UGA,Poland,POL,0,0,5,0,5
2019,Ukraine,UKR,Poland,POL,5,11,357,86,459
2019,Uzbekistan,UZB,Poland,POL,0,5,0,5,10
2019,Yemen,YEM,Poland,POL,0,0,0,5,5
2019,Stateless,XXA,Poland,POL,0,0,5,10,15
2019,Afghanistan,AFG,Portugal,PRT,5,0,0,16,21
2019,Albania,ALB,Portugal,PRT,0,0,0,5,5
2019,Algeria,DZA,Portugal,PRT,0,0,0,13,13
2019,Angola,AGO,Portugal,PRT,0,0,0,173,173
2019,Egypt,EGY,Portugal,PRT,0,0,0,5,5
2019,Azerbaijan,AZE,Portugal,PRT,0,0,0,5,5
2019,Bangladesh,BGD,Portugal,PRT,0,0,0,5,5
2019,Burkina Faso,BFA,Portugal,PRT,0,0,0,5,5
2019,Brazil,BRA,Portugal,PRT,0,0,0,5,5
2019,China,CHN,Portugal,PRT,0,0,0,5,5
2019,Cameroon,CMR,Portugal,PRT,0,0,0,29,29
2019,Congo,COG,Portugal,PRT,0,0,0,11,11
2019,Dem. Rep. of the Congo,COD,Portugal,PRT,0,0,0,57,57
2019,Comoros,COM,Portugal,PRT,0,0,0,5,5
2019,Cuba,CUB,Portugal,PRT,0,0,0,10,10
2019,Eritrea,ERI,Portugal,PRT,13,0,0,0,13
2019,Gambia,GMB,Portugal,PRT,0,0,0,126,126
2019,Ghana,GHA,Portugal,PRT,0,0,0,10,10
2019,Guinea-Bissau,GNB,Portugal,PRT,0,0,0,116,116
2019,Guinea,GIN,Portugal,PRT,0,5,0,82,87
2019,Haiti,HTI,Portugal,PRT,0,0,0,5,5
2019,Cote d'Ivoire,CIV,Portugal,PRT,0,0,0,15,15
2019,Iran (Islamic Rep. of),IRN,Portugal,PRT,5,0,0,12,17
2019,Iraq,IRQ,Portugal,PRT,17,5,0,10,32
2019,Sri Lanka,LKA,Portugal,PRT,0,0,0,5,5
2019,Mauritania,MRT,Portugal,PRT,0,0,0,5,5
2019,Mali,MLI,Portugal,PRT,0,0,0,19,19
2019,Morocco,MAR,Portugal,PRT,0,0,0,12,12
2019,Nigeria,NGA,Portugal,PRT,0,0,0,29,29
2019,Pakistan,PAK,Portugal,PRT,0,0,0,5,5
2019,Russian Federation,RUS,Portugal,PRT,0,0,0,5,5
2019,Senegal,SEN,Portugal,PRT,0,0,0,43,43
2019,Sierra Leone,SLE,Portugal,PRT,0,0,0,27,27
2019,Somalia,SOM,Portugal,PRT,0,0,0,12,12
2019,Sudan,SDN,Portugal,PRT,26,0,0,5,31
2019,South Sudan,SSD,Portugal,PRT,15,0,0,0,15
2019,Syrian Arab Rep.,SYR,Portugal,PRT,94,72,0,0,166
2019,Togo,TGO,Portugal,PRT,0,0,0,25,25
2019,Turkey,TUR,Portugal,PRT,5,0,0,0,5
2019,Ukraine,UKR,Portugal,PRT,0,13,0,27,40
2019,Venezuela (Bolivarian Republic of),VEN,Portugal,PRT,0,0,0,42,42
2019,Stateless,XXA,Portugal,PRT,0,5,0,5,10
2019,Unknown ,,Portugal,PRT,0,0,0,5,5
2019,Afghanistan,AFG,Romania,ROU,22,15,68,52,157
2019,Algeria,DZA,Romania,ROU,0,0,62,23,85
2019,Angola,AGO,Romania,ROU,0,0,5,0,5
2019,Bangladesh,BGD,Romania,ROU,5,0,118,30,153
2019,China,CHN,Romania,ROU,0,0,5,5,10
2019,Cameroon,CMR,Romania,ROU,0,0,42,5,47
2019,Congo,COG,Romania,ROU,0,0,5,0,5
2019,Comoros,COM,Romania,ROU,0,0,5,0,5
2019,Eritrea,ERI,Romania,ROU,10,0,0,5,15
2019,Ethiopia,ETH,Romania,ROU,0,0,5,5,10
2019,Palestinian,PSE,Romania,ROU,5,5,22,5,37
2019,Guinea,GIN,Romania,ROU,0,0,11,0,11
2019,Cote d'Ivoire,CIV,Romania,ROU,0,0,5,0,5
2019,India,IND,Romania,ROU,0,0,60,5,65
2019,Iran (Islamic Rep. of),IRN,Romania,ROU,25,5,63,40,133
2019,Iraq,IRQ,Romania,ROU,33,39,159,365,596
2019,Jordan,JOR,Romania,ROU,0,0,10,0,10
2019,Libya,LBY,Romania,ROU,0,0,10,10,20
2019,Sri Lanka,LKA,Romania,ROU,0,0,21,20,41
2019,Rep. of Moldova,MDA,Romania,ROU,0,0,5,10,15
2019,Morocco,MAR,Romania,ROU,0,0,33,12,45
2019,Myanmar,MMR,Romania,ROU,0,0,5,0,5
2019,Nepal,NPL,Romania,ROU,0,0,5,5,10
2019,Nigeria,NGA,Romania,ROU,0,0,15,0,15
2019,Pakistan,PAK,Romania,ROU,5,5,52,5,67
2019,South Africa,ZAF,Romania,ROU,0,0,5,0,5
2019,Senegal,SEN,Romania,ROU,0,0,5,0,5
2019,Somalia,SOM,Romania,ROU,40,14,29,22,105
2019,Viet Nam,VNM,Romania,ROU,0,0,0,12,12
2019,Sudan,SDN,Romania,ROU,5,0,5,0,10
2019,Syrian Arab Rep.,SYR,Romania,ROU,147,158,10,52,367
2019,Tunisia,TUN,Romania,ROU,0,0,16,11,27
2019,Turkey,TUR,Romania,ROU,10,0,40,54,104
2019,Uganda,UGA,Romania,ROU,5,0,0,0,5
2019,Ukraine,UKR,Romania,ROU,0,5,10,10,25
2019,Yemen,YEM,Romania,ROU,0,10,0,0,10
2019,Stateless,XXA,Romania,ROU,0,5,10,0,15
2019,Unknown ,,South Africa,ZAF,1835,0,22063,20,23918
2019,Afghanistan,AFG,Russian Federation,RUS,0,0,0,180,180
2019,Belgium,BEL,Russian Federation,RUS,0,0,0,15,15
2019,Bangladesh,BGD,Russian Federation,RUS,0,0,0,5,5
2019,Eritrea,ERI,Russian Federation,RUS,0,0,0,12,12
2019,Palestinian,PSE,Russian Federation,RUS,0,0,0,5,5
2019,Kazakhstan,KAZ,Russian Federation,RUS,0,0,0,5,5
2019,Kyrgyzstan,KGZ,Russian Federation,RUS,0,0,0,5,5
2019,Dem. People's Rep. of Korea,PRK,Russian Federation,RUS,0,0,0,5,5
2019,Niger,NER,Russian Federation,RUS,0,0,0,5,5
2019,Syrian Arab Rep.,SYR,Russian Federation,RUS,0,0,0,64,64
2019,Tajikistan,TJK,Russian Federation,RUS,0,0,0,10,10
2019,Turkmenistan,TKM,Russian Federation,RUS,0,0,0,5,5
2019,Ukraine,UKR,Russian Federation,RUS,16,0,0,27,43
2019,Uzbekistan,UZB,Russian Federation,RUS,0,0,0,5,5
2019,Yemen,YEM,Russian Federation,RUS,0,0,0,14,14
2019,Unknown ,,Russian Federation,RUS,0,0,0,5,5
2019,Burundi,BDI,Rwanda,RWA,5,0,0,21,26
2019,Dem. Rep. of the Congo,COD,Rwanda,RWA,52,0,0,98,150
2019,Eritrea,ERI,Rwanda,RWA,105,0,0,0,105
2019,Somalia,SOM,Rwanda,RWA,13,0,0,0,13
2019,Sudan,SDN,Rwanda,RWA,13,0,0,0,13
2019,Nicaragua,NIC,El Salvador,SLV,0,0,0,13,13
2019,Afghanistan,AFG,Serbia and Kosovo: S/RES/1244 (1999),SRB,5,0,5,91,101
2019,Algeria,DZA,Serbia and Kosovo: S/RES/1244 (1999),SRB,0,0,0,114,114
2019,Egypt,EGY,Serbia and Kosovo: S/RES/1244 (1999),SRB,0,0,0,5,5
2019,Burundi,BDI,Serbia and Kosovo: S/RES/1244 (1999),SRB,0,0,0,5,5
2019,Bangladesh,BGD,Serbia and Kosovo: S/RES/1244 (1999),SRB,0,0,0,5,5
2019,Bulgaria,BGR,Serbia and Kosovo: S/RES/1244 (1999),SRB,0,0,5,0,5
2019,Cuba,CUB,Serbia and Kosovo: S/RES/1244 (1999),SRB,5,0,0,5,10
2019,Palestinian,PSE,Serbia and Kosovo: S/RES/1244 (1999),SRB,0,0,0,90,90
2019,Ghana,GHA,Serbia and Kosovo: S/RES/1244 (1999),SRB,0,0,0,5,5
2019,India,IND,Serbia and Kosovo: S/RES/1244 (1999),SRB,0,0,5,0,5
2019,Iran (Islamic Rep. of),IRN,Serbia and Kosovo: S/RES/1244 (1999),SRB,5,0,55,96,156
2019,Iraq,IRQ,Serbia and Kosovo: S/RES/1244 (1999),SRB,0,5,0,559,564
2019,Libya,LBY,Serbia and Kosovo: S/RES/1244 (1999),SRB,0,5,0,48,53
2019,Lebanon,LBN,Serbia and Kosovo: S/RES/1244 (1999),SRB,0,0,0,13,13
2019,Morocco,MAR,Serbia and Kosovo: S/RES/1244 (1999),SRB,0,0,0,133,133
2019,Nigeria,NGA,Serbia and Kosovo: S/RES/1244 (1999),SRB,0,0,5,0,5
2019,Pakistan,PAK,Serbia and Kosovo: S/RES/1244 (1999),SRB,0,0,0,21,21
2019,Russian Federation,RUS,Serbia and Kosovo: S/RES/1244 (1999),SRB,5,0,0,0,5
2019,Somalia,SOM,Serbia and Kosovo: S/RES/1244 (1999),SRB,0,0,0,10,10
2019,Syrian Arab Rep.,SYR,Serbia and Kosovo: S/RES/1244 (1999),SRB,0,5,0,888,893
2019,Tunisia,TUN,Serbia and Kosovo: S/RES/1244 (1999),SRB,0,0,0,5,5
2019,Turkey,TUR,Serbia and Kosovo: S/RES/1244 (1999),SRB,33,0,0,15,48
2019,Yemen,YEM,Serbia and Kosovo: S/RES/1244 (1999),SRB,0,0,0,21,21
2019,Afghanistan,AFG,Spain,ESP,21,43,19,0,83
2019,Albania,ALB,Spain,ESP,0,0,34,0,34
2019,Algeria,DZA,Spain,ESP,10,11,514,0,535
2019,Angola,AGO,Spain,ESP,0,0,10,0,10
2019,Egypt,EGY,Spain,ESP,24,0,26,0,50
2019,Argentina,ARG,Spain,ESP,0,0,12,0,12
2019,Armenia,ARM,Spain,ESP,0,5,76,0,81
2019,Azerbaijan,AZE,Spain,ESP,10,0,5,0,15
2019,Burundi,BDI,Spain,ESP,5,0,0,0,5
2019,Bangladesh,BGD,Spain,ESP,5,0,312,0,317
2019,Burkina Faso,BFA,Spain,ESP,0,0,12,0,12
2019,Bolivia (Plurinational State of),BOL,Spain,ESP,0,0,33,0,33
2019,Brazil,BRA,Spain,ESP,14,0,147,0,161
2019,Central African Rep.,CAF,Spain,ESP,5,14,14,0,33
2019,Chad,TCD,Spain,ESP,5,0,5,0,10
2019,China,CHN,Spain,ESP,0,0,12,0,12
2019,Chile,CHL,Spain,ESP,0,0,5,0,5
2019,Cameroon,CMR,Spain,ESP,31,0,83,0,114
2019,Congo,COG,Spain,ESP,24,10,52,0,86
2019,Dem. Rep. of the Congo,COD,Spain,ESP,5,10,52,0,67
2019,Colombia,COL,Spain,ESP,48,10,3896,0,3954
2019,Costa Rica,CRI,Spain,ESP,0,0,5,0,5
2019,Cuba,CUB,Spain,ESP,15,0,256,0,271
2019,Dominican Rep.,DOM,Spain,ESP,5,0,105,0,110
2019,Ecuador,ECU,Spain,ESP,0,0,28,0,28
2019,Equatorial Guinea,GNQ,Spain,ESP,17,0,16,0,33
2019,Eritrea,ERI,Spain,ESP,29,0,0,0,29
2019,Ethiopia,ETH,Spain,ESP,5,0,5,0,10
2019,Gambia,GMB,Spain,ESP,24,0,113,0,137
2019,Palestinian,PSE,Spain,ESP,26,107,1053,0,1186
2019,Georgia,GEO,Spain,ESP,5,5,380,0,390
2019,Ghana,GHA,Spain,ESP,0,0,39,0,39
2019,Guinea-Bissau,GNB,Spain,ESP,0,0,10,0,10
2019,Guatemala,GTM,Spain,ESP,5,0,20,0,25
2019,Guinea,GIN,Spain,ESP,10,0,232,0,242
2019,Haiti,HTI,Spain,ESP,0,0,14,0,14
2019,Honduras,HND,Spain,ESP,226,13,779,0,1018
2019,Cote d'Ivoire,CIV,Spain,ESP,29,11,193,0,233
2019,India,IND,Spain,ESP,0,0,18,0,18
2019,Iran (Islamic Rep. of),IRN,Spain,ESP,84,5,15,0,104
2019,Iraq,IRQ,Spain,ESP,0,5,30,0,35
2019,Jamaica,JAM,Spain,ESP,32,0,0,0,32
2019,Jordan,JOR,Spain,ESP,0,5,0,0,5
2019,Kazakhstan,KAZ,Spain,ESP,0,5,0,0,5
2019,Kyrgyzstan,KGZ,Spain,ESP,5,0,10,0,15
2019,Liberia,LBR,Spain,ESP,0,0,15,0,15
2019,Libya,LBY,Spain,ESP,12,15,5,0,32
2019,Lebanon,LBN,Spain,ESP,0,0,21,0,21
2019,Sri Lanka,LKA,Spain,ESP,0,5,5,0,10
2019,Mauritania,MRT,Spain,ESP,0,0,5,0,5
2019,North Macedonia,MKD,Spain,ESP,0,0,5,0,5
2019,Rep. of Moldova,MDA,Spain,ESP,0,0,10,0,10
2019,Mexico,MEX,Spain,ESP,0,0,10,0,10
2019,Mali,MLI,Spain,ESP,5,56,166,0,227
2019,Mongolia,MNG,Spain,ESP,0,0,12,0,12
2019,Morocco,MAR,Spain,ESP,192,5,365,0,562
2019,Myanmar,MMR,Spain,ESP,5,0,0,0,5
2019,Nicaragua,NIC,Spain,ESP,166,0,694,0,860
2019,Nigeria,NGA,Spain,ESP,35,0,97,0,132
2019,Pakistan,PAK,Spain,ESP,24,0,99,0,123
2019,Panama,PAN,Spain,ESP,0,0,5,0,5
2019,Paraguay,PRY,Spain,ESP,5,0,40,0,45
2019,Peru,PER,Spain,ESP,24,0,533,0,557
2019,South Africa,ZAF,Spain,ESP,0,0,5,0,5
2019,Russian Federation,RUS,Spain,ESP,66,0,61,0,127
2019,El Salvador,SLV,Spain,ESP,245,22,1722,0,1989
2019,Saudi Arabia,SAU,Spain,ESP,5,0,0,0,5
2019,Serbia and Kosovo: S/RES/1244 (1999),SRB,Spain,ESP,5,0,13,0,18
2019,Senegal,SEN,Spain,ESP,0,0,193,0,193
2019,Sierra Leone,SLE,Spain,ESP,5,0,5,0,10
2019,Somalia,SOM,Spain,ESP,0,67,10,0,77
2019,Viet Nam,VNM,Spain,ESP,0,0,5,0,5
2019,Sudan,SDN,Spain,ESP,12,0,5,0,17
2019,South Sudan,SSD,Spain,ESP,5,0,0,0,5
2019,Syrian Arab Rep.,SYR,Spain,ESP,38,1081,615,0,1734
2019,Tunisia,TUN,Spain,ESP,5,0,88,0,93
2019,Turkey,TUR,Spain,ESP,5,0,24,0,29
2019,Uganda,UGA,Spain,ESP,0,0,5,0,5
2019,Ukraine,UKR,Spain,ESP,13,56,1024,0,1093
2019,Uruguay,URY,Spain,ESP,0,0,5,0,5
2019,United States of America,USA,Spain,ESP,0,0,10,0,10
2019,Uzbekistan,UZB,Spain,ESP,0,0,5,0,5
2019,Venezuela (Bolivarian Republic of),VEN,Spain,ESP,48,35128,181,0,35357
2019,Western Sahara,ESH,Spain,ESP,0,0,42,0,42
2019,Yemen,YEM,Spain,ESP,0,102,170,0,272
2019,Unknown ,,Spain,ESP,0,0,5,0,5
2019,Eritrea,ERI,Sudan,SDN,1801,0,0,1312,3113
2019,Ethiopia,ETH,Sudan,SDN,11,0,17,331,359
2019,Somalia,SOM,Sudan,SDN,32,0,0,119,151
2019,Yemen,YEM,Sudan,SDN,0,0,0,14,14
2019,Unknown ,,Sudan,SDN,0,0,0,62,62
2019,Burundi,BDI,South Sudan,SSD,52,0,0,0,52
2019,Eritrea,ERI,South Sudan,SSD,117,0,0,56,173
2019,Ethiopia,ETH,South Sudan,SSD,18,0,0,5,23
2019,Afghanistan,AFG,Slovakia,SVK,0,15,12,65,92
2019,Algeria,DZA,Slovakia,SVK,0,0,0,5,5
2019,Armenia,ARM,Slovakia,SVK,0,0,5,10,15
2019,Azerbaijan,AZE,Slovakia,SVK,0,0,5,0,5
2019,Bangladesh,BGD,Slovakia,SVK,0,0,0,12,12
2019,India,IND,Slovakia,SVK,0,0,0,5,5
2019,Iran (Islamic Rep. of),IRN,Slovakia,SVK,5,0,11,45,61
2019,Myanmar,MMR,Slovakia,SVK,0,0,0,5,5
2019,Pakistan,PAK,Slovakia,SVK,0,0,0,5,5
2019,Russian Federation,RUS,Slovakia,SVK,0,0,0,5,5
2019,Sudan,SDN,Slovakia,SVK,0,0,0,5,5
2019,Turkey,TUR,Slovakia,SVK,0,0,5,5,10
2019,Ukraine,UKR,Slovakia,SVK,0,0,10,0,10
2019,Afghanistan,AFG,Slovenia,SVN,5,0,73,369,447
2019,Albania,ALB,Slovenia,SVN,0,0,0,5,5
2019,Algeria,DZA,Slovenia,SVN,0,0,120,934,1054
2019,Egypt,EGY,Slovenia,SVN,0,0,0,40,40
2019,Azerbaijan,AZE,Slovenia,SVN,0,0,0,5,5
2019,Bangladesh,BGD,Slovenia,SVN,0,0,5,177,182
2019,Bosnia and Herzegovina,BIH,Slovenia,SVN,0,0,5,0,5
2019,China,CHN,Slovenia,SVN,0,0,0,10,10
2019,Dem. Rep. of the Congo,COD,Slovenia,SVN,0,0,5,0,5
2019,Cuba,CUB,Slovenia,SVN,0,0,10,20,30
2019,Eritrea,ERI,Slovenia,SVN,0,0,5,5,10
2019,Gambia,GMB,Slovenia,SVN,0,0,5,0,5
2019,Palestinian,PSE,Slovenia,SVN,0,0,5,26,31
2019,India,IND,Slovenia,SVN,0,0,0,29,29
2019,Iran (Islamic Rep. of),IRN,Slovenia,SVN,10,0,37,103,150
2019,Iraq,IRQ,Slovenia,SVN,5,0,32,70,107
2019,Libya,LBY,Slovenia,SVN,0,0,18,38,56
2019,Sri Lanka,LKA,Slovenia,SVN,0,0,0,5,5
2019,Morocco,MAR,Slovenia,SVN,0,0,53,649,702
2019,Nepal,NPL,Slovenia,SVN,0,0,0,5,5
2019,Nigeria,NGA,Slovenia,SVN,0,0,5,5,10
2019,Pakistan,PAK,Slovenia,SVN,0,0,26,510,536
2019,Philippines,PHL,Slovenia,SVN,0,0,0,5,5
2019,Russian Federation,RUS,Slovenia,SVN,5,0,5,5,15
2019,Serbia and Kosovo: S/RES/1244 (1999),SRB,Slovenia,SVN,0,0,16,10,26
2019,Somalia,SOM,Slovenia,SVN,5,0,0,0,5
2019,Viet Nam,VNM,Slovenia,SVN,0,0,0,5,5
2019,Syrian Arab Rep.,SYR,Slovenia,SVN,16,0,14,59,89
2019,Tajikistan,TJK,Slovenia,SVN,0,0,0,10,10
2019,Tunisia,TUN,Slovenia,SVN,0,0,17,108,125
2019,Turkey,TUR,Slovenia,SVN,28,0,10,55,93
2019,Yemen,YEM,Slovenia,SVN,0,0,0,5,5
2019,Unknown ,,Slovenia,SVN,0,0,5,5,10
2019,Congo,COG,Eswatini,SWZ,10,0,0,0,10
2019,Dem. Rep. of the Congo,COD,Eswatini,SWZ,23,0,0,0,23
2019,Rwanda,RWA,Eswatini,SWZ,13,0,0,0,13
2019,Somalia,SOM,Eswatini,SWZ,10,0,0,0,10
2019,Afghanistan,AFG,Sweden,SWE,223,53,458,133,867
2019,Albania,ALB,Sweden,SWE,0,0,400,110,510
2019,Algeria,DZA,Sweden,SWE,0,0,35,42,77
2019,Angola,AGO,Sweden,SWE,0,0,5,24,29
2019,Egypt,EGY,Sweden,SWE,23,5,275,54,357
2019,Argentina,ARG,Sweden,SWE,0,0,12,5,17
2019,Armenia,ARM,Sweden,SWE,0,0,64,17,81
2019,Azerbaijan,AZE,Sweden,SWE,45,0,226,78,349
2019,Burundi,BDI,Sweden,SWE,46,5,45,10,106
2019,Bangladesh,BGD,Sweden,SWE,10,0,149,18,177
2019,Burkina Faso,BFA,Sweden,SWE,0,0,5,0,5
2019,Belarus,BLR,Sweden,SWE,0,0,32,37,69
2019,Bolivia (Plurinational State of),BOL,Sweden,SWE,0,0,25,5,30
2019,Brazil,BRA,Sweden,SWE,0,0,19,5,24
2019,Bosnia and Herzegovina,BIH,Sweden,SWE,0,0,53,20,73
2019,Canada,CAN,Sweden,SWE,0,0,0,5,5
2019,China,CHN,Sweden,SWE,11,0,16,17,44
2019,Chile,CHL,Sweden,SWE,0,0,32,5,37
2019,Cameroon,CMR,Sweden,SWE,24,0,62,26,112
2019,Congo,COG,Sweden,SWE,0,0,0,14,14
2019,Dem. Rep. of the Congo,COD,Sweden,SWE,5,5,27,10,47
2019,Colombia,COL,Sweden,SWE,12,0,462,45,519
2019,Cuba,CUB,Sweden,SWE,0,0,13,15,28
2019,Djibouti,DJI,Sweden,SWE,0,0,5,5,10
2019,Ecuador,ECU,Sweden,SWE,0,0,11,5,16
2019,Eritrea,ERI,Sweden,SWE,549,52,83,139,823
2019,Ethiopia,ETH,Sweden,SWE,42,0,194,57,293
2019,Gabon,GAB,Sweden,SWE,0,0,0,5,5
2019,Gambia,GMB,Sweden,SWE,10,0,50,82,142
2019,Palestinian,PSE,Sweden,SWE,60,5,326,143,534
2019,Georgia,GEO,Sweden,SWE,0,0,933,150,1083
2019,Ghana,GHA,Sweden,SWE,0,0,20,28,48
2019,Guinea-Bissau,GNB,Sweden,SWE,0,0,5,5,10
2019,Guatemala,GTM,Sweden,SWE,0,0,11,0,11
2019,Guinea,GIN,Sweden,SWE,5,0,14,27,46
2019,Honduras,HND,Sweden,SWE,5,0,28,0,33
2019,Cote d'Ivoire,CIV,Sweden,SWE,10,0,5,10,25
2019,India,IND,Sweden,SWE,0,0,54,28,82
2019,Iran (Islamic Rep. of),IRN,Sweden,SWE,347,0,605,200,1152
2019,Iraq,IRQ,Sweden,SWE,142,55,733,331,1261
2019,Israel,ISR,Sweden,SWE,0,0,10,0,10
2019,Jordan,JOR,Sweden,SWE,16,5,111,55,187
2019,Japan,JPN,Sweden,SWE,0,0,5,0,5
2019,Kazakhstan,KAZ,Sweden,SWE,10,0,188,95,293
2019,Kenya,KEN,Sweden,SWE,5,0,13,5,23
2019,Kyrgyzstan,KGZ,Sweden,SWE,0,5,136,41,182
2019,Kuwait,KWT,Sweden,SWE,0,0,5,5,10
2019,Liberia,LBR,Sweden,SWE,0,0,10,5,15
2019,Libya,LBY,Sweden,SWE,0,5,35,45,85
2019,Lebanon,LBN,Sweden,SWE,10,0,99,56,165
2019,Sri Lanka,LKA,Sweden,SWE,0,0,19,11,30
2019,Mauritania,MRT,Sweden,SWE,0,0,0,5,5
2019,North Macedonia,MKD,Sweden,SWE,0,0,90,36,126
2019,Rep. of Moldova,MDA,Sweden,SWE,0,0,5,5,10
2019,Mexico,MEX,Sweden,SWE,0,0,11,0,11
2019,Mali,MLI,Sweden,SWE,0,0,5,5,10
2019,Malaysia,MYS,Sweden,SWE,0,0,5,0,5
2019,Mongolia,MNG,Sweden,SWE,0,0,240,71,311
2019,Morocco,MAR,Sweden,SWE,10,0,114,176,300
2019,Montenegro,MNE,Sweden,SWE,0,0,12,0,12
2019,Mauritius,MUS,Sweden,SWE,0,0,5,0,5
2019,Myanmar,MMR,Sweden,SWE,0,0,5,0,5
2019,Nepal,NPL,Sweden,SWE,0,0,10,0,10
2019,Niger,NER,Sweden,SWE,0,0,0,5,5
2019,Nicaragua,NIC,Sweden,SWE,69,0,312,14,395
2019,Nigeria,NGA,Sweden,SWE,36,0,163,143,342
2019,Norway,NOR,Sweden,SWE,0,0,0,5,5
2019,Pakistan,PAK,Sweden,SWE,65,0,246,72,383
2019,Peru,PER,Sweden,SWE,0,0,198,22,220
2019,Philippines,PHL,Sweden,SWE,0,0,15,0,15
2019,Romania,ROU,Sweden,SWE,0,0,5,0,5
2019,South Africa,ZAF,Sweden,SWE,0,0,5,0,5
2019,Russian Federation,RUS,Sweden,SWE,45,0,153,125,323
2019,Rwanda,RWA,Sweden,SWE,10,0,27,5,42
2019,El Salvador,SLV,Sweden,SWE,11,0,269,16,296
2019,Saudi Arabia,SAU,Sweden,SWE,0,0,5,5,10
2019,Serbia and Kosovo: S/RES/1244 (1999),SRB,Sweden,SWE,0,5,231,81,317
2019,Senegal,SEN,Sweden,SWE,0,0,5,18,23
2019,Sierra Leone,SLE,Sweden,SWE,0,0,11,5,16
2019,Somalia,SOM,Sweden,SWE,183,25,210,177,595
2019,Viet Nam,VNM,Sweden,SWE,0,0,32,13,45
2019,Sudan,SDN,Sweden,SWE,54,0,62,10,126
2019,Slovakia,SVK,Sweden,SWE,0,0,5,0,5
2019,Syrian Arab Rep.,SYR,Sweden,SWE,207,1644,99,445,2395
2019,United Rep. of Tanzania,TZA,Sweden,SWE,10,0,31,10,51
2019,Thailand,THA,Sweden,SWE,0,0,10,5,15
2019,Tajikistan,TJK,Sweden,SWE,12,0,27,21,60
2019,Tunisia,TUN,Sweden,SWE,0,0,59,43,102
2019,Turkey,TUR,Sweden,SWE,240,0,229,60,529
2019,Uganda,UGA,Sweden,SWE,21,0,23,12,56
2019,Ukraine,UKR,Sweden,SWE,0,0,623,181,804
2019,Uruguay,URY,Sweden,SWE,0,0,5,0,5
2019,United States of America,USA,Sweden,SWE,0,0,27,10,37
2019,Uzbekistan,UZB,Sweden,SWE,11,0,250,176,437
2019,Venezuela (Bolivarian Republic of),VEN,Sweden,SWE,13,0,163,12,188
2019,Yemen,YEM,Sweden,SWE,41,231,10,38,320
2019,Zambia,ZMB,Sweden,SWE,0,0,0,5,5
2019,Zimbabwe,ZWE,Sweden,SWE,0,0,5,5,10
2019,Stateless,XXA,Sweden,SWE,277,107,280,174,838
2019,Unknown ,,Sweden,SWE,5,5,85,40,135
2019,Afghanistan,AFG,Switzerland,CHE,374,1374,83,319,2150
2019,Albania,ALB,Switzerland,CHE,0,19,85,33,137
2019,Algeria,DZA,Switzerland,CHE,5,5,203,662,875
2019,Angola,AGO,Switzerland,CHE,0,29,10,35,74
2019,Egypt,EGY,Switzerland,CHE,0,0,10,26,36
2019,Armenia,ARM,Switzerland,CHE,5,5,18,31,59
2019,Australia,AUS,Switzerland,CHE,0,0,5,0,5
2019,Azerbaijan,AZE,Switzerland,CHE,13,10,18,48,89
2019,Burundi,BDI,Switzerland,CHE,22,5,5,0,32
2019,Benin,BEN,Switzerland,CHE,0,0,0,5,5
2019,Bangladesh,BGD,Switzerland,CHE,0,0,5,10,15
2019,Burkina Faso,BFA,Switzerland,CHE,0,0,0,10,10
2019,Belarus,BLR,Switzerland,CHE,0,0,12,26,38
2019,Brazil,BRA,Switzerland,CHE,0,0,5,0,5
2019,Bosnia and Herzegovina,BIH,Switzerland,CHE,0,5,18,13,36
2019,Central African Rep.,CAF,Switzerland,CHE,0,0,0,5,5
2019,Chad,TCD,Switzerland,CHE,0,0,5,5,10
2019,China,CHN,Switzerland,CHE,66,142,113,27,348
2019,Cameroon,CMR,Switzerland,CHE,5,25,21,30,81
2019,Congo,COG,Switzerland,CHE,0,0,5,0,5
2019,Dem. Rep. of the Congo,COD,Switzerland,CHE,15,46,31,29,121
2019,Colombia,COL,Switzerland,CHE,15,12,74,14,115
2019,Cuba,CUB,Switzerland,CHE,0,0,5,0,5
2019,Djibouti,DJI,Switzerland,CHE,0,0,0,5,5
2019,Eritrea,ERI,Switzerland,CHE,2797,714,567,92,4170
2019,Ethiopia,ETH,Switzerland,CHE,58,116,168,45,387
2019,Gambia,GMB,Switzerland,CHE,0,5,10,107,122
2019,Georgia,GEO,Switzerland,CHE,0,15,301,372,688
2019,Germany,DEU,Switzerland,CHE,0,0,5,5,10
2019,Ghana,GHA,Switzerland,CHE,0,0,0,27,27
2019,Guinea-Bissau,GNB,Switzerland,CHE,0,0,5,18,23
2019,Guinea,GIN,Switzerland,CHE,0,10,42,110,162
2019,Honduras,HND,Switzerland,CHE,0,0,5,0,5
2019,Hungary,HUN,Switzerland,CHE,0,0,5,0,5
2019,Cote d'Ivoire,CIV,Switzerland,CHE,5,24,12,35,76
2019,India,IND,Switzerland,CHE,0,5,10,5,20
2019,Iran (Islamic Rep. of),IRN,Switzerland,CHE,112,86,323,158,679
2019,Iraq,IRQ,Switzerland,CHE,105,289,144,214,752
2019,Italy,ITA,Switzerland,CHE,0,0,5,5,10
2019,Jordan,JOR,Switzerland,CHE,0,0,5,0,5
2019,Kazakhstan,KAZ,Switzerland,CHE,0,10,0,10,20
2019,Kenya,KEN,Switzerland,CHE,0,0,0,5,5
2019,Kuwait,KWT,Switzerland,CHE,0,5,0,0,5
2019,Liberia,LBR,Switzerland,CHE,0,0,5,5,10
2019,Libya,LBY,Switzerland,CHE,5,18,21,94,138
2019,Lebanon,LBN,Switzerland,CHE,5,5,10,10,30
2019,Sri Lanka,LKA,Switzerland,CHE,307,85,548,171,1111
2019,Mauritania,MRT,Switzerland,CHE,0,0,0,5,5
2019,North Macedonia,MKD,Switzerland,CHE,0,0,21,15,36
2019,Rep. of Moldova,MDA,Switzerland,CHE,0,0,10,5,15
2019,Mexico,MEX,Switzerland,CHE,0,0,5,0,5
2019,Mali,MLI,Switzerland,CHE,0,0,5,21,26
2019,Mongolia,MNG,Switzerland,CHE,0,10,10,10,30
2019,Morocco,MAR,Switzerland,CHE,5,0,62,330,397
2019,Montenegro,MNE,Switzerland,CHE,0,0,0,5,5
2019,Nepal,NPL,Switzerland,CHE,0,0,5,0,5
2019,Niger,NER,Switzerland,CHE,0,0,0,10,10
2019,Nicaragua,NIC,Switzerland,CHE,0,0,11,5,16
2019,Nigeria,NGA,Switzerland,CHE,0,28,44,339,411
2019,Pakistan,PAK,Switzerland,CHE,12,27,46,59,144
2019,Philippines,PHL,Switzerland,CHE,0,5,0,0,5
2019,Poland,POL,Switzerland,CHE,0,0,5,0,5
2019,Romania,ROU,Switzerland,CHE,0,0,5,0,5
2019,Russian Federation,RUS,Switzerland,CHE,20,10,33,92,155
2019,Rwanda,RWA,Switzerland,CHE,0,0,5,0,5
2019,El Salvador,SLV,Switzerland,CHE,0,0,5,5,10
2019,Saudi Arabia,SAU,Switzerland,CHE,0,5,0,5,10
2019,Serbia and Kosovo: S/RES/1244 (1999),SRB,Switzerland,CHE,5,40,99,128,272
2019,Senegal,SEN,Switzerland,CHE,0,5,5,29,39
2019,Sierra Leone,SLE,Switzerland,CHE,0,0,5,11,16
2019,Somalia,SOM,Switzerland,CHE,170,382,74,124,750
2019,Spain,ESP,Switzerland,CHE,0,0,5,0,5
2019,Viet Nam,VNM,Switzerland,CHE,0,0,0,5,5
2019,Sudan,SDN,Switzerland,CHE,25,10,13,22,70
2019,Slovakia,SVK,Switzerland,CHE,0,0,5,0,5
2019,Syrian Arab Rep.,SYR,Switzerland,CHE,654,1243,183,139,2219
2019,Tajikistan,TJK,Switzerland,CHE,5,0,0,5,10
2019,Togo,TGO,Switzerland,CHE,10,5,10,5,30
2019,Tunisia,TUN,Switzerland,CHE,0,0,38,120,158
2019,Turkey,TUR,Switzerland,CHE,633,45,165,152,995
2019,Uganda,UGA,Switzerland,CHE,0,0,5,10,15
2019,Ukraine,UKR,Switzerland,CHE,0,5,29,27,61
2019,United States of America,USA,Switzerland,CHE,0,0,5,5,10
2019,Venezuela (Bolivarian Republic of),VEN,Switzerland,CHE,5,5,22,5,37
2019,Western Sahara,ESH,Switzerland,CHE,0,0,0,5,5
2019,Yemen,YEM,Switzerland,CHE,13,11,0,10,34
2019,Zimbabwe,ZWE,Switzerland,CHE,0,0,5,0,5
2019,Stateless,XXA,Switzerland,CHE,5,5,0,0,10
2019,Unknown ,,Switzerland,CHE,56,97,67,64,284
2019,Myanmar,MMR,Thailand,THA,15,0,0,0,15
2019,Central African Rep.,CAF,Togo,TGO,5,0,29,0,34
2019,Cote d'Ivoire,CIV,Togo,TGO,19,0,33,0,52
2019,Syrian Arab Rep.,SYR,Togo,TGO,5,0,0,0,5
2019,Turkey,TUR,Togo,TGO,22,0,0,0,22
2019,Afghanistan,AFG,Turkey,TUR,2387,0,2515,11224,16126
2019,Iran (Islamic Rep. of),IRN,Turkey,TUR,872,0,350,4711,5933
2019,Iraq,IRQ,Turkey,TUR,2011,0,2111,25128,29250
2019,Unknown ,,Turkey,TUR,175,0,236,2226,2637
2019,Burundi,BDI,Uganda,UGA,8619,0,410,0,9029
2019,Central African Rep.,CAF,Uganda,UGA,0,0,0,5,5
2019,Cameroon,CMR,Uganda,UGA,5,0,0,0,5
2019,Dem. Rep. of the Congo,COD,Uganda,UGA,23306,0,1436,0,24742
2019,Eritrea,ERI,Uganda,UGA,1074,0,488,1839,3401
2019,Ethiopia,ETH,Uganda,UGA,209,0,40,180,429
2019,Guinea,GIN,Uganda,UGA,5,0,0,0,5
2019,Pakistan,PAK,Uganda,UGA,0,0,0,74,74
2019,Rwanda,RWA,Uganda,UGA,460,0,379,0,839
2019,Somalia,SOM,Uganda,UGA,12107,0,0,2859,14966
2019,Sudan,SDN,Uganda,UGA,321,0,5,0,326
2019,South Sudan,SSD,Uganda,UGA,16,0,0,301,317
2019,Turkey,TUR,Uganda,UGA,20,0,0,0,20
2019,Afghanistan,AFG,Ukraine,UKR,17,11,36,1081,1145
2019,Egypt,EGY,Ukraine,UKR,0,0,5,10,15
2019,Armenia,ARM,Ukraine,UKR,0,0,0,16,16
2019,Bangladesh,BGD,Ukraine,UKR,0,0,10,30,40
2019,Belarus,BLR,Ukraine,UKR,0,0,10,5,15
2019,Cameroon,CMR,Ukraine,UKR,0,0,5,39,44
2019,Congo,COG,Ukraine,UKR,0,0,5,5,10
2019,Dem. Rep. of the Congo,COD,Ukraine,UKR,0,0,5,0,5
2019,Cuba,CUB,Ukraine,UKR,0,0,0,5,5
2019,Gambia,GMB,Ukraine,UKR,0,0,5,0,5
2019,Palestinian,PSE,Ukraine,UKR,0,0,0,49,49
2019,Georgia,GEO,Ukraine,UKR,0,0,0,35,35
2019,Ghana,GHA,Ukraine,UKR,0,0,0,10,10
2019,Guinea,GIN,Ukraine,UKR,0,0,5,40,45
2019,Haiti,HTI,Ukraine,UKR,0,0,0,5,5
2019,Cote d'Ivoire,CIV,Ukraine,UKR,0,0,0,11,11
2019,India,IND,Ukraine,UKR,0,0,0,5,5
2019,Iran (Islamic Rep. of),IRN,Ukraine,UKR,0,0,10,22,32
2019,Iraq,IRQ,Ukraine,UKR,0,0,10,52,62
2019,Jordan,JOR,Ukraine,UKR,0,0,0,11,11
2019,Kazakhstan,KAZ,Ukraine,UKR,0,0,5,0,5
2019,Liberia,LBR,Ukraine,UKR,0,0,0,5,5
2019,Libya,LBY,Ukraine,UKR,0,0,0,11,11
2019,Rep. of Moldova,MDA,Ukraine,UKR,0,0,0,5,5
2019,Nepal,NPL,Ukraine,UKR,0,0,0,5,5
2019,Nigeria,NGA,Ukraine,UKR,0,0,5,73,78
2019,Pakistan,PAK,Ukraine,UKR,0,0,18,77,95
2019,Russian Federation,RUS,Ukraine,UKR,10,19,91,0,120
2019,Senegal,SEN,Ukraine,UKR,0,0,0,5,5
2019,Somalia,SOM,Ukraine,UKR,0,0,5,131,136
2019,Viet Nam,VNM,Ukraine,UKR,0,0,0,18,18
2019,Sudan,SDN,Ukraine,UKR,0,0,5,33,38
2019,Syrian Arab Rep.,SYR,Ukraine,UKR,0,10,40,99,149
2019,Tajikistan,TJK,Ukraine,UKR,5,0,40,0,45
2019,Turkmenistan,TKM,Ukraine,UKR,0,0,0,5,5
2019,Togo,TGO,Ukraine,UKR,0,0,0,5,5
2019,Tunisia,TUN,Ukraine,UKR,0,0,0,5,5
2019,Turkey,TUR,Ukraine,UKR,0,0,0,5,5
2019,Uzbekistan,UZB,Ukraine,UKR,0,0,5,0,5
2019,Yemen,YEM,Ukraine,UKR,0,0,11,0,11
2019,Stateless,XXA,Ukraine,UKR,0,5,12,0,17
2019,Angola,AGO,Uruguay,URY,5,0,0,0,5
2019,Argentina,ARG,Uruguay,URY,0,0,0,5,5
2019,Brazil,BRA,Uruguay,URY,0,0,0,5,5
2019,Colombia,COL,Uruguay,URY,10,0,0,5,15
2019,Cuba,CUB,Uruguay,URY,10,0,90,4565,4665
2019,Dominican Rep.,DOM,Uruguay,URY,0,0,0,13,13
2019,Nicaragua,NIC,Uruguay,URY,5,0,0,5,10
2019,Nigeria,NGA,Uruguay,URY,5,0,0,5,10
2019,Paraguay,PRY,Uruguay,URY,5,0,0,0,5
2019,El Salvador,SLV,Uruguay,URY,5,0,0,5,10
2019,Senegal,SEN,Uruguay,URY,0,0,0,41,41
2019,Spain,ESP,Uruguay,URY,0,0,0,5,5
2019,Syrian Arab Rep.,SYR,Uruguay,URY,0,0,0,5,5
2019,Turkey,TUR,Uruguay,URY,10,0,0,0,10
2019,Venezuela (Bolivarian Republic of),VEN,Uruguay,URY,57,0,0,27,84
2019,Colombia,COL,Venezuela (Bolivarian Republic of),VEN,248,0,543,0,791
2019,Burundi,BDI,Zambia,ZMB,884,0,12,162,1058
2019,Cameroon,CMR,Zambia,ZMB,5,0,0,0,5
2019,Dem. Rep. of the Congo,COD,Zambia,ZMB,4377,0,0,116,4493
2019,Eritrea,ERI,Zambia,ZMB,5,0,0,0,5
2019,Rwanda,RWA,Zambia,ZMB,12,0,0,0,12
2019,Somalia,SOM,Zambia,ZMB,437,0,0,52,489
2019,Syrian Arab Rep.,SYR,Zambia,ZMB,0,0,0,5,5
2019,Turkey,TUR,Zambia,ZMB,12,0,0,0,12
2019,Uganda,UGA,Zambia,ZMB,10,0,0,0,10
2019,Dem. Rep. of the Congo,COD,Zimbabwe,ZWE,396,0,118,0,514
2019,South Sudan,SSD,Zimbabwe,ZWE,0,0,0,5,5
2020,Palestinian,PSE,Albania,ALB,0,0,0,5,5
2020,Syrian Arab Rep.,SYR,Albania,ALB,5,0,0,0,5
2020,Egypt,EGY,Argentina,ARG,0,0,5,0,5
2020,Bangladesh,BGD,Argentina,ARG,0,0,5,0,5
2020,Bolivia (Plurinational State of),BOL,Argentina,ARG,60,0,0,5,65
2020,China,CHN,Argentina,ARG,0,0,5,0,5
2020,Dem. Rep. of the Congo,COD,Argentina,ARG,0,0,5,0,5
2020,Colombia,COL,Argentina,ARG,5,0,0,5,10
2020,Cuba,CUB,Argentina,ARG,5,0,59,5,69
2020,Dominican Rep.,DOM,Argentina,ARG,0,0,55,5,60
2020,Palestinian,PSE,Argentina,ARG,5,0,0,0,5
2020,Ghana,GHA,Argentina,ARG,0,0,29,0,29
2020,Haiti,HTI,Argentina,ARG,5,0,66,0,71
2020,Honduras,HND,Argentina,ARG,0,0,5,0,5
2020,India,IND,Argentina,ARG,0,0,16,0,16
2020,Jordan,JOR,Argentina,ARG,5,0,0,0,5
2020,Morocco,MAR,Argentina,ARG,0,0,0,5,5
2020,Nicaragua,NIC,Argentina,ARG,5,0,0,0,5
2020,Nigeria,NGA,Argentina,ARG,0,0,5,0,5
2020,Peru,PER,Argentina,ARG,5,0,0,0,5
2020,El Salvador,SLV,Argentina,ARG,14,0,0,0,14
2020,Senegal,SEN,Argentina,ARG,0,0,54,0,54
2020,Syrian Arab Rep.,SYR,Argentina,ARG,5,0,0,0,5
2020,Ukraine,UKR,Argentina,ARG,0,0,5,0,5
2020,Venezuela (Bolivarian Republic of),VEN,Argentina,ARG,5,0,0,44,49
2020,Unknown ,,Argentina,ARG,5,0,0,0,5
2020,Afghanistan,AFG,Armenia,ARM,0,0,0,5,5
2020,Azerbaijan,AZE,Armenia,ARM,0,0,0,5,5
2020,Congo,COG,Armenia,ARM,5,0,0,0,5
2020,Cuba,CUB,Armenia,ARM,0,0,10,0,10
2020,Georgia,GEO,Armenia,ARM,0,0,0,5,5
2020,India,IND,Armenia,ARM,0,0,0,5,5
2020,Iran (Islamic Rep. of),IRN,Armenia,ARM,37,0,43,26,106
2020,Iraq,IRQ,Armenia,ARM,11,0,0,0,11
2020,Lebanon,LBN,Armenia,ARM,5,0,0,17,22
2020,Pakistan,PAK,Armenia,ARM,0,0,0,5,5
2020,Syrian Arab Rep.,SYR,Armenia,ARM,23,0,0,11,34
2020,Turkey,TUR,Armenia,ARM,5,0,5,0,10
2020,Afghanistan,AFG,Australia,AUS,276,0,54,36,366
2020,Albania,ALB,Australia,AUS,0,0,20,5,25
2020,Algeria,DZA,Australia,AUS,5,0,0,0,5
2020,Egypt,EGY,Australia,AUS,32,0,26,0,58
2020,Argentina,ARG,Australia,AUS,0,0,5,5,10
2020,Burundi,BDI,Australia,AUS,13,0,0,0,13
2020,Bangladesh,BGD,Australia,AUS,25,0,329,96,450
2020,Brazil,BRA,Australia,AUS,0,0,17,0,17
2020,Bosnia and Herzegovina,BIH,Australia,AUS,0,0,5,0,5
2020,Cambodia,KHM,Australia,AUS,15,0,31,10,56
2020,China,CHN,Australia,AUS,93,0,4322,226,4641
2020,Chile,CHL,Australia,AUS,0,0,10,5,15
2020,Cameroon,CMR,Australia,AUS,0,0,14,0,14
2020,Congo,COG,Australia,AUS,5,0,0,0,5
2020,Colombia,COL,Australia,AUS,0,0,11,0,11
2020,Eritrea,ERI,Australia,AUS,12,0,0,0,12
2020,Ethiopia,ETH,Australia,AUS,15,0,10,0,25
2020,Fiji,FJI,Australia,AUS,13,0,792,36,841
2020,France,FRA,Australia,AUS,0,0,5,5,10
2020,Palestinian,PSE,Australia,AUS,19,0,5,15,39
2020,United Kingdom of Great Britain and Northern Ireland,GBR,Australia,AUS,0,0,32,0,32
2020,Ghana,GHA,Australia,AUS,14,0,5,0,19
2020,Greece,GRC,Australia,AUS,0,0,19,0,19
2020,"China, Hong Kong SAR",HKG,Australia,AUS,0,0,12,28,40
2020,Honduras,HND,Australia,AUS,0,0,0,5,5
2020,India,IND,Australia,AUS,20,0,896,396,1312
2020,Indonesia,IDN,Australia,AUS,14,0,664,54,732
2020,Ireland,IRL,Australia,AUS,0,0,10,0,10
2020,Iran (Islamic Rep. of),IRN,Australia,AUS,918,0,422,455,1795
2020,Iraq,IRQ,Australia,AUS,157,0,109,49,315
2020,Israel,ISR,Australia,AUS,0,0,5,0,5
2020,Italy,ITA,Australia,AUS,0,0,14,0,14
2020,Jordan,JOR,Australia,AUS,0,0,14,0,14
2020,Kenya,KEN,Australia,AUS,5,0,20,10,35
2020,Rep. of Korea,KOR,Australia,AUS,0,0,48,0,48
2020,Lao People's Dem. Rep.,LAO,Australia,AUS,0,0,5,72,77
2020,Liberia,LBR,Australia,AUS,5,0,5,0,10
2020,Libya,LBY,Australia,AUS,55,0,0,0,55
2020,Lebanon,LBN,Australia,AUS,47,0,197,0,244
2020,Sri Lanka,LKA,Australia,AUS,91,0,283,263,637
2020,North Macedonia,MKD,Australia,AUS,0,0,0,5,5
2020,Malaysia,MYS,Australia,AUS,44,0,3671,237,3952
2020,Mongolia,MNG,Australia,AUS,0,0,13,0,13
2020,Morocco,MAR,Australia,AUS,0,0,5,0,5
2020,Mauritius,MUS,Australia,AUS,0,0,11,5,16
2020,Myanmar,MMR,Australia,AUS,24,0,54,14,92
2020,Nepal,NPL,Australia,AUS,10,0,96,0,106
2020,Nigeria,NGA,Australia,AUS,27,0,161,5,193
2020,Nauru,NRU,Australia,AUS,5,0,0,0,5
2020,New Zealand,NZL,Australia,AUS,0,0,5,0,5
2020,Pakistan,PAK,Australia,AUS,239,0,398,33,670
2020,Peru,PER,Australia,AUS,0,0,5,0,5
2020,Philippines,PHL,Australia,AUS,5,0,282,0,287
2020,Papua New Guinea,PNG,Australia,AUS,49,0,29,0,78
2020,Poland,POL,Australia,AUS,0,0,5,0,5
2020,South Africa,ZAF,Australia,AUS,5,0,83,0,88
2020,Russian Federation,RUS,Australia,AUS,5,0,12,0,17
2020,Rwanda,RWA,Australia,AUS,20,0,10,0,30
2020,El Salvador,SLV,Australia,AUS,5,0,0,0,5
2020,Saudi Arabia,SAU,Australia,AUS,62,0,10,0,72
2020,Serbia and Kosovo: S/RES/1244 (1999),SRB,Australia,AUS,0,0,5,0,5
2020,Singapore,SGP,Australia,AUS,0,0,27,0,27
2020,Sierra Leone,SLE,Australia,AUS,5,0,0,0,5
2020,Solomon Islands,SLB,Australia,AUS,5,0,25,10,40
2020,Somalia,SOM,Australia,AUS,12,0,5,5,22
2020,Viet Nam,VNM,Australia,AUS,13,0,1273,141,1427
2020,Sudan,SDN,Australia,AUS,15,0,52,18,85
2020,South Sudan,SSD,Australia,AUS,0,0,10,11,21
2020,Syrian Arab Rep.,SYR,Australia,AUS,32,0,5,25,62
2020,Thailand,THA,Australia,AUS,5,0,810,0,815
2020,Timor-Leste,TLS,Australia,AUS,0,0,0,19,19
2020,Tonga,TON,Australia,AUS,0,0,60,19,79
2020,Turkey,TUR,Australia,AUS,113,0,52,5,170
2020,Uganda,UGA,Australia,AUS,5,0,0,0,5
2020,Ukraine,UKR,Australia,AUS,0,0,28,5,33
2020,United States of America,USA,Australia,AUS,5,0,5,5,15
2020,Uzbekistan,UZB,Australia,AUS,0,0,0,5,5
2020,Vanuatu,VUT,Australia,AUS,0,0,5,0,5
2020,Venezuela (Bolivarian Republic of),VEN,Australia,AUS,67,0,27,0,94
2020,Samoa,WSM,Australia,AUS,0,0,5,5,10
2020,Yemen,YEM,Australia,AUS,102,0,0,0,102
2020,Zambia,ZMB,Australia,AUS,5,0,0,0,5
2020,Zimbabwe,ZWE,Australia,AUS,35,0,61,0,96
2020,Stateless,XXA,Australia,AUS,151,0,44,231,426
2020,Unknown ,,Australia,AUS,45,0,92,97,234
2020,Afghanistan,AFG,Azerbaijan,AZE,0,0,109,5,114
2020,Egypt,EGY,Azerbaijan,AZE,0,0,5,0,5
2020,Cameroon,CMR,Azerbaijan,AZE,0,0,5,0,5
2020,India,IND,Azerbaijan,AZE,0,0,5,0,5
2020,Iran (Islamic Rep. of),IRN,Azerbaijan,AZE,0,0,12,0,12
2020,Iraq,IRQ,Azerbaijan,AZE,0,0,5,0,5
2020,Sri Lanka,LKA,Azerbaijan,AZE,0,0,5,0,5
2020,Pakistan,PAK,Azerbaijan,AZE,0,0,61,5,66
2020,Russian Federation,RUS,Azerbaijan,AZE,0,0,0,5,5
2020,Dem. Rep. of the Congo,COD,Burundi,BDI,3823,0,888,0,4711
2020,Rwanda,RWA,Burundi,BDI,48,0,38,248,334
2020,South Sudan,SSD,Burundi,BDI,5,0,0,0,5
2020,Afghanistan,AFG,Belgium,BEL,210,365,1155,0,1730
2020,Albania,ALB,Belgium,BEL,5,0,415,0,420
2020,Algeria,DZA,Belgium,BEL,5,0,35,0,40
2020,Angola,AGO,Belgium,BEL,10,0,45,0,55
2020,Egypt,EGY,Belgium,BEL,0,0,35,0,35
2020,Armenia,ARM,Belgium,BEL,10,5,75,0,90
2020,Azerbaijan,AZE,Belgium,BEL,10,0,15,0,25
2020,Burundi,BDI,Belgium,BEL,325,0,30,0,355
2020,Belgium,BEL,Belgium,BEL,0,0,5,0,5
2020,Benin,BEN,Belgium,BEL,0,0,25,0,25
2020,Bangladesh,BGD,Belgium,BEL,5,0,20,0,25
2020,Burkina Faso,BFA,Belgium,BEL,0,0,10,0,10
2020,Belarus,BLR,Belgium,BEL,0,0,10,0,10
2020,Brazil,BRA,Belgium,BEL,0,0,40,0,40
2020,Bosnia and Herzegovina,BIH,Belgium,BEL,0,0,25,0,25
2020,Bulgaria,BGR,Belgium,BEL,0,0,5,0,5
2020,Central African Rep.,CAF,Belgium,BEL,5,0,5,0,10
2020,Chad,TCD,Belgium,BEL,10,0,10,0,20
2020,China,CHN,Belgium,BEL,60,0,45,0,105
2020,Chile,CHL,Belgium,BEL,0,0,5,0,5
2020,Cameroon,CMR,Belgium,BEL,55,20,180,0,255
2020,Congo,COG,Belgium,BEL,0,0,10,0,10
2020,Dem. Rep. of the Congo,COD,Belgium,BEL,45,5,255,0,305
2020,Colombia,COL,Belgium,BEL,40,0,235,0,275
2020,Cuba,CUB,Belgium,BEL,0,0,5,0,5
2020,Djibouti,DJI,Belgium,BEL,25,0,35,0,60
2020,Eritrea,ERI,Belgium,BEL,610,0,145,0,755
2020,Ethiopia,ETH,Belgium,BEL,5,0,25,0,30
2020,Gabon,GAB,Belgium,BEL,0,0,5,0,5
2020,Gambia,GMB,Belgium,BEL,10,0,35,0,45
2020,Palestinian,PSE,Belgium,BEL,355,0,1305,0,1660
2020,Georgia,GEO,Belgium,BEL,30,0,150,0,180
2020,Ghana,GHA,Belgium,BEL,0,0,15,0,15
2020,Guinea-Bissau,GNB,Belgium,BEL,0,0,5,0,5
2020,Guinea,GIN,Belgium,BEL,180,5,670,0,855
2020,Cote d'Ivoire,CIV,Belgium,BEL,25,0,60,0,85
2020,India,IND,Belgium,BEL,0,0,15,0,15
2020,Indonesia,IDN,Belgium,BEL,0,0,5,0,5
2020,Iran (Islamic Rep. of),IRN,Belgium,BEL,140,0,170,0,310
2020,Iraq,IRQ,Belgium,BEL,160,60,795,0,1015
2020,Israel,ISR,Belgium,BEL,0,0,5,0,5
2020,Jordan,JOR,Belgium,BEL,0,0,20,0,20
2020,Kazakhstan,KAZ,Belgium,BEL,5,0,10,0,15
2020,Kenya,KEN,Belgium,BEL,0,0,5,0,5
2020,Kyrgyzstan,KGZ,Belgium,BEL,20,0,20,0,40
2020,Kuwait,KWT,Belgium,BEL,0,0,5,0,5
2020,Liberia,LBR,Belgium,BEL,0,0,15,0,15
2020,Libya,LBY,Belgium,BEL,0,30,15,0,45
2020,Lebanon,LBN,Belgium,BEL,0,0,45,0,45
2020,Sri Lanka,LKA,Belgium,BEL,5,0,55,0,60
2020,Mauritania,MRT,Belgium,BEL,10,0,55,0,65
2020,North Macedonia,MKD,Belgium,BEL,5,0,80,0,85
2020,Mexico,MEX,Belgium,BEL,0,0,5,0,5
2020,Mali,MLI,Belgium,BEL,5,0,30,0,35
2020,Malaysia,MYS,Belgium,BEL,0,0,5,0,5
2020,Mongolia,MNG,Belgium,BEL,0,0,5,0,5
2020,Morocco,MAR,Belgium,BEL,10,0,65,0,75
2020,Montenegro,MNE,Belgium,BEL,5,0,0,0,5
2020,Nepal,NPL,Belgium,BEL,0,0,5,0,5
2020,Niger,NER,Belgium,BEL,5,0,60,0,65
2020,Nicaragua,NIC,Belgium,BEL,5,0,5,0,10
2020,Nigeria,NGA,Belgium,BEL,0,0,40,0,40
2020,Pakistan,PAK,Belgium,BEL,20,0,110,0,130
2020,Romania,ROU,Belgium,BEL,0,0,5,0,5
2020,Russian Federation,RUS,Belgium,BEL,85,0,215,0,300
2020,Rwanda,RWA,Belgium,BEL,60,0,190,0,250
2020,El Salvador,SLV,Belgium,BEL,35,40,830,0,905
2020,Serbia and Kosovo: S/RES/1244 (1999),SRB,Belgium,BEL,25,0,195,0,220
2020,Senegal,SEN,Belgium,BEL,25,0,90,0,115
2020,Sierra Leone,SLE,Belgium,BEL,0,0,20,0,20
2020,Somalia,SOM,Belgium,BEL,270,80,270,0,620
2020,Spain,ESP,Belgium,BEL,0,0,5,0,5
2020,Viet Nam,VNM,Belgium,BEL,0,0,5,0,5
2020,Sudan,SDN,Belgium,BEL,35,0,50,0,85
2020,Suriname,SUR,Belgium,BEL,0,0,95,0,95
2020,South Sudan,SSD,Belgium,BEL,5,0,5,0,10
2020,Syrian Arab Rep.,SYR,Belgium,BEL,1145,165,990,0,2300
2020,United Rep. of Tanzania,TZA,Belgium,BEL,0,0,15,0,15
2020,Togo,TGO,Belgium,BEL,10,0,45,0,55
2020,Tunisia,TUN,Belgium,BEL,0,0,20,0,20
2020,Turkey,TUR,Belgium,BEL,360,0,215,0,575
2020,Uganda,UGA,Belgium,BEL,0,0,10,0,10
2020,Ukraine,UKR,Belgium,BEL,20,0,60,0,80
2020,Uzbekistan,UZB,Belgium,BEL,0,0,5,0,5
2020,Venezuela (Bolivarian Republic of),VEN,Belgium,BEL,70,5,230,0,305
2020,Yemen,YEM,Belgium,BEL,25,190,35,0,250
2020,Stateless,XXA,Belgium,BEL,0,0,5,0,5
2020,Unknown ,,Belgium,BEL,125,5,265,0,395
2020,Syrian Arab Rep.,SYR,Benin,BEN,0,0,0,5,5
2020,Benin,BEN,Burkina Faso,BFA,10,0,0,0,10
2020,Central African Rep.,CAF,Burkina Faso,BFA,14,0,0,0,14
2020,Turkey,TUR,Burkina Faso,BFA,5,0,0,0,5
2020,Afghanistan,AFG,Belarus,BLR,0,12,0,0,12
2020,Egypt,EGY,Belarus,BLR,0,0,5,0,5
2020,Armenia,ARM,Belarus,BLR,0,0,5,0,5
2020,Azerbaijan,AZE,Belarus,BLR,0,0,5,0,5
2020,Bangladesh,BGD,Belarus,BLR,0,0,5,0,5
2020,Cameroon,CMR,Belarus,BLR,0,5,0,0,5
2020,Cuba,CUB,Belarus,BLR,0,0,5,0,5
2020,Palestinian,PSE,Belarus,BLR,5,0,0,0,5
2020,Iraq,IRQ,Belarus,BLR,0,0,5,0,5
2020,Kazakhstan,KAZ,Belarus,BLR,0,0,10,0,10
2020,Mongolia,MNG,Belarus,BLR,0,0,5,0,5
2020,Pakistan,PAK,Belarus,BLR,0,0,0,5,5
2020,Russian Federation,RUS,Belarus,BLR,0,0,10,5,15
2020,Syrian Arab Rep.,SYR,Belarus,BLR,0,10,0,0,10
2020,Tajikistan,TJK,Belarus,BLR,0,0,5,0,5
2020,Turkey,TUR,Belarus,BLR,0,0,0,5,5
2020,Ukraine,UKR,Belarus,BLR,0,421,10,12,443
2020,Uzbekistan,UZB,Belarus,BLR,0,0,5,0,5
2020,Yemen,YEM,Belarus,BLR,0,5,0,0,5
2020,Colombia,COL,Bolivia (Plurinational State of),BOL,0,0,10,17,27
2020,Cuba,CUB,Bolivia (Plurinational State of),BOL,0,0,0,5,5
2020,Ecuador,ECU,Bolivia (Plurinational State of),BOL,0,0,0,5,5
2020,Peru,PER,Bolivia (Plurinational State of),BOL,11,0,5,5,21
2020,Venezuela (Bolivarian Republic of),VEN,Bolivia (Plurinational State of),BOL,242,0,273,404,919
2020,Dem. Rep. of the Congo,COD,Botswana,BWA,0,0,31,0,31
2020,Namibia,NAM,Botswana,BWA,0,0,0,5,5
2020,Afghanistan,AFG,Brazil,BRA,12,0,0,0,12
2020,Angola,AGO,Brazil,BRA,11,0,94,0,105
2020,Egypt,EGY,Brazil,BRA,10,0,10,0,20
2020,Argentina,ARG,Brazil,BRA,0,0,15,0,15
2020,Bangladesh,BGD,Brazil,BRA,0,0,13,0,13
2020,China,CHN,Brazil,BRA,5,0,5,0,10
2020,Cameroon,CMR,Brazil,BRA,10,0,5,0,15
2020,Dem. Rep. of the Congo,COD,Brazil,BRA,34,0,42,0,76
2020,Colombia,COL,Brazil,BRA,5,0,5,0,10
2020,Cuba,CUB,Brazil,BRA,123,0,25,0,148
2020,Cabo Verde,CPV,Brazil,BRA,0,0,5,0,5
2020,Dominican Rep.,DOM,Brazil,BRA,0,0,5,0,5
2020,Ethiopia,ETH,Brazil,BRA,5,0,0,0,5
2020,Gambia,GMB,Brazil,BRA,0,0,5,0,5
2020,Palestinian,PSE,Brazil,BRA,5,0,0,0,5
2020,Ghana,GHA,Brazil,BRA,0,0,5,0,5
2020,Guinea-Bissau,GNB,Brazil,BRA,5,0,22,0,27
2020,Guinea,GIN,Brazil,BRA,0,0,14,0,14
2020,Cote d'Ivoire,CIV,Brazil,BRA,0,0,10,0,10
2020,India,IND,Brazil,BRA,0,0,5,0,5
2020,Iran (Islamic Rep. of),IRN,Brazil,BRA,5,0,0,0,5
2020,Iraq,IRQ,Brazil,BRA,5,0,0,0,5
2020,Jordan,JOR,Brazil,BRA,0,0,5,0,5
2020,Kenya,KEN,Brazil,BRA,0,0,5,0,5
2020,Lebanon,LBN,Brazil,BRA,5,0,43,0,48
2020,Mauritania,MRT,Brazil,BRA,29,0,0,0,29
2020,Mali,MLI,Brazil,BRA,0,0,15,0,15
2020,Morocco,MAR,Brazil,BRA,10,0,11,0,21
2020,Mozambique,MOZ,Brazil,BRA,0,0,5,0,5
2020,Nepal,NPL,Brazil,BRA,0,0,5,0,5
2020,Nigeria,NGA,Brazil,BRA,5,0,51,0,56
2020,Pakistan,PAK,Brazil,BRA,27,0,15,0,42
2020,Philippines,PHL,Brazil,BRA,0,0,12,0,12
2020,Russian Federation,RUS,Brazil,BRA,5,0,0,0,5
2020,El Salvador,SLV,Brazil,BRA,0,0,0,5,5
2020,Senegal,SEN,Brazil,BRA,0,0,5,0,5
2020,Sierra Leone,SLE,Brazil,BRA,0,0,14,0,14
2020,Sudan,SDN,Brazil,BRA,5,0,0,0,5
2020,Syrian Arab Rep.,SYR,Brazil,BRA,179,0,0,10,189
2020,United Rep. of Tanzania,TZA,Brazil,BRA,0,0,10,0,10
2020,Togo,TGO,Brazil,BRA,13,0,13,0,26
2020,Tunisia,TUN,Brazil,BRA,0,0,5,0,5
2020,Turkey,TUR,Brazil,BRA,0,0,5,0,5
2020,Ukraine,UKR,Brazil,BRA,5,0,0,0,5
2020,Venezuela (Bolivarian Republic of),VEN,Brazil,BRA,25734,0,0,0,25734
2020,Yemen,YEM,Brazil,BRA,5,0,0,0,5
2020,Afghanistan,AFG,Bosnia and Herzegovina,BIH,0,0,5,132,137
2020,Algeria,DZA,Bosnia and Herzegovina,BIH,0,0,0,5,5
2020,Azerbaijan,AZE,Bosnia and Herzegovina,BIH,0,5,0,0,5
2020,Palestinian,PSE,Bosnia and Herzegovina,BIH,0,0,0,5,5
2020,India,IND,Bosnia and Herzegovina,BIH,0,0,0,5,5
2020,Iran (Islamic Rep. of),IRN,Bosnia and Herzegovina,BIH,0,0,10,95,105
2020,Iraq,IRQ,Bosnia and Herzegovina,BIH,0,0,5,236,241
2020,Morocco,MAR,Bosnia and Herzegovina,BIH,0,0,5,0,5
2020,Nepal,NPL,Bosnia and Herzegovina,BIH,0,0,0,5,5
2020,Pakistan,PAK,Bosnia and Herzegovina,BIH,0,0,19,56,75
2020,Syrian Arab Rep.,SYR,Bosnia and Herzegovina,BIH,0,5,0,41,46
2020,Tunisia,TUN,Bosnia and Herzegovina,BIH,0,0,0,5,5
2020,Turkey,TUR,Bosnia and Herzegovina,BIH,0,18,0,39,57
2020,Yemen,YEM,Bosnia and Herzegovina,BIH,0,0,5,5,10
2020,El Salvador,SLV,Belize,BLZ,0,0,0,10,10
2020,Viet Nam,VNM,Cambodia,KHM,0,0,0,15,15
2020,Afghanistan,AFG,Canada,CAN,206,0,49,0,265
2020,Albania,ALB,Canada,CAN,30,0,45,0,76
2020,Algeria,DZA,Canada,CAN,162,0,92,0,274
2020,Angola,AGO,Canada,CAN,96,0,131,0,238
2020,Egypt,EGY,Canada,CAN,448,0,71,28,547
2020,Azerbaijan,AZE,Canada,CAN,89,0,0,0,99
2020,Barbados,BRB,Canada,CAN,0,0,5,0,32
2020,Burundi,BDI,Canada,CAN,441,0,0,10,465
2020,Bangladesh,BGD,Canada,CAN,156,0,99,0,267
2020,Bahamas,BHS,Canada,CAN,44,0,5,22,82
2020,Burkina Faso,BFA,Canada,CAN,0,0,0,0,21
2020,Belarus,BLR,Canada,CAN,0,0,5,0,5
2020,Brazil,BRA,Canada,CAN,23,0,76,5,108
2020,Bulgaria,BGR,Canada,CAN,0,0,0,0,20
2020,Chad,TCD,Canada,CAN,104,0,0,0,127
2020,China,CHN,Canada,CAN,550,0,278,5,882
2020,Chile,CHL,Canada,CAN,0,0,10,0,38
2020,Cameroon,CMR,Canada,CAN,122,0,38,0,174
2020,Congo,COG,Canada,CAN,24,0,0,0,33
2020,Dem. Rep. of the Congo,COD,Canada,CAN,215,0,159,0,395
2020,Colombia,COL,Canada,CAN,796,0,359,0,1213
2020,Costa Rica,CRI,Canada,CAN,0,0,5,0,5
2020,Cuba,CUB,Canada,CAN,22,0,5,0,33
2020,Czechia,CZE,Canada,CAN,0,0,0,32,45
2020,Djibouti,DJI,Canada,CAN,38,0,5,0,72
2020,Dominica,DMA,Canada,CAN,0,0,5,0,5
2020,Dominican Rep.,DOM,Canada,CAN,0,0,5,0,33
2020,Ecuador,ECU,Canada,CAN,0,0,5,0,25
2020,Eritrea,ERI,Canada,CAN,243,0,28,60,331
2020,Ethiopia,ETH,Canada,CAN,289,0,96,0,401
2020,France,FRA,Canada,CAN,0,0,25,0,36
2020,Palestinian,PSE,Canada,CAN,357,0,74,0,437
2020,United Kingdom of Great Britain and Northern Ireland,GBR,Canada,CAN,0,0,5,0,5
2020,Georgia,GEO,Canada,CAN,37,0,25,0,65
2020,Ghana,GHA,Canada,CAN,0,0,31,5,54
2020,Greece,GRC,Canada,CAN,0,0,5,0,5
2020,Guatemala,GTM,Canada,CAN,49,0,0,5,75
2020,Guinea,GIN,Canada,CAN,46,0,5,0,61
2020,Haiti,HTI,Canada,CAN,458,0,603,54,1115
2020,Honduras,HND,Canada,CAN,90,0,33,0,133
2020,Hungary,HUN,Canada,CAN,608,0,53,44,708
2020,Cote d'Ivoire,CIV,Canada,CAN,25,0,5,0,39
2020,India,IND,Canada,CAN,263,0,542,175,980
2020,Ireland,IRL,Canada,CAN,0,0,5,0,5
2020,Iran (Islamic Rep. of),IRN,Canada,CAN,1409,0,0,39,1474
2020,Iraq,IRQ,Canada,CAN,136,0,40,5,204
2020,Israel,ISR,Canada,CAN,0,0,0,5,5
2020,Italy,ITA,Canada,CAN,0,0,5,0,26
2020,Jamaica,JAM,Canada,CAN,92,0,81,13,195
2020,Jordan,JOR,Canada,CAN,127,0,65,0,208
2020,Kenya,KEN,Canada,CAN,118,0,58,0,182
2020,Rep. of Korea,KOR,Canada,CAN,0,0,11,0,11
2020,Dem. People's Rep. of Korea,PRK,Canada,CAN,0,0,10,11,21
2020,Kuwait,KWT,Canada,CAN,36,0,5,0,42
2020,Liberia,LBR,Canada,CAN,0,0,0,0,21
2020,Libya,LBY,Canada,CAN,182,0,36,29,247
2020,Saint Lucia,LCA,Canada,CAN,0,0,10,0,10
2020,Lebanon,LBN,Canada,CAN,120,0,49,0,182
2020,Sri Lanka,LKA,Canada,CAN,191,0,68,0,282
2020,Mauritania,MRT,Canada,CAN,0,0,0,0,21
2020,Mexico,MEX,Canada,CAN,659,0,1049,426,2134
2020,Mali,MLI,Canada,CAN,24,0,0,0,27
2020,Malawi,MWI,Canada,CAN,0,0,5,0,31
2020,Morocco,MAR,Canada,CAN,24,0,10,0,41
2020,Nepal,NPL,Canada,CAN,59,0,0,0,62
2020,Nicaragua,NIC,Canada,CAN,154,0,5,0,173
2020,Nigeria,NGA,Canada,CAN,1419,0,1646,36,3113
2020,Norway,NOR,Canada,CAN,0,0,0,5,5
2020,Pakistan,PAK,Canada,CAN,753,0,305,0,1124
2020,Peru,PER,Canada,CAN,0,0,5,0,26
2020,Philippines,PHL,Canada,CAN,19,0,55,14,88
2020,Poland,POL,Canada,CAN,0,0,5,5,31
2020,Portugal,PRT,Canada,CAN,0,0,59,0,59
2020,Qatar,QAT,Canada,CAN,0,0,5,0,5
2020,Romania,ROU,Canada,CAN,62,0,33,157,252
2020,South Africa,ZAF,Canada,CAN,0,0,45,5,68
2020,Russian Federation,RUS,Canada,CAN,33,0,5,0,52
2020,Rwanda,RWA,Canada,CAN,170,0,53,0,233
2020,El Salvador,SLV,Canada,CAN,109,0,5,5,148
2020,Saudi Arabia,SAU,Canada,CAN,128,0,5,0,141
2020,Serbia and Kosovo: S/RES/1244 (1999),SRB,Canada,CAN,0,0,5,0,5
2020,Senegal,SEN,Canada,CAN,28,0,44,0,77
2020,Somalia,SOM,Canada,CAN,126,0,5,0,160
2020,Spain,ESP,Canada,CAN,0,0,0,0,26
2020,Viet Nam,VNM,Canada,CAN,0,0,12,0,39
2020,Sudan,SDN,Canada,CAN,414,0,5,22,457
2020,Slovakia,SVK,Canada,CAN,36,0,5,28,73
2020,Syrian Arab Rep.,SYR,Canada,CAN,159,0,0,0,180
2020,United Rep. of Tanzania,TZA,Canada,CAN,40,0,0,0,47
2020,Trinidad and Tobago,TTO,Canada,CAN,0,0,5,0,25
2020,Tunisia,TUN,Canada,CAN,0,0,0,5,5
2020,Turkey,TUR,Canada,CAN,618,0,5,26,668
2020,United Arab Emirates,ARE,Canada,CAN,30,0,5,0,35
2020,Uganda,UGA,Canada,CAN,166,0,37,0,213
2020,Ukraine,UKR,Canada,CAN,72,0,10,0,98
2020,United States of America,USA,Canada,CAN,0,0,550,62,639
2020,Saint Vincent and the Grenadines,VCT,Canada,CAN,0,0,10,5,15
2020,Venezuela (Bolivarian Republic of),VEN,Canada,CAN,545,0,54,25,624
2020,Yemen,YEM,Canada,CAN,252,0,0,0,258
2020,Zimbabwe,ZWE,Canada,CAN,137,0,23,0,165
2020,Stateless,XXA,Canada,CAN,119,0,0,0,140
2020,Unknown ,,Canada,CAN,2445,0,906,1064,3026
2020,Colombia,COL,Chile,CHL,5,0,1139,0,1144
2020,Cuba,CUB,Chile,CHL,0,0,383,0,383
2020,Venezuela (Bolivarian Republic of),VEN,Chile,CHL,0,0,399,0,399
2020,Unknown ,,Chile,CHL,0,0,137,0,137
2020,Central African Rep.,CAF,Congo,COG,1075,0,0,0,1075
2020,Dem. Rep. of the Congo,COD,Congo,COG,0,0,0,5,5
2020,Burundi,BDI,Dem. Rep. of the Congo,COD,0,0,0,1663,1663
2020,Central African Rep.,CAF,Dem. Rep. of the Congo,COD,0,0,20,22,42
2020,Chad,TCD,Dem. Rep. of the Congo,COD,5,0,0,0,5
2020,Cote d'Ivoire,CIV,Dem. Rep. of the Congo,COD,0,0,5,0,5
2020,Sudan,SDN,Dem. Rep. of the Congo,COD,0,0,0,5,5
2020,South Sudan,SSD,Dem. Rep. of the Congo,COD,0,0,0,10,10
2020,Syrian Arab Rep.,SYR,Dem. Rep. of the Congo,COD,0,0,0,13,13
2020,Uganda,UGA,Dem. Rep. of the Congo,COD,5,0,0,0,5
2020,Cuba,CUB,Colombia,COL,5,0,0,0,5
2020,Pakistan,PAK,Colombia,COL,0,0,5,0,5
2020,Venezuela (Bolivarian Republic of),VEN,Colombia,COL,346,0,0,723,1069
2020,Argentina,ARG,Costa Rica,CRI,0,0,5,5,10
2020,Burundi,BDI,Costa Rica,CRI,5,0,0,0,5
2020,China,CHN,Costa Rica,CRI,0,0,5,0,5
2020,Chile,CHL,Costa Rica,CRI,0,0,5,0,5
2020,Dem. Rep. of the Congo,COD,Costa Rica,CRI,0,0,0,10,10
2020,Colombia,COL,Costa Rica,CRI,20,0,187,438,645
2020,Cuba,CUB,Costa Rica,CRI,45,0,133,185,363
2020,Dominican Rep.,DOM,Costa Rica,CRI,0,0,0,14,14
2020,Guatemala,GTM,Costa Rica,CRI,0,0,0,5,5
2020,Haiti,HTI,Costa Rica,CRI,0,0,11,40,51
2020,Honduras,HND,Costa Rica,CRI,16,0,34,92,142
2020,Mexico,MEX,Costa Rica,CRI,5,0,12,0,17
2020,Nepal,NPL,Costa Rica,CRI,0,0,0,5,5
2020,Nicaragua,NIC,Costa Rica,CRI,2419,0,2135,9649,14203
2020,El Salvador,SLV,Costa Rica,CRI,229,0,311,403,943
2020,Spain,ESP,Costa Rica,CRI,0,0,0,5,5
2020,Syrian Arab Rep.,SYR,Costa Rica,CRI,0,0,0,5,5
2020,United States of America,USA,Costa Rica,CRI,0,0,0,5,5
2020,Venezuela (Bolivarian Republic of),VEN,Costa Rica,CRI,686,0,619,837,2142
2020,Egypt,EGY,Cyprus,CYP,5,0,103,133,241
2020,Armenia,ARM,Cyprus,CYP,0,0,5,0,5
2020,Bangladesh,BGD,Cyprus,CYP,0,0,172,179,351
2020,Cameroon,CMR,Cyprus,CYP,12,5,52,22,91
2020,Congo,COG,Cyprus,CYP,0,0,5,0,5
2020,Dem. Rep. of the Congo,COD,Cyprus,CYP,0,0,21,5,26
2020,Ethiopia,ETH,Cyprus,CYP,0,0,0,5,5
2020,Gambia,GMB,Cyprus,CYP,0,0,5,0,5
2020,Palestinian,PSE,Cyprus,CYP,34,11,0,5,50
2020,Georgia,GEO,Cyprus,CYP,0,0,285,547,832
2020,Guinea,GIN,Cyprus,CYP,0,0,5,5,10
2020,India,IND,Cyprus,CYP,0,0,224,396,620
2020,Iran (Islamic Rep. of),IRN,Cyprus,CYP,13,5,0,103,121
2020,Iraq,IRQ,Cyprus,CYP,13,5,24,5,47
2020,Jordan,JOR,Cyprus,CYP,0,0,0,14,14
2020,Kyrgyzstan,KGZ,Cyprus,CYP,0,0,0,5,5
2020,Lebanon,LBN,Cyprus,CYP,0,0,11,5,16
2020,Sri Lanka,LKA,Cyprus,CYP,0,0,36,57,93
2020,Morocco,MAR,Cyprus,CYP,0,0,5,0,5
2020,Nepal,NPL,Cyprus,CYP,0,0,33,59,92
2020,Nigeria,NGA,Cyprus,CYP,0,0,49,26,75
2020,Pakistan,PAK,Cyprus,CYP,0,0,553,240,793
2020,Philippines,PHL,Cyprus,CYP,0,0,59,32,91
2020,Russian Federation,RUS,Cyprus,CYP,0,0,0,10,10
2020,Sierra Leone,SLE,Cyprus,CYP,0,0,5,0,5
2020,Somalia,SOM,Cyprus,CYP,26,72,5,62,165
2020,Viet Nam,VNM,Cyprus,CYP,0,0,35,93,128
2020,Syrian Arab Rep.,SYR,Cyprus,CYP,22,1397,0,45,1464
2020,Turkey,TUR,Cyprus,CYP,16,0,5,18,39
2020,Ukraine,UKR,Cyprus,CYP,0,0,0,11,11
2020,Venezuela (Bolivarian Republic of),VEN,Cyprus,CYP,0,0,0,5,5
2020,Afghanistan,AFG,Czechia,CZE,0,0,5,14,19
2020,Algeria,DZA,Czechia,CZE,0,0,5,5,10
2020,Egypt,EGY,Czechia,CZE,0,0,5,0,5
2020,Armenia,ARM,Czechia,CZE,0,0,23,29,52
2020,Azerbaijan,AZE,Czechia,CZE,0,0,36,23,59
2020,Bangladesh,BGD,Czechia,CZE,0,0,0,5,5
2020,Belarus,BLR,Czechia,CZE,5,0,5,10,20
2020,China,CHN,Czechia,CZE,5,0,0,5,10
2020,Cameroon,CMR,Czechia,CZE,0,0,0,5,5
2020,Cuba,CUB,Czechia,CZE,0,0,19,13,32
2020,Eritrea,ERI,Czechia,CZE,0,0,0,5,5
2020,Ethiopia,ETH,Czechia,CZE,0,0,0,5,5
2020,Georgia,GEO,Czechia,CZE,0,0,98,70,168
2020,Ghana,GHA,Czechia,CZE,0,0,5,0,5
2020,India,IND,Czechia,CZE,0,0,10,5,15
2020,Iran (Islamic Rep. of),IRN,Czechia,CZE,0,0,12,5,17
2020,Iraq,IRQ,Czechia,CZE,0,0,5,10,15
2020,Jordan,JOR,Czechia,CZE,0,0,5,0,5
2020,Kazakhstan,KAZ,Czechia,CZE,5,0,33,28,66
2020,Kyrgyzstan,KGZ,Czechia,CZE,0,0,5,11,16
2020,Libya,LBY,Czechia,CZE,0,10,0,0,10
2020,Lebanon,LBN,Czechia,CZE,0,0,0,5,5
2020,Rep. of Moldova,MDA,Czechia,CZE,0,0,29,14,43
2020,Mongolia,MNG,Czechia,CZE,0,0,0,5,5
2020,Morocco,MAR,Czechia,CZE,0,0,0,5,5
2020,Nigeria,NGA,Czechia,CZE,0,0,12,10,22
2020,Pakistan,PAK,Czechia,CZE,0,0,12,5,17
2020,Russian Federation,RUS,Czechia,CZE,19,5,44,22,90
2020,Serbia and Kosovo: S/RES/1244 (1999),SRB,Czechia,CZE,0,0,5,0,5
2020,Viet Nam,VNM,Czechia,CZE,0,0,73,27,100
2020,Syrian Arab Rep.,SYR,Czechia,CZE,0,24,0,5,29
2020,Tunisia,TUN,Czechia,CZE,0,0,5,5,10
2020,Turkey,TUR,Czechia,CZE,0,0,16,16,32
2020,Ukraine,UKR,Czechia,CZE,0,12,248,132,392
2020,Uzbekistan,UZB,Czechia,CZE,5,0,48,33,86
2020,Venezuela (Bolivarian Republic of),VEN,Czechia,CZE,0,5,24,0,29
2020,Yemen,YEM,Czechia,CZE,0,5,0,0,5
2020,Stateless,XXA,Czechia,CZE,0,13,0,0,13
2020,Afghanistan,AFG,Denmark,DNK,5,0,36,0,41
2020,Albania,ALB,Denmark,DNK,0,0,14,0,14
2020,Algeria,DZA,Denmark,DNK,0,0,5,0,5
2020,Egypt,EGY,Denmark,DNK,0,0,5,0,5
2020,Armenia,ARM,Denmark,DNK,0,0,5,0,5
2020,Bangladesh,BGD,Denmark,DNK,0,0,5,0,5
2020,Belarus,BLR,Denmark,DNK,0,0,5,0,5
2020,Cameroon,CMR,Denmark,DNK,0,0,5,0,5
2020,Dem. Rep. of the Congo,COD,Denmark,DNK,0,0,5,0,5
2020,Colombia,COL,Denmark,DNK,0,0,12,0,12
2020,Eritrea,ERI,Denmark,DNK,45,39,5,0,89
2020,Ethiopia,ETH,Denmark,DNK,0,0,5,0,5
2020,Germany,DEU,Denmark,DNK,0,0,42,0,42
2020,Ghana,GHA,Denmark,DNK,0,0,5,0,5
2020,India,IND,Denmark,DNK,0,0,5,0,5
2020,Iran (Islamic Rep. of),IRN,Denmark,DNK,10,0,24,0,34
2020,Iraq,IRQ,Denmark,DNK,0,5,18,0,23
2020,Kenya,KEN,Denmark,DNK,0,0,5,0,5
2020,Lebanon,LBN,Denmark,DNK,0,0,5,0,5
2020,Sri Lanka,LKA,Denmark,DNK,0,0,5,0,5
2020,Morocco,MAR,Denmark,DNK,0,0,16,0,16
2020,Nigeria,NGA,Denmark,DNK,0,0,5,0,5
2020,Pakistan,PAK,Denmark,DNK,0,0,11,0,11
2020,Romania,ROU,Denmark,DNK,0,0,5,0,5
2020,Russian Federation,RUS,Denmark,DNK,0,0,12,0,12
2020,Serbia and Kosovo: S/RES/1244 (1999),SRB,Denmark,DNK,0,0,14,0,14
2020,Somalia,SOM,Denmark,DNK,16,5,66,0,87
2020,Viet Nam,VNM,Denmark,DNK,0,0,5,0,5
2020,Sudan,SDN,Denmark,DNK,0,0,5,0,5
2020,Syrian Arab Rep.,SYR,Denmark,DNK,75,130,29,0,234
2020,Tunisia,TUN,Denmark,DNK,0,0,5,0,5
2020,Turkey,TUR,Denmark,DNK,0,0,5,0,5
2020,Uganda,UGA,Denmark,DNK,0,0,5,0,5
2020,Ukraine,UKR,Denmark,DNK,0,0,16,0,16
2020,Venezuela (Bolivarian Republic of),VEN,Denmark,DNK,0,0,10,0,10
2020,Yemen,YEM,Denmark,DNK,5,0,0,0,5
2020,Stateless,XXA,Denmark,DNK,51,5,73,0,129
2020,Dem. Rep. of the Congo,COD,Djibouti,DJI,5,0,0,0,5
2020,Eritrea,ERI,Djibouti,DJI,58,0,0,10,68
2020,Ethiopia,ETH,Djibouti,DJI,563,0,0,0,563
2020,Iraq,IRQ,Djibouti,DJI,5,0,0,0,5
2020,Colombia,COL,Dominican Rep.,DOM,0,0,0,10,10
2020,Cuba,CUB,Dominican Rep.,DOM,0,0,0,5,5
2020,Venezuela (Bolivarian Republic of),VEN,Dominican Rep.,DOM,0,0,5,13,18
2020,Albania,ALB,Estonia,EST,0,0,5,0,5
2020,Eritrea,ERI,Estonia,EST,0,5,0,0,5
2020,Iran (Islamic Rep. of),IRN,Estonia,EST,0,0,5,0,5
2020,Russian Federation,RUS,Estonia,EST,14,0,21,0,35
2020,Syrian Arab Rep.,SYR,Estonia,EST,5,0,0,0,5
2020,Tajikistan,TJK,Estonia,EST,0,0,5,0,5
2020,Turkey,TUR,Estonia,EST,5,0,0,0,5
2020,Afghanistan,AFG,Fiji,FJI,5,0,0,0,5
2020,Afghanistan,AFG,Finland,FIN,159,82,155,58,454
2020,Albania,ALB,Finland,FIN,0,0,10,0,10
2020,Algeria,DZA,Finland,FIN,0,0,0,5,5
2020,Angola,AGO,Finland,FIN,0,0,5,11,16
2020,Egypt,EGY,Finland,FIN,13,0,5,0,18
2020,Azerbaijan,AZE,Finland,FIN,5,0,0,0,5
2020,Bangladesh,BGD,Finland,FIN,5,0,5,0,10
2020,Belarus,BLR,Finland,FIN,0,0,5,16,21
2020,China,CHN,Finland,FIN,18,0,0,5,23
2020,Cameroon,CMR,Finland,FIN,13,5,16,15,49
2020,Congo,COG,Finland,FIN,0,0,0,5,5
2020,Dem. Rep. of the Congo,COD,Finland,FIN,5,0,11,5,21
2020,Colombia,COL,Finland,FIN,0,0,12,5,17
2020,Cuba,CUB,Finland,FIN,0,0,5,5,10
2020,Eritrea,ERI,Finland,FIN,5,0,0,0,5
2020,Ethiopia,ETH,Finland,FIN,14,0,0,0,14
2020,Gambia,GMB,Finland,FIN,0,0,5,13,18
2020,Georgia,GEO,Finland,FIN,0,0,23,15,38
2020,Ghana,GHA,Finland,FIN,0,0,12,0,12
2020,Guinea,GIN,Finland,FIN,5,0,0,0,5
2020,Honduras,HND,Finland,FIN,0,13,10,0,23
2020,Cote d'Ivoire,CIV,Finland,FIN,0,0,5,0,5
2020,Iran (Islamic Rep. of),IRN,Finland,FIN,43,0,31,10,84
2020,Iraq,IRQ,Finland,FIN,415,38,213,62,728
2020,Kazakhstan,KAZ,Finland,FIN,0,0,5,0,5
2020,Kenya,KEN,Finland,FIN,5,0,0,0,5
2020,Liberia,LBR,Finland,FIN,0,0,0,5,5
2020,Libya,LBY,Finland,FIN,0,5,0,0,5
2020,Lebanon,LBN,Finland,FIN,0,0,5,0,5
2020,Sri Lanka,LKA,Finland,FIN,0,0,11,0,11
2020,Lithuania,LTU,Finland,FIN,0,0,5,0,5
2020,Mexico,MEX,Finland,FIN,0,0,5,0,5
2020,Malaysia,MYS,Finland,FIN,0,0,5,0,5
2020,Mongolia,MNG,Finland,FIN,0,0,5,0,5
2020,Morocco,MAR,Finland,FIN,0,0,11,5,16
2020,Nicaragua,NIC,Finland,FIN,22,0,5,0,27
2020,Nigeria,NGA,Finland,FIN,5,0,38,39,82
2020,Pakistan,PAK,Finland,FIN,5,0,5,0,10
2020,Peru,PER,Finland,FIN,0,0,5,0,5
2020,South Africa,ZAF,Finland,FIN,0,0,0,5,5
2020,Russian Federation,RUS,Finland,FIN,104,5,131,37,277
2020,Rwanda,RWA,Finland,FIN,11,0,0,0,11
2020,Serbia and Kosovo: S/RES/1244 (1999),SRB,Finland,FIN,0,0,5,0,5
2020,Senegal,SEN,Finland,FIN,0,0,0,5,5
2020,Sierra Leone,SLE,Finland,FIN,0,0,0,5,5
2020,Somalia,SOM,Finland,FIN,138,13,33,28,212
2020,Spain,ESP,Finland,FIN,0,0,0,5,5
2020,Sudan,SDN,Finland,FIN,11,0,0,0,11
2020,Sweden,SWE,Finland,FIN,0,0,0,5,5
2020,Syrian Arab Rep.,SYR,Finland,FIN,34,5,5,24,68
2020,Tajikistan,TJK,Finland,FIN,5,0,5,0,10
2020,Tunisia,TUN,Finland,FIN,0,0,0,5,5
2020,Turkey,TUR,Finland,FIN,154,0,31,12,197
2020,Ukraine,UKR,Finland,FIN,0,0,10,5,15
2020,United States of America,USA,Finland,FIN,0,0,10,0,10
2020,Venezuela (Bolivarian Republic of),VEN,Finland,FIN,0,0,5,0,5
2020,Yemen,YEM,Finland,FIN,11,24,0,5,40
2020,Stateless,XXA,Finland,FIN,13,0,5,0,18
2020,Unknown ,,Finland,FIN,0,0,10,5,15
2020,Afghanistan,AFG,France,FRA,526,4286,2632,93,7537
2020,Albania,ALB,France,FRA,65,239,3847,191,4342
2020,Algeria,DZA,France,FRA,101,47,1836,102,2086
2020,Angola,AGO,France,FRA,64,21,1092,10,1187
2020,Egypt,EGY,France,FRA,29,0,221,13,263
2020,Argentina,ARG,France,FRA,0,0,5,0,5
2020,Armenia,ARM,France,FRA,36,60,1766,16,1878
2020,Azerbaijan,AZE,France,FRA,44,0,452,10,506
2020,Burundi,BDI,France,FRA,190,0,234,0,424
2020,Benin,BEN,France,FRA,20,10,76,0,106
2020,Bangladesh,BGD,France,FRA,224,50,4607,43,4924
2020,Burkina Faso,BFA,France,FRA,37,5,126,5,173
2020,Belarus,BLR,France,FRA,10,0,42,5,57
2020,Brazil,BRA,France,FRA,5,5,37,0,47
2020,Bosnia and Herzegovina,BIH,France,FRA,13,5,775,51,844
2020,Cambodia,KHM,France,FRA,5,0,34,0,39
2020,Central African Rep.,CAF,France,FRA,151,39,235,10,435
2020,Chad,TCD,France,FRA,69,11,364,14,458
2020,China,CHN,France,FRA,1501,5,499,0,2005
2020,Chile,CHL,France,FRA,0,0,13,5,18
2020,Cameroon,CMR,France,FRA,176,47,699,20,942
2020,Congo,COG,France,FRA,85,29,600,15,729
2020,Dem. Rep. of the Congo,COD,France,FRA,635,82,2291,21,3029
2020,Comoros,COM,France,FRA,89,10,945,42,1086
2020,Colombia,COL,France,FRA,22,22,262,23,329
2020,Cuba,CUB,France,FRA,31,0,238,0,269
2020,Djibouti,DJI,France,FRA,5,0,39,0,44
2020,Dominican Rep.,DOM,France,FRA,5,12,112,12,141
2020,Ecuador,ECU,France,FRA,0,0,5,0,5
2020,Equatorial Guinea,GNQ,France,FRA,5,0,10,0,15
2020,Eritrea,ERI,France,FRA,854,0,262,10,1126
2020,Ethiopia,ETH,France,FRA,144,5,236,5,390
2020,Gabon,GAB,France,FRA,16,12,121,18,167
2020,Gambia,GMB,France,FRA,24,5,155,0,184
2020,Palestinian,PSE,France,FRA,123,5,59,0,187
2020,Georgia,GEO,France,FRA,58,82,3106,76,3322
2020,Ghana,GHA,France,FRA,5,0,53,0,58
2020,Guinea-Bissau,GNB,France,FRA,5,0,51,5,61
2020,Guatemala,GTM,France,FRA,0,5,0,0,5
2020,Guinea,GIN,France,FRA,1295,111,4598,25,6029
2020,Haiti,HTI,France,FRA,177,156,2949,61,3343
2020,Honduras,HND,France,FRA,0,0,18,0,18
2020,Cote d'Ivoire,CIV,France,FRA,932,139,3765,51,4887
2020,India,IND,France,FRA,10,0,268,5,283
2020,Iran (Islamic Rep. of),IRN,France,FRA,91,0,212,5,308
2020,Iraq,IRQ,France,FRA,257,64,407,28,756
2020,Kazakhstan,KAZ,France,FRA,10,5,355,13,383
2020,Kenya,KEN,France,FRA,0,0,22,0,22
2020,Kyrgyzstan,KGZ,France,FRA,0,0,15,5,20
2020,Kuwait,KWT,France,FRA,41,0,221,14,276
2020,Liberia,LBR,France,FRA,5,0,26,0,31
2020,Libya,LBY,France,FRA,65,77,172,5,319
2020,Lebanon,LBN,France,FRA,10,0,104,5,119
2020,Sri Lanka,LKA,France,FRA,180,36,1338,20,1574
2020,Madagascar,MDG,France,FRA,5,5,60,10,80
2020,Mauritania,MRT,France,FRA,162,0,938,18,1118
2020,North Macedonia,MKD,France,FRA,0,0,537,87,624
2020,Rep. of Moldova,MDA,France,FRA,5,5,1424,56,1490
2020,Mexico,MEX,France,FRA,0,0,5,0,5
2020,Mali,MLI,France,FRA,309,59,1878,55,2301
2020,Mongolia,MNG,France,FRA,11,11,124,10,156
2020,Morocco,MAR,France,FRA,86,19,440,28,573
2020,Mauritius,MUS,France,FRA,5,0,0,0,5
2020,Myanmar,MMR,France,FRA,0,0,10,0,10
2020,Nepal,NPL,France,FRA,5,0,87,0,92
2020,Niger,NER,France,FRA,5,0,52,0,57
2020,Nigeria,NGA,France,FRA,106,12,2814,30,2962
2020,Pakistan,PAK,France,FRA,73,26,2742,44,2885
2020,Peru,PER,France,FRA,5,10,46,0,61
2020,Philippines,PHL,France,FRA,0,0,5,0,5
2020,South Africa,ZAF,France,FRA,11,0,10,0,21
2020,Russian Federation,RUS,France,FRA,314,69,1870,70,2323
2020,Rwanda,RWA,France,FRA,120,0,135,5,260
2020,El Salvador,SLV,France,FRA,5,0,15,0,20
2020,Saudi Arabia,SAU,France,FRA,14,0,10,0,24
2020,Serbia and Kosovo: S/RES/1244 (1999),SRB,France,FRA,81,85,2572,175,2913
2020,Senegal,SEN,France,FRA,212,18,1453,18,1701
2020,Sierra Leone,SLE,France,FRA,31,0,114,0,145
2020,Somalia,SOM,France,FRA,203,248,1080,12,1543
2020,Viet Nam,VNM,France,FRA,5,0,32,5,42
2020,Sudan,SDN,France,FRA,944,60,737,20,1761
2020,Suriname,SUR,France,FRA,0,0,10,0,10
2020,Syrian Arab Rep.,SYR,France,FRA,730,1686,669,44,3129
2020,Thailand,THA,France,FRA,5,0,0,0,5
2020,Tajikistan,TJK,France,FRA,0,0,14,0,14
2020,Togo,TGO,France,FRA,25,0,87,0,112
2020,Tunisia,TUN,France,FRA,25,5,308,15,353
2020,Turkey,TUR,France,FRA,376,14,2142,33,2565
2020,Uganda,UGA,France,FRA,10,0,14,0,24
2020,Ukraine,UKR,France,FRA,40,39,993,72,1144
2020,United States of America,USA,France,FRA,0,0,20,0,20
2020,Uzbekistan,UZB,France,FRA,0,0,14,0,14
2020,Venezuela (Bolivarian Republic of),VEN,France,FRA,186,33,255,18,492
2020,Western Sahara,ESH,France,FRA,23,0,195,5,223
2020,Yemen,YEM,France,FRA,31,30,63,0,124
2020,Stateless,XXA,France,FRA,47,0,265,5,317
2020,Unknown ,,France,FRA,87,11,153,14,265
2020,Afghanistan,AFG,United Kingdom of Great Britain and Northern Ireland,GBR,554,15,336,309,1214
2020,Albania,ALB,United Kingdom of Great Britain and Northern Ireland,GBR,395,32,540,586,1553
2020,Algeria,DZA,United Kingdom of Great Britain and Northern Ireland,GBR,10,0,32,61,103
2020,Angola,AGO,United Kingdom of Great Britain and Northern Ireland,GBR,0,0,45,5,50
2020,Egypt,EGY,United Kingdom of Great Britain and Northern Ireland,GBR,68,0,74,31,173
2020,Argentina,ARG,United Kingdom of Great Britain and Northern Ireland,GBR,0,0,5,0,5
2020,Azerbaijan,AZE,United Kingdom of Great Britain and Northern Ireland,GBR,0,0,12,0,12
2020,Bahrain,BHR,United Kingdom of Great Britain and Northern Ireland,GBR,0,0,11,0,11
2020,Burundi,BDI,United Kingdom of Great Britain and Northern Ireland,GBR,0,0,5,0,5
2020,Benin,BEN,United Kingdom of Great Britain and Northern Ireland,GBR,0,0,10,0,10
2020,Bangladesh,BGD,United Kingdom of Great Britain and Northern Ireland,GBR,55,15,318,81,469
2020,Burkina Faso,BFA,United Kingdom of Great Britain and Northern Ireland,GBR,0,5,0,0,5
2020,Belarus,BLR,United Kingdom of Great Britain and Northern Ireland,GBR,5,0,0,5,10
2020,Bolivia (Plurinational State of),BOL,United Kingdom of Great Britain and Northern Ireland,GBR,0,0,5,0,5
2020,Botswana,BWA,United Kingdom of Great Britain and Northern Ireland,GBR,0,0,5,0,5
2020,Brazil,BRA,United Kingdom of Great Britain and Northern Ireland,GBR,5,0,66,37,108
2020,Canada,CAN,United Kingdom of Great Britain and Northern Ireland,GBR,0,0,5,5,10
2020,Central African Rep.,CAF,United Kingdom of Great Britain and Northern Ireland,GBR,0,0,0,5,5
2020,Chad,TCD,United Kingdom of Great Britain and Northern Ireland,GBR,10,0,5,38,53
2020,China,CHN,United Kingdom of Great Britain and Northern Ireland,GBR,35,16,184,284,519
2020,Chile,CHL,United Kingdom of Great Britain and Northern Ireland,GBR,0,0,0,5,5
2020,Cameroon,CMR,United Kingdom of Great Britain and Northern Ireland,GBR,53,5,45,10,113
2020,Congo,COG,United Kingdom of Great Britain and Northern Ireland,GBR,0,0,5,0,5
2020,Dem. Rep. of the Congo,COD,United Kingdom of Great Britain and Northern Ireland,GBR,22,0,24,5,51
2020,Colombia,COL,United Kingdom of Great Britain and Northern Ireland,GBR,0,0,11,0,11
2020,Cuba,CUB,United Kingdom of Great Britain and Northern Ireland,GBR,0,0,5,0,5
2020,Dominica,DMA,United Kingdom of Great Britain and Northern Ireland,GBR,0,0,0,32,32
2020,Equatorial Guinea,GNQ,United Kingdom of Great Britain and Northern Ireland,GBR,0,0,5,0,5
2020,Eritrea,ERI,United Kingdom of Great Britain and Northern Ireland,GBR,827,0,46,247,1120
2020,Ethiopia,ETH,United Kingdom of Great Britain and Northern Ireland,GBR,30,5,113,66,214
2020,Gambia,GMB,United Kingdom of Great Britain and Northern Ireland,GBR,16,5,19,15,55
2020,Palestinian,PSE,United Kingdom of Great Britain and Northern Ireland,GBR,56,20,41,20,137
2020,Georgia,GEO,United Kingdom of Great Britain and Northern Ireland,GBR,5,0,23,97,125
2020,Ghana,GHA,United Kingdom of Great Britain and Northern Ireland,GBR,17,5,66,29,117
2020,Grenada,GRD,United Kingdom of Great Britain and Northern Ireland,GBR,0,0,11,0,11
2020,Guatemala,GTM,United Kingdom of Great Britain and Northern Ireland,GBR,0,0,5,0,5
2020,Guinea,GIN,United Kingdom of Great Britain and Northern Ireland,GBR,10,0,0,10,20
2020,Guyana,GUY,United Kingdom of Great Britain and Northern Ireland,GBR,5,0,0,0,5
2020,"China, Hong Kong SAR",HKG,United Kingdom of Great Britain and Northern Ireland,GBR,0,5,0,15,20
2020,Honduras,HND,United Kingdom of Great Britain and Northern Ireland,GBR,5,13,34,14,66
2020,Cote d'Ivoire,CIV,United Kingdom of Great Britain and Northern Ireland,GBR,0,0,0,14,14
2020,India,IND,United Kingdom of Great Britain and Northern Ireland,GBR,5,28,547,358,938
2020,Indonesia,IDN,United Kingdom of Great Britain and Northern Ireland,GBR,12,0,0,0,12
2020,Iran (Islamic Rep. of),IRN,United Kingdom of Great Britain and Northern Ireland,GBR,1362,5,364,796,2527
2020,Iraq,IRQ,United Kingdom of Great Britain and Northern Ireland,GBR,356,177,871,799,2203
2020,Israel,ISR,United Kingdom of Great Britain and Northern Ireland,GBR,0,0,5,0,5
2020,Jamaica,JAM,United Kingdom of Great Britain and Northern Ireland,GBR,5,0,22,0,27
2020,Jordan,JOR,United Kingdom of Great Britain and Northern Ireland,GBR,17,5,27,0,49
2020,Japan,JPN,United Kingdom of Great Britain and Northern Ireland,GBR,0,0,0,5,5
2020,Kazakhstan,KAZ,United Kingdom of Great Britain and Northern Ireland,GBR,0,0,14,0,14
2020,Kenya,KEN,United Kingdom of Great Britain and Northern Ireland,GBR,16,5,35,5,61
2020,Kyrgyzstan,KGZ,United Kingdom of Great Britain and Northern Ireland,GBR,0,0,10,0,10
2020,Kuwait,KWT,United Kingdom of Great Britain and Northern Ireland,GBR,61,0,19,49,129
2020,Liberia,LBR,United Kingdom of Great Britain and Northern Ireland,GBR,0,0,5,0,5
2020,Libya,LBY,United Kingdom of Great Britain and Northern Ireland,GBR,72,542,0,42,656
2020,Saint Lucia,LCA,United Kingdom of Great Britain and Northern Ireland,GBR,0,0,5,5,10
2020,Lebanon,LBN,United Kingdom of Great Britain and Northern Ireland,GBR,10,0,18,5,33
2020,Sri Lanka,LKA,United Kingdom of Great Britain and Northern Ireland,GBR,39,16,168,43,266
2020,Lithuania,LTU,United Kingdom of Great Britain and Northern Ireland,GBR,0,0,5,0,5
2020,Mauritania,MRT,United Kingdom of Great Britain and Northern Ireland,GBR,0,0,0,5,5
2020,Maldives,MDV,United Kingdom of Great Britain and Northern Ireland,GBR,0,0,0,5,5
2020,Mexico,MEX,United Kingdom of Great Britain and Northern Ireland,GBR,0,0,5,5,10
2020,Mali,MLI,United Kingdom of Great Britain and Northern Ireland,GBR,0,0,0,14,14
2020,Malaysia,MYS,United Kingdom of Great Britain and Northern Ireland,GBR,41,0,38,17,96
2020,Malawi,MWI,United Kingdom of Great Britain and Northern Ireland,GBR,5,5,19,0,29
2020,Mongolia,MNG,United Kingdom of Great Britain and Northern Ireland,GBR,5,0,16,5,26
2020,Morocco,MAR,United Kingdom of Great Britain and Northern Ireland,GBR,12,5,24,27,68
2020,Mauritius,MUS,United Kingdom of Great Britain and Northern Ireland,GBR,0,5,17,0,22
2020,Myanmar,MMR,United Kingdom of Great Britain and Northern Ireland,GBR,12,0,0,0,12
2020,Namibia,NAM,United Kingdom of Great Britain and Northern Ireland,GBR,13,0,148,20,181
2020,Nepal,NPL,United Kingdom of Great Britain and Northern Ireland,GBR,0,5,21,25,51
2020,Niger,NER,United Kingdom of Great Britain and Northern Ireland,GBR,0,0,0,5,5
2020,Nicaragua,NIC,United Kingdom of Great Britain and Northern Ireland,GBR,19,0,14,5,38
2020,Nigeria,NGA,United Kingdom of Great Britain and Northern Ireland,GBR,177,84,468,81,810
2020,Oman,OMN,United Kingdom of Great Britain and Northern Ireland,GBR,0,0,0,12,12
2020,Pakistan,PAK,United Kingdom of Great Britain and Northern Ireland,GBR,268,76,540,290,1174
2020,Philippines,PHL,United Kingdom of Great Britain and Northern Ireland,GBR,5,0,13,5,23
2020,Poland,POL,United Kingdom of Great Britain and Northern Ireland,GBR,0,0,5,0,5
2020,Qatar,QAT,United Kingdom of Great Britain and Northern Ireland,GBR,5,0,0,0,5
2020,Romania,ROU,United Kingdom of Great Britain and Northern Ireland,GBR,0,0,10,0,10
2020,South Africa,ZAF,United Kingdom of Great Britain and Northern Ireland,GBR,0,10,55,10,75
2020,Russian Federation,RUS,United Kingdom of Great Britain and Northern Ireland,GBR,113,0,72,24,209
2020,Rwanda,RWA,United Kingdom of Great Britain and Northern Ireland,GBR,13,0,0,0,13
2020,El Salvador,SLV,United Kingdom of Great Britain and Northern Ireland,GBR,48,168,167,52,435
2020,Saudi Arabia,SAU,United Kingdom of Great Britain and Northern Ireland,GBR,48,0,5,18,71
2020,Serbia and Kosovo: S/RES/1244 (1999),SRB,United Kingdom of Great Britain and Northern Ireland,GBR,5,0,5,0,10
2020,Senegal,SEN,United Kingdom of Great Britain and Northern Ireland,GBR,5,0,5,13,23
2020,Sierra Leone,SLE,United Kingdom of Great Britain and Northern Ireland,GBR,11,0,25,5,41
2020,Somalia,SOM,United Kingdom of Great Britain and Northern Ireland,GBR,102,10,34,27,173
2020,Viet Nam,VNM,United Kingdom of Great Britain and Northern Ireland,GBR,313,19,148,106,586
2020,Saint Kitts and Nevis,KNA,United Kingdom of Great Britain and Northern Ireland,GBR,0,0,5,0,5
2020,Sudan,SDN,United Kingdom of Great Britain and Northern Ireland,GBR,817,5,55,518,1395
2020,South Sudan,SSD,United Kingdom of Great Britain and Northern Ireland,GBR,5,5,5,10,25
2020,Slovakia,SVK,United Kingdom of Great Britain and Northern Ireland,GBR,0,0,5,0,5
2020,Syrian Arab Rep.,SYR,United Kingdom of Great Britain and Northern Ireland,GBR,552,5,19,191,767
2020,United Rep. of Tanzania,TZA,United Kingdom of Great Britain and Northern Ireland,GBR,10,5,18,0,33
2020,Thailand,THA,United Kingdom of Great Britain and Northern Ireland,GBR,0,0,11,0,11
2020,Tajikistan,TJK,United Kingdom of Great Britain and Northern Ireland,GBR,5,0,0,5,10
2020,Turkmenistan,TKM,United Kingdom of Great Britain and Northern Ireland,GBR,5,0,0,5,10
2020,Togo,TGO,United Kingdom of Great Britain and Northern Ireland,GBR,0,0,5,0,5
2020,Trinidad and Tobago,TTO,United Kingdom of Great Britain and Northern Ireland,GBR,10,0,20,5,35
2020,Tunisia,TUN,United Kingdom of Great Britain and Northern Ireland,GBR,0,0,14,0,14
2020,Turkey,TUR,United Kingdom of Great Britain and Northern Ireland,GBR,245,5,131,46,427
2020,United Arab Emirates,ARE,United Kingdom of Great Britain and Northern Ireland,GBR,5,0,0,0,5
2020,Uganda,UGA,United Kingdom of Great Britain and Northern Ireland,GBR,49,0,32,5,86
2020,Ukraine,UKR,United Kingdom of Great Britain and Northern Ireland,GBR,5,13,94,18,130
2020,United States of America,USA,United Kingdom of Great Britain and Northern Ireland,GBR,5,0,13,16,34
2020,Uzbekistan,UZB,United Kingdom of Great Britain and Northern Ireland,GBR,0,0,5,0,5
2020,Vanuatu,VUT,United Kingdom of Great Britain and Northern Ireland,GBR,0,0,11,0,11
2020,Saint Vincent and the Grenadines,VCT,United Kingdom of Great Britain and Northern Ireland,GBR,0,0,10,0,10
2020,Venezuela (Bolivarian Republic of),VEN,United Kingdom of Great Britain and Northern Ireland,GBR,12,0,5,0,17
2020,Yemen,YEM,United Kingdom of Great Britain and Northern Ireland,GBR,65,100,10,128,303
2020,Zambia,ZMB,United Kingdom of Great Britain and Northern Ireland,GBR,5,0,5,0,10
2020,Zimbabwe,ZWE,United Kingdom of Great Britain and Northern Ireland,GBR,16,5,67,10,98
2020,Stateless,XXA,United Kingdom of Great Britain and Northern Ireland,GBR,221,0,44,364,629
2020,Unknown ,,United Kingdom of Great Britain and Northern Ireland,GBR,193,25,0,27,245
2020,Egypt,EGY,Georgia,GEO,5,0,0,15,20
2020,Azerbaijan,AZE,Georgia,GEO,0,0,0,5,5
2020,Bangladesh,BGD,Georgia,GEO,0,0,32,12,44
2020,China,CHN,Georgia,GEO,0,0,0,5,5
2020,Cameroon,CMR,Georgia,GEO,0,0,0,5,5
2020,Palestinian,PSE,Georgia,GEO,0,0,0,5,5
2020,India,IND,Georgia,GEO,0,0,42,43,85
2020,Iran (Islamic Rep. of),IRN,Georgia,GEO,5,0,111,114,230
2020,Iraq,IRQ,Georgia,GEO,0,5,5,33,43
2020,Jordan,JOR,Georgia,GEO,0,0,0,10,10
2020,Lebanon,LBN,Georgia,GEO,0,0,0,5,5
2020,Nigeria,NGA,Georgia,GEO,0,0,11,0,11
2020,Pakistan,PAK,Georgia,GEO,0,0,16,5,21
2020,South Africa,ZAF,Georgia,GEO,0,0,5,0,5
2020,Russian Federation,RUS,Georgia,GEO,0,0,33,10,43
2020,Somalia,SOM,Georgia,GEO,0,0,22,0,22
2020,Syrian Arab Rep.,SYR,Georgia,GEO,0,0,11,15,26
2020,Turkmenistan,TKM,Georgia,GEO,0,0,0,5,5
2020,Turkey,TUR,Georgia,GEO,0,0,38,10,48
2020,Ukraine,UKR,Georgia,GEO,0,0,0,5,5
2020,Uzbekistan,UZB,Georgia,GEO,0,0,0,5,5
2020,Yemen,YEM,Georgia,GEO,0,13,0,5,18
2020,Unknown ,,Georgia,GEO,0,0,5,0,5
2020,Burundi,BDI,Ghana,GHA,5,0,0,0,5
2020,Benin,BEN,Ghana,GHA,5,0,0,0,5
2020,Central African Rep.,CAF,Ghana,GHA,50,0,0,12,62
2020,Chad,TCD,Ghana,GHA,0,0,0,5,5
2020,Cameroon,CMR,Ghana,GHA,203,0,5,80,288
2020,Congo,COG,Ghana,GHA,0,0,0,5,5
2020,Dem. Rep. of the Congo,COD,Ghana,GHA,14,0,0,0,14
2020,Eritrea,ERI,Ghana,GHA,39,0,0,11,50
2020,Palestinian,PSE,Ghana,GHA,5,0,0,0,5
2020,Cote d'Ivoire,CIV,Ghana,GHA,5,0,13,19,37
2020,Libya,LBY,Ghana,GHA,5,0,0,5,10
2020,Pakistan,PAK,Ghana,GHA,32,0,0,5,37
2020,Rwanda,RWA,Ghana,GHA,0,0,5,0,5
2020,Somalia,SOM,Ghana,GHA,5,0,0,0,5
2020,Sudan,SDN,Ghana,GHA,89,0,0,10,99
2020,Syrian Arab Rep.,SYR,Ghana,GHA,60,0,0,22,82
2020,Togo,TGO,Ghana,GHA,12,0,0,0,12
2020,Turkey,TUR,Ghana,GHA,42,0,0,5,47
2020,Uganda,UGA,Ghana,GHA,5,0,0,0,5
2020,Yemen,YEM,Ghana,GHA,5,0,0,5,10
2020,Afghanistan,AFG,Greece,GRC,4606,6164,5494,3647,19911
2020,Albania,ALB,Greece,GRC,5,0,1383,619,2007
2020,Algeria,DZA,Greece,GRC,13,0,319,150,482
2020,Angola,AGO,Greece,GRC,5,0,19,5,29
2020,Egypt,EGY,Greece,GRC,43,0,617,224,884
2020,Armenia,ARM,Greece,GRC,0,0,44,29,73
2020,Azerbaijan,AZE,Greece,GRC,0,0,0,5,5
2020,Burundi,BDI,Greece,GRC,27,0,5,5,37
2020,Benin,BEN,Greece,GRC,0,0,5,0,5
2020,Bangladesh,BGD,Greece,GRC,19,0,1110,325,1454
2020,Burkina Faso,BFA,Greece,GRC,5,5,12,11,33
2020,Brazil,BRA,Greece,GRC,0,0,5,0,5
2020,Bosnia and Herzegovina,BIH,Greece,GRC,0,0,5,0,5
2020,Central African Rep.,CAF,Greece,GRC,5,0,0,0,5
2020,Chad,TCD,Greece,GRC,0,0,5,0,5
2020,China,CHN,Greece,GRC,21,0,118,63,202
2020,Chile,CHL,Greece,GRC,0,0,0,5,5
2020,Cameroon,CMR,Greece,GRC,226,10,315,137,688
2020,Congo,COG,Greece,GRC,19,5,45,14,83
2020,Dem. Rep. of the Congo,COD,Greece,GRC,562,77,1413,384,2436
2020,Colombia,COL,Greece,GRC,0,0,5,0,5
2020,Cuba,CUB,Greece,GRC,0,0,10,14,24
2020,Djibouti,DJI,Greece,GRC,10,0,0,0,10
2020,Dominican Rep.,DOM,Greece,GRC,0,0,10,5,15
2020,Eritrea,ERI,Greece,GRC,205,0,24,24,253
2020,Ethiopia,ETH,Greece,GRC,57,0,30,13,100
2020,Gabon,GAB,Greece,GRC,0,0,5,0,5
2020,Gambia,GMB,Greece,GRC,25,0,170,17,212
2020,Palestinian,PSE,Greece,GRC,1958,86,138,128,2310
2020,Georgia,GEO,Greece,GRC,5,0,676,356,1037
2020,Ghana,GHA,Greece,GRC,17,0,116,34,167
2020,Guinea,GIN,Greece,GRC,45,0,74,17,136
2020,Haiti,HTI,Greece,GRC,5,10,12,5,32
2020,Cote d'Ivoire,CIV,Greece,GRC,12,0,17,5,34
2020,India,IND,Greece,GRC,5,0,250,65,320
2020,Indonesia,IDN,Greece,GRC,0,0,50,17,67
2020,Iran (Islamic Rep. of),IRN,Greece,GRC,537,32,644,332,1545
2020,Iraq,IRQ,Greece,GRC,2202,538,1559,997,5296
2020,Jordan,JOR,Greece,GRC,14,0,5,5,24
2020,Kazakhstan,KAZ,Greece,GRC,0,0,0,5,5
2020,Kenya,KEN,Greece,GRC,0,0,5,5,10
2020,Kyrgyzstan,KGZ,Greece,GRC,0,0,5,0,5
2020,Kuwait,KWT,Greece,GRC,32,0,0,41,73
2020,Liberia,LBR,Greece,GRC,0,5,0,0,5
2020,Libya,LBY,Greece,GRC,10,13,17,5,45
2020,Lebanon,LBN,Greece,GRC,10,0,31,16,57
2020,Sri Lanka,LKA,Greece,GRC,5,0,22,13,40
2020,Mauritania,MRT,Greece,GRC,10,0,5,0,15
2020,Rep. of Moldova,MDA,Greece,GRC,0,0,27,11,38
2020,Mexico,MEX,Greece,GRC,0,0,5,5,10
2020,Mali,MLI,Greece,GRC,12,15,28,12,67
2020,Morocco,MAR,Greece,GRC,21,0,214,64,299
2020,Myanmar,MMR,Greece,GRC,25,0,5,5,35
2020,Nepal,NPL,Greece,GRC,5,0,103,15,123
2020,Niger,NER,Greece,GRC,5,0,12,0,17
2020,Nigeria,NGA,Greece,GRC,27,0,73,47,147
2020,Pakistan,PAK,Greece,GRC,99,10,4060,1344,5513
2020,Peru,PER,Greece,GRC,0,0,5,0,5
2020,Philippines,PHL,Greece,GRC,0,0,0,5,5
2020,Russian Federation,RUS,Greece,GRC,0,0,40,5,45
2020,Rwanda,RWA,Greece,GRC,0,0,5,0,5
2020,Serbia and Kosovo: S/RES/1244 (1999),SRB,Greece,GRC,0,0,10,0,10
2020,Senegal,SEN,Greece,GRC,5,0,58,18,81
2020,Sierra Leone,SLE,Greece,GRC,64,5,57,12,138
2020,Somalia,SOM,Greece,GRC,1222,885,131,126,2364
2020,Sudan,SDN,Greece,GRC,44,10,35,11,100
2020,South Sudan,SSD,Greece,GRC,12,12,5,0,29
2020,Syrian Arab Rep.,SYR,Greece,GRC,13479,0,1232,4162,18873
2020,United Rep. of Tanzania,TZA,Greece,GRC,0,0,5,5,10
2020,Tajikistan,TJK,Greece,GRC,0,0,5,0,5
2020,Togo,TGO,Greece,GRC,24,0,51,20,95
2020,Tunisia,TUN,Greece,GRC,0,0,25,14,39
2020,Turkey,TUR,Greece,GRC,214,0,1692,711,2617
2020,Uganda,UGA,Greece,GRC,19,0,12,0,31
2020,Ukraine,UKR,Greece,GRC,0,5,61,22,88
2020,United States of America,USA,Greece,GRC,0,0,0,5,5
2020,Uzbekistan,UZB,Greece,GRC,0,0,5,0,5
2020,Venezuela (Bolivarian Republic of),VEN,Greece,GRC,0,5,13,5,23
2020,Western Sahara,ESH,Greece,GRC,0,0,5,0,5
2020,Yemen,YEM,Greece,GRC,237,47,10,10,304
2020,Stateless,XXA,Greece,GRC,140,0,22,132,294
2020,Colombia,COL,Guatemala,GTM,0,0,10,0,10
2020,Cuba,CUB,Guatemala,GTM,0,0,0,5,5
2020,Honduras,HND,Guatemala,GTM,21,0,5,29,55
2020,Mexico,MEX,Guatemala,GTM,0,0,0,5,5
2020,Nicaragua,NIC,Guatemala,GTM,60,0,13,70,143
2020,El Salvador,SLV,Guatemala,GTM,45,0,30,18,93
2020,United States of America,USA,Guatemala,GTM,0,0,5,0,5
2020,Venezuela (Bolivarian Republic of),VEN,Guatemala,GTM,11,0,0,0,11
2020,Eritrea,ERI,Guinea,GIN,5,0,0,0,5
2020,Cote d'Ivoire,CIV,Guinea,GIN,108,0,5,0,113
2020,Liberia,LBR,Guinea,GIN,39,0,10,5,54
2020,Nigeria,NGA,Guinea,GIN,5,0,0,5,10
2020,Sierra Leone,SLE,Guinea,GIN,740,0,309,0,1049
2020,Syrian Arab Rep.,SYR,Guinea,GIN,5,0,0,0,5
2020,Cuba,CUB,Honduras,HND,0,0,0,5,5
2020,Haiti,HTI,Honduras,HND,0,0,0,5,5
2020,Cote d'Ivoire,CIV,Honduras,HND,0,0,0,5,5
2020,Nicaragua,NIC,Honduras,HND,12,0,0,11,23
2020,Afghanistan,AFG,Croatia,HRV,0,0,24,531,555
2020,Algeria,DZA,Croatia,HRV,0,0,15,5,20
2020,Egypt,EGY,Croatia,HRV,0,0,0,13,13
2020,Bangladesh,BGD,Croatia,HRV,0,0,5,5,10
2020,China,CHN,Croatia,HRV,0,0,0,5,5
2020,Dem. Rep. of the Congo,COD,Croatia,HRV,5,0,0,0,5
2020,Cuba,CUB,Croatia,HRV,0,0,5,0,5
2020,Eritrea,ERI,Croatia,HRV,0,0,0,5,5
2020,India,IND,Croatia,HRV,0,0,0,20,20
2020,Iran (Islamic Rep. of),IRN,Croatia,HRV,5,0,14,90,109
2020,Iraq,IRQ,Croatia,HRV,5,0,39,418,462
2020,Kazakhstan,KAZ,Croatia,HRV,0,0,5,0,5
2020,Libya,LBY,Croatia,HRV,0,0,0,5,5
2020,Morocco,MAR,Croatia,HRV,0,0,38,10,48
2020,Nepal,NPL,Croatia,HRV,0,0,0,10,10
2020,Nigeria,NGA,Croatia,HRV,0,0,5,0,5
2020,Pakistan,PAK,Croatia,HRV,0,0,5,18,23
2020,Sierra Leone,SLE,Croatia,HRV,0,0,5,0,5
2020,Viet Nam,VNM,Croatia,HRV,0,0,5,0,5
2020,Syrian Arab Rep.,SYR,Croatia,HRV,13,0,0,34,47
2020,Tajikistan,TJK,Croatia,HRV,0,0,0,5,5
2020,Tunisia,TUN,Croatia,HRV,0,0,12,0,12
2020,Turkey,TUR,Croatia,HRV,5,0,23,42,70
2020,Yemen,YEM,Croatia,HRV,0,0,0,5,5
2020,Stateless,XXA,Croatia,HRV,0,0,0,5,5
2020,Unknown ,,Croatia,HRV,0,0,0,12,12
2020,Afghanistan,AFG,Hungary,HUN,5,26,155,24,210
2020,Burundi,BDI,Hungary,HUN,0,0,5,0,5
2020,Bangladesh,BGD,Hungary,HUN,5,0,0,0,5
2020,Palestinian,PSE,Hungary,HUN,5,0,0,0,5
2020,Iran (Islamic Rep. of),IRN,Hungary,HUN,14,0,0,0,14
2020,Iraq,IRQ,Hungary,HUN,12,5,145,5,167
2020,Nigeria,NGA,Hungary,HUN,0,0,5,0,5
2020,Pakistan,PAK,Hungary,HUN,42,0,0,5,47
2020,Russian Federation,RUS,Hungary,HUN,0,0,5,0,5
2020,Syrian Arab Rep.,SYR,Hungary,HUN,0,0,10,10,20
2020,Tunisia,TUN,Hungary,HUN,0,0,5,0,5
2020,Yemen,YEM,Hungary,HUN,0,0,5,0,5
2020,Unknown ,,Hungary,HUN,12,5,0,0,17
2020,Afghanistan,AFG,Iceland,ISL,22,13,0,11,46
2020,Albania,ALB,Iceland,ISL,0,0,10,5,15
2020,Algeria,DZA,Iceland,ISL,0,0,5,0,5
2020,Egypt,EGY,Iceland,ISL,0,5,0,0,5
2020,Azerbaijan,AZE,Iceland,ISL,0,0,5,0,5
2020,Belarus,BLR,Iceland,ISL,0,0,5,0,5
2020,China,CHN,Iceland,ISL,5,0,0,0,5
2020,Chile,CHL,Iceland,ISL,0,0,5,0,5
2020,Dem. Rep. of the Congo,COD,Iceland,ISL,5,0,0,0,5
2020,Colombia,COL,Iceland,ISL,0,0,12,0,12
2020,Gambia,GMB,Iceland,ISL,0,0,5,0,5
2020,Palestinian,PSE,Iceland,ISL,5,34,0,31,70
2020,Georgia,GEO,Iceland,ISL,0,0,0,5,5
2020,Ghana,GHA,Iceland,ISL,0,0,11,0,11
2020,Honduras,HND,Iceland,ISL,5,5,0,0,10
2020,Iran (Islamic Rep. of),IRN,Iceland,ISL,30,0,0,5,35
2020,Iraq,IRQ,Iceland,ISL,18,83,5,63,169
2020,Kazakhstan,KAZ,Iceland,ISL,0,5,0,0,5
2020,Libya,LBY,Iceland,ISL,0,0,0,5,5
2020,North Macedonia,MKD,Iceland,ISL,0,0,5,0,5
2020,Rep. of Moldova,MDA,Iceland,ISL,0,0,0,5,5
2020,Morocco,MAR,Iceland,ISL,0,0,10,0,10
2020,Mozambique,MOZ,Iceland,ISL,0,5,0,0,5
2020,Nigeria,NGA,Iceland,ISL,5,41,36,14,96
2020,Pakistan,PAK,Iceland,ISL,0,0,12,0,12
2020,Romania,ROU,Iceland,ISL,0,0,0,5,5
2020,Russian Federation,RUS,Iceland,ISL,0,0,5,0,5
2020,Somalia,SOM,Iceland,ISL,22,16,10,10,58
2020,Syrian Arab Rep.,SYR,Iceland,ISL,0,58,0,15,73
2020,Tajikistan,TJK,Iceland,ISL,0,5,0,0,5
2020,Tunisia,TUN,Iceland,ISL,0,5,0,0,5
2020,Turkey,TUR,Iceland,ISL,0,0,5,0,5
2020,Ukraine,UKR,Iceland,ISL,0,0,5,0,5
2020,United States of America,USA,Iceland,ISL,0,0,0,10,10
2020,Venezuela (Bolivarian Republic of),VEN,Iceland,ISL,5,128,0,0,133
2020,Yemen,YEM,Iceland,ISL,5,0,0,5,10
2020,Stateless,XXA,Iceland,ISL,0,5,0,0,5
2020,Afghanistan,AFG,Ireland,IRL,24,11,0,12,47
2020,Albania,ALB,Ireland,IRL,0,5,267,274,546
2020,Algeria,DZA,Ireland,IRL,5,0,60,5,70
2020,Angola,AGO,Ireland,IRL,0,0,5,0,5
2020,Egypt,EGY,Ireland,IRL,12,0,5,0,17
2020,Bangladesh,BGD,Ireland,IRL,10,0,54,5,69
2020,Bolivia (Plurinational State of),BOL,Ireland,IRL,11,0,0,5,16
2020,Botswana,BWA,Ireland,IRL,0,0,10,0,10
2020,Brazil,BRA,Ireland,IRL,5,0,45,13,63
2020,Belize,BLZ,Ireland,IRL,0,0,5,0,5
2020,China,CHN,Ireland,IRL,5,0,14,26,45
2020,Cameroon,CMR,Ireland,IRL,13,5,5,0,23
2020,Dem. Rep. of the Congo,COD,Ireland,IRL,14,5,37,0,56
2020,Dominican Rep.,DOM,Ireland,IRL,0,0,5,0,5
2020,Eritrea,ERI,Ireland,IRL,11,0,0,5,16
2020,Ethiopia,ETH,Ireland,IRL,5,0,5,0,10
2020,Gambia,GMB,Ireland,IRL,0,0,5,0,5
2020,Palestinian,PSE,Ireland,IRL,25,0,5,5,35
2020,Georgia,GEO,Ireland,IRL,14,5,223,40,282
2020,Ghana,GHA,Ireland,IRL,5,0,14,0,19
2020,Guatemala,GTM,Ireland,IRL,0,0,5,0,5
2020,India,IND,Ireland,IRL,0,0,32,5,37
2020,Iran (Islamic Rep. of),IRN,Ireland,IRL,13,0,0,23,36
2020,Iraq,IRQ,Ireland,IRL,12,5,5,13,35
2020,Jordan,JOR,Ireland,IRL,0,0,5,0,5
2020,Kenya,KEN,Ireland,IRL,5,0,0,0,5
2020,Dem. People's Rep. of Korea,PRK,Ireland,IRL,5,0,0,0,5
2020,Kuwait,KWT,Ireland,IRL,0,0,5,11,16
2020,Libya,LBY,Ireland,IRL,11,0,0,0,11
2020,Rep. of Moldova,MDA,Ireland,IRL,0,0,5,0,5
2020,Mexico,MEX,Ireland,IRL,5,0,0,0,5
2020,Malawi,MWI,Ireland,IRL,10,0,32,0,42
2020,Mongolia,MNG,Ireland,IRL,0,0,5,0,5
2020,Morocco,MAR,Ireland,IRL,0,0,16,10,26
2020,Mauritius,MUS,Ireland,IRL,0,0,5,5,10
2020,Myanmar,MMR,Ireland,IRL,0,0,5,0,5
2020,Nepal,NPL,Ireland,IRL,0,0,5,0,5
2020,Nicaragua,NIC,Ireland,IRL,5,0,0,0,5
2020,Nigeria,NGA,Ireland,IRL,15,0,137,25,177
2020,Pakistan,PAK,Ireland,IRL,10,5,240,26,281
2020,South Africa,ZAF,Ireland,IRL,12,5,143,23,183
2020,Russian Federation,RUS,Ireland,IRL,5,0,0,0,5
2020,El Salvador,SLV,Ireland,IRL,11,0,0,0,11
2020,Serbia and Kosovo: S/RES/1244 (1999),SRB,Ireland,IRL,5,0,0,5,10
2020,Sierra Leone,SLE,Ireland,IRL,5,0,11,0,16
2020,Somalia,SOM,Ireland,IRL,36,15,0,15,66
2020,Viet Nam,VNM,Ireland,IRL,0,0,0,14,14
2020,Sudan,SDN,Ireland,IRL,17,0,0,5,22
2020,Eswatini,SWZ,Ireland,IRL,5,0,5,0,10
2020,Syrian Arab Rep.,SYR,Ireland,IRL,24,5,0,26,55
2020,United Rep. of Tanzania,TZA,Ireland,IRL,0,0,5,0,5
2020,Togo,TGO,Ireland,IRL,0,0,5,0,5
2020,Turkey,TUR,Ireland,IRL,5,0,0,0,5
2020,Uganda,UGA,Ireland,IRL,0,0,5,0,5
2020,United States of America,USA,Ireland,IRL,0,0,5,5,10
2020,Venezuela (Bolivarian Republic of),VEN,Ireland,IRL,35,5,10,0,50
2020,Yemen,YEM,Ireland,IRL,5,0,0,0,5
2020,Zambia,ZMB,Ireland,IRL,0,0,5,0,5
2020,Zimbabwe,ZWE,Ireland,IRL,66,0,167,0,233
2020,Afghanistan,AFG,Italy,ITA,107,952,72,27,1158
2020,Albania,ALB,Italy,ITA,65,53,816,0,934
2020,Algeria,DZA,Italy,ITA,11,5,105,0,121
2020,Angola,AGO,Italy,ITA,0,0,10,0,10
2020,Egypt,EGY,Italy,ITA,33,29,524,0,586
2020,Argentina,ARG,Italy,ITA,0,0,17,0,17
2020,Armenia,ARM,Italy,ITA,0,28,31,0,59
2020,Azerbaijan,AZE,Italy,ITA,17,11,16,0,44
2020,Benin,BEN,Italy,ITA,0,5,41,0,46
2020,Bangladesh,BGD,Italy,ITA,70,350,2490,5,2915
2020,Burkina Faso,BFA,Italy,ITA,11,77,89,0,177
2020,Belarus,BLR,Italy,ITA,0,5,13,0,18
2020,Brazil,BRA,Italy,ITA,46,5,122,0,173
2020,Bosnia and Herzegovina,BIH,Italy,ITA,12,5,59,0,76
2020,Central African Rep.,CAF,Italy,ITA,0,5,5,0,10
2020,Chad,TCD,Italy,ITA,0,5,16,0,21
2020,China,CHN,Italy,ITA,48,5,352,0,405
2020,Chile,CHL,Italy,ITA,0,0,14,0,14
2020,Cameroon,CMR,Italy,ITA,56,49,272,0,377
2020,Congo,COG,Italy,ITA,5,12,5,0,22
2020,Dem. Rep. of the Congo,COD,Italy,ITA,14,20,31,0,65
2020,Comoros,COM,Italy,ITA,0,0,5,0,5
2020,Colombia,COL,Italy,ITA,71,86,438,0,595
2020,Costa Rica,CRI,Italy,ITA,0,0,5,0,5
2020,Cuba,CUB,Italy,ITA,12,5,67,0,84
2020,Dominican Rep.,DOM,Italy,ITA,0,0,13,0,13
2020,Ecuador,ECU,Italy,ITA,5,0,17,0,22
2020,Eritrea,ERI,Italy,ITA,74,46,78,0,198
2020,Ethiopia,ETH,Italy,ITA,10,16,109,0,135
2020,Gabon,GAB,Italy,ITA,0,0,5,0,5
2020,Gambia,GMB,Italy,ITA,47,106,926,0,1079
2020,Palestinian,PSE,Italy,ITA,28,5,10,0,43
2020,Georgia,GEO,Italy,ITA,62,56,558,0,676
2020,Ghana,GHA,Italy,ITA,37,84,752,0,873
2020,Guinea-Bissau,GNB,Italy,ITA,5,12,122,0,139
2020,Guatemala,GTM,Italy,ITA,5,5,10,0,20
2020,Guinea,GIN,Italy,ITA,43,63,700,0,806
2020,Honduras,HND,Italy,ITA,67,72,82,0,221
2020,Cote d'Ivoire,CIV,Italy,ITA,142,156,1025,5,1328
2020,India,IND,Italy,ITA,12,10,668,0,690
2020,Iran (Islamic Rep. of),IRN,Italy,ITA,89,15,99,0,203
2020,Iraq,IRQ,Italy,ITA,97,239,190,5,531
2020,Jamaica,JAM,Italy,ITA,0,0,5,0,5
2020,Jordan,JOR,Italy,ITA,5,0,0,0,5
2020,Kazakhstan,KAZ,Italy,ITA,0,0,5,0,5
2020,Kenya,KEN,Italy,ITA,13,0,0,0,13
2020,Kyrgyzstan,KGZ,Italy,ITA,5,0,58,0,63
2020,Liberia,LBR,Italy,ITA,0,21,39,5,65
2020,Libya,LBY,Italy,ITA,33,101,34,5,173
2020,Lebanon,LBN,Italy,ITA,5,5,10,0,20
2020,Liechtenstein,LIE,Italy,ITA,0,0,5,0,5
2020,Sri Lanka,LKA,Italy,ITA,13,34,284,0,331
2020,Mauritania,MRT,Italy,ITA,5,5,5,0,15
2020,North Macedonia,MKD,Italy,ITA,19,5,16,0,40
2020,Rep. of Moldova,MDA,Italy,ITA,5,5,32,0,42
2020,Mexico,MEX,Italy,ITA,0,0,14,0,14
2020,Mali,MLI,Italy,ITA,53,343,590,5,991
2020,Mongolia,MNG,Italy,ITA,0,5,0,0,5
2020,Morocco,MAR,Italy,ITA,89,71,969,0,1129
2020,Montenegro,MNE,Italy,ITA,0,0,5,0,5
2020,Mauritius,MUS,Italy,ITA,0,0,5,0,5
2020,Nepal,NPL,Italy,ITA,5,5,34,0,44
2020,Niger,NER,Italy,ITA,10,16,32,0,58
2020,Nicaragua,NIC,Italy,ITA,16,5,5,0,26
2020,Nigeria,NGA,Italy,ITA,1317,614,4573,11,6515
2020,Norway,NOR,Italy,ITA,0,0,5,0,5
2020,Pakistan,PAK,Italy,ITA,298,772,4996,36,6102
2020,Panama,PAN,Italy,ITA,0,5,0,0,5
2020,Paraguay,PRY,Italy,ITA,0,0,16,0,16
2020,Peru,PER,Italy,ITA,106,59,1131,0,1296
2020,Philippines,PHL,Italy,ITA,5,5,65,0,75
2020,Russian Federation,RUS,Italy,ITA,21,10,57,0,88
2020,Rwanda,RWA,Italy,ITA,5,0,0,0,5
2020,El Salvador,SLV,Italy,ITA,454,626,703,0,1783
2020,Serbia and Kosovo: S/RES/1244 (1999),SRB,Italy,ITA,23,86,507,0,616
2020,Senegal,SEN,Italy,ITA,68,121,1487,0,1676
2020,Seychelles,SYC,Italy,ITA,0,0,5,0,5
2020,Sierra Leone,SLE,Italy,ITA,10,12,100,0,122
2020,Somalia,SOM,Italy,ITA,130,241,93,10,474
2020,Viet Nam,VNM,Italy,ITA,0,0,5,0,5
2020,Sudan,SDN,Italy,ITA,31,21,90,5,147
2020,South Sudan,SSD,Italy,ITA,0,5,0,0,5
2020,Syrian Arab Rep.,SYR,Italy,ITA,64,24,33,0,121
2020,United Rep. of Tanzania,TZA,Italy,ITA,5,0,0,0,5
2020,Tajikistan,TJK,Italy,ITA,5,0,0,0,5
2020,Togo,TGO,Italy,ITA,10,37,93,0,140
2020,Tunisia,TUN,Italy,ITA,34,11,837,0,882
2020,Turkey,TUR,Italy,ITA,157,55,185,0,397
2020,Uganda,UGA,Italy,ITA,0,0,5,0,5
2020,Ukraine,UKR,Italy,ITA,71,279,870,0,1220
2020,Uruguay,URY,Italy,ITA,0,0,12,0,12
2020,United States of America,USA,Italy,ITA,0,0,5,0,5
2020,Venezuela (Bolivarian Republic of),VEN,Italy,ITA,167,716,75,0,958
2020,Yemen,YEM,Italy,ITA,5,5,0,0,10
2020,Zimbabwe,ZWE,Italy,ITA,5,0,0,0,5
2020,Stateless,XXA,Italy,ITA,0,5,0,0,5
2020,Unknown ,,Italy,ITA,19,69,112,5,205
2020,Afghanistan,AFG,Japan,JPN,5,0,0,0,0
2020,China,CHN,Japan,JPN,11,0,0,0,0
2020,Dem. Rep. of the Congo,COD,Japan,JPN,5,0,0,0,0
2020,Guatemala,GTM,Japan,JPN,5,0,0,0,0
2020,Rwanda,RWA,Japan,JPN,5,0,0,0,0
2020,Syrian Arab Rep.,SYR,Japan,JPN,5,0,0,0,0
2020,Yemen,YEM,Japan,JPN,11,0,0,0,0
2020,Unknown ,,Japan,JPN,0,44,3433,1916,5393
2020,Afghanistan,AFG,Kazakhstan,KAZ,0,0,66,12,78
2020,China,CHN,Kazakhstan,KAZ,5,0,0,0,5
2020,Egypt,EGY,Kenya,KEN,0,0,0,10,10
2020,Burundi,BDI,Kenya,KEN,887,0,0,215,1102
2020,Congo,COG,Kenya,KEN,5,0,0,5,10
2020,Dem. Rep. of the Congo,COD,Kenya,KEN,1158,0,0,62,1220
2020,Eritrea,ERI,Kenya,KEN,18,0,0,0,18
2020,Ethiopia,ETH,Kenya,KEN,555,0,0,44,599
2020,Nigeria,NGA,Kenya,KEN,0,0,0,5,5
2020,Rwanda,RWA,Kenya,KEN,12,0,0,10,22
2020,Somalia,SOM,Kenya,KEN,12,0,0,75,87
2020,Sudan,SDN,Kenya,KEN,381,0,0,111,492
2020,South Sudan,SSD,Kenya,KEN,0,0,0,57,57
2020,United Rep. of Tanzania,TZA,Kenya,KEN,11,0,0,0,11
2020,Turkey,TUR,Kenya,KEN,67,0,0,0,67
2020,Uganda,UGA,Kenya,KEN,0,0,0,38,38
2020,Yemen,YEM,Kenya,KEN,24,0,0,0,24
2020,Afghanistan,AFG,Kyrgyzstan,KGZ,5,0,89,15,109
2020,Palestinian,PSE,Kyrgyzstan,KGZ,0,0,5,0,5
2020,Iraq,IRQ,Kyrgyzstan,KGZ,0,0,0,5,5
2020,Syrian Arab Rep.,SYR,Kyrgyzstan,KGZ,5,0,0,0,5
2020,Turkey,TUR,Kyrgyzstan,KGZ,0,0,0,10,10
2020,Uzbekistan,UZB,Kyrgyzstan,KGZ,0,0,0,5,5
2020,Dem. Rep. of the Congo,COD,Liberia,LBR,5,0,0,0,5
2020,South Sudan,SSD,Liberia,LBR,5,0,0,0,5
2020,Turkey,TUR,Liberia,LBR,15,0,0,0,15
2020,Dem. Rep. of the Congo,COD,Lesotho,LSO,45,0,0,0,45
2020,Eritrea,ERI,Lesotho,LSO,13,0,0,0,13
2020,Ethiopia,ETH,Lesotho,LSO,10,0,0,0,10
2020,Albania,ALB,Liechtenstein,LIE,0,0,0,5,5
2020,China,CHN,Liechtenstein,LIE,11,0,0,0,11
2020,Serbia and Kosovo: S/RES/1244 (1999),SRB,Liechtenstein,LIE,0,0,5,0,5
2020,Somalia,SOM,Liechtenstein,LIE,0,0,0,5,5
2020,Ukraine,UKR,Liechtenstein,LIE,0,0,0,5,5
2020,Afghanistan,AFG,Lithuania,LTU,0,0,5,0,5
2020,Armenia,ARM,Lithuania,LTU,0,0,0,10,10
2020,Belarus,BLR,Lithuania,LTU,0,0,10,19,29
2020,India,IND,Lithuania,LTU,0,0,0,5,5
2020,Iran (Islamic Rep. of),IRN,Lithuania,LTU,5,0,0,0,5
2020,Iraq,IRQ,Lithuania,LTU,0,0,5,5,10
2020,Kyrgyzstan,KGZ,Lithuania,LTU,0,0,5,0,5
2020,Rep. of Moldova,MDA,Lithuania,LTU,0,0,5,0,5
2020,Russian Federation,RUS,Lithuania,LTU,24,0,102,156,282
2020,Syrian Arab Rep.,SYR,Lithuania,LTU,10,0,0,0,10
2020,Tajikistan,TJK,Lithuania,LTU,12,0,114,71,197
2020,Turkey,TUR,Lithuania,LTU,17,0,5,0,22
2020,Ukraine,UKR,Lithuania,LTU,0,0,5,0,5
2020,Uzbekistan,UZB,Lithuania,LTU,5,0,0,0,5
2020,Afghanistan,AFG,Luxembourg,LUX,41,5,72,0,118
2020,Albania,ALB,Luxembourg,LUX,0,26,0,0,26
2020,Algeria,DZA,Luxembourg,LUX,0,5,5,10,20
2020,Egypt,EGY,Luxembourg,LUX,0,5,0,0,5
2020,Benin,BEN,Luxembourg,LUX,0,0,5,0,5
2020,Belarus,BLR,Luxembourg,LUX,0,0,13,0,13
2020,Bosnia and Herzegovina,BIH,Luxembourg,LUX,0,5,0,0,5
2020,Chad,TCD,Luxembourg,LUX,0,0,5,0,5
2020,Cameroon,CMR,Luxembourg,LUX,5,0,21,0,26
2020,Dem. Rep. of the Congo,COD,Luxembourg,LUX,0,5,0,5,10
2020,Colombia,COL,Luxembourg,LUX,0,0,5,0,5
2020,Eritrea,ERI,Luxembourg,LUX,421,0,0,5,426
2020,Ethiopia,ETH,Luxembourg,LUX,13,0,5,0,18
2020,Georgia,GEO,Luxembourg,LUX,0,0,0,10,10
2020,Guinea,GIN,Luxembourg,LUX,0,13,5,5,23
2020,Cote d'Ivoire,CIV,Luxembourg,LUX,0,5,5,0,10
2020,Iran (Islamic Rep. of),IRN,Luxembourg,LUX,16,5,12,0,33
2020,Iraq,IRQ,Luxembourg,LUX,14,0,42,5,61
2020,Libya,LBY,Luxembourg,LUX,0,0,15,0,15
2020,Mauritania,MRT,Luxembourg,LUX,0,0,0,5,5
2020,Morocco,MAR,Luxembourg,LUX,0,5,0,14,19
2020,Montenegro,MNE,Luxembourg,LUX,0,5,0,0,5
2020,Nigeria,NGA,Luxembourg,LUX,0,0,11,5,16
2020,Rwanda,RWA,Luxembourg,LUX,0,0,5,0,5
2020,Senegal,SEN,Luxembourg,LUX,0,0,10,0,10
2020,Somalia,SOM,Luxembourg,LUX,5,0,11,0,16
2020,Sudan,SDN,Luxembourg,LUX,21,0,12,5,38
2020,Syrian Arab Rep.,SYR,Luxembourg,LUX,183,0,0,0,183
2020,Togo,TGO,Luxembourg,LUX,0,5,0,0,5
2020,Tunisia,TUN,Luxembourg,LUX,0,0,0,14,14
2020,Turkey,TUR,Luxembourg,LUX,19,0,13,0,32
2020,Ukraine,UKR,Luxembourg,LUX,0,0,15,0,15
2020,Venezuela (Bolivarian Republic of),VEN,Luxembourg,LUX,0,13,10,0,23
2020,Yemen,YEM,Luxembourg,LUX,5,0,0,0,5
2020,Zambia,ZMB,Luxembourg,LUX,0,0,5,0,5
2020,Stateless,XXA,Luxembourg,LUX,0,5,0,0,5
2020,Unknown ,,Luxembourg,LUX,10,0,60,0,70
2020,Afghanistan,AFG,Latvia,LVA,0,0,0,5,5
2020,Egypt,EGY,Latvia,LVA,0,0,0,5,5
2020,Azerbaijan,AZE,Latvia,LVA,0,0,21,0,21
2020,Bangladesh,BGD,Latvia,LVA,0,0,0,5,5
2020,Belarus,BLR,Latvia,LVA,0,11,0,0,11
2020,Colombia,COL,Latvia,LVA,0,0,5,0,5
2020,Georgia,GEO,Latvia,LVA,0,0,5,0,5
2020,India,IND,Latvia,LVA,0,0,0,5,5
2020,Iran (Islamic Rep. of),IRN,Latvia,LVA,0,0,0,5,5
2020,Iraq,IRQ,Latvia,LVA,5,0,0,0,5
2020,Russian Federation,RUS,Latvia,LVA,0,0,14,0,14
2020,Syrian Arab Rep.,SYR,Latvia,LVA,0,5,0,5,10
2020,Tajikistan,TJK,Latvia,LVA,0,0,5,0,5
2020,Turkey,TUR,Latvia,LVA,5,0,0,0,5
2020,Uzbekistan,UZB,Latvia,LVA,0,0,5,0,5
2020,Armenia,ARM,Rep. of Moldova,MDA,0,0,5,0,5
2020,Iraq,IRQ,Rep. of Moldova,MDA,0,0,0,5,5
2020,Kyrgyzstan,KGZ,Rep. of Moldova,MDA,0,0,5,0,5
2020,Libya,LBY,Rep. of Moldova,MDA,0,5,0,0,5
2020,Romania,ROU,Rep. of Moldova,MDA,0,0,0,5,5
2020,Russian Federation,RUS,Rep. of Moldova,MDA,0,0,5,0,5
2020,Syrian Arab Rep.,SYR,Rep. of Moldova,MDA,0,5,0,0,5
2020,Tajikistan,TJK,Rep. of Moldova,MDA,0,0,5,0,5
2020,Turkey,TUR,Rep. of Moldova,MDA,35,0,12,10,57
2020,Ukraine,UKR,Rep. of Moldova,MDA,0,0,5,0,5
2020,Uzbekistan,UZB,Rep. of Moldova,MDA,5,0,5,0,10
2020,Angola,AGO,Mexico,MEX,5,0,0,13,18
2020,Argentina,ARG,Mexico,MEX,0,0,11,0,11
2020,Benin,BEN,Mexico,MEX,0,0,0,5,5
2020,Burkina Faso,BFA,Mexico,MEX,0,0,0,11,11
2020,Brazil,BRA,Mexico,MEX,14,44,56,44,158
2020,Belize,BLZ,Mexico,MEX,5,0,0,0,5
2020,Chile,CHL,Mexico,MEX,73,116,118,67,374
2020,Cameroon,CMR,Mexico,MEX,22,0,0,130,152
2020,Congo,COG,Mexico,MEX,0,0,0,5,5
2020,Dem. Rep. of the Congo,COD,Mexico,MEX,5,0,0,57,62
2020,Colombia,COL,Mexico,MEX,97,0,106,27,230
2020,Costa Rica,CRI,Mexico,MEX,0,0,11,0,11
2020,Cuba,CUB,Mexico,MEX,1497,133,1738,766,4134
2020,Dominican Rep.,DOM,Mexico,MEX,0,0,5,11,16
2020,Ecuador,ECU,Mexico,MEX,11,0,17,5,33
2020,Eritrea,ERI,Mexico,MEX,0,0,0,22,22
2020,Ethiopia,ETH,Mexico,MEX,0,0,0,5,5
2020,Gambia,GMB,Mexico,MEX,0,0,0,5,5
2020,Ghana,GHA,Mexico,MEX,5,5,0,25,35
2020,Guatemala,GTM,Mexico,MEX,669,22,555,272,1518
2020,Guinea,GIN,Mexico,MEX,0,0,0,11,11
2020,Guyana,GUY,Mexico,MEX,0,0,5,0,5
2020,Haiti,HTI,Mexico,MEX,475,647,1139,561,2822
2020,Honduras,HND,Mexico,MEX,6453,5,1064,1583,9105
2020,India,IND,Mexico,MEX,0,0,5,0,5
2020,Iran (Islamic Rep. of),IRN,Mexico,MEX,0,0,0,5,5
2020,Kyrgyzstan,KGZ,Mexico,MEX,0,5,0,0,5
2020,Sri Lanka,LKA,Mexico,MEX,0,0,0,5,5
2020,Nicaragua,NIC,Mexico,MEX,266,90,179,112,647
2020,Nigeria,NGA,Mexico,MEX,10,0,0,0,10
2020,Panama,PAN,Mexico,MEX,5,14,0,0,19
2020,Peru,PER,Mexico,MEX,14,0,0,0,14
2020,Portugal,PRT,Mexico,MEX,5,0,0,0,5
2020,Russian Federation,RUS,Mexico,MEX,5,0,0,0,5
2020,El Salvador,SLV,Mexico,MEX,1993,0,384,446,2823
2020,Sierra Leone,SLE,Mexico,MEX,0,0,0,5,5
2020,Spain,ESP,Mexico,MEX,0,0,5,0,5
2020,Togo,TGO,Mexico,MEX,5,0,0,0,5
2020,United States of America,USA,Mexico,MEX,12,0,0,0,12
2020,Venezuela (Bolivarian Republic of),VEN,Mexico,MEX,4232,12,81,219,4544
2020,Yemen,YEM,Mexico,MEX,0,0,0,5,5
2020,Burkina Faso,BFA,Mali,MLI,72,0,0,0,72
2020,Central African Rep.,CAF,Mali,MLI,5,0,0,0,5
2020,Burundi,BDI,Malawi,MWI,46,0,0,11,57
2020,Dem. Rep. of the Congo,COD,Malawi,MWI,238,0,0,57,295
2020,Rwanda,RWA,Malawi,MWI,68,0,0,12,80
2020,Somalia,SOM,Malawi,MWI,5,0,0,0,5
2020,Uganda,UGA,Malawi,MWI,5,0,0,0,5
2020,Algeria,DZA,Malta,MLT,0,0,0,11,11
2020,Egypt,EGY,Malta,MLT,0,0,10,11,21
2020,Bangladesh,BGD,Malta,MLT,0,0,124,51,175
2020,Burkina Faso,BFA,Malta,MLT,0,0,0,5,5
2020,Chad,TCD,Malta,MLT,0,0,5,11,16
2020,Cameroon,CMR,Malta,MLT,0,0,5,5,10
2020,Colombia,COL,Malta,MLT,0,0,0,11,11
2020,Eritrea,ERI,Malta,MLT,0,5,0,65,70
2020,Ethiopia,ETH,Malta,MLT,0,0,0,14,14
2020,Gambia,GMB,Malta,MLT,0,0,5,100,105
2020,Ghana,GHA,Malta,MLT,0,0,38,34,72
2020,Guinea-Bissau,GNB,Malta,MLT,0,0,0,5,5
2020,Guinea,GIN,Malta,MLT,0,0,5,40,45
2020,Cote d'Ivoire,CIV,Malta,MLT,0,0,14,74,88
2020,Iraq,IRQ,Malta,MLT,0,0,0,5,5
2020,Libya,LBY,Malta,MLT,0,71,0,50,121
2020,Sri Lanka,LKA,Malta,MLT,0,0,0,5,5
2020,Mali,MLI,Malta,MLT,0,0,10,36,46
2020,Morocco,MAR,Malta,MLT,0,0,72,31,103
2020,Niger,NER,Malta,MLT,0,0,5,0,5
2020,Nigeria,NGA,Malta,MLT,0,0,24,102,126
2020,Pakistan,PAK,Malta,MLT,0,0,5,14,19
2020,Peru,PER,Malta,MLT,0,0,0,5,5
2020,Russian Federation,RUS,Malta,MLT,0,0,0,5,5
2020,Senegal,SEN,Malta,MLT,0,0,5,36,41
2020,Sierra Leone,SLE,Malta,MLT,0,0,0,5,5
2020,Somalia,SOM,Malta,MLT,0,5,0,134,139
2020,Sudan,SDN,Malta,MLT,18,0,19,210,247
2020,South Sudan,SSD,Malta,MLT,0,0,0,5,5
2020,Syrian Arab Rep.,SYR,Malta,MLT,29,92,0,87,208
2020,Togo,TGO,Malta,MLT,0,0,5,0,5
2020,Tunisia,TUN,Malta,MLT,0,0,5,10,15
2020,Turkey,TUR,Malta,MLT,5,0,0,0,5
2020,Ukraine,UKR,Malta,MLT,0,0,10,11,21
2020,Venezuela (Bolivarian Republic of),VEN,Malta,MLT,0,0,12,12,24
2020,Yemen,YEM,Malta,MLT,5,0,0,0,5
2020,Unknown ,,Malta,MLT,0,0,0,5,5
2020,Burundi,BDI,Namibia,NAM,5,0,0,0,5
2020,Central African Rep.,CAF,Namibia,NAM,0,0,0,10,10
2020,Dem. Rep. of the Congo,COD,Namibia,NAM,174,0,0,82,256
2020,Afghanistan,AFG,Netherlands,NLD,120,99,71,53,343
2020,Albania,ALB,Netherlands,NLD,0,0,48,35,83
2020,Algeria,DZA,Netherlands,NLD,0,0,250,163,413
2020,Angola,AGO,Netherlands,NLD,0,0,5,0,5
2020,Egypt,EGY,Netherlands,NLD,34,5,35,11,85
2020,Argentina,ARG,Netherlands,NLD,5,0,0,0,5
2020,Armenia,ARM,Netherlands,NLD,5,0,22,14,41
2020,Azerbaijan,AZE,Netherlands,NLD,5,5,24,37,71
2020,Burundi,BDI,Netherlands,NLD,5,0,0,0,5
2020,Benin,BEN,Netherlands,NLD,0,0,5,0,5
2020,Bangladesh,BGD,Netherlands,NLD,0,0,10,0,10
2020,Belarus,BLR,Netherlands,NLD,0,0,5,15,20
2020,Brazil,BRA,Netherlands,NLD,0,0,14,5,19
2020,Bosnia and Herzegovina,BIH,Netherlands,NLD,0,0,16,0,16
2020,Chad,TCD,Netherlands,NLD,0,0,5,0,5
2020,China,CHN,Netherlands,NLD,69,14,12,5,100
2020,Cameroon,CMR,Netherlands,NLD,5,0,5,10,20
2020,Congo,COG,Netherlands,NLD,0,0,0,13,13
2020,Dem. Rep. of the Congo,COD,Netherlands,NLD,0,0,5,0,5
2020,Colombia,COL,Netherlands,NLD,26,5,35,25,91
2020,Cuba,CUB,Netherlands,NLD,0,0,0,5,5
2020,Dominican Rep.,DOM,Netherlands,NLD,0,0,5,0,5
2020,Eritrea,ERI,Netherlands,NLD,255,26,104,26,411
2020,Ethiopia,ETH,Netherlands,NLD,0,0,11,5,16
2020,Gambia,GMB,Netherlands,NLD,5,0,30,5,40
2020,Palestinian,PSE,Netherlands,NLD,5,0,0,0,5
2020,Georgia,GEO,Netherlands,NLD,5,0,130,40,175
2020,Ghana,GHA,Netherlands,NLD,0,0,13,5,18
2020,Guinea-Bissau,GNB,Netherlands,NLD,0,0,0,5,5
2020,Guinea,GIN,Netherlands,NLD,18,0,37,10,65
2020,Honduras,HND,Netherlands,NLD,0,0,5,0,5
2020,Cote d'Ivoire,CIV,Netherlands,NLD,0,0,0,13,13
2020,India,IND,Netherlands,NLD,0,0,14,0,14
2020,Iran (Islamic Rep. of),IRN,Netherlands,NLD,262,97,307,81,747
2020,Iraq,IRQ,Netherlands,NLD,179,14,140,54,387
2020,Jamaica,JAM,Netherlands,NLD,5,0,5,0,10
2020,Jordan,JOR,Netherlands,NLD,10,5,24,10,49
2020,Kazakhstan,KAZ,Netherlands,NLD,5,0,5,0,10
2020,Kenya,KEN,Netherlands,NLD,0,0,5,5,10
2020,Kyrgyzstan,KGZ,Netherlands,NLD,5,0,0,0,5
2020,Kuwait,KWT,Netherlands,NLD,0,0,0,5,5
2020,Liberia,LBR,Netherlands,NLD,0,0,5,5,10
2020,Libya,LBY,Netherlands,NLD,22,5,31,42,100
2020,Lebanon,LBN,Netherlands,NLD,11,5,10,10,36
2020,Sri Lanka,LKA,Netherlands,NLD,0,0,13,5,18
2020,Mauritania,MRT,Netherlands,NLD,0,0,0,5,5
2020,North Macedonia,MKD,Netherlands,NLD,0,0,75,5,80
2020,Rep. of Moldova,MDA,Netherlands,NLD,0,0,38,39,77
2020,Mexico,MEX,Netherlands,NLD,0,0,5,0,5
2020,Mali,MLI,Netherlands,NLD,0,0,5,0,5
2020,Malaysia,MYS,Netherlands,NLD,0,0,5,0,5
2020,Mongolia,MNG,Netherlands,NLD,0,0,5,0,5
2020,Morocco,MAR,Netherlands,NLD,5,5,228,222,460
2020,Montenegro,MNE,Netherlands,NLD,0,0,5,0,5
2020,Myanmar,MMR,Netherlands,NLD,0,0,11,0,11
2020,Nepal,NPL,Netherlands,NLD,0,0,0,5,5
2020,Niger,NER,Netherlands,NLD,0,0,5,0,5
2020,Nicaragua,NIC,Netherlands,NLD,11,5,0,5,21
2020,Nigeria,NGA,Netherlands,NLD,11,0,106,57,174
2020,Pakistan,PAK,Netherlands,NLD,150,16,38,21,225
2020,Peru,PER,Netherlands,NLD,0,0,5,0,5
2020,Philippines,PHL,Netherlands,NLD,0,0,5,0,5
2020,South Africa,ZAF,Netherlands,NLD,0,0,5,0,5
2020,Russian Federation,RUS,Netherlands,NLD,65,5,31,32,133
2020,Rwanda,RWA,Netherlands,NLD,0,0,5,5,10
2020,El Salvador,SLV,Netherlands,NLD,0,0,11,0,11
2020,Saudi Arabia,SAU,Netherlands,NLD,5,0,0,0,5
2020,Serbia and Kosovo: S/RES/1244 (1999),SRB,Netherlands,NLD,0,0,109,19,128
2020,Senegal,SEN,Netherlands,NLD,0,0,10,0,10
2020,Sierra Leone,SLE,Netherlands,NLD,5,0,15,5,25
2020,Somalia,SOM,Netherlands,NLD,38,0,37,19,94
2020,Viet Nam,VNM,Netherlands,NLD,0,0,14,0,14
2020,Sudan,SDN,Netherlands,NLD,23,5,22,10,60
2020,Suriname,SUR,Netherlands,NLD,0,0,5,0,5
2020,Syrian Arab Rep.,SYR,Netherlands,NLD,4061,51,328,81,4521
2020,United Rep. of Tanzania,TZA,Netherlands,NLD,0,0,5,0,5
2020,Tajikistan,TJK,Netherlands,NLD,5,0,0,19,24
2020,Turkmenistan,TKM,Netherlands,NLD,5,0,0,0,5
2020,Trinidad and Tobago,TTO,Netherlands,NLD,5,0,5,0,10
2020,Tunisia,TUN,Netherlands,NLD,5,0,37,40,82
2020,Turkey,TUR,Netherlands,NLD,1141,328,72,36,1577
2020,Uganda,UGA,Netherlands,NLD,12,0,71,5,88
2020,Ukraine,UKR,Netherlands,NLD,0,5,28,12,45
2020,United States of America,USA,Netherlands,NLD,12,5,0,0,17
2020,Uzbekistan,UZB,Netherlands,NLD,0,5,5,0,10
2020,Venezuela (Bolivarian Republic of),VEN,Netherlands,NLD,12,5,64,16,97
2020,Yemen,YEM,Netherlands,NLD,583,19,29,10,641
2020,Zimbabwe,ZWE,Netherlands,NLD,0,0,5,0,5
2020,Stateless,XXA,Netherlands,NLD,143,11,33,5,192
2020,Unknown ,,Netherlands,NLD,333,30,102,25,490
2020,Central African Rep.,CAF,Niger,NER,15,0,5,0,20
2020,Chad,TCD,Niger,NER,5,0,10,10,25
2020,Cameroon,CMR,Niger,NER,16,0,5,12,33
2020,Dem. Rep. of the Congo,COD,Niger,NER,0,0,0,14,14
2020,Eritrea,ERI,Niger,NER,0,0,0,5,5
2020,Ethiopia,ETH,Niger,NER,0,0,5,5,10
2020,Guinea,GIN,Niger,NER,0,0,5,5,10
2020,Cote d'Ivoire,CIV,Niger,NER,0,0,0,5,5
2020,Mali,MLI,Niger,NER,0,0,0,12,12
2020,Nigeria,NGA,Niger,NER,0,0,0,34689,34689
2020,Sudan,SDN,Niger,NER,788,0,16,76,880
2020,South Sudan,SSD,Niger,NER,5,0,0,0,5
2020,Syrian Arab Rep.,SYR,Niger,NER,5,0,0,0,5
2020,Central African Rep.,CAF,Nigeria,NGA,250,0,30,10,290
2020,Chad,TCD,Nigeria,NGA,0,0,0,10,10
2020,Cameroon,CMR,Nigeria,NGA,124,0,0,5,129
2020,Congo,COG,Nigeria,NGA,0,0,0,5,5
2020,Dem. Rep. of the Congo,COD,Nigeria,NGA,21,0,5,22,48
2020,Cote d'Ivoire,CIV,Nigeria,NGA,0,0,0,5,5
2020,Lebanon,LBN,Nigeria,NGA,0,0,0,5,5
2020,Mali,MLI,Nigeria,NGA,0,0,12,0,12
2020,Sudan,SDN,Nigeria,NGA,0,0,0,5,5
2020,Syrian Arab Rep.,SYR,Nigeria,NGA,43,0,0,10,53
2020,Togo,TGO,Nigeria,NGA,5,0,5,5,15
2020,Afghanistan,AFG,Norway,NOR,12,10,33,14,69
2020,Albania,ALB,Norway,NOR,0,0,19,5,24
2020,Algeria,DZA,Norway,NOR,0,0,0,5,5
2020,Angola,AGO,Norway,NOR,0,0,0,13,13
2020,Egypt,EGY,Norway,NOR,0,0,5,0,5
2020,Azerbaijan,AZE,Norway,NOR,5,0,0,0,5
2020,Belarus,BLR,Norway,NOR,0,0,0,5,5
2020,China,CHN,Norway,NOR,11,0,0,5,16
2020,Cameroon,CMR,Norway,NOR,0,0,0,5,5
2020,Colombia,COL,Norway,NOR,16,0,21,0,37
2020,Czechia,CZE,Norway,NOR,0,0,5,0,5
2020,Eritrea,ERI,Norway,NOR,117,5,10,25,157
2020,Ethiopia,ETH,Norway,NOR,5,0,16,5,26
2020,Gambia,GMB,Norway,NOR,0,0,0,5,5
2020,United Kingdom of Great Britain and Northern Ireland,GBR,Norway,NOR,0,0,5,0,5
2020,Georgia,GEO,Norway,NOR,0,0,13,0,13
2020,Guinea,GIN,Norway,NOR,0,0,0,5,5
2020,Cote d'Ivoire,CIV,Norway,NOR,0,0,0,10,10
2020,India,IND,Norway,NOR,0,0,0,5,5
2020,Iran (Islamic Rep. of),IRN,Norway,NOR,21,0,36,12,69
2020,Iraq,IRQ,Norway,NOR,12,5,14,26,57
2020,Libya,LBY,Norway,NOR,0,0,0,12,12
2020,Sri Lanka,LKA,Norway,NOR,0,0,5,5,10
2020,Mexico,MEX,Norway,NOR,0,0,5,0,5
2020,Morocco,MAR,Norway,NOR,0,0,5,14,19
2020,Myanmar,MMR,Norway,NOR,0,0,5,0,5
2020,Nicaragua,NIC,Norway,NOR,0,0,14,0,14
2020,Nigeria,NGA,Norway,NOR,5,0,0,5,10
2020,Pakistan,PAK,Norway,NOR,5,0,5,13,23
2020,Peru,PER,Norway,NOR,0,0,5,0,5
2020,Poland,POL,Norway,NOR,0,0,5,0,5
2020,Russian Federation,RUS,Norway,NOR,10,0,15,13,38
2020,Rwanda,RWA,Norway,NOR,0,0,0,5,5
2020,El Salvador,SLV,Norway,NOR,0,0,0,5,5
2020,Serbia and Kosovo: S/RES/1244 (1999),SRB,Norway,NOR,0,0,12,5,17
2020,Senegal,SEN,Norway,NOR,0,0,0,5,5
2020,Somalia,SOM,Norway,NOR,10,0,12,5,27
2020,Sudan,SDN,Norway,NOR,5,0,13,5,23
2020,Syrian Arab Rep.,SYR,Norway,NOR,401,0,0,41,442
2020,United Rep. of Tanzania,TZA,Norway,NOR,5,0,0,0,5
2020,Turkey,TUR,Norway,NOR,288,0,28,5,321
2020,Uganda,UGA,Norway,NOR,0,0,5,0,5
2020,Ukraine,UKR,Norway,NOR,0,0,16,0,16
2020,Venezuela (Bolivarian Republic of),VEN,Norway,NOR,15,0,12,0,27
2020,Yemen,YEM,Norway,NOR,5,13,0,0,18
2020,Stateless,XXA,Norway,NOR,42,0,22,26,90
2020,Afghanistan,AFG,Nauru,NRU,5,0,0,0,5
2020,Bangladesh,BGD,Nauru,NRU,5,0,0,0,5
2020,India,IND,Nauru,NRU,10,0,0,0,10
2020,Iran (Islamic Rep. of),IRN,Nauru,NRU,202,0,0,0,202
2020,Iraq,IRQ,Nauru,NRU,13,0,0,0,13
2020,Sri Lanka,LKA,Nauru,NRU,33,0,0,0,33
2020,Malaysia,MYS,Nauru,NRU,5,0,0,0,5
2020,Myanmar,MMR,Nauru,NRU,12,0,0,0,12
2020,Nepal,NPL,Nauru,NRU,10,0,0,0,10
2020,Pakistan,PAK,Nauru,NRU,5,0,0,0,5
2020,Somalia,SOM,Nauru,NRU,5,0,0,0,5
2020,Stateless,XXA,Nauru,NRU,19,0,0,0,19
2020,Afghanistan,AFG,New Zealand,NZL,0,16,5,0,21
2020,Bangladesh,BGD,New Zealand,NZL,0,0,14,0,14
2020,Brazil,BRA,New Zealand,NZL,0,0,5,0,5
2020,China,CHN,New Zealand,NZL,0,25,17,10,52
2020,Chile,CHL,New Zealand,NZL,0,0,5,0,5
2020,Colombia,COL,New Zealand,NZL,0,0,5,0,5
2020,Czechia,CZE,New Zealand,NZL,0,0,0,5,5
2020,Ethiopia,ETH,New Zealand,NZL,0,5,0,0,5
2020,Fiji,FJI,New Zealand,NZL,0,0,5,0,5
2020,India,IND,New Zealand,NZL,0,0,25,0,25
2020,Indonesia,IDN,New Zealand,NZL,0,0,0,13,13
2020,Iran (Islamic Rep. of),IRN,New Zealand,NZL,0,19,10,0,29
2020,Sri Lanka,LKA,New Zealand,NZL,0,5,33,0,38
2020,Mexico,MEX,New Zealand,NZL,0,0,5,0,5
2020,Malaysia,MYS,New Zealand,NZL,0,0,14,5,19
2020,Mongolia,MNG,New Zealand,NZL,0,5,0,0,5
2020,Pakistan,PAK,New Zealand,NZL,0,5,0,0,5
2020,Philippines,PHL,New Zealand,NZL,0,0,5,0,5
2020,Papua New Guinea,PNG,New Zealand,NZL,0,0,0,5,5
2020,South Africa,ZAF,New Zealand,NZL,0,0,13,0,13
2020,Syrian Arab Rep.,SYR,New Zealand,NZL,0,5,0,0,5
2020,Tonga,TON,New Zealand,NZL,0,0,5,0,5
2020,Turkey,TUR,New Zealand,NZL,0,0,11,0,11
2020,United States of America,USA,New Zealand,NZL,0,0,0,5,5
2020,Bangladesh,BGD,Panama,PAN,0,0,0,5,5
2020,Colombia,COL,Panama,PAN,5,0,0,870,875
2020,Costa Rica,CRI,Panama,PAN,0,0,0,5,5
2020,Cuba,CUB,Panama,PAN,0,0,0,713,713
2020,Dominican Rep.,DOM,Panama,PAN,0,0,0,14,14
2020,Ecuador,ECU,Panama,PAN,0,0,0,10,10
2020,Ghana,GHA,Panama,PAN,0,0,0,5,5
2020,Guatemala,GTM,Panama,PAN,0,0,0,5,5
2020,Guinea,GIN,Panama,PAN,0,0,0,5,5
2020,Haiti,HTI,Panama,PAN,0,0,0,17,17
2020,Honduras,HND,Panama,PAN,5,0,0,23,28
2020,Jamaica,JAM,Panama,PAN,0,0,0,5,5
2020,Kenya,KEN,Panama,PAN,0,0,0,5,5
2020,Nicaragua,NIC,Panama,PAN,0,0,0,1991,1991
2020,Pakistan,PAK,Panama,PAN,0,0,0,12,12
2020,Peru,PER,Panama,PAN,0,0,0,5,5
2020,El Salvador,SLV,Panama,PAN,19,0,0,358,377
2020,Syrian Arab Rep.,SYR,Panama,PAN,0,0,0,12,12
2020,Venezuela (Bolivarian Republic of),VEN,Panama,PAN,5,0,0,1248,1253
2020,Cuba,CUB,Paraguay,PRY,171,0,0,0,171
2020,Venezuela (Bolivarian Republic of),VEN,Paraguay,PRY,501,0,0,0,501
2020,Colombia,COL,Peru,PER,0,0,5,5,10
2020,Cuba,CUB,Peru,PER,18,0,17,5,40
2020,Haiti,HTI,Peru,PER,0,0,5,0,5
2020,El Salvador,SLV,Peru,PER,5,0,0,0,5
2020,Venezuela (Bolivarian Republic of),VEN,Peru,PER,1398,0,114,470,1982
2020,Afghanistan,AFG,Papua New Guinea,PNG,0,0,0,5,5
2020,Iran (Islamic Rep. of),IRN,Papua New Guinea,PNG,0,0,0,24,24
2020,Afghanistan,AFG,Poland,POL,5,14,0,49,68
2020,Algeria,DZA,Poland,POL,0,0,5,5,10
2020,Angola,AGO,Poland,POL,0,0,5,0,5
2020,Egypt,EGY,Poland,POL,5,0,11,0,16
2020,Armenia,ARM,Poland,POL,0,0,15,17,32
2020,Azerbaijan,AZE,Poland,POL,0,0,26,5,31
2020,Bangladesh,BGD,Poland,POL,0,0,10,0,10
2020,Belarus,BLR,Poland,POL,10,73,20,27,130
2020,Bulgaria,BGR,Poland,POL,0,0,0,5,5
2020,China,CHN,Poland,POL,0,0,0,5,5
2020,Chile,CHL,Poland,POL,0,0,0,5,5
2020,Cameroon,CMR,Poland,POL,0,0,5,0,5
2020,Cuba,CUB,Poland,POL,0,0,10,0,10
2020,Ethiopia,ETH,Poland,POL,0,0,5,0,5
2020,Gambia,GMB,Poland,POL,0,0,0,5,5
2020,Palestinian,PSE,Poland,POL,0,0,0,5,5
2020,Georgia,GEO,Poland,POL,0,0,57,27,84
2020,Guinea,GIN,Poland,POL,0,5,5,0,10
2020,India,IND,Poland,POL,0,0,12,5,17
2020,Iran (Islamic Rep. of),IRN,Poland,POL,10,0,13,10,33
2020,Iraq,IRQ,Poland,POL,0,5,10,11,26
2020,Kazakhstan,KAZ,Poland,POL,0,5,21,5,31
2020,Kyrgyzstan,KGZ,Poland,POL,5,0,38,0,43
2020,Libya,LBY,Poland,POL,0,5,0,5,10
2020,Lebanon,LBN,Poland,POL,0,0,5,11,16
2020,Sri Lanka,LKA,Poland,POL,0,0,5,0,5
2020,Rep. of Moldova,MDA,Poland,POL,0,0,10,0,10
2020,Morocco,MAR,Poland,POL,0,0,0,10,10
2020,Nepal,NPL,Poland,POL,0,5,0,0,5
2020,Nigeria,NGA,Poland,POL,0,0,11,0,11
2020,Pakistan,PAK,Poland,POL,5,0,11,0,16
2020,Russian Federation,RUS,Poland,POL,15,51,1295,712,2073
2020,Serbia and Kosovo: S/RES/1244 (1999),SRB,Poland,POL,0,0,5,0,5
2020,Sierra Leone,SLE,Poland,POL,0,5,0,0,5
2020,Somalia,SOM,Poland,POL,0,5,0,0,5
2020,Viet Nam,VNM,Poland,POL,0,0,11,0,11
2020,Sudan,SDN,Poland,POL,0,0,5,0,5
2020,Syrian Arab Rep.,SYR,Poland,POL,14,0,0,10,24
2020,Tajikistan,TJK,Poland,POL,0,27,63,34,124
2020,Turkmenistan,TKM,Poland,POL,10,0,0,0,10
2020,Tunisia,TUN,Poland,POL,0,0,0,5,5
2020,Turkey,TUR,Poland,POL,85,0,25,12,122
2020,Ukraine,UKR,Poland,POL,5,18,313,37,373
2020,Uzbekistan,UZB,Poland,POL,0,0,12,0,12
2020,Yemen,YEM,Poland,POL,0,5,0,0,5
2020,Stateless,XXA,Poland,POL,0,0,0,13,13
2020,Unknown ,,Poland,POL,0,0,0,5,5
2020,Afghanistan,AFG,Portugal,PRT,0,0,0,5,5
2020,Algeria,DZA,Portugal,PRT,0,0,0,5,0
2020,Angola,AGO,Portugal,PRT,0,0,5,105,108
2020,Bangladesh,BGD,Portugal,PRT,0,0,0,5,5
2020,Brazil,BRA,Portugal,PRT,0,0,0,12,12
2020,China,CHN,Portugal,PRT,0,0,11,0,11
2020,Cameroon,CMR,Portugal,PRT,0,0,0,5,5
2020,Dem. Rep. of the Congo,COD,Portugal,PRT,0,0,0,20,20
2020,Colombia,COL,Portugal,PRT,0,0,0,5,5
2020,Cuba,CUB,Portugal,PRT,0,0,0,5,0
2020,Ethiopia,ETH,Portugal,PRT,5,0,0,0,5
2020,Gambia,GMB,Portugal,PRT,0,0,11,146,19
2020,Palestinian,PSE,Portugal,PRT,0,0,0,5,0
2020,Ghana,GHA,Portugal,PRT,0,0,0,10,5
2020,Guinea-Bissau,GNB,Portugal,PRT,0,0,5,74,14
2020,Guinea,GIN,Portugal,PRT,0,0,0,68,14
2020,Haiti,HTI,Portugal,PRT,0,0,0,5,5
2020,Cote d'Ivoire,CIV,Portugal,PRT,0,0,0,5,0
2020,Iran (Islamic Rep. of),IRN,Portugal,PRT,5,0,0,0,5
2020,Iraq,IRQ,Portugal,PRT,5,0,0,5,5
2020,Mali,MLI,Portugal,PRT,0,0,0,10,5
2020,Morocco,MAR,Portugal,PRT,0,0,0,61,57
2020,Nigeria,NGA,Portugal,PRT,0,0,0,30,14
2020,Pakistan,PAK,Portugal,PRT,15,0,5,5,21
2020,Russian Federation,RUS,Portugal,PRT,5,0,0,0,5
2020,Senegal,SEN,Portugal,PRT,0,0,0,60,19
2020,Sierra Leone,SLE,Portugal,PRT,0,0,0,22,5
2020,Somalia,SOM,Portugal,PRT,0,0,0,5,0
2020,Sudan,SDN,Portugal,PRT,0,5,0,0,5
2020,Syrian Arab Rep.,SYR,Portugal,PRT,21,0,0,0,21
2020,Togo,TGO,Portugal,PRT,0,0,0,5,5
2020,Turkey,TUR,Portugal,PRT,17,0,0,0,17
2020,Ukraine,UKR,Portugal,PRT,0,5,18,21,45
2020,Venezuela (Bolivarian Republic of),VEN,Portugal,PRT,0,0,0,5,5
2020,Zimbabwe,ZWE,Portugal,PRT,5,0,0,0,5
2020,Afghanistan,AFG,Romania,ROU,10,21,426,430,887
2020,Albania,ALB,Romania,ROU,0,0,0,5,5
2020,Algeria,DZA,Romania,ROU,0,0,66,44,110
2020,Egypt,EGY,Romania,ROU,0,0,30,50,80
2020,Bangladesh,BGD,Romania,ROU,0,0,39,43,82
2020,China,CHN,Romania,ROU,5,0,0,5,10
2020,Cameroon,CMR,Romania,ROU,0,0,14,0,14
2020,Congo,COG,Romania,ROU,0,0,5,0,5
2020,Dem. Rep. of the Congo,COD,Romania,ROU,0,0,0,5,5
2020,Cuba,CUB,Romania,ROU,0,0,10,0,10
2020,Eritrea,ERI,Romania,ROU,5,5,0,16,26
2020,Ethiopia,ETH,Romania,ROU,0,0,5,0,5
2020,Palestinian,PSE,Romania,ROU,5,5,10,40,60
2020,Guinea,GIN,Romania,ROU,5,0,0,5,10
2020,India,IND,Romania,ROU,0,0,40,15,55
2020,Iran (Islamic Rep. of),IRN,Romania,ROU,23,0,16,44,83
2020,Iraq,IRQ,Romania,ROU,20,5,56,331,412
2020,Jordan,JOR,Romania,ROU,5,0,0,0,5
2020,Kazakhstan,KAZ,Romania,ROU,0,0,0,5,5
2020,Libya,LBY,Romania,ROU,0,5,18,41,64
2020,Lebanon,LBN,Romania,ROU,0,0,0,5,5
2020,Sri Lanka,LKA,Romania,ROU,0,0,16,26,42
2020,Rep. of Moldova,MDA,Romania,ROU,0,0,0,5,5
2020,Morocco,MAR,Romania,ROU,0,0,102,28,130
2020,Nepal,NPL,Romania,ROU,0,0,0,5,5
2020,Nigeria,NGA,Romania,ROU,0,0,5,5,10
2020,Pakistan,PAK,Romania,ROU,0,5,62,13,80
2020,South Africa,ZAF,Romania,ROU,0,0,0,5,5
2020,Rwanda,RWA,Romania,ROU,5,0,0,0,5
2020,Somalia,SOM,Romania,ROU,48,21,34,5,108
2020,Viet Nam,VNM,Romania,ROU,0,0,0,5,5
2020,Syrian Arab Rep.,SYR,Romania,ROU,105,337,101,791,1334
2020,Tajikistan,TJK,Romania,ROU,0,0,0,5,5
2020,Tunisia,TUN,Romania,ROU,0,0,43,36,79
2020,Turkey,TUR,Romania,ROU,17,0,82,199,298
2020,Ukraine,UKR,Romania,ROU,0,0,5,0,5
2020,Venezuela (Bolivarian Republic of),VEN,Romania,ROU,0,0,5,0,5
2020,Yemen,YEM,Romania,ROU,5,14,0,0,19
2020,Stateless,XXA,Romania,ROU,22,5,0,5,32
2020,Algeria,DZA,South Africa,ZAF,0,0,5,0,5
2020,Egypt,EGY,South Africa,ZAF,0,0,5,0,5
2020,Burundi,BDI,South Africa,ZAF,5,0,55,0,60
2020,Bangladesh,BGD,South Africa,ZAF,0,0,157,0,157
2020,Cameroon,CMR,South Africa,ZAF,5,0,26,0,31
2020,Congo,COG,South Africa,ZAF,14,0,78,0,92
2020,Dem. Rep. of the Congo,COD,South Africa,ZAF,74,0,352,0,426
2020,Eritrea,ERI,South Africa,ZAF,5,0,18,0,23
2020,Ethiopia,ETH,South Africa,ZAF,65,0,444,0,509
2020,Ghana,GHA,South Africa,ZAF,0,0,22,0,22
2020,India,IND,South Africa,ZAF,0,0,29,0,29
2020,Kenya,KEN,South Africa,ZAF,0,0,5,0,5
2020,Malawi,MWI,South Africa,ZAF,0,0,54,0,54
2020,Mozambique,MOZ,South Africa,ZAF,0,0,10,0,10
2020,Nepal,NPL,South Africa,ZAF,0,0,5,0,5
2020,Niger,NER,South Africa,ZAF,0,0,5,0,5
2020,Nigeria,NGA,South Africa,ZAF,0,0,106,0,106
2020,Pakistan,PAK,South Africa,ZAF,0,0,75,0,75
2020,Rwanda,RWA,South Africa,ZAF,5,0,24,0,29
2020,Senegal,SEN,South Africa,ZAF,0,0,12,0,12
2020,Somalia,SOM,South Africa,ZAF,127,0,110,0,237
2020,Eswatini,SWZ,South Africa,ZAF,0,0,5,0,5
2020,United Rep. of Tanzania,TZA,South Africa,ZAF,0,0,5,0,5
2020,Thailand,THA,South Africa,ZAF,0,0,5,0,5
2020,Uganda,UGA,South Africa,ZAF,0,0,46,0,46
2020,Zambia,ZMB,South Africa,ZAF,0,0,5,0,5
2020,Zimbabwe,ZWE,South Africa,ZAF,5,0,199,0,204
2020,Unknown ,,South Africa,ZAF,0,0,50,0,50
2020,Afghanistan,AFG,Russian Federation,RUS,10,0,0,100,110
2020,Egypt,EGY,Russian Federation,RUS,0,0,0,5,5
2020,Armenia,ARM,Russian Federation,RUS,5,0,0,0,5
2020,Azerbaijan,AZE,Russian Federation,RUS,0,0,0,5,5
2020,Belgium,BEL,Russian Federation,RUS,0,0,0,10,10
2020,Congo,COG,Russian Federation,RUS,0,0,0,5,5
2020,Germany,DEU,Russian Federation,RUS,5,0,0,0,5
2020,Kazakhstan,KAZ,Russian Federation,RUS,0,0,0,5,5
2020,Kyrgyzstan,KGZ,Russian Federation,RUS,0,0,0,5,5
2020,Dem. People's Rep. of Korea,PRK,Russian Federation,RUS,0,0,0,5,5
2020,Niger,NER,Russian Federation,RUS,0,0,0,5,5
2020,Sudan,SDN,Russian Federation,RUS,0,0,0,5,5
2020,Syrian Arab Rep.,SYR,Russian Federation,RUS,0,0,0,25,25
2020,Tajikistan,TJK,Russian Federation,RUS,0,0,0,10,10
2020,Ukraine,UKR,Russian Federation,RUS,10,0,0,27,37
2020,Uzbekistan,UZB,Russian Federation,RUS,0,0,0,5,5
2020,Yemen,YEM,Russian Federation,RUS,0,0,0,10,10
2020,Burundi,BDI,Rwanda,RWA,0,0,0,16,16
2020,Dem. Rep. of the Congo,COD,Rwanda,RWA,15,0,0,33,48
2020,Eritrea,ERI,Rwanda,RWA,29,0,0,104,133
2020,Ethiopia,ETH,Rwanda,RWA,5,0,0,0,5
2020,Somalia,SOM,Rwanda,RWA,16,0,0,5,21
2020,Sudan,SDN,Rwanda,RWA,5,0,0,0,5
2020,Honduras,HND,El Salvador,SLV,0,0,0,5,5
2020,Afghanistan,AFG,Serbia and Kosovo: S/RES/1244 (1999),SRB,11,0,0,62,73
2020,Algeria,DZA,Serbia and Kosovo: S/RES/1244 (1999),SRB,0,0,0,52,52
2020,Egypt,EGY,Serbia and Kosovo: S/RES/1244 (1999),SRB,0,0,0,23,23
2020,Burundi,BDI,Serbia and Kosovo: S/RES/1244 (1999),SRB,0,0,15,11,26
2020,Bangladesh,BGD,Serbia and Kosovo: S/RES/1244 (1999),SRB,0,0,0,10,10
2020,Palestinian,PSE,Serbia and Kosovo: S/RES/1244 (1999),SRB,0,0,0,109,109
2020,Ghana,GHA,Serbia and Kosovo: S/RES/1244 (1999),SRB,0,0,0,5,5
2020,Guinea,GIN,Serbia and Kosovo: S/RES/1244 (1999),SRB,0,0,0,5,5
2020,Iran (Islamic Rep. of),IRN,Serbia and Kosovo: S/RES/1244 (1999),SRB,5,0,26,50,81
2020,Iraq,IRQ,Serbia and Kosovo: S/RES/1244 (1999),SRB,0,0,0,125,125
2020,Libya,LBY,Serbia and Kosovo: S/RES/1244 (1999),SRB,0,0,0,64,64
2020,Lebanon,LBN,Serbia and Kosovo: S/RES/1244 (1999),SRB,0,0,0,10,10
2020,North Macedonia,MKD,Serbia and Kosovo: S/RES/1244 (1999),SRB,0,0,5,0,5
2020,Morocco,MAR,Serbia and Kosovo: S/RES/1244 (1999),SRB,0,0,0,175,175
2020,Pakistan,PAK,Serbia and Kosovo: S/RES/1244 (1999),SRB,0,0,5,0,5
2020,Russian Federation,RUS,Serbia and Kosovo: S/RES/1244 (1999),SRB,0,0,5,0,5
2020,Somalia,SOM,Serbia and Kosovo: S/RES/1244 (1999),SRB,0,0,0,5,5
2020,Syrian Arab Rep.,SYR,Serbia and Kosovo: S/RES/1244 (1999),SRB,5,5,0,645,655
2020,Tunisia,TUN,Serbia and Kosovo: S/RES/1244 (1999),SRB,0,0,0,16,16
2020,Turkey,TUR,Serbia and Kosovo: S/RES/1244 (1999),SRB,11,0,0,29,40
2020,Yemen,YEM,Serbia and Kosovo: S/RES/1244 (1999),SRB,0,0,0,15,15
2020,Afghanistan,AFG,Spain,ESP,10,85,32,0,127
2020,Albania,ALB,Spain,ESP,0,0,104,0,104
2020,Algeria,DZA,Spain,ESP,12,5,641,0,658
2020,Angola,AGO,Spain,ESP,22,0,11,0,33
2020,Egypt,EGY,Spain,ESP,32,0,55,0,87
2020,Argentina,ARG,Spain,ESP,14,0,258,0,272
2020,Armenia,ARM,Spain,ESP,0,5,127,0,132
2020,Azerbaijan,AZE,Spain,ESP,0,0,13,0,13
2020,Bangladesh,BGD,Spain,ESP,5,0,279,0,284
2020,Burkina Faso,BFA,Spain,ESP,0,0,56,0,56
2020,Belarus,BLR,Spain,ESP,5,0,24,0,29
2020,Bolivia (Plurinational State of),BOL,Spain,ESP,0,5,58,0,63
2020,Brazil,BRA,Spain,ESP,24,0,745,0,769
2020,Central African Rep.,CAF,Spain,ESP,5,18,5,0,28
2020,Chad,TCD,Spain,ESP,0,0,5,0,5
2020,China,CHN,Spain,ESP,10,0,35,0,45
2020,Chile,CHL,Spain,ESP,5,10,70,0,85
2020,Cameroon,CMR,Spain,ESP,15,0,72,0,87
2020,Congo,COG,Spain,ESP,5,0,17,0,22
2020,Dem. Rep. of the Congo,COD,Spain,ESP,30,5,103,0,138
2020,Colombia,COL,Spain,ESP,624,152,37907,0,38683
2020,Costa Rica,CRI,Spain,ESP,5,0,30,0,35
2020,Cuba,CUB,Spain,ESP,20,0,286,0,306
2020,Dominican Rep.,DOM,Spain,ESP,0,5,58,0,63
2020,Ecuador,ECU,Spain,ESP,5,0,91,0,96
2020,Equatorial Guinea,GNQ,Spain,ESP,5,0,18,0,23
2020,Eritrea,ERI,Spain,ESP,5,0,11,0,16
2020,France,FRA,Spain,ESP,0,0,5,0,5
2020,Gambia,GMB,Spain,ESP,11,0,138,0,149
2020,Palestinian,PSE,Spain,ESP,53,149,606,0,808
2020,Georgia,GEO,Spain,ESP,10,0,614,0,624
2020,Ghana,GHA,Spain,ESP,0,0,392,0,392
2020,Guinea-Bissau,GNB,Spain,ESP,0,0,5,0,5
2020,Guatemala,GTM,Spain,ESP,55,0,420,0,475
2020,Guinea,GIN,Spain,ESP,50,10,567,0,627
2020,Haiti,HTI,Spain,ESP,0,0,5,0,5
2020,Honduras,HND,Spain,ESP,687,15,5180,0,5882
2020,Cote d'Ivoire,CIV,Spain,ESP,174,5,635,0,814
2020,India,IND,Spain,ESP,0,0,72,0,72
2020,Iran (Islamic Rep. of),IRN,Spain,ESP,5,0,39,0,44
2020,Iraq,IRQ,Spain,ESP,5,5,62,0,72
2020,Jamaica,JAM,Spain,ESP,26,0,0,0,26
2020,Jordan,JOR,Spain,ESP,0,0,5,0,5
2020,Kazakhstan,KAZ,Spain,ESP,5,0,5,0,10
2020,Kenya,KEN,Spain,ESP,5,0,0,0,5
2020,Kyrgyzstan,KGZ,Spain,ESP,0,0,5,0,5
2020,Liberia,LBR,Spain,ESP,0,0,23,0,23
2020,Libya,LBY,Spain,ESP,33,49,14,0,96
2020,Lebanon,LBN,Spain,ESP,0,5,86,0,91
2020,Sri Lanka,LKA,Spain,ESP,0,5,14,0,19
2020,Mauritania,MRT,Spain,ESP,15,0,54,0,69
2020,Rep. of Moldova,MDA,Spain,ESP,0,0,13,0,13
2020,Mexico,MEX,Spain,ESP,0,5,34,0,39
2020,Mali,MLI,Spain,ESP,5,233,208,0,446
2020,Morocco,MAR,Spain,ESP,184,0,403,0,587
2020,Niger,NER,Spain,ESP,0,0,12,0,12
2020,Nicaragua,NIC,Spain,ESP,1117,5,3118,0,4240
2020,Nigeria,NGA,Spain,ESP,36,0,276,0,312
2020,Pakistan,PAK,Spain,ESP,38,0,884,0,922
2020,Panama,PAN,Spain,ESP,0,12,11,0,23
2020,Paraguay,PRY,Spain,ESP,48,0,125,0,173
2020,Peru,PER,Spain,ESP,96,17,3604,0,3717
2020,Philippines,PHL,Spain,ESP,0,0,5,0,5
2020,Qatar,QAT,Spain,ESP,0,0,5,0,5
2020,South Africa,ZAF,Spain,ESP,5,0,0,0,5
2020,Russian Federation,RUS,Spain,ESP,158,5,92,0,255
2020,El Salvador,SLV,Spain,ESP,408,16,3927,0,4351
2020,Senegal,SEN,Spain,ESP,19,0,366,0,385
2020,Sierra Leone,SLE,Spain,ESP,0,0,18,0,18
2020,Somalia,SOM,Spain,ESP,0,11,16,0,27
2020,Viet Nam,VNM,Spain,ESP,0,0,14,0,14
2020,Sudan,SDN,Spain,ESP,95,5,5,0,105
2020,Syrian Arab Rep.,SYR,Spain,ESP,5,525,948,0,1478
2020,Trinidad and Tobago,TTO,Spain,ESP,5,0,0,0,5
2020,Tunisia,TUN,Spain,ESP,21,0,192,0,213
2020,Turkey,TUR,Spain,ESP,78,0,83,0,161
2020,Ukraine,UKR,Spain,ESP,34,257,2768,0,3059
2020,Uruguay,URY,Spain,ESP,0,0,46,0,46
2020,United States of America,USA,Spain,ESP,0,10,27,0,37
2020,Venezuela (Bolivarian Republic of),VEN,Spain,ESP,5,40396,882,0,41283
2020,Western Sahara,ESH,Spain,ESP,5,0,14,0,19
2020,Yemen,YEM,Spain,ESP,22,88,252,0,362
2020,Unknown ,,Spain,ESP,0,0,10,0,10
2020,Dem. Rep. of the Congo,COD,Sudan,SDN,15,0,47,49,111
2020,Eritrea,ERI,Sudan,SDN,2844,0,24,2256,5124
2020,Ethiopia,ETH,Sudan,SDN,1023,0,2244,100,3367
2020,Somalia,SOM,Sudan,SDN,27,0,0,20,47
2020,Yemen,YEM,Sudan,SDN,0,0,0,61,61
2020,Burundi,BDI,South Sudan,SSD,52,0,0,5,57
2020,Eritrea,ERI,South Sudan,SSD,65,0,0,57,122
2020,Ethiopia,ETH,South Sudan,SSD,0,0,0,5,5
2020,Afghanistan,AFG,Slovakia,SVK,0,20,5,37,62
2020,Algeria,DZA,Slovakia,SVK,0,0,5,14,19
2020,Bangladesh,BGD,Slovakia,SVK,0,0,0,12,12
2020,China,CHN,Slovakia,SVK,0,0,0,5,5
2020,India,IND,Slovakia,SVK,0,0,0,12,12
2020,Iran (Islamic Rep. of),IRN,Slovakia,SVK,0,0,5,11,16
2020,Iraq,IRQ,Slovakia,SVK,0,0,0,5,5
2020,Libya,LBY,Slovakia,SVK,0,5,0,5,10
2020,Sri Lanka,LKA,Slovakia,SVK,0,0,0,11,11
2020,Morocco,MAR,Slovakia,SVK,0,0,5,26,31
2020,Pakistan,PAK,Slovakia,SVK,0,0,0,5,5
2020,Russian Federation,RUS,Slovakia,SVK,0,0,0,5,5
2020,Viet Nam,VNM,Slovakia,SVK,0,0,5,0,5
2020,Syrian Arab Rep.,SYR,Slovakia,SVK,0,10,0,23,33
2020,Tunisia,TUN,Slovakia,SVK,0,0,0,5,5
2020,Turkey,TUR,Slovakia,SVK,0,0,0,5,5
2020,Ukraine,UKR,Slovakia,SVK,0,0,0,5,5
2020,Afghanistan,AFG,Slovenia,SVN,5,0,109,508,622
2020,Algeria,DZA,Slovenia,SVN,0,0,72,277,349
2020,Egypt,EGY,Slovenia,SVN,0,0,0,146,146
2020,Azerbaijan,AZE,Slovenia,SVN,0,0,5,0,5
2020,Bangladesh,BGD,Slovenia,SVN,0,0,5,143,148
2020,Bosnia and Herzegovina,BIH,Slovenia,SVN,0,0,0,5,5
2020,Cameroon,CMR,Slovenia,SVN,0,0,0,5,5
2020,Cuba,CUB,Slovenia,SVN,0,0,0,5,5
2020,Eritrea,ERI,Slovenia,SVN,5,0,12,20,37
2020,Gambia,GMB,Slovenia,SVN,0,0,5,0,5
2020,Palestinian,PSE,Slovenia,SVN,13,0,5,5,23
2020,India,IND,Slovenia,SVN,0,0,10,12,22
2020,Iran (Islamic Rep. of),IRN,Slovenia,SVN,11,0,35,25,71
2020,Iraq,IRQ,Slovenia,SVN,10,0,53,37,100
2020,Libya,LBY,Slovenia,SVN,0,0,0,13,13
2020,Sri Lanka,LKA,Slovenia,SVN,0,0,24,0,24
2020,Morocco,MAR,Slovenia,SVN,0,0,193,1086,1279
2020,Nepal,NPL,Slovenia,SVN,0,0,0,10,10
2020,Nigeria,NGA,Slovenia,SVN,0,0,5,0,5
2020,Pakistan,PAK,Slovenia,SVN,0,0,57,447,504
2020,Russian Federation,RUS,Slovenia,SVN,0,0,5,5,10
2020,Serbia and Kosovo: S/RES/1244 (1999),SRB,Slovenia,SVN,0,0,10,16,26
2020,Sudan,SDN,Slovenia,SVN,0,0,0,11,11
2020,Syrian Arab Rep.,SYR,Slovenia,SVN,14,0,10,35,59
2020,Togo,TGO,Slovenia,SVN,0,0,0,5,5
2020,Tunisia,TUN,Slovenia,SVN,0,0,12,28,40
2020,Turkey,TUR,Slovenia,SVN,17,0,10,46,73
2020,Ukraine,UKR,Slovenia,SVN,0,0,5,0,5
2020,Yemen,YEM,Slovenia,SVN,0,0,10,0,10
2020,Dem. Rep. of the Congo,COD,Eswatini,SWZ,5,0,0,0,5
2020,Afghanistan,AFG,Sweden,SWE,239,55,334,107,735
2020,Albania,ALB,Sweden,SWE,0,0,242,39,281
2020,Algeria,DZA,Sweden,SWE,5,0,26,39,70
2020,Angola,AGO,Sweden,SWE,0,0,10,5,15
2020,Egypt,EGY,Sweden,SWE,15,0,305,35,355
2020,Argentina,ARG,Sweden,SWE,0,0,5,0,5
2020,Armenia,ARM,Sweden,SWE,0,0,41,13,54
2020,Australia,AUS,Sweden,SWE,0,0,5,0,5
2020,Azerbaijan,AZE,Sweden,SWE,30,5,186,30,251
2020,Burundi,BDI,Sweden,SWE,16,0,39,5,60
2020,Bangladesh,BGD,Sweden,SWE,14,0,209,17,240
2020,Burkina Faso,BFA,Sweden,SWE,0,0,5,0,5
2020,Belarus,BLR,Sweden,SWE,0,0,36,38,74
2020,Bolivia (Plurinational State of),BOL,Sweden,SWE,0,0,11,0,11
2020,Brazil,BRA,Sweden,SWE,0,0,14,0,14
2020,Bosnia and Herzegovina,BIH,Sweden,SWE,0,0,26,5,31
2020,Canada,CAN,Sweden,SWE,0,0,5,0,5
2020,China,CHN,Sweden,SWE,17,0,27,10,54
2020,Chile,CHL,Sweden,SWE,0,0,77,5,82
2020,Cameroon,CMR,Sweden,SWE,28,5,125,16,174
2020,Congo,COG,Sweden,SWE,0,0,14,5,19
2020,Dem. Rep. of the Congo,COD,Sweden,SWE,15,0,49,15,79
2020,Colombia,COL,Sweden,SWE,5,0,271,22,298
2020,Cuba,CUB,Sweden,SWE,0,0,12,10,22
2020,Denmark,DNK,Sweden,SWE,0,0,0,5,5
2020,Djibouti,DJI,Sweden,SWE,5,0,0,14,19
2020,Ecuador,ECU,Sweden,SWE,0,0,10,0,10
2020,Equatorial Guinea,GNQ,Sweden,SWE,0,0,5,0,5
2020,Eritrea,ERI,Sweden,SWE,344,38,147,101,630
2020,Ethiopia,ETH,Sweden,SWE,39,0,238,53,330
2020,Gambia,GMB,Sweden,SWE,5,0,71,41,117
2020,Palestinian,PSE,Sweden,SWE,64,16,360,71,511
2020,Georgia,GEO,Sweden,SWE,0,0,327,74,401
2020,Germany,DEU,Sweden,SWE,0,0,5,0,5
2020,Ghana,GHA,Sweden,SWE,10,0,44,19,73
2020,Greece,GRC,Sweden,SWE,0,0,0,5,5
2020,Guatemala,GTM,Sweden,SWE,0,0,10,0,10
2020,Guinea,GIN,Sweden,SWE,5,0,10,5,20
2020,Honduras,HND,Sweden,SWE,0,0,16,5,21
2020,Cote d'Ivoire,CIV,Sweden,SWE,0,0,5,0,5
2020,India,IND,Sweden,SWE,0,0,96,16,112
2020,Indonesia,IDN,Sweden,SWE,0,0,0,5,5
2020,Iran (Islamic Rep. of),IRN,Sweden,SWE,294,0,591,108,993
2020,Iraq,IRQ,Sweden,SWE,111,45,683,207,1046
2020,Israel,ISR,Sweden,SWE,0,0,10,0,10
2020,Jamaica,JAM,Sweden,SWE,0,0,5,0,5
2020,Jordan,JOR,Sweden,SWE,10,0,114,20,144
2020,Kazakhstan,KAZ,Sweden,SWE,5,0,181,51,237
2020,Kenya,KEN,Sweden,SWE,5,0,22,10,37
2020,Kyrgyzstan,KGZ,Sweden,SWE,5,0,111,23,139
2020,Rep. of Korea,KOR,Sweden,SWE,0,0,5,0,5
2020,Kuwait,KWT,Sweden,SWE,0,0,5,0,5
2020,Liberia,LBR,Sweden,SWE,0,0,10,0,10
2020,Libya,LBY,Sweden,SWE,5,0,18,14,37
2020,Lebanon,LBN,Sweden,SWE,5,5,88,36,134
2020,Sri Lanka,LKA,Sweden,SWE,5,0,32,10,47
2020,North Macedonia,MKD,Sweden,SWE,0,0,76,40,116
2020,Rep. of Moldova,MDA,Sweden,SWE,0,0,5,0,5
2020,Mexico,MEX,Sweden,SWE,0,0,5,0,5
2020,Mali,MLI,Sweden,SWE,0,0,0,5,5
2020,Malaysia,MYS,Sweden,SWE,0,0,5,0,5
2020,Mongolia,MNG,Sweden,SWE,0,0,280,68,348
2020,Morocco,MAR,Sweden,SWE,10,0,96,109,215
2020,Mozambique,MOZ,Sweden,SWE,0,0,12,0,12
2020,Montenegro,MNE,Sweden,SWE,0,0,5,0,5
2020,Myanmar,MMR,Sweden,SWE,0,0,5,0,5
2020,Nepal,NPL,Sweden,SWE,0,0,17,5,22
2020,Netherlands,NLD,Sweden,SWE,0,0,5,5,10
2020,Nicaragua,NIC,Sweden,SWE,29,0,205,5,239
2020,Nigeria,NGA,Sweden,SWE,24,0,203,82,309
2020,Pakistan,PAK,Sweden,SWE,35,0,299,71,405
2020,Peru,PER,Sweden,SWE,0,0,112,13,125
2020,Philippines,PHL,Sweden,SWE,0,0,18,5,23
2020,Poland,POL,Sweden,SWE,0,0,5,0,5
2020,Romania,ROU,Sweden,SWE,0,0,0,5,5
2020,South Africa,ZAF,Sweden,SWE,0,0,12,0,12
2020,Russian Federation,RUS,Sweden,SWE,43,5,165,57,270
2020,Rwanda,RWA,Sweden,SWE,13,0,39,10,62
2020,El Salvador,SLV,Sweden,SWE,12,0,143,5,160
2020,Saudi Arabia,SAU,Sweden,SWE,0,11,0,0,11
2020,Serbia and Kosovo: S/RES/1244 (1999),SRB,Sweden,SWE,0,0,141,82,223
2020,Senegal,SEN,Sweden,SWE,0,0,21,10,31
2020,Sierra Leone,SLE,Sweden,SWE,0,0,0,13,13
2020,Somalia,SOM,Sweden,SWE,112,5,200,135,452
2020,Spain,ESP,Sweden,SWE,0,0,5,0,5
2020,Viet Nam,VNM,Sweden,SWE,0,0,26,10,36
2020,Sudan,SDN,Sweden,SWE,34,0,81,23,138
2020,Syrian Arab Rep.,SYR,Sweden,SWE,347,868,523,274,2012
2020,United Rep. of Tanzania,TZA,Sweden,SWE,10,0,31,10,51
2020,Thailand,THA,Sweden,SWE,0,0,15,0,15
2020,Tajikistan,TJK,Sweden,SWE,5,0,80,10,95
2020,Turkmenistan,TKM,Sweden,SWE,0,0,5,5,10
2020,Tunisia,TUN,Sweden,SWE,0,0,26,28,54
2020,Turkey,TUR,Sweden,SWE,382,0,300,55,737
2020,Uganda,UGA,Sweden,SWE,47,0,63,17,127
2020,Ukraine,UKR,Sweden,SWE,0,0,425,103,528
2020,United States of America,USA,Sweden,SWE,0,0,12,0,12
2020,Uzbekistan,UZB,Sweden,SWE,15,0,1034,167,1216
2020,Venezuela (Bolivarian Republic of),VEN,Sweden,SWE,10,5,133,13,161
2020,Yemen,YEM,Sweden,SWE,39,166,5,24,234
2020,Zambia,ZMB,Sweden,SWE,5,0,0,0,5
2020,Zimbabwe,ZWE,Sweden,SWE,0,0,5,0,5
2020,Stateless,XXA,Sweden,SWE,115,48,283,78,524
2020,Unknown ,,Sweden,SWE,11,5,69,27,112
2020,Afghanistan,AFG,Switzerland,CHE,351,1433,90,248,2122
2020,Albania,ALB,Switzerland,CHE,0,10,46,28,84
2020,Algeria,DZA,Switzerland,CHE,5,10,176,506,697
2020,Angola,AGO,Switzerland,CHE,5,49,27,40,121
2020,Egypt,EGY,Switzerland,CHE,15,0,10,5,30
2020,Armenia,ARM,Switzerland,CHE,0,22,28,11,61
2020,Austria,AUT,Switzerland,CHE,0,0,0,5,5
2020,Azerbaijan,AZE,Switzerland,CHE,63,10,51,0,124
2020,Burundi,BDI,Switzerland,CHE,36,25,5,0,66
2020,Benin,BEN,Switzerland,CHE,0,0,0,11,11
2020,Bangladesh,BGD,Switzerland,CHE,0,0,11,0,11
2020,Burkina Faso,BFA,Switzerland,CHE,0,0,0,5,5
2020,Belarus,BLR,Switzerland,CHE,0,0,15,5,20
2020,Brazil,BRA,Switzerland,CHE,0,0,5,0,5
2020,Bosnia and Herzegovina,BIH,Switzerland,CHE,5,10,10,11,36
2020,Cambodia,KHM,Switzerland,CHE,0,0,5,0,5
2020,Central African Rep.,CAF,Switzerland,CHE,5,0,0,0,5
2020,Chad,TCD,Switzerland,CHE,0,5,0,5,10
2020,China,CHN,Switzerland,CHE,47,135,107,10,299
2020,Chile,CHL,Switzerland,CHE,0,0,5,0,5
2020,Cameroon,CMR,Switzerland,CHE,5,20,28,10,63
2020,Congo,COG,Switzerland,CHE,0,0,5,0,5
2020,Dem. Rep. of the Congo,COD,Switzerland,CHE,10,79,48,17,154
2020,Colombia,COL,Switzerland,CHE,24,11,54,5,94
2020,Djibouti,DJI,Switzerland,CHE,5,0,0,0,5
2020,Eritrea,ERI,Switzerland,CHE,1546,462,252,33,2293
2020,Ethiopia,ETH,Switzerland,CHE,68,104,102,23,297
2020,France,FRA,Switzerland,CHE,0,0,5,0,5
2020,Gambia,GMB,Switzerland,CHE,0,5,10,33,48
2020,United Kingdom of Great Britain and Northern Ireland,GBR,Switzerland,CHE,0,0,5,0,5
2020,Georgia,GEO,Switzerland,CHE,0,31,85,150,266
2020,Germany,DEU,Switzerland,CHE,0,5,0,0,5
2020,Ghana,GHA,Switzerland,CHE,0,0,5,13,18
2020,Guinea-Bissau,GNB,Switzerland,CHE,0,5,0,0,5
2020,Guinea,GIN,Switzerland,CHE,5,5,16,54,80
2020,Honduras,HND,Switzerland,CHE,0,5,0,0,5
2020,Cote d'Ivoire,CIV,Switzerland,CHE,5,17,10,18,50
2020,India,IND,Switzerland,CHE,0,0,14,0,14
2020,Indonesia,IDN,Switzerland,CHE,0,0,5,0,5
2020,Iran (Islamic Rep. of),IRN,Switzerland,CHE,213,168,407,38,826
2020,Iraq,IRQ,Switzerland,CHE,105,275,180,100,660
2020,Israel,ISR,Switzerland,CHE,0,0,0,5,5
2020,Italy,ITA,Switzerland,CHE,0,0,5,0,5
2020,Jamaica,JAM,Switzerland,CHE,5,0,0,5,10
2020,Jordan,JOR,Switzerland,CHE,0,0,5,0,5
2020,Kazakhstan,KAZ,Switzerland,CHE,0,0,5,0,5
2020,Kenya,KEN,Switzerland,CHE,0,5,0,0,5
2020,Kyrgyzstan,KGZ,Switzerland,CHE,0,0,5,0,5
2020,Liberia,LBR,Switzerland,CHE,0,0,0,5,5
2020,Libya,LBY,Switzerland,CHE,5,27,10,51,93
2020,Lebanon,LBN,Switzerland,CHE,0,5,11,10,26
2020,Sri Lanka,LKA,Switzerland,CHE,327,119,577,120,1143
2020,Mauritania,MRT,Switzerland,CHE,0,0,0,5,5
2020,North Macedonia,MKD,Switzerland,CHE,0,0,17,11,28
2020,Rep. of Moldova,MDA,Switzerland,CHE,0,0,45,28,73
2020,Mexico,MEX,Switzerland,CHE,0,0,5,0,5
2020,Mali,MLI,Switzerland,CHE,0,0,0,12,12
2020,Mongolia,MNG,Switzerland,CHE,5,0,10,5,20
2020,Morocco,MAR,Switzerland,CHE,5,11,59,220,295
2020,Montenegro,MNE,Switzerland,CHE,0,5,0,0,5
2020,Myanmar,MMR,Switzerland,CHE,5,0,0,5,10
2020,Nepal,NPL,Switzerland,CHE,5,0,5,0,10
2020,Niger,NER,Switzerland,CHE,0,0,0,5,5
2020,Nicaragua,NIC,Switzerland,CHE,0,0,5,0,5
2020,Nigeria,NGA,Switzerland,CHE,5,34,53,142,234
2020,Pakistan,PAK,Switzerland,CHE,26,29,71,21,147
2020,Russian Federation,RUS,Switzerland,CHE,51,24,41,47,163
2020,Rwanda,RWA,Switzerland,CHE,0,0,5,0,5
2020,El Salvador,SLV,Switzerland,CHE,0,0,20,0,20
2020,Saudi Arabia,SAU,Switzerland,CHE,5,5,0,0,10
2020,Serbia and Kosovo: S/RES/1244 (1999),SRB,Switzerland,CHE,5,40,56,36,137
2020,Senegal,SEN,Switzerland,CHE,0,5,5,13,23
2020,Sierra Leone,SLE,Switzerland,CHE,0,13,0,0,13
2020,Somalia,SOM,Switzerland,CHE,127,193,43,74,437
2020,Viet Nam,VNM,Switzerland,CHE,0,0,0,5,5
2020,Sudan,SDN,Switzerland,CHE,10,5,10,16,41
2020,South Sudan,SSD,Switzerland,CHE,0,11,0,0,11
2020,Syrian Arab Rep.,SYR,Switzerland,CHE,676,854,205,72,1807
2020,Togo,TGO,Switzerland,CHE,10,0,10,0,20
2020,Tunisia,TUN,Switzerland,CHE,5,0,30,88,123
2020,Turkey,TUR,Switzerland,CHE,1524,216,373,86,2199
2020,Uganda,UGA,Switzerland,CHE,0,12,11,0,23
2020,Ukraine,UKR,Switzerland,CHE,5,0,23,15,43
2020,Uzbekistan,UZB,Switzerland,CHE,0,5,0,0,5
2020,Venezuela (Bolivarian Republic of),VEN,Switzerland,CHE,5,15,11,0,31
2020,Western Sahara,ESH,Switzerland,CHE,0,0,0,5,5
2020,Yemen,YEM,Switzerland,CHE,20,12,0,0,32
2020,Zimbabwe,ZWE,Switzerland,CHE,0,0,5,0,5
2020,Stateless,XXA,Switzerland,CHE,5,0,0,0,5
2020,Unknown ,,Switzerland,CHE,64,92,67,63,286
2020,Burundi,BDI,United Rep. of Tanzania,TZA,30,0,0,1497,1527
2020,Dem. Rep. of the Congo,COD,United Rep. of Tanzania,TZA,20,0,0,0,20
2020,South Sudan,SSD,United Rep. of Tanzania,TZA,0,0,0,10,10
2020,Syrian Arab Rep.,SYR,United Rep. of Tanzania,TZA,0,0,0,5,5
2020,Myanmar,MMR,Thailand,THA,15,0,0,0,15
2020,Burkina Faso,BFA,Togo,TGO,0,0,0,5,5
2020,Central African Rep.,CAF,Togo,TGO,5,0,28,0,33
2020,Cameroon,CMR,Togo,TGO,0,0,0,5,5
2020,Congo,COG,Togo,TGO,5,0,5,0,10
2020,Dem. Rep. of the Congo,COD,Togo,TGO,5,0,0,0,5
2020,Cote d'Ivoire,CIV,Togo,TGO,10,0,18,152,180
2020,Lebanon,LBN,Togo,TGO,5,0,0,19,24
2020,Mali,MLI,Togo,TGO,0,0,13,0,13
2020,Nigeria,NGA,Togo,TGO,0,0,0,10,10
2020,Sudan,SDN,Togo,TGO,0,0,0,5,5
2020,Syrian Arab Rep.,SYR,Togo,TGO,11,0,0,0,11
2020,Turkey,TUR,Togo,TGO,10,0,5,0,15
2020,Afghanistan,AFG,Turkey,TUR,3249,0,5348,8432,17029
2020,Iran (Islamic Rep. of),IRN,Turkey,TUR,1231,0,791,3081,5103
2020,Iraq,IRQ,Turkey,TUR,3887,0,4196,12976,21059
2020,Unknown ,,Turkey,TUR,386,0,339,2597,3322
2020,Egypt,EGY,Uganda,UGA,5,0,0,0,5
2020,Burundi,BDI,Uganda,UGA,3624,0,161,462,4247
2020,Dem. Rep. of the Congo,COD,Uganda,UGA,6999,0,288,913,8200
2020,Eritrea,ERI,Uganda,UGA,1838,0,152,189,2179
2020,Ethiopia,ETH,Uganda,UGA,151,0,16,55,222
2020,Pakistan,PAK,Uganda,UGA,0,0,0,19,19
2020,Rwanda,RWA,Uganda,UGA,282,0,126,13,421
2020,Somalia,SOM,Uganda,UGA,4250,0,5,347,4602
2020,Sudan,SDN,Uganda,UGA,58,0,0,0,58
2020,South Sudan,SSD,Uganda,UGA,68,0,0,147,215
2020,Syrian Arab Rep.,SYR,Uganda,UGA,10,0,0,0,10
2020,Turkey,TUR,Uganda,UGA,16,0,0,0,16
2020,Afghanistan,AFG,Ukraine,UKR,10,23,69,36,138
2020,Algeria,DZA,Ukraine,UKR,0,0,0,5,5
2020,Angola,AGO,Ukraine,UKR,0,0,0,5,5
2020,Egypt,EGY,Ukraine,UKR,0,0,0,5,5
2020,Azerbaijan,AZE,Ukraine,UKR,0,0,13,0,13
2020,Bangladesh,BGD,Ukraine,UKR,0,0,5,16,21
2020,Belarus,BLR,Ukraine,UKR,0,0,5,5,10
2020,China,CHN,Ukraine,UKR,0,0,5,0,5
2020,Cameroon,CMR,Ukraine,UKR,0,0,5,19,24
2020,Congo,COG,Ukraine,UKR,0,0,0,5,5
2020,Dem. Rep. of the Congo,COD,Ukraine,UKR,0,0,5,11,16
2020,Eritrea,ERI,Ukraine,UKR,0,0,0,5,5
2020,Gambia,GMB,Ukraine,UKR,0,0,0,5,5
2020,Georgia,GEO,Ukraine,UKR,0,0,5,0,5
2020,Ghana,GHA,Ukraine,UKR,0,0,5,12,17
2020,Guinea,GIN,Ukraine,UKR,0,0,0,11,11
2020,Cote d'Ivoire,CIV,Ukraine,UKR,0,0,0,11,11
2020,India,IND,Ukraine,UKR,0,0,5,5,10
2020,Iran (Islamic Rep. of),IRN,Ukraine,UKR,0,0,5,5,10
2020,Iraq,IRQ,Ukraine,UKR,0,0,13,5,18
2020,Jordan,JOR,Ukraine,UKR,0,0,5,0,5
2020,Kazakhstan,KAZ,Ukraine,UKR,5,0,5,0,10
2020,Kyrgyzstan,KGZ,Ukraine,UKR,5,0,0,0,5
2020,Libya,LBY,Ukraine,UKR,0,5,0,0,5
2020,Lebanon,LBN,Ukraine,UKR,0,0,5,5,10
2020,Sri Lanka,LKA,Ukraine,UKR,0,0,5,0,5
2020,Niger,NER,Ukraine,UKR,0,0,0,5,5
2020,Nigeria,NGA,Ukraine,UKR,0,0,27,55,82
2020,Pakistan,PAK,Ukraine,UKR,0,0,11,0,11
2020,Russian Federation,RUS,Ukraine,UKR,19,23,65,24,131
2020,Senegal,SEN,Ukraine,UKR,0,0,0,5,5
2020,Sierra Leone,SLE,Ukraine,UKR,0,0,0,5,5
2020,Somalia,SOM,Ukraine,UKR,0,5,10,12,27
2020,Sudan,SDN,Ukraine,UKR,0,0,0,11,11
2020,Syrian Arab Rep.,SYR,Ukraine,UKR,0,20,45,10,75
2020,Tajikistan,TJK,Ukraine,UKR,0,5,31,5,41
2020,Turkey,TUR,Ukraine,UKR,0,0,5,0,5
2020,Uzbekistan,UZB,Ukraine,UKR,0,0,5,11,16
2020,Yemen,YEM,Ukraine,UKR,0,0,5,10,15
2020,Stateless,XXA,Ukraine,UKR,0,5,10,0,15
2020,Egypt,EGY,Uruguay,URY,0,0,0,5,5
2020,Bangladesh,BGD,Uruguay,URY,0,0,0,24,24
2020,Brazil,BRA,Uruguay,URY,0,0,0,5,5
2020,Cameroon,CMR,Uruguay,URY,5,0,0,0,5
2020,Colombia,COL,Uruguay,URY,0,0,0,13,13
2020,Cuba,CUB,Uruguay,URY,0,0,17,5506,5523
2020,Dominican Rep.,DOM,Uruguay,URY,0,0,0,37,37
2020,Guinea,GIN,Uruguay,URY,0,0,0,5,5
2020,Haiti,HTI,Uruguay,URY,0,0,0,5,5
2020,Morocco,MAR,Uruguay,URY,0,0,0,12,12
2020,Nicaragua,NIC,Uruguay,URY,0,0,0,5,5
2020,Nigeria,NGA,Uruguay,URY,0,0,0,5,5
2020,Pakistan,PAK,Uruguay,URY,0,0,0,5,5
2020,Russian Federation,RUS,Uruguay,URY,0,0,0,5,5
2020,El Salvador,SLV,Uruguay,URY,5,0,0,0,5
2020,Senegal,SEN,Uruguay,URY,0,0,0,152,152
2020,Syrian Arab Rep.,SYR,Uruguay,URY,0,0,0,5,5
2020,Venezuela (Bolivarian Republic of),VEN,Uruguay,URY,153,0,0,84,237
2020,Yemen,YEM,Uruguay,URY,0,0,0,5,5
2020,Colombia,COL,Venezuela (Bolivarian Republic of),VEN,314,0,49,0,363
2020,Syrian Arab Rep.,SYR,Venezuela (Bolivarian Republic of),VEN,29,0,0,0,29
2020,Burundi,BDI,Zambia,ZMB,615,0,61,1261,1937
2020,Congo,COG,Zambia,ZMB,10,0,0,0,10
2020,Dem. Rep. of the Congo,COD,Zambia,ZMB,4664,0,209,1397,6270
2020,Eritrea,ERI,Zambia,ZMB,10,0,0,13,23
2020,Ethiopia,ETH,Zambia,ZMB,0,0,0,14,14
2020,Rwanda,RWA,Zambia,ZMB,5,0,0,39,44
2020,Sierra Leone,SLE,Zambia,ZMB,0,0,0,5,5
2020,Somalia,SOM,Zambia,ZMB,15,0,0,5,20
2020,South Sudan,SSD,Zambia,ZMB,0,0,0,5,5
2020,Syrian Arab Rep.,SYR,Zambia,ZMB,5,0,0,0,5
2020,Turkey,TUR,Zambia,ZMB,29,0,0,0,29
2020,Uganda,UGA,Zambia,ZMB,58,0,11,0,69
2020,Burundi,BDI,Zimbabwe,ZWE,5,0,0,5,10
2020,Dem. Rep. of the Congo,COD,Zimbabwe,ZWE,198,0,93,127,418
2020,Rwanda,RWA,Zimbabwe,ZWE,0,0,0,5,5
2000,Afghanistan,AFG,United States of America,USA,182,0,51,40,273
2000,Albania,ALB,United States of America,USA,253,0,650,71,974
2000,Algeria,DZA,United States of America,USA,50,0,30,34,114
2000,Angola,AGO,United States of America,USA,31,0,28,5,64
2000,Egypt,EGY,United States of America,USA,294,0,254,65,613
2000,Argentina,ARG,United States of America,USA,0,0,5,5,10
2000,Armenia,ARM,United States of America,USA,794,0,846,96,1736
2000,Azerbaijan,AZE,United States of America,USA,180,0,87,38,305
2000,Burundi,BDI,United States of America,USA,24,0,37,17,78
2000,Bangladesh,BGD,United States of America,USA,54,0,123,169,346
2000,Belarus,BLR,United States of America,USA,50,0,74,5,129
2000,Brazil,BRA,United States of America,USA,15,0,86,239,340
2000,Bosnia and Herzegovina,BIH,United States of America,USA,24,0,20,5,49
2000,Bulgaria,BGR,United States of America,USA,60,0,50,84,194
2000,Cambodia,KHM,United States of America,USA,38,0,82,15,135
2000,China,CHN,United States of America,USA,2522,0,2842,1300,6664
2000,Cameroon,CMR,United States of America,USA,302,0,219,40,561
2000,Congo,COG,United States of America,USA,184,0,128,32,344
2000,Dem. Rep. of the Congo,COD,United States of America,USA,164,0,107,23,294
2000,Colombia,COL,United States of America,USA,1165,0,640,173,1978
2000,Cuba,CUB,United States of America,USA,96,0,39,791,926
2000,Eritrea,ERI,United States of America,USA,168,0,106,5,279
2000,Ethiopia,ETH,United States of America,USA,1259,0,394,231,1884
2000,Fiji,FJI,United States of America,USA,47,0,64,129,240
2000,Gambia,GMB,United States of America,USA,19,0,40,31,90
2000,Georgia,GEO,United States of America,USA,99,0,119,16,234
2000,Ghana,GHA,United States of America,USA,12,0,24,98,134
2000,Guatemala,GTM,United States of America,USA,223,0,1122,2545,3890
2000,Guinea,GIN,United States of America,USA,83,0,133,38,254
2000,Haiti,HTI,United States of America,USA,613,0,2703,983,4299
2000,Honduras,HND,United States of America,USA,13,0,161,269,443
2000,Croatia,HRV,United States of America,USA,27,0,12,12,51
2000,Cote d'Ivoire,CIV,United States of America,USA,14,0,13,45,72
2000,India,IND,United States of America,USA,539,0,628,557,1724
2000,Indonesia,IDN,United States of America,USA,667,0,673,62,1402
2000,Iran (Islamic Rep. of),IRN,United States of America,USA,596,0,305,174,1075
2000,Iraq,IRQ,United States of America,USA,233,0,57,24,314
2000,Jordan,JOR,United States of America,USA,15,0,37,56,108
2000,Kazakhstan,KAZ,United States of America,USA,31,0,31,10,72
2000,Kenya,KEN,United States of America,USA,77,0,39,12,128
2000,Kyrgyzstan,KGZ,United States of America,USA,14,0,21,0,35
2000,Liberia,LBR,United States of America,USA,584,0,429,243,1256
2000,Lebanon,LBN,United States of America,USA,21,0,38,76,135
2000,Sri Lanka,LKA,United States of America,USA,36,0,54,25,115
2000,Mauritania,MRT,United States of America,USA,92,0,367,66,525
2000,North Macedonia,MKD,United States of America,USA,5,0,27,5,37
2000,Mexico,MEX,United States of America,USA,36,0,2779,955,3770
2000,Myanmar,MMR,United States of America,USA,307,0,136,49,492
2000,Nepal,NPL,United States of America,USA,15,0,23,16,54
2000,Niger,NER,United States of America,USA,31,0,23,35,89
2000,Nicaragua,NIC,United States of America,USA,12,0,15,833,860
2000,Nigeria,NGA,United States of America,USA,31,0,72,118,221
2000,Pakistan,PAK,United States of America,USA,215,0,195,308,718
2000,Peru,PER,United States of America,USA,77,0,109,159,345
2000,Philippines,PHL,United States of America,USA,13,0,60,306,379
2000,Romania,ROU,United States of America,USA,34,0,38,222,294
2000,Russian Federation,RUS,United States of America,USA,389,0,454,284,1127
2000,Rwanda,RWA,United States of America,USA,65,0,41,10,116
2000,El Salvador,SLV,United States of America,USA,131,0,1181,7249,8561
2000,Senegal,SEN,United States of America,USA,14,0,29,32,75
2000,Sierra Leone,SLE,United States of America,USA,186,0,227,68,481
2000,Somalia,SOM,United States of America,USA,1689,0,850,261,2800
2000,Viet Nam,VNM,United States of America,USA,12,0,12,12,36
2000,Sudan,SDN,United States of America,USA,429,0,131,36,596
2000,Syrian Arab Rep.,SYR,United States of America,USA,26,0,21,20,67
2000,Togo,TGO,United States of America,USA,58,0,49,14,121
2000,Turkey,TUR,United States of America,USA,40,0,20,24,84
2000,Uganda,UGA,United States of America,USA,99,0,100,19,218
2000,Ukraine,UKR,United States of America,USA,71,0,139,86,296
2000,Uzbekistan,UZB,United States of America,USA,41,0,56,5,102
2000,Yemen,YEM,United States of America,USA,35,0,29,28,92
2000,Stateless,XXA,United States of America,USA,48,0,62,37,147
2000,Unknown ,,United States of America,USA,617,0,751,1437,2805
2001,Afghanistan,AFG,United States of America,USA,212,0,43,19,274
2001,Albania,ALB,United States of America,USA,330,0,899,76,1305
2001,Algeria,DZA,United States of America,USA,30,0,25,10,65
2001,Angola,AGO,United States of America,USA,32,0,32,5,69
2001,Egypt,EGY,United States of America,USA,274,0,261,24,559
2001,Argentina,ARG,United States of America,USA,0,0,14,10,24
2001,Armenia,ARM,United States of America,USA,991,0,1072,115,2178
2001,Azerbaijan,AZE,United States of America,USA,267,0,130,61,458
2001,Burundi,BDI,United States of America,USA,43,0,45,5,93
2001,Benin,BEN,United States of America,USA,0,0,5,0,5
2001,Bangladesh,BGD,United States of America,USA,44,0,66,98,208
2001,Bhutan,BTN,United States of America,USA,15,0,5,0,20
2001,Burkina Faso,BFA,United States of America,USA,5,0,5,0,10
2001,Belarus,BLR,United States of America,USA,59,0,57,11,127
2001,Bolivia (Plurinational State of),BOL,United States of America,USA,0,0,11,0,11
2001,Brazil,BRA,United States of America,USA,26,0,41,65,132
2001,Bosnia and Herzegovina,BIH,United States of America,USA,25,0,30,10,65
2001,Bulgaria,BGR,United States of America,USA,49,0,43,24,116
2001,Belize,BLZ,United States of America,USA,0,0,5,5,10
2001,Cambodia,KHM,United States of America,USA,11,0,37,5,53
2001,Canada,CAN,United States of America,USA,0,0,5,0,5
2001,Central African Rep.,CAF,United States of America,USA,5,0,5,0,10
2001,Chad,TCD,United States of America,USA,11,0,12,0,23
2001,China,CHN,United States of America,USA,4092,0,3359,939,8390
2001,Chile,CHL,United States of America,USA,0,0,0,5,5
2001,Cameroon,CMR,United States of America,USA,290,0,187,24,501
2001,Congo,COG,United States of America,USA,186,0,160,33,379
2001,Dem. Rep. of the Congo,COD,United States of America,USA,118,0,114,15,247
2001,Colombia,COL,United States of America,USA,2625,0,2054,194,4873
2001,Costa Rica,CRI,United States of America,USA,0,0,5,5,10
2001,Cuba,CUB,United States of America,USA,63,0,39,57,159
2001,Cabo Verde,CPV,United States of America,USA,0,0,0,5,5
2001,Ecuador,ECU,United States of America,USA,5,0,20,55,80
2001,Eritrea,ERI,United States of America,USA,123,0,85,5,213
2001,Estonia,EST,United States of America,USA,5,0,11,5,21
2001,Ethiopia,ETH,United States of America,USA,942,0,430,73,1445
2001,Fiji,FJI,United States of America,USA,170,0,262,27,459
2001,France,FRA,United States of America,USA,0,0,0,5,5
2001,Gambia,GMB,United States of America,USA,19,0,18,18,55
2001,United Kingdom of Great Britain and Northern Ireland,GBR,United States of America,USA,0,0,0,5,5
2001,Georgia,GEO,United States of America,USA,81,0,115,17,213
2001,Germany,DEU,United States of America,USA,0,0,5,5,10
2001,Ghana,GHA,United States of America,USA,5,0,16,32,53
2001,Guinea-Bissau,GNB,United States of America,USA,0,0,5,0,5
2001,Greece,GRC,United States of America,USA,0,0,5,0,5
2001,Guatemala,GTM,United States of America,USA,123,0,767,3286,4176
2001,Guinea,GIN,United States of America,USA,144,0,323,66,533
2001,Guyana,GUY,United States of America,USA,0,0,5,39,44
2001,Haiti,HTI,United States of America,USA,899,0,1847,329,3075
2001,"China, Hong Kong SAR",HKG,United States of America,USA,0,0,5,0,5
2001,Honduras,HND,United States of America,USA,10,0,69,68,147
2001,Croatia,HRV,United States of America,USA,10,0,10,5,25
2001,Hungary,HUN,United States of America,USA,5,0,0,5,10
2001,Cote d'Ivoire,CIV,United States of America,USA,36,0,35,20,91
2001,India,IND,United States of America,USA,778,0,707,287,1772
2001,Indonesia,IDN,United States of America,USA,415,0,1021,75,1511
2001,Iran (Islamic Rep. of),IRN,United States of America,USA,622,0,258,65,945
2001,Iraq,IRQ,United States of America,USA,396,0,95,16,507
2001,Israel,ISR,United States of America,USA,10,0,17,5,32
2001,Jamaica,JAM,United States of America,USA,0,0,5,26,31
2001,Jordan,JOR,United States of America,USA,27,0,22,10,59
2001,Kazakhstan,KAZ,United States of America,USA,18,0,32,0,50
2001,Kenya,KEN,United States of America,USA,64,0,39,5,108
2001,Kyrgyzstan,KGZ,United States of America,USA,12,0,40,5,57
2001,Rep. of Korea,KOR,United States of America,USA,0,0,5,5,10
2001,Kuwait,KWT,United States of America,USA,5,0,0,5,10
2001,Lao People's Dem. Rep.,LAO,United States of America,USA,5,0,19,26,50
2001,Liberia,LBR,United States of America,USA,647,0,460,97,1204
2001,Libya,LBY,United States of America,USA,5,0,0,0,5
2001,Lebanon,LBN,United States of America,USA,27,0,33,15,75
2001,Sri Lanka,LKA,United States of America,USA,65,0,58,10,133
2001,Lithuania,LTU,United States of America,USA,5,0,10,5,20
2001,Latvia,LVA,United States of America,USA,5,0,31,5,41
2001,Mauritania,MRT,United States of America,USA,91,0,489,119,699
2001,North Macedonia,MKD,United States of America,USA,22,0,34,12,68
2001,Rep. of Moldova,MDA,United States of America,USA,16,0,15,0,31
2001,Mexico,MEX,United States of America,USA,30,0,6721,1695,8446
2001,Mali,MLI,United States of America,USA,0,0,5,14,19
2001,Malaysia,MYS,United States of America,USA,16,0,10,5,31
2001,Mongolia,MNG,United States of America,USA,5,0,10,5,20
2001,Morocco,MAR,United States of America,USA,5,0,5,0,10
2001,Myanmar,MMR,United States of America,USA,1238,0,189,66,1493
2001,Nepal,NPL,United States of America,USA,16,0,21,5,42
2001,Niger,NER,United States of America,USA,23,0,19,10,52
2001,Nicaragua,NIC,United States of America,USA,15,0,5,43,63
2001,Nigeria,NGA,United States of America,USA,24,0,36,43,103
2001,Pakistan,PAK,United States of America,USA,235,0,145,114,494
2001,Panama,PAN,United States of America,USA,0,0,0,5,5
2001,Peru,PER,United States of America,USA,56,0,110,52,218
2001,Philippines,PHL,United States of America,USA,0,0,45,162,207
2001,Poland,POL,United States of America,USA,0,0,17,46,63
2001,Qatar,QAT,United States of America,USA,5,0,0,0,5
2001,Romania,ROU,United States of America,USA,71,0,57,55,183
2001,South Africa,ZAF,United States of America,USA,0,0,12,0,12
2001,Russian Federation,RUS,United States of America,USA,351,0,334,126,811
2001,Rwanda,RWA,United States of America,USA,45,0,27,5,77
2001,El Salvador,SLV,United States of America,USA,104,0,808,11787,12699
2001,Saudi Arabia,SAU,United States of America,USA,5,0,5,0,10
2001,Senegal,SEN,United States of America,USA,15,0,18,11,44
2001,Singapore,SGP,United States of America,USA,5,0,0,0,5
2001,Sierra Leone,SLE,United States of America,USA,249,0,425,86,760
2001,Somalia,SOM,United States of America,USA,1010,0,443,239,1692
2001,Viet Nam,VNM,United States of America,USA,5,0,5,0,10
2001,Sudan,SDN,United States of America,USA,410,0,160,30,600
2001,Suriname,SUR,United States of America,USA,0,0,0,11,11
2001,Slovakia,SVK,United States of America,USA,0,0,10,5,15
2001,Syrian Arab Rep.,SYR,United States of America,USA,17,0,19,11,47
2001,United Rep. of Tanzania,TZA,United States of America,USA,10,0,14,0,24
2001,Thailand,THA,United States of America,USA,0,0,0,19,19
2001,Tajikistan,TJK,United States of America,USA,5,0,0,0,5
2001,Turkmenistan,TKM,United States of America,USA,10,0,12,0,22
2001,Togo,TGO,United States of America,USA,76,0,57,10,143
2001,Trinidad and Tobago,TTO,United States of America,USA,0,0,0,23,23
2001,Tunisia,TUN,United States of America,USA,5,0,5,0,10
2001,Turkey,TUR,United States of America,USA,60,0,38,19,117
2001,Uganda,UGA,United States of America,USA,110,0,104,10,224
2001,Ukraine,UKR,United States of America,USA,87,0,104,52,243
2001,Uzbekistan,UZB,United States of America,USA,88,0,100,10,198
2001,Venezuela (Bolivarian Republic of),VEN,United States of America,USA,34,0,35,5,74
2001,Yemen,YEM,United States of America,USA,29,0,34,16,79
2001,Zambia,ZMB,United States of America,USA,5,0,0,0,5
2001,Zimbabwe,ZWE,United States of America,USA,23,0,19,5,47
2001,Stateless,XXA,United States of America,USA,79,0,84,25,188
2001,Unknown ,,United States of America,USA,271,0,456,195,922
2002,Afghanistan,AFG,United States of America,USA,123,0,72,23,218
2002,Albania,ALB,United States of America,USA,257,0,898,116,1271
2002,Algeria,DZA,United States of America,USA,17,0,33,24,74
2002,Angola,AGO,United States of America,USA,26,0,21,5,52
2002,Egypt,EGY,United States of America,USA,248,0,351,20,619
2002,Argentina,ARG,United States of America,USA,5,0,40,51,96
2002,Armenia,ARM,United States of America,USA,695,0,959,122,1776
2002,Azerbaijan,AZE,United States of America,USA,198,0,119,105,422
2002,Burundi,BDI,United States of America,USA,54,0,35,5,94
2002,Benin,BEN,United States of America,USA,5,0,5,0,10
2002,Bangladesh,BGD,United States of America,USA,60,0,86,322,468
2002,Bhutan,BTN,United States of America,USA,10,0,0,0,10
2002,Burkina Faso,BFA,United States of America,USA,5,0,13,0,18
2002,Belarus,BLR,United States of America,USA,54,0,95,12,161
2002,Bolivia (Plurinational State of),BOL,United States of America,USA,0,0,12,5,17
2002,Brazil,BRA,United States of America,USA,29,0,67,135,231
2002,Bosnia and Herzegovina,BIH,United States of America,USA,20,0,28,5,53
2002,Bulgaria,BGR,United States of America,USA,49,0,41,25,115
2002,Belize,BLZ,United States of America,USA,0,0,5,0,5
2002,Cambodia,KHM,United States of America,USA,37,0,151,13,201
2002,Canada,CAN,United States of America,USA,0,0,5,0,5
2002,Central African Rep.,CAF,United States of America,USA,22,0,28,5,55
2002,Chad,TCD,United States of America,USA,10,0,10,0,20
2002,China,CHN,United States of America,USA,5045,0,4652,1167,10864
2002,Chile,CHL,United States of America,USA,5,0,14,5,24
2002,Cameroon,CMR,United States of America,USA,668,0,415,47,1130
2002,Congo,COG,United States of America,USA,193,0,215,37,445
2002,Dem. Rep. of the Congo,COD,United States of America,USA,175,0,196,25,396
2002,Colombia,COL,United States of America,USA,2532,0,4246,459,7237
2002,Costa Rica,CRI,United States of America,USA,0,0,5,5,10
2002,Cuba,CUB,United States of America,USA,47,0,27,684,758
2002,Czechia,CZE,United States of America,USA,0,0,5,0,5
2002,Dominican Rep.,DOM,United States of America,USA,0,0,5,17,22
2002,Ecuador,ECU,United States of America,USA,10,0,31,149,190
2002,Eritrea,ERI,United States of America,USA,142,0,97,12,251
2002,Estonia,EST,United States of America,USA,5,0,26,0,31
2002,Ethiopia,ETH,United States of America,USA,927,0,430,91,1448
2002,Fiji,FJI,United States of America,USA,102,0,153,49,304
2002,France,FRA,United States of America,USA,0,0,5,5,10
2002,Gambia,GMB,United States of America,USA,16,0,19,11,46
2002,United Kingdom of Great Britain and Northern Ireland,GBR,United States of America,USA,0,0,5,0,5
2002,Georgia,GEO,United States of America,USA,53,0,97,18,168
2002,Germany,DEU,United States of America,USA,0,0,5,0,5
2002,Ghana,GHA,United States of America,USA,5,0,12,26,43
2002,Guinea-Bissau,GNB,United States of America,USA,0,0,5,0,5
2002,Guatemala,GTM,United States of America,USA,132,0,682,4414,5228
2002,Guinea,GIN,United States of America,USA,158,0,502,95,755
2002,Guyana,GUY,United States of America,USA,0,0,10,51,61
2002,Haiti,HTI,United States of America,USA,703,0,1863,1621,4187
2002,"China, Hong Kong SAR",HKG,United States of America,USA,0,0,5,0,5
2002,Honduras,HND,United States of America,USA,15,0,67,98,180
2002,Croatia,HRV,United States of America,USA,5,0,10,5,20
2002,Hungary,HUN,United States of America,USA,0,0,5,11,16
2002,Cote d'Ivoire,CIV,United States of America,USA,19,0,40,14,73
2002,India,IND,United States of America,USA,942,0,988,504,2434
2002,Indonesia,IDN,United States of America,USA,341,0,1126,95,1562
2002,Iran (Islamic Rep. of),IRN,United States of America,USA,537,0,335,130,1002
2002,Iraq,IRQ,United States of America,USA,344,0,157,142,643
2002,Israel,ISR,United States of America,USA,5,0,15,15,35
2002,Italy,ITA,United States of America,USA,0,0,0,5,5
2002,Jamaica,JAM,United States of America,USA,0,0,11,27,38
2002,Jordan,JOR,United States of America,USA,32,0,58,22,112
2002,Kazakhstan,KAZ,United States of America,USA,19,0,26,0,45
2002,Kenya,KEN,United States of America,USA,153,0,121,15,289
2002,Kyrgyzstan,KGZ,United States of America,USA,17,0,39,5,61
2002,Rep. of Korea,KOR,United States of America,USA,0,0,5,0,5
2002,Kuwait,KWT,United States of America,USA,5,0,5,5,15
2002,Lao People's Dem. Rep.,LAO,United States of America,USA,5,0,19,32,56
2002,Liberia,LBR,United States of America,USA,523,0,431,72,1026
2002,Libya,LBY,United States of America,USA,5,0,0,0,5
2002,Lebanon,LBN,United States of America,USA,28,0,46,22,96
2002,Sri Lanka,LKA,United States of America,USA,48,0,99,16,163
2002,Lithuania,LTU,United States of America,USA,10,0,51,5,66
2002,Latvia,LVA,United States of America,USA,5,0,24,10,39
2002,Mauritania,MRT,United States of America,USA,87,0,489,85,661
2002,North Macedonia,MKD,United States of America,USA,18,0,69,24,111
2002,Rep. of Moldova,MDA,United States of America,USA,10,0,28,5,43
2002,Mexico,MEX,United States of America,USA,31,0,8041,1413,9485
2002,Mali,MLI,United States of America,USA,10,0,12,21,43
2002,Malaysia,MYS,United States of America,USA,26,0,10,5,41
2002,Malawi,MWI,United States of America,USA,5,0,5,0,10
2002,Mongolia,MNG,United States of America,USA,0,0,10,0,10
2002,Morocco,MAR,United States of America,USA,5,0,11,0,16
2002,Mauritius,MUS,United States of America,USA,0,0,5,0,5
2002,Myanmar,MMR,United States of America,USA,310,0,218,91,619
2002,Nepal,NPL,United States of America,USA,56,0,68,13,137
2002,Niger,NER,United States of America,USA,18,0,36,12,66
2002,Nicaragua,NIC,United States of America,USA,10,0,15,3399,3424
2002,Nigeria,NGA,United States of America,USA,20,0,43,50,113
2002,Pakistan,PAK,United States of America,USA,291,0,234,234,759
2002,Panama,PAN,United States of America,USA,0,0,5,0,5
2002,Paraguay,PRY,United States of America,USA,0,0,5,0,5
2002,Peru,PER,United States of America,USA,52,0,139,57,248
2002,Philippines,PHL,United States of America,USA,15,0,54,123,192
2002,Poland,POL,United States of America,USA,0,0,11,63,74
2002,Romania,ROU,United States of America,USA,112,0,124,76,312
2002,South Africa,ZAF,United States of America,USA,5,0,27,5,37
2002,Russian Federation,RUS,United States of America,USA,294,0,411,114,819
2002,Rwanda,RWA,United States of America,USA,38,0,33,0,71
2002,El Salvador,SLV,United States of America,USA,66,0,674,13110,13850
2002,Saudi Arabia,SAU,United States of America,USA,5,0,0,0,5
2002,Senegal,SEN,United States of America,USA,15,0,28,21,64
2002,Sierra Leone,SLE,United States of America,USA,157,0,364,60,581
2002,Somalia,SOM,United States of America,USA,369,0,369,199,937
2002,Viet Nam,VNM,United States of America,USA,11,0,13,5,29
2002,Sudan,SDN,United States of America,USA,360,0,208,23,591
2002,Suriname,SUR,United States of America,USA,0,0,5,10,15
2002,Slovakia,SVK,United States of America,USA,0,0,5,0,5
2002,Syrian Arab Rep.,SYR,United States of America,USA,20,0,29,10,59
2002,United Rep. of Tanzania,TZA,United States of America,USA,12,0,17,0,29
2002,Thailand,THA,United States of America,USA,0,0,5,12,17
2002,Tajikistan,TJK,United States of America,USA,5,0,10,5,20
2002,Turkmenistan,TKM,United States of America,USA,11,0,5,0,16
2002,Togo,TGO,United States of America,USA,181,0,131,5,317
2002,Tonga,TON,United States of America,USA,0,0,5,0,5
2002,Trinidad and Tobago,TTO,United States of America,USA,0,0,5,38,43
2002,Tunisia,TUN,United States of America,USA,0,0,5,0,5
2002,Turkey,TUR,United States of America,USA,58,0,46,22,126
2002,Uganda,UGA,United States of America,USA,136,0,143,16,295
2002,Ukraine,UKR,United States of America,USA,78,0,150,43,271
2002,Uruguay,URY,United States of America,USA,0,0,0,5,5
2002,Uzbekistan,UZB,United States of America,USA,94,0,152,14,260
2002,Venezuela (Bolivarian Republic of),VEN,United States of America,USA,48,0,100,10,158
2002,Yemen,YEM,United States of America,USA,22,0,31,16,69
2002,Zambia,ZMB,United States of America,USA,5,0,20,5,30
2002,Zimbabwe,ZWE,United States of America,USA,52,0,82,5,139
2002,Stateless,XXA,United States of America,USA,102,0,129,36,267
2002,Unknown ,,United States of America,USA,100,0,447,138,685
2003,Afghanistan,AFG,United States of America,USA,18,0,29,42,89
2003,Albania,ALB,United States of America,USA,177,0,672,99,948
2003,Algeria,DZA,United States of America,USA,15,0,21,27,63
2003,Angola,AGO,United States of America,USA,11,0,26,5,42
2003,Egypt,EGY,United States of America,USA,152,0,274,27,453
2003,Argentina,ARG,United States of America,USA,10,0,112,234,356
2003,Armenia,ARM,United States of America,USA,374,0,570,100,1044
2003,Azerbaijan,AZE,United States of America,USA,64,0,73,74,211
2003,Burundi,BDI,United States of America,USA,26,0,39,0,65
2003,Benin,BEN,United States of America,USA,0,0,5,0,5
2003,Bangladesh,BGD,United States of America,USA,43,0,124,129,296
2003,Bhutan,BTN,United States of America,USA,5,0,5,0,10
2003,Burkina Faso,BFA,United States of America,USA,5,0,20,5,30
2003,Belarus,BLR,United States of America,USA,95,0,134,16,245
2003,Bolivia (Plurinational State of),BOL,United States of America,USA,10,0,11,5,26
2003,Brazil,BRA,United States of America,USA,24,0,76,48,148
2003,Bosnia and Herzegovina,BIH,United States of America,USA,10,0,24,5,39
2003,Bulgaria,BGR,United States of America,USA,39,0,43,79,161
2003,Belize,BLZ,United States of America,USA,0,0,5,0,5
2003,Cambodia,KHM,United States of America,USA,20,0,104,24,148
2003,Canada,CAN,United States of America,USA,0,0,0,5,5
2003,Central African Rep.,CAF,United States of America,USA,23,0,55,12,90
2003,Chad,TCD,United States of America,USA,25,0,18,0,43
2003,China,CHN,United States of America,USA,2037,0,3600,767,6404
2003,Chile,CHL,United States of America,USA,5,0,5,5,15
2003,Cameroon,CMR,United States of America,USA,778,0,780,57,1615
2003,Congo,COG,United States of America,USA,103,0,167,29,299
2003,Dem. Rep. of the Congo,COD,United States of America,USA,73,0,159,22,254
2003,Colombia,COL,United States of America,USA,1661,0,2935,278,4874
2003,Costa Rica,CRI,United States of America,USA,0,0,5,0,5
2003,Cuba,CUB,United States of America,USA,33,0,30,425,488
2003,Czechia,CZE,United States of America,USA,0,0,5,0,5
2003,Dominican Rep.,DOM,United States of America,USA,0,0,0,5,5
2003,Ecuador,ECU,United States of America,USA,0,0,23,43,66
2003,Eritrea,ERI,United States of America,USA,113,0,91,12,216
2003,Estonia,EST,United States of America,USA,5,0,39,10,54
2003,Ethiopia,ETH,United States of America,USA,515,0,361,143,1019
2003,Fiji,FJI,United States of America,USA,28,0,143,277,448
2003,France,FRA,United States of America,USA,0,0,13,18,31
2003,Gabon,GAB,United States of America,USA,5,0,5,0,10
2003,Gambia,GMB,United States of America,USA,27,0,47,23,97
2003,United Kingdom of Great Britain and Northern Ireland,GBR,United States of America,USA,0,0,5,5,10
2003,Georgia,GEO,United States of America,USA,39,0,107,26,172
2003,Germany,DEU,United States of America,USA,0,0,5,0,5
2003,Ghana,GHA,United States of America,USA,0,0,17,23,40
2003,Guinea-Bissau,GNB,United States of America,USA,0,0,5,0,5
2003,Greece,GRC,United States of America,USA,5,0,0,0,5
2003,Guatemala,GTM,United States of America,USA,120,0,1258,9120,10498
2003,Guinea,GIN,United States of America,USA,109,0,527,63,699
2003,Guyana,GUY,United States of America,USA,5,0,12,18,35
2003,Haiti,HTI,United States of America,USA,897,0,1874,4675,7446
2003,Honduras,HND,United States of America,USA,10,0,73,104,187
2003,Croatia,HRV,United States of America,USA,0,0,10,5,15
2003,Hungary,HUN,United States of America,USA,0,0,5,27,32
2003,Cote d'Ivoire,CIV,United States of America,USA,106,0,228,40,374
2003,India,IND,United States of America,USA,283,0,541,787,1611
2003,Indonesia,IDN,United States of America,USA,150,0,2079,250,2479
2003,Iran (Islamic Rep. of),IRN,United States of America,USA,251,0,272,216,739
2003,Iraq,IRQ,United States of America,USA,201,0,180,40,421
2003,Israel,ISR,United States of America,USA,5,0,18,14,37
2003,Italy,ITA,United States of America,USA,0,0,0,5,5
2003,Jamaica,JAM,United States of America,USA,0,0,10,10,20
2003,Jordan,JOR,United States of America,USA,16,0,65,59,140
2003,Japan,JPN,United States of America,USA,0,0,5,0,5
2003,Kazakhstan,KAZ,United States of America,USA,14,0,33,5,52
2003,Kenya,KEN,United States of America,USA,178,0,185,23,386
2003,Kyrgyzstan,KGZ,United States of America,USA,15,0,30,0,45
2003,Rep. of Korea,KOR,United States of America,USA,0,0,0,5,5
2003,Kuwait,KWT,United States of America,USA,5,0,5,17,27
2003,Lao People's Dem. Rep.,LAO,United States of America,USA,14,0,50,421,485
2003,Liberia,LBR,United States of America,USA,299,0,247,117,663
2003,Libya,LBY,United States of America,USA,0,0,0,5,5
2003,Lebanon,LBN,United States of America,USA,25,0,49,56,130
2003,Sri Lanka,LKA,United States of America,USA,11,0,51,15,77
2003,Lithuania,LTU,United States of America,USA,5,0,33,5,43
2003,Latvia,LVA,United States of America,USA,10,0,30,10,50
2003,Madagascar,MDG,United States of America,USA,0,0,5,0,5
2003,Mauritania,MRT,United States of America,USA,58,0,856,414,1328
2003,North Macedonia,MKD,United States of America,USA,5,0,42,10,57
2003,Rep. of Moldova,MDA,United States of America,USA,12,0,23,5,40
2003,Mexico,MEX,United States of America,USA,30,0,3422,786,4238
2003,Mali,MLI,United States of America,USA,10,0,24,15,49
2003,Malaysia,MYS,United States of America,USA,16,0,10,5,31
2003,Malawi,MWI,United States of America,USA,0,0,5,0,5
2003,Mongolia,MNG,United States of America,USA,13,0,21,0,34
2003,Morocco,MAR,United States of America,USA,5,0,5,5,15
2003,Mauritius,MUS,United States of America,USA,0,0,0,5,5
2003,Myanmar,MMR,United States of America,USA,184,0,166,84,434
2003,Nepal,NPL,United States of America,USA,111,0,162,16,289
2003,Niger,NER,United States of America,USA,25,0,49,19,93
2003,Nicaragua,NIC,United States of America,USA,10,0,24,3088,3122
2003,Nigeria,NGA,United States of America,USA,25,0,69,37,131
2003,Pakistan,PAK,United States of America,USA,169,0,286,187,642
2003,Panama,PAN,United States of America,USA,0,0,5,5,10
2003,Paraguay,PRY,United States of America,USA,0,0,5,0,5
2003,Peru,PER,United States of America,USA,49,0,157,83,289
2003,Philippines,PHL,United States of America,USA,10,0,146,380,536
2003,Poland,POL,United States of America,USA,0,0,34,68,102
2003,Portugal,PRT,United States of America,USA,0,0,5,5,10
2003,Romania,ROU,United States of America,USA,89,0,76,265,430
2003,South Africa,ZAF,United States of America,USA,5,0,38,13,56
2003,Russian Federation,RUS,United States of America,USA,224,0,447,230,901
2003,Rwanda,RWA,United States of America,USA,33,0,35,5,73
2003,El Salvador,SLV,United States of America,USA,63,0,749,22953,23765
2003,Saudi Arabia,SAU,United States of America,USA,5,0,0,5,10
2003,Senegal,SEN,United States of America,USA,13,0,67,12,92
2003,Sierra Leone,SLE,United States of America,USA,47,0,198,51,296
2003,Somalia,SOM,United States of America,USA,106,0,128,117,351
2003,Spain,ESP,United States of America,USA,0,0,5,0,5
2003,Viet Nam,VNM,United States of America,USA,5,0,5,5,15
2003,Sudan,SDN,United States of America,USA,94,0,91,25,210
2003,Suriname,SUR,United States of America,USA,0,0,0,10,10
2003,Slovakia,SVK,United States of America,USA,0,0,5,0,5
2003,Syrian Arab Rep.,SYR,United States of America,USA,10,0,35,16,61
2003,United Rep. of Tanzania,TZA,United States of America,USA,5,0,32,0,37
2003,Thailand,THA,United States of America,USA,0,0,5,32,37
2003,Tajikistan,TJK,United States of America,USA,5,0,5,0,10
2003,Turkmenistan,TKM,United States of America,USA,12,0,11,0,23
2003,Togo,TGO,United States of America,USA,278,0,263,17,558
2003,Trinidad and Tobago,TTO,United States of America,USA,0,0,5,13,18
2003,Tunisia,TUN,United States of America,USA,0,0,5,0,5
2003,Turkey,TUR,United States of America,USA,24,0,21,17,62
2003,Uganda,UGA,United States of America,USA,67,0,96,10,173
2003,Ukraine,UKR,United States of America,USA,52,0,128,73,253
2003,Uruguay,URY,United States of America,USA,0,0,14,29,43
2003,Uzbekistan,UZB,United States of America,USA,64,0,189,28,281
2003,Venezuela (Bolivarian Republic of),VEN,United States of America,USA,168,0,327,30,525
2003,Yemen,YEM,United States of America,USA,5,0,24,17,46
2003,Zambia,ZMB,United States of America,USA,5,0,17,0,22
2003,Zimbabwe,ZWE,United States of America,USA,115,0,160,10,285
2003,Stateless,XXA,United States of America,USA,56,0,98,21,175
2003,Unknown ,,United States of America,USA,57,0,572,277,906
2004,Afghanistan,AFG,United States of America,USA,26,0,21,11,58
2004,Albania,ALB,United States of America,USA,129,0,418,88,635
2004,Algeria,DZA,United States of America,USA,13,0,18,5,36
2004,Angola,AGO,United States of America,USA,5,0,16,5,26
2004,Egypt,EGY,United States of America,USA,101,0,143,27,271
2004,Argentina,ARG,United States of America,USA,5,0,27,366,398
2004,Armenia,ARM,United States of America,USA,203,0,471,75,749
2004,Azerbaijan,AZE,United States of America,USA,60,0,54,27,141
2004,Burundi,BDI,United States of America,USA,20,0,39,12,71
2004,Benin,BEN,United States of America,USA,5,0,5,0,10
2004,Bangladesh,BGD,United States of America,USA,31,0,63,66,160
2004,Bhutan,BTN,United States of America,USA,5,0,0,0,5
2004,Burkina Faso,BFA,United States of America,USA,5,0,10,5,20
2004,Belarus,BLR,United States of America,USA,123,0,268,17,408
2004,Bolivia (Plurinational State of),BOL,United States of America,USA,5,0,0,5,10
2004,Brazil,BRA,United States of America,USA,23,0,50,778,851
2004,Bosnia and Herzegovina,BIH,United States of America,USA,10,0,12,5,27
2004,Bulgaria,BGR,United States of America,USA,32,0,73,37,142
2004,Cambodia,KHM,United States of America,USA,36,0,91,11,138
2004,Canada,CAN,United States of America,USA,0,0,0,5,5
2004,Central African Rep.,CAF,United States of America,USA,10,0,28,5,43
2004,Chad,TCD,United States of America,USA,18,0,30,0,48
2004,China,CHN,United States of America,USA,748,0,2203,563,3514
2004,Chile,CHL,United States of America,USA,10,0,5,5,20
2004,Cameroon,CMR,United States of America,USA,558,0,764,51,1373
2004,Congo,COG,United States of America,USA,75,0,116,33,224
2004,Dem. Rep. of the Congo,COD,United States of America,USA,61,0,95,28,184
2004,Colombia,COL,United States of America,USA,1555,0,1934,524,4013
2004,Costa Rica,CRI,United States of America,USA,0,0,0,5,5
2004,Cuba,CUB,United States of America,USA,28,0,23,139,190
2004,Dominican Rep.,DOM,United States of America,USA,0,0,5,10,15
2004,Ecuador,ECU,United States of America,USA,5,0,32,38,75
2004,Eritrea,ERI,United States of America,USA,107,0,73,5,185
2004,Estonia,EST,United States of America,USA,5,0,33,10,48
2004,Ethiopia,ETH,United States of America,USA,657,0,449,89,1195
2004,Fiji,FJI,United States of America,USA,27,0,44,73,144
2004,France,FRA,United States of America,USA,5,0,5,16,26
2004,Gabon,GAB,United States of America,USA,5,0,5,0,10
2004,Gambia,GMB,United States of America,USA,25,0,98,27,150
2004,United Kingdom of Great Britain and Northern Ireland,GBR,United States of America,USA,0,0,5,5,10
2004,Georgia,GEO,United States of America,USA,49,0,102,23,174
2004,Germany,DEU,United States of America,USA,0,0,0,5,5
2004,Ghana,GHA,United States of America,USA,11,0,22,11,44
2004,Guinea-Bissau,GNB,United States of America,USA,5,0,11,5,21
2004,Guatemala,GTM,United States of America,USA,171,0,1363,29990,31524
2004,Guinea,GIN,United States of America,USA,136,0,515,64,715
2004,Guyana,GUY,United States of America,USA,0,0,14,18,32
2004,Haiti,HTI,United States of America,USA,1414,0,2663,2681,6758
2004,Honduras,HND,United States of America,USA,5,0,54,96,155
2004,Croatia,HRV,United States of America,USA,0,0,5,5,10
2004,Hungary,HUN,United States of America,USA,0,0,5,19,24
2004,Cote d'Ivoire,CIV,United States of America,USA,77,0,266,39,382
2004,India,IND,United States of America,USA,132,0,303,409,844
2004,Indonesia,IDN,United States of America,USA,64,0,602,146,812
2004,Iran (Islamic Rep. of),IRN,United States of America,USA,141,0,118,95,354
2004,Iraq,IRQ,United States of America,USA,103,0,93,10,206
2004,Israel,ISR,United States of America,USA,0,0,26,5,31
2004,Italy,ITA,United States of America,USA,0,0,0,12,12
2004,Jamaica,JAM,United States of America,USA,0,0,85,17,102
2004,Jordan,JOR,United States of America,USA,14,0,38,22,74
2004,Kazakhstan,KAZ,United States of America,USA,18,0,37,5,60
2004,Kenya,KEN,United States of America,USA,126,0,180,46,352
2004,Kyrgyzstan,KGZ,United States of America,USA,15,0,26,5,46
2004,Rep. of Korea,KOR,United States of America,USA,0,0,0,5,5
2004,Kuwait,KWT,United States of America,USA,5,0,5,5,15
2004,Lao People's Dem. Rep.,LAO,United States of America,USA,20,0,21,142,183
2004,Liberia,LBR,United States of America,USA,256,0,294,85,635
2004,Libya,LBY,United States of America,USA,5,0,5,5,15
2004,Saint Lucia,LCA,United States of America,USA,0,0,5,0,5
2004,Lebanon,LBN,United States of America,USA,20,0,43,29,92
2004,Sri Lanka,LKA,United States of America,USA,13,0,60,14,87
2004,Lithuania,LTU,United States of America,USA,5,0,26,5,36
2004,Latvia,LVA,United States of America,USA,5,0,21,5,31
2004,Mauritania,MRT,United States of America,USA,60,0,461,159,680
2004,North Macedonia,MKD,United States of America,USA,5,0,27,5,37
2004,Rep. of Moldova,MDA,United States of America,USA,10,0,17,5,32
2004,Mexico,MEX,United States of America,USA,36,0,1239,699,1974
2004,Mali,MLI,United States of America,USA,13,0,30,15,58
2004,Malaysia,MYS,United States of America,USA,10,0,15,5,30
2004,Mongolia,MNG,United States of America,USA,26,0,36,0,62
2004,Morocco,MAR,United States of America,USA,0,0,10,0,10
2004,Myanmar,MMR,United States of America,USA,156,0,116,57,329
2004,Nepal,NPL,United States of America,USA,115,0,160,10,285
2004,Netherlands,NLD,United States of America,USA,0,0,0,5,5
2004,Niger,NER,United States of America,USA,19,0,42,15,76
2004,Nicaragua,NIC,United States of America,USA,5,0,23,596,624
2004,Nigeria,NGA,United States of America,USA,26,0,71,27,124
2004,Pakistan,PAK,United States of America,USA,124,0,122,88,334
2004,Panama,PAN,United States of America,USA,0,0,0,5,5
2004,Peru,PER,United States of America,USA,62,0,125,44,231
2004,Philippines,PHL,United States of America,USA,12,0,56,95,163
2004,Poland,POL,United States of America,USA,0,0,66,41,107
2004,Portugal,PRT,United States of America,USA,0,0,0,5,5
2004,Romania,ROU,United States of America,USA,47,0,75,76,198
2004,South Africa,ZAF,United States of America,USA,5,0,19,10,34
2004,Russian Federation,RUS,United States of America,USA,201,0,454,147,802
2004,Rwanda,RWA,United States of America,USA,28,0,29,5,62
2004,El Salvador,SLV,United States of America,USA,93,0,934,37086,38113
2004,Saudi Arabia,SAU,United States of America,USA,0,0,5,0,5
2004,Serbia and Kosovo: S/RES/1244 (1999),SRB,United States of America,USA,5,0,19,0,24
2004,Senegal,SEN,United States of America,USA,15,0,57,15,87
2004,Singapore,SGP,United States of America,USA,5,0,0,0,5
2004,Sierra Leone,SLE,United States of America,USA,51,0,154,89,294
2004,Somalia,SOM,United States of America,USA,119,0,126,106,351
2004,Viet Nam,VNM,United States of America,USA,5,0,13,0,18
2004,Sudan,SDN,United States of America,USA,64,0,57,10,131
2004,Suriname,SUR,United States of America,USA,0,0,0,5,5
2004,Slovakia,SVK,United States of America,USA,0,0,5,0,5
2004,Slovenia,SVN,United States of America,USA,0,0,0,5,5
2004,Syrian Arab Rep.,SYR,United States of America,USA,13,0,23,5,41
2004,United Rep. of Tanzania,TZA,United States of America,USA,10,0,37,5,52
2004,Thailand,THA,United States of America,USA,0,0,5,17,22
2004,Tajikistan,TJK,United States of America,USA,5,0,10,0,15
2004,Turkmenistan,TKM,United States of America,USA,19,0,25,0,44
2004,Togo,TGO,United States of America,USA,304,0,310,20,634
2004,Tonga,TON,United States of America,USA,0,0,0,5,5
2004,Trinidad and Tobago,TTO,United States of America,USA,5,0,10,11,26
2004,Tunisia,TUN,United States of America,USA,0,0,0,5,5
2004,Turkey,TUR,United States of America,USA,20,0,24,10,54
2004,Uganda,UGA,United States of America,USA,59,0,70,15,144
2004,Ukraine,UKR,United States of America,USA,36,0,119,45,200
2004,Uruguay,URY,United States of America,USA,0,0,5,30,35
2004,Uzbekistan,UZB,United States of America,USA,91,0,180,18,289
2004,Venezuela (Bolivarian Republic of),VEN,United States of America,USA,611,0,740,55,1406
2004,Yemen,YEM,United States of America,USA,5,0,5,10,20
2004,Zambia,ZMB,United States of America,USA,5,0,30,0,35
2004,Zimbabwe,ZWE,United States of America,USA,140,0,219,13,372
2004,Stateless,XXA,United States of America,USA,48,0,83,20,151
2004,Unknown ,,United States of America,USA,41,0,428,104,573
2005,Afghanistan,AFG,United States of America,USA,10,0,10,10,30
2005,Albania,ALB,United States of America,USA,51,0,261,81,393
2005,Algeria,DZA,United States of America,USA,5,0,10,10,25
2005,Angola,AGO,United States of America,USA,5,0,10,5,20
2005,Egypt,EGY,United States of America,USA,85,0,180,26,291
2005,Argentina,ARG,United States of America,USA,0,0,5,50,55
2005,Armenia,ARM,United States of America,USA,127,0,357,34,518
2005,Azerbaijan,AZE,United States of America,USA,29,0,31,25,85
2005,Burundi,BDI,United States of America,USA,15,0,19,0,34
2005,Benin,BEN,United States of America,USA,0,0,5,0,5
2005,Bangladesh,BGD,United States of America,USA,23,0,46,62,131
2005,Bahamas,BHS,United States of America,USA,0,0,5,0,5
2005,Burkina Faso,BFA,United States of America,USA,10,0,43,0,53
2005,Belarus,BLR,United States of America,USA,98,0,228,15,341
2005,Bolivia (Plurinational State of),BOL,United States of America,USA,5,0,5,5,15
2005,Brazil,BRA,United States of America,USA,21,0,37,32,90
2005,Bosnia and Herzegovina,BIH,United States of America,USA,15,0,14,0,29
2005,Bulgaria,BGR,United States of America,USA,32,0,54,33,119
2005,Cambodia,KHM,United States of America,USA,23,0,60,5,88
2005,Canada,CAN,United States of America,USA,0,0,5,0,5
2005,Central African Rep.,CAF,United States of America,USA,11,0,27,5,43
2005,Chad,TCD,United States of America,USA,11,0,31,5,47
2005,China,CHN,United States of America,USA,1751,0,2540,439,4730
2005,Chile,CHL,United States of America,USA,5,0,5,5,15
2005,Cameroon,CMR,United States of America,USA,344,0,391,38,773
2005,Congo,COG,United States of America,USA,44,0,95,40,179
2005,Dem. Rep. of the Congo,COD,United States of America,USA,46,0,72,10,128
2005,Colombia,COL,United States of America,USA,1122,0,1337,479,2938
2005,Costa Rica,CRI,United States of America,USA,0,0,0,5,5
2005,Cuba,CUB,United States of America,USA,69,0,21,510,600
2005,Cabo Verde,CPV,United States of America,USA,0,0,0,5,5
2005,Czechia,CZE,United States of America,USA,0,0,13,11,24
2005,Dominican Rep.,DOM,United States of America,USA,0,0,5,0,5
2005,Ecuador,ECU,United States of America,USA,5,0,18,42,65
2005,Eritrea,ERI,United States of America,USA,116,0,62,5,183
2005,Estonia,EST,United States of America,USA,5,0,25,5,35
2005,Ethiopia,ETH,United States of America,USA,398,0,291,70,759
2005,Fiji,FJI,United States of America,USA,12,0,19,21,52
2005,France,FRA,United States of America,USA,0,0,0,5,5
2005,Gabon,GAB,United States of America,USA,0,0,5,0,5
2005,Gambia,GMB,United States of America,USA,27,0,165,22,214
2005,United Kingdom of Great Britain and Northern Ireland,GBR,United States of America,USA,0,0,5,0,5
2005,Georgia,GEO,United States of America,USA,28,0,80,12,120
2005,Germany,DEU,United States of America,USA,0,0,5,5,10
2005,Ghana,GHA,United States of America,USA,5,0,24,13,42
2005,Guinea-Bissau,GNB,United States of America,USA,0,0,5,0,5
2005,Guatemala,GTM,United States of America,USA,182,0,1455,26713,28350
2005,Guinea,GIN,United States of America,USA,118,0,513,65,696
2005,Guyana,GUY,United States of America,USA,0,0,12,18,30
2005,Haiti,HTI,United States of America,USA,1740,0,2386,2924,7050
2005,Honduras,HND,United States of America,USA,14,0,36,61,111
2005,Croatia,HRV,United States of America,USA,5,0,5,5,15
2005,Hungary,HUN,United States of America,USA,5,0,0,5,10
2005,Cote d'Ivoire,CIV,United States of America,USA,75,0,274,35,384
2005,India,IND,United States of America,USA,76,0,839,217,1132
2005,Indonesia,IDN,United States of America,USA,64,0,351,96,511
2005,Iran (Islamic Rep. of),IRN,United States of America,USA,98,0,104,44,246
2005,Iraq,IRQ,United States of America,USA,120,0,100,10,230
2005,Israel,ISR,United States of America,USA,5,0,18,5,28
2005,Jamaica,JAM,United States of America,USA,5,0,24,16,45
2005,Jordan,JOR,United States of America,USA,15,0,39,12,66
2005,Kazakhstan,KAZ,United States of America,USA,10,0,48,5,63
2005,Kenya,KEN,United States of America,USA,89,0,159,52,300
2005,Kyrgyzstan,KGZ,United States of America,USA,10,0,26,5,41
2005,Rep. of Korea,KOR,United States of America,USA,0,0,5,0,5
2005,Kuwait,KWT,United States of America,USA,5,0,5,5,15
2005,Lao People's Dem. Rep.,LAO,United States of America,USA,10,0,23,37,70
2005,Liberia,LBR,United States of America,USA,109,0,189,42,340
2005,Lebanon,LBN,United States of America,USA,18,0,35,26,79
2005,Sri Lanka,LKA,United States of America,USA,10,0,58,11,79
2005,Lithuania,LTU,United States of America,USA,5,0,22,16,43
2005,Latvia,LVA,United States of America,USA,5,0,12,13,30
2005,Mauritania,MRT,United States of America,USA,43,0,357,241,641
2005,North Macedonia,MKD,United States of America,USA,0,0,19,13,32
2005,Rep. of Moldova,MDA,United States of America,USA,10,0,19,5,34
2005,Mexico,MEX,United States of America,USA,55,0,946,675,1676
2005,Mali,MLI,United States of America,USA,17,0,127,12,156
2005,Malaysia,MYS,United States of America,USA,5,0,11,0,16
2005,Mongolia,MNG,United States of America,USA,30,0,53,5,88
2005,Morocco,MAR,United States of America,USA,5,0,10,0,15
2005,Myanmar,MMR,United States of America,USA,81,0,91,30,202
2005,Nepal,NPL,United States of America,USA,170,0,204,10,384
2005,Niger,NER,United States of America,USA,10,0,41,12,63
2005,Nicaragua,NIC,United States of America,USA,13,0,74,2183,2270
2005,Nigeria,NGA,United States of America,USA,24,0,52,21,97
2005,Pakistan,PAK,United States of America,USA,65,0,100,84,249
2005,Panama,PAN,United States of America,USA,0,0,5,0,5
2005,Peru,PER,United States of America,USA,44,0,83,32,159
2005,Philippines,PHL,United States of America,USA,5,0,34,51,90
2005,Poland,POL,United States of America,USA,0,0,91,25,116
2005,Romania,ROU,United States of America,USA,15,0,18,57,90
2005,South Africa,ZAF,United States of America,USA,5,0,12,5,22
2005,Russian Federation,RUS,United States of America,USA,187,0,382,131,700
2005,Rwanda,RWA,United States of America,USA,46,0,47,5,98
2005,El Salvador,SLV,United States of America,USA,143,0,1741,46540,48424
2005,Saudi Arabia,SAU,United States of America,USA,0,0,5,0,5
2005,Serbia and Kosovo: S/RES/1244 (1999),SRB,United States of America,USA,26,0,114,44,184
2005,Senegal,SEN,United States of America,USA,10,0,58,18,86
2005,Sierra Leone,SLE,United States of America,USA,34,0,106,111,251
2005,Somalia,SOM,United States of America,USA,66,0,94,143,303
2005,Spain,ESP,United States of America,USA,0,0,5,0,5
2005,Viet Nam,VNM,United States of America,USA,10,0,10,0,20
2005,Sudan,SDN,United States of America,USA,47,0,31,5,83
2005,Suriname,SUR,United States of America,USA,0,0,5,0,5
2005,Slovakia,SVK,United States of America,USA,0,0,5,5,10
2005,Slovenia,SVN,United States of America,USA,0,0,0,5,5
2005,Syrian Arab Rep.,SYR,United States of America,USA,5,0,17,5,27
2005,United Rep. of Tanzania,TZA,United States of America,USA,11,0,22,5,38
2005,Thailand,THA,United States of America,USA,0,0,5,5,10
2005,Tajikistan,TJK,United States of America,USA,0,0,5,0,5
2005,Turkmenistan,TKM,United States of America,USA,20,0,28,5,53
2005,Togo,TGO,United States of America,USA,184,0,255,27,466
2005,Trinidad and Tobago,TTO,United States of America,USA,0,0,13,18,31
2005,Tunisia,TUN,United States of America,USA,0,0,5,0,5
2005,Turkey,TUR,United States of America,USA,10,0,23,10,43
2005,Uganda,UGA,United States of America,USA,48,0,58,10,116
2005,Ukraine,UKR,United States of America,USA,43,0,117,35,195
2005,Uruguay,URY,United States of America,USA,0,0,0,10,10
2005,Uzbekistan,UZB,United States of America,USA,49,0,190,25,264
2005,Venezuela (Bolivarian Republic of),VEN,United States of America,USA,508,0,636,67,1211
2005,Yemen,YEM,United States of America,USA,0,0,14,13,27
2005,Zambia,ZMB,United States of America,USA,5,0,12,5,22
2005,Zimbabwe,ZWE,United States of America,USA,113,0,153,17,283
2005,Stateless,XXA,United States of America,USA,31,0,62,10,103
2005,Unknown ,,United States of America,USA,0,0,300,10,310
2006,Afghanistan,AFG,United States of America,USA,22,0,11,5,38
2006,Albania,ALB,United States of America,USA,49,0,203,73,325
2006,Algeria,DZA,United States of America,USA,5,0,5,5,15
2006,Angola,AGO,United States of America,USA,5,0,5,5,15
2006,Egypt,EGY,United States of America,USA,111,0,190,12,313
2006,Argentina,ARG,United States of America,USA,5,0,5,35,45
2006,Armenia,ARM,United States of America,USA,144,0,275,36,455
2006,Azerbaijan,AZE,United States of America,USA,30,0,16,5,51
2006,Burundi,BDI,United States of America,USA,24,0,23,5,52
2006,Benin,BEN,United States of America,USA,0,0,5,0,5
2006,Bangladesh,BGD,United States of America,USA,37,0,52,65,154
2006,Bhutan,BTN,United States of America,USA,10,0,0,0,10
2006,Burkina Faso,BFA,United States of America,USA,12,0,34,0,46
2006,Belarus,BLR,United States of America,USA,95,0,164,28,287
2006,Bolivia (Plurinational State of),BOL,United States of America,USA,0,0,5,10,15
2006,Brazil,BRA,United States of America,USA,24,0,100,62,186
2006,Bosnia and Herzegovina,BIH,United States of America,USA,17,0,16,5,38
2006,Bulgaria,BGR,United States of America,USA,36,0,88,99,223
2006,Cambodia,KHM,United States of America,USA,12,0,19,5,36
2006,Canada,CAN,United States of America,USA,0,0,5,5,10
2006,Central African Rep.,CAF,United States of America,USA,5,0,10,10,25
2006,Chad,TCD,United States of America,USA,20,0,45,0,65
2006,China,CHN,United States of America,USA,1517,0,3121,490,5128
2006,Chile,CHL,United States of America,USA,0,0,5,5,10
2006,Cameroon,CMR,United States of America,USA,228,0,286,26,540
2006,Congo,COG,United States of America,USA,42,0,56,24,122
2006,Dem. Rep. of the Congo,COD,United States of America,USA,37,0,40,11,88
2006,Colombia,COL,United States of America,USA,1143,0,638,213,1994
2006,Costa Rica,CRI,United States of America,USA,0,0,0,5,5
2006,Cuba,CUB,United States of America,USA,45,0,35,443,523
2006,Cabo Verde,CPV,United States of America,USA,0,0,5,0,5
2006,Czechia,CZE,United States of America,USA,0,0,13,22,35
2006,Dominica,DMA,United States of America,USA,5,0,5,5,15
2006,Ecuador,ECU,United States of America,USA,5,0,14,30,49
2006,Eritrea,ERI,United States of America,USA,105,0,67,10,182
2006,Estonia,EST,United States of America,USA,0,0,19,12,31
2006,Ethiopia,ETH,United States of America,USA,423,0,349,73,845
2006,Fiji,FJI,United States of America,USA,19,0,16,18,53
2006,France,FRA,United States of America,USA,0,0,5,5,10
2006,Gabon,GAB,United States of America,USA,0,0,5,0,5
2006,Gambia,GMB,United States of America,USA,31,0,174,32,237
2006,United Kingdom of Great Britain and Northern Ireland,GBR,United States of America,USA,0,0,0,5,5
2006,Georgia,GEO,United States of America,USA,13,0,38,12,63
2006,Germany,DEU,United States of America,USA,5,0,0,5,10
2006,Ghana,GHA,United States of America,USA,5,0,17,26,48
2006,Guinea-Bissau,GNB,United States of America,USA,0,0,5,0,5
2006,Guatemala,GTM,United States of America,USA,389,0,3251,13002,16642
2006,Guinea,GIN,United States of America,USA,91,0,335,51,477
2006,Guyana,GUY,United States of America,USA,0,0,5,15,20
2006,Haiti,HTI,United States of America,USA,1874,0,2984,2753,7611
2006,Honduras,HND,United States of America,USA,26,0,130,121,277
2006,Croatia,HRV,United States of America,USA,5,0,5,10,20
2006,Hungary,HUN,United States of America,USA,0,0,5,27,32
2006,Cote d'Ivoire,CIV,United States of America,USA,59,0,174,38,271
2006,India,IND,United States of America,USA,159,0,316,207,682
2006,Indonesia,IDN,United States of America,USA,282,0,321,106,709
2006,Iran (Islamic Rep. of),IRN,United States of America,USA,116,0,95,41,252
2006,Iraq,IRQ,United States of America,USA,137,0,68,13,218
2006,Israel,ISR,United States of America,USA,0,0,14,10,24
2006,Jamaica,JAM,United States of America,USA,5,0,5,15,25
2006,Jordan,JOR,United States of America,USA,10,0,24,14,48
2006,Kazakhstan,KAZ,United States of America,USA,11,0,28,10,49
2006,Kenya,KEN,United States of America,USA,67,0,107,52,226
2006,Kyrgyzstan,KGZ,United States of America,USA,10,0,16,0,26
2006,Rep. of Korea,KOR,United States of America,USA,0,0,12,5,17
2006,Dem. People's Rep. of Korea,PRK,United States of America,USA,0,0,5,0,5
2006,Lao People's Dem. Rep.,LAO,United States of America,USA,11,0,40,37,88
2006,Liberia,LBR,United States of America,USA,87,0,90,60,237
2006,Libya,LBY,United States of America,USA,5,0,0,0,5
2006,Lebanon,LBN,United States of America,USA,10,0,31,26,67
2006,Sri Lanka,LKA,United States of America,USA,18,0,39,5,62
2006,Lithuania,LTU,United States of America,USA,0,0,42,33,75
2006,Latvia,LVA,United States of America,USA,5,0,19,11,35
2006,Mauritania,MRT,United States of America,USA,14,0,106,115,235
2006,North Macedonia,MKD,United States of America,USA,5,0,14,10,29
2006,Rep. of Moldova,MDA,United States of America,USA,11,0,33,5,49
2006,Mexico,MEX,United States of America,USA,61,0,839,510,1410
2006,Mali,MLI,United States of America,USA,20,0,166,25,211
2006,Malaysia,MYS,United States of America,USA,5,0,11,0,16
2006,Malawi,MWI,United States of America,USA,0,0,5,0,5
2006,Mongolia,MNG,United States of America,USA,27,0,49,5,81
2006,Morocco,MAR,United States of America,USA,5,0,5,5,15
2006,Myanmar,MMR,United States of America,USA,94,0,62,42,198
2006,Nepal,NPL,United States of America,USA,159,0,200,24,383
2006,Niger,NER,United States of America,USA,12,0,21,10,43
2006,Nicaragua,NIC,United States of America,USA,34,0,199,2756,2989
2006,Nigeria,NGA,United States of America,USA,25,0,45,41,111
2006,Pakistan,PAK,United States of America,USA,93,0,110,79,282
2006,Panama,PAN,United States of America,USA,0,0,0,5,5
2006,Paraguay,PRY,United States of America,USA,0,0,0,5,5
2006,Peru,PER,United States of America,USA,51,0,84,64,199
2006,Philippines,PHL,United States of America,USA,16,0,44,56,116
2006,Poland,POL,United States of America,USA,0,0,71,215,286
2006,Portugal,PRT,United States of America,USA,0,0,0,5,5
2006,Romania,ROU,United States of America,USA,18,0,82,264,364
2006,South Africa,ZAF,United States of America,USA,0,0,10,10,20
2006,Russian Federation,RUS,United States of America,USA,220,0,388,505,1113
2006,Rwanda,RWA,United States of America,USA,52,0,37,0,89
2006,El Salvador,SLV,United States of America,USA,389,0,4085,19810,24284
2006,Saudi Arabia,SAU,United States of America,USA,5,0,0,0,5
2006,Serbia and Kosovo: S/RES/1244 (1999),SRB,United States of America,USA,51,0,112,123,286
2006,Senegal,SEN,United States of America,USA,5,0,37,11,53
2006,Sierra Leone,SLE,United States of America,USA,25,0,99,97,221
2006,Somalia,SOM,United States of America,USA,45,0,74,70,189
2006,Viet Nam,VNM,United States of America,USA,10,0,13,5,28
2006,Sudan,SDN,United States of America,USA,36,0,39,11,86
2006,Suriname,SUR,United States of America,USA,0,0,5,5,10
2006,Slovakia,SVK,United States of America,USA,0,0,17,12,29
2006,Sweden,SWE,United States of America,USA,0,0,0,5,5
2006,Syrian Arab Rep.,SYR,United States of America,USA,10,0,14,13,37
2006,United Rep. of Tanzania,TZA,United States of America,USA,5,0,13,0,18
2006,Thailand,THA,United States of America,USA,0,0,10,12,22
2006,Tajikistan,TJK,United States of America,USA,0,0,5,0,5
2006,Turkmenistan,TKM,United States of America,USA,24,0,27,5,56
2006,Togo,TGO,United States of America,USA,72,0,90,10,172
2006,Trinidad and Tobago,TTO,United States of America,USA,0,0,5,14,19
2006,Tunisia,TUN,United States of America,USA,0,0,0,5,5
2006,Turkey,TUR,United States of America,USA,10,0,5,5,20
2006,Uganda,UGA,United States of America,USA,30,0,31,10,71
2006,Ukraine,UKR,United States of America,USA,44,0,143,119,306
2006,Uruguay,URY,United States of America,USA,0,0,5,10,15
2006,Uzbekistan,UZB,United States of America,USA,78,0,163,31,272
2006,Venezuela (Bolivarian Republic of),VEN,United States of America,USA,497,0,480,44,1021
2006,Yemen,YEM,United States of America,USA,5,0,12,5,22
2006,Zambia,ZMB,United States of America,USA,5,0,10,5,20
2006,Zimbabwe,ZWE,United States of America,USA,84,0,110,13,207
2006,Stateless,XXA,United States of America,USA,33,0,48,21,102
2006,Unknown ,,United States of America,USA,0,0,147,5,152
2007,Afghanistan,AFG,United States of America,USA,51,0,16,5,72
2007,Albania,ALB,United States of America,USA,53,0,137,40,230
2007,Algeria,DZA,United States of America,USA,5,0,10,16,31
2007,Angola,AGO,United States of America,USA,5,0,11,0,16
2007,Egypt,EGY,United States of America,USA,118,0,199,29,346
2007,Argentina,ARG,United States of America,USA,0,0,0,73,73
2007,Armenia,ARM,United States of America,USA,198,0,238,29,465
2007,Azerbaijan,AZE,United States of America,USA,16,0,14,5,35
2007,Burundi,BDI,United States of America,USA,27,0,34,5,66
2007,Benin,BEN,United States of America,USA,5,0,5,0,10
2007,Bangladesh,BGD,United States of America,USA,30,0,44,73,147
2007,Bhutan,BTN,United States of America,USA,5,0,0,0,5
2007,Burkina Faso,BFA,United States of America,USA,26,0,77,5,108
2007,Belarus,BLR,United States of America,USA,87,0,153,26,266
2007,Bolivia (Plurinational State of),BOL,United States of America,USA,5,0,10,0,15
2007,Brazil,BRA,United States of America,USA,34,0,47,231,312
2007,Bosnia and Herzegovina,BIH,United States of America,USA,13,0,30,5,48
2007,Bulgaria,BGR,United States of America,USA,36,0,65,74,175
2007,Cambodia,KHM,United States of America,USA,21,0,13,5,39
2007,Canada,CAN,United States of America,USA,0,0,5,0,5
2007,Central African Rep.,CAF,United States of America,USA,5,0,12,0,17
2007,Chad,TCD,United States of America,USA,30,0,38,5,73
2007,China,CHN,United States of America,USA,1804,0,4650,472,6926
2007,Chile,CHL,United States of America,USA,0,0,0,10,10
2007,Cameroon,CMR,United States of America,USA,270,0,281,33,584
2007,Congo,COG,United States of America,USA,60,0,45,19,124
2007,Dem. Rep. of the Congo,COD,United States of America,USA,39,0,29,14,82
2007,Colombia,COL,United States of America,USA,798,0,625,227,1650
2007,Costa Rica,CRI,United States of America,USA,5,0,5,13,23
2007,Cuba,CUB,United States of America,USA,49,0,41,158,248
2007,Czechia,CZE,United States of America,USA,0,0,5,22,27
2007,Djibouti,DJI,United States of America,USA,0,0,5,0,5
2007,Dominican Rep.,DOM,United States of America,USA,5,0,0,10,15
2007,Ecuador,ECU,United States of America,USA,5,0,15,48,68
2007,Eritrea,ERI,United States of America,USA,141,0,71,5,217
2007,Estonia,EST,United States of America,USA,0,0,10,5,15
2007,Ethiopia,ETH,United States of America,USA,503,0,442,59,1004
2007,Fiji,FJI,United States of America,USA,20,0,25,18,63
2007,France,FRA,United States of America,USA,0,0,0,5,5
2007,Gambia,GMB,United States of America,USA,36,0,224,20,280
2007,United Kingdom of Great Britain and Northern Ireland,GBR,United States of America,USA,0,0,0,5,5
2007,Georgia,GEO,United States of America,USA,15,0,27,10,52
2007,Germany,DEU,United States of America,USA,0,0,5,5,10
2007,Ghana,GHA,United States of America,USA,21,0,11,23,55
2007,Guatemala,GTM,United States of America,USA,430,0,4547,6551,11528
2007,Guinea,GIN,United States of America,USA,111,0,411,34,556
2007,Guyana,GUY,United States of America,USA,0,0,5,15,20
2007,Haiti,HTI,United States of America,USA,879,0,1728,1078,3685
2007,Honduras,HND,United States of America,USA,18,0,87,212,317
2007,Croatia,HRV,United States of America,USA,5,0,5,5,15
2007,Hungary,HUN,United States of America,USA,0,0,5,24,29
2007,Cote d'Ivoire,CIV,United States of America,USA,46,0,226,24,296
2007,India,IND,United States of America,USA,124,0,413,162,699
2007,Indonesia,IDN,United States of America,USA,409,0,657,59,1125
2007,Iran (Islamic Rep. of),IRN,United States of America,USA,146,0,86,32,264
2007,Iraq,IRQ,United States of America,USA,326,0,74,21,421
2007,Israel,ISR,United States of America,USA,5,0,26,5,36
2007,Italy,ITA,United States of America,USA,0,0,0,5,5
2007,Jamaica,JAM,United States of America,USA,12,0,10,11,33
2007,Jordan,JOR,United States of America,USA,18,0,41,16,75
2007,Kazakhstan,KAZ,United States of America,USA,27,0,41,5,73
2007,Kenya,KEN,United States of America,USA,152,0,134,49,335
2007,Kyrgyzstan,KGZ,United States of America,USA,12,0,24,0,36
2007,Rep. of Korea,KOR,United States of America,USA,0,0,10,0,10
2007,Lao People's Dem. Rep.,LAO,United States of America,USA,33,0,33,18,84
2007,Liberia,LBR,United States of America,USA,90,0,94,53,237
2007,Lebanon,LBN,United States of America,USA,30,0,60,30,120
2007,Sri Lanka,LKA,United States of America,USA,28,0,100,23,151
2007,Lithuania,LTU,United States of America,USA,0,0,13,16,29
2007,Latvia,LVA,United States of America,USA,5,0,5,5,15
2007,Mauritania,MRT,United States of America,USA,17,0,54,52,123
2007,North Macedonia,MKD,United States of America,USA,5,0,11,5,21
2007,Rep. of Moldova,MDA,United States of America,USA,29,0,58,24,111
2007,Mexico,MEX,United States of America,USA,88,0,828,1449,2365
2007,Mali,MLI,United States of America,USA,36,0,248,19,303
2007,Malaysia,MYS,United States of America,USA,5,0,0,5,10
2007,Malawi,MWI,United States of America,USA,5,0,5,0,10
2007,Mongolia,MNG,United States of America,USA,55,0,58,5,118
2007,Morocco,MAR,United States of America,USA,0,0,5,0,5
2007,Montenegro,MNE,United States of America,USA,0,0,5,0,5
2007,Myanmar,MMR,United States of America,USA,112,0,72,29,213
2007,Nepal,NPL,United States of America,USA,229,0,283,20,532
2007,Netherlands,NLD,United States of America,USA,0,0,0,5,5
2007,Niger,NER,United States of America,USA,10,0,21,5,36
2007,Nicaragua,NIC,United States of America,USA,26,0,97,573,696
2007,Nigeria,NGA,United States of America,USA,28,0,37,28,93
2007,Pakistan,PAK,United States of America,USA,109,0,82,66,257
2007,Panama,PAN,United States of America,USA,0,0,5,5,10
2007,Peru,PER,United States of America,USA,50,0,60,74,184
2007,Philippines,PHL,United States of America,USA,14,0,48,37,99
2007,Poland,POL,United States of America,USA,0,0,23,76,99
2007,Portugal,PRT,United States of America,USA,0,0,0,5,5
2007,Romania,ROU,United States of America,USA,18,0,37,175,230
2007,South Africa,ZAF,United States of America,USA,0,0,15,5,20
2007,Russian Federation,RUS,United States of America,USA,253,0,381,201,835
2007,Rwanda,RWA,United States of America,USA,60,0,40,5,105
2007,El Salvador,SLV,United States of America,USA,355,0,6191,8853,15399
2007,Saudi Arabia,SAU,United States of America,USA,0,0,5,5,10
2007,Serbia and Kosovo: S/RES/1244 (1999),SRB,United States of America,USA,78,0,140,63,281
2007,Senegal,SEN,United States of America,USA,13,0,64,13,90
2007,Sierra Leone,SLE,United States of America,USA,26,0,60,50,136
2007,Somalia,SOM,United States of America,USA,109,0,45,51,205
2007,Spain,ESP,United States of America,USA,0,0,0,5,5
2007,Viet Nam,VNM,United States of America,USA,13,0,11,5,29
2007,Sudan,SDN,United States of America,USA,73,0,48,5,126
2007,Suriname,SUR,United States of America,USA,0,0,0,5,5
2007,Slovakia,SVK,United States of America,USA,0,0,0,5,5
2007,Sweden,SWE,United States of America,USA,0,0,5,0,5
2007,Syrian Arab Rep.,SYR,United States of America,USA,10,0,21,0,31
2007,United Rep. of Tanzania,TZA,United States of America,USA,5,0,16,5,26
2007,Thailand,THA,United States of America,USA,0,0,5,5,10
2007,Tajikistan,TJK,United States of America,USA,5,0,5,0,10
2007,Turkmenistan,TKM,United States of America,USA,13,0,18,0,31
2007,Togo,TGO,United States of America,USA,58,0,55,5,118
2007,Trinidad and Tobago,TTO,United States of America,USA,5,0,5,18,28
2007,Tunisia,TUN,United States of America,USA,5,0,0,0,5
2007,Turkey,TUR,United States of America,USA,16,0,19,14,49
2007,Uganda,UGA,United States of America,USA,71,0,33,13,117
2007,Ukraine,UKR,United States of America,USA,66,0,127,69,262
2007,Uruguay,URY,United States of America,USA,0,0,5,28,33
2007,Uzbekistan,UZB,United States of America,USA,91,0,147,22,260
2007,Venezuela (Bolivarian Republic of),VEN,United States of America,USA,384,0,346,50,780
2007,Yemen,YEM,United States of America,USA,24,0,12,10,46
2007,Zambia,ZMB,United States of America,USA,5,0,11,0,16
2007,Zimbabwe,ZWE,United States of America,USA,105,0,110,11,226
2007,Stateless,XXA,United States of America,USA,40,0,83,20,143
2007,Unknown ,,United States of America,USA,0,0,226,11,237
2008,Afghanistan,AFG,United States of America,USA,67,0,11,5,83
2008,Albania,ALB,United States of America,USA,32,0,79,25,136
2008,Algeria,DZA,United States of America,USA,10,0,14,5,29
2008,Angola,AGO,United States of America,USA,5,0,5,5,15
2008,Egypt,EGY,United States of America,USA,166,0,202,21,389
2008,Argentina,ARG,United States of America,USA,0,0,5,26,31
2008,Armenia,ARM,United States of America,USA,96,0,127,22,245
2008,Azerbaijan,AZE,United States of America,USA,12,0,23,0,35
2008,Burundi,BDI,United States of America,USA,27,0,14,0,41
2008,Benin,BEN,United States of America,USA,5,0,12,0,17
2008,Bangladesh,BGD,United States of America,USA,24,0,78,26,128
2008,Bahamas,BHS,United States of America,USA,0,0,0,5,5
2008,Bhutan,BTN,United States of America,USA,5,0,5,0,10
2008,Burkina Faso,BFA,United States of America,USA,15,0,68,10,93
2008,Belarus,BLR,United States of America,USA,62,0,102,17,181
2008,Bolivia (Plurinational State of),BOL,United States of America,USA,5,0,5,5,15
2008,Brazil,BRA,United States of America,USA,36,0,54,35,125
2008,Bosnia and Herzegovina,BIH,United States of America,USA,10,0,20,5,35
2008,Bulgaria,BGR,United States of America,USA,39,0,47,49,135
2008,Belize,BLZ,United States of America,USA,0,0,0,5,5
2008,Cambodia,KHM,United States of America,USA,5,0,5,5,15
2008,Canada,CAN,United States of America,USA,0,0,0,5,5
2008,Central African Rep.,CAF,United States of America,USA,12,0,16,0,28
2008,Chad,TCD,United States of America,USA,37,0,70,5,112
2008,China,CHN,United States of America,USA,1902,0,5714,422,8038
2008,Chile,CHL,United States of America,USA,0,0,0,5,5
2008,Cameroon,CMR,United States of America,USA,259,0,280,38,577
2008,Congo,COG,United States of America,USA,45,0,44,15,104
2008,Dem. Rep. of the Congo,COD,United States of America,USA,39,0,44,13,96
2008,Colombia,COL,United States of America,USA,594,0,330,116,1040
2008,Costa Rica,CRI,United States of America,USA,0,0,0,13,13
2008,Cuba,CUB,United States of America,USA,63,0,42,77,182
2008,Czechia,CZE,United States of America,USA,0,0,5,10,15
2008,Djibouti,DJI,United States of America,USA,0,0,5,0,5
2008,Dominican Rep.,DOM,United States of America,USA,0,0,5,5,10
2008,Ecuador,ECU,United States of America,USA,5,0,22,77,104
2008,Eritrea,ERI,United States of America,USA,173,0,109,10,292
2008,Estonia,EST,United States of America,USA,0,0,5,5,10
2008,Ethiopia,ETH,United States of America,USA,582,0,520,45,1147
2008,Fiji,FJI,United States of America,USA,23,0,16,10,49
2008,France,FRA,United States of America,USA,0,0,5,5,10
2008,Gambia,GMB,United States of America,USA,38,0,116,12,166
2008,United Kingdom of Great Britain and Northern Ireland,GBR,United States of America,USA,0,0,5,5,10
2008,Georgia,GEO,United States of America,USA,22,0,26,10,58
2008,Germany,DEU,United States of America,USA,0,0,10,10,20
2008,Ghana,GHA,United States of America,USA,10,0,10,10,30
2008,Guinea-Bissau,GNB,United States of America,USA,0,0,5,0,5
2008,Guatemala,GTM,United States of America,USA,286,0,2219,3706,6211
2008,Guinea,GIN,United States of America,USA,101,0,296,33,430
2008,Guyana,GUY,United States of America,USA,0,0,0,5,5
2008,Haiti,HTI,United States of America,USA,587,0,1067,515,2169
2008,Honduras,HND,United States of America,USA,21,0,56,103,180
2008,Croatia,HRV,United States of America,USA,5,0,0,0,5
2008,Hungary,HUN,United States of America,USA,0,0,5,5,10
2008,Cote d'Ivoire,CIV,United States of America,USA,40,0,185,17,242
2008,India,IND,United States of America,USA,137,0,442,98,677
2008,Indonesia,IDN,United States of America,USA,277,0,544,122,943
2008,Iran (Islamic Rep. of),IRN,United States of America,USA,249,0,87,30,366
2008,Iraq,IRQ,United States of America,USA,420,0,93,21,534
2008,Israel,ISR,United States of America,USA,10,0,26,5,41
2008,Jamaica,JAM,United States of America,USA,19,0,11,13,43
2008,Jordan,JOR,United States of America,USA,18,0,31,5,54
2008,Kazakhstan,KAZ,United States of America,USA,17,0,28,5,50
2008,Kenya,KEN,United States of America,USA,184,0,195,50,429
2008,Kyrgyzstan,KGZ,United States of America,USA,21,0,26,5,52
2008,Lao People's Dem. Rep.,LAO,United States of America,USA,13,0,19,10,42
2008,Liberia,LBR,United States of America,USA,87,0,80,32,199
2008,Libya,LBY,United States of America,USA,5,0,5,0,10
2008,Lebanon,LBN,United States of America,USA,23,0,45,13,81
2008,Sri Lanka,LKA,United States of America,USA,30,0,143,14,187
2008,Lithuania,LTU,United States of America,USA,0,0,5,10,15
2008,Latvia,LVA,United States of America,USA,0,0,5,0,5
2008,Mauritania,MRT,United States of America,USA,10,0,29,19,58
2008,North Macedonia,MKD,United States of America,USA,5,0,10,0,15
2008,Rep. of Moldova,MDA,United States of America,USA,41,0,94,34,169
2008,Mexico,MEX,United States of America,USA,123,0,829,1543,2495
2008,Mali,MLI,United States of America,USA,32,0,187,13,232
2008,Malaysia,MYS,United States of America,USA,5,0,15,0,20
2008,Mongolia,MNG,United States of America,USA,45,0,75,5,125
2008,Morocco,MAR,United States of America,USA,0,0,5,5,10
2008,Montenegro,MNE,United States of America,USA,0,0,5,0,5
2008,Myanmar,MMR,United States of America,USA,142,0,76,22,240
2008,Nepal,NPL,United States of America,USA,295,0,307,29,631
2008,Netherlands,NLD,United States of America,USA,0,0,5,0,5
2008,Niger,NER,United States of America,USA,14,0,20,10,44
2008,Nicaragua,NIC,United States of America,USA,22,0,83,177,282
2008,Nigeria,NGA,United States of America,USA,38,0,43,21,102
2008,Pakistan,PAK,United States of America,USA,118,0,129,60,307
2008,Panama,PAN,United States of America,USA,0,0,5,0,5
2008,Peru,PER,United States of America,USA,39,0,32,37,108
2008,Philippines,PHL,United States of America,USA,10,0,46,34,90
2008,Poland,POL,United States of America,USA,0,0,5,40,45
2008,Romania,ROU,United States of America,USA,12,0,23,58,93
2008,South Africa,ZAF,United States of America,USA,0,0,10,0,10
2008,Russian Federation,RUS,United States of America,USA,304,0,322,180,806
2008,Rwanda,RWA,United States of America,USA,64,0,43,5,112
2008,El Salvador,SLV,United States of America,USA,260,0,3934,5176,9370
2008,Saudi Arabia,SAU,United States of America,USA,5,0,5,0,10
2008,Serbia and Kosovo: S/RES/1244 (1999),SRB,United States of America,USA,63,0,136,46,245
2008,Senegal,SEN,United States of America,USA,10,0,71,15,96
2008,Sierra Leone,SLE,United States of America,USA,29,0,42,31,102
2008,Somalia,SOM,United States of America,USA,111,0,27,37,175
2008,Spain,ESP,United States of America,USA,0,0,0,5,5
2008,Viet Nam,VNM,United States of America,USA,18,0,17,0,35
2008,Sudan,SDN,United States of America,USA,92,0,63,10,165
2008,Suriname,SUR,United States of America,USA,0,0,5,0,5
2008,Switzerland,CHE,United States of America,USA,0,0,0,5,5
2008,Syrian Arab Rep.,SYR,United States of America,USA,17,0,21,5,43
2008,United Rep. of Tanzania,TZA,United States of America,USA,10,0,5,0,15
2008,Thailand,THA,United States of America,USA,0,0,5,0,5
2008,Tajikistan,TJK,United States of America,USA,5,0,11,0,16
2008,Turkmenistan,TKM,United States of America,USA,10,0,16,0,26
2008,Togo,TGO,United States of America,USA,42,0,59,10,111
2008,Tonga,TON,United States of America,USA,0,0,5,0,5
2008,Trinidad and Tobago,TTO,United States of America,USA,5,0,15,5,25
2008,Turkey,TUR,United States of America,USA,29,0,20,10,59
2008,Uganda,UGA,United States of America,USA,58,0,33,10,101
2008,Ukraine,UKR,United States of America,USA,59,0,95,42,196
2008,Uruguay,URY,United States of America,USA,0,0,0,10,10
2008,Uzbekistan,UZB,United States of America,USA,78,0,116,16,210
2008,Venezuela (Bolivarian Republic of),VEN,United States of America,USA,348,0,307,36,691
2008,Yemen,YEM,United States of America,USA,22,0,10,0,32
2008,Zambia,ZMB,United States of America,USA,5,0,10,0,15
2008,Zimbabwe,ZWE,United States of America,USA,136,0,93,18,247
2008,Stateless,XXA,United States of America,USA,61,0,80,12,153
2008,Unknown ,,United States of America,USA,0,0,255,5,260
2009,Afghanistan,AFG,United States of America,USA,64,0,0,15,79
2009,Albania,ALB,United States of America,USA,34,0,10,100,144
2009,Algeria,DZA,United States of America,USA,5,0,0,10,15
2009,Angola,AGO,United States of America,USA,5,0,5,5,15
2009,Egypt,EGY,United States of America,USA,185,0,5,196,386
2009,Argentina,ARG,United States of America,USA,0,0,0,11,11
2009,Armenia,ARM,United States of America,USA,89,0,5,117,211
2009,Australia,AUS,United States of America,USA,0,0,0,5,5
2009,Azerbaijan,AZE,United States of America,USA,18,0,0,20,38
2009,Barbados,BRB,United States of America,USA,0,0,0,5,5
2009,Burundi,BDI,United States of America,USA,17,0,5,14,36
2009,Benin,BEN,United States of America,USA,5,0,0,12,17
2009,Bangladesh,BGD,United States of America,USA,21,0,0,102,123
2009,Bahamas,BHS,United States of America,USA,0,0,0,5,5
2009,Bhutan,BTN,United States of America,USA,5,0,0,5,10
2009,Burkina Faso,BFA,United States of America,USA,18,0,5,54,77
2009,Belarus,BLR,United States of America,USA,96,0,5,140,241
2009,Bolivia (Plurinational State of),BOL,United States of America,USA,5,0,0,12,17
2009,Brazil,BRA,United States of America,USA,44,0,0,69,113
2009,Bosnia and Herzegovina,BIH,United States of America,USA,5,0,0,10,15
2009,Bulgaria,BGR,United States of America,USA,17,0,0,34,51
2009,Cambodia,KHM,United States of America,USA,5,0,0,5,10
2009,Canada,CAN,United States of America,USA,0,0,0,5,5
2009,Central African Rep.,CAF,United States of America,USA,10,0,0,5,15
2009,Chad,TCD,United States of America,USA,22,0,5,27,54
2009,China,CHN,United States of America,USA,2433,0,171,6292,8896
2009,Cameroon,CMR,United States of America,USA,214,0,36,213,463
2009,Congo,COG,United States of America,USA,43,0,0,49,92
2009,Dem. Rep. of the Congo,COD,United States of America,USA,37,0,10,31,78
2009,Colombia,COL,United States of America,USA,336,0,10,289,635
2009,Cuba,CUB,United States of America,USA,29,0,0,46,75
2009,Czechia,CZE,United States of America,USA,0,0,0,5,5
2009,Djibouti,DJI,United States of America,USA,5,0,0,10,15
2009,Dominican Rep.,DOM,United States of America,USA,0,0,0,10,10
2009,Ecuador,ECU,United States of America,USA,5,0,0,80,85
2009,Eritrea,ERI,United States of America,USA,222,0,5,99,326
2009,Estonia,EST,United States of America,USA,0,0,0,10,10
2009,Ethiopia,ETH,United States of America,USA,617,0,77,425,1119
2009,Fiji,FJI,United States of America,USA,12,0,0,11,23
2009,Gabon,GAB,United States of America,USA,5,0,0,5,10
2009,Gambia,GMB,United States of America,USA,43,0,5,133,181
2009,United Kingdom of Great Britain and Northern Ireland,GBR,United States of America,USA,0,0,0,5,5
2009,Georgia,GEO,United States of America,USA,21,0,0,52,73
2009,Germany,DEU,United States of America,USA,0,0,0,10,10
2009,Ghana,GHA,United States of America,USA,14,0,0,24,38
2009,Guinea-Bissau,GNB,United States of America,USA,0,0,0,5,5
2009,Guatemala,GTM,United States of America,USA,265,0,399,1852,2516
2009,Guinea,GIN,United States of America,USA,118,0,10,302,430
2009,Guyana,GUY,United States of America,USA,0,0,0,21,21
2009,Haiti,HTI,United States of America,USA,458,0,48,916,1422
2009,Honduras,HND,United States of America,USA,25,0,5,93,123
2009,Croatia,HRV,United States of America,USA,0,0,0,5,5
2009,Hungary,HUN,United States of America,USA,0,0,0,5,5
2009,Cote d'Ivoire,CIV,United States of America,USA,39,0,10,157,206
2009,India,IND,United States of America,USA,144,0,10,445,599
2009,Indonesia,IDN,United States of America,USA,110,0,14,273,397
2009,Iran (Islamic Rep. of),IRN,United States of America,USA,211,0,5,82,298
2009,Iraq,IRQ,United States of America,USA,384,0,14,72,470
2009,Israel,ISR,United States of America,USA,5,0,0,13,18
2009,Jamaica,JAM,United States of America,USA,37,0,0,22,59
2009,Jordan,JOR,United States of America,USA,15,0,0,24,39
2009,Japan,JPN,United States of America,USA,0,0,0,5,5
2009,Kazakhstan,KAZ,United States of America,USA,19,0,0,66,85
2009,Kenya,KEN,United States of America,USA,182,0,25,175,382
2009,Kyrgyzstan,KGZ,United States of America,USA,27,0,0,43,70
2009,Rep. of Korea,KOR,United States of America,USA,0,0,0,22,22
2009,Dem. People's Rep. of Korea,PRK,United States of America,USA,0,0,0,5,5
2009,Kuwait,KWT,United States of America,USA,5,0,0,5,10
2009,Lao People's Dem. Rep.,LAO,United States of America,USA,10,0,0,21,31
2009,Liberia,LBR,United States of America,USA,84,0,5,66,155
2009,Saint Lucia,LCA,United States of America,USA,0,0,0,5,5
2009,Lebanon,LBN,United States of America,USA,31,0,0,30,61
2009,Sri Lanka,LKA,United States of America,USA,70,0,5,176,251
2009,Latvia,LVA,United States of America,USA,0,0,0,5,5
2009,Mauritania,MRT,United States of America,USA,19,0,0,35,54
2009,North Macedonia,MKD,United States of America,USA,5,0,0,23,28
2009,Rep. of Moldova,MDA,United States of America,USA,84,0,0,221,305
2009,Mexico,MEX,United States of America,USA,150,0,5,1584,1739
2009,Mali,MLI,United States of America,USA,44,0,5,147,196
2009,Malaysia,MYS,United States of America,USA,5,0,0,5,10
2009,Malawi,MWI,United States of America,USA,5,0,0,5,10
2009,Mongolia,MNG,United States of America,USA,30,0,10,95,135
2009,Morocco,MAR,United States of America,USA,5,0,0,10,15
2009,Montenegro,MNE,United States of America,USA,0,0,0,5,5
2009,Myanmar,MMR,United States of America,USA,165,0,11,88,264
2009,Nepal,NPL,United States of America,USA,398,0,57,551,1006
2009,Netherlands,NLD,United States of America,USA,0,0,0,5,5
2009,Niger,NER,United States of America,USA,5,0,5,23,33
2009,Nicaragua,NIC,United States of America,USA,19,0,5,81,105
2009,Nigeria,NGA,United States of America,USA,17,0,5,33,55
2009,Pakistan,PAK,United States of America,USA,124,0,12,171,307
2009,Peru,PER,United States of America,USA,20,0,0,33,53
2009,Philippines,PHL,United States of America,USA,12,0,5,46,63
2009,Poland,POL,United States of America,USA,0,0,0,10,10
2009,Romania,ROU,United States of America,USA,10,0,0,19,29
2009,South Africa,ZAF,United States of America,USA,5,0,0,10,15
2009,Russian Federation,RUS,United States of America,USA,264,0,22,460,746
2009,Rwanda,RWA,United States of America,USA,49,0,12,43,104
2009,El Salvador,SLV,United States of America,USA,178,0,830,2043,3051
2009,Saudi Arabia,SAU,United States of America,USA,5,0,0,5,10
2009,Serbia and Kosovo: S/RES/1244 (1999),SRB,United States of America,USA,40,0,0,113,153
2009,Senegal,SEN,United States of America,USA,20,0,0,94,114
2009,Sierra Leone,SLE,United States of America,USA,38,0,0,35,73
2009,Somalia,SOM,United States of America,USA,149,0,5,34,188
2009,Viet Nam,VNM,United States of America,USA,29,0,5,13,47
2009,Sudan,SDN,United States of America,USA,60,0,5,37,102
2009,Suriname,SUR,United States of America,USA,0,0,0,5,5
2009,Slovenia,SVN,United States of America,USA,0,0,0,5,5
2009,Syrian Arab Rep.,SYR,United States of America,USA,11,0,0,14,25
2009,United Rep. of Tanzania,TZA,United States of America,USA,5,0,0,10,15
2009,Thailand,THA,United States of America,USA,0,0,0,5,5
2009,Tajikistan,TJK,United States of America,USA,11,0,0,36,47
2009,Turkmenistan,TKM,United States of America,USA,10,0,0,15,25
2009,Togo,TGO,United States of America,USA,37,0,5,46,88
2009,Trinidad and Tobago,TTO,United States of America,USA,0,0,0,17,17
2009,Turkey,TUR,United States of America,USA,22,0,5,29,56
2009,Uganda,UGA,United States of America,USA,57,0,5,34,96
2009,Ukraine,UKR,United States of America,USA,65,0,5,159,229
2009,Uruguay,URY,United States of America,USA,0,0,0,5,5
2009,Uzbekistan,UZB,United States of America,USA,62,0,10,103,175
2009,Venezuela (Bolivarian Republic of),VEN,United States of America,USA,187,0,22,207,416
2009,Yemen,YEM,United States of America,USA,19,0,0,16,35
2009,Zambia,ZMB,United States of America,USA,0,0,0,5,5
2009,Zimbabwe,ZWE,United States of America,USA,114,0,28,105,247
2009,Stateless,XXA,United States of America,USA,82,0,0,61,143
2009,Unknown ,,United States of America,USA,0,0,0,223,223
2010,Afghanistan,AFG,United States of America,USA,81,0,5,19,105
2010,Albania,ALB,United States of America,USA,25,0,0,74,99
2010,Algeria,DZA,United States of America,USA,5,0,0,10,15
2010,Angola,AGO,United States of America,USA,5,0,0,10,15
2010,Egypt,EGY,United States of America,USA,179,0,5,191,375
2010,Argentina,ARG,United States of America,USA,0,0,0,10,10
2010,Armenia,ARM,United States of America,USA,65,0,5,98,168
2010,Azerbaijan,AZE,United States of America,USA,17,0,0,13,30
2010,Burundi,BDI,United States of America,USA,15,0,0,5,20
2010,Benin,BEN,United States of America,USA,5,0,0,5,10
2010,Bangladesh,BGD,United States of America,USA,23,0,0,79,102
2010,Bahamas,BHS,United States of America,USA,0,0,0,5,5
2010,Bhutan,BTN,United States of America,USA,0,0,0,5,5
2010,Burkina Faso,BFA,United States of America,USA,36,0,5,73,114
2010,Belarus,BLR,United States of America,USA,58,0,5,137,200
2010,Bolivia (Plurinational State of),BOL,United States of America,USA,10,0,0,5,15
2010,Brazil,BRA,United States of America,USA,41,0,0,77,118
2010,Bosnia and Herzegovina,BIH,United States of America,USA,5,0,0,10,15
2010,Bulgaria,BGR,United States of America,USA,17,0,0,15,32
2010,Belize,BLZ,United States of America,USA,5,0,0,0,5
2010,Cambodia,KHM,United States of America,USA,5,0,0,5,10
2010,Central African Rep.,CAF,United States of America,USA,13,0,5,11,29
2010,Chad,TCD,United States of America,USA,16,0,0,10,26
2010,China,CHN,United States of America,USA,2650,0,204,7716,10570
2010,Chile,CHL,United States of America,USA,0,0,0,5,5
2010,Cameroon,CMR,United States of America,USA,165,0,22,147,334
2010,Congo,COG,United States of America,USA,60,0,0,37,97
2010,Dem. Rep. of the Congo,COD,United States of America,USA,33,0,5,38,76
2010,Colombia,COL,United States of America,USA,187,0,17,200,404
2010,Costa Rica,CRI,United States of America,USA,0,0,0,5,5
2010,Cuba,CUB,United States of America,USA,18,0,5,30,53
2010,Djibouti,DJI,United States of America,USA,11,0,0,5,16
2010,Dominican Rep.,DOM,United States of America,USA,0,0,0,5,5
2010,Ecuador,ECU,United States of America,USA,5,0,0,201,206
2010,Eritrea,ERI,United States of America,USA,172,0,10,83,265
2010,Estonia,EST,United States of America,USA,0,0,0,5,5
2010,Ethiopia,ETH,United States of America,USA,619,0,69,337,1025
2010,Fiji,FJI,United States of America,USA,12,0,0,13,25
2010,Gabon,GAB,United States of America,USA,5,0,5,5,15
2010,Gambia,GMB,United States of America,USA,47,0,5,128,180
2010,United Kingdom of Great Britain and Northern Ireland,GBR,United States of America,USA,0,0,0,5,5
2010,Georgia,GEO,United States of America,USA,14,0,0,21,35
2010,Germany,DEU,United States of America,USA,0,0,0,12,12
2010,Ghana,GHA,United States of America,USA,5,0,5,13,23
2010,Guinea-Bissau,GNB,United States of America,USA,0,0,0,5,5
2010,Grenada,GRD,United States of America,USA,5,0,0,10,15
2010,Guatemala,GTM,United States of America,USA,233,0,68,922,1223
2010,Guinea,GIN,United States of America,USA,120,0,10,289,419
2010,Guyana,GUY,United States of America,USA,5,0,0,12,17
2010,Haiti,HTI,United States of America,USA,522,0,73,423,1018
2010,Honduras,HND,United States of America,USA,48,0,5,169,222
2010,Hungary,HUN,United States of America,USA,5,0,0,20,25
2010,Cote d'Ivoire,CIV,United States of America,USA,37,0,5,158,200
2010,India,IND,United States of America,USA,87,0,14,457,558
2010,Indonesia,IDN,United States of America,USA,60,0,5,172,237
2010,Iran (Islamic Rep. of),IRN,United States of America,USA,309,0,10,69,388
2010,Iraq,IRQ,United States of America,USA,210,0,12,42,264
2010,Israel,ISR,United States of America,USA,5,0,0,12,17
2010,Italy,ITA,United States of America,USA,0,0,0,5,5
2010,Jamaica,JAM,United States of America,USA,49,0,0,39,88
2010,Jordan,JOR,United States of America,USA,10,0,0,24,34
2010,Japan,JPN,United States of America,USA,0,0,0,5,5
2010,Kazakhstan,KAZ,United States of America,USA,24,0,0,53,77
2010,Kenya,KEN,United States of America,USA,159,0,14,204,377
2010,Kyrgyzstan,KGZ,United States of America,USA,41,0,0,54,95
2010,Rep. of Korea,KOR,United States of America,USA,0,0,0,10,10
2010,Dem. People's Rep. of Korea,PRK,United States of America,USA,0,0,0,5,5
2010,Kuwait,KWT,United States of America,USA,0,0,0,5,5
2010,Lao People's Dem. Rep.,LAO,United States of America,USA,13,0,0,18,31
2010,Liberia,LBR,United States of America,USA,69,0,5,30,104
2010,Libya,LBY,United States of America,USA,5,0,0,0,5
2010,Saint Lucia,LCA,United States of America,USA,5,0,0,0,5
2010,Lebanon,LBN,United States of America,USA,15,0,0,11,26
2010,Sri Lanka,LKA,United States of America,USA,72,0,5,105,182
2010,Lithuania,LTU,United States of America,USA,0,0,0,5,5
2010,Latvia,LVA,United States of America,USA,0,0,0,5,5
2010,Madagascar,MDG,United States of America,USA,5,0,0,0,5
2010,Mauritania,MRT,United States of America,USA,35,0,5,96,136
2010,North Macedonia,MKD,United States of America,USA,0,0,0,10,10
2010,Rep. of Moldova,MDA,United States of America,USA,55,0,5,229,289
2010,Mexico,MEX,United States of America,USA,115,0,5,1949,2069
2010,Mali,MLI,United States of America,USA,62,0,15,172,249
2010,Malaysia,MYS,United States of America,USA,0,0,0,10,10
2010,Malawi,MWI,United States of America,USA,5,0,0,5,10
2010,Mongolia,MNG,United States of America,USA,64,0,5,109,178
2010,Morocco,MAR,United States of America,USA,0,0,0,10,10
2010,Montenegro,MNE,United States of America,USA,0,0,0,5,5
2010,Mauritius,MUS,United States of America,USA,5,0,0,10,15
2010,Myanmar,MMR,United States of America,USA,138,0,12,59,209
2010,Nepal,NPL,United States of America,USA,346,0,69,529,944
2010,Netherlands,NLD,United States of America,USA,0,0,0,5,5
2010,Niger,NER,United States of America,USA,10,0,0,18,28
2010,Nicaragua,NIC,United States of America,USA,18,0,5,32,55
2010,Nigeria,NGA,United States of America,USA,21,0,5,39,65
2010,Pakistan,PAK,United States of America,USA,119,0,12,195,326
2010,Paraguay,PRY,United States of America,USA,5,0,0,0,5
2010,Peru,PER,United States of America,USA,22,0,0,35,57
2010,Philippines,PHL,United States of America,USA,5,0,0,31,36
2010,Poland,POL,United States of America,USA,0,0,0,5,5
2010,Romania,ROU,United States of America,USA,0,0,0,56,56
2010,South Africa,ZAF,United States of America,USA,0,0,0,5,5
2010,Russian Federation,RUS,United States of America,USA,288,0,12,449,749
2010,Rwanda,RWA,United States of America,USA,78,0,5,26,109
2010,El Salvador,SLV,United States of America,USA,131,0,123,893,1147
2010,Saudi Arabia,SAU,United States of America,USA,10,0,0,0,10
2010,Serbia and Kosovo: S/RES/1244 (1999),SRB,United States of America,USA,34,0,0,87,121
2010,Senegal,SEN,United States of America,USA,10,0,0,141,151
2010,Sierra Leone,SLE,United States of America,USA,26,0,0,35,61
2010,Somalia,SOM,United States of America,USA,94,0,5,26,125
2010,Viet Nam,VNM,United States of America,USA,19,0,0,12,31
2010,Sudan,SDN,United States of America,USA,56,0,5,43,104
2010,Suriname,SUR,United States of America,USA,0,0,0,5,5
2010,Syrian Arab Rep.,SYR,United States of America,USA,14,0,0,20,34
2010,United Rep. of Tanzania,TZA,United States of America,USA,5,0,0,11,16
2010,Thailand,THA,United States of America,USA,0,0,0,10,10
2010,Tajikistan,TJK,United States of America,USA,18,0,5,30,53
2010,Turkmenistan,TKM,United States of America,USA,10,0,0,12,22
2010,Togo,TGO,United States of America,USA,16,0,0,14,30
2010,Trinidad and Tobago,TTO,United States of America,USA,5,0,0,16,21
2010,Tunisia,TUN,United States of America,USA,0,0,0,5,5
2010,Turkey,TUR,United States of America,USA,36,0,0,26,62
2010,Uganda,UGA,United States of America,USA,74,0,0,39,113
2010,Ukraine,UKR,United States of America,USA,55,0,5,131,191
2010,Uruguay,URY,United States of America,USA,0,0,0,10,10
2010,Uzbekistan,UZB,United States of America,USA,58,0,5,84,147
2010,Venezuela (Bolivarian Republic of),VEN,United States of America,USA,233,0,31,153,417
2010,Yemen,YEM,United States of America,USA,24,0,0,14,38
2010,Zambia,ZMB,United States of America,USA,0,0,0,5,5
2010,Zimbabwe,ZWE,United States of America,USA,50,0,11,58,119
2010,Stateless,XXA,United States of America,USA,36,0,5,47,88
2010,Unknown ,,United States of America,USA,0,0,0,90,90
2011,Afghanistan,AFG,United States of America,USA,104,0,0,20,124
2011,Albania,ALB,United States of America,USA,15,0,0,94,109
2011,Algeria,DZA,United States of America,USA,11,0,0,10,21
2011,Angola,AGO,United States of America,USA,10,0,0,0,10
2011,Egypt,EGY,United States of America,USA,576,0,20,238,834
2011,Argentina,ARG,United States of America,USA,0,0,0,24,24
2011,Armenia,ARM,United States of America,USA,32,0,5,56,93
2011,Azerbaijan,AZE,United States of America,USA,15,0,5,28,48
2011,Bahrain,BHR,United States of America,USA,10,0,0,0,10
2011,Burundi,BDI,United States of America,USA,20,0,5,46,71
2011,Benin,BEN,United States of America,USA,5,0,0,17,22
2011,Bangladesh,BGD,United States of America,USA,20,0,0,109,129
2011,Bahamas,BHS,United States of America,USA,0,0,0,5,5
2011,Bhutan,BTN,United States of America,USA,0,0,0,5,5
2011,Burkina Faso,BFA,United States of America,USA,46,0,17,99,162
2011,Belarus,BLR,United States of America,USA,117,0,5,178,300
2011,Bolivia (Plurinational State of),BOL,United States of America,USA,12,0,0,29,41
2011,Brazil,BRA,United States of America,USA,40,0,0,137,177
2011,Bosnia and Herzegovina,BIH,United States of America,USA,5,0,0,5,10
2011,Bulgaria,BGR,United States of America,USA,15,0,0,15,30
2011,Belize,BLZ,United States of America,USA,5,0,0,10,15
2011,Cambodia,KHM,United States of America,USA,0,0,0,5,5
2011,Canada,CAN,United States of America,USA,0,0,0,5,5
2011,Central African Rep.,CAF,United States of America,USA,5,0,0,12,17
2011,Chad,TCD,United States of America,USA,10,0,0,5,15
2011,China,CHN,United States of America,USA,3614,0,277,8235,12126
2011,Chile,CHL,United States of America,USA,0,0,0,10,10
2011,Cameroon,CMR,United States of America,USA,228,0,31,178,437
2011,Congo,COG,United States of America,USA,76,0,10,66,152
2011,Dem. Rep. of the Congo,COD,United States of America,USA,61,0,0,32,93
2011,Colombia,COL,United States of America,USA,184,0,10,186,380
2011,Costa Rica,CRI,United States of America,USA,0,0,0,10,10
2011,Cuba,CUB,United States of America,USA,15,0,0,22,37
2011,Czechia,CZE,United States of America,USA,0,0,0,5,5
2011,Djibouti,DJI,United States of America,USA,21,0,0,20,41
2011,Dominica,DMA,United States of America,USA,0,0,0,5,5
2011,Dominican Rep.,DOM,United States of America,USA,0,0,0,16,16
2011,Ecuador,ECU,United States of America,USA,10,0,0,408,418
2011,Eritrea,ERI,United States of America,USA,159,0,5,34,198
2011,Estonia,EST,United States of America,USA,0,0,0,5,5
2011,Ethiopia,ETH,United States of America,USA,516,0,66,268,850
2011,Fiji,FJI,United States of America,USA,5,0,0,5,10
2011,France,FRA,United States of America,USA,0,0,0,5,5
2011,Gabon,GAB,United States of America,USA,0,0,0,5,5
2011,Gambia,GMB,United States of America,USA,70,0,5,178,253
2011,United Kingdom of Great Britain and Northern Ireland,GBR,United States of America,USA,0,0,0,5,5
2011,Georgia,GEO,United States of America,USA,10,0,0,25,35
2011,Germany,DEU,United States of America,USA,0,0,0,10,10
2011,Ghana,GHA,United States of America,USA,5,0,0,32,37
2011,Guinea-Bissau,GNB,United States of America,USA,0,0,0,5,5
2011,Grenada,GRD,United States of America,USA,0,0,0,14,14
2011,Guatemala,GTM,United States of America,USA,315,0,42,1236,1593
2011,Guinea,GIN,United States of America,USA,75,0,5,171,251
2011,Guyana,GUY,United States of America,USA,0,0,0,5,5
2011,Haiti,HTI,United States of America,USA,541,0,59,268,868
2011,Honduras,HND,United States of America,USA,66,0,19,265,350
2011,Croatia,HRV,United States of America,USA,0,0,0,5,5
2011,Hungary,HUN,United States of America,USA,0,0,0,18,18
2011,Cote d'Ivoire,CIV,United States of America,USA,129,0,28,202,359
2011,India,IND,United States of America,USA,80,0,5,401,486
2011,Indonesia,IDN,United States of America,USA,72,0,5,207,284
2011,Iran (Islamic Rep. of),IRN,United States of America,USA,336,0,15,65,416
2011,Iraq,IRQ,United States of America,USA,230,0,27,60,317
2011,Israel,ISR,United States of America,USA,5,0,0,10,15
2011,Italy,ITA,United States of America,USA,0,0,0,5,5
2011,Jamaica,JAM,United States of America,USA,43,0,0,62,105
2011,Jordan,JOR,United States of America,USA,14,0,0,14,28
2011,Japan,JPN,United States of America,USA,0,0,0,5,5
2011,Kazakhstan,KAZ,United States of America,USA,46,0,5,60,111
2011,Kenya,KEN,United States of America,USA,91,0,23,140,254
2011,Kyrgyzstan,KGZ,United States of America,USA,107,0,29,155,291
2011,Rep. of Korea,KOR,United States of America,USA,0,0,0,5,5
2011,Dem. People's Rep. of Korea,PRK,United States of America,USA,0,0,0,5,5
2011,Kuwait,KWT,United States of America,USA,5,0,0,5,10
2011,Lao People's Dem. Rep.,LAO,United States of America,USA,0,0,0,5,5
2011,Liberia,LBR,United States of America,USA,51,0,0,32,83
2011,Libya,LBY,United States of America,USA,52,0,30,50,132
2011,Lebanon,LBN,United States of America,USA,13,0,0,20,33
2011,Sri Lanka,LKA,United States of America,USA,31,0,0,100,131
2011,Lithuania,LTU,United States of America,USA,0,0,0,10,10
2011,Latvia,LVA,United States of America,USA,0,0,0,10,10
2011,Mauritania,MRT,United States of America,USA,27,0,5,92,124
2011,North Macedonia,MKD,United States of America,USA,5,0,0,19,24
2011,Rep. of Moldova,MDA,United States of America,USA,100,0,0,146,246
2011,Mexico,MEX,United States of America,USA,230,0,5,3903,4138
2011,Mali,MLI,United States of America,USA,52,0,17,209,278
2011,Malaysia,MYS,United States of America,USA,5,0,0,23,28
2011,Malawi,MWI,United States of America,USA,0,0,0,5,5
2011,Mongolia,MNG,United States of America,USA,70,0,5,103,178
2011,Morocco,MAR,United States of America,USA,10,0,0,10,20
2011,Montenegro,MNE,United States of America,USA,0,0,0,5,5
2011,Mauritius,MUS,United States of America,USA,5,0,0,10,15
2011,Myanmar,MMR,United States of America,USA,139,0,13,61,213
2011,Namibia,NAM,United States of America,USA,25,0,13,58,96
2011,Nepal,NPL,United States of America,USA,351,0,98,491,940
2011,Niger,NER,United States of America,USA,5,0,5,32,42
2011,Nicaragua,NIC,United States of America,USA,16,0,0,39,55
2011,Nigeria,NGA,United States of America,USA,29,0,5,53,87
2011,Pakistan,PAK,United States of America,USA,169,0,5,195,369
2011,Panama,PAN,United States of America,USA,5,0,0,0,5
2011,Peru,PER,United States of America,USA,27,0,0,85,112
2011,Philippines,PHL,United States of America,USA,0,0,0,130,130
2011,Poland,POL,United States of America,USA,0,0,0,5,5
2011,Portugal,PRT,United States of America,USA,0,0,0,5,5
2011,Romania,ROU,United States of America,USA,10,0,0,18,28
2011,South Africa,ZAF,United States of America,USA,0,0,0,5,5
2011,Russian Federation,RUS,United States of America,USA,337,0,23,371,731
2011,Rwanda,RWA,United States of America,USA,68,0,10,59,137
2011,El Salvador,SLV,United States of America,USA,113,0,108,863,1084
2011,Saudi Arabia,SAU,United States of America,USA,5,0,0,5,10
2011,Serbia and Kosovo: S/RES/1244 (1999),SRB,United States of America,USA,20,0,0,63,83
2011,Senegal,SEN,United States of America,USA,10,0,0,136,146
2011,Sierra Leone,SLE,United States of America,USA,16,0,0,22,38
2011,Somalia,SOM,United States of America,USA,50,0,0,22,72
2011,Spain,ESP,United States of America,USA,0,0,0,5,5
2011,Viet Nam,VNM,United States of America,USA,16,0,0,5,21
2011,Sudan,SDN,United States of America,USA,92,0,12,42,146
2011,Suriname,SUR,United States of America,USA,0,0,0,5,5
2011,Slovakia,SVK,United States of America,USA,0,0,0,5,5
2011,Syrian Arab Rep.,SYR,United States of America,USA,61,0,10,52,123
2011,United Rep. of Tanzania,TZA,United States of America,USA,10,0,0,13,23
2011,Thailand,THA,United States of America,USA,5,0,0,5,10
2011,Tajikistan,TJK,United States of America,USA,24,0,0,36,60
2011,Turkmenistan,TKM,United States of America,USA,12,0,0,10,22
2011,Togo,TGO,United States of America,USA,18,0,0,31,49
2011,Trinidad and Tobago,TTO,United States of America,USA,5,0,0,33,38
2011,Tunisia,TUN,United States of America,USA,5,0,0,5,10
2011,Turkey,TUR,United States of America,USA,25,0,5,28,58
2011,United Arab Emirates,ARE,United States of America,USA,5,0,0,0,5
2011,Uganda,UGA,United States of America,USA,102,0,0,60,162
2011,Ukraine,UKR,United States of America,USA,100,0,5,138,243
2011,Uruguay,URY,United States of America,USA,0,0,0,5,5
2011,Uzbekistan,UZB,United States of America,USA,77,0,5,109,191
2011,Venezuela (Bolivarian Republic of),VEN,United States of America,USA,437,0,33,198,668
2011,Yemen,YEM,United States of America,USA,24,0,0,43,67
2011,Zambia,ZMB,United States of America,USA,5,0,0,0,5
2011,Zimbabwe,ZWE,United States of America,USA,59,0,11,40,110
2011,Unknown ,,United States of America,USA,51,0,5,141,197
2012,Afghanistan,AFG,United States of America,USA,118,0,5,25,148
2012,Albania,ALB,United States of America,USA,17,0,5,91,113
2012,Algeria,DZA,United States of America,USA,10,0,0,10,20
2012,Angola,AGO,United States of America,USA,10,0,0,10,20
2012,Antigua and Barbuda,ATG,United States of America,USA,0,0,0,5,5
2012,Egypt,EGY,United States of America,USA,1475,0,30,247,1752
2012,Argentina,ARG,United States of America,USA,0,0,0,28,28
2012,Armenia,ARM,United States of America,USA,40,0,0,38,78
2012,Azerbaijan,AZE,United States of America,USA,15,0,0,12,27
2012,Bahrain,BHR,United States of America,USA,14,0,0,0,14
2012,Burundi,BDI,United States of America,USA,19,0,5,32,56
2012,Benin,BEN,United States of America,USA,0,0,0,12,12
2012,Bangladesh,BGD,United States of America,USA,22,0,0,106,128
2012,Bahamas,BHS,United States of America,USA,0,0,0,5,5
2012,Bhutan,BTN,United States of America,USA,0,0,0,10,10
2012,Burkina Faso,BFA,United States of America,USA,54,0,14,126,194
2012,Belarus,BLR,United States of America,USA,169,0,10,136,315
2012,Bolivia (Plurinational State of),BOL,United States of America,USA,13,0,0,30,43
2012,Brazil,BRA,United States of America,USA,37,0,0,160,197
2012,Bosnia and Herzegovina,BIH,United States of America,USA,5,0,0,0,5
2012,Bulgaria,BGR,United States of America,USA,16,0,0,14,30
2012,Belize,BLZ,United States of America,USA,0,0,0,10,10
2012,Cambodia,KHM,United States of America,USA,5,0,0,0,5
2012,Canada,CAN,United States of America,USA,0,0,0,5,5
2012,Central African Rep.,CAF,United States of America,USA,10,0,0,12,22
2012,Chad,TCD,United States of America,USA,5,0,0,10,15
2012,China,CHN,United States of America,USA,4523,0,302,7811,12636
2012,Chile,CHL,United States of America,USA,5,0,0,15,20
2012,Cameroon,CMR,United States of America,USA,244,0,42,190,476
2012,Congo,COG,United States of America,USA,81,0,21,57,159
2012,Dem. Rep. of the Congo,COD,United States of America,USA,72,0,5,30,107
2012,Colombia,COL,United States of America,USA,182,0,5,172,359
2012,Costa Rica,CRI,United States of America,USA,0,0,0,5,5
2012,Cuba,CUB,United States of America,USA,25,0,5,24,54
2012,Djibouti,DJI,United States of America,USA,10,0,0,11,21
2012,Dominica,DMA,United States of America,USA,0,0,0,10,10
2012,Dominican Rep.,DOM,United States of America,USA,5,0,0,55,60
2012,Ecuador,ECU,United States of America,USA,15,0,0,681,696
2012,Eritrea,ERI,United States of America,USA,115,0,5,12,132
2012,Estonia,EST,United States of America,USA,225,0,23,112,360
2012,Ethiopia,ETH,United States of America,USA,420,0,37,171,628
2012,Fiji,FJI,United States of America,USA,13,0,0,5,18
2012,France,FRA,United States of America,USA,0,0,0,10,10
2012,Gabon,GAB,United States of America,USA,5,0,0,5,10
2012,Gambia,GMB,United States of America,USA,118,0,10,162,290
2012,United Kingdom of Great Britain and Northern Ireland,GBR,United States of America,USA,0,0,0,10,10
2012,Georgia,GEO,United States of America,USA,13,0,0,14,27
2012,Germany,DEU,United States of America,USA,0,0,0,10,10
2012,Ghana,GHA,United States of America,USA,10,0,0,23,33
2012,Guinea-Bissau,GNB,United States of America,USA,0,0,0,5,5
2012,Grenada,GRD,United States of America,USA,0,0,0,15,15
2012,Guatemala,GTM,United States of America,USA,287,0,10,1119,1416
2012,Guinea,GIN,United States of America,USA,42,0,5,113,160
2012,Guyana,GUY,United States of America,USA,5,0,0,19,24
2012,Haiti,HTI,United States of America,USA,546,0,52,259,857
2012,"China, Hong Kong SAR",HKG,United States of America,USA,0,0,0,5,5
2012,Honduras,HND,United States of America,USA,95,0,5,300,400
2012,Croatia,HRV,United States of America,USA,5,0,0,0,5
2012,Hungary,HUN,United States of America,USA,0,0,0,5,5
2012,Cote d'Ivoire,CIV,United States of America,USA,98,0,12,110,220
2012,India,IND,United States of America,USA,84,0,10,448,542
2012,Indonesia,IDN,United States of America,USA,63,0,5,117,185
2012,Iran (Islamic Rep. of),IRN,United States of America,USA,478,0,11,74,563
2012,Iraq,IRQ,United States of America,USA,258,0,28,64,350
2012,Israel,ISR,United States of America,USA,5,0,0,24,29
2012,Jamaica,JAM,United States of America,USA,49,0,0,48,97
2012,Jordan,JOR,United States of America,USA,24,0,0,19,43
2012,Japan,JPN,United States of America,USA,0,0,5,5,10
2012,Kazakhstan,KAZ,United States of America,USA,65,0,5,82,152
2012,Kenya,KEN,United States of America,USA,120,0,16,103,239
2012,Kyrgyzstan,KGZ,United States of America,USA,117,0,5,124,246
2012,Rep. of Korea,KOR,United States of America,USA,0,0,0,10,10
2012,Kuwait,KWT,United States of America,USA,5,0,0,0,5
2012,Lao People's Dem. Rep.,LAO,United States of America,USA,5,0,0,5,10
2012,Liberia,LBR,United States of America,USA,48,0,5,46,99
2012,Libya,LBY,United States of America,USA,20,0,19,15,54
2012,Lebanon,LBN,United States of America,USA,16,0,0,18,34
2012,Sri Lanka,LKA,United States of America,USA,36,0,5,65,106
2012,Latvia,LVA,United States of America,USA,0,0,0,10,10
2012,Mauritania,MRT,United States of America,USA,36,0,0,27,63
2012,North Macedonia,MKD,United States of America,USA,5,0,0,17,22
2012,Rep. of Moldova,MDA,United States of America,USA,122,0,5,138,265
2012,Mexico,MEX,United States of America,USA,412,0,5,5138,5555
2012,Mali,MLI,United States of America,USA,69,0,12,124,205
2012,Malaysia,MYS,United States of America,USA,10,0,0,19,29
2012,Mongolia,MNG,United States of America,USA,47,0,5,62,114
2012,Morocco,MAR,United States of America,USA,10,0,0,10,20
2012,Montenegro,MNE,United States of America,USA,5,0,0,0,5
2012,Mauritius,MUS,United States of America,USA,0,0,0,10,10
2012,Myanmar,MMR,United States of America,USA,73,0,5,50,128
2012,Nepal,NPL,United States of America,USA,534,0,133,491,1158
2012,Netherlands,NLD,United States of America,USA,0,0,0,5,5
2012,Niger,NER,United States of America,USA,0,0,0,20,20
2012,Nicaragua,NIC,United States of America,USA,23,0,0,37,60
2012,Nigeria,NGA,United States of America,USA,59,0,5,76,140
2012,Pakistan,PAK,United States of America,USA,149,0,5,152,306
2012,Panama,PAN,United States of America,USA,0,0,0,5,5
2012,Paraguay,PRY,United States of America,USA,0,0,0,5,5
2012,Peru,PER,United States of America,USA,24,0,0,104,128
2012,Philippines,PHL,United States of America,USA,5,0,0,116,121
2012,Poland,POL,United States of America,USA,0,0,0,12,12
2012,Romania,ROU,United States of America,USA,5,0,0,14,19
2012,South Africa,ZAF,United States of America,USA,10,0,0,5,15
2012,Russian Federation,RUS,United States of America,USA,357,0,16,274,647
2012,Rwanda,RWA,United States of America,USA,74,0,5,50,129
2012,El Salvador,SLV,United States of America,USA,144,0,67,795,1006
2012,Saudi Arabia,SAU,United States of America,USA,31,0,5,10,46
2012,Serbia and Kosovo: S/RES/1244 (1999),SRB,United States of America,USA,45,0,0,82,127
2012,Senegal,SEN,United States of America,USA,19,0,0,98,117
2012,Sierra Leone,SLE,United States of America,USA,12,0,0,25,37
2012,Somalia,SOM,United States of America,USA,47,0,0,10,57
2012,Viet Nam,VNM,United States of America,USA,11,0,0,5,16
2012,Saint Kitts and Nevis,KNA,United States of America,USA,0,0,0,5,5
2012,Sudan,SDN,United States of America,USA,99,0,10,33,142
2012,Slovakia,SVK,United States of America,USA,5,0,0,0,5
2012,Syrian Arab Rep.,SYR,United States of America,USA,316,0,21,89,426
2012,United Rep. of Tanzania,TZA,United States of America,USA,10,0,0,10,20
2012,Thailand,THA,United States of America,USA,5,0,0,5,10
2012,Tajikistan,TJK,United States of America,USA,20,0,0,29,49
2012,Turkmenistan,TKM,United States of America,USA,5,0,0,13,18
2012,Togo,TGO,United States of America,USA,27,0,5,27,59
2012,Trinidad and Tobago,TTO,United States of America,USA,5,0,0,27,32
2012,Tunisia,TUN,United States of America,USA,5,0,0,5,10
2012,Turkey,TUR,United States of America,USA,35,0,0,24,59
2012,United Arab Emirates,ARE,United States of America,USA,5,0,0,0,5
2012,Uganda,UGA,United States of America,USA,80,0,11,35,126
2012,Ukraine,UKR,United States of America,USA,106,0,5,135,246
2012,Uruguay,URY,United States of America,USA,0,0,0,5,5
2012,Uzbekistan,UZB,United States of America,USA,66,0,5,58,129
2012,Venezuela (Bolivarian Republic of),VEN,United States of America,USA,492,0,33,153,678
2012,Yemen,YEM,United States of America,USA,30,0,5,28,63
2012,Zimbabwe,ZWE,United States of America,USA,45,0,12,36,93
2012,Unknown ,,United States of America,USA,48,0,5,70,123
2013,Afghanistan,AFG,United States of America,USA,98,0,5,31,134
2013,Albania,ALB,United States of America,USA,10,0,0,86,96
2013,Algeria,DZA,United States of America,USA,5,0,0,5,10
2013,Angola,AGO,United States of America,USA,5,0,0,14,19
2013,Egypt,EGY,United States of America,USA,1756,0,18,183,1957
2013,Argentina,ARG,United States of America,USA,0,0,0,11,11
2013,Armenia,ARM,United States of America,USA,63,0,5,42,110
2013,Azerbaijan,AZE,United States of America,USA,13,0,0,15,28
2013,Barbados,BRB,United States of America,USA,0,0,0,5,5
2013,Burundi,BDI,United States of America,USA,27,0,0,28,55
2013,Benin,BEN,United States of America,USA,0,0,0,21,21
2013,Bangladesh,BGD,United States of America,USA,37,0,5,101,143
2013,Bhutan,BTN,United States of America,USA,0,0,0,10,10
2013,Burkina Faso,BFA,United States of America,USA,61,0,14,163,238
2013,Belarus,BLR,United States of America,USA,79,0,5,90,174
2013,Bolivia (Plurinational State of),BOL,United States of America,USA,5,0,0,16,21
2013,Brazil,BRA,United States of America,USA,26,0,0,78,104
2013,Bosnia and Herzegovina,BIH,United States of America,USA,5,0,0,5,10
2013,Bulgaria,BGR,United States of America,USA,11,0,0,5,16
2013,Belize,BLZ,United States of America,USA,0,0,0,5,5
2013,Canada,CAN,United States of America,USA,0,0,0,5,5
2013,Central African Rep.,CAF,United States of America,USA,12,0,0,11,23
2013,Chad,TCD,United States of America,USA,5,0,0,5,10
2013,China,CHN,United States of America,USA,3348,0,227,4717,8292
2013,Chile,CHL,United States of America,USA,0,0,0,5,5
2013,Cameroon,CMR,United States of America,USA,160,0,21,100,281
2013,Congo,COG,United States of America,USA,81,0,5,63,149
2013,Dem. Rep. of the Congo,COD,United States of America,USA,50,0,5,35,90
2013,Costa Rica,CRI,United States of America,USA,119,0,5,130,254
2013,Cuba,CUB,United States of America,USA,0,0,0,14,14
2013,Djibouti,DJI,United States of America,USA,22,0,0,5,27
2013,Dominican Rep.,DOM,United States of America,USA,5,0,0,25,30
2013,Ecuador,ECU,United States of America,USA,10,0,0,720,730
2013,Eritrea,ERI,United States of America,USA,77,0,0,23,100
2013,Ethiopia,ETH,United States of America,USA,402,0,28,237,667
2013,Fiji,FJI,United States of America,USA,5,0,0,5,10
2013,France,FRA,United States of America,USA,0,0,0,5,5
2013,Gambia,GMB,United States of America,USA,52,0,0,48,100
2013,Georgia,GEO,United States of America,USA,14,0,0,11,25
2013,Germany,DEU,United States of America,USA,5,0,0,5,10
2013,Ghana,GHA,United States of America,USA,10,0,0,16,26
2013,Guinea-Bissau,GNB,United States of America,USA,5,0,0,0,5
2013,Greece,GRC,United States of America,USA,0,0,0,5,5
2013,Grenada,GRD,United States of America,USA,0,0,0,5,5
2013,Guatemala,GTM,United States of America,USA,208,0,5,723,936
2013,Guinea,GIN,United States of America,USA,25,0,0,42,67
2013,Guyana,GUY,United States of America,USA,5,0,0,5,10
2013,Haiti,HTI,United States of America,USA,324,0,41,240,605
2013,Honduras,HND,United States of America,USA,73,0,10,248,331
2013,Croatia,HRV,United States of America,USA,5,0,0,0,5
2013,Hungary,HUN,United States of America,USA,0,0,0,10,10
2013,Cote d'Ivoire,CIV,United States of America,USA,51,0,10,65,126
2013,India,IND,United States of America,USA,80,0,5,260,345
2013,Indonesia,IDN,United States of America,USA,40,0,0,64,104
2013,Iran (Islamic Rep. of),IRN,United States of America,USA,498,0,5,60,563
2013,Iraq,IRQ,United States of America,USA,390,0,20,71,481
2013,Israel,ISR,United States of America,USA,5,0,0,12,17
2013,Jamaica,JAM,United States of America,USA,35,0,0,18,53
2013,Jordan,JOR,United States of America,USA,16,0,5,24,45
2013,Kazakhstan,KAZ,United States of America,USA,35,0,5,71,111
2013,Kenya,KEN,United States of America,USA,77,0,0,45,122
2013,Kyrgyzstan,KGZ,United States of America,USA,64,0,5,142,211
2013,Rep. of Korea,KOR,United States of America,USA,0,0,0,10,10
2013,Kuwait,KWT,United States of America,USA,5,0,0,0,5
2013,Liberia,LBR,United States of America,USA,68,0,0,20,88
2013,Libya,LBY,United States of America,USA,15,0,12,10,37
2013,Lebanon,LBN,United States of America,USA,12,0,0,20,32
2013,Sri Lanka,LKA,United States of America,USA,26,0,0,68,94
2013,Lithuania,LTU,United States of America,USA,0,0,0,5,5
2013,Mauritania,MRT,United States of America,USA,30,0,0,34,64
2013,North Macedonia,MKD,United States of America,USA,12,0,0,11,23
2013,Rep. of Moldova,MDA,United States of America,USA,64,0,0,92,156
2013,Mexico,MEX,United States of America,USA,284,0,5,3686,3975
2013,Mali,MLI,United States of America,USA,47,0,18,90,155
2013,Malaysia,MYS,United States of America,USA,5,0,0,14,19
2013,Mongolia,MNG,United States of America,USA,27,0,0,21,48
2013,Morocco,MAR,United States of America,USA,5,0,0,5,10
2013,Montenegro,MNE,United States of America,USA,0,0,0,5,5
2013,Myanmar,MMR,United States of America,USA,53,0,0,28,81
2013,Nepal,NPL,United States of America,USA,366,0,55,353,774
2013,Niger,NER,United States of America,USA,5,0,5,13,23
2013,Nicaragua,NIC,United States of America,USA,5,0,0,18,23
2013,Nigeria,NGA,United States of America,USA,49,0,5,33,87
2013,Pakistan,PAK,United States of America,USA,190,0,5,140,335
2013,Peru,PER,United States of America,USA,14,0,0,58,72
2013,Philippines,PHL,United States of America,USA,5,0,0,53,58
2013,Poland,POL,United States of America,USA,0,0,0,13,13
2013,Portugal,PRT,United States of America,USA,0,0,0,5,5
2013,Romania,ROU,United States of America,USA,0,0,0,10,10
2013,South Africa,ZAF,United States of America,USA,0,0,0,5,5
2013,Russian Federation,RUS,United States of America,USA,215,0,10,172,397
2013,Rwanda,RWA,United States of America,USA,40,0,5,65,110
2013,El Salvador,SLV,United States of America,USA,76,0,29,596,701
2013,Saudi Arabia,SAU,United States of America,USA,25,0,0,5,30
2013,Serbia and Kosovo: S/RES/1244 (1999),SRB,United States of America,USA,32,0,5,75,112
2013,Senegal,SEN,United States of America,USA,5,0,0,41,46
2013,Sierra Leone,SLE,United States of America,USA,11,0,0,5,16
2013,Somalia,SOM,United States of America,USA,44,0,0,10,54
2013,Viet Nam,VNM,United States of America,USA,10,0,0,0,10
2013,Sudan,SDN,United States of America,USA,67,0,5,32,104
2013,Syrian Arab Rep.,SYR,United States of America,USA,576,0,55,137,768
2013,United Rep. of Tanzania,TZA,United States of America,USA,10,0,0,5,15
2013,Tajikistan,TJK,United States of America,USA,12,0,0,40,52
2013,Turkmenistan,TKM,United States of America,USA,5,0,0,12,17
2013,Togo,TGO,United States of America,USA,32,0,0,13,45
2013,Trinidad and Tobago,TTO,United States of America,USA,5,0,0,10,15
2013,Tunisia,TUN,United States of America,USA,5,0,0,5,10
2013,Turkey,TUR,United States of America,USA,14,0,0,15,29
2013,Uganda,UGA,United States of America,USA,54,0,0,24,78
2013,Ukraine,UKR,United States of America,USA,69,0,5,84,158
2013,Uzbekistan,UZB,United States of America,USA,37,0,5,75,117
2013,Venezuela (Bolivarian Republic of),VEN,United States of America,USA,255,0,18,94,367
2013,Yemen,YEM,United States of America,USA,26,0,5,21,52
2013,Zimbabwe,ZWE,United States of America,USA,30,0,5,19,54
2013,Curacao ,CUW,United States of America,USA,26,0,0,14,40
2013,Unknown ,,United States of America,USA,35,0,5,39,79
2014,Afghanistan,AFG,United States of America,USA,155,0,5,30,190
2014,Albania,ALB,United States of America,USA,25,0,5,110,140
2014,Algeria,DZA,United States of America,USA,10,0,0,10,20
2014,Angola,AGO,United States of America,USA,10,0,0,20,30
2014,Egypt,EGY,United States of America,USA,1207,0,36,179,1422
2014,Argentina,ARG,United States of America,USA,5,0,5,14,24
2014,Armenia,ARM,United States of America,USA,69,0,15,56,140
2014,Azerbaijan,AZE,United States of America,USA,18,0,0,14,32
2014,Bahrain,BHR,United States of America,USA,5,0,0,0,5
2014,Burundi,BDI,United States of America,USA,83,0,0,45,128
2014,Benin,BEN,United States of America,USA,5,0,5,5,15
2014,Bangladesh,BGD,United States of America,USA,103,0,55,220,378
2014,Bhutan,BTN,United States of America,USA,0,0,0,5,5
2014,Burkina Faso,BFA,United States of America,USA,66,0,18,167,251
2014,Belarus,BLR,United States of America,USA,55,0,11,39,105
2014,Bolivia (Plurinational State of),BOL,United States of America,USA,5,0,10,19,34
2014,Brazil,BRA,United States of America,USA,28,0,54,52,134
2014,Bosnia and Herzegovina,BIH,United States of America,USA,10,0,5,0,15
2014,Bulgaria,BGR,United States of America,USA,14,0,5,10,29
2014,Belize,BLZ,United States of America,USA,0,0,5,5,10
2014,Cambodia,KHM,United States of America,USA,5,0,0,0,5
2014,Central African Rep.,CAF,United States of America,USA,14,0,5,10,29
2014,Chad,TCD,United States of America,USA,14,0,5,5,24
2014,China,CHN,United States of America,USA,2927,0,1136,4103,8166
2014,Chile,CHL,United States of America,USA,0,0,0,5,5
2014,Cameroon,CMR,United States of America,USA,170,0,37,111,318
2014,Congo,COG,United States of America,USA,57,0,18,58,133
2014,Dem. Rep. of the Congo,COD,United States of America,USA,58,0,10,43,111
2014,Colombia,COL,United States of America,USA,138,0,37,111,286
2014,Costa Rica,CRI,United States of America,USA,0,0,10,5,15
2014,Cuba,CUB,United States of America,USA,12,0,5,17,34
2014,Djibouti,DJI,United States of America,USA,24,0,0,10,34
2014,Dominican Rep.,DOM,United States of America,USA,10,0,14,16,40
2014,Ecuador,ECU,United States of America,USA,55,0,538,625,1218
2014,Eritrea,ERI,United States of America,USA,195,0,5,27,227
2014,Ethiopia,ETH,United States of America,USA,530,0,58,341,929
2014,Fiji,FJI,United States of America,USA,12,0,5,5,22
2014,Gabon,GAB,United States of America,USA,0,0,0,5,5
2014,Gambia,GMB,United States of America,USA,71,0,29,31,131
2014,Georgia,GEO,United States of America,USA,10,0,5,17,32
2014,Germany,DEU,United States of America,USA,5,0,0,5,10
2014,Ghana,GHA,United States of America,USA,12,0,5,10,27
2014,Guinea-Bissau,GNB,United States of America,USA,5,0,0,0,5
2014,Grenada,GRD,United States of America,USA,0,0,5,5,10
2014,Guatemala,GTM,United States of America,USA,619,0,298,1028,1945
2014,Guinea,GIN,United States of America,USA,41,0,26,26,93
2014,Guyana,GUY,United States of America,USA,5,0,5,5,15
2014,Haiti,HTI,United States of America,USA,482,0,43,439,964
2014,Honduras,HND,United States of America,USA,267,0,114,503,884
2014,Hungary,HUN,United States of America,USA,0,0,0,5,5
2014,Cote d'Ivoire,CIV,United States of America,USA,31,0,13,31,75
2014,India,IND,United States of America,USA,132,0,162,247,541
2014,Indonesia,IDN,United States of America,USA,25,0,25,25,75
2014,Iran (Islamic Rep. of),IRN,United States of America,USA,483,0,19,106,608
2014,Iraq,IRQ,United States of America,USA,422,0,10,101,533
2014,Israel,ISR,United States of America,USA,0,0,10,5,15
2014,Italy,ITA,United States of America,USA,0,0,0,5,5
2014,Jamaica,JAM,United States of America,USA,36,0,10,11,57
2014,Jordan,JOR,United States of America,USA,26,0,5,19,50
2014,Kazakhstan,KAZ,United States of America,USA,47,0,10,54,111
2014,Kenya,KEN,United States of America,USA,85,0,18,44,147
2014,Kyrgyzstan,KGZ,United States of America,USA,85,0,15,153,253
2014,Rep. of Korea,KOR,United States of America,USA,0,0,0,5,5
2014,Kuwait,KWT,United States of America,USA,11,0,0,0,11
2014,Lao People's Dem. Rep.,LAO,United States of America,USA,5,0,5,0,10
2014,Liberia,LBR,United States of America,USA,76,0,5,23,104
2014,Libya,LBY,United States of America,USA,16,0,5,10,31
2014,Lebanon,LBN,United States of America,USA,15,0,5,19,39
2014,Sri Lanka,LKA,United States of America,USA,19,0,13,51,83
2014,Madagascar,MDG,United States of America,USA,5,0,0,0,5
2014,Mauritania,MRT,United States of America,USA,44,0,5,63,112
2014,North Macedonia,MKD,United States of America,USA,10,0,5,0,15
2014,Rep. of Moldova,MDA,United States of America,USA,51,0,0,78,129
2014,Mexico,MEX,United States of America,USA,564,0,1714,2600,4878
2014,Mali,MLI,United States of America,USA,46,0,23,40,109
2014,Malaysia,MYS,United States of America,USA,10,0,18,5,33
2014,Malawi,MWI,United States of America,USA,0,0,0,5,5
2014,Mongolia,MNG,United States of America,USA,29,0,14,17,60
2014,Morocco,MAR,United States of America,USA,5,0,0,5,10
2014,Mauritius,MUS,United States of America,USA,5,0,0,0,5
2014,Myanmar,MMR,United States of America,USA,39,0,5,36,80
2014,Nepal,NPL,United States of America,USA,229,0,125,252,606
2014,Niger,NER,United States of America,USA,10,0,5,0,15
2014,Nicaragua,NIC,United States of America,USA,19,0,5,17,41
2014,Nigeria,NGA,United States of America,USA,62,0,15,41,118
2014,Pakistan,PAK,United States of America,USA,161,0,26,105,292
2014,Paraguay,PRY,United States of America,USA,0,0,0,5,5
2014,Peru,PER,United States of America,USA,11,0,30,51,92
2014,Philippines,PHL,United States of America,USA,0,0,15,10,25
2014,Poland,POL,United States of America,USA,0,0,20,0,20
2014,Romania,ROU,United States of America,USA,10,0,5,19,34
2014,South Africa,ZAF,United States of America,USA,0,0,0,5,5
2014,Russian Federation,RUS,United States of America,USA,177,0,32,150,359
2014,Rwanda,RWA,United States of America,USA,59,0,5,25,89
2014,El Salvador,SLV,United States of America,USA,567,0,203,1018,1788
2014,Saudi Arabia,SAU,United States of America,USA,20,0,0,16,36
2014,Serbia and Kosovo: S/RES/1244 (1999),SRB,United States of America,USA,65,0,18,78,161
2014,Senegal,SEN,United States of America,USA,15,0,19,12,46
2014,Sierra Leone,SLE,United States of America,USA,15,0,5,5,25
2014,Somalia,SOM,United States of America,USA,46,0,0,10,56
2014,Viet Nam,VNM,United States of America,USA,10,0,5,5,20
2014,Sudan,SDN,United States of America,USA,76,0,5,34,115
2014,Syrian Arab Rep.,SYR,United States of America,USA,652,0,38,130,820
2014,United Rep. of Tanzania,TZA,United States of America,USA,5,0,0,5,10
2014,Tajikistan,TJK,United States of America,USA,13,0,5,14,32
2014,Turkmenistan,TKM,United States of America,USA,5,0,0,5,10
2014,Togo,TGO,United States of America,USA,28,0,0,5,33
2014,Trinidad and Tobago,TTO,United States of America,USA,0,0,12,5,17
2014,Tunisia,TUN,United States of America,USA,5,0,0,5,10
2014,Turkey,TUR,United States of America,USA,13,0,5,5,23
2014,Uganda,UGA,United States of America,USA,71,0,5,18,94
2014,Ukraine,UKR,United States of America,USA,94,0,44,141,279
2014,Uzbekistan,UZB,United States of America,USA,40,0,11,72,123
2014,Saint Vincent and the Grenadines,VCT,United States of America,USA,0,0,5,0,5
2014,Venezuela (Bolivarian Republic of),VEN,United States of America,USA,226,0,36,125,387
2014,Yemen,YEM,United States of America,USA,36,0,5,17,58
2014,Zimbabwe,ZWE,United States of America,USA,27,0,5,18,50
2014,Unknown ,,United States of America,USA,34,0,10,21,65
2015,Afghanistan,AFG,United States of America,USA,131,0,0,39,170
2015,Albania,ALB,United States of America,USA,28,0,0,55,83
2015,Algeria,DZA,United States of America,USA,5,0,0,5,10
2015,Angola,AGO,United States of America,USA,18,0,0,40,58
2015,Egypt,EGY,United States of America,USA,696,0,10,239,945
2015,Argentina,ARG,United States of America,USA,0,0,0,5,5
2015,Armenia,ARM,United States of America,USA,31,0,5,37,73
2015,Azerbaijan,AZE,United States of America,USA,10,0,0,14,24
2015,Bahrain,BHR,United States of America,USA,0,0,0,5,5
2015,Burundi,BDI,United States of America,USA,69,0,0,55,124
2015,Benin,BEN,United States of America,USA,5,0,0,10,15
2015,Bangladesh,BGD,United States of America,USA,62,0,5,170,237
2015,Bhutan,BTN,United States of America,USA,5,0,0,5,10
2015,Burkina Faso,BFA,United States of America,USA,42,0,5,84,131
2015,Belarus,BLR,United States of America,USA,53,0,0,44,97
2015,Bolivia (Plurinational State of),BOL,United States of America,USA,0,0,0,22,22
2015,Brazil,BRA,United States of America,USA,17,0,0,130,147
2015,Bosnia and Herzegovina,BIH,United States of America,USA,5,0,0,10,15
2015,Bulgaria,BGR,United States of America,USA,10,0,0,11,21
2015,Belize,BLZ,United States of America,USA,5,0,0,5,10
2015,Cambodia,KHM,United States of America,USA,0,0,0,5,5
2015,Central African Rep.,CAF,United States of America,USA,21,0,0,5,26
2015,Chad,TCD,United States of America,USA,10,0,0,10,20
2015,China,CHN,United States of America,USA,1916,0,80,3448,5444
2015,Chile,CHL,United States of America,USA,0,0,0,10,10
2015,Cameroon,CMR,United States of America,USA,120,0,10,76,206
2015,Congo,COG,United States of America,USA,80,0,10,68,158
2015,Dem. Rep. of the Congo,COD,United States of America,USA,81,0,0,55,136
2015,Colombia,COL,United States of America,USA,115,0,5,122,242
2015,Costa Rica,CRI,United States of America,USA,0,0,0,16,16
2015,Cuba,CUB,United States of America,USA,5,0,0,22,27
2015,Djibouti,DJI,United States of America,USA,39,0,0,19,58
2015,Dominica,DMA,United States of America,USA,0,0,0,5,5
2015,Dominican Rep.,DOM,United States of America,USA,5,0,0,19,24
2015,Ecuador,ECU,United States of America,USA,158,0,0,966,1124
2015,Eritrea,ERI,United States of America,USA,225,0,0,34,259
2015,Ethiopia,ETH,United States of America,USA,541,0,12,206,759
2015,Fiji,FJI,United States of America,USA,10,0,0,10,20
2015,France,FRA,United States of America,USA,0,0,0,5,5
2015,Gabon,GAB,United States of America,USA,5,0,0,5,10
2015,Gambia,GMB,United States of America,USA,83,0,0,64,147
2015,United Kingdom of Great Britain and Northern Ireland,GBR,United States of America,USA,0,0,0,5,5
2015,Georgia,GEO,United States of America,USA,16,0,0,18,34
2015,Germany,DEU,United States of America,USA,0,0,0,10,10
2015,Ghana,GHA,United States of America,USA,12,0,0,10,22
2015,Greece,GRC,United States of America,USA,0,0,0,5,5
2015,Grenada,GRD,United States of America,USA,0,0,0,5,5
2015,Guatemala,GTM,United States of America,USA,1937,0,10,3501,5448
2015,Guinea,GIN,United States of America,USA,73,0,0,47,120
2015,Guyana,GUY,United States of America,USA,5,0,0,10,15
2015,Haiti,HTI,United States of America,USA,275,0,5,342,622
2015,Honduras,HND,United States of America,USA,1305,0,5,2483,3793
2015,Hungary,HUN,United States of America,USA,0,0,0,10,10
2015,Cote d'Ivoire,CIV,United States of America,USA,39,0,5,49,93
2015,India,IND,United States of America,USA,158,0,0,441,599
2015,Indonesia,IDN,United States of America,USA,19,0,0,70,89
2015,Iran (Islamic Rep. of),IRN,United States of America,USA,433,0,5,141,579
2015,Iraq,IRQ,United States of America,USA,484,0,10,174,668
2015,Israel,ISR,United States of America,USA,5,0,0,16,21
2015,Italy,ITA,United States of America,USA,0,0,0,5,5
2015,Jamaica,JAM,United States of America,USA,45,0,0,20,65
2015,Jordan,JOR,United States of America,USA,34,0,0,32,66
2015,Japan,JPN,United States of America,USA,0,0,0,5,5
2015,Kazakhstan,KAZ,United States of America,USA,34,0,0,79,113
2015,Kenya,KEN,United States of America,USA,78,0,5,71,154
2015,Kyrgyzstan,KGZ,United States of America,USA,95,0,0,172,267
2015,Rep. of Korea,KOR,United States of America,USA,0,0,0,5,5
2015,Kuwait,KWT,United States of America,USA,5,0,0,5,10
2015,Lao People's Dem. Rep.,LAO,United States of America,USA,5,0,0,5,10
2015,Liberia,LBR,United States of America,USA,90,0,0,19,109
2015,Libya,LBY,United States of America,USA,21,0,5,14,40
2015,Lebanon,LBN,United States of America,USA,13,0,0,24,37
2015,Sri Lanka,LKA,United States of America,USA,25,0,0,94,119
2015,Lithuania,LTU,United States of America,USA,0,0,0,5,5
2015,Latvia,LVA,United States of America,USA,0,0,0,5,5
2015,Mauritania,MRT,United States of America,USA,60,0,0,53,113
2015,North Macedonia,MKD,United States of America,USA,0,0,0,10,10
2015,Rep. of Moldova,MDA,United States of America,USA,59,0,0,133,192
2015,Mexico,MEX,United States of America,USA,610,0,0,2717,3327
2015,Mali,MLI,United States of America,USA,58,0,0,75,133
2015,Malaysia,MYS,United States of America,USA,0,0,0,18,18
2015,Mongolia,MNG,United States of America,USA,24,0,0,33,57
2015,Morocco,MAR,United States of America,USA,5,0,0,5,10
2015,Montenegro,MNE,United States of America,USA,5,0,0,15,20
2015,Myanmar,MMR,United States of America,USA,39,0,5,17,61
2015,Nepal,NPL,United States of America,USA,350,0,29,614,993
2015,Niger,NER,United States of America,USA,5,0,0,10,15
2015,Nicaragua,NIC,United States of America,USA,35,0,0,49,84
2015,Nigeria,NGA,United States of America,USA,70,0,0,67,137
2015,Pakistan,PAK,United States of America,USA,196,0,5,200,401
2015,Peru,PER,United States of America,USA,19,0,0,76,95
2015,Philippines,PHL,United States of America,USA,5,0,0,39,44
2015,Poland,POL,United States of America,USA,0,0,0,29,29
2015,Portugal,PRT,United States of America,USA,0,0,0,5,5
2015,Romania,ROU,United States of America,USA,5,0,0,34,39
2015,South Africa,ZAF,United States of America,USA,5,0,0,5,10
2015,Russian Federation,RUS,United States of America,USA,227,0,0,246,473
2015,Rwanda,RWA,United States of America,USA,68,0,0,53,121
2015,El Salvador,SLV,United States of America,USA,2070,0,22,3842,5934
2015,Saudi Arabia,SAU,United States of America,USA,29,0,0,5,34
2015,Serbia and Kosovo: S/RES/1244 (1999),SRB,United States of America,USA,32,0,0,60,92
2015,Senegal,SEN,United States of America,USA,16,0,0,33,49
2015,Sierra Leone,SLE,United States of America,USA,34,0,0,10,44
2015,Somalia,SOM,United States of America,USA,38,0,0,11,49
2015,Viet Nam,VNM,United States of America,USA,11,0,0,10,21
2015,Sudan,SDN,United States of America,USA,85,0,0,24,109
2015,Suriname,SUR,United States of America,USA,0,0,0,5,5
2015,Slovakia,SVK,United States of America,USA,0,0,0,5,5
2015,Syrian Arab Rep.,SYR,United States of America,USA,581,0,27,169,777
2015,United Rep. of Tanzania,TZA,United States of America,USA,5,0,0,16,21
2015,Thailand,THA,United States of America,USA,0,0,0,5,5
2015,Tajikistan,TJK,United States of America,USA,20,0,0,34,54
2015,Turkmenistan,TKM,United States of America,USA,10,0,0,5,15
2015,Togo,TGO,United States of America,USA,22,0,0,16,38
2015,Trinidad and Tobago,TTO,United States of America,USA,5,0,0,15,20
2015,Tunisia,TUN,United States of America,USA,5,0,0,5,10
2015,Turkey,TUR,United States of America,USA,13,0,0,28,41
2015,United Arab Emirates,ARE,United States of America,USA,5,0,0,0,5
2015,Uganda,UGA,United States of America,USA,116,0,0,52,168
2015,Ukraine,UKR,United States of America,USA,111,0,5,217,333
2015,Uruguay,URY,United States of America,USA,0,0,0,5,5
2015,Uzbekistan,UZB,United States of America,USA,58,0,0,95,153
2015,Venezuela (Bolivarian Republic of),VEN,United States of America,USA,244,0,5,98,347
2015,Yemen,YEM,United States of America,USA,39,0,0,20,59
2015,Zimbabwe,ZWE,United States of America,USA,28,0,0,22,50
2015,Unknown ,,United States of America,USA,47,0,0,59,106
2016,Afghanistan,AFG,United States of America,USA,91,0,0,38,129
2016,Albania,ALB,United States of America,USA,10,0,0,57,67
2016,Algeria,DZA,United States of America,USA,5,0,0,5,10
2016,Angola,AGO,United States of America,USA,10,0,0,23,33
2016,Egypt,EGY,United States of America,USA,418,0,0,164,582
2016,Argentina,ARG,United States of America,USA,0,0,0,5,5
2016,Armenia,ARM,United States of America,USA,13,0,0,22,35
2016,Azerbaijan,AZE,United States of America,USA,10,0,0,5,15
2016,Burundi,BDI,United States of America,USA,50,0,0,32,82
2016,Benin,BEN,United States of America,USA,5,0,0,5,10
2016,Bangladesh,BGD,United States of America,USA,23,0,0,129,152
2016,Bhutan,BTN,United States of America,USA,0,0,0,5,5
2016,Burkina Faso,BFA,United States of America,USA,23,0,0,66,89
2016,Belarus,BLR,United States of America,USA,17,0,0,16,33
2016,Bolivia (Plurinational State of),BOL,United States of America,USA,5,0,0,11,16
2016,Brazil,BRA,United States of America,USA,18,0,0,114,132
2016,Bosnia and Herzegovina,BIH,United States of America,USA,5,0,0,5,10
2016,Bulgaria,BGR,United States of America,USA,5,0,0,5,10
2016,Belize,BLZ,United States of America,USA,0,0,0,10,10
2016,Cambodia,KHM,United States of America,USA,5,0,0,0,5
2016,Central African Rep.,CAF,United States of America,USA,0,0,0,5,5
2016,Chad,TCD,United States of America,USA,10,0,0,5,15
2016,China,CHN,United States of America,USA,1040,0,16,2113,3169
2016,Cameroon,CMR,United States of America,USA,65,0,0,51,116
2016,Congo,COG,United States of America,USA,50,0,0,37,87
2016,Dem. Rep. of the Congo,COD,United States of America,USA,53,0,0,47,100
2016,Colombia,COL,United States of America,USA,67,0,0,102,169
2016,Costa Rica,CRI,United States of America,USA,0,0,0,13,13
2016,Cuba,CUB,United States of America,USA,0,0,0,17,17
2016,Djibouti,DJI,United States of America,USA,18,0,0,5,23
2016,Dominica,DMA,United States of America,USA,0,0,0,5,5
2016,Dominican Rep.,DOM,United States of America,USA,0,0,0,19,19
2016,Ecuador,ECU,United States of America,USA,88,0,0,1038,1126
2016,Eritrea,ERI,United States of America,USA,306,0,0,29,335
2016,Ethiopia,ETH,United States of America,USA,275,0,0,144,419
2016,Fiji,FJI,United States of America,USA,5,0,0,5,10
2016,Gabon,GAB,United States of America,USA,0,0,0,5,5
2016,Gambia,GMB,United States of America,USA,70,0,0,34,104
2016,United Kingdom of Great Britain and Northern Ireland,GBR,United States of America,USA,0,0,0,5,5
2016,Georgia,GEO,United States of America,USA,14,0,0,26,40
2016,Ghana,GHA,United States of America,USA,16,0,0,24,40
2016,Greece,GRC,United States of America,USA,0,0,0,5,5
2016,Grenada,GRD,United States of America,USA,0,0,0,5,5
2016,Guatemala,GTM,United States of America,USA,1629,0,5,3363,4997
2016,Guinea,GIN,United States of America,USA,34,0,0,40,74
2016,Guyana,GUY,United States of America,USA,0,0,0,20,20
2016,Haiti,HTI,United States of America,USA,91,0,10,254,355
2016,Honduras,HND,United States of America,USA,992,0,0,2125,3117
2016,Croatia,HRV,United States of America,USA,0,0,0,5,5
2016,Hungary,HUN,United States of America,USA,0,0,0,5,5
2016,Cote d'Ivoire,CIV,United States of America,USA,30,0,0,39,69
2016,India,IND,United States of America,USA,183,0,0,471,654
2016,Indonesia,IDN,United States of America,USA,24,0,0,26,50
2016,Ireland,IRL,United States of America,USA,0,0,0,5,5
2016,Iran (Islamic Rep. of),IRN,United States of America,USA,278,0,5,92,375
2016,Iraq,IRQ,United States of America,USA,461,0,5,170,636
2016,Israel,ISR,United States of America,USA,5,0,0,22,27
2016,Italy,ITA,United States of America,USA,0,0,0,5,5
2016,Jamaica,JAM,United States of America,USA,22,0,0,18,40
2016,Jordan,JOR,United States of America,USA,32,0,0,23,55
2016,Kazakhstan,KAZ,United States of America,USA,31,0,0,44,75
2016,Kenya,KEN,United States of America,USA,54,0,0,53,107
2016,Kyrgyzstan,KGZ,United States of America,USA,61,0,0,126,187
2016,Rep. of Korea,KOR,United States of America,USA,0,0,0,5,5
2016,Kuwait,KWT,United States of America,USA,5,0,0,10,15
2016,Lao People's Dem. Rep.,LAO,United States of America,USA,5,0,0,5,10
2016,Liberia,LBR,United States of America,USA,54,0,0,19,73
2016,Libya,LBY,United States of America,USA,20,0,0,24,44
2016,Saint Lucia,LCA,United States of America,USA,0,0,0,5,5
2016,Lebanon,LBN,United States of America,USA,19,0,0,30,49
2016,Sri Lanka,LKA,United States of America,USA,18,0,0,75,93
2016,Latvia,LVA,United States of America,USA,0,0,0,5,5
2016,Mauritania,MRT,United States of America,USA,30,0,0,34,64
2016,North Macedonia,MKD,United States of America,USA,0,0,0,5,5
2016,Rep. of Moldova,MDA,United States of America,USA,54,0,0,76,130
2016,Mexico,MEX,United States of America,USA,487,0,0,3346,3833
2016,Mali,MLI,United States of America,USA,26,0,0,38,64
2016,Malaysia,MYS,United States of America,USA,5,0,0,23,28
2016,Mongolia,MNG,United States of America,USA,22,0,0,28,50
2016,Morocco,MAR,United States of America,USA,5,0,0,0,5
2016,Montenegro,MNE,United States of America,USA,0,0,0,5,5
2016,Myanmar,MMR,United States of America,USA,13,0,0,11,24
2016,Nepal,NPL,United States of America,USA,205,0,15,333,553
2016,Netherlands,NLD,United States of America,USA,5,0,0,0,5
2016,Niger,NER,United States of America,USA,5,0,0,5,10
2016,Nicaragua,NIC,United States of America,USA,26,0,0,43,69
2016,Nigeria,NGA,United States of America,USA,52,0,0,55,107
2016,Pakistan,PAK,United States of America,USA,152,0,0,138,290
2016,Paraguay,PRY,United States of America,USA,0,0,0,10,10
2016,Peru,PER,United States of America,USA,17,0,0,102,119
2016,Philippines,PHL,United States of America,USA,5,0,0,52,57
2016,Poland,POL,United States of America,USA,0,0,0,43,43
2016,Portugal,PRT,United States of America,USA,0,0,0,5,5
2016,Romania,ROU,United States of America,USA,5,0,0,31,36
2016,South Africa,ZAF,United States of America,USA,0,0,0,5,5
2016,Russian Federation,RUS,United States of America,USA,156,0,0,144,300
2016,Rwanda,RWA,United States of America,USA,59,0,0,42,101
2016,El Salvador,SLV,United States of America,USA,1767,0,18,3467,5252
2016,Saudi Arabia,SAU,United States of America,USA,26,0,0,13,39
2016,Serbia and Kosovo: S/RES/1244 (1999),SRB,United States of America,USA,16,0,0,37,53
2016,Senegal,SEN,United States of America,USA,11,0,0,17,28
2016,Singapore,SGP,United States of America,USA,0,0,0,5,5
2016,Sierra Leone,SLE,United States of America,USA,14,0,0,5,19
2016,Somalia,SOM,United States of America,USA,32,0,0,16,48
2016,Viet Nam,VNM,United States of America,USA,12,0,0,5,17
2016,Sudan,SDN,United States of America,USA,54,0,0,16,70
2016,Slovakia,SVK,United States of America,USA,0,0,0,5,5
2016,Syrian Arab Rep.,SYR,United States of America,USA,501,0,15,150,666
2016,United Rep. of Tanzania,TZA,United States of America,USA,5,0,0,5,10
2016,Thailand,THA,United States of America,USA,0,0,0,5,5
2016,Tajikistan,TJK,United States of America,USA,10,0,0,18,28
2016,Turkmenistan,TKM,United States of America,USA,5,0,0,10,15
2016,Togo,TGO,United States of America,USA,32,0,0,5,37
2016,Trinidad and Tobago,TTO,United States of America,USA,0,0,0,17,17
2016,Tunisia,TUN,United States of America,USA,5,0,0,5,10
2016,Turkey,TUR,United States of America,USA,12,0,0,19,31
2016,Uganda,UGA,United States of America,USA,68,0,0,50,118
2016,Ukraine,UKR,United States of America,USA,92,0,0,206,298
2016,Uzbekistan,UZB,United States of America,USA,32,0,0,84,116
2016,Venezuela (Bolivarian Republic of),VEN,United States of America,USA,176,0,0,151,327
2016,Yemen,YEM,United States of America,USA,45,0,0,34,79
2016,Zimbabwe,ZWE,United States of America,USA,16,0,0,10,26
2016,Unknown ,,United States of America,USA,43,0,0,56,99
2017,Afghanistan,AFG,United States of America,USA,101,0,35,32,168
2017,Albania,ALB,United States of America,USA,13,0,56,64,133
2017,Algeria,DZA,United States of America,USA,10,0,5,0,15
2017,Angola,AGO,United States of America,USA,14,0,50,16,80
2017,Egypt,EGY,United States of America,USA,604,0,130,164,898
2017,Argentina,ARG,United States of America,USA,0,0,0,14,14
2017,Armenia,ARM,United States of America,USA,40,0,33,22,95
2017,Azerbaijan,AZE,United States of America,USA,18,0,28,12,58
2017,Burundi,BDI,United States of America,USA,43,0,45,13,101
2017,Benin,BEN,United States of America,USA,10,0,10,10,30
2017,Bangladesh,BGD,United States of America,USA,71,0,270,124,465
2017,Bhutan,BTN,United States of America,USA,0,0,15,13,28
2017,Burkina Faso,BFA,United States of America,USA,96,0,323,49,468
2017,Belarus,BLR,United States of America,USA,35,0,32,18,85
2017,Bolivia (Plurinational State of),BOL,United States of America,USA,5,0,0,12,17
2017,Brazil,BRA,United States of America,USA,34,0,25,322,381
2017,Bosnia and Herzegovina,BIH,United States of America,USA,0,0,5,5,10
2017,Bulgaria,BGR,United States of America,USA,5,0,10,5,20
2017,Belize,BLZ,United States of America,USA,0,0,5,10,15
2017,Central African Rep.,CAF,United States of America,USA,10,0,5,0,15
2017,Chad,TCD,United States of America,USA,14,0,17,5,36
2017,China,CHN,United States of America,USA,2780,0,3339,2141,8260
2017,Chile,CHL,United States of America,USA,0,0,0,13,13
2017,Cameroon,CMR,United States of America,USA,135,0,40,35,210
2017,Congo,COG,United States of America,USA,86,0,63,15,164
2017,Dem. Rep. of the Congo,COD,United States of America,USA,89,0,84,22,195
2017,Colombia,COL,United States of America,USA,67,0,66,151,284
2017,Costa Rica,CRI,United States of America,USA,0,0,5,49,54
2017,Cuba,CUB,United States of America,USA,0,0,0,18,18
2017,Djibouti,DJI,United States of America,USA,15,0,11,5,31
2017,Dominican Rep.,DOM,United States of America,USA,0,0,0,47,47
2017,Ecuador,ECU,United States of America,USA,79,0,106,2194,2379
2017,Eritrea,ERI,United States of America,USA,328,0,85,23,436
2017,Estonia,EST,United States of America,USA,0,0,0,5,5
2017,Ethiopia,ETH,United States of America,USA,333,0,150,58,541
2017,Fiji,FJI,United States of America,USA,0,0,5,5,10
2017,France,FRA,United States of America,USA,0,0,5,10,15
2017,Gabon,GAB,United States of America,USA,5,0,5,0,10
2017,Gambia,GMB,United States of America,USA,95,0,63,80,238
2017,United Kingdom of Great Britain and Northern Ireland,GBR,United States of America,USA,0,0,5,0,5
2017,Georgia,GEO,United States of America,USA,28,0,61,25,114
2017,Germany,DEU,United States of America,USA,0,0,10,5,15
2017,Ghana,GHA,United States of America,USA,5,0,5,18,28
2017,Greece,GRC,United States of America,USA,0,0,0,5,5
2017,Grenada,GRD,United States of America,USA,0,0,0,5,5
2017,Guatemala,GTM,United States of America,USA,2148,0,3625,2884,8657
2017,Guinea,GIN,United States of America,USA,79,0,62,45,186
2017,Guyana,GUY,United States of America,USA,5,0,0,26,31
2017,Haiti,HTI,United States of America,USA,72,0,67,294,433
2017,Honduras,HND,United States of America,USA,1197,0,2149,1216,4562
2017,Croatia,HRV,United States of America,USA,0,0,5,5,10
2017,Hungary,HUN,United States of America,USA,0,0,0,20,20
2017,Cote d'Ivoire,CIV,United States of America,USA,26,0,40,32,98
2017,India,IND,United States of America,USA,166,0,634,468,1268
2017,Indonesia,IDN,United States of America,USA,35,0,56,99,190
2017,Iran (Islamic Rep. of),IRN,United States of America,USA,238,0,89,117,444
2017,Iraq,IRQ,United States of America,USA,334,0,201,130,665
2017,Israel,ISR,United States of America,USA,14,0,10,20,44
2017,Italy,ITA,United States of America,USA,0,0,0,10,10
2017,Jamaica,JAM,United States of America,USA,48,0,5,25,78
2017,Jordan,JOR,United States of America,USA,42,0,55,48,145
2017,Japan,JPN,United States of America,USA,0,0,5,11,16
2017,Kazakhstan,KAZ,United States of America,USA,57,0,58,30,145
2017,Kenya,KEN,United States of America,USA,89,0,58,38,185
2017,Kyrgyzstan,KGZ,United States of America,USA,110,0,176,77,363
2017,Rep. of Korea,KOR,United States of America,USA,0,0,0,16,16
2017,Kuwait,KWT,United States of America,USA,14,0,0,5,19
2017,Lao People's Dem. Rep.,LAO,United States of America,USA,5,0,5,5,15
2017,Liberia,LBR,United States of America,USA,107,0,38,24,169
2017,Libya,LBY,United States of America,USA,27,0,34,26,87
2017,Saint Lucia,LCA,United States of America,USA,0,0,5,0,5
2017,Lebanon,LBN,United States of America,USA,17,0,30,36,83
2017,Sri Lanka,LKA,United States of America,USA,33,0,80,36,149
2017,Lithuania,LTU,United States of America,USA,0,0,0,10,10
2017,Latvia,LVA,United States of America,USA,0,0,0,5,5
2017,Mauritania,MRT,United States of America,USA,78,0,72,29,179
2017,North Macedonia,MKD,United States of America,USA,5,0,5,10,20
2017,Rep. of Moldova,MDA,United States of America,USA,59,0,75,32,166
2017,Mexico,MEX,United States of America,USA,574,0,363,7686,8623
2017,Mali,MLI,United States of America,USA,28,0,32,43,103
2017,Malaysia,MYS,United States of America,USA,0,0,0,37,37
2017,Malawi,MWI,United States of America,USA,5,0,0,5,10
2017,Mongolia,MNG,United States of America,USA,27,0,23,43,93
2017,Morocco,MAR,United States of America,USA,5,0,0,10,15
2017,Montenegro,MNE,United States of America,USA,5,0,5,12,22
2017,Myanmar,MMR,United States of America,USA,35,0,24,20,79
2017,Nepal,NPL,United States of America,USA,144,0,313,172,629
2017,Niger,NER,United States of America,USA,14,0,5,18,37
2017,Nicaragua,NIC,United States of America,USA,37,0,33,52,122
2017,Nigeria,NGA,United States of America,USA,97,0,91,68,256
2017,Pakistan,PAK,United States of America,USA,211,0,170,116,497
2017,Panama,PAN,United States of America,USA,0,0,5,10,15
2017,Paraguay,PRY,United States of America,USA,0,0,0,11,11
2017,Peru,PER,United States of America,USA,17,0,16,241,274
2017,Philippines,PHL,United States of America,USA,10,0,14,247,271
2017,Poland,POL,United States of America,USA,0,0,0,79,79
2017,Portugal,PRT,United States of America,USA,0,0,0,10,10
2017,Romania,ROU,United States of America,USA,14,0,5,58,77
2017,South Africa,ZAF,United States of America,USA,0,0,10,10,20
2017,Russian Federation,RUS,United States of America,USA,293,0,252,205,750
2017,Rwanda,RWA,United States of America,USA,61,0,43,10,114
2017,El Salvador,SLV,United States of America,USA,2166,0,4183,1900,8249
2017,Saudi Arabia,SAU,United States of America,USA,47,0,10,22,79
2017,Serbia and Kosovo: S/RES/1244 (1999),SRB,United States of America,USA,29,0,75,15,119
2017,Senegal,SEN,United States of America,USA,29,0,11,56,96
2017,Singapore,SGP,United States of America,USA,0,0,5,0,5
2017,Sierra Leone,SLE,United States of America,USA,24,0,17,5,46
2017,Somalia,SOM,United States of America,USA,46,0,5,14,65
2017,Viet Nam,VNM,United States of America,USA,10,0,5,14,29
2017,Sudan,SDN,United States of America,USA,53,0,41,44,138
2017,Slovakia,SVK,United States of America,USA,0,0,0,10,10
2017,Syrian Arab Rep.,SYR,United States of America,USA,466,0,96,113,675
2017,United Rep. of Tanzania,TZA,United States of America,USA,10,0,0,5,15
2017,Thailand,THA,United States of America,USA,5,0,13,5,23
2017,Tajikistan,TJK,United States of America,USA,15,0,12,13,40
2017,Turkmenistan,TKM,United States of America,USA,5,0,5,5,15
2017,Togo,TGO,United States of America,USA,28,0,17,12,57
2017,Trinidad and Tobago,TTO,United States of America,USA,5,0,0,18,23
2017,Tunisia,TUN,United States of America,USA,0,0,5,10,15
2017,Turkey,TUR,United States of America,USA,40,0,18,26,84
2017,Uganda,UGA,United States of America,USA,97,0,49,27,173
2017,Ukraine,UKR,United States of America,USA,189,0,391,226,806
2017,Uruguay,URY,United States of America,USA,0,0,0,5,5
2017,Uzbekistan,UZB,United States of America,USA,46,0,80,46,172
2017,Venezuela (Bolivarian Republic of),VEN,United States of America,USA,411,0,139,226,776
2017,Yemen,YEM,United States of America,USA,48,0,39,28,115
2017,Zambia,ZMB,United States of America,USA,5,0,0,0,5
2017,Zimbabwe,ZWE,United States of America,USA,51,0,12,20,83
2017,Unknown ,,United States of America,USA,61,0,62,59,182
2018,Afghanistan,AFG,United States of America,USA,70,0,26,17,113
2018,Albania,ALB,United States of America,USA,31,0,179,84,294
2018,Algeria,DZA,United States of America,USA,21,0,40,19,80
2018,Angola,AGO,United States of America,USA,18,0,113,20,151
2018,Egypt,EGY,United States of America,USA,980,0,274,137,1391
2018,Argentina,ARG,United States of America,USA,0,0,21,44,65
2018,Armenia,ARM,United States of America,USA,87,0,119,42,248
2018,Australia,AUS,United States of America,USA,0,0,5,5,10
2018,Azerbaijan,AZE,United States of America,USA,63,0,70,22,155
2018,Bahrain,BHR,United States of America,USA,0,0,5,0,5
2018,Burundi,BDI,United States of America,USA,37,0,46,16,99
2018,Belgium,BEL,United States of America,USA,0,0,0,5,5
2018,Benin,BEN,United States of America,USA,0,0,10,5,15
2018,Bangladesh,BGD,United States of America,USA,80,0,341,198,619
2018,Bahamas,BHS,United States of America,USA,5,0,0,5,10
2018,Bhutan,BTN,United States of America,USA,0,0,29,17,46
2018,Burkina Faso,BFA,United States of America,USA,69,0,328,71,468
2018,Belarus,BLR,United States of America,USA,131,0,221,48,400
2018,Bolivia (Plurinational State of),BOL,United States of America,USA,5,0,16,18,39
2018,Brazil,BRA,United States of America,USA,108,0,181,503,792
2018,Bosnia and Herzegovina,BIH,United States of America,USA,10,0,11,5,26
2018,Bulgaria,BGR,United States of America,USA,5,0,13,13,31
2018,Belize,BLZ,United States of America,USA,0,0,5,10,15
2018,Cambodia,KHM,United States of America,USA,16,0,5,0,21
2018,Canada,CAN,United States of America,USA,0,0,5,5,10
2018,Central African Rep.,CAF,United States of America,USA,14,0,5,0,19
2018,Chad,TCD,United States of America,USA,23,0,20,5,48
2018,China,CHN,United States of America,USA,3041,0,4125,2267,9433
2018,Chile,CHL,United States of America,USA,0,0,10,17,27
2018,Cameroon,CMR,United States of America,USA,260,0,198,72,530
2018,Dem. Rep. of the Congo,COD,United States of America,USA,196,0,229,72,497
2018,Colombia,COL,United States of America,USA,192,0,732,296,1220
2018,Costa Rica,CRI,United States of America,USA,0,0,16,78,94
2018,Cuba,CUB,United States of America,USA,5,0,5,32,42
2018,Djibouti,DJI,United States of America,USA,12,0,5,5,22
2018,Dominica,DMA,United States of America,USA,0,0,0,10,10
2018,Dominican Rep.,DOM,United States of America,USA,12,0,19,64,95
2018,Ecuador,ECU,United States of America,USA,43,0,478,1478,1999
2018,Equatorial Guinea,GNQ,United States of America,USA,0,0,5,0,5
2018,Eritrea,ERI,United States of America,USA,300,0,76,23,399
2018,Estonia,EST,United States of America,USA,0,0,0,5,5
2018,Ethiopia,ETH,United States of America,USA,346,0,212,69,627
2018,Fiji,FJI,United States of America,USA,0,0,23,27,50
2018,France,FRA,United States of America,USA,0,0,0,5,5
2018,Gabon,GAB,United States of America,USA,10,0,16,5,31
2018,Gambia,GMB,United States of America,USA,59,0,36,41,136
2018,United Kingdom of Great Britain and Northern Ireland,GBR,United States of America,USA,0,0,0,10,10
2018,Georgia,GEO,United States of America,USA,39,0,126,66,231
2018,Germany,DEU,United States of America,USA,5,0,5,5,15
2018,Ghana,GHA,United States of America,USA,12,0,18,30,60
2018,Guinea-Bissau,GNB,United States of America,USA,0,0,5,0,5
2018,Greece,GRC,United States of America,USA,0,0,5,12,17
2018,Guatemala,GTM,United States of America,USA,1309,0,2981,3780,8070
2018,Guinea,GIN,United States of America,USA,74,0,82,40,196
2018,Guyana,GUY,United States of America,USA,19,0,19,41,79
2018,Haiti,HTI,United States of America,USA,185,0,593,568,1346
2018,Honduras,HND,United States of America,USA,791,0,1737,2363,4891
2018,Croatia,HRV,United States of America,USA,0,0,5,0,5
2018,Hungary,HUN,United States of America,USA,0,0,5,43,48
2018,Cote d'Ivoire,CIV,United States of America,USA,53,0,97,38,188
2018,India,IND,United States of America,USA,273,0,1280,887,2440
2018,Indonesia,IDN,United States of America,USA,57,0,201,133,391
2018,Ireland,IRL,United States of America,USA,0,0,0,5,5
2018,Iran (Islamic Rep. of),IRN,United States of America,USA,287,0,131,107,525
2018,Iraq,IRQ,United States of America,USA,268,0,307,143,718
2018,Israel,ISR,United States of America,USA,17,0,18,32,67
2018,Italy,ITA,United States of America,USA,0,0,10,15,25
2018,Jamaica,JAM,United States of America,USA,94,0,26,56,176
2018,Jordan,JOR,United States of America,USA,97,0,162,113,372
2018,Japan,JPN,United States of America,USA,0,0,0,12,12
2018,Kazakhstan,KAZ,United States of America,USA,92,0,171,56,319
2018,Kenya,KEN,United States of America,USA,121,0,219,88,428
2018,Kyrgyzstan,KGZ,United States of America,USA,74,0,96,69,239
2018,Rep. of Korea,KOR,United States of America,USA,5,0,5,34,44
2018,Dem. People's Rep. of Korea,PRK,United States of America,USA,0,0,0,10,10
2018,Kuwait,KWT,United States of America,USA,13,0,5,5,23
2018,Lao People's Dem. Rep.,LAO,United States of America,USA,5,0,5,20,30
2018,Liberia,LBR,United States of America,USA,140,0,81,68,289
2018,Libya,LBY,United States of America,USA,50,0,53,45,148
2018,Saint Lucia,LCA,United States of America,USA,0,0,0,5,5
2018,Lebanon,LBN,United States of America,USA,31,0,62,45,138
2018,Sri Lanka,LKA,United States of America,USA,29,0,153,45,227
2018,Lithuania,LTU,United States of America,USA,0,0,0,10,10
2018,Latvia,LVA,United States of America,USA,0,0,0,12,12
2018,Mauritania,MRT,United States of America,USA,74,0,78,45,197
2018,North Macedonia,MKD,United States of America,USA,16,0,10,13,39
2018,Rep. of Moldova,MDA,United States of America,USA,74,0,130,65,269
2018,Mexico,MEX,United States of America,USA,669,0,2593,8468,11730
2018,Mali,MLI,United States of America,USA,24,0,30,24,78
2018,Malaysia,MYS,United States of America,USA,10,0,11,22,43
2018,Malawi,MWI,United States of America,USA,0,0,10,5,15
2018,Mongolia,MNG,United States of America,USA,43,0,89,71,203
2018,Morocco,MAR,United States of America,USA,10,0,5,10,25
2018,Montenegro,MNE,United States of America,USA,5,0,37,22,64
2018,Mauritius,MUS,United States of America,USA,5,0,5,5,15
2018,Myanmar,MMR,United States of America,USA,93,0,117,35,245
2018,Nepal,NPL,United States of America,USA,82,0,447,122,651
2018,Netherlands,NLD,United States of America,USA,0,0,0,5,5
2018,Niger,NER,United States of America,USA,15,0,25,11,51
2018,Nicaragua,NIC,United States of America,USA,49,0,84,142,275
2018,Nigeria,NGA,United States of America,USA,362,0,1221,295,1878
2018,Pakistan,PAK,United States of America,USA,310,0,303,155,768
2018,Panama,PAN,United States of America,USA,0,0,5,10,15
2018,Paraguay,PRY,United States of America,USA,0,0,5,5,10
2018,Peru,PER,United States of America,USA,21,0,85,294,400
2018,Philippines,PHL,United States of America,USA,15,0,88,179,282
2018,Poland,POL,United States of America,USA,0,0,29,110,139
2018,Portugal,PRT,United States of America,USA,0,0,5,46,51
2018,Romania,ROU,United States of America,USA,15,0,72,157,244
2018,South Africa,ZAF,United States of America,USA,5,0,58,10,73
2018,Russian Federation,RUS,United States of America,USA,629,0,649,245,1523
2018,Rwanda,RWA,United States of America,USA,87,0,85,10,182
2018,El Salvador,SLV,United States of America,USA,1141,0,2712,2855,6708
2018,Saudi Arabia,SAU,United States of America,USA,62,0,35,39,136
2018,Serbia and Kosovo: S/RES/1244 (1999),SRB,United States of America,USA,28,0,120,27,175
2018,Senegal,SEN,United States of America,USA,22,0,32,49,103
2018,Sierra Leone,SLE,United States of America,USA,24,0,19,5,48
2018,Somalia,SOM,United States of America,USA,45,0,10,12,67
2018,Spain,ESP,United States of America,USA,0,0,5,5,10
2018,Viet Nam,VNM,United States of America,USA,29,0,49,39,117
2018,Sudan,SDN,United States of America,USA,91,0,40,38,169
2018,South Sudan,SSD,United States of America,USA,11,0,5,0,16
2018,Slovakia,SVK,United States of America,USA,0,0,0,5,5
2018,Syrian Arab Rep.,SYR,United States of America,USA,395,0,179,133,707
2018,United Rep. of Tanzania,TZA,United States of America,USA,10,0,11,5,26
2018,Thailand,THA,United States of America,USA,5,0,10,32,47
2018,Tajikistan,TJK,United States of America,USA,17,0,34,19,70
2018,Turkmenistan,TKM,United States of America,USA,26,0,30,5,61
2018,Togo,TGO,United States of America,USA,49,0,65,15,129
2018,Trinidad and Tobago,TTO,United States of America,USA,0,0,12,25,37
2018,Tunisia,TUN,United States of America,USA,17,0,27,13,57
2018,Turkey,TUR,United States of America,USA,478,0,157,80,715
2018,United Arab Emirates,ARE,United States of America,USA,11,0,5,0,16
2018,Uganda,UGA,United States of America,USA,213,0,267,31,511
2018,Ukraine,UKR,United States of America,USA,304,0,567,275,1146
2018,Uruguay,URY,United States of America,USA,0,0,5,13,18
2018,Uzbekistan,UZB,United States of America,USA,92,0,146,90,328
2018,Venezuela (Bolivarian Republic of),VEN,United States of America,USA,4290,0,5507,974,10771
2018,Yemen,YEM,United States of America,USA,53,0,58,57,168
2018,Zambia,ZMB,United States of America,USA,5,0,5,5,15
2018,Zimbabwe,ZWE,United States of America,USA,62,0,30,27,119
2018,Unknown ,,United States of America,USA,126,0,190,125,441
2019,Afghanistan,AFG,United States of America,USA,71,0,43,12,126
2019,Albania,ALB,United States of America,USA,38,0,209,45,292
2019,Algeria,DZA,United States of America,USA,22,0,35,10,67
2019,Angola,AGO,United States of America,USA,25,0,143,20,188
2019,Antigua and Barbuda,ATG,United States of America,USA,5,0,5,0,10
2019,Egypt,EGY,United States of America,USA,1292,0,321,94,1707
2019,Argentina,ARG,United States of America,USA,0,0,18,34,52
2019,Armenia,ARM,United States of America,USA,112,0,188,48,348
2019,Australia,AUS,United States of America,USA,0,0,5,5,10
2019,Azerbaijan,AZE,United States of America,USA,86,0,92,21,199
2019,Burundi,BDI,United States of America,USA,42,0,49,13,104
2019,Belgium,BEL,United States of America,USA,0,0,0,5,5
2019,Benin,BEN,United States of America,USA,5,0,23,10,38
2019,Bangladesh,BGD,United States of America,USA,56,0,387,96,539
2019,Bahamas,BHS,United States of America,USA,0,0,10,0,10
2019,Bhutan,BTN,United States of America,USA,0,0,18,5,23
2019,Burkina Faso,BFA,United States of America,USA,69,0,205,30,304
2019,Belarus,BLR,United States of America,USA,121,0,227,46,394
2019,Bolivia (Plurinational State of),BOL,United States of America,USA,5,0,34,5,44
2019,Brazil,BRA,United States of America,USA,205,0,492,354,1051
2019,Bosnia and Herzegovina,BIH,United States of America,USA,12,0,13,10,35
2019,Bulgaria,BGR,United States of America,USA,10,0,15,5,30
2019,Belize,BLZ,United States of America,USA,0,0,12,5,17
2019,Cambodia,KHM,United States of America,USA,10,0,0,0,10
2019,Canada,CAN,United States of America,USA,0,0,0,5,5
2019,Central African Rep.,CAF,United States of America,USA,10,0,5,0,15
2019,Chad,TCD,United States of America,USA,13,0,13,0,26
2019,China,CHN,United States of America,USA,3310,0,3685,1161,8156
2019,Chile,CHL,United States of America,USA,5,0,25,12,42
2019,Cameroon,CMR,United States of America,USA,316,0,256,42,614
2019,Dem. Rep. of the Congo,COD,United States of America,USA,197,0,362,58,617
2019,Colombia,COL,United States of America,USA,268,0,1282,213,1763
2019,Costa Rica,CRI,United States of America,USA,0,0,79,16,95
2019,Cuba,CUB,United States of America,USA,5,0,35,56,96
2019,Cabo Verde,CPV,United States of America,USA,0,0,5,0,5
2019,Cyprus,CYP,United States of America,USA,0,0,5,0,5
2019,Djibouti,DJI,United States of America,USA,50,0,13,16,79
2019,Dominica,DMA,United States of America,USA,5,0,0,0,5
2019,Dominican Rep.,DOM,United States of America,USA,16,0,68,38,122
2019,Ecuador,ECU,United States of America,USA,42,0,2026,357,2425
2019,Equatorial Guinea,GNQ,United States of America,USA,10,0,5,0,15
2019,Eritrea,ERI,United States of America,USA,271,0,65,10,346
2019,Ethiopia,ETH,United States of America,USA,295,0,204,65,564
2019,Fiji,FJI,United States of America,USA,5,0,30,0,35
2019,France,FRA,United States of America,USA,0,0,5,10,15
2019,Gabon,GAB,United States of America,USA,5,0,38,5,48
2019,Gambia,GMB,United States of America,USA,52,0,57,10,119
2019,United Kingdom of Great Britain and Northern Ireland,GBR,United States of America,USA,0,0,5,5,10
2019,Georgia,GEO,United States of America,USA,60,0,185,36,281
2019,Germany,DEU,United States of America,USA,5,0,5,5,15
2019,Ghana,GHA,United States of America,USA,13,0,42,12,67
2019,Guinea-Bissau,GNB,United States of America,USA,0,0,5,5,10
2019,Greece,GRC,United States of America,USA,0,0,5,10,15
2019,Grenada,GRD,United States of America,USA,5,0,0,0,5
2019,Guatemala,GTM,United States of America,USA,1358,0,4877,2202,8437
2019,Guinea,GIN,United States of America,USA,73,0,122,10,205
2019,Guyana,GUY,United States of America,USA,18,0,70,18,106
2019,Haiti,HTI,United States of America,USA,234,0,1021,270,1525
2019,"China, Hong Kong SAR",HKG,United States of America,USA,0,0,10,5,15
2019,Honduras,HND,United States of America,USA,625,0,2553,1274,4452
2019,Hungary,HUN,United States of America,USA,0,0,34,31,65
2019,Cote d'Ivoire,CIV,United States of America,USA,29,0,125,29,183
2019,India,IND,United States of America,USA,329,0,2244,454,3027
2019,Indonesia,IDN,United States of America,USA,75,0,415,52,542
2019,Iran (Islamic Rep. of),IRN,United States of America,USA,352,0,121,115,588
2019,Iraq,IRQ,United States of America,USA,288,0,300,128,716
2019,Israel,ISR,United States of America,USA,16,0,22,19,57
2019,Italy,ITA,United States of America,USA,0,0,36,25,61
2019,Jamaica,JAM,United States of America,USA,105,0,63,26,194
2019,Jordan,JOR,United States of America,USA,81,0,243,89,413
2019,Japan,JPN,United States of America,USA,0,0,10,5,15
2019,Kazakhstan,KAZ,United States of America,USA,183,0,242,57,482
2019,Kenya,KEN,United States of America,USA,163,0,206,32,401
2019,Kyrgyzstan,KGZ,United States of America,USA,97,0,146,29,272
2019,Rep. of Korea,KOR,United States of America,USA,0,0,26,25,51
2019,Dem. People's Rep. of Korea,PRK,United States of America,USA,0,0,5,5,10
2019,Kuwait,KWT,United States of America,USA,10,0,5,5,20
2019,Lao People's Dem. Rep.,LAO,United States of America,USA,5,0,11,5,21
2019,Liberia,LBR,United States of America,USA,126,0,163,21,310
2019,Libya,LBY,United States of America,USA,41,0,59,33,133
2019,Saint Lucia,LCA,United States of America,USA,0,0,5,5,10
2019,Lebanon,LBN,United States of America,USA,32,0,125,29,186
2019,Sri Lanka,LKA,United States of America,USA,37,0,163,32,232
2019,Lithuania,LTU,United States of America,USA,0,0,5,5,10
2019,Mauritania,MRT,United States of America,USA,94,0,124,22,240
2019,North Macedonia,MKD,United States of America,USA,17,0,19,5,41
2019,Rep. of Moldova,MDA,United States of America,USA,59,0,139,40,238
2019,Mexico,MEX,United States of America,USA,1114,0,9107,2915,13136
2019,Mali,MLI,United States of America,USA,21,0,55,10,86
2019,Malaysia,MYS,United States of America,USA,10,0,41,5,56
2019,Malawi,MWI,United States of America,USA,10,0,17,0,27
2019,Mongolia,MNG,United States of America,USA,74,0,140,27,241
2019,Morocco,MAR,United States of America,USA,22,0,20,13,55
2019,Mozambique,MOZ,United States of America,USA,18,0,14,14,46
2019,Montenegro,MNE,United States of America,USA,22,0,69,11,102
2019,Mauritius,MUS,United States of America,USA,5,0,5,0,10
2019,Myanmar,MMR,United States of America,USA,124,0,191,20,335
2019,Nepal,NPL,United States of America,USA,51,0,423,77,551
2019,Niger,NER,United States of America,USA,5,0,29,5,39
2019,Nicaragua,NIC,United States of America,USA,273,0,372,140,785
2019,Nigeria,NGA,United States of America,USA,434,0,1426,125,1985
2019,Oman,OMN,United States of America,USA,5,0,0,0,5
2019,Pakistan,PAK,United States of America,USA,279,0,420,110,809
2019,Panama,PAN,United States of America,USA,0,0,10,5,15
2019,Paraguay,PRY,United States of America,USA,5,0,13,0,18
2019,Peru,PER,United States of America,USA,26,0,349,79,454
2019,Philippines,PHL,United States of America,USA,15,0,258,56,329
2019,Poland,POL,United States of America,USA,0,0,142,23,165
2019,Portugal,PRT,United States of America,USA,0,0,14,39,53
2019,Romania,ROU,United States of America,USA,25,0,129,135,289
2019,South Africa,ZAF,United States of America,USA,10,0,131,5,146
2019,Russian Federation,RUS,United States of America,USA,1018,0,799,281,2098
2019,Rwanda,RWA,United States of America,USA,140,0,126,19,285
2019,El Salvador,SLV,United States of America,USA,1121,0,3549,1299,5969
2019,Saudi Arabia,SAU,United States of America,USA,84,0,38,21,143
2019,Serbia and Kosovo: S/RES/1244 (1999),SRB,United States of America,USA,36,0,81,10,127
2019,Senegal,SEN,United States of America,USA,21,0,69,11,101
2019,Sierra Leone,SLE,United States of America,USA,18,0,23,5,46
2019,Somalia,SOM,United States of America,USA,23,0,5,10,38
2019,Spain,ESP,United States of America,USA,0,0,21,12,33
2019,Viet Nam,VNM,United States of America,USA,33,0,71,18,122
2019,Sudan,SDN,United States of America,USA,94,0,70,28,192
2019,South Sudan,SSD,United States of America,USA,21,0,15,0,36
2019,Slovakia,SVK,United States of America,USA,0,0,5,0,5
2019,Syrian Arab Rep.,SYR,United States of America,USA,344,0,210,100,654
2019,United Rep. of Tanzania,TZA,United States of America,USA,11,0,14,5,30
2019,Thailand,THA,United States of America,USA,5,0,15,47,67
2019,Tajikistan,TJK,United States of America,USA,14,0,43,10,67
2019,Turkmenistan,TKM,United States of America,USA,34,0,10,5,49
2019,Togo,TGO,United States of America,USA,43,0,72,10,125
2019,Trinidad and Tobago,TTO,United States of America,USA,0,0,29,10,39
2019,Tunisia,TUN,United States of America,USA,5,0,38,5,48
2019,Turkey,TUR,United States of America,USA,1309,0,199,73,1581
2019,United Arab Emirates,ARE,United States of America,USA,5,0,0,5,10
2019,Uganda,UGA,United States of America,USA,211,0,329,20,560
2019,Ukraine,UKR,United States of America,USA,250,0,529,204,983
2019,Uruguay,URY,United States of America,USA,0,0,18,11,29
2019,Uzbekistan,UZB,United States of America,USA,73,0,175,68,316
2019,Saint Vincent and the Grenadines,VCT,United States of America,USA,0,0,5,0,5
2019,Venezuela (Bolivarian Republic of),VEN,United States of America,USA,3824,0,7316,1015,12155
2019,Yemen,YEM,United States of America,USA,89,0,63,24,176
2019,Zambia,ZMB,United States of America,USA,11,0,10,5,26
2019,Zimbabwe,ZWE,United States of America,USA,81,0,64,11,156
2019,Unknown ,,United States of America,USA,643,0,1003,312,1958
2020,Afghanistan,AFG,United States of America,USA,34,0,26,28,88
2020,Albania,ALB,United States of America,USA,5,0,62,24,91
2020,Algeria,DZA,United States of America,USA,5,0,5,14,24
2020,Angola,AGO,United States of America,USA,10,0,63,31,104
2020,Egypt,EGY,United States of America,USA,404,0,165,121,690
2020,Argentina,ARG,United States of America,USA,0,0,5,11,16
2020,Armenia,ARM,United States of America,USA,31,0,68,28,127
2020,Azerbaijan,AZE,United States of America,USA,27,0,22,33,82
2020,Bahrain,BHR,United States of America,USA,0,0,0,5,5
2020,Burundi,BDI,United States of America,USA,16,0,30,14,60
2020,Benin,BEN,United States of America,USA,5,0,14,0,19
2020,Bangladesh,BGD,United States of America,USA,14,0,163,95,272
2020,Bahamas,BHS,United States of America,USA,0,0,5,0,5
2020,Bhutan,BTN,United States of America,USA,0,0,12,15,27
2020,Burkina Faso,BFA,United States of America,USA,25,0,55,61,141
2020,Belarus,BLR,United States of America,USA,30,0,74,46,150
2020,Bolivia (Plurinational State of),BOL,United States of America,USA,0,0,16,5,21
2020,Botswana,BWA,United States of America,USA,0,0,5,0,5
2020,Brazil,BRA,United States of America,USA,76,0,227,278,581
2020,Bosnia and Herzegovina,BIH,United States of America,USA,0,0,14,0,14
2020,Bulgaria,BGR,United States of America,USA,5,0,15,5,25
2020,Belize,BLZ,United States of America,USA,0,0,11,0,11
2020,Cambodia,KHM,United States of America,USA,0,0,0,5,5
2020,Central African Rep.,CAF,United States of America,USA,5,0,5,0,10
2020,Chad,TCD,United States of America,USA,12,0,12,0,24
2020,China,CHN,United States of America,USA,1501,0,1807,1470,4778
2020,Chile,CHL,United States of America,USA,0,0,15,12,27
2020,Cameroon,CMR,United States of America,USA,114,0,142,115,371
2020,Congo,COG,United States of America,USA,34,0,55,57,146
2020,Dem. Rep. of the Congo,COD,United States of America,USA,36,0,112,50,198
2020,Colombia,COL,United States of America,USA,101,0,534,133,768
2020,Costa Rica,CRI,United States of America,USA,0,0,45,10,55
2020,Cuba,CUB,United States of America,USA,10,0,36,675,721
2020,Czechia,CZE,United States of America,USA,0,0,5,0,5
2020,Djibouti,DJI,United States of America,USA,22,0,11,5,38
2020,Dominican Rep.,DOM,United States of America,USA,5,0,35,14,54
2020,Ecuador,ECU,United States of America,USA,16,0,852,272,1140
2020,Equatorial Guinea,GNQ,United States of America,USA,0,0,5,0,5
2020,Eritrea,ERI,United States of America,USA,89,0,20,33,142
2020,Ethiopia,ETH,United States of America,USA,136,0,118,132,386
2020,Fiji,FJI,United States of America,USA,0,0,11,5,16
2020,France,FRA,United States of America,USA,0,0,0,5,5
2020,Gabon,GAB,United States of America,USA,5,0,17,0,22
2020,Gambia,GMB,United States of America,USA,21,0,26,25,72
2020,Georgia,GEO,United States of America,USA,19,0,38,48,105
2020,Germany,DEU,United States of America,USA,0,0,5,5,10
2020,Ghana,GHA,United States of America,USA,5,0,24,15,44
2020,Greece,GRC,United States of America,USA,0,0,0,5,5
2020,Guatemala,GTM,United States of America,USA,424,0,2220,2054,4698
2020,Guinea,GIN,United States of America,USA,34,0,32,18,84
2020,Guyana,GUY,United States of America,USA,0,0,33,12,45
2020,Haiti,HTI,United States of America,USA,78,0,553,810,1441
2020,"China, Hong Kong SAR",HKG,United States of America,USA,0,0,5,0,5
2020,Honduras,HND,United States of America,USA,232,0,1391,1867,3490
2020,Hungary,HUN,United States of America,USA,0,0,10,29,39
2020,Cote d'Ivoire,CIV,United States of America,USA,20,0,47,28,95
2020,India,IND,United States of America,USA,64,0,834,451,1349
2020,Indonesia,IDN,United States of America,USA,18,0,82,65,165
2020,Ireland,IRL,United States of America,USA,0,0,0,5,5
2020,Iran (Islamic Rep. of),IRN,United States of America,USA,117,0,53,148,318
2020,Iraq,IRQ,United States of America,USA,98,0,236,177,511
2020,Israel,ISR,United States of America,USA,0,0,13,19,32
2020,Italy,ITA,United States of America,USA,0,0,16,16,32
2020,Jamaica,JAM,United States of America,USA,25,0,30,19,74
2020,Jordan,JOR,United States of America,USA,25,0,105,88,218
2020,Japan,JPN,United States of America,USA,0,0,0,5,5
2020,Kazakhstan,KAZ,United States of America,USA,53,0,79,47,179
2020,Kenya,KEN,United States of America,USA,41,0,86,82,209
2020,Kyrgyzstan,KGZ,United States of America,USA,42,0,76,19,137
2020,Rep. of Korea,KOR,United States of America,USA,0,0,11,29,40
2020,Dem. People's Rep. of Korea,PRK,United States of America,USA,0,0,0,5,5
2020,Kuwait,KWT,United States of America,USA,0,0,5,5,10
2020,Lao People's Dem. Rep.,LAO,United States of America,USA,5,0,11,10,26
2020,Liberia,LBR,United States of America,USA,44,0,63,45,152
2020,Libya,LBY,United States of America,USA,17,0,39,53,109
2020,Lebanon,LBN,United States of America,USA,11,0,37,23,71
2020,Sri Lanka,LKA,United States of America,USA,5,0,58,38,101
2020,Lithuania,LTU,United States of America,USA,0,0,0,5,5
2020,Latvia,LVA,United States of America,USA,0,0,5,0,5
2020,Madagascar,MDG,United States of America,USA,0,0,5,0,5
2020,Mauritania,MRT,United States of America,USA,44,0,78,17,139
2020,North Macedonia,MKD,United States of America,USA,0,0,10,5,15
2020,Rep. of Moldova,MDA,United States of America,USA,17,0,71,52,140
2020,Mexico,MEX,United States of America,USA,350,0,3851,1184,5385
2020,Mali,MLI,United States of America,USA,11,0,28,10,49
2020,Malaysia,MYS,United States of America,USA,5,0,21,5,31
2020,Malawi,MWI,United States of America,USA,5,0,10,0,15
2020,Mongolia,MNG,United States of America,USA,32,0,55,27,114
2020,Morocco,MAR,United States of America,USA,0,0,14,0,14
2020,Mozambique,MOZ,United States of America,USA,5,0,0,0,5
2020,Montenegro,MNE,United States of America,USA,5,0,23,5,33
2020,Myanmar,MMR,United States of America,USA,51,0,102,21,174
2020,Nepal,NPL,United States of America,USA,10,0,166,97,273
2020,Netherlands,NLD,United States of America,USA,0,0,0,5,5
2020,Niger,NER,United States of America,USA,0,0,0,12,12
2020,Nicaragua,NIC,United States of America,USA,81,0,122,195,398
2020,Nigeria,NGA,United States of America,USA,151,0,665,156,972
2020,Oman,OMN,United States of America,USA,0,0,5,0,5
2020,Pakistan,PAK,United States of America,USA,96,0,137,135,368
2020,Paraguay,PRY,United States of America,USA,0,0,5,5,10
2020,Peru,PER,United States of America,USA,5,0,153,60,218
2020,Philippines,PHL,United States of America,USA,5,0,37,35,77
2020,Poland,POL,United States of America,USA,0,0,45,15,60
2020,Portugal,PRT,United States of America,USA,0,0,5,21,26
2020,Romania,ROU,United States of America,USA,5,0,37,158,200
2020,South Africa,ZAF,United States of America,USA,0,0,51,10,61
2020,Russian Federation,RUS,United States of America,USA,310,0,319,273,902
2020,Rwanda,RWA,United States of America,USA,51,0,68,14,133
2020,El Salvador,SLV,United States of America,USA,250,0,1880,1533,3663
2020,Saudi Arabia,SAU,United States of America,USA,24,0,18,33,75
2020,Serbia and Kosovo: S/RES/1244 (1999),SRB,United States of America,USA,5,0,53,44,102
2020,Senegal,SEN,United States of America,USA,12,0,29,10,51
2020,Sierra Leone,SLE,United States of America,USA,10,0,11,10,31
2020,Somalia,SOM,United States of America,USA,15,0,10,10,35
2020,Spain,ESP,United States of America,USA,0,0,0,12,12
2020,Viet Nam,VNM,United States of America,USA,12,0,34,33,79
2020,Sudan,SDN,United States of America,USA,51,0,31,39,121
2020,Suriname,SUR,United States of America,USA,0,0,5,0,5
2020,South Sudan,SSD,United States of America,USA,0,0,13,0,13
2020,Slovakia,SVK,United States of America,USA,0,0,0,5,5
2020,Sweden,SWE,United States of America,USA,0,0,0,5,5
2020,Syrian Arab Rep.,SYR,United States of America,USA,137,0,111,136,384
2020,United Rep. of Tanzania,TZA,United States of America,USA,5,0,0,12,17
2020,Thailand,THA,United States of America,USA,0,0,5,39,44
2020,Tajikistan,TJK,United States of America,USA,10,0,25,12,47
2020,Turkmenistan,TKM,United States of America,USA,15,0,12,5,32
2020,Togo,TGO,United States of America,USA,20,0,31,10,61
2020,Trinidad and Tobago,TTO,United States of America,USA,0,0,21,5,26
2020,Tunisia,TUN,United States of America,USA,10,0,10,10,30
2020,Turkey,TUR,United States of America,USA,581,0,94,117,792
2020,United Arab Emirates,ARE,United States of America,USA,0,0,0,10,10
2020,Uganda,UGA,United States of America,USA,84,0,130,47,261
2020,Ukraine,UKR,United States of America,USA,62,0,214,248,524
2020,Uruguay,URY,United States of America,USA,0,0,14,0,14
2020,Uzbekistan,UZB,United States of America,USA,22,0,67,48,137
2020,Saint Vincent and the Grenadines,VCT,United States of America,USA,0,0,5,0,5
2020,Venezuela (Bolivarian Republic of),VEN,United States of America,USA,1356,0,3118,1157,5631
2020,Yemen,YEM,United States of America,USA,23,0,42,42,107
2020,Zambia,ZMB,United States of America,USA,5,0,5,0,10
2020,Zimbabwe,ZWE,United States of America,USA,27,0,35,23,85
2020,Unknown ,,United States of America,USA,39,0,95,51,185
2000,Unknown ,,United Kingdom of Great Britain and Northern Ireland,GBR,365,0,300,1430,2095
2001,Unknown ,,United Kingdom of Great Britain and Northern Ireland,GBR,260,0,60,1980,2300
2002,Unknown ,,United Kingdom of Great Britain and Northern Ireland,GBR,25,0,60,2890,2975
2003,Unknown ,,United Kingdom of Great Britain and Northern Ireland,GBR,30,0,55,2155,2240
2004,Unknown ,,United Kingdom of Great Britain and Northern Ireland,GBR,15,0,30,1085,1130
2005,Unknown ,,United Kingdom of Great Britain and Northern Ireland,GBR,25,0,25,1575,1625
2006,Afghanistan,AFG,Azerbaijan,AZE,0,0,14,0,14
2006,Iran (Islamic Rep. of),IRN,Azerbaijan,AZE,0,0,5,0,5
2006,Unknown ,,United Kingdom of Great Britain and Northern Ireland,GBR,25,0,15,1715,1755
2006,Unknown ,,Japan,JPN,0,0,0,5,5
2007,Afghanistan,AFG,Azerbaijan,AZE,0,0,5,0,5
2007,Iran (Islamic Rep. of),IRN,Azerbaijan,AZE,0,0,5,0,5
2007,Unknown ,,United Kingdom of Great Britain and Northern Ireland,GBR,15,0,25,2245,2285
2007,Unknown ,,Luxembourg,LUX,0,0,132,47,179
2008,Afghanistan,AFG,Azerbaijan,AZE,0,0,5,0,5
2008,Unknown ,,United Kingdom of Great Britain and Northern Ireland,GBR,30,0,60,2425,2515
2008,Unknown ,,Luxembourg,LUX,0,5,91,20,116
2009,Afghanistan,AFG,Azerbaijan,AZE,0,0,5,0,5
2009,Albania,ALB,Luxembourg,LUX,0,0,5,0,5
2009,Belarus,BLR,Luxembourg,LUX,0,0,5,0,5
2009,Bosnia and Herzegovina,BIH,Luxembourg,LUX,0,0,14,0,14
2009,Rep. of Moldova,MDA,Luxembourg,LUX,0,0,5,0,5
2009,Montenegro,MNE,Luxembourg,LUX,0,0,5,0,5
2009,Russian Federation,RUS,Luxembourg,LUX,0,0,5,0,5
2009,Serbia and Kosovo: S/RES/1244 (1999),SRB,Luxembourg,LUX,11,0,0,0,11
2012,Unknown ,,Belgium,BEL,0,0,9425,609,10034
2012,Unknown ,,Rep. of Korea,KOR,19,0,93,38,150
2013,Afghanistan,AFG,Belgium,BEL,5,5,770,47,827
2013,Albania,ALB,Belgium,BEL,5,0,92,39,136
2013,Algeria,DZA,Belgium,BEL,0,0,36,13,49
2013,Angola,AGO,Belgium,BEL,0,0,86,17,103
2013,Egypt,EGY,Belgium,BEL,0,0,10,5,15
2013,Argentina,ARG,Belgium,BEL,0,0,5,0,5
2013,Armenia,ARM,Belgium,BEL,0,5,123,24,152
2013,Azerbaijan,AZE,Belgium,BEL,0,0,63,10,73
2013,Burundi,BDI,Belgium,BEL,18,0,92,30,140
2013,Belgium,BEL,Belgium,BEL,0,0,5,0,5
2013,Benin,BEN,Belgium,BEL,5,0,66,10,81
2013,Bangladesh,BGD,Belgium,BEL,0,0,118,51,169
2013,Bhutan,BTN,Belgium,BEL,0,0,5,0,5
2013,Burkina Faso,BFA,Belgium,BEL,0,0,53,17,70
2013,Belarus,BLR,Belgium,BEL,0,0,16,10,26
2013,Bulgaria,BGR,Belgium,BEL,0,0,0,5,5
2013,Chad,TCD,Belgium,BEL,0,0,5,5,10
2013,China,CHN,Belgium,BEL,0,0,10,0,10
2013,Cameroon,CMR,Belgium,BEL,14,0,218,43,275
2013,Congo,COG,Belgium,BEL,0,0,10,5,15
2013,Dem. Rep. of the Congo,COD,Belgium,BEL,14,5,1153,292,1464
2013,Comoros,COM,Belgium,BEL,0,0,150,31,181
2013,Cuba,CUB,Belgium,BEL,0,0,5,0,5
2013,Djibouti,DJI,Belgium,BEL,5,0,16,10,31
2013,Eritrea,ERI,Belgium,BEL,0,0,10,0,10
2013,Ethiopia,ETH,Belgium,BEL,0,0,10,0,10
2013,Gabon,GAB,Belgium,BEL,0,0,5,0,5
2013,Gambia,GMB,Belgium,BEL,0,0,28,0,28
2013,Palestinian,PSE,Belgium,BEL,0,0,5,5,10
2013,Georgia,GEO,Belgium,BEL,0,0,131,23,154
2013,Ghana,GHA,Belgium,BEL,0,0,42,5,47
2013,Guinea,GIN,Belgium,BEL,99,10,1052,174,1335
2013,Cote d'Ivoire,CIV,Belgium,BEL,5,0,0,0,5
2013,India,IND,Belgium,BEL,0,0,5,5,10
2013,Iran (Islamic Rep. of),IRN,Belgium,BEL,0,0,111,13,124
2013,Iraq,IRQ,Belgium,BEL,10,0,241,57,308
2013,Israel,ISR,Belgium,BEL,0,0,5,0,5
2013,Jordan,JOR,Belgium,BEL,0,0,5,0,5
2013,Kazakhstan,KAZ,Belgium,BEL,0,0,71,11,82
2013,Kenya,KEN,Belgium,BEL,0,0,20,5,25
2013,Kyrgyzstan,KGZ,Belgium,BEL,0,0,66,11,77
2013,Dem. People's Rep. of Korea,PRK,Belgium,BEL,0,0,10,5,15
2013,Liberia,LBR,Belgium,BEL,0,0,10,0,10
2013,Lebanon,LBN,Belgium,BEL,0,0,22,5,27
2013,Sri Lanka,LKA,Belgium,BEL,0,0,26,0,26
2013,Mauritania,MRT,Belgium,BEL,15,0,151,46,212
2013,North Macedonia,MKD,Belgium,BEL,0,0,10,0,10
2013,Mali,MLI,Belgium,BEL,0,0,5,0,5
2013,Mongolia,MNG,Belgium,BEL,0,0,13,0,13
2013,Morocco,MAR,Belgium,BEL,5,0,34,10,49
2013,Montenegro,MNE,Belgium,BEL,0,0,5,5,10
2013,Nepal,NPL,Belgium,BEL,0,0,200,65,265
2013,Niger,NER,Belgium,BEL,5,0,47,5,57
2013,Nigeria,NGA,Belgium,BEL,0,0,69,23,92
2013,Pakistan,PAK,Belgium,BEL,5,0,342,95,442
2013,Russian Federation,RUS,Belgium,BEL,5,0,329,59,393
2013,Rwanda,RWA,Belgium,BEL,27,0,182,69,278
2013,El Salvador,SLV,Belgium,BEL,0,0,5,0,5
2013,Serbia and Kosovo: S/RES/1244 (1999),SRB,Belgium,BEL,0,0,41,20,61
2013,Senegal,SEN,Belgium,BEL,33,5,229,22,289
2013,Sierra Leone,SLE,Belgium,BEL,0,0,37,0,37
2013,Somalia,SOM,Belgium,BEL,5,0,69,10,84
2013,Viet Nam,VNM,Belgium,BEL,0,0,5,0,5
2013,Sudan,SDN,Belgium,BEL,0,0,10,5,15
2013,Syrian Arab Rep.,SYR,Belgium,BEL,0,10,12,12,34
2013,United Rep. of Tanzania,TZA,Belgium,BEL,0,0,34,5,39
2013,Togo,TGO,Belgium,BEL,10,0,215,62,287
2013,Tunisia,TUN,Belgium,BEL,0,0,11,0,11
2013,Turkey,TUR,Belgium,BEL,10,0,88,23,121
2013,Uganda,UGA,Belgium,BEL,0,0,5,0,5
2013,Ukraine,UKR,Belgium,BEL,0,0,24,5,29
2013,Uzbekistan,UZB,Belgium,BEL,0,0,5,5,10
2013,Unknown ,,Belgium,BEL,0,0,10,10,20
2013,Myanmar,MMR,Rep. of Korea,KOR,5,0,0,0,5
2013,Unknown ,,Rep. of Korea,KOR,0,0,126,46,172
2013,Albania,ALB,Luxembourg,LUX,10,0,0,0,10
2013,Iraq,IRQ,Luxembourg,LUX,5,0,0,0,5
2013,Mexico,MEX,Luxembourg,LUX,5,0,0,0,5
2013,Serbia and Kosovo: S/RES/1244 (1999),SRB,Luxembourg,LUX,10,0,0,0,10
2014,Afghanistan,AFG,Belgium,BEL,5,0,346,20,371
2014,Albania,ALB,Belgium,BEL,12,0,74,5,91
2014,Algeria,DZA,Belgium,BEL,0,0,38,0,38
2014,Angola,AGO,Belgium,BEL,0,0,95,5,100
2014,Egypt,EGY,Belgium,BEL,0,0,51,0,51
2014,Armenia,ARM,Belgium,BEL,0,0,73,5,78
2014,Azerbaijan,AZE,Belgium,BEL,0,0,23,0,23
2014,Burundi,BDI,Belgium,BEL,0,0,50,5,55
2014,Benin,BEN,Belgium,BEL,5,0,47,0,52
2014,Bangladesh,BGD,Belgium,BEL,0,0,248,11,259
2014,Bhutan,BTN,Belgium,BEL,0,0,5,0,5
2014,Burkina Faso,BFA,Belgium,BEL,5,0,50,5,60
2014,Belarus,BLR,Belgium,BEL,0,0,17,0,17
2014,Bosnia and Herzegovina,BIH,Belgium,BEL,0,0,5,0,5
2014,Bulgaria,BGR,Belgium,BEL,0,0,0,5,5
2014,Chad,TCD,Belgium,BEL,0,0,5,0,5
2014,China,CHN,Belgium,BEL,0,0,148,5,153
2014,Cameroon,CMR,Belgium,BEL,12,0,145,14,171
2014,Congo,COG,Belgium,BEL,0,0,10,0,10
2014,Dem. Rep. of the Congo,COD,Belgium,BEL,19,5,702,30,756
2014,Colombia,COL,Belgium,BEL,0,0,5,0,5
2014,Djibouti,DJI,Belgium,BEL,5,0,22,0,27
2014,Eritrea,ERI,Belgium,BEL,0,0,11,0,11
2014,Ethiopia,ETH,Belgium,BEL,0,0,13,0,13
2014,Gambia,GMB,Belgium,BEL,0,0,24,0,24
2014,Palestinian,PSE,Belgium,BEL,0,0,16,0,16
2014,Georgia,GEO,Belgium,BEL,0,0,67,5,72
2014,Ghana,GHA,Belgium,BEL,0,0,18,5,23
2014,Guinea-Bissau,GNB,Belgium,BEL,0,0,5,0,5
2014,Guinea,GIN,Belgium,BEL,89,5,580,31,705
2014,Cote d'Ivoire,CIV,Belgium,BEL,5,0,111,5,121
2014,India,IND,Belgium,BEL,0,0,16,0,16
2014,Iran (Islamic Rep. of),IRN,Belgium,BEL,0,0,131,11,142
2014,Iraq,IRQ,Belgium,BEL,0,0,73,10,83
2014,Jordan,JOR,Belgium,BEL,0,0,15,0,15
2014,Kazakhstan,KAZ,Belgium,BEL,0,0,23,0,23
2014,Kenya,KEN,Belgium,BEL,0,0,14,0,14
2014,Kyrgyzstan,KGZ,Belgium,BEL,0,0,24,0,24
2014,Liberia,LBR,Belgium,BEL,0,0,10,0,10
2014,Libya,LBY,Belgium,BEL,0,0,5,0,5
2014,Lebanon,LBN,Belgium,BEL,0,0,28,0,28
2014,Sri Lanka,LKA,Belgium,BEL,0,0,20,0,20
2014,Mauritania,MRT,Belgium,BEL,19,0,88,5,112
2014,North Macedonia,MKD,Belgium,BEL,0,0,16,5,21
2014,Rep. of Moldova,MDA,Belgium,BEL,0,0,5,0,5
2014,Mali,MLI,Belgium,BEL,0,0,71,5,76
2014,Mongolia,MNG,Belgium,BEL,0,0,10,0,10
2014,Morocco,MAR,Belgium,BEL,0,0,49,10,59
2014,Mauritius,MUS,Belgium,BEL,0,0,5,0,5
2014,Myanmar,MMR,Belgium,BEL,0,0,10,0,10
2014,Nepal,NPL,Belgium,BEL,0,0,100,5,105
2014,Niger,NER,Belgium,BEL,5,0,60,5,70
2014,Nigeria,NGA,Belgium,BEL,0,0,55,5,60
2014,Pakistan,PAK,Belgium,BEL,0,0,251,15,266
2014,South Africa,ZAF,Belgium,BEL,0,0,5,0,5
2014,Russian Federation,RUS,Belgium,BEL,12,0,176,11,199
2014,Rwanda,RWA,Belgium,BEL,23,0,151,5,179
2014,El Salvador,SLV,Belgium,BEL,0,0,14,0,14
2014,Serbia and Kosovo: S/RES/1244 (1999),SRB,Belgium,BEL,5,0,65,5,75
2014,Senegal,SEN,Belgium,BEL,36,0,160,5,201
2014,Sierra Leone,SLE,Belgium,BEL,0,0,42,5,47
2014,Somalia,SOM,Belgium,BEL,0,0,31,0,31
2014,Sudan,SDN,Belgium,BEL,0,0,17,0,17
2014,Syrian Arab Rep.,SYR,Belgium,BEL,5,5,23,0,33
2014,United Rep. of Tanzania,TZA,Belgium,BEL,5,0,15,0,20
2014,Togo,TGO,Belgium,BEL,10,0,167,5,182
2014,Tunisia,TUN,Belgium,BEL,0,0,20,0,20
2014,Turkey,TUR,Belgium,BEL,20,0,117,10,147
2014,Uganda,UGA,Belgium,BEL,0,0,13,0,13
2014,Ukraine,UKR,Belgium,BEL,0,0,18,0,18
2014,Uzbekistan,UZB,Belgium,BEL,0,0,5,0,5
2014,Venezuela (Bolivarian Republic of),VEN,Belgium,BEL,0,0,5,0,5
2014,Yemen,YEM,Belgium,BEL,0,0,5,0,5
2014,Stateless,XXA,Belgium,BEL,0,0,5,0,5
2014,Unknown ,,Belgium,BEL,0,0,35,0,35
2015,Afghanistan,AFG,Belgium,BEL,0,5,196,23,224
2015,Albania,ALB,Belgium,BEL,10,0,174,76,260
2015,Algeria,DZA,Belgium,BEL,0,0,17,5,22
2015,Angola,AGO,Belgium,BEL,0,0,58,13,71
2015,Egypt,EGY,Belgium,BEL,0,0,41,10,51
2015,Armenia,ARM,Belgium,BEL,5,0,71,22,98
2015,Azerbaijan,AZE,Belgium,BEL,0,0,18,5,23
2015,Burundi,BDI,Belgium,BEL,0,0,27,17,44
2015,Benin,BEN,Belgium,BEL,0,0,32,10,42
2015,Bangladesh,BGD,Belgium,BEL,0,0,57,22,79
2015,Burkina Faso,BFA,Belgium,BEL,0,0,29,5,34
2015,Bosnia and Herzegovina,BIH,Belgium,BEL,0,0,5,0,5
2015,Chad,TCD,Belgium,BEL,0,0,5,0,5
2015,China,CHN,Belgium,BEL,0,0,175,10,185
2015,Cameroon,CMR,Belgium,BEL,13,0,129,19,161
2015,Congo,COG,Belgium,BEL,0,0,5,5,10
2015,Dem. Rep. of the Congo,COD,Belgium,BEL,10,5,297,65,377
2015,Djibouti,DJI,Belgium,BEL,5,0,45,10,60
2015,Eritrea,ERI,Belgium,BEL,0,0,24,5,29
2015,Ethiopia,ETH,Belgium,BEL,0,0,24,0,24
2015,Gambia,GMB,Belgium,BEL,0,0,24,5,29
2015,Palestinian,PSE,Belgium,BEL,5,0,35,10,50
2015,Georgia,GEO,Belgium,BEL,0,0,74,16,90
2015,Ghana,GHA,Belgium,BEL,0,0,12,0,12
2015,Guinea-Bissau,GNB,Belgium,BEL,0,0,5,0,5
2015,Guinea,GIN,Belgium,BEL,72,0,251,62,385
2015,Haiti,HTI,Belgium,BEL,0,0,11,0,11
2015,Cote d'Ivoire,CIV,Belgium,BEL,5,0,54,21,80
2015,India,IND,Belgium,BEL,0,0,0,5,5
2015,Indonesia,IDN,Belgium,BEL,0,0,19,0,19
2015,Iran (Islamic Rep. of),IRN,Belgium,BEL,0,0,83,25,108
2015,Iraq,IRQ,Belgium,BEL,5,5,83,25,118
2015,Jordan,JOR,Belgium,BEL,0,0,5,5,10
2015,Kazakhstan,KAZ,Belgium,BEL,0,0,12,5,17
2015,Kenya,KEN,Belgium,BEL,0,0,10,5,15
2015,Kyrgyzstan,KGZ,Belgium,BEL,0,0,5,0,5
2015,Liberia,LBR,Belgium,BEL,0,0,10,5,15
2015,Libya,LBY,Belgium,BEL,0,0,5,0,5
2015,Lebanon,LBN,Belgium,BEL,5,0,60,5,70
2015,Sri Lanka,LKA,Belgium,BEL,0,0,12,5,17
2015,Mauritania,MRT,Belgium,BEL,5,0,47,15,67
2015,North Macedonia,MKD,Belgium,BEL,0,0,45,30,75
2015,Mali,MLI,Belgium,BEL,5,0,28,0,33
2015,Mongolia,MNG,Belgium,BEL,0,0,5,0,5
2015,Morocco,MAR,Belgium,BEL,0,0,34,5,39
2015,Myanmar,MMR,Belgium,BEL,0,0,15,5,20
2015,Nepal,NPL,Belgium,BEL,0,0,14,5,19
2015,Niger,NER,Belgium,BEL,5,0,35,10,50
2015,Nigeria,NGA,Belgium,BEL,0,5,48,0,53
2015,Pakistan,PAK,Belgium,BEL,0,0,108,24,132
2015,Russian Federation,RUS,Belgium,BEL,5,0,216,52,273
2015,Rwanda,RWA,Belgium,BEL,15,0,118,27,160
2015,Serbia and Kosovo: S/RES/1244 (1999),SRB,Belgium,BEL,14,0,126,62,202
2015,Senegal,SEN,Belgium,BEL,37,0,112,14,163
2015,Sierra Leone,SLE,Belgium,BEL,0,0,10,0,10
2015,Somalia,SOM,Belgium,BEL,0,0,41,5,46
2015,Sudan,SDN,Belgium,BEL,0,0,28,10,38
2015,Syrian Arab Rep.,SYR,Belgium,BEL,0,0,15,5,20
2015,United Rep. of Tanzania,TZA,Belgium,BEL,0,0,5,5,10
2015,Togo,TGO,Belgium,BEL,10,0,67,23,100
2015,Tunisia,TUN,Belgium,BEL,0,0,12,0,12
2015,Turkey,TUR,Belgium,BEL,5,0,65,33,103
2015,Uganda,UGA,Belgium,BEL,0,0,11,0,11
2015,Ukraine,UKR,Belgium,BEL,0,0,108,11,119
2015,Stateless,XXA,Belgium,BEL,0,0,5,0,5
2015,Unknown ,,Belgium,BEL,0,0,76,10,86
2016,Afghanistan,AFG,Belgium,BEL,5,0,346,10,361
2016,Albania,ALB,Belgium,BEL,18,0,241,5,264
2016,Algeria,DZA,Belgium,BEL,0,0,21,0,21
2016,Angola,AGO,Belgium,BEL,0,0,25,0,25
2016,Egypt,EGY,Belgium,BEL,0,0,23,0,23
2016,Armenia,ARM,Belgium,BEL,0,0,65,5,70
2016,Azerbaijan,AZE,Belgium,BEL,0,0,15,0,15
2016,Burundi,BDI,Belgium,BEL,0,0,34,28,62
2016,Benin,BEN,Belgium,BEL,0,0,5,0,5
2016,Bangladesh,BGD,Belgium,BEL,0,0,56,0,56
2016,Burkina Faso,BFA,Belgium,BEL,0,0,13,0,13
2016,Belarus,BLR,Belgium,BEL,0,0,5,0,5
2016,Bosnia and Herzegovina,BIH,Belgium,BEL,0,0,12,0,12
2016,Chad,TCD,Belgium,BEL,0,0,5,0,5
2016,China,CHN,Belgium,BEL,0,0,30,5,35
2016,Cameroon,CMR,Belgium,BEL,11,0,100,5,116
2016,Congo,COG,Belgium,BEL,0,0,5,0,5
2016,Dem. Rep. of the Congo,COD,Belgium,BEL,22,0,318,14,354
2016,Djibouti,DJI,Belgium,BEL,0,0,28,0,28
2016,Dominican Rep.,DOM,Belgium,BEL,0,0,5,0,5
2016,Eritrea,ERI,Belgium,BEL,0,0,29,0,29
2016,Ethiopia,ETH,Belgium,BEL,0,0,46,0,46
2016,Gabon,GAB,Belgium,BEL,0,0,5,0,5
2016,Gambia,GMB,Belgium,BEL,0,0,16,0,16
2016,Palestinian,PSE,Belgium,BEL,0,0,11,0,11
2016,Georgia,GEO,Belgium,BEL,0,0,61,0,61
2016,Ghana,GHA,Belgium,BEL,0,0,16,0,16
2016,Guinea,GIN,Belgium,BEL,31,0,211,11,253
2016,Cote d'Ivoire,CIV,Belgium,BEL,0,0,43,5,48
2016,India,IND,Belgium,BEL,0,0,23,0,23
2016,Iran (Islamic Rep. of),IRN,Belgium,BEL,0,0,38,0,38
2016,Iraq,IRQ,Belgium,BEL,38,10,579,18,645
2016,Jordan,JOR,Belgium,BEL,0,0,5,0,5
2016,Kazakhstan,KAZ,Belgium,BEL,0,0,5,0,5
2016,Kenya,KEN,Belgium,BEL,0,0,10,0,10
2016,Kyrgyzstan,KGZ,Belgium,BEL,0,0,5,0,5
2016,Lebanon,LBN,Belgium,BEL,0,0,23,0,23
2016,Sri Lanka,LKA,Belgium,BEL,0,0,14,0,14
2016,Mauritania,MRT,Belgium,BEL,5,0,31,5,41
2016,North Macedonia,MKD,Belgium,BEL,0,0,47,0,47
2016,Rep. of Moldova,MDA,Belgium,BEL,0,0,5,0,5
2016,Mexico,MEX,Belgium,BEL,0,0,5,0,5
2016,Mali,MLI,Belgium,BEL,0,0,14,0,14
2016,Mongolia,MNG,Belgium,BEL,0,0,5,0,5
2016,Morocco,MAR,Belgium,BEL,0,0,42,5,47
2016,Montenegro,MNE,Belgium,BEL,0,0,5,0,5
2016,Nepal,NPL,Belgium,BEL,0,0,21,0,21
2016,Niger,NER,Belgium,BEL,0,0,28,0,28
2016,Nigeria,NGA,Belgium,BEL,0,0,46,0,46
2016,Pakistan,PAK,Belgium,BEL,0,0,149,10,159
2016,Russian Federation,RUS,Belgium,BEL,10,0,188,10,208
2016,Rwanda,RWA,Belgium,BEL,10,0,115,16,141
2016,Serbia and Kosovo: S/RES/1244 (1999),SRB,Belgium,BEL,10,0,137,10,157
2016,Senegal,SEN,Belgium,BEL,12,0,79,5,96
2016,Sierra Leone,SLE,Belgium,BEL,0,0,5,0,5
2016,Somalia,SOM,Belgium,BEL,0,0,241,0,241
2016,Sudan,SDN,Belgium,BEL,0,0,18,0,18
2016,Syrian Arab Rep.,SYR,Belgium,BEL,5,0,25,0,30
2016,United Rep. of Tanzania,TZA,Belgium,BEL,0,0,5,0,5
2016,Tajikistan,TJK,Belgium,BEL,0,0,5,0,5
2016,Togo,TGO,Belgium,BEL,10,0,77,0,87
2016,Tunisia,TUN,Belgium,BEL,0,0,17,0,17
2016,Turkey,TUR,Belgium,BEL,10,0,34,10,54
2016,Ukraine,UKR,Belgium,BEL,5,0,74,0,79
2016,Uzbekistan,UZB,Belgium,BEL,0,0,5,0,5
2016,Zimbabwe,ZWE,Belgium,BEL,0,0,10,0,10
2016,Unknown ,,Belgium,BEL,0,0,29,0,29
2003,Algeria,DZA,Spain,ESP,0,5,13,0,18
2003,Angola,AGO,Spain,ESP,0,0,5,0,5
2003,Armenia,ARM,Spain,ESP,0,11,36,0,47
2003,Azerbaijan,AZE,Spain,ESP,0,0,5,0,5
2003,Dem. Rep. of the Congo,COD,Spain,ESP,0,0,12,0,12
2003,Colombia,COL,Spain,ESP,5,0,25,0,30
2003,Cuba,CUB,Spain,ESP,0,0,11,0,11
2003,Equatorial Guinea,GNQ,Spain,ESP,5,0,5,0,10
2003,Georgia,GEO,Spain,ESP,0,0,12,0,12
2003,Iran (Islamic Rep. of),IRN,Spain,ESP,0,0,5,0,5
2003,Nigeria,NGA,Spain,ESP,0,0,5,0,5
2003,Russian Federation,RUS,Spain,ESP,5,0,10,0,15
2003,Serbia and Kosovo: S/RES/1244 (1999),SRB,Spain,ESP,0,0,5,0,5
2003,Tajikistan,TJK,Spain,ESP,0,0,5,0,5
2003,Turkey,TUR,Spain,ESP,0,0,5,0,5
2003,Ukraine,UKR,Spain,ESP,0,0,5,0,5
2003,Afghanistan,AFG,Ukraine,UKR,0,41,50,0,91
2003,Angola,AGO,Ukraine,UKR,0,36,10,0,46
2003,Armenia,ARM,Ukraine,UKR,0,0,14,0,14
2003,Bangladesh,BGD,Ukraine,UKR,0,0,5,0,5
2003,China,CHN,Ukraine,UKR,0,0,5,0,5
2003,Congo,COG,Ukraine,UKR,0,0,5,0,5
2003,Ethiopia,ETH,Ukraine,UKR,0,5,5,0,10
2003,Palestinian,PSE,Ukraine,UKR,0,0,5,0,5
2003,India,IND,Ukraine,UKR,0,0,5,0,5
2003,Iran (Islamic Rep. of),IRN,Ukraine,UKR,0,21,10,0,31
2003,Iraq,IRQ,Ukraine,UKR,0,27,41,0,68
2003,Lebanon,LBN,Ukraine,UKR,0,0,5,0,5
2003,Sri Lanka,LKA,Ukraine,UKR,0,17,18,0,35
2003,Nigeria,NGA,Ukraine,UKR,0,0,5,0,5
2003,Russian Federation,RUS,Ukraine,UKR,0,5,23,0,28
2003,Somalia,SOM,Ukraine,UKR,0,27,11,0,38
2003,Syrian Arab Rep.,SYR,Ukraine,UKR,0,5,5,0,10
2004,Afghanistan,AFG,Azerbaijan,AZE,0,0,5,0,5
2004,Afghanistan,AFG,Japan,JPN,0,0,0,15,15
2004,Myanmar,MMR,Japan,JPN,0,0,0,13,13
2004,Unknown ,,Japan,JPN,0,0,0,27,27
2004,Colombia,COL,Spain,ESP,16,10,0,0,26
2004,Ethiopia,ETH,Spain,ESP,5,0,0,0,5
2004,Iraq,IRQ,Spain,ESP,0,5,0,0,5
2004,Russian Federation,RUS,Spain,ESP,5,0,0,0,5
2005,Afghanistan,AFG,Azerbaijan,AZE,0,0,67,5,72
2005,Iran (Islamic Rep. of),IRN,Azerbaijan,AZE,0,0,10,0,10
2005,Iraq,IRQ,Azerbaijan,AZE,0,0,12,0,12
2005,Pakistan,PAK,Azerbaijan,AZE,0,0,10,0,10
2005,Iran (Islamic Rep. of),IRN,Japan,JPN,0,0,0,5,5
2005,Myanmar,MMR,Japan,JPN,0,0,0,13,13
2005,Unknown ,,Japan,JPN,0,0,52,5,57
2005,Afghanistan,AFG,Ukraine,UKR,0,0,30,49,79
2005,Algeria,DZA,Ukraine,UKR,0,0,0,5,5
2005,Angola,AGO,Ukraine,UKR,0,0,10,5,15
2005,Armenia,ARM,Ukraine,UKR,0,0,5,5,10
2005,Azerbaijan,AZE,Ukraine,UKR,0,0,5,5,10
2005,Bangladesh,BGD,Ukraine,UKR,0,0,30,11,41
2005,Chad,TCD,Ukraine,UKR,0,0,5,14,19
2005,China,CHN,Ukraine,UKR,0,0,25,0,25
2005,Congo,COG,Ukraine,UKR,0,0,0,10,10
2005,Dem. Rep. of the Congo,COD,Ukraine,UKR,0,0,14,0,14
2005,Cuba,CUB,Ukraine,UKR,0,0,0,5,5
2005,Ethiopia,ETH,Ukraine,UKR,0,0,5,5,10
2005,Palestinian,PSE,Ukraine,UKR,0,0,22,11,33
2005,Georgia,GEO,Ukraine,UKR,0,0,0,5,5
2005,Guinea-Bissau,GNB,Ukraine,UKR,0,0,0,5,5
2005,India,IND,Ukraine,UKR,0,0,129,5,134
2005,Iran (Islamic Rep. of),IRN,Ukraine,UKR,0,0,5,30,35
2005,Iraq,IRQ,Ukraine,UKR,5,0,15,17,37
2005,Kenya,KEN,Ukraine,UKR,0,0,0,10,10
2005,Liberia,LBR,Ukraine,UKR,0,0,0,5,5
2005,Lebanon,LBN,Ukraine,UKR,0,0,0,5,5
2005,Sri Lanka,LKA,Ukraine,UKR,0,0,5,11,16
2005,Nigeria,NGA,Ukraine,UKR,0,0,23,0,23
2005,Pakistan,PAK,Ukraine,UKR,0,0,45,17,62
2005,Russian Federation,RUS,Ukraine,UKR,0,0,10,15,25
2005,Sierra Leone,SLE,Ukraine,UKR,0,0,5,0,5
2005,Somalia,SOM,Ukraine,UKR,0,0,5,5,10
2005,Viet Nam,VNM,Ukraine,UKR,0,0,13,0,13
2005,Sudan,SDN,Ukraine,UKR,0,0,0,5,5
2005,Syrian Arab Rep.,SYR,Ukraine,UKR,0,0,5,5,10
2005,Tajikistan,TJK,Ukraine,UKR,0,0,0,5,5
2005,Uganda,UGA,Ukraine,UKR,0,0,0,5,5
2006,Unknown ,,Luxembourg,LUX,0,0,149,18,167
2007,Unknown ,,Japan,JPN,0,0,125,0,125
2008,Unknown ,,Japan,JPN,5,0,5,0,10
2009,Unknown ,,Japan,JPN,5,0,5,0,10
2010,Unknown ,,Japan,JPN,10,0,60,0,70
2010,Unknown ,,Luxembourg,LUX,5,0,48,5,58
2010,Afghanistan,AFG,Netherlands,NLD,5,83,87,0,175
2010,Angola,AGO,Netherlands,NLD,0,5,5,0,10
2010,Armenia,ARM,Netherlands,NLD,5,29,33,0,67
2010,Azerbaijan,AZE,Netherlands,NLD,5,5,10,0,20
2010,Burundi,BDI,Netherlands,NLD,0,10,10,0,20
2010,Benin,BEN,Netherlands,NLD,0,5,5,0,10
2010,Bangladesh,BGD,Netherlands,NLD,0,0,5,0,5
2010,China,CHN,Netherlands,NLD,0,10,12,0,22
2010,Congo,COG,Netherlands,NLD,0,11,12,0,23
2010,Colombia,COL,Netherlands,NLD,0,5,5,0,10
2010,Eritrea,ERI,Netherlands,NLD,0,10,12,0,22
2010,Georgia,GEO,Netherlands,NLD,0,5,5,0,10
2010,Guinea,GIN,Netherlands,NLD,0,10,11,0,21
2010,Cote d'Ivoire,CIV,Netherlands,NLD,0,5,5,0,10
2010,Iran (Islamic Rep. of),IRN,Netherlands,NLD,14,14,28,0,56
2010,Iraq,IRQ,Netherlands,NLD,39,182,221,0,442
2010,Kenya,KEN,Netherlands,NLD,0,5,5,0,10
2010,Libya,LBY,Netherlands,NLD,0,5,5,0,10
2010,Sri Lanka,LKA,Netherlands,NLD,5,23,26,0,54
2010,Myanmar,MMR,Netherlands,NLD,0,0,5,0,5
2010,Nigeria,NGA,Netherlands,NLD,0,0,5,0,5
2010,Russian Federation,RUS,Netherlands,NLD,0,5,5,0,10
2010,Serbia and Kosovo: S/RES/1244 (1999),SRB,Netherlands,NLD,0,5,5,0,10
2010,Sierra Leone,SLE,Netherlands,NLD,0,10,10,0,20
2010,Somalia,SOM,Netherlands,NLD,0,93,95,0,188
2010,Sudan,SDN,Netherlands,NLD,0,5,5,0,10
2010,Syrian Arab Rep.,SYR,Netherlands,NLD,0,5,10,0,15
2010,Turkey,TUR,Netherlands,NLD,0,5,5,0,10
2010,Stateless,XXA,Netherlands,NLD,0,5,5,0,10
2010,Unknown ,,Netherlands,NLD,0,28,30,0,58
2010,Afghanistan,AFG,Sweden,SWE,36,71,413,76,596
2010,Albania,ALB,Sweden,SWE,0,10,69,5,84
2010,Algeria,DZA,Sweden,SWE,0,0,78,13,91
2010,Angola,AGO,Sweden,SWE,0,0,13,0,13
2010,Egypt,EGY,Sweden,SWE,5,0,81,37,123
2010,Armenia,ARM,Sweden,SWE,0,16,215,30,261
2010,Azerbaijan,AZE,Sweden,SWE,0,10,255,77,342
2010,Burundi,BDI,Sweden,SWE,0,5,68,5,78
2010,Bangladesh,BGD,Sweden,SWE,0,5,97,22,124
2010,Bhutan,BTN,Sweden,SWE,0,0,10,0,10
2010,Burkina Faso,BFA,Sweden,SWE,0,0,5,0,5
2010,Belarus,BLR,Sweden,SWE,0,0,142,50,192
2010,Bolivia (Plurinational State of),BOL,Sweden,SWE,0,0,38,11,49
2010,Brazil,BRA,Sweden,SWE,0,0,5,0,5
2010,Bosnia and Herzegovina,BIH,Sweden,SWE,0,0,73,5,78
2010,Chad,TCD,Sweden,SWE,0,0,5,0,5
2010,China,CHN,Sweden,SWE,14,0,33,5,52
2010,Chile,CHL,Sweden,SWE,0,0,10,0,10
2010,Cameroon,CMR,Sweden,SWE,0,0,23,5,28
2010,Dem. Rep. of the Congo,COD,Sweden,SWE,0,5,63,5,73
2010,Colombia,COL,Sweden,SWE,0,0,10,5,15
2010,Cuba,CUB,Sweden,SWE,0,0,27,5,32
2010,Ecuador,ECU,Sweden,SWE,0,0,11,0,11
2010,Eritrea,ERI,Sweden,SWE,14,21,153,32,220
2010,Ethiopia,ETH,Sweden,SWE,16,5,163,10,194
2010,Gambia,GMB,Sweden,SWE,0,0,19,5,24
2010,Georgia,GEO,Sweden,SWE,0,5,144,33,182
2010,Ghana,GHA,Sweden,SWE,0,0,29,5,34
2010,Guinea-Bissau,GNB,Sweden,SWE,0,0,5,0,5
2010,Guinea,GIN,Sweden,SWE,0,0,33,0,33
2010,Honduras,HND,Sweden,SWE,0,0,5,5,10
2010,Cote d'Ivoire,CIV,Sweden,SWE,0,0,27,0,27
2010,India,IND,Sweden,SWE,0,5,33,5,43
2010,Indonesia,IDN,Sweden,SWE,0,0,10,5,15
2010,Iran (Islamic Rep. of),IRN,Sweden,SWE,65,55,558,98,776
2010,Iraq,IRQ,Sweden,SWE,60,147,3498,343,4048
2010,Israel,ISR,Sweden,SWE,0,0,12,0,12
2010,Jordan,JOR,Sweden,SWE,0,5,108,44,157
2010,Kazakhstan,KAZ,Sweden,SWE,0,5,184,33,222
2010,Kenya,KEN,Sweden,SWE,0,0,59,22,81
2010,Kyrgyzstan,KGZ,Sweden,SWE,0,0,111,16,127
2010,Kuwait,KWT,Sweden,SWE,0,0,5,0,5
2010,Liberia,LBR,Sweden,SWE,0,0,18,0,18
2010,Libya,LBY,Sweden,SWE,5,0,380,59,444
2010,Lebanon,LBN,Sweden,SWE,5,5,176,29,215
2010,Sri Lanka,LKA,Sweden,SWE,0,0,39,5,44
2010,Lithuania,LTU,Sweden,SWE,0,0,13,0,13
2010,Mauritania,MRT,Sweden,SWE,0,0,5,0,5
2010,North Macedonia,MKD,Sweden,SWE,0,0,115,32,147
2010,Rep. of Moldova,MDA,Sweden,SWE,0,0,10,0,10
2010,Mexico,MEX,Sweden,SWE,0,0,5,0,5
2010,Mongolia,MNG,Sweden,SWE,0,5,483,85,573
2010,Morocco,MAR,Sweden,SWE,0,0,24,5,29
2010,Montenegro,MNE,Sweden,SWE,0,0,26,0,26
2010,Nepal,NPL,Sweden,SWE,0,0,55,0,55
2010,Nicaragua,NIC,Sweden,SWE,0,5,20,5,30
2010,Nigeria,NGA,Sweden,SWE,5,10,168,28,211
2010,Pakistan,PAK,Sweden,SWE,0,10,45,12,67
2010,Peru,PER,Sweden,SWE,0,0,16,10,26
2010,Philippines,PHL,Sweden,SWE,0,0,5,0,5
2010,Russian Federation,RUS,Sweden,SWE,5,17,504,81,607
2010,Rwanda,RWA,Sweden,SWE,0,0,10,0,10
2010,El Salvador,SLV,Sweden,SWE,0,0,48,5,53
2010,Serbia and Kosovo: S/RES/1244 (1999),SRB,Sweden,SWE,0,53,2319,361,2733
2010,Senegal,SEN,Sweden,SWE,0,0,5,0,5
2010,Sierra Leone,SLE,Sweden,SWE,0,0,19,0,19
2010,Somalia,SOM,Sweden,SWE,5,377,691,66,1139
2010,Viet Nam,VNM,Sweden,SWE,0,0,104,5,109
2010,Sudan,SDN,Sweden,SWE,5,5,39,10,59
2010,Syrian Arab Rep.,SYR,Sweden,SWE,5,13,481,68,567
2010,United Rep. of Tanzania,TZA,Sweden,SWE,0,0,21,14,35
2010,Thailand,THA,Sweden,SWE,0,0,12,0,12
2010,Tajikistan,TJK,Sweden,SWE,0,0,15,0,15
2010,Turkmenistan,TKM,Sweden,SWE,0,0,10,0,10
2010,Togo,TGO,Sweden,SWE,0,0,5,0,5
2010,Tunisia,TUN,Sweden,SWE,0,0,37,12,49
2010,Turkey,TUR,Sweden,SWE,0,5,133,49,187
2010,Uganda,UGA,Sweden,SWE,0,0,44,0,44
2010,Ukraine,UKR,Sweden,SWE,0,0,64,10,74
2010,Uzbekistan,UZB,Sweden,SWE,10,11,398,45,464
2010,Venezuela (Bolivarian Republic of),VEN,Sweden,SWE,0,0,10,0,10
2010,Yemen,YEM,Sweden,SWE,12,5,96,13,126
2010,Zimbabwe,ZWE,Sweden,SWE,0,0,5,0,5
2010,Stateless,XXA,Sweden,SWE,10,63,587,59,719
2010,Unknown ,,Sweden,SWE,0,11,461,87,559
2011,Iran (Islamic Rep. of),IRN,Armenia,ARM,0,0,0,5,5
2011,Afghanistan,AFG,France,FRA,65,109,118,0,292
2011,Albania,ALB,France,FRA,19,59,268,0,346
2011,Algeria,DZA,France,FRA,29,23,579,0,631
2011,Angola,AGO,France,FRA,45,5,407,0,457
2011,Egypt,EGY,France,FRA,42,0,19,0,61
2011,Armenia,ARM,France,FRA,170,62,2133,0,2365
2011,Azerbaijan,AZE,France,FRA,126,11,427,0,564
2011,Burundi,BDI,France,FRA,0,0,10,0,10
2011,Benin,BEN,France,FRA,0,0,5,0,5
2011,Bangladesh,BGD,France,FRA,334,10,2087,0,2431
2011,Bhutan,BTN,France,FRA,10,0,5,0,15
2011,Burkina Faso,BFA,France,FRA,0,0,22,0,22
2011,Belarus,BLR,France,FRA,16,0,30,0,46
2011,Bolivia (Plurinational State of),BOL,France,FRA,0,0,5,0,5
2011,Brazil,BRA,France,FRA,0,0,5,0,5
2011,Bosnia and Herzegovina,BIH,France,FRA,20,5,231,0,256
2011,Cambodia,KHM,France,FRA,0,0,10,0,10
2011,Central African Rep.,CAF,France,FRA,5,0,77,0,82
2011,Chad,TCD,France,FRA,51,0,123,0,174
2011,China,CHN,France,FRA,21,5,825,0,851
2011,Cameroon,CMR,France,FRA,19,5,111,0,135
2011,Congo,COG,France,FRA,46,13,510,0,569
2011,Dem. Rep. of the Congo,COD,France,FRA,276,33,1723,0,2032
2011,Comoros,COM,France,FRA,5,0,205,0,210
2011,Colombia,COL,France,FRA,14,5,47,0,66
2011,Djibouti,DJI,France,FRA,0,0,5,0,5
2011,Dominican Rep.,DOM,France,FRA,0,0,30,0,30
2011,Ecuador,ECU,France,FRA,0,0,5,0,5
2011,Equatorial Guinea,GNQ,France,FRA,0,0,5,0,5
2011,Eritrea,ERI,France,FRA,58,15,79,0,152
2011,Ethiopia,ETH,France,FRA,13,0,25,0,38
2011,Gabon,GAB,France,FRA,0,0,10,0,10
2011,Gambia,GMB,France,FRA,0,5,37,0,42
2011,Palestinian,PSE,France,FRA,5,0,28,0,33
2011,Georgia,GEO,France,FRA,74,5,426,0,505
2011,Ghana,GHA,France,FRA,0,0,14,0,14
2011,Guinea-Bissau,GNB,France,FRA,5,0,93,0,98
2011,Guinea,GIN,France,FRA,207,61,1243,0,1511
2011,Haiti,HTI,France,FRA,30,64,1093,0,1187
2011,Cote d'Ivoire,CIV,France,FRA,26,28,283,0,337
2011,India,IND,France,FRA,0,0,34,0,34
2011,Iran (Islamic Rep. of),IRN,France,FRA,44,0,38,0,82
2011,Iraq,IRQ,France,FRA,19,5,49,0,73
2011,Israel,ISR,France,FRA,0,0,5,0,5
2011,Kazakhstan,KAZ,France,FRA,5,10,74,0,89
2011,Kenya,KEN,France,FRA,0,0,11,0,11
2011,Kyrgyzstan,KGZ,France,FRA,21,5,34,0,60
2011,Dem. People's Rep. of Korea,PRK,France,FRA,0,0,19,0,19
2011,Liberia,LBR,France,FRA,0,0,16,0,16
2011,Lebanon,LBN,France,FRA,0,0,19,0,19
2011,Sri Lanka,LKA,France,FRA,843,47,2254,0,3144
2011,Madagascar,MDG,France,FRA,10,0,77,0,87
2011,Mauritania,MRT,France,FRA,92,23,1066,0,1181
2011,North Macedonia,MKD,France,FRA,14,0,252,0,266
2011,Rep. of Moldova,MDA,France,FRA,5,5,122,0,132
2011,Mexico,MEX,France,FRA,0,0,5,0,5
2011,Mali,MLI,France,FRA,5,78,123,0,206
2011,Mongolia,MNG,France,FRA,10,10,115,0,135
2011,Morocco,MAR,France,FRA,0,0,29,0,29
2011,Montenegro,MNE,France,FRA,10,0,47,0,57
2011,Myanmar,MMR,France,FRA,5,0,18,0,23
2011,Nepal,NPL,France,FRA,5,0,28,0,33
2011,Niger,NER,France,FRA,0,0,12,0,12
2011,Nigeria,NGA,France,FRA,19,26,486,0,531
2011,Pakistan,PAK,France,FRA,47,5,474,0,526
2011,Peru,PER,France,FRA,5,5,97,0,107
2011,Philippines,PHL,France,FRA,0,0,5,0,5
2011,South Africa,ZAF,France,FRA,0,0,5,0,5
2011,Russian Federation,RUS,France,FRA,791,100,1219,0,2110
2011,Rwanda,RWA,France,FRA,32,0,41,0,73
2011,Serbia and Kosovo: S/RES/1244 (1999),SRB,France,FRA,591,232,3108,0,3931
2011,Senegal,SEN,France,FRA,15,14,64,0,93
2011,Sierra Leone,SLE,France,FRA,5,5,92,0,102
2011,Somalia,SOM,France,FRA,10,15,29,0,54
2011,Viet Nam,VNM,France,FRA,0,0,12,0,12
2011,Sudan,SDN,France,FRA,186,43,366,0,595
2011,Suriname,SUR,France,FRA,0,0,5,0,5
2011,Syrian Arab Rep.,SYR,France,FRA,43,5,5,0,53
2011,Thailand,THA,France,FRA,0,0,14,0,14
2011,Tajikistan,TJK,France,FRA,0,0,11,0,11
2011,Togo,TGO,France,FRA,10,0,113,0,123
2011,Tunisia,TUN,France,FRA,0,0,17,0,17
2011,Turkey,TUR,France,FRA,202,12,1467,0,1681
2011,Uganda,UGA,France,FRA,5,0,5,0,10
2011,Ukraine,UKR,France,FRA,5,0,46,0,51
2011,Uzbekistan,UZB,France,FRA,0,5,15,0,20
2011,Venezuela (Bolivarian Republic of),VEN,France,FRA,0,0,5,0,5
2011,Western Sahara,ESH,France,FRA,0,0,5,0,5
2011,Zimbabwe,ZWE,France,FRA,0,0,5,0,5
2011,Unknown ,,France,FRA,17,5,0,0,22
2011,Unknown ,,Japan,JPN,5,0,10,0,15
2011,Unknown ,,Rep. of Korea,KOR,17,0,241,0,258
2011,Serbia and Kosovo: S/RES/1244 (1999),SRB,Luxembourg,LUX,0,0,0,12,12
2011,Unknown ,,Luxembourg,LUX,0,0,192,0,192
2011,Afghanistan,AFG,Netherlands,NLD,18,299,278,0,595
2011,Angola,AGO,Netherlands,NLD,0,0,5,0,5
2011,Egypt,EGY,Netherlands,NLD,0,0,5,0,5
2011,Armenia,ARM,Netherlands,NLD,5,13,29,0,47
2011,Azerbaijan,AZE,Netherlands,NLD,0,0,10,0,10
2011,Burundi,BDI,Netherlands,NLD,0,0,10,0,10
2011,Bangladesh,BGD,Netherlands,NLD,0,0,5,0,5
2011,Bosnia and Herzegovina,BIH,Netherlands,NLD,0,0,5,0,5
2011,China,CHN,Netherlands,NLD,14,33,12,0,59
2011,Cameroon,CMR,Netherlands,NLD,0,5,5,0,10
2011,Congo,COG,Netherlands,NLD,5,0,10,0,15
2011,Dem. Rep. of the Congo,COD,Netherlands,NLD,0,0,5,0,5
2011,Eritrea,ERI,Netherlands,NLD,5,47,16,0,68
2011,Ethiopia,ETH,Netherlands,NLD,0,11,10,0,21
2011,Palestinian,PSE,Netherlands,NLD,0,0,5,0,5
2011,Georgia,GEO,Netherlands,NLD,0,0,17,0,17
2011,Guinea,GIN,Netherlands,NLD,0,15,24,0,39
2011,Cote d'Ivoire,CIV,Netherlands,NLD,0,0,5,0,5
2011,Iran (Islamic Rep. of),IRN,Netherlands,NLD,22,50,44,0,116
2011,Iraq,IRQ,Netherlands,NLD,15,142,179,0,336
2011,Libya,LBY,Netherlands,NLD,0,0,5,0,5
2011,Sri Lanka,LKA,Netherlands,NLD,5,23,26,0,54
2011,North Macedonia,MKD,Netherlands,NLD,0,0,10,0,10
2011,Mongolia,MNG,Netherlands,NLD,0,0,14,0,14
2011,Myanmar,MMR,Netherlands,NLD,0,5,0,0,5
2011,Nepal,NPL,Netherlands,NLD,0,5,5,0,10
2011,Nigeria,NGA,Netherlands,NLD,0,5,10,0,15
2011,Pakistan,PAK,Netherlands,NLD,5,5,0,0,10
2011,Russian Federation,RUS,Netherlands,NLD,0,5,22,0,27
2011,Serbia and Kosovo: S/RES/1244 (1999),SRB,Netherlands,NLD,0,0,10,0,10
2011,Sierra Leone,SLE,Netherlands,NLD,0,10,11,0,21
2011,Somalia,SOM,Netherlands,NLD,10,675,310,0,995
2011,Sudan,SDN,Netherlands,NLD,5,5,24,0,34
2011,Syrian Arab Rep.,SYR,Netherlands,NLD,0,0,5,0,5
2011,Turkey,TUR,Netherlands,NLD,0,0,10,0,10
2011,Uganda,UGA,Netherlands,NLD,5,0,5,0,10
2011,Ukraine,UKR,Netherlands,NLD,0,0,5,0,5
2011,Stateless,XXA,Netherlands,NLD,0,5,10,0,15
2011,Unknown ,,Netherlands,NLD,0,49,41,0,90
2011,Afghanistan,AFG,Ukraine,UKR,5,5,38,59,107
2011,Bangladesh,BGD,Ukraine,UKR,0,0,0,5,5
2011,Cameroon,CMR,Ukraine,UKR,0,0,5,10,15
2011,Congo,COG,Ukraine,UKR,0,0,0,5,5
2011,Dem. Rep. of the Congo,COD,Ukraine,UKR,0,0,10,10,20
2011,Palestinian,PSE,Ukraine,UKR,0,0,5,10,15
2011,Guinea,GIN,Ukraine,UKR,0,0,10,5,15
2011,Cote d'Ivoire,CIV,Ukraine,UKR,0,0,0,5,5
2011,India,IND,Ukraine,UKR,0,0,5,5,10
2011,Iran (Islamic Rep. of),IRN,Ukraine,UKR,0,0,0,5,5
2011,Iraq,IRQ,Ukraine,UKR,0,0,5,5,10
2011,Kyrgyzstan,KGZ,Ukraine,UKR,0,0,44,25,69
2011,Nigeria,NGA,Ukraine,UKR,0,0,0,5,5
2011,Pakistan,PAK,Ukraine,UKR,0,0,0,10,10
2011,Russian Federation,RUS,Ukraine,UKR,0,0,5,10,15
2011,Somalia,SOM,Ukraine,UKR,0,0,5,43,48
2011,Syrian Arab Rep.,SYR,Ukraine,UKR,0,0,10,5,15
2011,Uzbekistan,UZB,Ukraine,UKR,0,5,0,5,10
2012,Iran (Islamic Rep. of),IRN,Armenia,ARM,0,0,0,5,5
2012,Turkey,TUR,Armenia,ARM,0,0,5,0,5
2012,Afghanistan,AFG,Belarus,BLR,0,0,22,0,22
2012,Afghanistan,AFG,Croatia,HRV,0,0,5,0,5
2012,Algeria,DZA,Croatia,HRV,0,0,5,0,5
2012,Bosnia and Herzegovina,BIH,Croatia,HRV,0,0,5,0,5
2012,Morocco,MAR,Croatia,HRV,0,0,5,0,5
2012,Russian Federation,RUS,Croatia,HRV,0,0,5,0,5
2012,Unknown ,,Japan,JPN,5,0,5,0,10
2012,Unknown ,,Luxembourg,LUX,0,0,76,22,98
2012,Armenia,ARM,Rep. of Moldova,MDA,0,0,10,0,10
2012,Turkey,TUR,Rep. of Moldova,MDA,0,0,5,0,5
2012,Burundi,BDI,Mozambique,MOZ,0,0,0,25,25
2012,Dem. Rep. of the Congo,COD,Mozambique,MOZ,0,0,0,52,52
2012,Cote d'Ivoire,CIV,Mozambique,MOZ,0,0,0,5,5
2012,Afghanistan,AFG,Netherlands,NLD,5,52,98,0,155
2012,Egypt,EGY,Netherlands,NLD,0,5,5,0,10
2012,Armenia,ARM,Netherlands,NLD,0,10,25,0,35
2012,Azerbaijan,AZE,Netherlands,NLD,0,0,10,0,10
2012,Burundi,BDI,Netherlands,NLD,0,0,10,0,10
2012,Bangladesh,BGD,Netherlands,NLD,0,0,5,0,5
2012,China,CHN,Netherlands,NLD,0,5,5,0,10
2012,Congo,COG,Netherlands,NLD,0,0,5,0,5
2012,Dem. Rep. of the Congo,COD,Netherlands,NLD,0,0,5,0,5
2012,Eritrea,ERI,Netherlands,NLD,0,5,14,0,19
2012,Gambia,GMB,Netherlands,NLD,0,0,5,0,5
2012,Palestinian,PSE,Netherlands,NLD,0,0,5,0,5
2012,Georgia,GEO,Netherlands,NLD,0,0,11,0,11
2012,Guinea,GIN,Netherlands,NLD,0,5,16,0,21
2012,Croatia,HRV,Netherlands,NLD,0,0,5,0,5
2012,Cote d'Ivoire,CIV,Netherlands,NLD,0,5,5,0,10
2012,Iran (Islamic Rep. of),IRN,Netherlands,NLD,32,35,56,0,123
2012,Iraq,IRQ,Netherlands,NLD,12,44,66,0,122
2012,Jamaica,JAM,Netherlands,NLD,0,0,5,0,5
2012,Libya,LBY,Netherlands,NLD,0,0,33,0,33
2012,Sri Lanka,LKA,Netherlands,NLD,5,5,14,0,24
2012,Mongolia,MNG,Netherlands,NLD,0,0,5,0,5
2012,Nepal,NPL,Netherlands,NLD,0,0,5,0,5
2012,Nigeria,NGA,Netherlands,NLD,0,5,12,0,17
2012,Pakistan,PAK,Netherlands,NLD,0,5,5,0,10
2012,Russian Federation,RUS,Netherlands,NLD,0,5,18,0,23
2012,Sierra Leone,SLE,Netherlands,NLD,0,0,10,0,10
2012,Somalia,SOM,Netherlands,NLD,0,107,127,0,234
2012,Sudan,SDN,Netherlands,NLD,0,5,15,0,20
2012,Syrian Arab Rep.,SYR,Netherlands,NLD,0,27,0,0,27
2012,Turkey,TUR,Netherlands,NLD,0,0,5,0,5
2012,Uganda,UGA,Netherlands,NLD,0,0,5,0,5
2012,Stateless,XXA,Netherlands,NLD,0,0,12,0,12
2012,Unknown ,,Netherlands,NLD,0,5,14,0,19
2012,Unknown ,,South Africa,ZAF,1676,0,38628,0,40304
2013,Afghanistan,AFG,Belarus,BLR,0,0,16,5,21
2013,Georgia,GEO,Belarus,BLR,0,0,11,0,11
2013,Pakistan,PAK,Belarus,BLR,0,0,5,0,5
2013,Afghanistan,AFG,Croatia,HRV,0,0,5,0,5
2013,Algeria,DZA,Croatia,HRV,0,0,35,0,35
2013,Morocco,MAR,Croatia,HRV,0,0,11,0,11
2013,Russian Federation,RUS,Croatia,HRV,0,0,5,0,5
2013,Somalia,SOM,Croatia,HRV,0,0,5,5,10
2013,Tunisia,TUN,Croatia,HRV,0,0,10,0,10
2013,Myanmar,MMR,Japan,JPN,0,0,5,0,5
2013,Unknown ,,Japan,JPN,0,0,15,0,15
2013,Armenia,ARM,Rep. of Moldova,MDA,0,0,5,0,5
2013,Turkey,TUR,Rep. of Moldova,MDA,0,0,5,0,5
2013,Afghanistan,AFG,Netherlands,NLD,88,137,178,0,403
2013,Algeria,DZA,Netherlands,NLD,0,0,5,0,5
2013,Egypt,EGY,Netherlands,NLD,0,16,21,0,37
2013,Armenia,ARM,Netherlands,NLD,5,0,47,0,52
2013,Azerbaijan,AZE,Netherlands,NLD,5,5,10,0,20
2013,Bangladesh,BGD,Netherlands,NLD,0,5,0,0,5
2013,Belarus,BLR,Netherlands,NLD,0,0,10,0,10
2013,Bosnia and Herzegovina,BIH,Netherlands,NLD,0,0,10,0,10
2013,China,CHN,Netherlands,NLD,22,29,10,0,61
2013,Cameroon,CMR,Netherlands,NLD,0,0,5,0,5
2013,Congo,COG,Netherlands,NLD,5,5,10,0,20
2013,Colombia,COL,Netherlands,NLD,0,0,5,0,5
2013,Eritrea,ERI,Netherlands,NLD,0,19,10,0,29
2013,Ethiopia,ETH,Netherlands,NLD,0,5,0,0,5
2013,Palestinian,PSE,Netherlands,NLD,0,0,5,0,5
2013,Georgia,GEO,Netherlands,NLD,5,0,10,0,15
2013,Ghana,GHA,Netherlands,NLD,0,0,5,0,5
2013,Guinea,GIN,Netherlands,NLD,0,10,5,0,15
2013,Cote d'Ivoire,CIV,Netherlands,NLD,0,5,10,0,15
2013,Iran (Islamic Rep. of),IRN,Netherlands,NLD,214,86,51,0,351
2013,Iraq,IRQ,Netherlands,NLD,57,82,80,0,219
2013,Jamaica,JAM,Netherlands,NLD,0,0,5,0,5
2013,Kenya,KEN,Netherlands,NLD,0,0,5,0,5
2013,Libya,LBY,Netherlands,NLD,0,5,17,0,22
2013,Sri Lanka,LKA,Netherlands,NLD,5,15,19,0,39
2013,Mongolia,MNG,Netherlands,NLD,0,0,5,0,5
2013,Morocco,MAR,Netherlands,NLD,0,0,5,0,5
2013,Nepal,NPL,Netherlands,NLD,0,0,11,0,11
2013,Nigeria,NGA,Netherlands,NLD,0,5,12,0,17
2013,Pakistan,PAK,Netherlands,NLD,10,5,10,0,25
2013,Russian Federation,RUS,Netherlands,NLD,0,10,49,0,59
2013,Saudi Arabia,SAU,Netherlands,NLD,0,5,0,0,5
2013,Serbia and Kosovo: S/RES/1244 (1999),SRB,Netherlands,NLD,0,0,10,0,10
2013,Sierra Leone,SLE,Netherlands,NLD,0,5,5,0,10
2013,Somalia,SOM,Netherlands,NLD,0,49,92,0,141
2013,Sudan,SDN,Netherlands,NLD,0,14,10,0,24
2013,Syrian Arab Rep.,SYR,Netherlands,NLD,0,34,10,0,44
2013,Turkey,TUR,Netherlands,NLD,0,5,5,0,10
2013,Uganda,UGA,Netherlands,NLD,5,0,0,0,5
2013,Yemen,YEM,Netherlands,NLD,0,5,5,0,10
2013,Stateless,XXA,Netherlands,NLD,0,11,5,0,16
2013,Unknown ,,Netherlands,NLD,10,37,38,0,85
2014,Iran (Islamic Rep. of),IRN,Armenia,ARM,0,0,5,0,5
2014,Afghanistan,AFG,Belarus,BLR,5,0,22,0,27
2014,Egypt,EGY,Belarus,BLR,0,0,5,0,5
2014,Georgia,GEO,Belarus,BLR,0,0,5,0,5
2014,Iran (Islamic Rep. of),IRN,Belarus,BLR,0,0,5,0,5
2014,Dem. People's Rep. of Korea,PRK,Belarus,BLR,0,0,5,0,5
2014,Syrian Arab Rep.,SYR,Bosnia and Herzegovina,BIH,0,0,5,0,5
2014,Egypt,EGY,Georgia,GEO,0,0,5,0,5
2014,Bangladesh,BGD,Georgia,GEO,0,0,0,5,5
2014,Iraq,IRQ,Georgia,GEO,0,10,12,36,58
2014,Sri Lanka,LKA,Georgia,GEO,0,0,5,0,5
2014,Russian Federation,RUS,Georgia,GEO,0,0,5,0,5
2014,Syrian Arab Rep.,SYR,Georgia,GEO,0,0,0,5,5
2014,Algeria,DZA,Croatia,HRV,0,0,25,0,25
2014,Egypt,EGY,Croatia,HRV,0,0,5,0,5
2014,Bosnia and Herzegovina,BIH,Croatia,HRV,0,0,5,0,5
2014,Morocco,MAR,Croatia,HRV,0,0,13,0,13
2014,Nigeria,NGA,Croatia,HRV,0,0,5,0,5
2014,Russian Federation,RUS,Croatia,HRV,0,0,5,0,5
2014,Somalia,SOM,Croatia,HRV,0,0,5,0,5
2014,Syrian Arab Rep.,SYR,Croatia,HRV,0,0,5,0,5
2014,Tunisia,TUN,Croatia,HRV,0,0,11,0,11
2014,Unknown ,,Croatia,HRV,0,0,5,5,10
2014,Unknown ,,Japan,JPN,0,0,5,0,5
2014,Unknown ,,Rep. of Korea,KOR,0,0,182,34,216
2014,Afghanistan,AFG,Luxembourg,LUX,0,0,5,0,5
2014,Albania,ALB,Luxembourg,LUX,0,0,70,0,70
2014,Algeria,DZA,Luxembourg,LUX,0,0,5,0,5
2014,Bosnia and Herzegovina,BIH,Luxembourg,LUX,5,0,43,0,48
2014,Cote d'Ivoire,CIV,Luxembourg,LUX,0,0,5,0,5
2014,Iraq,IRQ,Luxembourg,LUX,0,0,0,5,5
2014,Kyrgyzstan,KGZ,Luxembourg,LUX,0,0,5,0,5
2014,North Macedonia,MKD,Luxembourg,LUX,0,0,14,0,14
2014,Montenegro,MNE,Luxembourg,LUX,0,0,20,0,20
2014,Nigeria,NGA,Luxembourg,LUX,0,0,10,0,10
2014,Serbia and Kosovo: S/RES/1244 (1999),SRB,Luxembourg,LUX,10,5,220,0,235
2014,Tunisia,TUN,Luxembourg,LUX,0,0,5,0,5
2014,Turkey,TUR,Luxembourg,LUX,0,0,5,0,5
2014,Afghanistan,AFG,Netherlands,NLD,33,41,63,0,137
2014,Albania,ALB,Netherlands,NLD,0,0,5,0,5
2014,Algeria,DZA,Netherlands,NLD,0,0,5,0,5
2014,Angola,AGO,Netherlands,NLD,0,0,5,0,5
2014,Egypt,EGY,Netherlands,NLD,5,0,15,0,20
2014,Armenia,ARM,Netherlands,NLD,0,10,38,0,48
2014,Azerbaijan,AZE,Netherlands,NLD,0,5,5,0,10
2014,Burundi,BDI,Netherlands,NLD,0,0,5,0,5
2014,Bangladesh,BGD,Netherlands,NLD,5,0,0,0,5
2014,Belarus,BLR,Netherlands,NLD,0,0,12,0,12
2014,Bosnia and Herzegovina,BIH,Netherlands,NLD,0,0,19,0,19
2014,China,CHN,Netherlands,NLD,5,17,11,0,33
2014,Cameroon,CMR,Netherlands,NLD,5,0,0,0,5
2014,Congo,COG,Netherlands,NLD,0,5,18,0,23
2014,Eritrea,ERI,Netherlands,NLD,0,70,19,0,89
2014,Ethiopia,ETH,Netherlands,NLD,5,5,10,0,20
2014,Gambia,GMB,Netherlands,NLD,5,5,5,0,15
2014,Georgia,GEO,Netherlands,NLD,0,0,20,0,20
2014,Guinea,GIN,Netherlands,NLD,0,5,5,0,10
2014,Cote d'Ivoire,CIV,Netherlands,NLD,0,5,5,0,10
2014,Iran (Islamic Rep. of),IRN,Netherlands,NLD,50,17,35,0,102
2014,Iraq,IRQ,Netherlands,NLD,18,46,56,0,120
2014,Jamaica,JAM,Netherlands,NLD,10,0,5,0,15
2014,Kazakhstan,KAZ,Netherlands,NLD,5,5,0,0,10
2014,Dem. People's Rep. of Korea,PRK,Netherlands,NLD,0,0,21,0,21
2014,Libya,LBY,Netherlands,NLD,0,0,19,0,19
2014,Sri Lanka,LKA,Netherlands,NLD,5,10,11,0,26
2014,North Macedonia,MKD,Netherlands,NLD,0,0,18,0,18
2014,Mongolia,MNG,Netherlands,NLD,0,5,13,0,18
2014,Morocco,MAR,Netherlands,NLD,0,0,10,0,10
2014,Nepal,NPL,Netherlands,NLD,0,5,5,0,10
2014,Nigeria,NGA,Netherlands,NLD,12,5,15,0,32
2014,Pakistan,PAK,Netherlands,NLD,5,10,10,0,25
2014,Russian Federation,RUS,Netherlands,NLD,0,18,46,0,64
2014,Serbia and Kosovo: S/RES/1244 (1999),SRB,Netherlands,NLD,0,0,34,0,34
2014,Sierra Leone,SLE,Netherlands,NLD,5,11,10,0,26
2014,Somalia,SOM,Netherlands,NLD,0,43,43,0,86
2014,Sudan,SDN,Netherlands,NLD,0,5,10,0,15
2014,Syrian Arab Rep.,SYR,Netherlands,NLD,0,43,13,0,56
2014,Togo,TGO,Netherlands,NLD,0,0,5,0,5
2014,Trinidad and Tobago,TTO,Netherlands,NLD,5,0,0,0,5
2014,Turkey,TUR,Netherlands,NLD,0,5,0,0,5
2014,Uganda,UGA,Netherlands,NLD,40,5,5,0,50
2014,Ukraine,UKR,Netherlands,NLD,0,0,10,0,10
2014,Zimbabwe,ZWE,Netherlands,NLD,5,0,0,0,5
2014,Stateless,XXA,Netherlands,NLD,12,12,16,0,40
2014,Unknown ,,Netherlands,NLD,11,17,45,0,73
2014,Afghanistan,AFG,Romania,ROU,0,10,17,0,27
2014,Algeria,DZA,Romania,ROU,0,0,5,0,5
2014,Egypt,EGY,Romania,ROU,0,0,5,0,5
2014,Bangladesh,BGD,Romania,ROU,0,0,10,0,10
2014,China,CHN,Romania,ROU,0,0,14,10,24
2014,Palestinian,PSE,Romania,ROU,0,0,5,0,5
2014,Cote d'Ivoire,CIV,Romania,ROU,0,0,5,0,5
2014,Iran (Islamic Rep. of),IRN,Romania,ROU,0,0,5,5,10
2014,Iraq,IRQ,Romania,ROU,0,0,5,5,10
2014,Kazakhstan,KAZ,Romania,ROU,0,0,0,5,5
2014,Rep. of Moldova,MDA,Romania,ROU,0,0,5,0,5
2014,Morocco,MAR,Romania,ROU,0,0,5,0,5
2014,Nepal,NPL,Romania,ROU,0,0,5,0,5
2014,Pakistan,PAK,Romania,ROU,5,0,20,0,25
2014,Philippines,PHL,Romania,ROU,0,0,5,0,5
2014,Senegal,SEN,Romania,ROU,0,0,5,0,5
2014,Somalia,SOM,Romania,ROU,0,5,5,0,10
2014,Syrian Arab Rep.,SYR,Romania,ROU,0,5,5,0,10
2014,Tunisia,TUN,Romania,ROU,0,0,5,0,5
2014,Turkey,TUR,Romania,ROU,0,0,5,5,10
2014,Stateless,XXA,Romania,ROU,0,5,0,0,5
2014,Afghanistan,AFG,Ukraine,UKR,10,0,24,14,48
2014,Azerbaijan,AZE,Ukraine,UKR,5,0,0,0,5
2014,Dem. Rep. of the Congo,COD,Ukraine,UKR,0,0,5,0,5
2014,Palestinian,PSE,Ukraine,UKR,5,0,0,5,10
2014,Iran (Islamic Rep. of),IRN,Ukraine,UKR,5,0,21,10,36
2014,Iraq,IRQ,Ukraine,UKR,0,0,5,5,10
2014,Sri Lanka,LKA,Ukraine,UKR,0,0,5,0,5
2014,Russian Federation,RUS,Ukraine,UKR,5,0,0,5,10
2014,Senegal,SEN,Ukraine,UKR,5,0,5,0,10
2014,Somalia,SOM,Ukraine,UKR,10,0,5,0,15
2014,Sudan,SDN,Ukraine,UKR,5,0,0,5,10
2014,Syrian Arab Rep.,SYR,Ukraine,UKR,34,0,21,11,66
2014,Turkmenistan,TKM,Ukraine,UKR,5,0,0,0,5
2014,Uzbekistan,UZB,Ukraine,UKR,10,0,17,10,37
2015,Iran (Islamic Rep. of),IRN,Armenia,ARM,0,0,0,5,5
2015,Afghanistan,AFG,Belarus,BLR,0,0,22,0,22
2015,Armenia,ARM,Belarus,BLR,0,0,5,0,5
2015,Bangladesh,BGD,Belarus,BLR,0,0,5,0,5
2015,Syrian Arab Rep.,SYR,Belarus,BLR,0,0,0,5,5
2015,Ukraine,UKR,Belarus,BLR,0,0,10,5,15
2015,Iraq,IRQ,Georgia,GEO,0,0,0,10,10
2015,Syrian Arab Rep.,SYR,Georgia,GEO,0,0,5,0,5
2015,Ukraine,UKR,Georgia,GEO,0,0,0,5,5
2015,Afghanistan,AFG,Germany,DEU,237,404,295,1555,2491
2015,Albania,ALB,Germany,DEU,0,38,2383,4079,6500
2015,Algeria,DZA,Germany,DEU,0,0,41,228,269
2015,Angola,AGO,Germany,DEU,5,0,5,15,25
2015,Egypt,EGY,Germany,DEU,10,0,14,152,176
2015,Armenia,ARM,Germany,DEU,15,27,145,266,453
2015,Azerbaijan,AZE,Germany,DEU,11,20,153,114,298
2015,Burundi,BDI,Germany,DEU,0,0,0,5,5
2015,Benin,BEN,Germany,DEU,0,0,10,38,48
2015,Bangladesh,BGD,Germany,DEU,5,5,187,117,314
2015,Burkina Faso,BFA,Germany,DEU,0,0,19,112,131
2015,Belarus,BLR,Germany,DEU,0,0,11,15,26
2015,Bosnia and Herzegovina,BIH,Germany,DEU,0,46,905,1591,2542
2015,Bulgaria,BGR,Germany,DEU,0,0,5,12,17
2015,Cambodia,KHM,Germany,DEU,0,0,5,5,10
2015,Central African Rep.,CAF,Germany,DEU,0,0,0,5,5
2015,Chad,TCD,Germany,DEU,0,0,5,47,52
2015,China,CHN,Germany,DEU,10,0,19,22,51
2015,Cameroon,CMR,Germany,DEU,0,5,40,241,286
2015,Congo,COG,Germany,DEU,0,0,0,10,10
2015,Dem. Rep. of the Congo,COD,Germany,DEU,5,0,21,18,44
2015,Colombia,COL,Germany,DEU,0,0,0,5,5
2015,Cuba,CUB,Germany,DEU,0,0,0,5,5
2015,Djibouti,DJI,Germany,DEU,0,0,0,5,5
2015,Eritrea,ERI,Germany,DEU,49,0,20,596,665
2015,Ethiopia,ETH,Germany,DEU,56,24,76,168,324
2015,Gabon,GAB,Germany,DEU,0,0,0,5,5
2015,Gambia,GMB,Germany,DEU,5,5,28,290,328
2015,Georgia,GEO,Germany,DEU,5,25,258,774,1062
2015,Ghana,GHA,Germany,DEU,0,5,63,253,321
2015,Guinea-Bissau,GNB,Germany,DEU,0,0,10,62,72
2015,Guatemala,GTM,Germany,DEU,0,0,0,10,10
2015,Guinea,GIN,Germany,DEU,5,0,32,223,260
2015,Honduras,HND,Germany,DEU,0,5,0,0,5
2015,Hungary,HUN,Germany,DEU,0,0,0,5,5
2015,Cote d'Ivoire,CIV,Germany,DEU,0,0,23,189,212
2015,India,IND,Germany,DEU,0,5,57,42,104
2015,Iran (Islamic Rep. of),IRN,Germany,DEU,296,12,164,726,1198
2015,Iraq,IRQ,Germany,DEU,28,15,39,798,880
2015,Jordan,JOR,Germany,DEU,0,0,5,10,15
2015,Kazakhstan,KAZ,Germany,DEU,0,0,0,39,39
2015,Kenya,KEN,Germany,DEU,0,5,21,39,65
2015,Kyrgyzstan,KGZ,Germany,DEU,5,5,5,39,54
2015,Liberia,LBR,Germany,DEU,0,0,0,32,32
2015,Libya,LBY,Germany,DEU,0,0,16,122,138
2015,Lebanon,LBN,Germany,DEU,0,5,53,174,232
2015,Sri Lanka,LKA,Germany,DEU,17,10,65,46,138
2015,Mauritania,MRT,Germany,DEU,0,0,0,42,42
2015,North Macedonia,MKD,Germany,DEU,5,46,1996,3182,5229
2015,Rep. of Moldova,MDA,Germany,DEU,0,0,0,5,5
2015,Mexico,MEX,Germany,DEU,0,0,0,5,5
2015,Mali,MLI,Germany,DEU,0,0,33,117,150
2015,Mongolia,MNG,Germany,DEU,0,0,12,40,52
2015,Morocco,MAR,Germany,DEU,0,0,34,197,231
2015,Mozambique,MOZ,Germany,DEU,0,0,0,5,5
2015,Montenegro,MNE,Germany,DEU,0,13,285,440,738
2015,Myanmar,MMR,Germany,DEU,0,0,0,5,5
2015,Nepal,NPL,Germany,DEU,0,0,0,5,5
2015,Niger,NER,Germany,DEU,0,0,5,41,46
2015,Nigeria,NGA,Germany,DEU,5,19,75,416,515
2015,Pakistan,PAK,Germany,DEU,321,24,469,593,1407
2015,Romania,ROU,Germany,DEU,0,0,0,5,5
2015,South Africa,ZAF,Germany,DEU,0,0,0,5,5
2015,Russian Federation,RUS,Germany,DEU,41,54,511,2115,2721
2015,Rwanda,RWA,Germany,DEU,10,0,0,5,15
2015,Serbia and Kosovo: S/RES/1244 (1999),SRB,Germany,DEU,0,114,9013,14789,23916
2015,Senegal,SEN,Germany,DEU,0,0,25,42,67
2015,Sierra Leone,SLE,Germany,DEU,0,5,5,19,29
2015,Somalia,SOM,Germany,DEU,49,108,109,869,1135
2015,Spain,ESP,Germany,DEU,0,0,5,0,5
2015,Viet Nam,VNM,Germany,DEU,0,0,15,34,49
2015,Sudan,SDN,Germany,DEU,10,0,51,148,209
2015,South Sudan,SSD,Germany,DEU,0,0,0,13,13
2015,Syrian Arab Rep.,SYR,Germany,DEU,227,15,50,3546,3838
2015,United Rep. of Tanzania,TZA,Germany,DEU,0,0,0,5,5
2015,Tajikistan,TJK,Germany,DEU,5,5,21,55,86
2015,Turkmenistan,TKM,Germany,DEU,0,0,0,5,5
2015,Togo,TGO,Germany,DEU,0,0,10,42,52
2015,Tunisia,TUN,Germany,DEU,5,0,80,145,230
2015,Turkey,TUR,Germany,DEU,26,10,167,237,440
2015,Uganda,UGA,Germany,DEU,5,0,0,5,10
2015,Ukraine,UKR,Germany,DEU,0,0,18,307,325
2015,Uzbekistan,UZB,Germany,DEU,0,0,0,10,10
2015,Yemen,YEM,Germany,DEU,0,5,0,5,10
2015,Zimbabwe,ZWE,Germany,DEU,5,0,0,0,5
2015,Stateless,XXA,Germany,DEU,5,5,5,147,162
2015,Unknown ,,Germany,DEU,44,10,155,627,836
2015,Algeria,DZA,Croatia,HRV,0,0,19,0,19
2015,Bangladesh,BGD,Croatia,HRV,0,0,5,0,5
2015,Bosnia and Herzegovina,BIH,Croatia,HRV,0,0,5,0,5
2015,Morocco,MAR,Croatia,HRV,0,0,5,0,5
2015,Nigeria,NGA,Croatia,HRV,0,0,10,0,10
2015,Russian Federation,RUS,Croatia,HRV,0,0,5,0,5
2015,Serbia and Kosovo: S/RES/1244 (1999),SRB,Croatia,HRV,0,0,5,0,5
2015,Ukraine,UKR,Croatia,HRV,0,0,5,0,5
2015,Unknown ,,Croatia,HRV,0,0,5,0,5
2015,Afghanistan,AFG,Luxembourg,LUX,0,0,5,0,5
2015,Albania,ALB,Luxembourg,LUX,0,10,15,0,25
2015,Azerbaijan,AZE,Luxembourg,LUX,0,0,5,0,5
2015,Benin,BEN,Luxembourg,LUX,0,0,5,0,5
2015,Bosnia and Herzegovina,BIH,Luxembourg,LUX,0,0,16,0,16
2015,Dem. Rep. of the Congo,COD,Luxembourg,LUX,0,0,5,0,5
2015,Guinea,GIN,Luxembourg,LUX,0,0,5,0,5
2015,Iran (Islamic Rep. of),IRN,Luxembourg,LUX,5,0,0,0,5
2015,North Macedonia,MKD,Luxembourg,LUX,0,0,11,0,11
2015,Montenegro,MNE,Luxembourg,LUX,0,0,10,5,15
2015,Nigeria,NGA,Luxembourg,LUX,0,0,5,0,5
2015,Serbia and Kosovo: S/RES/1244 (1999),SRB,Luxembourg,LUX,0,0,28,0,28
2015,Turkey,TUR,Luxembourg,LUX,11,0,10,0,21
2015,Kyrgyzstan,KGZ,Rep. of Moldova,MDA,0,0,5,0,5
2015,Ukraine,UKR,Rep. of Moldova,MDA,0,0,5,0,5
2015,Afghanistan,AFG,Romania,ROU,0,14,16,0,30
2015,Egypt,EGY,Romania,ROU,0,0,5,0,5
2015,Bangladesh,BGD,Romania,ROU,0,0,10,0,10
2015,China,CHN,Romania,ROU,0,0,10,0,10
2015,Cameroon,CMR,Romania,ROU,0,0,5,0,5
2015,Palestinian,PSE,Romania,ROU,0,5,0,0,5
2015,Iran (Islamic Rep. of),IRN,Romania,ROU,5,0,10,0,15
2015,Iraq,IRQ,Romania,ROU,0,5,5,0,10
2015,Jordan,JOR,Romania,ROU,5,0,0,0,5
2015,Rep. of Moldova,MDA,Romania,ROU,0,0,5,0,5
2015,Nigeria,NGA,Romania,ROU,0,0,5,0,5
2015,Pakistan,PAK,Romania,ROU,0,5,5,0,10
2015,Philippines,PHL,Romania,ROU,0,0,10,0,10
2015,Russian Federation,RUS,Romania,ROU,0,5,0,0,5
2015,Syrian Arab Rep.,SYR,Romania,ROU,0,0,5,0,5
2015,Turkey,TUR,Romania,ROU,0,0,5,0,5
2015,Stateless,XXA,Romania,ROU,0,5,0,0,5
2015,Afghanistan,AFG,Ukraine,UKR,30,0,36,14,80
2015,Armenia,ARM,Ukraine,UKR,5,0,0,0,5
2015,Azerbaijan,AZE,Ukraine,UKR,0,0,5,0,5
2015,Bangladesh,BGD,Ukraine,UKR,0,0,0,5,5
2015,Cameroon,CMR,Ukraine,UKR,0,0,5,0,5
2015,Congo,COG,Ukraine,UKR,5,0,0,0,5
2015,Dem. Rep. of the Congo,COD,Ukraine,UKR,5,0,5,5,15
2015,Eritrea,ERI,Ukraine,UKR,0,0,0,5,5
2015,Palestinian,PSE,Ukraine,UKR,12,0,5,5,22
2015,Georgia,GEO,Ukraine,UKR,0,0,5,0,5
2015,Guinea,GIN,Ukraine,UKR,0,0,5,0,5
2015,Cote d'Ivoire,CIV,Ukraine,UKR,0,0,0,5,5
2015,Iran (Islamic Rep. of),IRN,Ukraine,UKR,0,0,18,10,28
2015,Iraq,IRQ,Ukraine,UKR,5,0,24,12,41
2015,Kyrgyzstan,KGZ,Ukraine,UKR,5,0,0,5,10
2015,Lebanon,LBN,Ukraine,UKR,0,0,0,5,5
2015,Sri Lanka,LKA,Ukraine,UKR,0,0,5,10,15
2015,Pakistan,PAK,Ukraine,UKR,5,0,14,10,29
2015,Russian Federation,RUS,Ukraine,UKR,16,0,17,13,46
2015,Sierra Leone,SLE,Ukraine,UKR,0,0,5,0,5
2015,Somalia,SOM,Ukraine,UKR,5,0,24,32,61
2015,Sudan,SDN,Ukraine,UKR,5,0,12,0,17
2015,Syrian Arab Rep.,SYR,Ukraine,UKR,90,0,19,0,109
2015,Uzbekistan,UZB,Ukraine,UKR,5,0,16,12,33
2015,Stateless,XXA,Ukraine,UKR,5,0,5,0,10
2016,Iran (Islamic Rep. of),IRN,Armenia,ARM,0,0,5,5,10
2016,Iran (Islamic Rep. of),IRN,Belarus,BLR,0,0,5,0,5
2016,Iraq,IRQ,Belarus,BLR,0,0,10,0,10
2016,Pakistan,PAK,Belarus,BLR,0,0,5,0,5
2016,Ukraine,UKR,Belarus,BLR,0,0,0,5,5
2016,Afghanistan,AFG,Germany,DEU,268,594,702,2291,3855
2016,Albania,ALB,Germany,DEU,0,126,5350,7027,12503
2016,Algeria,DZA,Germany,DEU,0,5,293,321,619
2016,Angola,AGO,Germany,DEU,0,0,5,12,17
2016,Egypt,EGY,Germany,DEU,74,5,88,89,256
2016,Armenia,ARM,Germany,DEU,10,12,135,226,383
2016,Azerbaijan,AZE,Germany,DEU,12,22,135,123,292
2016,Benin,BEN,Germany,DEU,0,0,30,29,59
2016,Bangladesh,BGD,Germany,DEU,5,10,162,76,253
2016,Burkina Faso,BFA,Germany,DEU,0,0,33,51,84
2016,Belarus,BLR,Germany,DEU,0,0,5,10,15
2016,Bosnia and Herzegovina,BIH,Germany,DEU,0,20,576,987,1583
2016,Cambodia,KHM,Germany,DEU,0,0,5,0,5
2016,Chad,TCD,Germany,DEU,0,0,10,42,52
2016,China,CHN,Germany,DEU,16,5,15,27,63
2016,Cameroon,CMR,Germany,DEU,5,0,51,153,209
2016,Congo,COG,Germany,DEU,0,0,0,5,5
2016,Dem. Rep. of the Congo,COD,Germany,DEU,0,5,45,33,83
2016,Cuba,CUB,Germany,DEU,0,0,0,5,5
2016,Eritrea,ERI,Germany,DEU,73,11,72,499,655
2016,Ethiopia,ETH,Germany,DEU,31,15,122,170,338
2016,Gambia,GMB,Germany,DEU,5,5,50,259,319
2016,Georgia,GEO,Germany,DEU,5,10,395,683,1093
2016,Ghana,GHA,Germany,DEU,0,0,101,241,342
2016,Guinea-Bissau,GNB,Germany,DEU,0,0,40,75,115
2016,Greece,GRC,Germany,DEU,0,0,0,5,5
2016,Guinea,GIN,Germany,DEU,0,5,30,54,89
2016,Honduras,HND,Germany,DEU,0,0,0,5,5
2016,Cote d'Ivoire,CIV,Germany,DEU,5,0,37,218,260
2016,India,IND,Germany,DEU,0,0,104,118,222
2016,Iran (Islamic Rep. of),IRN,Germany,DEU,272,14,186,523,995
2016,Iraq,IRQ,Germany,DEU,25,24,413,1443,1905
2016,Israel,ISR,Germany,DEU,0,0,0,5,5
2016,Italy,ITA,Germany,DEU,0,0,5,0,5
2016,Jordan,JOR,Germany,DEU,0,0,5,10,15
2016,Kazakhstan,KAZ,Germany,DEU,0,5,0,14,19
2016,Kenya,KEN,Germany,DEU,0,5,54,60,119
2016,Kyrgyzstan,KGZ,Germany,DEU,0,0,11,11,22
2016,Liberia,LBR,Germany,DEU,0,0,5,31,36
2016,Libya,LBY,Germany,DEU,5,5,22,91,123
2016,Lebanon,LBN,Germany,DEU,0,12,68,130,210
2016,Sri Lanka,LKA,Germany,DEU,19,5,62,32,118
2016,Mauritania,MRT,Germany,DEU,0,0,5,23,28
2016,North Macedonia,MKD,Germany,DEU,5,41,1726,2786,4558
2016,Rep. of Moldova,MDA,Germany,DEU,0,0,0,32,32
2016,Mali,MLI,Germany,DEU,0,5,56,97,158
2016,Mongolia,MNG,Germany,DEU,0,0,12,30,42
2016,Morocco,MAR,Germany,DEU,5,5,214,274,498
2016,Montenegro,MNE,Germany,DEU,0,5,406,941,1352
2016,Myanmar,MMR,Germany,DEU,0,0,0,5,5
2016,Nepal,NPL,Germany,DEU,0,0,5,5,10
2016,Niger,NER,Germany,DEU,0,0,14,46,60
2016,Nigeria,NGA,Germany,DEU,10,16,144,347,517
2016,Pakistan,PAK,Germany,DEU,279,34,743,584,1640
2016,Philippines,PHL,Germany,DEU,0,0,5,5,10
2016,Russian Federation,RUS,Germany,DEU,46,47,592,2497,3182
2016,Rwanda,RWA,Germany,DEU,11,5,0,10,26
2016,El Salvador,SLV,Germany,DEU,0,0,0,5,5
2016,Serbia and Kosovo: S/RES/1244 (1999),SRB,Germany,DEU,5,172,7083,9254,16514
2016,Senegal,SEN,Germany,DEU,0,0,218,117,335
2016,Sierra Leone,SLE,Germany,DEU,0,0,10,18,28
2016,Somalia,SOM,Germany,DEU,71,180,122,945,1318
2016,Viet Nam,VNM,Germany,DEU,0,0,10,21,31
2016,Sudan,SDN,Germany,DEU,19,0,30,171,220
2016,South Sudan,SSD,Germany,DEU,0,0,0,10,10
2016,Slovakia,SVK,Germany,DEU,0,0,0,5,5
2016,Syrian Arab Rep.,SYR,Germany,DEU,5799,299,843,2931,9872
2016,Tajikistan,TJK,Germany,DEU,0,0,14,37,51
2016,Turkmenistan,TKM,Germany,DEU,0,5,0,11,16
2016,Togo,TGO,Germany,DEU,0,0,12,32,44
2016,Tunisia,TUN,Germany,DEU,0,0,130,193,323
2016,Turkey,TUR,Germany,DEU,21,11,88,153,273
2016,Uganda,UGA,Germany,DEU,5,0,5,5,15
2016,Ukraine,UKR,Germany,DEU,0,0,179,628,807
2016,Venezuela (Bolivarian Republic of),VEN,Germany,DEU,0,5,0,0,5
2016,Yemen,YEM,Germany,DEU,0,0,0,19,19
2016,Zimbabwe,ZWE,Germany,DEU,0,0,5,5,10
2016,Stateless,XXA,Germany,DEU,145,5,21,144,315
2016,Unknown ,,Germany,DEU,218,33,223,470,944
2016,Afghanistan,AFG,Croatia,HRV,0,0,5,0,5
2016,Algeria,DZA,Croatia,HRV,0,0,10,0,10
2016,Cameroon,CMR,Croatia,HRV,0,0,5,0,5
2016,Iraq,IRQ,Croatia,HRV,0,0,5,0,5
2016,Lebanon,LBN,Croatia,HRV,0,0,5,0,5
2016,North Macedonia,MKD,Croatia,HRV,0,0,5,0,5
2016,Morocco,MAR,Croatia,HRV,0,0,10,0,10
2016,Nigeria,NGA,Croatia,HRV,0,0,10,0,10
2016,Russian Federation,RUS,Croatia,HRV,0,0,5,0,5
2016,Serbia and Kosovo: S/RES/1244 (1999),SRB,Croatia,HRV,0,0,10,0,10
2016,Somalia,SOM,Croatia,HRV,0,0,5,0,5
2016,Syrian Arab Rep.,SYR,Croatia,HRV,0,0,5,0,5
2016,Ukraine,UKR,Croatia,HRV,0,0,10,0,10
2016,Albania,ALB,Luxembourg,LUX,0,0,12,0,12
2016,Azerbaijan,AZE,Luxembourg,LUX,0,0,15,0,15
2016,Belarus,BLR,Luxembourg,LUX,0,0,5,0,5
2016,Gambia,GMB,Luxembourg,LUX,0,0,5,0,5
2016,Georgia,GEO,Luxembourg,LUX,0,0,5,0,5
2016,Guinea,GIN,Luxembourg,LUX,0,0,5,0,5
2016,Cote d'Ivoire,CIV,Luxembourg,LUX,0,0,5,0,5
2016,Montenegro,MNE,Luxembourg,LUX,0,0,11,0,11
2016,Nigeria,NGA,Luxembourg,LUX,0,0,5,0,5
2016,Serbia and Kosovo: S/RES/1244 (1999),SRB,Luxembourg,LUX,0,0,21,0,21
2016,Somalia,SOM,Luxembourg,LUX,0,0,5,0,5
2016,Tunisia,TUN,Luxembourg,LUX,0,0,5,0,5
2016,Kyrgyzstan,KGZ,Rep. of Moldova,MDA,5,0,0,0,5
2016,Sri Lanka,LKA,Rep. of Moldova,MDA,0,0,10,0,10
2016,Turkey,TUR,Rep. of Moldova,MDA,0,0,5,0,5
2016,Ukraine,UKR,Rep. of Moldova,MDA,0,0,20,0,20
2016,Afghanistan,AFG,Romania,ROU,0,0,13,0,13
2016,Egypt,EGY,Romania,ROU,0,0,5,0,5
2016,Bangladesh,BGD,Romania,ROU,0,0,5,0,5
2016,China,CHN,Romania,ROU,0,0,15,0,15
2016,Palestinian,PSE,Romania,ROU,0,0,5,0,5
2016,India,IND,Romania,ROU,0,0,5,0,5
2016,Iraq,IRQ,Romania,ROU,0,5,12,0,17
2016,Pakistan,PAK,Romania,ROU,0,0,10,0,10
2016,Syrian Arab Rep.,SYR,Romania,ROU,0,0,5,0,5
2016,Turkey,TUR,Romania,ROU,0,0,5,0,5
2016,Ukraine,UKR,Romania,ROU,0,0,5,0,5
2016,Afghanistan,AFG,Ukraine,UKR,0,0,34,29,63
2016,Azerbaijan,AZE,Ukraine,UKR,0,0,5,5,10
2016,Belarus,BLR,Ukraine,UKR,0,0,0,5,5
2016,Dem. Rep. of the Congo,COD,Ukraine,UKR,0,0,5,5,10
2016,Eritrea,ERI,Ukraine,UKR,0,0,5,0,5
2016,Palestinian,PSE,Ukraine,UKR,0,0,10,10,20
2016,Georgia,GEO,Ukraine,UKR,0,0,0,5,5
2016,Guinea,GIN,Ukraine,UKR,0,0,5,0,5
2016,Iran (Islamic Rep. of),IRN,Ukraine,UKR,0,0,12,5,17
2016,Iraq,IRQ,Ukraine,UKR,0,0,15,11,26
2016,Kyrgyzstan,KGZ,Ukraine,UKR,0,0,10,16,26
2016,Sri Lanka,LKA,Ukraine,UKR,0,0,10,5,15
2016,Nigeria,NGA,Ukraine,UKR,0,0,5,5,10
2016,Pakistan,PAK,Ukraine,UKR,0,0,10,5,15
2016,Russian Federation,RUS,Ukraine,UKR,0,0,10,10,20
2016,Sierra Leone,SLE,Ukraine,UKR,0,0,5,5,10
2016,Somalia,SOM,Ukraine,UKR,0,0,24,26,50
2016,Syrian Arab Rep.,SYR,Ukraine,UKR,5,0,26,5,36
2016,Uzbekistan,UZB,Ukraine,UKR,0,0,10,5,15
2016,Yemen,YEM,Ukraine,UKR,0,0,5,0,5
2017,Iraq,IRQ,Armenia,ARM,0,0,0,14,14
2017,Afghanistan,AFG,Belarus,BLR,0,0,10,0,10
2017,Iran (Islamic Rep. of),IRN,Belarus,BLR,0,0,5,0,5
2017,Iraq,IRQ,Belarus,BLR,0,0,5,0,5
2017,Russian Federation,RUS,Belarus,BLR,0,0,5,5,10
2017,Tajikistan,TJK,Belarus,BLR,0,0,10,0,10
2017,Ukraine,UKR,Belarus,BLR,0,0,5,0,5
2017,Serbia and Kosovo: S/RES/1244 (1999),SRB,Bosnia and Herzegovina,BIH,0,0,5,0,5
2017,Afghanistan,AFG,Germany,DEU,1018,6220,4589,7599,19426
2017,Albania,ALB,Germany,DEU,0,109,2289,3483,5881
2017,Algeria,DZA,Germany,DEU,5,13,524,511,1053
2017,Angola,AGO,Germany,DEU,0,5,10,29,44
2017,Egypt,EGY,Germany,DEU,154,5,233,323,715
2017,Armenia,ARM,Germany,DEU,5,55,704,1237,2001
2017,Azerbaijan,AZE,Germany,DEU,27,40,620,1066,1753
2017,Burundi,BDI,Germany,DEU,0,0,5,5,10
2017,Benin,BEN,Germany,DEU,0,0,122,65,187
2017,Bangladesh,BGD,Germany,DEU,5,10,351,257,623
2017,Burkina Faso,BFA,Germany,DEU,0,0,97,72,169
2017,Belarus,BLR,Germany,DEU,0,0,28,130,158
2017,Botswana,BWA,Germany,DEU,0,0,5,0,5
2017,Brazil,BRA,Germany,DEU,0,0,0,5,5
2017,Bosnia and Herzegovina,BIH,Germany,DEU,0,17,341,724,1082
2017,Bulgaria,BGR,Germany,DEU,0,0,0,5,5
2017,Central African Rep.,CAF,Germany,DEU,0,0,0,5,5
2017,Chad,TCD,Germany,DEU,0,0,28,66,94
2017,China,CHN,Germany,DEU,13,0,72,137,222
2017,Cameroon,CMR,Germany,DEU,0,0,144,312,456
2017,Congo,COG,Germany,DEU,0,0,5,14,19
2017,Dem. Rep. of the Congo,COD,Germany,DEU,5,5,43,68,121
2017,Colombia,COL,Germany,DEU,0,5,10,5,20
2017,Cuba,CUB,Germany,DEU,0,0,26,21,47
2017,Djibouti,DJI,Germany,DEU,0,0,0,5,5
2017,Equatorial Guinea,GNQ,Germany,DEU,0,0,0,5,5
2017,Eritrea,ERI,Germany,DEU,250,44,514,2353,3161
2017,Ethiopia,ETH,Germany,DEU,176,29,224,747,1176
2017,Gabon,GAB,Germany,DEU,0,0,5,5,10
2017,Gambia,GMB,Germany,DEU,5,5,318,587,915
2017,Georgia,GEO,Germany,DEU,5,33,880,1162,2080
2017,Ghana,GHA,Germany,DEU,5,5,444,452,906
2017,Guinea-Bissau,GNB,Germany,DEU,0,0,65,79,144
2017,Guinea,GIN,Germany,DEU,0,5,275,716,996
2017,Haiti,HTI,Germany,DEU,0,0,5,0,5
2017,Honduras,HND,Germany,DEU,0,0,0,5,5
2017,Croatia,HRV,Germany,DEU,0,0,0,5,5
2017,Cote d'Ivoire,CIV,Germany,DEU,0,11,125,483,619
2017,India,IND,Germany,DEU,0,12,791,621,1424
2017,Iran (Islamic Rep. of),IRN,Germany,DEU,754,39,841,1488,3122
2017,Iraq,IRQ,Germany,DEU,499,431,4701,4422,10053
2017,Israel,ISR,Germany,DEU,0,0,0,5,5
2017,Italy,ITA,Germany,DEU,0,0,0,5,5
2017,Jamaica,JAM,Germany,DEU,5,0,15,5,25
2017,Jordan,JOR,Germany,DEU,0,0,13,30,43
2017,Kazakhstan,KAZ,Germany,DEU,0,0,36,36,72
2017,Kenya,KEN,Germany,DEU,0,0,11,53,64
2017,Kyrgyzstan,KGZ,Germany,DEU,0,0,5,19,24
2017,Liberia,LBR,Germany,DEU,0,0,10,47,57
2017,Libya,LBY,Germany,DEU,34,46,91,251,422
2017,Lebanon,LBN,Germany,DEU,0,11,734,479,1224
2017,Sri Lanka,LKA,Germany,DEU,13,5,73,70,161
2017,Madagascar,MDG,Germany,DEU,0,0,0,5,5
2017,Mauritania,MRT,Germany,DEU,0,0,28,31,59
2017,North Macedonia,MKD,Germany,DEU,5,35,1348,2220,3608
2017,Rep. of Moldova,MDA,Germany,DEU,0,0,357,1447,1804
2017,Mali,MLI,Germany,DEU,0,10,188,219,417
2017,Mongolia,MNG,Germany,DEU,0,0,28,75,103
2017,Morocco,MAR,Germany,DEU,5,5,366,576,952
2017,Mozambique,MOZ,Germany,DEU,0,0,0,5,5
2017,Montenegro,MNE,Germany,DEU,0,12,165,358,535
2017,Myanmar,MMR,Germany,DEU,11,0,5,13,29
2017,Nepal,NPL,Germany,DEU,0,0,5,17,22
2017,Niger,NER,Germany,DEU,0,0,28,47,75
2017,Nigeria,NGA,Germany,DEU,27,77,1152,1625,2881
2017,Pakistan,PAK,Germany,DEU,589,63,2828,2906,6386
2017,Peru,PER,Germany,DEU,0,0,0,5,5
2017,Philippines,PHL,Germany,DEU,0,0,5,5,10
2017,Romania,ROU,Germany,DEU,0,0,0,5,5
2017,Russian Federation,RUS,Germany,DEU,70,132,1457,5403,7062
2017,Rwanda,RWA,Germany,DEU,0,0,0,5,5
2017,Saudi Arabia,SAU,Germany,DEU,0,0,0,5,5
2017,Serbia and Kosovo: S/RES/1244 (1999),SRB,Germany,DEU,10,167,3556,5143,8876
2017,Senegal,SEN,Germany,DEU,5,14,302,288,609
2017,Sierra Leone,SLE,Germany,DEU,0,5,64,217,286
2017,Somalia,SOM,Germany,DEU,73,392,282,1444,2191
2017,Viet Nam,VNM,Germany,DEU,0,0,57,70,127
2017,Sudan,SDN,Germany,DEU,55,13,55,340,463
2017,South Sudan,SSD,Germany,DEU,0,5,0,16,21
2017,Syrian Arab Rep.,SYR,Germany,DEU,18594,476,11688,9414,40172
2017,United Rep. of Tanzania,TZA,Germany,DEU,0,0,0,26,26
2017,Thailand,THA,Germany,DEU,0,0,0,5,5
2017,Tajikistan,TJK,Germany,DEU,0,5,27,298,330
2017,Turkmenistan,TKM,Germany,DEU,0,10,10,10,30
2017,Togo,TGO,Germany,DEU,0,0,18,32,50
2017,Tunisia,TUN,Germany,DEU,10,10,143,243,406
2017,Turkey,TUR,Germany,DEU,47,23,180,698,948
2017,Uganda,UGA,Germany,DEU,0,0,10,16,26
2017,Ukraine,UKR,Germany,DEU,5,15,1192,996,2208
2017,United States of America,USA,Germany,DEU,0,0,0,5,5
2017,Uzbekistan,UZB,Germany,DEU,0,0,0,12,12
2017,Venezuela (Bolivarian Republic of),VEN,Germany,DEU,0,0,5,14,19
2017,Yemen,YEM,Germany,DEU,0,0,5,80,85
2017,Zimbabwe,ZWE,Germany,DEU,11,0,12,30,53
2017,Stateless,XXA,Germany,DEU,503,12,230,332,1077
2017,Unknown ,,Germany,DEU,743,76,917,1573,3309
2017,Afghanistan,AFG,Croatia,HRV,0,0,19,12,31
2017,Algeria,DZA,Croatia,HRV,0,0,0,5,5
2017,Bosnia and Herzegovina,BIH,Croatia,HRV,0,0,0,5,5
2017,Iran (Islamic Rep. of),IRN,Croatia,HRV,5,0,5,10,20
2017,Iraq,IRQ,Croatia,HRV,10,0,10,25,45
2017,Morocco,MAR,Croatia,HRV,0,0,5,5,10
2017,Pakistan,PAK,Croatia,HRV,0,0,0,5,5
2017,Serbia and Kosovo: S/RES/1244 (1999),SRB,Croatia,HRV,0,0,5,0,5
2017,Syrian Arab Rep.,SYR,Croatia,HRV,5,0,10,11,26
2017,Lebanon,LBN,Rep. of Moldova,MDA,0,0,5,0,5
2017,Sri Lanka,LKA,Rep. of Moldova,MDA,0,0,5,0,5
2017,Ukraine,UKR,Rep. of Moldova,MDA,0,0,10,0,10
2017,Afghanistan,AFG,Romania,ROU,0,10,5,0,15
2017,Bangladesh,BGD,Romania,ROU,0,0,5,0,5
2017,Cameroon,CMR,Romania,ROU,0,0,5,0,5
2017,Dem. Rep. of the Congo,COD,Romania,ROU,0,5,0,0,5
2017,Iraq,IRQ,Romania,ROU,0,27,38,0,65
2017,Nigeria,NGA,Romania,ROU,0,0,5,0,5
2017,Pakistan,PAK,Romania,ROU,0,0,10,0,10
2017,Sudan,SDN,Romania,ROU,0,0,5,0,5
2017,Syrian Arab Rep.,SYR,Romania,ROU,0,21,0,0,21
2017,Turkey,TUR,Romania,ROU,5,0,5,0,10
2017,Stateless,XXA,Romania,ROU,0,10,0,0,10
2017,Afghanistan,AFG,Ukraine,UKR,0,0,97,20,117
2017,Bangladesh,BGD,Ukraine,UKR,0,0,5,0,5
2017,Cameroon,CMR,Ukraine,UKR,0,0,5,22,27
2017,Dem. Rep. of the Congo,COD,Ukraine,UKR,0,0,5,36,41
2017,Georgia,GEO,Ukraine,UKR,0,0,0,25,25
2017,Guinea,GIN,Ukraine,UKR,0,0,5,0,5
2017,India,IND,Ukraine,UKR,0,0,0,16,16
2017,Iran (Islamic Rep. of),IRN,Ukraine,UKR,0,0,5,0,5
2017,Iraq,IRQ,Ukraine,UKR,0,0,5,0,5
2017,Kyrgyzstan,KGZ,Ukraine,UKR,0,0,5,0,5
2017,Liberia,LBR,Ukraine,UKR,0,0,5,0,5
2017,Lebanon,LBN,Ukraine,UKR,0,0,5,0,5
2017,Nigeria,NGA,Ukraine,UKR,0,0,0,16,16
2017,Pakistan,PAK,Ukraine,UKR,0,0,5,0,5
2017,Russian Federation,RUS,Ukraine,UKR,5,0,5,0,10
2017,Somalia,SOM,Ukraine,UKR,0,0,26,31,57
2017,Sudan,SDN,Ukraine,UKR,0,0,5,5,10
2017,Syrian Arab Rep.,SYR,Ukraine,UKR,20,0,18,0,38
2017,Togo,TGO,Ukraine,UKR,0,0,0,18,18
2017,Uganda,UGA,Ukraine,UKR,0,0,0,5,5
2017,Uzbekistan,UZB,Ukraine,UKR,0,0,17,0,17
2017,Zimbabwe,ZWE,Ukraine,UKR,0,0,0,5,5
2017,Stateless,XXA,Ukraine,UKR,0,0,5,22,27
2018,Iran (Islamic Rep. of),IRN,Armenia,ARM,0,0,5,0,5
2018,Bangladesh,BGD,Belarus,BLR,0,0,5,0,5
2018,India,IND,Belarus,BLR,0,0,5,0,5
2018,Russian Federation,RUS,Belarus,BLR,0,0,5,0,5
2018,Algeria,DZA,Bosnia and Herzegovina,BIH,0,0,5,0,5
2018,Pakistan,PAK,Bosnia and Herzegovina,BIH,0,0,5,0,5
2018,Russian Federation,RUS,Bosnia and Herzegovina,BIH,0,0,10,0,10
2018,Turkey,TUR,Bosnia and Herzegovina,BIH,0,5,0,0,5
2018,Unknown ,,Czechia,CZE,0,0,820,111,931
2018,Afghanistan,AFG,Germany,DEU,1663,9598,8274,8715,28250
2018,Albania,ALB,Germany,DEU,5,90,699,1662,2456
2018,Algeria,DZA,Germany,DEU,5,11,334,658,1008
2018,Angola,AGO,Germany,DEU,5,5,26,127,163
2018,Egypt,EGY,Germany,DEU,134,21,397,519,1071
2018,Armenia,ARM,Germany,DEU,5,153,1563,2005,3726
2018,Azerbaijan,AZE,Germany,DEU,24,48,948,1736,2756
2018,Bahrain,BHR,Germany,DEU,0,0,5,5,10
2018,Burundi,BDI,Germany,DEU,0,0,5,0,5
2018,Benin,BEN,Germany,DEU,0,0,79,49,128
2018,Bangladesh,BGD,Germany,DEU,15,31,858,405,1309
2018,Burkina Faso,BFA,Germany,DEU,0,5,56,74,135
2018,Belarus,BLR,Germany,DEU,5,0,42,185,232
2018,Brazil,BRA,Germany,DEU,0,0,0,5,5
2018,Bosnia and Herzegovina,BIH,Germany,DEU,0,27,178,340,545
2018,Central African Rep.,CAF,Germany,DEU,0,0,18,14,32
2018,Chad,TCD,Germany,DEU,0,0,5,78,83
2018,China,CHN,Germany,DEU,42,5,182,261,490
2018,Chile,CHL,Germany,DEU,0,0,0,5,5
2018,Cameroon,CMR,Germany,DEU,0,11,117,619,747
2018,Congo,COG,Germany,DEU,0,5,10,17,32
2018,Dem. Rep. of the Congo,COD,Germany,DEU,0,22,100,156,278
2018,Colombia,COL,Germany,DEU,0,0,15,14,29
2018,Cuba,CUB,Germany,DEU,0,0,72,36,108
2018,Djibouti,DJI,Germany,DEU,0,0,0,10,10
2018,Equatorial Guinea,GNQ,Germany,DEU,0,0,5,5,10
2018,Eritrea,ERI,Germany,DEU,207,132,673,1954,2966
2018,Ethiopia,ETH,Germany,DEU,151,56,731,921,1859
2018,Gabon,GAB,Germany,DEU,0,0,5,10,15
2018,Gambia,GMB,Germany,DEU,10,14,1058,1900,2982
2018,United Kingdom of Great Britain and Northern Ireland,GBR,Germany,DEU,0,5,0,5,10
2018,Georgia,GEO,Germany,DEU,5,24,1249,1788,3066
2018,Ghana,GHA,Germany,DEU,5,13,467,644,1129
2018,Guinea-Bissau,GNB,Germany,DEU,5,0,43,65,113
2018,Greece,GRC,Germany,DEU,0,0,5,0,5
2018,Guinea,GIN,Germany,DEU,25,18,601,1642,2286
2018,Honduras,HND,Germany,DEU,0,10,0,0,10
2018,Cote d'Ivoire,CIV,Germany,DEU,0,14,271,825,1110
2018,India,IND,Germany,DEU,0,14,596,412,1022
2018,Indonesia,IDN,Germany,DEU,0,0,0,5,5
2018,Iran (Islamic Rep. of),IRN,Germany,DEU,1261,94,1651,2873,5879
2018,Iraq,IRQ,Germany,DEU,644,1078,7587,6865,16174
2018,Israel,ISR,Germany,DEU,0,0,5,5,10
2018,Italy,ITA,Germany,DEU,0,0,0,5,5
2018,Jamaica,JAM,Germany,DEU,5,0,25,12,42
2018,Jordan,JOR,Germany,DEU,5,10,61,87,163
2018,Kazakhstan,KAZ,Germany,DEU,5,0,24,59,88
2018,Kenya,KEN,Germany,DEU,0,0,28,110,138
2018,Kyrgyzstan,KGZ,Germany,DEU,0,0,14,44,58
2018,Rep. of Korea,KOR,Germany,DEU,0,0,5,0,5
2018,Dem. People's Rep. of Korea,PRK,Germany,DEU,0,0,0,5,5
2018,Kuwait,KWT,Germany,DEU,0,0,5,16,21
2018,Liberia,LBR,Germany,DEU,0,5,27,128,160
2018,Libya,LBY,Germany,DEU,23,129,243,551,946
2018,Lebanon,LBN,Germany,DEU,14,49,1332,651,2046
2018,Sri Lanka,LKA,Germany,DEU,20,13,181,224,438
2018,Latvia,LVA,Germany,DEU,0,0,0,5,5
2018,Mauritania,MRT,Germany,DEU,0,0,22,17,39
2018,North Macedonia,MKD,Germany,DEU,0,37,529,1187,1753
2018,Rep. of Moldova,MDA,Germany,DEU,0,0,421,552,973
2018,Mexico,MEX,Germany,DEU,0,5,0,0,5
2018,Mali,MLI,Germany,DEU,0,10,309,359,678
2018,Malaysia,MYS,Germany,DEU,0,0,5,5,10
2018,Mongolia,MNG,Germany,DEU,0,0,246,220,466
2018,Morocco,MAR,Germany,DEU,16,18,373,590,997
2018,Mozambique,MOZ,Germany,DEU,0,0,0,5,5
2018,Montenegro,MNE,Germany,DEU,0,5,86,190,281
2018,Myanmar,MMR,Germany,DEU,5,0,0,10,15
2018,Nepal,NPL,Germany,DEU,0,0,5,28,33
2018,Niger,NER,Germany,DEU,0,0,33,58,91
2018,Nigeria,NGA,Germany,DEU,62,248,2935,4777,8022
2018,Pakistan,PAK,Germany,DEU,561,109,4157,3080,7907
2018,Philippines,PHL,Germany,DEU,0,0,5,5,10
2018,Poland,POL,Germany,DEU,0,0,0,5,5
2018,South Africa,ZAF,Germany,DEU,0,0,0,10,10
2018,Russian Federation,RUS,Germany,DEU,145,191,2113,4688,7137
2018,Rwanda,RWA,Germany,DEU,19,0,0,10,29
2018,El Salvador,SLV,Germany,DEU,0,0,0,37,37
2018,Saudi Arabia,SAU,Germany,DEU,5,0,12,5,22
2018,Serbia and Kosovo: S/RES/1244 (1999),SRB,Germany,DEU,0,115,1033,2534,3682
2018,Senegal,SEN,Germany,DEU,0,15,165,207,387
2018,Sierra Leone,SLE,Germany,DEU,0,5,142,510,657
2018,Somalia,SOM,Germany,DEU,120,416,543,2664,3743
2018,Spain,ESP,Germany,DEU,0,0,0,21,21
2018,Viet Nam,VNM,Germany,DEU,0,0,43,89,132
2018,Sudan,SDN,Germany,DEU,106,16,149,745,1016
2018,South Sudan,SSD,Germany,DEU,0,0,12,26,38
2018,Syrian Arab Rep.,SYR,Germany,DEU,8877,1087,16075,8815,34854
2018,United Rep. of Tanzania,TZA,Germany,DEU,0,0,5,30,35
2018,Thailand,THA,Germany,DEU,0,0,0,5,5
2018,Tajikistan,TJK,Germany,DEU,5,15,439,694,1153
2018,Turkmenistan,TKM,Germany,DEU,0,0,5,38,43
2018,Togo,TGO,Germany,DEU,0,0,14,149,163
2018,Tunisia,TUN,Germany,DEU,11,0,112,260,383
2018,Turkey,TUR,Germany,DEU,120,35,859,1808,2822
2018,Uganda,UGA,Germany,DEU,0,0,19,46,65
2018,Ukraine,UKR,Germany,DEU,5,10,1142,827,1984
2018,United States of America,USA,Germany,DEU,0,0,0,5,5
2018,Uzbekistan,UZB,Germany,DEU,0,0,5,12,17
2018,Venezuela (Bolivarian Republic of),VEN,Germany,DEU,0,5,19,24,48
2018,Yemen,YEM,Germany,DEU,18,0,124,202,344
2018,Zimbabwe,ZWE,Germany,DEU,18,0,26,34,78
2018,Stateless,XXA,Germany,DEU,342,29,289,419,1079
2018,Unknown ,,Germany,DEU,494,267,1378,2060,4199
2018,Afghanistan,AFG,Croatia,HRV,0,0,49,0,49
2018,Algeria,DZA,Croatia,HRV,0,0,10,0,10
2018,Egypt,EGY,Croatia,HRV,0,0,5,0,5
2018,Bangladesh,BGD,Croatia,HRV,5,0,5,0,10
2018,Iran (Islamic Rep. of),IRN,Croatia,HRV,5,0,13,0,18
2018,Iraq,IRQ,Croatia,HRV,5,0,10,0,15
2018,Morocco,MAR,Croatia,HRV,0,0,5,0,5
2018,Pakistan,PAK,Croatia,HRV,0,0,5,0,5
2018,Syrian Arab Rep.,SYR,Croatia,HRV,5,5,12,0,22
2018,Tunisia,TUN,Croatia,HRV,0,0,12,0,12
2018,Georgia,GEO,Rep. of Moldova,MDA,0,0,0,5,5
2018,Syrian Arab Rep.,SYR,Rep. of Moldova,MDA,0,0,0,5,5
2018,Turkey,TUR,Rep. of Moldova,MDA,0,0,0,5,5
2018,Ukraine,UKR,Rep. of Moldova,MDA,0,0,0,10,10
2018,Afghanistan,AFG,Romania,ROU,0,5,18,0,23
2018,Bangladesh,BGD,Romania,ROU,0,0,5,0,5
2018,Cuba,CUB,Romania,ROU,0,0,5,0,5
2018,Palestinian,PSE,Romania,ROU,0,0,5,0,5
2018,India,IND,Romania,ROU,0,0,5,0,5
2018,Iran (Islamic Rep. of),IRN,Romania,ROU,5,13,11,0,29
2018,Iraq,IRQ,Romania,ROU,0,24,73,0,97
2018,Pakistan,PAK,Romania,ROU,0,0,10,0,10
2018,Somalia,SOM,Romania,ROU,0,0,5,0,5
2018,Syrian Arab Rep.,SYR,Romania,ROU,0,10,0,0,10
2018,Turkey,TUR,Romania,ROU,5,0,5,0,10
2018,Afghanistan,AFG,Sweden,SWE,367,280,8909,1154,10710
2018,Albania,ALB,Sweden,SWE,0,0,350,24,374
2018,Algeria,DZA,Sweden,SWE,0,0,55,10,65
2018,Angola,AGO,Sweden,SWE,0,0,19,0,19
2018,Egypt,EGY,Sweden,SWE,0,0,86,34,120
2018,Armenia,ARM,Sweden,SWE,5,0,150,12,167
2018,Azerbaijan,AZE,Sweden,SWE,0,0,141,20,161
2018,Burundi,BDI,Sweden,SWE,0,0,21,0,21
2018,Bangladesh,BGD,Sweden,SWE,5,0,78,22,105
2018,Burkina Faso,BFA,Sweden,SWE,0,0,5,0,5
2018,Belarus,BLR,Sweden,SWE,0,0,50,12,62
2018,Bolivia (Plurinational State of),BOL,Sweden,SWE,0,0,16,5,21
2018,Brazil,BRA,Sweden,SWE,0,0,10,0,10
2018,Bosnia and Herzegovina,BIH,Sweden,SWE,0,0,58,12,70
2018,Canada,CAN,Sweden,SWE,0,0,0,5,5
2018,Central African Rep.,CAF,Sweden,SWE,0,0,5,0,5
2018,Chad,TCD,Sweden,SWE,0,0,5,0,5
2018,China,CHN,Sweden,SWE,0,0,12,5,17
2018,Chile,CHL,Sweden,SWE,0,0,22,5,27
2018,Cameroon,CMR,Sweden,SWE,0,0,18,0,18
2018,Congo,COG,Sweden,SWE,0,0,12,0,12
2018,Dem. Rep. of the Congo,COD,Sweden,SWE,0,0,20,5,25
2018,Colombia,COL,Sweden,SWE,0,0,124,14,138
2018,Cuba,CUB,Sweden,SWE,0,0,19,0,19
2018,Djibouti,DJI,Sweden,SWE,0,0,5,0,5
2018,Ecuador,ECU,Sweden,SWE,0,0,10,5,15
2018,Eritrea,ERI,Sweden,SWE,13,5,66,24,108
2018,Ethiopia,ETH,Sweden,SWE,21,0,297,74,392
2018,Gambia,GMB,Sweden,SWE,0,0,59,5,64
2018,Palestinian,PSE,Sweden,SWE,5,0,80,30,115
2018,Georgia,GEO,Sweden,SWE,0,0,533,54,587
2018,Ghana,GHA,Sweden,SWE,0,0,22,0,22
2018,Guinea,GIN,Sweden,SWE,0,0,16,0,16
2018,Honduras,HND,Sweden,SWE,0,0,10,0,10
2018,Hungary,HUN,Sweden,SWE,0,0,5,0,5
2018,Cote d'Ivoire,CIV,Sweden,SWE,0,0,10,5,15
2018,India,IND,Sweden,SWE,0,0,39,5,44
2018,Iran (Islamic Rep. of),IRN,Sweden,SWE,87,0,454,86,627
2018,Iraq,IRQ,Sweden,SWE,170,97,2545,667,3479
2018,Italy,ITA,Sweden,SWE,0,0,5,0,5
2018,Jordan,JOR,Sweden,SWE,5,0,90,12,107
2018,Kazakhstan,KAZ,Sweden,SWE,0,0,107,11,118
2018,Kenya,KEN,Sweden,SWE,0,0,19,0,19
2018,Kyrgyzstan,KGZ,Sweden,SWE,0,5,90,14,109
2018,Rep. of Korea,KOR,Sweden,SWE,0,0,5,0,5
2018,Dem. People's Rep. of Korea,PRK,Sweden,SWE,0,0,5,0,5
2018,Kuwait,KWT,Sweden,SWE,5,0,19,5,29
2018,Liberia,LBR,Sweden,SWE,0,0,5,0,5
2018,Libya,LBY,Sweden,SWE,0,0,52,10,62
2018,Lebanon,LBN,Sweden,SWE,5,0,196,24,225
2018,Sri Lanka,LKA,Sweden,SWE,0,0,18,0,18
2018,North Macedonia,MKD,Sweden,SWE,0,0,62,11,73
2018,Rep. of Moldova,MDA,Sweden,SWE,0,0,10,0,10
2018,Mexico,MEX,Sweden,SWE,0,0,0,5,5
2018,Mali,MLI,Sweden,SWE,0,0,5,0,5
2018,Mongolia,MNG,Sweden,SWE,0,0,316,47,363
2018,Morocco,MAR,Sweden,SWE,0,0,180,25,205
2018,Montenegro,MNE,Sweden,SWE,0,0,12,0,12
2018,Nepal,NPL,Sweden,SWE,0,0,5,5,10
2018,Niger,NER,Sweden,SWE,0,0,5,0,5
2018,Nicaragua,NIC,Sweden,SWE,0,0,50,5,55
2018,Nigeria,NGA,Sweden,SWE,10,0,141,24,175
2018,Pakistan,PAK,Sweden,SWE,5,0,124,31,160
2018,Peru,PER,Sweden,SWE,0,0,36,10,46
2018,Philippines,PHL,Sweden,SWE,0,0,12,0,12
2018,South Africa,ZAF,Sweden,SWE,0,0,10,0,10
2018,Russian Federation,RUS,Sweden,SWE,5,0,131,44,180
2018,Rwanda,RWA,Sweden,SWE,0,0,10,0,10
2018,El Salvador,SLV,Sweden,SWE,5,0,110,10,125
2018,Saudi Arabia,SAU,Sweden,SWE,0,0,5,5,10
2018,Serbia and Kosovo: S/RES/1244 (1999),SRB,Sweden,SWE,0,0,219,41,260
2018,Senegal,SEN,Sweden,SWE,0,0,12,5,17
2018,Sierra Leone,SLE,Sweden,SWE,0,0,11,0,11
2018,Somalia,SOM,Sweden,SWE,43,15,600,106,764
2018,Viet Nam,VNM,Sweden,SWE,0,0,23,0,23
2018,Sudan,SDN,Sweden,SWE,10,0,60,19,89
2018,Syrian Arab Rep.,SYR,Sweden,SWE,5,11,246,341,603
2018,United Rep. of Tanzania,TZA,Sweden,SWE,0,0,5,0,5
2018,Thailand,THA,Sweden,SWE,0,0,10,0,10
2018,Tajikistan,TJK,Sweden,SWE,0,0,19,10,29
2018,Togo,TGO,Sweden,SWE,0,0,5,0,5
2018,Tunisia,TUN,Sweden,SWE,0,0,51,10,61
2018,Turkey,TUR,Sweden,SWE,10,5,91,67,173
2018,Uganda,UGA,Sweden,SWE,0,0,16,0,16
2018,Ukraine,UKR,Sweden,SWE,5,0,288,63,356
2018,United States of America,USA,Sweden,SWE,0,0,5,0,5
2018,Uzbekistan,UZB,Sweden,SWE,0,0,133,33,166
2018,Venezuela (Bolivarian Republic of),VEN,Sweden,SWE,0,0,35,5,40
2018,Yemen,YEM,Sweden,SWE,0,0,16,15,31
2018,Stateless,XXA,Sweden,SWE,50,5,409,78,542
2018,Unknown ,,Sweden,SWE,5,5,205,33,248
2018,Afghanistan,AFG,Ukraine,UKR,0,0,51,0,51
2018,Azerbaijan,AZE,Ukraine,UKR,0,0,5,0,5
2018,Bangladesh,BGD,Ukraine,UKR,0,0,13,0,13
2018,Cameroon,CMR,Ukraine,UKR,0,0,5,0,5
2018,Dem. Rep. of the Congo,COD,Ukraine,UKR,0,0,10,0,10
2018,Eritrea,ERI,Ukraine,UKR,0,0,5,0,5
2018,Palestinian,PSE,Ukraine,UKR,0,0,11,0,11
2018,Iran (Islamic Rep. of),IRN,Ukraine,UKR,0,0,5,0,5
2018,Iraq,IRQ,Ukraine,UKR,0,0,13,0,13
2018,Russian Federation,RUS,Ukraine,UKR,5,0,29,5,39
2018,Somalia,SOM,Ukraine,UKR,0,0,37,0,37
2018,Sudan,SDN,Ukraine,UKR,0,0,5,0,5
2018,Syrian Arab Rep.,SYR,Ukraine,UKR,5,0,21,0,26
2018,Tajikistan,TJK,Ukraine,UKR,0,0,5,0,5
2018,Uzbekistan,UZB,Ukraine,UKR,0,0,5,5,10
2018,Yemen,YEM,Ukraine,UKR,0,0,0,5,5
2019,Afghanistan,AFG,Belarus,BLR,0,0,19,0,19
2019,Armenia,ARM,Belarus,BLR,0,0,5,0,5
2019,Cuba,CUB,Belarus,BLR,0,0,5,0,5
2019,Russian Federation,RUS,Belarus,BLR,0,0,5,0,5
2019,Afghanistan,AFG,Bosnia and Herzegovina,BIH,0,0,10,0,10
2019,Pakistan,PAK,Bosnia and Herzegovina,BIH,0,0,5,0,5
2019,Russian Federation,RUS,Bosnia and Herzegovina,BIH,0,0,5,0,5
2019,Afghanistan,AFG,Germany,DEU,1606,7043,9103,7627,25379
2019,Albania,ALB,Germany,DEU,0,46,415,1211,1672
2019,Algeria,DZA,Germany,DEU,5,13,253,560,831
2019,Angola,AGO,Germany,DEU,0,26,38,157,221
2019,Egypt,EGY,Germany,DEU,62,42,470,428,1002
2019,Argentina,ARG,Germany,DEU,0,0,0,5,5
2019,Armenia,ARM,Germany,DEU,11,149,1721,1654,3535
2019,Azerbaijan,AZE,Germany,DEU,39,81,1480,1289,2889
2019,Bahrain,BHR,Germany,DEU,0,0,10,0,10
2019,Burundi,BDI,Germany,DEU,5,0,0,10,15
2019,Benin,BEN,Germany,DEU,0,0,55,67,122
2019,Bangladesh,BGD,Germany,DEU,17,20,422,244,703
2019,Burkina Faso,BFA,Germany,DEU,0,5,37,53,95
2019,Belarus,BLR,Germany,DEU,5,5,16,169,195
2019,Brazil,BRA,Germany,DEU,0,0,0,5,5
2019,Bosnia and Herzegovina,BIH,Germany,DEU,0,12,52,224,288
2019,Bulgaria,BGR,Germany,DEU,0,0,0,10,10
2019,Central African Rep.,CAF,Germany,DEU,0,5,26,12,43
2019,Chad,TCD,Germany,DEU,0,5,16,54,75
2019,China,CHN,Germany,DEU,84,15,178,308,585
2019,Cameroon,CMR,Germany,DEU,16,30,475,570,1091
2019,Congo,COG,Germany,DEU,0,5,19,35,59
2019,Dem. Rep. of the Congo,COD,Germany,DEU,0,17,85,109,211
2019,Colombia,COL,Germany,DEU,0,0,18,25,43
2019,Cuba,CUB,Germany,DEU,0,0,21,23,44
2019,Cabo Verde,CPV,Germany,DEU,0,0,0,5,5
2019,Djibouti,DJI,Germany,DEU,0,0,0,17,17
2019,Dominican Rep.,DOM,Germany,DEU,0,0,5,5,10
2019,Eritrea,ERI,Germany,DEU,158,165,478,1514,2315
2019,Ethiopia,ETH,Germany,DEU,33,129,1370,753,2285
2019,Gabon,GAB,Germany,DEU,0,0,5,11,16
2019,Gambia,GMB,Germany,DEU,5,61,1927,1640,3633
2019,Georgia,GEO,Germany,DEU,5,24,1512,1604,3145
2019,Ghana,GHA,Germany,DEU,0,26,329,692,1047
2019,Guinea-Bissau,GNB,Germany,DEU,0,5,64,106,175
2019,Guinea,GIN,Germany,DEU,20,54,1250,1603,2927
2019,Haiti,HTI,Germany,DEU,0,0,0,5,5
2019,Croatia,HRV,Germany,DEU,0,0,0,5,5
2019,Cote d'Ivoire,CIV,Germany,DEU,10,34,615,481,1140
2019,India,IND,Germany,DEU,0,22,315,442,779
2019,Indonesia,IDN,Germany,DEU,0,0,5,5,10
2019,Iran (Islamic Rep. of),IRN,Germany,DEU,1413,132,2522,3223,7290
2019,Iraq,IRQ,Germany,DEU,653,1742,8182,6212,16789
2019,Israel,ISR,Germany,DEU,0,0,5,0,5
2019,Italy,ITA,Germany,DEU,0,0,0,5,5
2019,Jamaica,JAM,Germany,DEU,0,0,5,13,18
2019,Jordan,JOR,Germany,DEU,10,0,66,100,176
2019,Kazakhstan,KAZ,Germany,DEU,0,5,63,71,139
2019,Kenya,KEN,Germany,DEU,0,0,56,136,192
2019,Kyrgyzstan,KGZ,Germany,DEU,5,10,38,64,117
2019,Dem. People's Rep. of Korea,PRK,Germany,DEU,0,0,0,5,5
2019,Kuwait,KWT,Germany,DEU,0,0,0,27,27
2019,Liberia,LBR,Germany,DEU,0,0,46,99,145
2019,Libya,LBY,Germany,DEU,19,79,213,334,645
2019,Lebanon,LBN,Germany,DEU,5,39,660,525,1229
2019,Sri Lanka,LKA,Germany,DEU,28,26,194,216,464
2019,Madagascar,MDG,Germany,DEU,0,0,5,0,5
2019,Mauritania,MRT,Germany,DEU,0,0,18,14,32
2019,North Macedonia,MKD,Germany,DEU,0,23,260,1012,1295
2019,Rep. of Moldova,MDA,Germany,DEU,0,5,407,924,1336
2019,Mali,MLI,Germany,DEU,5,12,197,234,448
2019,Malaysia,MYS,Germany,DEU,0,0,0,5,5
2019,Malawi,MWI,Germany,DEU,0,0,0,5,5
2019,Mongolia,MNG,Germany,DEU,0,36,235,178,449
2019,Morocco,MAR,Germany,DEU,14,14,245,490,763
2019,Mozambique,MOZ,Germany,DEU,0,0,0,5,5
2019,Montenegro,MNE,Germany,DEU,0,0,24,156,180
2019,Mauritius,MUS,Germany,DEU,0,0,0,5,5
2019,Myanmar,MMR,Germany,DEU,0,0,5,27,32
2019,Nepal,NPL,Germany,DEU,0,5,19,30,54
2019,Netherlands,NLD,Germany,DEU,0,0,0,5,5
2019,Niger,NER,Germany,DEU,0,5,32,57,94
2019,Nigeria,NGA,Germany,DEU,78,459,3532,6636,10705
2019,Pakistan,PAK,Germany,DEU,698,98,3350,2263,6409
2019,Peru,PER,Germany,DEU,0,0,0,5,5
2019,Philippines,PHL,Germany,DEU,0,0,5,10,15
2019,South Africa,ZAF,Germany,DEU,0,0,0,5,5
2019,Russian Federation,RUS,Germany,DEU,221,223,2915,3568,6927
2019,Rwanda,RWA,Germany,DEU,20,0,0,17,37
2019,Saudi Arabia,SAU,Germany,DEU,0,0,0,10,10
2019,Serbia and Kosovo: S/RES/1244 (1999),SRB,Germany,DEU,5,65,579,1690,2339
2019,Senegal,SEN,Germany,DEU,0,5,111,238,354
2019,Sierra Leone,SLE,Germany,DEU,0,17,373,260,650
2019,Somalia,SOM,Germany,DEU,144,492,795,2455,3886
2019,Spain,ESP,Germany,DEU,0,0,5,5,10
2019,Viet Nam,VNM,Germany,DEU,0,0,47,74,121
2019,Sudan,SDN,Germany,DEU,38,15,142,397,592
2019,South Sudan,SSD,Germany,DEU,0,10,0,15,25
2019,Syrian Arab Rep.,SYR,Germany,DEU,2651,1282,8345,7054,19332
2019,United Rep. of Tanzania,TZA,Germany,DEU,0,0,23,40,63
2019,Thailand,THA,Germany,DEU,0,0,0,5,5
2019,Tajikistan,TJK,Germany,DEU,74,41,597,378,1090
2019,Turkmenistan,TKM,Germany,DEU,0,0,5,15,20
2019,Togo,TGO,Germany,DEU,10,0,199,148,357
2019,Tunisia,TUN,Germany,DEU,10,5,84,248,347
2019,Turkey,TUR,Germany,DEU,361,45,1783,1957,4146
2019,United Arab Emirates,ARE,Germany,DEU,0,5,0,0,5
2019,Uganda,UGA,Germany,DEU,0,0,16,39,55
2019,Ukraine,UKR,Germany,DEU,14,32,1213,618,1877
2019,United States of America,USA,Germany,DEU,0,0,5,5,10
2019,Uzbekistan,UZB,Germany,DEU,0,5,5,18,28
2019,Venezuela (Bolivarian Republic of),VEN,Germany,DEU,16,70,36,49,171
2019,Yemen,YEM,Germany,DEU,17,5,117,199,338
2019,Zimbabwe,ZWE,Germany,DEU,22,0,59,40,121
2019,Stateless,XXA,Germany,DEU,123,33,198,306,660
2019,Unknown ,,Germany,DEU,205,261,1184,1589,3239
2019,Afghanistan,AFG,Croatia,HRV,0,0,10,0,10
2019,Algeria,DZA,Croatia,HRV,0,0,15,0,15
2019,Iran (Islamic Rep. of),IRN,Croatia,HRV,0,0,5,10,15
2019,Iraq,IRQ,Croatia,HRV,0,0,5,0,5
2019,Pakistan,PAK,Croatia,HRV,0,0,5,0,5
2019,Russian Federation,RUS,Croatia,HRV,0,0,5,0,5
2019,Serbia and Kosovo: S/RES/1244 (1999),SRB,Croatia,HRV,0,0,0,5,5
2019,Syrian Arab Rep.,SYR,Croatia,HRV,0,0,5,10,15
2019,Ukraine,UKR,Croatia,HRV,0,0,5,0,5
2019,Afghanistan,AFG,Rep. of Moldova,MDA,0,0,5,0,5
2019,Bangladesh,BGD,Rep. of Moldova,MDA,0,0,5,0,5
2019,Kyrgyzstan,KGZ,Rep. of Moldova,MDA,0,0,5,0,5
2019,Russian Federation,RUS,Rep. of Moldova,MDA,0,0,5,0,5
2019,Turkey,TUR,Rep. of Moldova,MDA,0,0,10,0,10
2019,Ukraine,UKR,Rep. of Moldova,MDA,0,0,5,0,5
2019,Uzbekistan,UZB,Rep. of Moldova,MDA,0,0,5,0,5
2019,Afghanistan,AFG,Romania,ROU,0,0,5,0,5
2019,Egypt,EGY,Romania,ROU,0,0,16,0,16
2019,Cameroon,CMR,Romania,ROU,0,0,10,0,10
2019,Dem. Rep. of the Congo,COD,Romania,ROU,0,5,0,0,5
2019,Palestinian,PSE,Romania,ROU,0,0,5,0,5
2019,Guinea,GIN,Romania,ROU,0,0,5,0,5
2019,India,IND,Romania,ROU,0,0,5,0,5
2019,Iran (Islamic Rep. of),IRN,Romania,ROU,10,5,12,0,27
2019,Iraq,IRQ,Romania,ROU,0,10,65,0,75
2019,Nigeria,NGA,Romania,ROU,0,0,5,0,5
2019,Pakistan,PAK,Romania,ROU,0,0,5,0,5
2019,Turkey,TUR,Romania,ROU,10,0,19,0,29
2019,Afghanistan,AFG,Ukraine,UKR,0,0,78,1328,1406
2019,Algeria,DZA,Ukraine,UKR,0,0,0,5,5
2019,Angola,AGO,Ukraine,UKR,0,0,0,12,12
2019,Egypt,EGY,Ukraine,UKR,0,0,0,5,5
2019,Armenia,ARM,Ukraine,UKR,0,0,0,11,11
2019,Azerbaijan,AZE,Ukraine,UKR,0,0,5,28,33
2019,Burundi,BDI,Ukraine,UKR,0,0,0,5,5
2019,Bangladesh,BGD,Ukraine,UKR,0,0,31,23,54
2019,Belarus,BLR,Ukraine,UKR,0,0,0,24,24
2019,Cambodia,KHM,Ukraine,UKR,0,0,0,5,5
2019,China,CHN,Ukraine,UKR,0,0,0,5,5
2019,Cameroon,CMR,Ukraine,UKR,0,0,11,59,70
2019,Congo,COG,Ukraine,UKR,0,0,5,18,23
2019,Dem. Rep. of the Congo,COD,Ukraine,UKR,0,0,14,85,99
2019,Cuba,CUB,Ukraine,UKR,0,0,0,5,5
2019,Eritrea,ERI,Ukraine,UKR,0,0,5,10,15
2019,Ethiopia,ETH,Ukraine,UKR,0,0,5,24,29
2019,Gambia,GMB,Ukraine,UKR,0,0,0,5,5
2019,Palestinian,PSE,Ukraine,UKR,0,0,5,84,89
2019,Georgia,GEO,Ukraine,UKR,0,0,0,59,59
2019,Guinea,GIN,Ukraine,UKR,0,0,13,71,84
2019,Cote d'Ivoire,CIV,Ukraine,UKR,0,0,5,13,18
2019,India,IND,Ukraine,UKR,0,0,5,14,19
2019,Iran (Islamic Rep. of),IRN,Ukraine,UKR,0,0,10,38,48
2019,Iraq,IRQ,Ukraine,UKR,0,0,13,120,133
2019,Jordan,JOR,Ukraine,UKR,0,0,5,10,15
2019,Kenya,KEN,Ukraine,UKR,0,0,0,5,5
2019,Kyrgyzstan,KGZ,Ukraine,UKR,0,0,0,122,122
2019,Liberia,LBR,Ukraine,UKR,0,0,0,11,11
2019,Lebanon,LBN,Ukraine,UKR,0,0,10,0,10
2019,Sri Lanka,LKA,Ukraine,UKR,0,0,0,39,39
2019,Myanmar,MMR,Ukraine,UKR,0,0,0,5,5
2019,Nepal,NPL,Ukraine,UKR,0,0,0,15,15
2019,Nigeria,NGA,Ukraine,UKR,0,0,10,32,42
2019,Pakistan,PAK,Ukraine,UKR,0,0,14,52,66
2019,Russian Federation,RUS,Ukraine,UKR,0,0,27,0,27
2019,Senegal,SEN,Ukraine,UKR,0,0,5,0,5
2019,Sierra Leone,SLE,Ukraine,UKR,0,0,0,5,5
2019,Somalia,SOM,Ukraine,UKR,0,0,18,82,100
2019,Viet Nam,VNM,Ukraine,UKR,0,0,0,5,5
2019,Sudan,SDN,Ukraine,UKR,0,0,0,62,62
2019,Syrian Arab Rep.,SYR,Ukraine,UKR,0,10,33,215,258
2019,Tajikistan,TJK,Ukraine,UKR,5,0,13,15,33
2019,Turkey,TUR,Ukraine,UKR,0,0,5,19,24
2019,Uganda,UGA,Ukraine,UKR,0,0,0,5,5
2019,Uzbekistan,UZB,Ukraine,UKR,0,0,26,0,26
2019,Western Sahara,ESH,Ukraine,UKR,0,0,0,5,5
2019,Yemen,YEM,Ukraine,UKR,0,5,12,0,17
2019,Stateless,XXA,Ukraine,UKR,0,0,5,0,5
2020,Armenia,ARM,Belarus,BLR,0,0,5,0,5
2020,Cuba,CUB,Belarus,BLR,0,0,5,0,5
2020,Mongolia,MNG,Belarus,BLR,0,0,5,0,5
2020,Russian Federation,RUS,Belarus,BLR,0,0,10,0,10
2020,Ukraine,UKR,Belarus,BLR,0,0,5,0,5
2020,Afghanistan,AFG,Bosnia and Herzegovina,BIH,0,0,5,0,5
2020,Pakistan,PAK,Bosnia and Herzegovina,BIH,0,0,5,0,5
2020,Yemen,YEM,Bosnia and Herzegovina,BIH,0,5,0,0,5
2020,Afghanistan,AFG,Germany,DEU,1201,7086,5518,7363,21168
2020,Albania,ALB,Germany,DEU,0,43,340,789,1172
2020,Algeria,DZA,Germany,DEU,5,10,168,369,552
2020,Angola,AGO,Germany,DEU,0,13,55,151,219
2020,Egypt,EGY,Germany,DEU,110,53,428,389,980
2020,Armenia,ARM,Germany,DEU,0,154,1245,1148,2547
2020,Azerbaijan,AZE,Germany,DEU,24,43,1119,976,2162
2020,Bahrain,BHR,Germany,DEU,0,0,5,0,5
2020,Burundi,BDI,Germany,DEU,0,0,0,5,5
2020,Benin,BEN,Germany,DEU,0,0,56,54,110
2020,Bangladesh,BGD,Germany,DEU,10,5,203,161,379
2020,Bhutan,BTN,Germany,DEU,0,0,5,0,5
2020,Burkina Faso,BFA,Germany,DEU,0,5,23,41,69
2020,Belarus,BLR,Germany,DEU,0,0,43,109,152
2020,Botswana,BWA,Germany,DEU,0,5,0,0,5
2020,Brazil,BRA,Germany,DEU,0,0,5,0,5
2020,Bosnia and Herzegovina,BIH,Germany,DEU,0,5,39,203,247
2020,Cambodia,KHM,Germany,DEU,0,0,0,5,5
2020,Central African Rep.,CAF,Germany,DEU,0,0,5,5,10
2020,Chad,TCD,Germany,DEU,5,0,10,39,54
2020,China,CHN,Germany,DEU,60,5,125,260,450
2020,Cameroon,CMR,Germany,DEU,29,60,446,470,1005
2020,Congo,COG,Germany,DEU,0,0,15,5,20
2020,Dem. Rep. of the Congo,COD,Germany,DEU,0,22,90,115,227
2020,Colombia,COL,Germany,DEU,0,0,61,37,98
2020,Cuba,CUB,Germany,DEU,0,0,19,26,45
2020,Djibouti,DJI,Germany,DEU,0,0,5,5,10
2020,Ecuador,ECU,Germany,DEU,0,0,0,5,5
2020,Equatorial Guinea,GNQ,Germany,DEU,0,0,0,5,5
2020,Eritrea,ERI,Germany,DEU,116,190,422,1094,1822
2020,Ethiopia,ETH,Germany,DEU,85,950,760,628,2423
2020,Gabon,GAB,Germany,DEU,0,0,0,5,5
2020,Gambia,GMB,Germany,DEU,20,125,1782,1301,3228
2020,Palestinian,PSE,Germany,DEU,0,25,55,73,153
2020,Georgia,GEO,Germany,DEU,11,49,1219,1271,2550
2020,Ghana,GHA,Germany,DEU,5,30,191,416,642
2020,Guinea-Bissau,GNB,Germany,DEU,0,10,26,61,97
2020,Guinea,GIN,Germany,DEU,27,78,1040,1107,2252
2020,Cote d'Ivoire,CIV,Germany,DEU,0,47,426,281,754
2020,India,IND,Germany,DEU,0,18,185,240,443
2020,Indonesia,IDN,Germany,DEU,0,0,0,5,5
2020,Iran (Islamic Rep. of),IRN,Germany,DEU,1553,132,2559,2785,7029
2020,Iraq,IRQ,Germany,DEU,572,1869,6287,5932,14660
2020,Israel,ISR,Germany,DEU,0,0,5,11,16
2020,Italy,ITA,Germany,DEU,0,0,5,0,5
2020,Jamaica,JAM,Germany,DEU,0,0,10,10,20
2020,Jordan,JOR,Germany,DEU,5,5,48,106,164
2020,Kazakhstan,KAZ,Germany,DEU,0,0,35,26,61
2020,Kenya,KEN,Germany,DEU,0,0,64,227,291
2020,Kyrgyzstan,KGZ,Germany,DEU,5,17,84,50,156
2020,Rep. of Korea,KOR,Germany,DEU,0,0,5,5,10
2020,Dem. People's Rep. of Korea,PRK,Germany,DEU,10,0,15,5,30
2020,Kuwait,KWT,Germany,DEU,0,0,0,14,14
2020,Liberia,LBR,Germany,DEU,0,5,44,78,127
2020,Libya,LBY,Germany,DEU,0,122,84,342,548
2020,Lebanon,LBN,Germany,DEU,5,62,395,461,923
2020,Sri Lanka,LKA,Germany,DEU,48,40,450,236,774
2020,Mauritania,MRT,Germany,DEU,0,0,5,5,10
2020,North Macedonia,MKD,Germany,DEU,0,17,150,477,644
2020,Rep. of Moldova,MDA,Germany,DEU,0,0,330,565,895
2020,Mexico,MEX,Germany,DEU,0,0,0,5,5
2020,Mali,MLI,Germany,DEU,5,12,152,163,332
2020,Malaysia,MYS,Germany,DEU,5,0,0,0,5
2020,Mongolia,MNG,Germany,DEU,0,12,124,92,228
2020,Morocco,MAR,Germany,DEU,17,17,153,371,558
2020,Mozambique,MOZ,Germany,DEU,0,0,0,10,10
2020,Montenegro,MNE,Germany,DEU,0,0,11,92,103
2020,Mauritius,MUS,Germany,DEU,0,0,0,5,5
2020,Myanmar,MMR,Germany,DEU,20,0,22,25,67
2020,Nepal,NPL,Germany,DEU,5,0,33,14,52
2020,Niger,NER,Germany,DEU,0,5,27,25,57
2020,Nigeria,NGA,Germany,DEU,73,625,4161,5823,10682
2020,Pakistan,PAK,Germany,DEU,523,162,2353,1961,4999
2020,Philippines,PHL,Germany,DEU,0,0,0,12,12
2020,Portugal,PRT,Germany,DEU,0,0,0,5,5
2020,South Africa,ZAF,Germany,DEU,0,0,5,13,18
2020,Russian Federation,RUS,Germany,DEU,243,190,1989,2592,5014
2020,Rwanda,RWA,Germany,DEU,5,0,5,25,35
2020,El Salvador,SLV,Germany,DEU,0,5,0,5,10
2020,Saudi Arabia,SAU,Germany,DEU,5,0,5,12,22
2020,Serbia and Kosovo: S/RES/1244 (1999),SRB,Germany,DEU,0,38,302,898,1238
2020,Senegal,SEN,Germany,DEU,0,5,78,136,219
2020,Sierra Leone,SLE,Germany,DEU,0,19,246,210,475
2020,Somalia,SOM,Germany,DEU,110,445,711,2081,3347
2020,Spain,ESP,Germany,DEU,0,0,5,5,10
2020,Viet Nam,VNM,Germany,DEU,0,0,58,84,142
2020,Sudan,SDN,Germany,DEU,28,185,240,416,869
2020,South Sudan,SSD,Germany,DEU,0,12,0,14,26
2020,Syrian Arab Rep.,SYR,Germany,DEU,873,854,5398,8361,15486
2020,United Rep. of Tanzania,TZA,Germany,DEU,0,5,19,88,112
2020,Tajikistan,TJK,Germany,DEU,30,10,197,197,434
2020,Turkmenistan,TKM,Germany,DEU,0,0,0,5,5
2020,Togo,TGO,Germany,DEU,10,22,289,225,546
2020,Tunisia,TUN,Germany,DEU,10,0,72,192,274
2020,Turkey,TUR,Germany,DEU,550,88,1830,1796,4264
2020,Uganda,UGA,Germany,DEU,0,0,32,48,80
2020,Ukraine,UKR,Germany,DEU,5,35,547,492,1079
2020,United States of America,USA,Germany,DEU,0,0,0,10,10
2020,Uzbekistan,UZB,Germany,DEU,5,5,19,32,61
2020,Venezuela (Bolivarian Republic of),VEN,Germany,DEU,27,122,54,58,261
2020,Yemen,YEM,Germany,DEU,11,18,70,126,225
2020,Zambia,ZMB,Germany,DEU,0,0,10,0,10
2020,Zimbabwe,ZWE,Germany,DEU,23,0,31,37,91
2020,Stateless,XXA,Germany,DEU,54,45,130,221,450
2020,Unknown ,,Germany,DEU,155,261,741,1136,2293
2020,Afghanistan,AFG,Croatia,HRV,0,0,5,0,5
2020,Algeria,DZA,Croatia,HRV,0,0,22,0,22
2020,Iran (Islamic Rep. of),IRN,Croatia,HRV,0,0,13,0,13
2020,Iraq,IRQ,Croatia,HRV,0,0,5,0,5
2020,Morocco,MAR,Croatia,HRV,0,0,12,0,12
2020,Nigeria,NGA,Croatia,HRV,0,0,5,0,5
2020,Sierra Leone,SLE,Croatia,HRV,0,0,5,0,5
2020,Tunisia,TUN,Croatia,HRV,0,0,5,0,5
2020,Turkey,TUR,Croatia,HRV,0,0,10,0,10
2020,Armenia,ARM,Rep. of Moldova,MDA,0,0,5,0,5
2020,Azerbaijan,AZE,Rep. of Moldova,MDA,0,0,5,0,5
2020,Bangladesh,BGD,Rep. of Moldova,MDA,0,0,14,0,14
2020,Turkey,TUR,Rep. of Moldova,MDA,0,0,5,0,5
2020,Ukraine,UKR,Rep. of Moldova,MDA,0,0,5,0,5
2020,Afghanistan,AFG,Romania,ROU,0,11,26,0,37
2020,Angola,AGO,Romania,ROU,5,0,0,0,5
2020,Bangladesh,BGD,Romania,ROU,0,0,10,0,10
2020,Cameroon,CMR,Romania,ROU,0,0,10,0,10
2020,Dem. Rep. of the Congo,COD,Romania,ROU,0,0,5,0,5
2020,Comoros,COM,Romania,ROU,0,0,5,0,5
2020,Palestinian,PSE,Romania,ROU,0,0,5,0,5
2020,Cote d'Ivoire,CIV,Romania,ROU,0,0,5,0,5
2020,India,IND,Romania,ROU,5,0,0,0,5
2020,Iran (Islamic Rep. of),IRN,Romania,ROU,5,5,19,0,29
2020,Iraq,IRQ,Romania,ROU,10,16,52,0,78
2020,Nigeria,NGA,Romania,ROU,0,0,5,0,5
2020,Pakistan,PAK,Romania,ROU,0,0,5,0,5
2020,South Africa,ZAF,Romania,ROU,0,0,5,0,5
2020,Somalia,SOM,Romania,ROU,0,0,11,0,11
2020,Syrian Arab Rep.,SYR,Romania,ROU,0,11,0,0,11
2020,Turkey,TUR,Romania,ROU,0,0,5,0,5
2020,Stateless,XXA,Romania,ROU,0,0,5,0,5
2020,Afghanistan,AFG,Ukraine,UKR,0,0,40,5,45
2020,Bangladesh,BGD,Ukraine,UKR,0,0,12,0,12
2020,Cameroon,CMR,Ukraine,UKR,0,0,5,0,5
2020,Dem. Rep. of the Congo,COD,Ukraine,UKR,0,0,5,5,10
2020,Eritrea,ERI,Ukraine,UKR,0,0,5,0,5
2020,Guinea,GIN,Ukraine,UKR,0,0,5,0,5
2020,Iran (Islamic Rep. of),IRN,Ukraine,UKR,0,0,5,0,5
2020,Iraq,IRQ,Ukraine,UKR,0,0,11,0,11
2020,Jordan,JOR,Ukraine,UKR,0,0,5,0,5
2020,Morocco,MAR,Ukraine,UKR,0,0,5,0,5
2020,Pakistan,PAK,Ukraine,UKR,0,0,5,0,5
2020,Russian Federation,RUS,Ukraine,UKR,0,10,18,0,28
2020,Somalia,SOM,Ukraine,UKR,0,0,12,5,17
2020,Syrian Arab Rep.,SYR,Ukraine,UKR,0,12,5,0,17
2020,Tajikistan,TJK,Ukraine,UKR,0,0,11,0,11
2020,Uzbekistan,UZB,Ukraine,UKR,0,0,5,0,5
2000,Afghanistan,AFG,Germany,DEU,31,721,2450,142,3344
2000,Albania,ALB,Germany,DEU,5,5,364,47,421
2000,Algeria,DZA,Germany,DEU,10,5,1292,129,1436
2000,Angola,AGO,Germany,DEU,12,64,268,21,365
2000,Egypt,EGY,Germany,DEU,11,0,101,10,122
2000,Armenia,ARM,Germany,DEU,11,19,1109,70,1209
2000,Azerbaijan,AZE,Germany,DEU,239,13,1270,42,1564
2000,Burundi,BDI,Germany,DEU,13,0,34,0,47
2000,Benin,BEN,Germany,DEU,0,0,43,0,43
2000,Bangladesh,BGD,Germany,DEU,0,5,293,10,308
2000,Bhutan,BTN,Germany,DEU,5,0,14,0,19
2000,Burkina Faso,BFA,Germany,DEU,0,0,475,5,480
2000,Belarus,BLR,Germany,DEU,5,0,369,44,418
2000,Bosnia and Herzegovina,BIH,Germany,DEU,5,17,1239,176,1437
2000,Bulgaria,BGR,Germany,DEU,0,0,66,155,221
2000,Cambodia,KHM,Germany,DEU,0,0,5,0,5
2000,Central African Rep.,CAF,Germany,DEU,0,0,10,0,10
2000,Chad,TCD,Germany,DEU,5,0,10,0,15
2000,China,CHN,Germany,DEU,87,10,1913,34,2044
2000,Cameroon,CMR,Germany,DEU,16,5,686,13,720
2000,Congo,COG,Germany,DEU,5,5,35,0,45
2000,Dem. Rep. of the Congo,COD,Germany,DEU,62,25,669,48,804
2000,Colombia,COL,Germany,DEU,21,0,137,12,170
2000,Cuba,CUB,Germany,DEU,5,0,78,20,103
2000,Czechia,CZE,Germany,DEU,0,0,57,13,70
2000,Ecuador,ECU,Germany,DEU,0,0,21,5,26
2000,Eritrea,ERI,Germany,DEU,15,10,188,10,223
2000,Estonia,EST,Germany,DEU,0,0,21,0,21
2000,Ethiopia,ETH,Germany,DEU,35,26,274,14,349
2000,Gabon,GAB,Germany,DEU,0,0,13,0,13
2000,Gambia,GMB,Germany,DEU,0,0,31,0,31
2000,Georgia,GEO,Germany,DEU,10,5,840,61,916
2000,Ghana,GHA,Germany,DEU,0,0,261,29,290
2000,Guinea-Bissau,GNB,Germany,DEU,0,0,10,0,10
2000,Guinea,GIN,Germany,DEU,5,0,229,5,239
2000,Haiti,HTI,Germany,DEU,0,0,5,0,5
2000,Croatia,HRV,Germany,DEU,5,0,53,14,72
2000,Hungary,HUN,Germany,DEU,0,0,21,5,26
2000,Cote d'Ivoire,CIV,Germany,DEU,5,5,155,5,170
2000,India,IND,Germany,DEU,5,0,1600,87,1692
2000,Indonesia,IDN,Germany,DEU,0,0,10,5,15
2000,Iran (Islamic Rep. of),IRN,Germany,DEU,799,27,3108,228,4162
2000,Iraq,IRQ,Germany,DEU,6561,45,4470,323,11399
2000,Israel,ISR,Germany,DEU,11,0,20,0,31
2000,Jordan,JOR,Germany,DEU,0,0,121,20,141
2000,Kazakhstan,KAZ,Germany,DEU,5,5,124,13,147
2000,Kenya,KEN,Germany,DEU,0,0,34,0,34
2000,Kyrgyzstan,KGZ,Germany,DEU,0,0,59,5,64
2000,Dem. People's Rep. of Korea,PRK,Germany,DEU,56,0,53,0,109
2000,Kuwait,KWT,Germany,DEU,0,0,5,0,5
2000,Lao People's Dem. Rep.,LAO,Germany,DEU,0,0,10,0,10
2000,Liberia,LBR,Germany,DEU,0,0,47,16,63
2000,Libya,LBY,Germany,DEU,10,0,79,31,120
2000,Lebanon,LBN,Germany,DEU,29,5,725,68,827
2000,Sri Lanka,LKA,Germany,DEU,135,10,1313,124,1582
2000,Lithuania,LTU,Germany,DEU,0,0,125,20,145
2000,Latvia,LVA,Germany,DEU,0,0,26,5,31
2000,Mauritania,MRT,Germany,DEU,5,0,13,0,18
2000,North Macedonia,MKD,Germany,DEU,0,0,217,23,240
2000,Rep. of Moldova,MDA,Germany,DEU,0,0,266,64,330
2000,Mali,MLI,Germany,DEU,0,0,37,5,42
2000,Mongolia,MNG,Germany,DEU,0,0,117,11,128
2000,Morocco,MAR,Germany,DEU,0,0,250,22,272
2000,Mozambique,MOZ,Germany,DEU,0,0,0,5,5
2000,Myanmar,MMR,Germany,DEU,43,0,46,0,89
2000,Nepal,NPL,Germany,DEU,0,0,64,0,64
2000,Niger,NER,Germany,DEU,0,0,70,0,70
2000,Nigeria,NGA,Germany,DEU,5,5,449,38,497
2000,Pakistan,PAK,Germany,DEU,73,0,1482,89,1644
2000,Peru,PER,Germany,DEU,0,0,18,0,18
2000,Poland,POL,Germany,DEU,0,0,94,19,113
2000,Romania,ROU,Germany,DEU,0,0,144,488,632
2000,South Africa,ZAF,Germany,DEU,0,0,0,10,10
2000,Russian Federation,RUS,Germany,DEU,10,18,1258,369,1655
2000,Rwanda,RWA,Germany,DEU,47,0,34,10,91
2000,Serbia and Kosovo: S/RES/1244 (1999),SRB,Germany,DEU,191,83,12022,2769,15065
2000,Senegal,SEN,Germany,DEU,0,0,20,0,20
2000,Sierra Leone,SLE,Germany,DEU,0,5,502,27,534
2000,Somalia,SOM,Germany,DEU,0,143,270,12,425
2000,Viet Nam,VNM,Germany,DEU,5,0,2088,81,2174
2000,Sudan,SDN,Germany,DEU,5,5,139,10,159
2000,Slovakia,SVK,Germany,DEU,0,0,140,45,185
2000,Slovenia,SVN,Germany,DEU,0,0,5,0,5
2000,Syrian Arab Rep.,SYR,Germany,DEU,258,10,2056,63,2387
2000,Thailand,THA,Germany,DEU,0,0,5,0,5
2000,Tajikistan,TJK,Germany,DEU,0,0,20,0,20
2000,Togo,TGO,Germany,DEU,83,0,585,30,698
2000,Tunisia,TUN,Germany,DEU,24,0,201,23,248
2000,Turkey,TUR,Germany,DEU,1782,42,6879,426,9129
2000,Uganda,UGA,Germany,DEU,0,0,29,0,29
2000,Ukraine,UKR,Germany,DEU,5,5,404,103,517
2000,Uzbekistan,UZB,Germany,DEU,0,0,37,20,57
2000,Yemen,YEM,Germany,DEU,5,5,149,0,159
2000,Zimbabwe,ZWE,Germany,DEU,0,0,5,0,5
2000,Stateless,XXA,Germany,DEU,97,5,2505,62,2669
2000,Unknown ,,Germany,DEU,17,0,602,14,633
2001,Afghanistan,AFG,Germany,DEU,2656,1519,972,168,5315
2001,Albania,ALB,Germany,DEU,0,0,292,66,358
2001,Algeria,DZA,Germany,DEU,25,12,1517,140,1694
2001,Angola,AGO,Germany,DEU,15,64,171,17,267
2001,Egypt,EGY,Germany,DEU,0,0,54,12,66
2001,Armenia,ARM,Germany,DEU,14,12,813,56,895
2001,Azerbaijan,AZE,Germany,DEU,274,34,1053,48,1409
2001,Burundi,BDI,Germany,DEU,10,0,32,0,42
2001,Benin,BEN,Germany,DEU,0,0,110,5,115
2001,Bangladesh,BGD,Germany,DEU,5,0,139,5,149
2001,Bhutan,BTN,Germany,DEU,0,0,18,0,18
2001,Burkina Faso,BFA,Germany,DEU,0,5,470,5,480
2001,Belarus,BLR,Germany,DEU,19,5,372,90,486
2001,Bosnia and Herzegovina,BIH,Germany,DEU,10,21,1615,447,2093
2001,Bulgaria,BGR,Germany,DEU,0,0,43,62,105
2001,Cambodia,KHM,Germany,DEU,0,0,10,0,10
2001,China,CHN,Germany,DEU,91,5,1192,34,1322
2001,Cameroon,CMR,Germany,DEU,27,10,600,17,654
2001,Congo,COG,Germany,DEU,5,0,19,14,38
2001,Dem. Rep. of the Congo,COD,Germany,DEU,78,45,336,38,497
2001,Colombia,COL,Germany,DEU,13,5,92,5,115
2001,Cuba,CUB,Germany,DEU,10,0,55,14,79
2001,Czechia,CZE,Germany,DEU,0,0,43,25,68
2001,Ecuador,ECU,Germany,DEU,0,0,26,5,31
2001,Eritrea,ERI,Germany,DEU,17,34,178,5,234
2001,Estonia,EST,Germany,DEU,0,0,22,0,22
2001,Ethiopia,ETH,Germany,DEU,28,88,230,11,357
2001,Gabon,GAB,Germany,DEU,0,0,18,0,18
2001,Gambia,GMB,Germany,DEU,0,0,32,0,32
2001,Georgia,GEO,Germany,DEU,5,5,965,46,1021
2001,Ghana,GHA,Germany,DEU,0,5,267,14,286
2001,Guinea,GIN,Germany,DEU,0,5,408,13,426
2001,Croatia,HRV,Germany,DEU,0,0,105,11,116
2001,Hungary,HUN,Germany,DEU,0,0,0,30,30
2001,Cote d'Ivoire,CIV,Germany,DEU,0,5,189,5,199
2001,India,IND,Germany,DEU,5,5,2380,100,2490
2001,Indonesia,IDN,Germany,DEU,0,0,5,0,5
2001,Iran (Islamic Rep. of),IRN,Germany,DEU,740,18,2872,306,3936
2001,Iraq,IRQ,Germany,DEU,10086,38,5334,426,15884
2001,Israel,ISR,Germany,DEU,0,0,35,19,54
2001,Jamaica,JAM,Germany,DEU,0,0,5,0,5
2001,Jordan,JOR,Germany,DEU,0,0,69,10,79
2001,Kazakhstan,KAZ,Germany,DEU,0,5,153,21,179
2001,Kenya,KEN,Germany,DEU,0,5,24,0,29
2001,Kyrgyzstan,KGZ,Germany,DEU,5,0,40,15,60
2001,Dem. People's Rep. of Korea,PRK,Germany,DEU,52,0,33,0,85
2001,Liberia,LBR,Germany,DEU,0,0,44,18,62
2001,Libya,LBY,Germany,DEU,15,0,63,13,91
2001,Lebanon,LBN,Germany,DEU,28,0,502,37,567
2001,Sri Lanka,LKA,Germany,DEU,75,19,642,49,785
2001,Lithuania,LTU,Germany,DEU,0,0,93,29,122
2001,Latvia,LVA,Germany,DEU,0,0,27,0,27
2001,Mauritania,MRT,Germany,DEU,0,0,5,10,15
2001,North Macedonia,MKD,Germany,DEU,0,0,803,62,865
2001,Rep. of Moldova,MDA,Germany,DEU,0,0,264,49,313
2001,Mali,MLI,Germany,DEU,0,0,78,5,83
2001,Mongolia,MNG,Germany,DEU,0,0,183,15,198
2001,Morocco,MAR,Germany,DEU,0,0,205,30,235
2001,Myanmar,MMR,Germany,DEU,126,5,12,0,143
2001,Nepal,NPL,Germany,DEU,5,0,114,5,124
2001,Niger,NER,Germany,DEU,5,0,95,5,105
2001,Nigeria,NGA,Germany,DEU,10,5,464,32,511
2001,Pakistan,PAK,Germany,DEU,54,5,1128,40,1227
2001,Peru,PER,Germany,DEU,0,0,5,0,5
2001,Poland,POL,Germany,DEU,0,0,132,24,156
2001,Romania,ROU,Germany,DEU,0,0,139,223,362
2001,South Africa,ZAF,Germany,DEU,0,0,5,0,5
2001,Russian Federation,RUS,Germany,DEU,645,79,3194,301,4219
2001,Rwanda,RWA,Germany,DEU,36,0,19,5,60
2001,Saudi Arabia,SAU,Germany,DEU,0,0,5,0,5
2001,Serbia and Kosovo: S/RES/1244 (1999),SRB,Germany,DEU,51,120,3453,1091,4715
2001,Senegal,SEN,Germany,DEU,0,0,20,0,20
2001,Sierra Leone,SLE,Germany,DEU,5,21,1226,38,1290
2001,Somalia,SOM,Germany,DEU,0,100,192,16,308
2001,Viet Nam,VNM,Germany,DEU,5,5,3452,101,3563
2001,Sudan,SDN,Germany,DEU,5,5,111,10,131
2001,Slovakia,SVK,Germany,DEU,0,0,66,33,99
2001,Slovenia,SVN,Germany,DEU,0,0,5,0,5
2001,Syrian Arab Rep.,SYR,Germany,DEU,258,5,1900,98,2261
2001,United Rep. of Tanzania,TZA,Germany,DEU,0,0,5,0,5
2001,Thailand,THA,Germany,DEU,0,0,5,0,5
2001,Tajikistan,TJK,Germany,DEU,5,0,25,0,30
2001,Turkmenistan,TKM,Germany,DEU,0,0,5,0,5
2001,Togo,TGO,Germany,DEU,111,5,858,29,1003
2001,Tunisia,TUN,Germany,DEU,5,0,147,19,171
2001,Turkey,TUR,Germany,DEU,1728,31,7395,569,9723
2001,Uganda,UGA,Germany,DEU,5,0,45,5,55
2001,Ukraine,UKR,Germany,DEU,11,5,491,92,599
2001,Uzbekistan,UZB,Germany,DEU,0,0,23,10,33
2001,Yemen,YEM,Germany,DEU,10,0,57,5,72
2001,Zimbabwe,ZWE,Germany,DEU,0,0,5,0,5
2001,Stateless,XXA,Germany,DEU,21,5,140,5,171
2001,Unknown ,,Germany,DEU,123,18,3004,103,3248
2002,Afghanistan,AFG,Germany,DEU,21,43,5,341,410
2002,Albania,ALB,Germany,DEU,5,5,307,51,368
2002,Algeria,DZA,Germany,DEU,5,5,1721,193,1924
2002,Angola,AGO,Germany,DEU,22,64,412,35,533
2002,Egypt,EGY,Germany,DEU,0,0,68,14,82
2002,Armenia,ARM,Germany,DEU,0,5,931,60,996
2002,Azerbaijan,AZE,Germany,DEU,58,10,1596,43,1707
2002,Burundi,BDI,Germany,DEU,10,0,41,0,51
2002,Benin,BEN,Germany,DEU,0,0,140,5,145
2002,Bangladesh,BGD,Germany,DEU,0,0,169,10,179
2002,Bhutan,BTN,Germany,DEU,5,0,37,0,42
2002,Burkina Faso,BFA,Germany,DEU,0,0,141,0,141
2002,Belarus,BLR,Germany,DEU,21,10,492,83,606
2002,Bosnia and Herzegovina,BIH,Germany,DEU,0,36,1171,214,1421
2002,Bulgaria,BGR,Germany,DEU,0,0,620,212,832
2002,Cambodia,KHM,Germany,DEU,0,0,14,0,14
2002,Central African Rep.,CAF,Germany,DEU,0,0,5,0,5
2002,Chad,TCD,Germany,DEU,0,0,12,0,12
2002,China,CHN,Germany,DEU,28,5,1435,53,1521
2002,Cameroon,CMR,Germany,DEU,12,10,1043,21,1086
2002,Congo,COG,Germany,DEU,11,5,19,5,40
2002,Dem. Rep. of the Congo,COD,Germany,DEU,41,79,648,72,840
2002,Colombia,COL,Germany,DEU,5,0,78,25,108
2002,Cuba,CUB,Germany,DEU,5,0,68,10,83
2002,Czechia,CZE,Germany,DEU,0,0,32,5,37
2002,Ecuador,ECU,Germany,DEU,0,0,17,10,27
2002,Eritrea,ERI,Germany,DEU,18,55,265,12,350
2002,Estonia,EST,Germany,DEU,0,0,12,0,12
2002,Ethiopia,ETH,Germany,DEU,29,75,351,10,465
2002,Fiji,FJI,Germany,DEU,0,0,10,0,10
2002,Gabon,GAB,Germany,DEU,0,0,10,0,10
2002,Gambia,GMB,Germany,DEU,0,0,39,5,44
2002,Georgia,GEO,Germany,DEU,10,5,1395,71,1481
2002,Ghana,GHA,Germany,DEU,0,0,269,26,295
2002,Guinea-Bissau,GNB,Germany,DEU,0,0,21,5,26
2002,Guinea,GIN,Germany,DEU,12,5,357,10,384
2002,Croatia,HRV,Germany,DEU,0,0,59,5,64
2002,Hungary,HUN,Germany,DEU,0,0,5,5,10
2002,Cote d'Ivoire,CIV,Germany,DEU,0,5,130,10,145
2002,India,IND,Germany,DEU,5,0,2168,82,2255
2002,Iran (Islamic Rep. of),IRN,Germany,DEU,459,24,2110,230,2823
2002,Iraq,IRQ,Germany,DEU,2868,71,8301,746,11986
2002,Israel,ISR,Germany,DEU,0,0,42,12,54
2002,Jordan,JOR,Germany,DEU,0,0,60,13,73
2002,Kazakhstan,KAZ,Germany,DEU,5,0,132,22,159
2002,Kenya,KEN,Germany,DEU,0,5,67,5,77
2002,Kyrgyzstan,KGZ,Germany,DEU,11,0,61,14,86
2002,Dem. People's Rep. of Korea,PRK,Germany,DEU,48,0,16,0,64
2002,Lao People's Dem. Rep.,LAO,Germany,DEU,0,0,5,0,5
2002,Liberia,LBR,Germany,DEU,0,5,154,11,170
2002,Libya,LBY,Germany,DEU,12,0,64,10,86
2002,Lebanon,LBN,Germany,DEU,15,0,736,44,795
2002,Sri Lanka,LKA,Germany,DEU,35,5,533,45,618
2002,Lithuania,LTU,Germany,DEU,0,0,64,10,74
2002,Latvia,LVA,Germany,DEU,0,0,24,10,34
2002,Mauritania,MRT,Germany,DEU,0,0,31,0,31
2002,North Macedonia,MKD,Germany,DEU,0,5,615,99,719
2002,Rep. of Moldova,MDA,Germany,DEU,0,0,220,35,255
2002,Mali,MLI,Germany,DEU,0,0,72,0,72
2002,Mongolia,MNG,Germany,DEU,0,0,164,23,187
2002,Morocco,MAR,Germany,DEU,0,0,248,44,292
2002,Mozambique,MOZ,Germany,DEU,0,0,5,0,5
2002,Myanmar,MMR,Germany,DEU,25,0,16,5,46
2002,Nepal,NPL,Germany,DEU,5,0,256,5,266
2002,Niger,NER,Germany,DEU,0,0,149,5,154
2002,Nigeria,NGA,Germany,DEU,5,5,862,43,915
2002,Pakistan,PAK,Germany,DEU,63,5,980,60,1108
2002,Peru,PER,Germany,DEU,0,0,5,0,5
2002,Poland,POL,Germany,DEU,0,0,37,15,52
2002,Romania,ROU,Germany,DEU,0,0,93,351,444
2002,Russian Federation,RUS,Germany,DEU,382,56,3334,388,4160
2002,Rwanda,RWA,Germany,DEU,16,0,24,0,40
2002,Serbia and Kosovo: S/RES/1244 (1999),SRB,Germany,DEU,31,221,24092,1729,26073
2002,Senegal,SEN,Germany,DEU,0,0,24,5,29
2002,Sierra Leone,SLE,Germany,DEU,0,10,460,34,504
2002,Somalia,SOM,Germany,DEU,0,69,96,10,175
2002,Viet Nam,VNM,Germany,DEU,5,5,2294,90,2394
2002,Sudan,SDN,Germany,DEU,16,0,174,10,200
2002,Slovakia,SVK,Germany,DEU,0,0,415,223,638
2002,Slovenia,SVN,Germany,DEU,0,0,5,0,5
2002,Syrian Arab Rep.,SYR,Germany,DEU,157,5,1514,101,1777
2002,United Rep. of Tanzania,TZA,Germany,DEU,0,0,11,0,11
2002,Tajikistan,TJK,Germany,DEU,5,0,36,0,41
2002,Turkmenistan,TKM,Germany,DEU,0,0,13,5,18
2002,Togo,TGO,Germany,DEU,67,15,965,34,1081
2002,Tunisia,TUN,Germany,DEU,13,0,156,25,194
2002,Turkey,TUR,Germany,DEU,1348,45,7987,772,10152
2002,Uganda,UGA,Germany,DEU,10,0,87,5,102
2002,Ukraine,UKR,Germany,DEU,10,5,472,108,595
2002,Uzbekistan,UZB,Germany,DEU,10,5,49,12,76
2002,Venezuela (Bolivarian Republic of),VEN,Germany,DEU,0,0,5,0,5
2002,Yemen,YEM,Germany,DEU,0,0,82,5,87
2002,Zimbabwe,ZWE,Germany,DEU,0,0,15,0,15
2002,Stateless,XXA,Germany,DEU,15,0,97,11,123
2002,Unknown ,,Germany,DEU,67,19,2263,75,2424
2003,Afghanistan,AFG,Germany,DEU,46,237,6686,386,7355
2003,Albania,ALB,Germany,DEU,0,0,290,29,319
2003,Algeria,DZA,Germany,DEU,0,0,1283,99,1382
2003,Angola,AGO,Germany,DEU,10,109,537,16,672
2003,Egypt,EGY,Germany,DEU,0,0,78,12,90
2003,Armenia,ARM,Germany,DEU,0,5,676,79,760
2003,Azerbaijan,AZE,Germany,DEU,22,13,1527,53,1615
2003,Burundi,BDI,Germany,DEU,17,0,50,5,72
2003,Benin,BEN,Germany,DEU,0,0,43,0,43
2003,Bangladesh,BGD,Germany,DEU,0,0,151,5,156
2003,Bhutan,BTN,Germany,DEU,0,0,26,0,26
2003,Burkina Faso,BFA,Germany,DEU,0,0,77,0,77
2003,Belarus,BLR,Germany,DEU,5,0,559,61,625
2003,Bosnia and Herzegovina,BIH,Germany,DEU,5,26,706,84,821
2003,Bulgaria,BGR,Germany,DEU,0,5,482,117,604
2003,Cambodia,KHM,Germany,DEU,0,0,28,0,28
2003,Central African Rep.,CAF,Germany,DEU,0,0,5,0,5
2003,Chad,TCD,Germany,DEU,0,0,5,0,5
2003,China,CHN,Germany,DEU,65,0,2809,54,2928
2003,Cameroon,CMR,Germany,DEU,5,16,1290,13,1324
2003,Congo,COG,Germany,DEU,0,10,103,10,123
2003,Dem. Rep. of the Congo,COD,Germany,DEU,41,82,1096,47,1266
2003,Colombia,COL,Germany,DEU,0,10,75,5,90
2003,Cuba,CUB,Germany,DEU,0,0,47,5,52
2003,Czechia,CZE,Germany,DEU,0,0,31,11,42
2003,Djibouti,DJI,Germany,DEU,0,0,5,0,5
2003,Ecuador,ECU,Germany,DEU,0,0,26,5,31
2003,Eritrea,ERI,Germany,DEU,11,25,488,12,536
2003,Estonia,EST,Germany,DEU,0,0,5,5,10
2003,Ethiopia,ETH,Germany,DEU,21,47,564,17,649
2003,Fiji,FJI,Germany,DEU,0,0,5,0,5
2003,Gabon,GAB,Germany,DEU,0,0,5,0,5
2003,Gambia,GMB,Germany,DEU,0,0,47,0,47
2003,Palestinian,PSE,Germany,DEU,5,0,56,5,66
2003,Georgia,GEO,Germany,DEU,13,5,1172,97,1287
2003,Ghana,GHA,Germany,DEU,0,0,357,12,369
2003,Guinea-Bissau,GNB,Germany,DEU,0,0,35,0,35
2003,Guinea,GIN,Germany,DEU,10,5,425,10,450
2003,Croatia,HRV,Germany,DEU,0,0,71,10,81
2003,Hungary,HUN,Germany,DEU,0,0,10,12,22
2003,Cote d'Ivoire,CIV,Germany,DEU,5,0,279,10,294
2003,India,IND,Germany,DEU,0,0,1988,72,2060
2003,Indonesia,IDN,Germany,DEU,0,0,10,0,10
2003,Iran (Islamic Rep. of),IRN,Germany,DEU,305,22,2588,159,3074
2003,Iraq,IRQ,Germany,DEU,540,20,4694,461,5715
2003,Israel,ISR,Germany,DEU,0,0,99,5,104
2003,Jordan,JOR,Germany,DEU,0,0,60,14,74
2003,Kazakhstan,KAZ,Germany,DEU,0,0,94,16,110
2003,Kenya,KEN,Germany,DEU,0,0,60,0,60
2003,Rep. of Korea,KOR,Germany,DEU,5,0,5,0,10
2003,Dem. People's Rep. of Korea,PRK,Germany,DEU,24,0,14,0,38
2003,Kuwait,KWT,Germany,DEU,0,0,5,0,5
2003,Liberia,LBR,Germany,DEU,0,0,146,11,157
2003,Libya,LBY,Germany,DEU,5,0,115,5,125
2003,Lebanon,LBN,Germany,DEU,11,0,731,44,786
2003,Sri Lanka,LKA,Germany,DEU,17,5,423,34,479
2003,Lithuania,LTU,Germany,DEU,0,0,44,11,55
2003,Latvia,LVA,Germany,DEU,0,0,16,18,34
2003,Mauritania,MRT,Germany,DEU,0,0,21,5,26
2003,North Macedonia,MKD,Germany,DEU,0,0,354,35,389
2003,Rep. of Moldova,MDA,Germany,DEU,0,0,172,5,177
2003,Mali,MLI,Germany,DEU,0,0,44,0,44
2003,Mongolia,MNG,Germany,DEU,0,0,62,13,75
2003,Morocco,MAR,Germany,DEU,0,0,300,19,319
2003,Mozambique,MOZ,Germany,DEU,0,0,5,0,5
2003,Myanmar,MMR,Germany,DEU,18,0,61,0,79
2003,Nepal,NPL,Germany,DEU,5,0,245,10,260
2003,Niger,NER,Germany,DEU,0,0,107,5,112
2003,Nigeria,NGA,Germany,DEU,0,5,1231,38,1274
2003,Pakistan,PAK,Germany,DEU,36,5,1188,43,1272
2003,Peru,PER,Germany,DEU,0,0,12,0,12
2003,Philippines,PHL,Germany,DEU,0,0,5,0,5
2003,Poland,POL,Germany,DEU,0,0,28,5,33
2003,Romania,ROU,Germany,DEU,0,0,94,96,190
2003,South Africa,ZAF,Germany,DEU,0,0,5,0,5
2003,Russian Federation,RUS,Germany,DEU,354,129,2521,353,3357
2003,Rwanda,RWA,Germany,DEU,24,0,20,5,49
2003,Serbia and Kosovo: S/RES/1244 (1999),SRB,Germany,DEU,13,134,5829,406,6382
2003,Senegal,SEN,Germany,DEU,0,0,24,5,29
2003,Sierra Leone,SLE,Germany,DEU,0,16,237,12,265
2003,Somalia,SOM,Germany,DEU,0,105,128,10,243
2003,Viet Nam,VNM,Germany,DEU,0,5,2223,53,2281
2003,Sudan,SDN,Germany,DEU,5,0,301,23,329
2003,Slovakia,SVK,Germany,DEU,0,0,428,194,622
2003,Slovenia,SVN,Germany,DEU,0,0,5,0,5
2003,Syrian Arab Rep.,SYR,Germany,DEU,117,10,1584,87,1798
2003,United Rep. of Tanzania,TZA,Germany,DEU,0,0,31,0,31
2003,Thailand,THA,Germany,DEU,0,0,5,0,5
2003,Tajikistan,TJK,Germany,DEU,0,0,18,0,18
2003,Turkmenistan,TKM,Germany,DEU,5,0,18,0,23
2003,Togo,TGO,Germany,DEU,55,11,1065,21,1152
2003,Tunisia,TUN,Germany,DEU,0,0,173,14,187
2003,Turkey,TUR,Germany,DEU,979,64,7119,550,8712
2003,Uganda,UGA,Germany,DEU,0,0,111,0,111
2003,Ukraine,UKR,Germany,DEU,5,0,376,76,457
2003,United States of America,USA,Germany,DEU,0,0,5,0,5
2003,Uzbekistan,UZB,Germany,DEU,0,0,49,16,65
2003,Yemen,YEM,Germany,DEU,10,0,45,5,60
2003,Zimbabwe,ZWE,Germany,DEU,0,0,43,0,43
2003,Stateless,XXA,Germany,DEU,5,0,81,0,86
2003,Unknown ,,Germany,DEU,21,13,2027,117,2178
2004,Afghanistan,AFG,Germany,DEU,46,232,1883,174,2335
2004,Albania,ALB,Germany,DEU,0,5,183,22,210
2004,Algeria,DZA,Germany,DEU,0,0,792,90,882
2004,Angola,AGO,Germany,DEU,0,28,212,12,252
2004,Egypt,EGY,Germany,DEU,5,0,51,5,61
2004,Armenia,ARM,Germany,DEU,5,5,568,181,759
2004,Azerbaijan,AZE,Germany,DEU,43,13,1310,114,1480
2004,Burundi,BDI,Germany,DEU,5,0,27,5,37
2004,Benin,BEN,Germany,DEU,0,0,45,5,50
2004,Bangladesh,BGD,Germany,DEU,0,5,99,26,130
2004,Bhutan,BTN,Germany,DEU,0,0,12,0,12
2004,Burkina Faso,BFA,Germany,DEU,0,0,47,0,47
2004,Belarus,BLR,Germany,DEU,5,0,311,71,387
2004,Bosnia and Herzegovina,BIH,Germany,DEU,0,10,387,123,520
2004,Bulgaria,BGR,Germany,DEU,0,0,334,148,482
2004,Cambodia,KHM,Germany,DEU,0,0,45,0,45
2004,Chad,TCD,Germany,DEU,0,0,12,0,12
2004,China,CHN,Germany,DEU,40,0,1350,61,1451
2004,Cameroon,CMR,Germany,DEU,0,13,585,14,612
2004,Congo,COG,Germany,DEU,0,0,30,5,35
2004,Dem. Rep. of the Congo,COD,Germany,DEU,15,26,489,18,548
2004,Colombia,COL,Germany,DEU,5,0,32,5,42
2004,Cuba,CUB,Germany,DEU,0,0,40,5,45
2004,Czechia,CZE,Germany,DEU,0,0,17,5,22
2004,Ecuador,ECU,Germany,DEU,0,0,20,5,25
2004,Eritrea,ERI,Germany,DEU,18,22,451,82,573
2004,Estonia,EST,Germany,DEU,0,0,10,0,10
2004,Ethiopia,ETH,Germany,DEU,10,13,279,12,314
2004,Gabon,GAB,Germany,DEU,0,0,5,0,5
2004,Gambia,GMB,Germany,DEU,0,0,60,5,65
2004,Georgia,GEO,Germany,DEU,5,0,613,350,968
2004,Ghana,GHA,Germany,DEU,0,0,405,19,424
2004,Guinea-Bissau,GNB,Germany,DEU,0,0,23,0,23
2004,Guinea,GIN,Germany,DEU,12,0,354,25,391
2004,Haiti,HTI,Germany,DEU,0,5,5,0,10
2004,Croatia,HRV,Germany,DEU,0,0,15,5,20
2004,Hungary,HUN,Germany,DEU,0,0,10,10,20
2004,Cote d'Ivoire,CIV,Germany,DEU,0,0,190,10,200
2004,India,IND,Germany,DEU,0,0,1116,163,1279
2004,Indonesia,IDN,Germany,DEU,0,0,10,0,10
2004,Iran (Islamic Rep. of),IRN,Germany,DEU,213,19,1639,180,2051
2004,Iraq,IRQ,Germany,DEU,38,46,3319,373,3776
2004,Israel,ISR,Germany,DEU,0,0,39,5,44
2004,Jamaica,JAM,Germany,DEU,0,0,5,0,5
2004,Jordan,JOR,Germany,DEU,0,0,38,10,48
2004,Kazakhstan,KAZ,Germany,DEU,0,0,56,20,76
2004,Kenya,KEN,Germany,DEU,0,0,43,0,43
2004,Kyrgyzstan,KGZ,Germany,DEU,0,0,22,5,27
2004,Dem. People's Rep. of Korea,PRK,Germany,DEU,0,0,10,0,10
2004,Kuwait,KWT,Germany,DEU,0,0,10,0,10
2004,Lao People's Dem. Rep.,LAO,Germany,DEU,0,0,5,0,5
2004,Liberia,LBR,Germany,DEU,0,0,341,31,372
2004,Libya,LBY,Germany,DEU,5,0,74,11,90
2004,Lebanon,LBN,Germany,DEU,5,0,367,66,438
2004,Sri Lanka,LKA,Germany,DEU,5,5,220,26,256
2004,Lithuania,LTU,Germany,DEU,0,0,26,0,26
2004,Latvia,LVA,Germany,DEU,0,0,15,5,20
2004,Mauritania,MRT,Germany,DEU,5,0,23,5,33
2004,North Macedonia,MKD,Germany,DEU,0,0,178,62,240
2004,Rep. of Moldova,MDA,Germany,DEU,0,0,114,23,137
2004,Mexico,MEX,Germany,DEU,0,0,5,0,5
2004,Mali,MLI,Germany,DEU,0,0,42,13,55
2004,Mongolia,MNG,Germany,DEU,0,0,54,10,64
2004,Morocco,MAR,Germany,DEU,0,0,250,27,277
2004,Mozambique,MOZ,Germany,DEU,0,0,5,0,5
2004,Myanmar,MMR,Germany,DEU,11,0,66,5,82
2004,Nepal,NPL,Germany,DEU,5,0,128,13,146
2004,Netherlands,NLD,Germany,DEU,0,0,5,0,5
2004,Niger,NER,Germany,DEU,0,0,75,5,80
2004,Nigeria,NGA,Germany,DEU,0,10,1324,53,1387
2004,Pakistan,PAK,Germany,DEU,42,0,1147,94,1283
2004,Peru,PER,Germany,DEU,0,0,5,5,10
2004,Philippines,PHL,Germany,DEU,0,0,5,0,5
2004,Poland,POL,Germany,DEU,0,0,25,5,30
2004,Romania,ROU,Germany,DEU,0,0,47,13,60
2004,Russian Federation,RUS,Germany,DEU,524,107,1753,839,3223
2004,Rwanda,RWA,Germany,DEU,13,0,21,5,39
2004,Serbia and Kosovo: S/RES/1244 (1999),SRB,Germany,DEU,5,51,3778,507,4341
2004,Senegal,SEN,Germany,DEU,0,0,16,0,16
2004,Sierra Leone,SLE,Germany,DEU,0,5,182,22,209
2004,Somalia,SOM,Germany,DEU,0,53,119,74,246
2004,Spain,ESP,Germany,DEU,0,0,5,0,5
2004,Viet Nam,VNM,Germany,DEU,0,29,1738,68,1835
2004,Sudan,SDN,Germany,DEU,5,5,265,31,306
2004,Slovakia,SVK,Germany,DEU,0,0,224,139,363
2004,Syrian Arab Rep.,SYR,Germany,DEU,79,10,830,137,1056
2004,United Rep. of Tanzania,TZA,Germany,DEU,0,0,28,0,28
2004,Thailand,THA,Germany,DEU,0,0,5,0,5
2004,Tajikistan,TJK,Germany,DEU,0,0,18,5,23
2004,Turkmenistan,TKM,Germany,DEU,0,5,19,0,24
2004,Togo,TGO,Germany,DEU,40,0,421,12,473
2004,Tunisia,TUN,Germany,DEU,5,0,103,14,122
2004,Turkey,TUR,Germany,DEU,499,32,4129,434,5094
2004,Uganda,UGA,Germany,DEU,0,5,98,5,108
2004,Ukraine,UKR,Germany,DEU,0,0,170,58,228
2004,Uzbekistan,UZB,Germany,DEU,0,0,30,11,41
2004,Yemen,YEM,Germany,DEU,0,0,36,5,41
2004,Zimbabwe,ZWE,Germany,DEU,0,0,55,5,60
2004,Stateless,XXA,Germany,DEU,0,0,38,10,48
2004,Unknown ,,Germany,DEU,34,5,1652,218,1909
2005,Afghanistan,AFG,Germany,DEU,29,71,680,66,846
2005,Albania,ALB,Germany,DEU,0,0,113,20,133
2005,Algeria,DZA,Germany,DEU,5,0,437,49,491
2005,Angola,AGO,Germany,DEU,5,18,124,11,158
2005,Egypt,EGY,Germany,DEU,5,0,47,10,62
2005,Armenia,ARM,Germany,DEU,5,10,528,60,603
2005,Azerbaijan,AZE,Germany,DEU,54,13,861,83,1011
2005,Burundi,BDI,Germany,DEU,0,0,24,0,24
2005,Benin,BEN,Germany,DEU,0,0,28,0,28
2005,Bangladesh,BGD,Germany,DEU,0,0,69,13,82
2005,Burkina Faso,BFA,Germany,DEU,0,0,35,0,35
2005,Belarus,BLR,Germany,DEU,5,0,145,36,186
2005,Brazil,BRA,Germany,DEU,0,0,5,0,5
2005,Bosnia and Herzegovina,BIH,Germany,DEU,0,11,308,55,374
2005,Bulgaria,BGR,Germany,DEU,0,0,266,47,313
2005,Cambodia,KHM,Germany,DEU,0,0,19,0,19
2005,China,CHN,Germany,DEU,17,0,605,47,669
2005,Cameroon,CMR,Germany,DEU,5,5,383,15,408
2005,Congo,COG,Germany,DEU,5,0,32,11,48
2005,Dem. Rep. of the Congo,COD,Germany,DEU,17,22,347,31,417
2005,Colombia,COL,Germany,DEU,5,0,21,0,26
2005,Cuba,CUB,Germany,DEU,5,0,22,5,32
2005,Czechia,CZE,Germany,DEU,0,0,16,0,16
2005,Dominican Rep.,DOM,Germany,DEU,0,0,5,0,5
2005,Ecuador,ECU,Germany,DEU,0,0,10,5,15
2005,Eritrea,ERI,Germany,DEU,31,11,308,30,380
2005,Ethiopia,ETH,Germany,DEU,20,10,164,14,208
2005,Gambia,GMB,Germany,DEU,0,0,97,5,102
2005,Georgia,GEO,Germany,DEU,0,0,342,175,517
2005,Ghana,GHA,Germany,DEU,0,0,430,21,451
2005,Guinea-Bissau,GNB,Germany,DEU,0,5,15,5,25
2005,Guinea,GIN,Germany,DEU,5,0,220,24,249
2005,Haiti,HTI,Germany,DEU,0,0,10,5,15
2005,Croatia,HRV,Germany,DEU,0,0,32,5,37
2005,Hungary,HUN,Germany,DEU,0,0,5,0,5
2005,Cote d'Ivoire,CIV,Germany,DEU,0,0,126,10,136
2005,India,IND,Germany,DEU,0,0,550,74,624
2005,Indonesia,IDN,Germany,DEU,0,0,5,0,5
2005,Iran (Islamic Rep. of),IRN,Germany,DEU,167,5,871,88,1131
2005,Iraq,IRQ,Germany,DEU,54,12,1591,191,1848
2005,Israel,ISR,Germany,DEU,0,0,23,11,34
2005,Italy,ITA,Germany,DEU,0,0,5,0,5
2005,Jordan,JOR,Germany,DEU,0,0,36,11,47
2005,Kazakhstan,KAZ,Germany,DEU,0,0,31,15,46
2005,Kenya,KEN,Germany,DEU,0,0,40,0,40
2005,Kyrgyzstan,KGZ,Germany,DEU,0,0,25,5,30
2005,Dem. People's Rep. of Korea,PRK,Germany,DEU,0,0,17,0,17
2005,Liberia,LBR,Germany,DEU,0,0,97,13,110
2005,Libya,LBY,Germany,DEU,5,0,53,5,63
2005,Lebanon,LBN,Germany,DEU,5,0,436,72,513
2005,Sri Lanka,LKA,Germany,DEU,5,0,189,28,222
2005,Lithuania,LTU,Germany,DEU,0,0,5,0,5
2005,Latvia,LVA,Germany,DEU,0,0,0,5,5
2005,Mauritania,MRT,Germany,DEU,0,0,5,0,5
2005,North Macedonia,MKD,Germany,DEU,0,0,160,38,198
2005,Rep. of Moldova,MDA,Germany,DEU,0,0,73,21,94
2005,Mali,MLI,Germany,DEU,0,0,21,10,31
2005,Malaysia,MYS,Germany,DEU,0,0,5,0,5
2005,Mongolia,MNG,Germany,DEU,0,0,46,14,60
2005,Morocco,MAR,Germany,DEU,0,0,157,29,186
2005,Mozambique,MOZ,Germany,DEU,0,0,5,0,5
2005,Myanmar,MMR,Germany,DEU,11,0,18,0,29
2005,Nepal,NPL,Germany,DEU,5,0,68,10,83
2005,Niger,NER,Germany,DEU,0,5,38,5,48
2005,Nigeria,NGA,Germany,DEU,0,5,855,54,914
2005,Pakistan,PAK,Germany,DEU,26,0,575,65,666
2005,Peru,PER,Germany,DEU,0,0,5,0,5
2005,Poland,POL,Germany,DEU,0,0,15,0,15
2005,Romania,ROU,Germany,DEU,0,0,55,10,65
2005,Russian Federation,RUS,Germany,DEU,274,80,2018,773,3145
2005,Rwanda,RWA,Germany,DEU,5,0,28,5,38
2005,Serbia and Kosovo: S/RES/1244 (1999),SRB,Germany,DEU,11,46,4634,784,5475
2005,Senegal,SEN,Germany,DEU,0,0,10,0,10
2005,Sierra Leone,SLE,Germany,DEU,5,0,120,10,135
2005,Somalia,SOM,Germany,DEU,5,47,97,33,182
2005,Viet Nam,VNM,Germany,DEU,10,5,1166,121,1302
2005,Sudan,SDN,Germany,DEU,10,0,247,22,279
2005,Suriname,SUR,Germany,DEU,0,0,0,5,5
2005,Slovakia,SVK,Germany,DEU,0,0,60,5,65
2005,Syrian Arab Rep.,SYR,Germany,DEU,77,0,751,121,949
2005,Tajikistan,TJK,Germany,DEU,0,0,5,0,5
2005,Turkmenistan,TKM,Germany,DEU,0,0,10,0,10
2005,Togo,TGO,Germany,DEU,40,5,264,49,358
2005,Tunisia,TUN,Germany,DEU,5,0,95,11,111
2005,Turkey,TUR,Germany,DEU,328,17,2806,341,3492
2005,Uganda,UGA,Germany,DEU,0,0,53,5,58
2005,Ukraine,UKR,Germany,DEU,0,5,125,45,175
2005,Uzbekistan,UZB,Germany,DEU,0,0,21,16,37
2005,Yemen,YEM,Germany,DEU,12,0,40,5,57
2005,Zimbabwe,ZWE,Germany,DEU,0,5,53,5,63
2005,Stateless,XXA,Germany,DEU,5,0,53,17,75
2005,Unknown ,,Germany,DEU,24,0,1322,140,1486
2006,Afghanistan,AFG,Germany,DEU,43,69,379,45,536
2006,Albania,ALB,Germany,DEU,0,0,85,15,100
2006,Algeria,DZA,Germany,DEU,0,0,305,56,361
2006,Angola,AGO,Germany,DEU,0,11,88,18,117
2006,Egypt,EGY,Germany,DEU,5,0,54,5,64
2006,Armenia,ARM,Germany,DEU,0,0,340,48,388
2006,Azerbaijan,AZE,Germany,DEU,19,5,456,52,532
2006,Burundi,BDI,Germany,DEU,0,0,12,0,12
2006,Benin,BEN,Germany,DEU,0,0,24,0,24
2006,Bangladesh,BGD,Germany,DEU,5,0,78,10,93
2006,Bhutan,BTN,Germany,DEU,0,0,10,0,10
2006,Burkina Faso,BFA,Germany,DEU,0,0,18,0,18
2006,Belarus,BLR,Germany,DEU,5,0,87,19,111
2006,Bosnia and Herzegovina,BIH,Germany,DEU,0,0,181,41,222
2006,Bulgaria,BGR,Germany,DEU,0,0,110,43,153
2006,Cambodia,KHM,Germany,DEU,0,0,10,0,10
2006,Chad,TCD,Germany,DEU,5,0,0,0,5
2006,China,CHN,Germany,DEU,17,5,381,29,432
2006,Cameroon,CMR,Germany,DEU,5,10,225,17,257
2006,Congo,COG,Germany,DEU,0,0,17,0,17
2006,Dem. Rep. of the Congo,COD,Germany,DEU,10,16,198,44,268
2006,Colombia,COL,Germany,DEU,0,0,70,5,75
2006,Cuba,CUB,Germany,DEU,5,0,70,10,85
2006,Czechia,CZE,Germany,DEU,0,0,10,5,15
2006,Ecuador,ECU,Germany,DEU,0,0,5,0,5
2006,Eritrea,ERI,Germany,DEU,79,25,190,19,313
2006,Ethiopia,ETH,Germany,DEU,10,0,111,17,138
2006,Gabon,GAB,Germany,DEU,0,0,5,0,5
2006,Gambia,GMB,Germany,DEU,0,0,47,5,52
2006,Georgia,GEO,Germany,DEU,0,0,214,81,295
2006,Ghana,GHA,Germany,DEU,0,0,389,23,412
2006,Guinea-Bissau,GNB,Germany,DEU,0,0,11,5,16
2006,Guinea,GIN,Germany,DEU,11,0,84,5,100
2006,Croatia,HRV,Germany,DEU,0,0,14,10,24
2006,Hungary,HUN,Germany,DEU,0,0,0,5,5
2006,Cote d'Ivoire,CIV,Germany,DEU,5,0,64,5,74
2006,India,IND,Germany,DEU,0,0,476,57,533
2006,Indonesia,IDN,Germany,DEU,0,0,0,5,5
2006,Iran (Islamic Rep. of),IRN,Germany,DEU,82,5,463,72,622
2006,Iraq,IRQ,Germany,DEU,123,17,1528,263,1931
2006,Israel,ISR,Germany,DEU,0,0,24,15,39
2006,Jordan,JOR,Germany,DEU,0,0,20,13,33
2006,Kazakhstan,KAZ,Germany,DEU,0,0,11,12,23
2006,Kenya,KEN,Germany,DEU,0,0,41,5,46
2006,Kyrgyzstan,KGZ,Germany,DEU,0,0,13,5,18
2006,Dem. People's Rep. of Korea,PRK,Germany,DEU,0,0,5,0,5
2006,Kuwait,KWT,Germany,DEU,0,0,5,0,5
2006,Liberia,LBR,Germany,DEU,0,0,26,5,31
2006,Libya,LBY,Germany,DEU,5,0,16,5,26
2006,Lebanon,LBN,Germany,DEU,0,0,466,81,547
2006,Sri Lanka,LKA,Germany,DEU,5,0,132,26,163
2006,Lithuania,LTU,Germany,DEU,0,0,5,0,5
2006,Latvia,LVA,Germany,DEU,0,0,5,0,5
2006,Mauritania,MRT,Germany,DEU,0,0,5,0,5
2006,North Macedonia,MKD,Germany,DEU,0,0,117,25,142
2006,Rep. of Moldova,MDA,Germany,DEU,0,0,35,19,54
2006,Mali,MLI,Germany,DEU,0,0,20,0,20
2006,Mongolia,MNG,Germany,DEU,0,0,27,18,45
2006,Morocco,MAR,Germany,DEU,0,0,151,33,184
2006,Montenegro,MNE,Germany,DEU,0,0,33,5,38
2006,Myanmar,MMR,Germany,DEU,130,0,0,0,130
2006,Nepal,NPL,Germany,DEU,0,0,46,5,51
2006,Niger,NER,Germany,DEU,0,0,23,5,28
2006,Nigeria,NGA,Germany,DEU,0,5,445,49,499
2006,Pakistan,PAK,Germany,DEU,14,5,369,48,436
2006,Peru,PER,Germany,DEU,0,0,5,0,5
2006,Philippines,PHL,Germany,DEU,0,0,5,0,5
2006,Romania,ROU,Germany,DEU,0,0,36,24,60
2006,Russian Federation,RUS,Germany,DEU,115,19,705,282,1121
2006,Rwanda,RWA,Germany,DEU,5,5,21,0,31
2006,Serbia and Kosovo: S/RES/1244 (1999),SRB,Germany,DEU,5,51,2842,590,3488
2006,Senegal,SEN,Germany,DEU,0,0,10,0,10
2006,Sierra Leone,SLE,Germany,DEU,5,5,79,5,94
2006,Somalia,SOM,Germany,DEU,21,14,83,28,146
2006,Viet Nam,VNM,Germany,DEU,0,0,954,71,1025
2006,Sudan,SDN,Germany,DEU,5,0,50,5,60
2006,Slovakia,SVK,Germany,DEU,0,0,148,33,181
2006,Syrian Arab Rep.,SYR,Germany,DEU,69,5,568,110,752
2006,United Rep. of Tanzania,TZA,Germany,DEU,0,0,5,0,5
2006,Tajikistan,TJK,Germany,DEU,0,0,5,0,5
2006,Turkmenistan,TKM,Germany,DEU,0,0,5,0,5
2006,Togo,TGO,Germany,DEU,22,5,117,27,171
2006,Tunisia,TUN,Germany,DEU,0,0,86,16,102
2006,Turkey,TUR,Germany,DEU,102,5,1703,256,2066
2006,Uganda,UGA,Germany,DEU,5,0,12,5,22
2006,Ukraine,UKR,Germany,DEU,0,0,72,32,104
2006,Uzbekistan,UZB,Germany,DEU,5,0,20,10,35
2006,Yemen,YEM,Germany,DEU,0,0,52,11,63
2006,Zimbabwe,ZWE,Germany,DEU,0,0,17,0,17
2006,Stateless,XXA,Germany,DEU,0,0,21,5,26
2006,Unknown ,,Germany,DEU,10,5,953,136,1104
2007,Afghanistan,AFG,Germany,DEU,34,69,222,52,377
2007,Albania,ALB,Germany,DEU,0,5,68,20,93
2007,Algeria,DZA,Germany,DEU,5,0,308,40,353
2007,Angola,AGO,Germany,DEU,0,18,52,19,89
2007,Egypt,EGY,Germany,DEU,0,0,45,10,55
2007,Armenia,ARM,Germany,DEU,0,0,181,46,227
2007,Azerbaijan,AZE,Germany,DEU,22,5,234,37,298
2007,Burundi,BDI,Germany,DEU,0,0,10,0,10
2007,Benin,BEN,Germany,DEU,0,0,16,0,16
2007,Bangladesh,BGD,Germany,DEU,0,5,79,0,84
2007,Burkina Faso,BFA,Germany,DEU,0,0,25,0,25
2007,Belarus,BLR,Germany,DEU,10,0,39,13,62
2007,Brazil,BRA,Germany,DEU,0,0,0,5,5
2007,Bosnia and Herzegovina,BIH,Germany,DEU,0,0,90,27,117
2007,Bulgaria,BGR,Germany,DEU,0,0,20,5,25
2007,Cambodia,KHM,Germany,DEU,0,0,5,0,5
2007,China,CHN,Germany,DEU,33,0,261,30,324
2007,Chile,CHL,Germany,DEU,0,0,5,0,5
2007,Cameroon,CMR,Germany,DEU,5,5,127,18,155
2007,Congo,COG,Germany,DEU,0,0,5,5,10
2007,Dem. Rep. of the Congo,COD,Germany,DEU,5,11,94,37,147
2007,Colombia,COL,Germany,DEU,0,0,165,12,177
2007,Cuba,CUB,Germany,DEU,5,0,47,5,57
2007,Czechia,CZE,Germany,DEU,0,0,21,0,21
2007,Ecuador,ECU,Germany,DEU,0,0,10,0,10
2007,Eritrea,ERI,Germany,DEU,109,29,127,33,298
2007,Ethiopia,ETH,Germany,DEU,27,5,132,16,180
2007,Gambia,GMB,Germany,DEU,0,0,57,10,67
2007,Georgia,GEO,Germany,DEU,0,0,190,53,243
2007,Ghana,GHA,Germany,DEU,0,0,220,17,237
2007,Guinea-Bissau,GNB,Germany,DEU,0,0,11,5,16
2007,Guinea,GIN,Germany,DEU,10,0,117,12,139
2007,Croatia,HRV,Germany,DEU,0,0,12,10,22
2007,Hungary,HUN,Germany,DEU,0,0,0,5,5
2007,Cote d'Ivoire,CIV,Germany,DEU,0,5,52,5,62
2007,India,IND,Germany,DEU,0,0,403,25,428
2007,Indonesia,IDN,Germany,DEU,0,0,5,0,5
2007,Iran (Islamic Rep. of),IRN,Germany,DEU,133,10,385,80,608
2007,Iraq,IRQ,Germany,DEU,1766,22,996,349,3133
2007,Israel,ISR,Germany,DEU,0,0,31,5,36
2007,Jordan,JOR,Germany,DEU,0,0,19,13,32
2007,Kazakhstan,KAZ,Germany,DEU,0,0,10,0,10
2007,Kenya,KEN,Germany,DEU,5,0,57,5,67
2007,Kyrgyzstan,KGZ,Germany,DEU,0,0,10,5,15
2007,Liberia,LBR,Germany,DEU,0,0,12,0,12
2007,Libya,LBY,Germany,DEU,5,0,12,10,27
2007,Lebanon,LBN,Germany,DEU,5,0,502,84,591
2007,Sri Lanka,LKA,Germany,DEU,39,26,73,28,166
2007,Lithuania,LTU,Germany,DEU,0,0,5,0,5
2007,Latvia,LVA,Germany,DEU,0,0,0,5,5
2007,North Macedonia,MKD,Germany,DEU,0,0,82,21,103
2007,Rep. of Moldova,MDA,Germany,DEU,0,0,27,5,32
2007,Mali,MLI,Germany,DEU,0,0,14,5,19
2007,Mongolia,MNG,Germany,DEU,0,0,22,20,42
2007,Morocco,MAR,Germany,DEU,5,5,149,30,189
2007,Montenegro,MNE,Germany,DEU,0,0,53,21,74
2007,Myanmar,MMR,Germany,DEU,97,0,34,0,131
2007,Nepal,NPL,Germany,DEU,0,0,19,0,19
2007,Niger,NER,Germany,DEU,0,0,15,0,15
2007,Nigeria,NGA,Germany,DEU,10,5,441,69,525
2007,Pakistan,PAK,Germany,DEU,12,0,255,35,302
2007,Philippines,PHL,Germany,DEU,0,0,5,0,5
2007,Poland,POL,Germany,DEU,0,0,5,0,5
2007,Romania,ROU,Germany,DEU,0,0,10,0,10
2007,Russian Federation,RUS,Germany,DEU,113,20,560,178,871
2007,Rwanda,RWA,Germany,DEU,0,0,10,0,10
2007,Serbia and Kosovo: S/RES/1244 (1999),SRB,Germany,DEU,10,21,1531,453,2015
2007,Senegal,SEN,Germany,DEU,0,0,13,5,18
2007,Sierra Leone,SLE,Germany,DEU,10,0,57,11,78
2007,Somalia,SOM,Germany,DEU,51,34,34,14,133
2007,Viet Nam,VNM,Germany,DEU,0,5,844,61,910
2007,Sudan,SDN,Germany,DEU,13,0,35,10,58
2007,Slovakia,SVK,Germany,DEU,0,0,176,43,219
2007,Syrian Arab Rep.,SYR,Germany,DEU,63,0,409,89,561
2007,Tajikistan,TJK,Germany,DEU,0,0,5,0,5
2007,Togo,TGO,Germany,DEU,10,0,64,19,93
2007,Tunisia,TUN,Germany,DEU,0,0,76,24,100
2007,Turkey,TUR,Germany,DEU,73,10,1184,224,1491
2007,Uganda,UGA,Germany,DEU,0,0,16,5,21
2007,Ukraine,UKR,Germany,DEU,0,0,50,19,69
2007,Uzbekistan,UZB,Germany,DEU,0,0,10,0,10
2007,Venezuela (Bolivarian Republic of),VEN,Germany,DEU,0,0,5,0,5
2007,Yemen,YEM,Germany,DEU,5,0,17,0,22
2007,Zimbabwe,ZWE,Germany,DEU,0,0,21,0,21
2007,Stateless,XXA,Germany,DEU,0,5,15,10,30
2007,Unknown ,,Germany,DEU,32,0,572,131,735
2008,Afghanistan,AFG,Germany,DEU,46,51,64,73,234
2008,Albania,ALB,Germany,DEU,0,5,28,19,52
2008,Algeria,DZA,Germany,DEU,0,0,260,90,350
2008,Angola,AGO,Germany,DEU,5,11,13,5,34
2008,Egypt,EGY,Germany,DEU,0,0,21,13,34
2008,Argentina,ARG,Germany,DEU,0,0,5,0,5
2008,Armenia,ARM,Germany,DEU,5,13,101,33,152
2008,Azerbaijan,AZE,Germany,DEU,27,0,87,25,139
2008,Burundi,BDI,Germany,DEU,0,0,5,0,5
2008,Benin,BEN,Germany,DEU,0,0,30,0,30
2008,Bangladesh,BGD,Germany,DEU,0,0,29,5,34
2008,Burkina Faso,BFA,Germany,DEU,0,0,11,5,16
2008,Belarus,BLR,Germany,DEU,5,0,23,13,41
2008,Bosnia and Herzegovina,BIH,Germany,DEU,0,5,46,23,74
2008,Bulgaria,BGR,Germany,DEU,0,0,10,0,10
2008,Chad,TCD,Germany,DEU,0,0,0,5,5
2008,China,CHN,Germany,DEU,27,5,93,22,147
2008,Cameroon,CMR,Germany,DEU,10,0,48,27,85
2008,Dem. Rep. of the Congo,COD,Germany,DEU,5,13,31,34,83
2008,Colombia,COL,Germany,DEU,0,0,5,5,10
2008,Cuba,CUB,Germany,DEU,5,0,5,10,20
2008,Dominican Rep.,DOM,Germany,DEU,0,0,5,0,5
2008,Eritrea,ERI,Germany,DEU,150,15,41,39,245
2008,Ethiopia,ETH,Germany,DEU,32,0,98,17,147
2008,Gambia,GMB,Germany,DEU,10,0,43,5,58
2008,Georgia,GEO,Germany,DEU,0,0,85,52,137
2008,Ghana,GHA,Germany,DEU,0,0,121,27,148
2008,Guinea-Bissau,GNB,Germany,DEU,0,0,5,5,10
2008,Guinea,GIN,Germany,DEU,5,5,72,15,97
2008,Croatia,HRV,Germany,DEU,0,0,10,0,10
2008,Cote d'Ivoire,CIV,Germany,DEU,5,0,31,10,46
2008,India,IND,Germany,DEU,0,0,242,41,283
2008,Iran (Islamic Rep. of),IRN,Germany,DEU,94,5,240,84,423
2008,Iraq,IRQ,Germany,DEU,4875,20,460,550,5905
2008,Israel,ISR,Germany,DEU,0,0,5,5,10
2008,Jamaica,JAM,Germany,DEU,0,0,5,0,5
2008,Jordan,JOR,Germany,DEU,0,0,10,5,15
2008,Kazakhstan,KAZ,Germany,DEU,0,0,5,0,5
2008,Kenya,KEN,Germany,DEU,0,5,24,10,39
2008,Kyrgyzstan,KGZ,Germany,DEU,0,0,5,0,5
2008,Liberia,LBR,Germany,DEU,0,0,5,0,5
2008,Libya,LBY,Germany,DEU,0,0,5,5,10
2008,Lebanon,LBN,Germany,DEU,10,0,260,70,340
2008,Sri Lanka,LKA,Germany,DEU,92,88,106,70,356
2008,North Macedonia,MKD,Germany,DEU,0,0,31,17,48
2008,Rep. of Moldova,MDA,Germany,DEU,0,0,13,10,23
2008,Mali,MLI,Germany,DEU,0,0,5,0,5
2008,Mongolia,MNG,Germany,DEU,0,0,5,11,16
2008,Morocco,MAR,Germany,DEU,0,0,82,39,121
2008,Montenegro,MNE,Germany,DEU,0,0,20,5,25
2008,Myanmar,MMR,Germany,DEU,72,0,5,0,77
2008,Nepal,NPL,Germany,DEU,0,0,10,0,10
2008,Niger,NER,Germany,DEU,0,0,5,0,5
2008,Nigeria,NGA,Germany,DEU,10,0,229,66,305
2008,Pakistan,PAK,Germany,DEU,12,0,139,44,195
2008,Russian Federation,RUS,Germany,DEU,104,5,250,251,610
2008,Rwanda,RWA,Germany,DEU,0,0,5,5,10
2008,Saudi Arabia,SAU,Germany,DEU,0,0,0,5,5
2008,Serbia and Kosovo: S/RES/1244 (1999),SRB,Germany,DEU,5,16,672,429,1122
2008,Senegal,SEN,Germany,DEU,0,0,5,0,5
2008,Sierra Leone,SLE,Germany,DEU,5,5,33,10,53
2008,Somalia,SOM,Germany,DEU,68,28,13,16,125
2008,Viet Nam,VNM,Germany,DEU,5,0,821,81,907
2008,Sudan,SDN,Germany,DEU,0,0,14,5,19
2008,Slovakia,SVK,Germany,DEU,0,0,18,0,18
2008,Syrian Arab Rep.,SYR,Germany,DEU,68,5,280,122,475
2008,Thailand,THA,Germany,DEU,0,0,5,0,5
2008,Togo,TGO,Germany,DEU,10,5,25,21,61
2008,Tunisia,TUN,Germany,DEU,0,5,36,26,67
2008,Turkey,TUR,Germany,DEU,75,5,637,222,939
2008,Uganda,UGA,Germany,DEU,0,0,18,5,23
2008,Ukraine,UKR,Germany,DEU,5,0,18,15,38
2008,Uzbekistan,UZB,Germany,DEU,0,0,0,5,5
2008,Yemen,YEM,Germany,DEU,5,0,0,0,5
2008,Zimbabwe,ZWE,Germany,DEU,0,0,5,5,10
2008,Stateless,XXA,Germany,DEU,0,0,10,5,15
2008,Unknown ,,Germany,DEU,33,5,351,98,487
2009,Afghanistan,AFG,Germany,DEU,256,608,417,163,1444
2009,Albania,ALB,Germany,DEU,5,5,35,12,57
2009,Algeria,DZA,Germany,DEU,0,0,343,114,457
2009,Angola,AGO,Germany,DEU,0,10,37,13,60
2009,Egypt,EGY,Germany,DEU,10,5,34,18,67
2009,Armenia,ARM,Germany,DEU,5,10,116,51,182
2009,Azerbaijan,AZE,Germany,DEU,16,10,205,71,302
2009,Burundi,BDI,Germany,DEU,0,0,5,0,5
2009,Benin,BEN,Germany,DEU,0,0,57,0,57
2009,Bangladesh,BGD,Germany,DEU,0,0,32,5,37
2009,Burkina Faso,BFA,Germany,DEU,0,0,32,0,32
2009,Belarus,BLR,Germany,DEU,0,0,27,13,40
2009,Bosnia and Herzegovina,BIH,Germany,DEU,0,10,100,43,153
2009,Bulgaria,BGR,Germany,DEU,0,0,5,0,5
2009,Cambodia,KHM,Germany,DEU,0,0,10,0,10
2009,Chad,TCD,Germany,DEU,5,0,5,0,10
2009,China,CHN,Germany,DEU,31,5,201,17,254
2009,Cameroon,CMR,Germany,DEU,5,10,60,29,104
2009,Congo,COG,Germany,DEU,0,0,5,5,10
2009,Dem. Rep. of the Congo,COD,Germany,DEU,12,31,63,22,128
2009,Colombia,COL,Germany,DEU,5,0,21,0,26
2009,Cuba,CUB,Germany,DEU,5,0,13,11,29
2009,Ecuador,ECU,Germany,DEU,0,0,5,0,5
2009,Eritrea,ERI,Germany,DEU,325,52,19,21,417
2009,Ethiopia,ETH,Germany,DEU,62,13,71,15,161
2009,Gabon,GAB,Germany,DEU,0,0,5,0,5
2009,Gambia,GMB,Germany,DEU,5,0,57,23,85
2009,Georgia,GEO,Germany,DEU,10,0,207,155,372
2009,Ghana,GHA,Germany,DEU,0,0,135,30,165
2009,Guinea-Bissau,GNB,Germany,DEU,0,0,15,5,20
2009,Guinea,GIN,Germany,DEU,15,5,139,13,172
2009,Croatia,HRV,Germany,DEU,0,0,12,5,17
2009,Hungary,HUN,Germany,DEU,0,0,5,0,5
2009,Cote d'Ivoire,CIV,Germany,DEU,11,5,36,5,57
2009,India,IND,Germany,DEU,0,5,515,44,564
2009,Iran (Islamic Rep. of),IRN,Germany,DEU,320,10,306,119,755
2009,Iraq,IRQ,Germany,DEU,5087,101,1593,502,7283
2009,Israel,ISR,Germany,DEU,0,0,10,5,15
2009,Jordan,JOR,Germany,DEU,0,0,14,10,24
2009,Kazakhstan,KAZ,Germany,DEU,0,0,5,0,5
2009,Kenya,KEN,Germany,DEU,0,5,37,16,58
2009,Liberia,LBR,Germany,DEU,0,0,5,5,10
2009,Libya,LBY,Germany,DEU,5,0,20,10,35
2009,Lebanon,LBN,Germany,DEU,10,0,425,108,543
2009,Sri Lanka,LKA,Germany,DEU,247,165,71,43,526
2009,Lithuania,LTU,Germany,DEU,0,0,5,0,5
2009,Latvia,LVA,Germany,DEU,0,0,10,0,10
2009,North Macedonia,MKD,Germany,DEU,5,0,35,33,73
2009,Rep. of Moldova,MDA,Germany,DEU,0,0,10,5,15
2009,Mexico,MEX,Germany,DEU,0,0,0,5,5
2009,Mali,MLI,Germany,DEU,0,0,5,0,5
2009,Mongolia,MNG,Germany,DEU,0,0,5,11,16
2009,Morocco,MAR,Germany,DEU,5,0,166,57,228
2009,Montenegro,MNE,Germany,DEU,0,0,39,16,55
2009,Myanmar,MMR,Germany,DEU,47,0,13,5,65
2009,Nepal,NPL,Germany,DEU,0,0,18,5,23
2009,Netherlands,NLD,Germany,DEU,0,0,5,0,5
2009,Niger,NER,Germany,DEU,0,0,11,5,16
2009,Nigeria,NGA,Germany,DEU,5,10,361,127,503
2009,Pakistan,PAK,Germany,DEU,31,5,191,45,272
2009,Russian Federation,RUS,Germany,DEU,114,12,318,200,644
2009,Rwanda,RWA,Germany,DEU,10,0,14,0,24
2009,Serbia and Kosovo: S/RES/1244 (1999),SRB,Germany,DEU,10,46,1116,551,1723
2009,Senegal,SEN,Germany,DEU,0,0,5,5,10
2009,Sierra Leone,SLE,Germany,DEU,5,12,43,10,70
2009,Somalia,SOM,Germany,DEU,121,41,12,29,203
2009,Viet Nam,VNM,Germany,DEU,5,5,1088,87,1185
2009,Sudan,SDN,Germany,DEU,10,5,13,11,39
2009,Slovakia,SVK,Germany,DEU,0,0,5,0,5
2009,Syrian Arab Rep.,SYR,Germany,DEU,97,10,428,109,644
2009,United Rep. of Tanzania,TZA,Germany,DEU,0,0,0,5,5
2009,Tajikistan,TJK,Germany,DEU,0,0,17,5,22
2009,Turkmenistan,TKM,Germany,DEU,0,0,5,0,5
2009,Togo,TGO,Germany,DEU,10,0,28,13,51
2009,Tunisia,TUN,Germany,DEU,0,0,85,42,127
2009,Turkey,TUR,Germany,DEU,147,12,997,349,1505
2009,Uganda,UGA,Germany,DEU,0,0,5,0,5
2009,Ukraine,UKR,Germany,DEU,0,0,28,18,46
2009,Uzbekistan,UZB,Germany,DEU,5,0,5,5,15
2009,Venezuela (Bolivarian Republic of),VEN,Germany,DEU,0,0,5,0,5
2009,Yemen,YEM,Germany,DEU,0,0,5,0,5
2009,Zimbabwe,ZWE,Germany,DEU,0,5,15,5,25
2009,Stateless,XXA,Germany,DEU,10,0,33,10,53
2009,Unknown ,,Germany,DEU,27,12,453,164,656
2010,Afghanistan,AFG,Germany,DEU,525,1597,2374,351,4847
2010,Albania,ALB,Germany,DEU,0,0,23,11,34
2010,Algeria,DZA,Germany,DEU,0,0,465,101,566
2010,Angola,AGO,Germany,DEU,0,21,68,12,101
2010,Egypt,EGY,Germany,DEU,26,0,106,14,146
2010,Armenia,ARM,Germany,DEU,5,12,337,69,423
2010,Azerbaijan,AZE,Germany,DEU,37,21,638,101,797
2010,Burundi,BDI,Germany,DEU,0,0,5,5,10
2010,Benin,BEN,Germany,DEU,0,0,91,5,96
2010,Bangladesh,BGD,Germany,DEU,0,0,82,5,87
2010,Burkina Faso,BFA,Germany,DEU,0,0,42,5,47
2010,Belarus,BLR,Germany,DEU,0,0,45,16,61
2010,Bosnia and Herzegovina,BIH,Germany,DEU,0,5,228,34,267
2010,Bulgaria,BGR,Germany,DEU,0,0,20,0,20
2010,Cambodia,KHM,Germany,DEU,0,0,10,0,10
2010,Chad,TCD,Germany,DEU,5,0,0,0,5
2010,China,CHN,Germany,DEU,62,5,391,24,482
2010,Cameroon,CMR,Germany,DEU,22,16,270,35,343
2010,Congo,COG,Germany,DEU,0,0,15,0,15
2010,Dem. Rep. of the Congo,COD,Germany,DEU,31,33,175,20,259
2010,Colombia,COL,Germany,DEU,0,0,0,5,5
2010,Cuba,CUB,Germany,DEU,0,0,23,5,28
2010,Equatorial Guinea,GNQ,Germany,DEU,0,0,5,0,5
2010,Eritrea,ERI,Germany,DEU,266,46,10,49,371
2010,Ethiopia,ETH,Germany,DEU,74,15,239,17,345
2010,Gambia,GMB,Germany,DEU,11,0,170,27,208
2010,Georgia,GEO,Germany,DEU,5,5,362,473,845
2010,Ghana,GHA,Germany,DEU,0,10,201,57,268
2010,Guinea-Bissau,GNB,Germany,DEU,0,0,5,5,10
2010,Guinea,GIN,Germany,DEU,33,11,242,34,320
2010,Croatia,HRV,Germany,DEU,0,0,5,11,16
2010,Hungary,HUN,Germany,DEU,0,0,5,5,10
2010,Cote d'Ivoire,CIV,Germany,DEU,5,0,61,5,71
2010,India,IND,Germany,DEU,10,0,935,38,983
2010,Indonesia,IDN,Germany,DEU,0,0,5,0,5
2010,Iran (Islamic Rep. of),IRN,Germany,DEU,969,26,828,176,1999
2010,Iraq,IRQ,Germany,DEU,3151,90,2458,336,6035
2010,Israel,ISR,Germany,DEU,0,0,14,5,19
2010,Italy,ITA,Germany,DEU,0,0,0,5,5
2010,Jamaica,JAM,Germany,DEU,0,0,5,0,5
2010,Jordan,JOR,Germany,DEU,0,0,33,13,46
2010,Kazakhstan,KAZ,Germany,DEU,0,0,5,5,10
2010,Kenya,KEN,Germany,DEU,10,17,286,17,330
2010,Kyrgyzstan,KGZ,Germany,DEU,5,0,31,0,36
2010,Liberia,LBR,Germany,DEU,0,0,13,5,18
2010,Libya,LBY,Germany,DEU,0,0,5,5,10
2010,Lebanon,LBN,Germany,DEU,0,5,469,80,554
2010,Sri Lanka,LKA,Germany,DEU,262,36,196,32,526
2010,Lithuania,LTU,Germany,DEU,0,0,12,0,12
2010,Latvia,LVA,Germany,DEU,0,0,5,0,5
2010,Mauritania,MRT,Germany,DEU,0,0,5,0,5
2010,North Macedonia,MKD,Germany,DEU,0,0,1793,329,2122
2010,Rep. of Moldova,MDA,Germany,DEU,0,0,53,5,58
2010,Mali,MLI,Germany,DEU,0,0,16,5,21
2010,Mongolia,MNG,Germany,DEU,0,0,40,29,69
2010,Morocco,MAR,Germany,DEU,5,5,184,40,234
2010,Montenegro,MNE,Germany,DEU,0,0,60,12,72
2010,Myanmar,MMR,Germany,DEU,52,0,0,0,52
2010,Nepal,NPL,Germany,DEU,0,0,10,0,10
2010,Niger,NER,Germany,DEU,0,0,13,5,18
2010,Nigeria,NGA,Germany,DEU,20,36,886,135,1077
2010,Pakistan,PAK,Germany,DEU,52,5,605,38,700
2010,Peru,PER,Germany,DEU,0,0,5,0,5
2010,Philippines,PHL,Germany,DEU,0,0,5,0,5
2010,Poland,POL,Germany,DEU,0,0,5,0,5
2010,Romania,ROU,Germany,DEU,0,0,10,0,10
2010,South Africa,ZAF,Germany,DEU,0,0,5,0,5
2010,Russian Federation,RUS,Germany,DEU,195,70,725,368,1358
2010,Rwanda,RWA,Germany,DEU,12,5,17,0,34
2010,Serbia and Kosovo: S/RES/1244 (1999),SRB,Germany,DEU,5,55,4892,777,5729
2010,Senegal,SEN,Germany,DEU,0,5,36,10,51
2010,Sierra Leone,SLE,Germany,DEU,5,19,90,10,124
2010,Somalia,SOM,Germany,DEU,372,80,45,400,897
2010,Viet Nam,VNM,Germany,DEU,0,10,948,92,1050
2010,Sudan,SDN,Germany,DEU,5,0,10,18,33
2010,Syrian Arab Rep.,SYR,Germany,DEU,230,24,1066,119,1439
2010,United Rep. of Tanzania,TZA,Germany,DEU,0,0,5,0,5
2010,Tajikistan,TJK,Germany,DEU,0,0,50,5,55
2010,Turkmenistan,TKM,Germany,DEU,0,0,5,5,10
2010,Togo,TGO,Germany,DEU,14,0,47,22,83
2010,Tunisia,TUN,Germany,DEU,5,0,136,32,173
2010,Turkey,TUR,Germany,DEU,188,13,1259,256,1716
2010,Uganda,UGA,Germany,DEU,5,5,22,0,32
2010,Ukraine,UKR,Germany,DEU,0,0,26,22,48
2010,United States of America,USA,Germany,DEU,0,0,5,0,5
2010,Uzbekistan,UZB,Germany,DEU,0,0,12,0,12
2010,Yemen,YEM,Germany,DEU,10,0,16,5,31
2010,Zimbabwe,ZWE,Germany,DEU,5,0,5,5,15
2010,Stateless,XXA,Germany,DEU,16,0,110,18,144
2010,Unknown ,,Germany,DEU,48,10,884,130,1072
2011,Afghanistan,AFG,Germany,DEU,701,1493,3813,388,6395
2011,Albania,ALB,Germany,DEU,0,11,44,12,67
2011,Algeria,DZA,Germany,DEU,0,0,353,71,424
2011,Angola,AGO,Germany,DEU,5,10,38,10,63
2011,Egypt,EGY,Germany,DEU,13,0,43,15,71
2011,Armenia,ARM,Germany,DEU,5,10,151,72,238
2011,Azerbaijan,AZE,Germany,DEU,39,10,217,34,300
2011,Burundi,BDI,Germany,DEU,0,0,5,0,5
2011,Benin,BEN,Germany,DEU,0,0,32,5,37
2011,Bangladesh,BGD,Germany,DEU,0,0,97,5,102
2011,Burkina Faso,BFA,Germany,DEU,0,0,36,0,36
2011,Belarus,BLR,Germany,DEU,0,0,27,23,50
2011,Bosnia and Herzegovina,BIH,Germany,DEU,0,10,257,52,319
2011,Bulgaria,BGR,Germany,DEU,0,0,10,5,15
2011,Cambodia,KHM,Germany,DEU,0,0,0,5,5
2011,Chad,TCD,Germany,DEU,0,0,5,0,5
2011,China,CHN,Germany,DEU,49,0,332,30,411
2011,Cameroon,CMR,Germany,DEU,5,5,102,21,133
2011,Congo,COG,Germany,DEU,0,0,19,0,19
2011,Dem. Rep. of the Congo,COD,Germany,DEU,10,43,112,18,183
2011,Colombia,COL,Germany,DEU,0,0,14,5,19
2011,Cuba,CUB,Germany,DEU,5,0,5,5,15
2011,Eritrea,ERI,Germany,DEU,250,34,16,82,382
2011,Estonia,EST,Germany,DEU,0,0,10,0,10
2011,Ethiopia,ETH,Germany,DEU,44,13,155,31,243
2011,Gabon,GAB,Germany,DEU,0,0,5,0,5
2011,Gambia,GMB,Germany,DEU,11,5,181,21,218
2011,Georgia,GEO,Germany,DEU,5,5,174,179,363
2011,Ghana,GHA,Germany,DEU,0,0,179,35,214
2011,Guinea-Bissau,GNB,Germany,DEU,0,0,10,5,15
2011,Guinea,GIN,Germany,DEU,40,5,114,22,181
2011,Haiti,HTI,Germany,DEU,0,0,5,0,5
2011,Honduras,HND,Germany,DEU,0,5,0,0,5
2011,Croatia,HRV,Germany,DEU,0,0,10,0,10
2011,Cote d'Ivoire,CIV,Germany,DEU,5,5,62,12,84
2011,India,IND,Germany,DEU,0,0,821,48,869
2011,Iran (Islamic Rep. of),IRN,Germany,DEU,1133,24,894,179,2230
2011,Iraq,IRQ,Germany,DEU,2670,70,1963,294,4997
2011,Israel,ISR,Germany,DEU,0,0,22,0,22
2011,Jordan,JOR,Germany,DEU,0,0,18,10,28
2011,Kazakhstan,KAZ,Germany,DEU,0,0,21,0,21
2011,Kenya,KEN,Germany,DEU,5,5,90,16,116
2011,Kyrgyzstan,KGZ,Germany,DEU,5,5,48,5,63
2011,Liberia,LBR,Germany,DEU,0,0,5,5,10
2011,Libya,LBY,Germany,DEU,0,0,5,37,42
2011,Lebanon,LBN,Germany,DEU,5,0,248,57,310
2011,Sri Lanka,LKA,Germany,DEU,124,11,178,19,332
2011,Lithuania,LTU,Germany,DEU,0,0,5,0,5
2011,Latvia,LVA,Germany,DEU,0,0,5,0,5
2011,Mauritania,MRT,Germany,DEU,0,0,10,0,10
2011,North Macedonia,MKD,Germany,DEU,0,0,1040,197,1237
2011,Rep. of Moldova,MDA,Germany,DEU,0,0,11,5,16
2011,Mali,MLI,Germany,DEU,0,0,13,10,23
2011,Mongolia,MNG,Germany,DEU,0,5,18,32,55
2011,Morocco,MAR,Germany,DEU,5,0,238,41,284
2011,Montenegro,MNE,Germany,DEU,0,0,57,17,74
2011,Myanmar,MMR,Germany,DEU,83,0,10,0,93
2011,Niger,NER,Germany,DEU,0,0,16,5,21
2011,Nigeria,NGA,Germany,DEU,29,43,557,95,724
2011,Pakistan,PAK,Germany,DEU,147,0,865,51,1063
2011,Philippines,PHL,Germany,DEU,0,0,5,0,5
2011,Poland,POL,Germany,DEU,0,0,0,5,5
2011,Romania,ROU,Germany,DEU,0,0,5,0,5
2011,Russian Federation,RUS,Germany,DEU,110,30,501,415,1056
2011,Rwanda,RWA,Germany,DEU,0,0,15,0,15
2011,El Salvador,SLV,Germany,DEU,0,0,5,0,5
2011,Serbia and Kosovo: S/RES/1244 (1999),SRB,Germany,DEU,0,34,4985,947,5966
2011,Senegal,SEN,Germany,DEU,0,0,38,5,43
2011,Sierra Leone,SLE,Germany,DEU,5,5,47,5,62
2011,Somalia,SOM,Germany,DEU,451,305,31,516,1303
2011,Viet Nam,VNM,Germany,DEU,5,10,629,87,731
2011,Sudan,SDN,Germany,DEU,5,23,34,22,84
2011,Syrian Arab Rep.,SYR,Germany,DEU,283,17,362,154,816
2011,Tajikistan,TJK,Germany,DEU,5,0,41,19,65
2011,Turkmenistan,TKM,Germany,DEU,0,0,5,0,5
2011,Togo,TGO,Germany,DEU,10,0,41,17,68
2011,Tunisia,TUN,Germany,DEU,0,0,175,125,300
2011,Turkey,TUR,Germany,DEU,116,15,1118,243,1492
2011,Uganda,UGA,Germany,DEU,0,0,34,5,39
2011,Ukraine,UKR,Germany,DEU,5,10,33,14,62
2011,United States of America,USA,Germany,DEU,0,0,5,0,5
2011,Uzbekistan,UZB,Germany,DEU,5,0,14,5,24
2011,Venezuela (Bolivarian Republic of),VEN,Germany,DEU,0,0,5,0,5
2011,Yemen,YEM,Germany,DEU,10,0,5,0,15
2011,Zimbabwe,ZWE,Germany,DEU,0,0,5,0,5
2011,Stateless,XXA,Germany,DEU,21,10,54,12,97
2011,Unknown ,,Germany,DEU,32,10,579,127,748
2012,Afghanistan,AFG,Germany,DEU,755,994,2262,445,4456
2012,Albania,ALB,Germany,DEU,0,12,82,20,114
2012,Algeria,DZA,Germany,DEU,0,0,285,57,342
2012,Angola,AGO,Germany,DEU,0,15,22,10,47
2012,Egypt,EGY,Germany,DEU,12,0,31,23,66
2012,Armenia,ARM,Germany,DEU,5,30,214,53,302
2012,Azerbaijan,AZE,Germany,DEU,15,20,220,65,320
2012,Burundi,BDI,Germany,DEU,0,5,5,0,10
2012,Benin,BEN,Germany,DEU,0,0,58,5,63
2012,Bangladesh,BGD,Germany,DEU,10,0,172,5,187
2012,Burkina Faso,BFA,Germany,DEU,0,0,43,10,53
2012,Belarus,BLR,Germany,DEU,0,0,45,17,62
2012,Bosnia and Herzegovina,BIH,Germany,DEU,0,21,1742,93,1856
2012,Bulgaria,BGR,Germany,DEU,0,0,51,0,51
2012,Cambodia,KHM,Germany,DEU,0,0,10,0,10
2012,Chad,TCD,Germany,DEU,0,0,0,19,19
2012,China,CHN,Germany,DEU,53,5,111,10,179
2012,Cameroon,CMR,Germany,DEU,0,10,145,15,170
2012,Congo,COG,Germany,DEU,0,0,5,0,5
2012,Dem. Rep. of the Congo,COD,Germany,DEU,10,15,83,12,120
2012,Colombia,COL,Germany,DEU,0,0,24,5,29
2012,Cuba,CUB,Germany,DEU,0,0,5,0,5
2012,Equatorial Guinea,GNQ,Germany,DEU,0,0,5,0,5
2012,Eritrea,ERI,Germany,DEU,204,35,38,81,358
2012,Ethiopia,ETH,Germany,DEU,61,11,214,29,315
2012,Gabon,GAB,Germany,DEU,0,0,5,5,10
2012,Gambia,GMB,Germany,DEU,10,5,114,23,152
2012,Georgia,GEO,Germany,DEU,5,0,256,321,582
2012,Ghana,GHA,Germany,DEU,0,5,163,55,223
2012,Guinea-Bissau,GNB,Germany,DEU,0,0,20,5,25
2012,Guatemala,GTM,Germany,DEU,0,0,0,5,5
2012,Guinea,GIN,Germany,DEU,23,10,80,49,162
2012,Honduras,HND,Germany,DEU,0,10,10,0,20
2012,Croatia,HRV,Germany,DEU,0,0,24,12,36
2012,Cote d'Ivoire,CIV,Germany,DEU,0,0,46,10,56
2012,India,IND,Germany,DEU,0,5,597,20,622
2012,Iran (Islamic Rep. of),IRN,Germany,DEU,1414,44,1022,215,2695
2012,Iraq,IRQ,Germany,DEU,2594,98,1418,244,4354
2012,Israel,ISR,Germany,DEU,0,0,5,0,5
2012,Jordan,JOR,Germany,DEU,5,0,13,0,18
2012,Kazakhstan,KAZ,Germany,DEU,0,0,5,18,23
2012,Kenya,KEN,Germany,DEU,0,5,125,14,144
2012,Kyrgyzstan,KGZ,Germany,DEU,5,0,29,11,45
2012,Liberia,LBR,Germany,DEU,0,0,5,5,10
2012,Libya,LBY,Germany,DEU,5,0,0,36,41
2012,Lebanon,LBN,Germany,DEU,10,5,235,57,307
2012,Sri Lanka,LKA,Germany,DEU,136,19,261,36,452
2012,Lithuania,LTU,Germany,DEU,0,0,5,0,5
2012,Mauritania,MRT,Germany,DEU,0,0,5,5,10
2012,North Macedonia,MKD,Germany,DEU,0,5,4098,359,4462
2012,Rep. of Moldova,MDA,Germany,DEU,0,0,19,5,24
2012,Mexico,MEX,Germany,DEU,0,5,0,0,5
2012,Mali,MLI,Germany,DEU,0,0,10,22,32
2012,Mongolia,MNG,Germany,DEU,0,0,21,15,36
2012,Morocco,MAR,Germany,DEU,0,0,210,61,271
2012,Montenegro,MNE,Germany,DEU,0,5,253,13,271
2012,Myanmar,MMR,Germany,DEU,27,0,5,0,32
2012,Nepal,NPL,Germany,DEU,0,0,10,5,15
2012,Niger,NER,Germany,DEU,0,0,14,15,29
2012,Nigeria,NGA,Germany,DEU,15,25,352,93,485
2012,Pakistan,PAK,Germany,DEU,280,13,1150,112,1555
2012,Philippines,PHL,Germany,DEU,0,0,5,0,5
2012,Romania,ROU,Germany,DEU,0,0,10,0,10
2012,South Africa,ZAF,Germany,DEU,0,0,5,0,5
2012,Russian Federation,RUS,Germany,DEU,102,30,536,339,1007
2012,Rwanda,RWA,Germany,DEU,5,0,15,0,20
2012,Serbia and Kosovo: S/RES/1244 (1999),SRB,Germany,DEU,5,42,10327,1107,11481
2012,Senegal,SEN,Germany,DEU,0,0,16,15,31
2012,Sierra Leone,SLE,Germany,DEU,5,5,16,10,36
2012,Somalia,SOM,Germany,DEU,277,224,38,278,817
2012,Viet Nam,VNM,Germany,DEU,5,0,477,62,544
2012,Sudan,SDN,Germany,DEU,0,20,48,24,92
2012,Slovakia,SVK,Germany,DEU,0,0,5,0,5
2012,Syrian Arab Rep.,SYR,Germany,DEU,1708,3522,10,268,5508
2012,Tajikistan,TJK,Germany,DEU,10,0,50,5,65
2012,Turkmenistan,TKM,Germany,DEU,0,0,5,0,5
2012,Togo,TGO,Germany,DEU,5,0,43,15,63
2012,Tunisia,TUN,Germany,DEU,0,0,116,167,283
2012,Turkey,TUR,Germany,DEU,105,16,683,177,981
2012,Uganda,UGA,Germany,DEU,0,5,13,5,23
2012,Ukraine,UKR,Germany,DEU,0,0,17,5,22
2012,Uzbekistan,UZB,Germany,DEU,0,0,20,0,20
2012,Yemen,YEM,Germany,DEU,0,0,5,5,10
2012,Zimbabwe,ZWE,Germany,DEU,0,0,5,5,10
2012,Stateless,XXA,Germany,DEU,79,156,29,25,289
2012,Unknown ,,Germany,DEU,95,241,462,94,892
2013,Afghanistan,AFG,Germany,DEU,1180,1588,2243,760,5771
2013,Albania,ALB,Germany,DEU,5,31,362,95,493
2013,Algeria,DZA,Germany,DEU,10,5,267,167,449
2013,Angola,AGO,Germany,DEU,5,35,24,5,69
2013,Egypt,EGY,Germany,DEU,62,24,152,73,311
2013,Armenia,ARM,Germany,DEU,10,57,397,126,590
2013,Azerbaijan,AZE,Germany,DEU,35,34,452,65,586
2013,Bahrain,BHR,Germany,DEU,5,0,0,0,5
2013,Burundi,BDI,Germany,DEU,0,0,5,0,5
2013,Benin,BEN,Germany,DEU,0,0,106,11,117
2013,Bangladesh,BGD,Germany,DEU,12,5,207,18,242
2013,Burkina Faso,BFA,Germany,DEU,0,0,65,30,95
2013,Belarus,BLR,Germany,DEU,5,0,42,55,102
2013,Bosnia and Herzegovina,BIH,Germany,DEU,0,16,2003,315,2334
2013,Bulgaria,BGR,Germany,DEU,0,0,52,10,62
2013,Cambodia,KHM,Germany,DEU,0,0,5,0,5
2013,Chad,TCD,Germany,DEU,0,0,5,24,29
2013,China,CHN,Germany,DEU,42,5,158,36,241
2013,Chile,CHL,Germany,DEU,0,0,5,0,5
2013,Cameroon,CMR,Germany,DEU,10,5,102,58,175
2013,Congo,COG,Germany,DEU,5,0,12,5,22
2013,Dem. Rep. of the Congo,COD,Germany,DEU,10,24,141,17,192
2013,Colombia,COL,Germany,DEU,0,0,21,5,26
2013,Cuba,CUB,Germany,DEU,0,0,13,5,18
2013,Eritrea,ERI,Germany,DEU,368,51,20,136,575
2013,Ethiopia,ETH,Germany,DEU,71,19,223,44,357
2013,Gambia,GMB,Germany,DEU,5,5,75,61,146
2013,Palestinian,PSE,Germany,DEU,16,10,11,19,56
2013,United Kingdom of Great Britain and Northern Ireland,GBR,Germany,DEU,0,0,5,0,5
2013,Georgia,GEO,Germany,DEU,5,5,445,991,1446
2013,Ghana,GHA,Germany,DEU,0,10,323,127,460
2013,Guinea-Bissau,GNB,Germany,DEU,0,0,32,28,60
2013,Guinea,GIN,Germany,DEU,56,30,199,108,393
2013,Haiti,HTI,Germany,DEU,0,0,10,13,23
2013,Honduras,HND,Germany,DEU,0,5,0,0,5
2013,Croatia,HRV,Germany,DEU,0,0,26,0,26
2013,Cote d'Ivoire,CIV,Germany,DEU,5,0,41,58,104
2013,India,IND,Germany,DEU,0,0,543,38,581
2013,Iran (Islamic Rep. of),IRN,Germany,DEU,1709,62,995,437,3203
2013,Iraq,IRQ,Germany,DEU,2047,143,1437,317,3944
2013,Israel,ISR,Germany,DEU,0,0,0,5,5
2013,Jamaica,JAM,Germany,DEU,0,0,5,5,10
2013,Jordan,JOR,Germany,DEU,0,0,15,10,25
2013,Kazakhstan,KAZ,Germany,DEU,0,0,15,48,63
2013,Kenya,KEN,Germany,DEU,5,5,71,11,92
2013,Kyrgyzstan,KGZ,Germany,DEU,5,0,46,22,73
2013,Dem. People's Rep. of Korea,PRK,Germany,DEU,0,0,5,12,17
2013,Liberia,LBR,Germany,DEU,0,0,0,10,10
2013,Libya,LBY,Germany,DEU,0,14,67,37,118
2013,Lebanon,LBN,Germany,DEU,14,11,277,58,360
2013,Sri Lanka,LKA,Germany,DEU,106,19,224,56,405
2013,Lithuania,LTU,Germany,DEU,0,0,5,0,5
2013,Mauritania,MRT,Germany,DEU,0,0,5,33,38
2013,North Macedonia,MKD,Germany,DEU,5,10,3527,439,3981
2013,Rep. of Moldova,MDA,Germany,DEU,0,0,22,5,27
2013,Mexico,MEX,Germany,DEU,0,5,0,0,5
2013,Mali,MLI,Germany,DEU,5,0,56,86,147
2013,Mongolia,MNG,Germany,DEU,0,0,5,22,27
2013,Morocco,MAR,Germany,DEU,0,0,381,178,559
2013,Montenegro,MNE,Germany,DEU,0,5,138,37,180
2013,Myanmar,MMR,Germany,DEU,28,10,10,0,48
2013,Nepal,NPL,Germany,DEU,0,0,16,0,16
2013,Niger,NER,Germany,DEU,0,0,19,19,38
2013,Nigeria,NGA,Germany,DEU,36,39,362,240,677
2013,Pakistan,PAK,Germany,DEU,762,22,1141,353,2278
2013,Poland,POL,Germany,DEU,0,0,5,0,5
2013,Romania,ROU,Germany,DEU,0,0,26,5,31
2013,Russian Federation,RUS,Germany,DEU,141,90,1300,10299,11830
2013,Rwanda,RWA,Germany,DEU,5,0,11,5,21
2013,Serbia and Kosovo: S/RES/1244 (1999),SRB,Germany,DEU,0,39,8531,1260,9830
2013,Senegal,SEN,Germany,DEU,0,5,53,44,102
2013,Sierra Leone,SLE,Germany,DEU,5,16,38,15,74
2013,Somalia,SOM,Germany,DEU,449,258,271,398,1376
2013,Viet Nam,VNM,Germany,DEU,0,5,501,90,596
2013,Sudan,SDN,Germany,DEU,11,5,63,70,149
2013,South Sudan,SSD,Germany,DEU,0,0,0,5,5
2013,Syrian Arab Rep.,SYR,Germany,DEU,2726,5465,10,369,8570
2013,United Rep. of Tanzania,TZA,Germany,DEU,0,0,5,5,10
2013,Tajikistan,TJK,Germany,DEU,10,13,49,10,82
2013,Turkmenistan,TKM,Germany,DEU,0,0,13,0,13
2013,Togo,TGO,Germany,DEU,5,0,20,21,46
2013,Tunisia,TUN,Germany,DEU,5,0,152,125,282
2013,Turkey,TUR,Germany,DEU,74,21,732,258,1085
2013,Uganda,UGA,Germany,DEU,5,10,27,5,47
2013,Ukraine,UKR,Germany,DEU,0,5,25,27,57
2013,United States of America,USA,Germany,DEU,0,0,0,5,5
2013,Uzbekistan,UZB,Germany,DEU,5,0,21,0,26
2013,Venezuela (Bolivarian Republic of),VEN,Germany,DEU,0,0,5,0,5
2013,Yemen,YEM,Germany,DEU,0,0,0,5,5
2013,Zimbabwe,ZWE,Germany,DEU,0,5,10,5,20
2013,Stateless,XXA,Germany,DEU,61,96,38,26,221
2013,Unknown ,,Germany,DEU,118,189,504,95,906
2014,Afghanistan,AFG,Germany,DEU,1830,1307,1554,2185,6876
2014,Albania,ALB,Germany,DEU,10,65,2806,434,3315
2014,Algeria,DZA,Germany,DEU,0,5,361,759,1125
2014,Angola,AGO,Germany,DEU,0,27,0,35,62
2014,Egypt,EGY,Germany,DEU,79,13,171,283,546
2014,Armenia,ARM,Germany,DEU,10,64,456,287,817
2014,Azerbaijan,AZE,Germany,DEU,40,30,517,114,701
2014,Bahrain,BHR,Germany,DEU,27,0,0,0,27
2014,Burundi,BDI,Germany,DEU,0,0,0,5,5
2014,Benin,BEN,Germany,DEU,0,0,98,60,158
2014,Bangladesh,BGD,Germany,DEU,31,16,398,112,557
2014,Burkina Faso,BFA,Germany,DEU,0,0,64,142,206
2014,Belarus,BLR,Germany,DEU,5,0,25,52,82
2014,Bosnia and Herzegovina,BIH,Germany,DEU,0,12,3625,850,4487
2014,Bulgaria,BGR,Germany,DEU,0,0,55,10,65
2014,Cambodia,KHM,Germany,DEU,0,0,5,5,10
2014,Central African Rep.,CAF,Germany,DEU,0,0,0,5,5
2014,Chad,TCD,Germany,DEU,0,0,5,166,171
2014,China,CHN,Germany,DEU,13,13,97,54,177
2014,Cameroon,CMR,Germany,DEU,5,11,117,239,372
2014,Congo,COG,Germany,DEU,0,0,21,15,36
2014,Dem. Rep. of the Congo,COD,Germany,DEU,5,25,62,33,125
2014,Colombia,COL,Germany,DEU,0,0,5,14,19
2014,Cuba,CUB,Germany,DEU,0,5,16,23,44
2014,Djibouti,DJI,Germany,DEU,0,0,0,5,5
2014,Ecuador,ECU,Germany,DEU,5,0,0,0,5
2014,Eritrea,ERI,Germany,DEU,738,230,16,773,1757
2014,Ethiopia,ETH,Germany,DEU,82,47,265,209,603
2014,Gabon,GAB,Germany,DEU,0,0,0,5,5
2014,Gambia,GMB,Germany,DEU,10,0,105,600,715
2014,Palestinian,PSE,Germany,DEU,172,13,5,16,206
2014,Georgia,GEO,Germany,DEU,5,5,916,1371,2297
2014,Ghana,GHA,Germany,DEU,0,10,197,422,629
2014,Guinea-Bissau,GNB,Germany,DEU,0,0,81,149,230
2014,Greece,GRC,Germany,DEU,0,0,5,0,5
2014,Guatemala,GTM,Germany,DEU,0,0,10,0,10
2014,Guinea,GIN,Germany,DEU,60,32,115,444,651
2014,Haiti,HTI,Germany,DEU,0,0,5,0,5
2014,Croatia,HRV,Germany,DEU,0,0,10,11,21
2014,Cote d'Ivoire,CIV,Germany,DEU,5,5,60,223,293
2014,India,IND,Germany,DEU,5,5,515,80,605
2014,Iran (Islamic Rep. of),IRN,Germany,DEU,1875,68,712,1145,3800
2014,Iraq,IRQ,Germany,DEU,2601,146,411,684,3842
2014,Israel,ISR,Germany,DEU,0,0,0,10,10
2014,Italy,ITA,Germany,DEU,0,0,0,5,5
2014,Jamaica,JAM,Germany,DEU,0,0,5,5,10
2014,Jordan,JOR,Germany,DEU,10,0,5,22,37
2014,Kazakhstan,KAZ,Germany,DEU,10,5,19,98,132
2014,Kenya,KEN,Germany,DEU,0,10,61,60,131
2014,Kyrgyzstan,KGZ,Germany,DEU,28,0,35,69,132
2014,Rep. of Korea,KOR,Germany,DEU,0,0,5,10,15
2014,Dem. People's Rep. of Korea,PRK,Germany,DEU,0,0,0,10,10
2014,Kuwait,KWT,Germany,DEU,0,0,0,5,5
2014,Liberia,LBR,Germany,DEU,0,0,0,54,54
2014,Libya,LBY,Germany,DEU,105,12,46,176,339
2014,Lebanon,LBN,Germany,DEU,17,5,186,238,446
2014,Sri Lanka,LKA,Germany,DEU,119,27,125,47,318
2014,Mauritania,MRT,Germany,DEU,0,0,18,81,99
2014,North Macedonia,MKD,Germany,DEU,0,12,4694,903,5609
2014,Rep. of Moldova,MDA,Germany,DEU,5,0,15,10,30
2014,Mexico,MEX,Germany,DEU,0,0,5,0,5
2014,Mali,MLI,Germany,DEU,5,5,188,357,555
2014,Malawi,MWI,Germany,DEU,0,0,0,5,5
2014,Mongolia,MNG,Germany,DEU,0,0,83,147,230
2014,Morocco,MAR,Germany,DEU,5,5,513,614,1137
2014,Mozambique,MOZ,Germany,DEU,0,0,0,5,5
2014,Montenegro,MNE,Germany,DEU,0,0,582,59,641
2014,Myanmar,MMR,Germany,DEU,10,5,0,15,30
2014,Nepal,NPL,Germany,DEU,0,0,10,5,15
2014,Niger,NER,Germany,DEU,0,0,27,148,175
2014,Nigeria,NGA,Germany,DEU,46,47,223,901,1217
2014,Pakistan,PAK,Germany,DEU,499,31,1412,954,2896
2014,Poland,POL,Germany,DEU,0,0,5,0,5
2014,Romania,ROU,Germany,DEU,0,0,13,5,18
2014,South Africa,ZAF,Germany,DEU,0,0,0,5,5
2014,Russian Federation,RUS,Germany,DEU,190,158,1296,3799,5443
2014,Rwanda,RWA,Germany,DEU,5,0,5,5,15
2014,Saudi Arabia,SAU,Germany,DEU,5,0,0,0,5
2014,Serbia and Kosovo: S/RES/1244 (1999),SRB,Germany,DEU,5,58,13771,2761,16595
2014,Senegal,SEN,Germany,DEU,0,0,74,177,251
2014,Sierra Leone,SLE,Germany,DEU,5,17,5,52,79
2014,Somalia,SOM,Germany,DEU,508,311,298,2231,3348
2014,Spain,ESP,Germany,DEU,0,0,10,0,10
2014,Viet Nam,VNM,Germany,DEU,0,5,114,121,240
2014,Sudan,SDN,Germany,DEU,41,18,36,345,440
2014,South Sudan,SSD,Germany,DEU,0,0,5,27,32
2014,Syrian Arab Rep.,SYR,Germany,DEU,19560,2998,10,2459,25027
2014,United Rep. of Tanzania,TZA,Germany,DEU,0,0,0,13,13
2014,Thailand,THA,Germany,DEU,5,0,0,0,5
2014,Tajikistan,TJK,Germany,DEU,20,0,80,60,160
2014,Turkmenistan,TKM,Germany,DEU,5,0,14,22,41
2014,Togo,TGO,Germany,DEU,0,0,26,50,76
2014,Tunisia,TUN,Germany,DEU,0,0,484,373,857
2014,Turkey,TUR,Germany,DEU,79,33,507,379,998
2014,Uganda,UGA,Germany,DEU,0,0,5,12,17
2014,Ukraine,UKR,Germany,DEU,10,10,37,274,331
2014,United States of America,USA,Germany,DEU,0,0,0,5,5
2014,Uzbekistan,UZB,Germany,DEU,5,0,5,14,24
2014,Venezuela (Bolivarian Republic of),VEN,Germany,DEU,0,0,5,0,5
2014,Yemen,YEM,Germany,DEU,0,5,10,46,61
2014,Zimbabwe,ZWE,Germany,DEU,0,0,5,0,5
2014,Stateless,XXA,Germany,DEU,516,189,35,163,903
2014,Unknown ,,Germany,DEU,1597,374,533,643,3147
2015,Afghanistan,AFG,Germany,DEU,1550,1001,809,2132,5492
2015,Albania,ALB,Germany,DEU,5,68,31086,4074,35233
2015,Algeria,DZA,Germany,DEU,10,5,330,665,1010
2015,Angola,AGO,Germany,DEU,5,24,21,14,64
2015,Egypt,EGY,Germany,DEU,335,21,224,244,824
2015,Armenia,ARM,Germany,DEU,18,34,263,300,615
2015,Azerbaijan,AZE,Germany,DEU,42,24,160,127,353
2015,Bahrain,BHR,Germany,DEU,24,0,0,0,24
2015,Burundi,BDI,Germany,DEU,0,0,5,0,5
2015,Benin,BEN,Germany,DEU,0,0,21,74,95
2015,Bangladesh,BGD,Germany,DEU,19,10,217,178,424
2015,Bhutan,BTN,Germany,DEU,0,0,5,0,5
2015,Burkina Faso,BFA,Germany,DEU,0,5,23,85,113
2015,Belarus,BLR,Germany,DEU,5,0,0,55,60
2015,Botswana,BWA,Germany,DEU,0,0,5,0,5
2015,Brazil,BRA,Germany,DEU,0,0,0,10,10
2015,Bosnia and Herzegovina,BIH,Germany,DEU,0,10,3081,809,3900
2015,Bulgaria,BGR,Germany,DEU,0,0,15,13,28
2015,Cambodia,KHM,Germany,DEU,0,0,5,0,5
2015,Central African Rep.,CAF,Germany,DEU,0,0,0,5,5
2015,Chad,TCD,Germany,DEU,0,15,24,65,104
2015,China,CHN,Germany,DEU,25,0,95,27,147
2015,Cameroon,CMR,Germany,DEU,0,5,94,261,360
2015,Congo,COG,Germany,DEU,0,0,11,10,21
2015,Dem. Rep. of the Congo,COD,Germany,DEU,5,23,106,21,155
2015,Colombia,COL,Germany,DEU,0,0,5,5,10
2015,Cuba,CUB,Germany,DEU,0,0,0,34,34
2015,Czechia,CZE,Germany,DEU,0,0,5,5,10
2015,Djibouti,DJI,Germany,DEU,0,0,5,5,10
2015,Eritrea,ERI,Germany,DEU,8895,367,37,728,10027
2015,Ethiopia,ETH,Germany,DEU,58,35,85,188,366
2015,France,FRA,Germany,DEU,0,0,5,0,5
2015,Gabon,GAB,Germany,DEU,0,0,5,5,10
2015,Gambia,GMB,Germany,DEU,10,5,53,519,587
2015,Georgia,GEO,Germany,DEU,0,5,1370,640,2015
2015,Ghana,GHA,Germany,DEU,10,5,128,398,541
2015,Guinea-Bissau,GNB,Germany,DEU,0,0,20,184,204
2015,Greece,GRC,Germany,DEU,0,0,5,0,5
2015,Guinea,GIN,Germany,DEU,47,23,80,215,365
2015,Honduras,HND,Germany,DEU,0,5,5,5,15
2015,Croatia,HRV,Germany,DEU,0,0,10,5,15
2015,Hungary,HUN,Germany,DEU,0,0,0,5,5
2015,Cote d'Ivoire,CIV,Germany,DEU,5,5,30,295,335
2015,India,IND,Germany,DEU,5,5,411,99,520
2015,Iran (Islamic Rep. of),IRN,Germany,DEU,1424,37,260,737,2458
2015,Iraq,IRQ,Germany,DEU,10732,229,111,1667,12739
2015,Italy,ITA,Germany,DEU,0,0,5,0,5
2015,Jamaica,JAM,Germany,DEU,0,0,5,10,15
2015,Jordan,JOR,Germany,DEU,22,0,5,23,50
2015,Kazakhstan,KAZ,Germany,DEU,0,0,14,57,71
2015,Kenya,KEN,Germany,DEU,0,0,109,53,162
2015,Kyrgyzstan,KGZ,Germany,DEU,5,0,13,39,57
2015,Dem. People's Rep. of Korea,PRK,Germany,DEU,0,0,5,0,5
2015,Liberia,LBR,Germany,DEU,0,0,0,40,40
2015,Libya,LBY,Germany,DEU,112,10,33,186,341
2015,Lebanon,LBN,Germany,DEU,33,10,136,205,384
2015,Sri Lanka,LKA,Germany,DEU,64,5,84,25,178
2015,Mauritania,MRT,Germany,DEU,0,0,15,54,69
2015,North Macedonia,MKD,Germany,DEU,22,11,4967,671,5671
2015,Rep. of Moldova,MDA,Germany,DEU,0,0,24,16,40
2015,Mali,MLI,Germany,DEU,5,5,58,243,311
2015,Mongolia,MNG,Germany,DEU,0,0,51,129,180
2015,Morocco,MAR,Germany,DEU,21,14,394,442,871
2015,Montenegro,MNE,Germany,DEU,0,5,1775,188,1968
2015,Myanmar,MMR,Germany,DEU,12,0,0,10,22
2015,Namibia,NAM,Germany,DEU,0,0,0,5,5
2015,Nepal,NPL,Germany,DEU,0,5,5,0,10
2015,Niger,NER,Germany,DEU,0,0,13,74,87
2015,Nigeria,NGA,Germany,DEU,31,40,176,867,1114
2015,Pakistan,PAK,Germany,DEU,143,27,831,860,1861
2015,Philippines,PHL,Germany,DEU,0,0,10,0,10
2015,Russian Federation,RUS,Germany,DEU,167,117,811,2556,3651
2015,Rwanda,RWA,Germany,DEU,11,5,10,5,31
2015,Serbia and Kosovo: S/RES/1244 (1999),SRB,Germany,DEU,17,124,37130,3981,41252
2015,Senegal,SEN,Germany,DEU,0,0,29,182,211
2015,Sierra Leone,SLE,Germany,DEU,5,10,26,37,78
2015,Somalia,SOM,Germany,DEU,407,340,180,927,1854
2015,Viet Nam,VNM,Germany,DEU,0,5,71,187,263
2015,Sudan,SDN,Germany,DEU,46,87,47,261,441
2015,South Sudan,SSD,Germany,DEU,5,0,0,16,21
2015,Syrian Arab Rep.,SYR,Germany,DEU,97656,197,22,4062,101937
2015,United Rep. of Tanzania,TZA,Germany,DEU,0,0,0,10,10
2015,Tajikistan,TJK,Germany,DEU,5,0,24,130,159
2015,Turkmenistan,TKM,Germany,DEU,0,0,13,33,46
2015,Togo,TGO,Germany,DEU,0,0,16,36,52
2015,Tunisia,TUN,Germany,DEU,0,0,246,203,449
2015,Turkey,TUR,Germany,DEU,75,27,237,399,738
2015,Uganda,UGA,Germany,DEU,5,0,5,13,23
2015,Ukraine,UKR,Germany,DEU,50,0,42,873,965
2015,Uzbekistan,UZB,Germany,DEU,5,0,0,5,10
2015,Venezuela (Bolivarian Republic of),VEN,Germany,DEU,0,0,5,0,5
2015,Yemen,YEM,Germany,DEU,13,31,0,23,67
2015,Zambia,ZMB,Germany,DEU,0,0,0,5,5
2015,Zimbabwe,ZWE,Germany,DEU,0,5,10,0,15
2015,Stateless,XXA,Germany,DEU,1824,0,25,151,2000
2015,Unknown ,,Germany,DEU,4915,50,567,661,6193
2016,Afghanistan,AFG,Germany,DEU,13647,24108,24734,4892,67381
2016,Albania,ALB,Germany,DEU,18,139,29681,5400,35238
2016,Algeria,DZA,Germany,DEU,41,97,3154,1712,5004
2016,Angola,AGO,Germany,DEU,5,23,41,25,94
2016,Egypt,EGY,Germany,DEU,374,92,1755,395,2616
2016,Armenia,ARM,Germany,DEU,33,149,1717,505,2404
2016,Azerbaijan,AZE,Germany,DEU,276,163,1681,446,2566
2016,Bahrain,BHR,Germany,DEU,5,0,0,0,5
2016,Burundi,BDI,Germany,DEU,0,10,0,5,15
2016,Benin,BEN,Germany,DEU,0,13,166,121,300
2016,Bangladesh,BGD,Germany,DEU,73,33,520,295,921
2016,Bhutan,BTN,Germany,DEU,0,0,0,5,5
2016,Burkina Faso,BFA,Germany,DEU,5,0,138,88,231
2016,Belarus,BLR,Germany,DEU,10,0,59,126,195
2016,Bosnia and Herzegovina,BIH,Germany,DEU,5,41,3659,885,4590
2016,Bulgaria,BGR,Germany,DEU,0,0,16,0,16
2016,Central African Rep.,CAF,Germany,DEU,5,0,0,5,10
2016,Chad,TCD,Germany,DEU,5,11,43,78,137
2016,China,CHN,Germany,DEU,78,22,386,171,657
2016,Cameroon,CMR,Germany,DEU,5,5,263,270,543
2016,Congo,COG,Germany,DEU,12,0,13,15,40
2016,Dem. Rep. of the Congo,COD,Germany,DEU,18,11,94,32,155
2016,Colombia,COL,Germany,DEU,5,0,22,5,32
2016,Cuba,CUB,Germany,DEU,0,0,15,45,60
2016,Djibouti,DJI,Germany,DEU,0,0,5,5,10
2016,Eritrea,ERI,Germany,DEU,16568,3738,135,1498,21939
2016,Ethiopia,ETH,Germany,DEU,159,84,752,365,1360
2016,Gabon,GAB,Germany,DEU,0,0,5,0,5
2016,Gambia,GMB,Germany,DEU,41,31,544,470,1086
2016,Georgia,GEO,Germany,DEU,26,36,2441,1125,3628
2016,Ghana,GHA,Germany,DEU,10,49,1199,500,1758
2016,Guinea-Bissau,GNB,Germany,DEU,0,13,175,282,470
2016,Greece,GRC,Germany,DEU,0,0,5,5,10
2016,Guinea,GIN,Germany,DEU,152,51,516,466,1185
2016,Haiti,HTI,Germany,DEU,0,0,5,0,5
2016,Honduras,HND,Germany,DEU,0,10,0,0,10
2016,Croatia,HRV,Germany,DEU,0,0,5,5,10
2016,Hungary,HUN,Germany,DEU,0,0,5,10,15
2016,Cote d'Ivoire,CIV,Germany,DEU,5,14,148,233,400
2016,India,IND,Germany,DEU,27,41,3636,932,4636
2016,Iran (Islamic Rep. of),IRN,Germany,DEU,5288,364,3700,1671,11023
2016,Iraq,IRQ,Germany,DEU,36149,11139,14074,5757,67119
2016,Israel,ISR,Germany,DEU,0,0,14,10,24
2016,Italy,ITA,Germany,DEU,0,0,11,5,16
2016,Jamaica,JAM,Germany,DEU,0,0,5,5,10
2016,Jordan,JOR,Germany,DEU,19,16,35,55,125
2016,Kazakhstan,KAZ,Germany,DEU,0,0,73,47,120
2016,Kenya,KEN,Germany,DEU,0,5,111,69,185
2016,Kyrgyzstan,KGZ,Germany,DEU,15,5,32,28,80
2016,Dem. People's Rep. of Korea,PRK,Germany,DEU,0,0,5,11,16
2016,Kuwait,KWT,Germany,DEU,5,0,0,10,15
2016,Liberia,LBR,Germany,DEU,0,0,22,41,63
2016,Libya,LBY,Germany,DEU,334,99,680,366,1479
2016,Lebanon,LBN,Germany,DEU,148,179,2785,780,3892
2016,Sri Lanka,LKA,Germany,DEU,83,34,147,55,319
2016,Lithuania,LTU,Germany,DEU,0,0,5,0,5
2016,Latvia,LVA,Germany,DEU,0,0,5,5,10
2016,Mauritania,MRT,Germany,DEU,0,0,18,73,91
2016,North Macedonia,MKD,Germany,DEU,5,35,7815,1571,9426
2016,Rep. of Moldova,MDA,Germany,DEU,11,12,2826,1876,4725
2016,Mexico,MEX,Germany,DEU,0,0,5,0,5
2016,Mali,MLI,Germany,DEU,19,20,266,349,654
2016,Malawi,MWI,Germany,DEU,0,0,0,5,5
2016,Mongolia,MNG,Germany,DEU,0,5,111,107,223
2016,Morocco,MAR,Germany,DEU,77,89,3004,1481,4651
2016,Montenegro,MNE,Germany,DEU,0,13,2439,338,2790
2016,Myanmar,MMR,Germany,DEU,11,5,0,11,27
2016,Nepal,NPL,Germany,DEU,0,0,5,10,15
2016,Niger,NER,Germany,DEU,0,5,60,87,152
2016,Nigeria,NGA,Germany,DEU,123,238,1774,1553,3688
2016,Pakistan,PAK,Germany,DEU,263,144,8109,2556,11072
2016,Philippines,PHL,Germany,DEU,0,0,5,5,10
2016,Poland,POL,Germany,DEU,0,0,10,10,20
2016,Portugal,PRT,Germany,DEU,0,0,5,5,10
2016,Romania,ROU,Germany,DEU,0,0,0,5,5
2016,South Africa,ZAF,Germany,DEU,0,0,10,0,10
2016,Russian Federation,RUS,Germany,DEU,325,248,5459,5034,11066
2016,Rwanda,RWA,Germany,DEU,5,0,5,10,20
2016,El Salvador,SLV,Germany,DEU,0,0,5,0,5
2016,Saudi Arabia,SAU,Germany,DEU,29,0,12,5,46
2016,Serbia and Kosovo: S/RES/1244 (1999),SRB,Germany,DEU,13,156,25836,4293,30298
2016,Senegal,SEN,Germany,DEU,13,17,1270,290,1590
2016,Sierra Leone,SLE,Germany,DEU,5,5,46,78,134
2016,Somalia,SOM,Germany,DEU,1828,2731,582,1193,6334
2016,Spain,ESP,Germany,DEU,0,0,5,5,10
2016,Viet Nam,VNM,Germany,DEU,5,5,737,361,1108
2016,Sudan,SDN,Germany,DEU,143,92,157,357,749
2016,South Sudan,SSD,Germany,DEU,0,0,5,17,22
2016,Syrian Arab Rep.,SYR,Germany,DEU,164926,121182,158,5398,291664
2016,United Rep. of Tanzania,TZA,Germany,DEU,0,0,0,5,5
2016,Tajikistan,TJK,Germany,DEU,49,10,172,318,549
2016,Turkmenistan,TKM,Germany,DEU,5,5,185,48,243
2016,Togo,TGO,Germany,DEU,0,5,31,33,69
2016,Tunisia,TUN,Germany,DEU,5,5,854,482,1346
2016,Turkey,TUR,Germany,DEU,99,45,643,855,1642
2016,Uganda,UGA,Germany,DEU,0,13,15,26,54
2016,Ukraine,UKR,Germany,DEU,28,34,2260,1605,3927
2016,United States of America,USA,Germany,DEU,5,0,5,0,10
2016,Uzbekistan,UZB,Germany,DEU,5,0,5,5,15
2016,Venezuela (Bolivarian Republic of),VEN,Germany,DEU,5,0,22,5,32
2016,Yemen,YEM,Germany,DEU,49,199,0,53,301
2016,Zimbabwe,ZWE,Germany,DEU,10,5,22,5,42
2016,Stateless,XXA,Germany,DEU,3081,2299,295,211,5886
2016,Unknown ,,Germany,DEU,8285,6884,2313,1445,18927
2017,Afghanistan,AFG,Germany,DEU,17718,32647,56309,5918,112592
2017,Albania,ALB,Germany,DEU,10,119,5955,997,7081
2017,Algeria,DZA,Germany,DEU,32,86,1759,1448,3325
2017,Angola,AGO,Germany,DEU,29,113,124,147,413
2017,Egypt,EGY,Germany,DEU,354,135,1625,580,2694
2017,Armenia,ARM,Germany,DEU,183,623,6839,1553,9198
2017,Azerbaijan,AZE,Germany,DEU,595,341,4178,1609,6723
2017,Bahrain,BHR,Germany,DEU,14,5,5,5,29
2017,Burundi,BDI,Germany,DEU,18,5,12,5,40
2017,Benin,BEN,Germany,DEU,10,26,464,100,600
2017,Bangladesh,BGD,Germany,DEU,217,89,2221,529,3056
2017,Bhutan,BTN,Germany,DEU,0,0,5,0,5
2017,Burkina Faso,BFA,Germany,DEU,10,19,321,136,486
2017,Belarus,BLR,Germany,DEU,20,13,313,316,662
2017,Brazil,BRA,Germany,DEU,0,0,29,0,29
2017,Bosnia and Herzegovina,BIH,Germany,DEU,0,20,1031,195,1246
2017,Bulgaria,BGR,Germany,DEU,0,0,20,0,20
2017,Cambodia,KHM,Germany,DEU,0,5,13,5,23
2017,Canada,CAN,Germany,DEU,0,0,5,0,5
2017,Central African Rep.,CAF,Germany,DEU,13,18,47,25,103
2017,Chad,TCD,Germany,DEU,15,10,117,119,261
2017,China,CHN,Germany,DEU,191,46,1131,494,1862
2017,Cameroon,CMR,Germany,DEU,64,125,1704,864,2757
2017,Congo,COG,Germany,DEU,22,20,72,45,159
2017,Dem. Rep. of the Congo,COD,Germany,DEU,156,166,438,157,917
2017,Comoros,COM,Germany,DEU,0,0,5,0,5
2017,Colombia,COL,Germany,DEU,0,0,52,14,66
2017,Cuba,CUB,Germany,DEU,0,0,170,44,214
2017,Czechia,CZE,Germany,DEU,0,0,5,0,5
2017,Djibouti,DJI,Germany,DEU,13,0,10,10,33
2017,Dominican Rep.,DOM,Germany,DEU,0,0,5,5,10
2017,Equatorial Guinea,GNQ,Germany,DEU,5,5,5,5,20
2017,Eritrea,ERI,Germany,DEU,10033,7906,452,2970,21361
2017,Ethiopia,ETH,Germany,DEU,1055,817,5721,907,8500
2017,France,FRA,Germany,DEU,0,0,5,0,5
2017,Gabon,GAB,Germany,DEU,0,0,19,11,30
2017,Gambia,GMB,Germany,DEU,216,230,5806,3064,9316
2017,United Kingdom of Great Britain and Northern Ireland,GBR,Germany,DEU,0,0,10,5,15
2017,Georgia,GEO,Germany,DEU,17,98,4095,1343,5553
2017,Ghana,GHA,Germany,DEU,36,138,2522,751,3447
2017,Guinea-Bissau,GNB,Germany,DEU,5,37,321,231,594
2017,Greece,GRC,Germany,DEU,0,0,5,12,17
2017,Guatemala,GTM,Germany,DEU,0,0,5,0,5
2017,Guinea,GIN,Germany,DEU,589,611,3204,2826,7230
2017,Haiti,HTI,Germany,DEU,0,0,10,0,10
2017,Honduras,HND,Germany,DEU,10,5,10,5,30
2017,Croatia,HRV,Germany,DEU,0,0,15,0,15
2017,Cote d'Ivoire,CIV,Germany,DEU,85,144,1164,1180,2573
2017,India,IND,Germany,DEU,39,58,2758,745,3600
2017,Indonesia,IDN,Germany,DEU,0,0,10,5,15
2017,Iran (Islamic Rep. of),IRN,Germany,DEU,13881,934,11174,3607,29596
2017,Iraq,IRQ,Germany,DEU,24009,15489,21751,7713,68962
2017,Israel,ISR,Germany,DEU,0,5,24,5,34
2017,Italy,ITA,Germany,DEU,0,0,12,5,17
2017,Jamaica,JAM,Germany,DEU,44,0,83,10,137
2017,Jordan,JOR,Germany,DEU,48,78,240,113,479
2017,Kazakhstan,KAZ,Germany,DEU,5,5,150,45,205
2017,Kenya,KEN,Germany,DEU,10,5,279,86,380
2017,Kyrgyzstan,KGZ,Germany,DEU,18,15,115,65,213
2017,Rep. of Korea,KOR,Germany,DEU,0,0,5,11,16
2017,Dem. People's Rep. of Korea,PRK,Germany,DEU,0,0,37,40,77
2017,Kuwait,KWT,Germany,DEU,5,0,17,32,54
2017,Liberia,LBR,Germany,DEU,12,5,91,140,248
2017,Libya,LBY,Germany,DEU,309,271,557,704,1841
2017,Lebanon,LBN,Germany,DEU,139,334,2985,670,4128
2017,Sri Lanka,LKA,Germany,DEU,134,52,814,230,1230
2017,Latvia,LVA,Germany,DEU,0,0,5,0,5
2017,Madagascar,MDG,Germany,DEU,0,0,5,0,5
2017,Mauritania,MRT,Germany,DEU,16,5,83,36,140
2017,North Macedonia,MKD,Germany,DEU,5,34,3378,508,3925
2017,Rep. of Moldova,MDA,Germany,DEU,15,10,1035,165,1225
2017,Mexico,MEX,Germany,DEU,0,0,5,0,5
2017,Mali,MLI,Germany,DEU,55,76,1017,659,1807
2017,Malaysia,MYS,Germany,DEU,5,0,11,0,16
2017,Mongolia,MNG,Germany,DEU,10,71,797,320,1198
2017,Morocco,MAR,Germany,DEU,85,133,1907,1287,3412
2017,Mozambique,MOZ,Germany,DEU,0,0,5,5,10
2017,Montenegro,MNE,Germany,DEU,0,0,531,78,609
2017,Mauritius,MUS,Germany,DEU,0,0,5,0,5
2017,Myanmar,MMR,Germany,DEU,137,37,46,39,259
2017,Nepal,NPL,Germany,DEU,5,5,105,24,139
2017,Netherlands,NLD,Germany,DEU,0,0,5,5,10
2017,Niger,NER,Germany,DEU,5,5,167,101,278
2017,Nicaragua,NIC,Germany,DEU,0,0,5,0,5
2017,Nigeria,NGA,Germany,DEU,1538,2328,12484,6002,22352
2017,Oman,OMN,Germany,DEU,5,0,5,0,10
2017,Pakistan,PAK,Germany,DEU,487,367,14605,3631,19090
2017,Peru,PER,Germany,DEU,0,0,5,5,10
2017,Philippines,PHL,Germany,DEU,0,5,20,10,35
2017,Poland,POL,Germany,DEU,0,0,18,0,18
2017,Portugal,PRT,Germany,DEU,0,0,0,5,5
2017,Romania,ROU,Germany,DEU,0,0,16,13,29
2017,South Africa,ZAF,Germany,DEU,0,0,18,5,23
2017,Russian Federation,RUS,Germany,DEU,707,651,9075,3973,14406
2017,Rwanda,RWA,Germany,DEU,23,5,44,5,77
2017,El Salvador,SLV,Germany,DEU,0,5,29,10,44
2017,Saudi Arabia,SAU,Germany,DEU,31,11,19,13,74
2017,Serbia and Kosovo: S/RES/1244 (1999),SRB,Germany,DEU,5,121,6255,1112,7493
2017,Senegal,SEN,Germany,DEU,33,42,946,402,1423
2017,Sierra Leone,SLE,Germany,DEU,155,185,954,565,1859
2017,Somalia,SOM,Germany,DEU,4814,6187,2287,4172,17460
2017,Spain,ESP,Germany,DEU,0,0,14,20,34
2017,Viet Nam,VNM,Germany,DEU,16,14,614,219,863
2017,Sudan,SDN,Germany,DEU,642,587,743,1426,3398
2017,South Sudan,SSD,Germany,DEU,16,14,22,51,103
2017,Syrian Arab Rep.,SYR,Germany,DEU,34201,55274,107,7309,96891
2017,United Rep. of Tanzania,TZA,Germany,DEU,24,13,81,38,156
2017,Thailand,THA,Germany,DEU,0,0,5,5,10
2017,Tajikistan,TJK,Germany,DEU,264,134,1406,899,2703
2017,Turkmenistan,TKM,Germany,DEU,5,17,146,67,235
2017,Togo,TGO,Germany,DEU,31,35,490,266,822
2017,Tunisia,TUN,Germany,DEU,11,20,500,337,868
2017,Turkey,TUR,Germany,DEU,3260,233,6602,1654,11749
2017,United Arab Emirates,ARE,Germany,DEU,5,0,5,0,10
2017,Uganda,UGA,Germany,DEU,42,11,216,37,306
2017,Ukraine,UKR,Germany,DEU,109,186,4071,1046,5412
2017,Uruguay,URY,Germany,DEU,0,0,0,5,5
2017,United States of America,USA,Germany,DEU,5,5,12,5,27
2017,Uzbekistan,UZB,Germany,DEU,19,12,44,25,100
2017,Venezuela (Bolivarian Republic of),VEN,Germany,DEU,53,28,127,5,213
2017,Yemen,YEM,Germany,DEU,176,703,13,161,1053
2017,Zambia,ZMB,Germany,DEU,0,0,5,0,5
2017,Zimbabwe,ZWE,Germany,DEU,98,13,195,36,342
2017,Stateless,XXA,Germany,DEU,1374,1188,728,401,3691
2017,Unknown ,,Germany,DEU,3024,3711,4284,2061,13080
2018,Afghanistan,AFG,Germany,DEU,1994,4130,6143,3229,15496
2018,Albania,ALB,Germany,DEU,5,22,1683,356,2066
2018,Algeria,DZA,Germany,DEU,12,20,763,890,1685
2018,Angola,AGO,Germany,DEU,12,32,123,145,312
2018,Egypt,EGY,Germany,DEU,83,28,498,212,821
2018,Argentina,ARG,Germany,DEU,0,0,5,0,5
2018,Armenia,ARM,Germany,DEU,23,126,1896,644,2689
2018,Azerbaijan,AZE,Germany,DEU,134,74,1632,854,2694
2018,Bahrain,BHR,Germany,DEU,10,5,5,0,20
2018,Burundi,BDI,Germany,DEU,10,10,20,5,45
2018,Benin,BEN,Germany,DEU,0,0,81,60,141
2018,Bangladesh,BGD,Germany,DEU,30,17,268,80,395
2018,Bhutan,BTN,Germany,DEU,0,0,5,0,5
2018,Burkina Faso,BFA,Germany,DEU,5,0,82,58,145
2018,Belarus,BLR,Germany,DEU,0,5,73,144,222
2018,Botswana,BWA,Germany,DEU,0,0,5,0,5
2018,Brazil,BRA,Germany,DEU,0,0,13,0,13
2018,Bosnia and Herzegovina,BIH,Germany,DEU,0,5,346,68,419
2018,Bulgaria,BGR,Germany,DEU,0,0,5,5,10
2018,Cambodia,KHM,Germany,DEU,0,0,14,5,19
2018,Canada,CAN,Germany,DEU,0,0,5,0,5
2018,Central African Rep.,CAF,Germany,DEU,0,0,18,10,28
2018,Chad,TCD,Germany,DEU,0,5,37,69,111
2018,China,CHN,Germany,DEU,65,5,211,177,458
2018,Cameroon,CMR,Germany,DEU,44,64,926,431,1465
2018,Congo,COG,Germany,DEU,5,5,24,10,44
2018,Dem. Rep. of the Congo,COD,Germany,DEU,40,31,166,43,280
2018,Comoros,COM,Germany,DEU,0,0,5,5,10
2018,Colombia,COL,Germany,DEU,0,5,116,10,131
2018,Cuba,CUB,Germany,DEU,0,0,61,23,84
2018,Djibouti,DJI,Germany,DEU,5,0,5,5,15
2018,Dominican Rep.,DOM,Germany,DEU,0,0,5,0,5
2018,Equatorial Guinea,GNQ,Germany,DEU,0,0,5,0,5
2018,Eritrea,ERI,Germany,DEU,2218,2969,332,1676,7195
2018,Ethiopia,ETH,Germany,DEU,201,198,1044,338,1781
2018,Gabon,GAB,Germany,DEU,0,5,18,5,28
2018,Gambia,GMB,Germany,DEU,122,139,2476,1116,3853
2018,Georgia,GEO,Germany,DEU,10,50,4022,491,4573
2018,Ghana,GHA,Germany,DEU,13,44,717,317,1091
2018,Guinea-Bissau,GNB,Germany,DEU,5,10,101,141,257
2018,Greece,GRC,Germany,DEU,0,0,5,0,5
2018,Guinea,GIN,Germany,DEU,321,254,1860,1112,3547
2018,Haiti,HTI,Germany,DEU,0,0,5,0,5
2018,Honduras,HND,Germany,DEU,0,5,5,0,10
2018,Croatia,HRV,Germany,DEU,0,0,5,0,5
2018,Hungary,HUN,Germany,DEU,0,0,0,5,5
2018,Cote d'Ivoire,CIV,Germany,DEU,47,80,809,312,1248
2018,India,IND,Germany,DEU,11,12,739,210,972
2018,Indonesia,IDN,Germany,DEU,0,5,5,5,15
2018,Iran (Islamic Rep. of),IRN,Germany,DEU,2315,226,5023,2841,10405
2018,Iraq,IRQ,Germany,DEU,4249,2022,7364,4273,17908
2018,Israel,ISR,Germany,DEU,0,0,20,0,20
2018,Italy,ITA,Germany,DEU,0,0,21,5,26
2018,Jamaica,JAM,Germany,DEU,14,0,14,5,33
2018,Jordan,JOR,Germany,DEU,13,20,109,78,220
2018,Kazakhstan,KAZ,Germany,DEU,5,0,39,24,68
2018,Kenya,KEN,Germany,DEU,0,5,199,126,330
2018,Kyrgyzstan,KGZ,Germany,DEU,5,12,106,23,146
2018,Rep. of Korea,KOR,Germany,DEU,0,0,13,0,13
2018,Dem. People's Rep. of Korea,PRK,Germany,DEU,0,0,12,5,17
2018,Kuwait,KWT,Germany,DEU,0,0,10,20,30
2018,Liberia,LBR,Germany,DEU,12,18,134,94,258
2018,Libya,LBY,Germany,DEU,77,121,428,580,1206
2018,Lebanon,LBN,Germany,DEU,17,48,626,221,912
2018,Sri Lanka,LKA,Germany,DEU,46,25,366,128,565
2018,Latvia,LVA,Germany,DEU,0,0,5,0,5
2018,Madagascar,MDG,Germany,DEU,0,0,5,0,5
2018,Mauritania,MRT,Germany,DEU,10,0,21,16,47
2018,North Macedonia,MKD,Germany,DEU,0,11,1160,165,1336
2018,Rep. of Moldova,MDA,Germany,DEU,5,11,1495,84,1595
2018,Mexico,MEX,Germany,DEU,0,5,0,0,5
2018,Mali,MLI,Germany,DEU,12,26,240,202,480
2018,Malaysia,MYS,Germany,DEU,5,0,10,0,15
2018,Mongolia,MNG,Germany,DEU,5,15,161,51,232
2018,Morocco,MAR,Germany,DEU,29,39,814,558,1440
2018,Mozambique,MOZ,Germany,DEU,0,5,17,12,34
2018,Montenegro,MNE,Germany,DEU,0,0,160,12,172
2018,Myanmar,MMR,Germany,DEU,42,0,19,18,79
2018,Namibia,NAM,Germany,DEU,0,0,5,0,5
2018,Nepal,NPL,Germany,DEU,0,10,33,15,58
2018,Netherlands,NLD,Germany,DEU,0,0,5,0,5
2018,Niger,NER,Germany,DEU,0,10,56,53,119
2018,Nicaragua,NIC,Germany,DEU,0,0,5,0,5
2018,Nigeria,NGA,Germany,DEU,752,945,5672,4595,11964
2018,Pakistan,PAK,Germany,DEU,117,73,2479,844,3513
2018,Philippines,PHL,Germany,DEU,0,5,21,5,31
2018,Poland,POL,Germany,DEU,0,0,5,0,5
2018,South Africa,ZAF,Germany,DEU,0,0,16,10,26
2018,Russian Federation,RUS,Germany,DEU,548,199,3737,1818,6302
2018,Rwanda,RWA,Germany,DEU,28,5,45,11,89
2018,El Salvador,SLV,Germany,DEU,0,5,17,0,22
2018,Saudi Arabia,SAU,Germany,DEU,12,5,14,5,36
2018,Serbia and Kosovo: S/RES/1244 (1999),SRB,Germany,DEU,0,32,1705,320,2057
2018,Senegal,SEN,Germany,DEU,5,5,172,168,350
2018,Sierra Leone,SLE,Germany,DEU,51,60,560,166,837
2018,Somalia,SOM,Germany,DEU,1853,1262,1687,2276,7078
2018,Spain,ESP,Germany,DEU,0,0,24,5,29
2018,Viet Nam,VNM,Germany,DEU,5,10,491,75,581
2018,Sudan,SDN,Germany,DEU,226,215,431,666,1538
2018,South Sudan,SSD,Germany,DEU,5,14,37,25,81
2018,Syrian Arab Rep.,SYR,Germany,DEU,17503,17451,47,6855,41856
2018,United Rep. of Tanzania,TZA,Germany,DEU,0,5,56,32,93
2018,Thailand,THA,Germany,DEU,0,0,5,0,5
2018,Tajikistan,TJK,Germany,DEU,68,30,530,261,889
2018,Turkmenistan,TKM,Germany,DEU,12,5,60,5,82
2018,Togo,TGO,Germany,DEU,14,18,359,170,561
2018,Tunisia,TUN,Germany,DEU,10,10,323,361,704
2018,Turkey,TUR,Germany,DEU,3644,92,4090,793,8619
2018,Uganda,UGA,Germany,DEU,31,5,51,31,118
2018,Ukraine,UKR,Germany,DEU,20,53,1107,181,1361
2018,United States of America,USA,Germany,DEU,5,0,18,5,28
2018,Uzbekistan,UZB,Germany,DEU,0,5,41,10,56
2018,Venezuela (Bolivarian Republic of),VEN,Germany,DEU,66,27,189,12,294
2018,Yemen,YEM,Germany,DEU,75,504,15,213,807
2018,Zambia,ZMB,Germany,DEU,0,0,5,0,5
2018,Zimbabwe,ZWE,Germany,DEU,25,5,92,18,140
2018,Stateless,XXA,Germany,DEU,687,217,216,282,1402
2018,Unknown ,,Germany,DEU,1577,546,1616,1215,4954
2019,Afghanistan,AFG,Germany,DEU,1619,2363,2543,3096,9621
2019,Albania,ALB,Germany,DEU,5,13,1411,244,1673
2019,Algeria,DZA,Germany,DEU,5,21,573,548,1147
2019,Angola,AGO,Germany,DEU,5,26,96,201,328
2019,Egypt,EGY,Germany,DEU,91,12,340,197,640
2019,Argentina,ARG,Germany,DEU,0,0,10,5,15
2019,Armenia,ARM,Germany,DEU,5,57,856,364,1282
2019,Azerbaijan,AZE,Germany,DEU,58,24,1090,510,1682
2019,Bahrain,BHR,Germany,DEU,5,0,0,0,5
2019,Burundi,BDI,Germany,DEU,10,0,5,5,20
2019,Benin,BEN,Germany,DEU,5,5,48,59,117
2019,Bangladesh,BGD,Germany,DEU,18,5,128,40,191
2019,Burkina Faso,BFA,Germany,DEU,5,5,61,55,126
2019,Belarus,BLR,Germany,DEU,5,0,51,225,281
2019,Brazil,BRA,Germany,DEU,0,0,17,0,17
2019,Bosnia and Herzegovina,BIH,Germany,DEU,0,5,251,44,300
2019,Bulgaria,BGR,Germany,DEU,0,0,5,0,5
2019,Cambodia,KHM,Germany,DEU,0,5,25,0,30
2019,Canada,CAN,Germany,DEU,0,0,5,0,5
2019,Central African Rep.,CAF,Germany,DEU,0,0,10,10,20
2019,Chad,TCD,Germany,DEU,5,0,20,31,56
2019,China,CHN,Germany,DEU,157,5,200,483,845
2019,Cameroon,CMR,Germany,DEU,34,30,613,284,961
2019,Congo,COG,Germany,DEU,5,0,18,18,41
2019,Dem. Rep. of the Congo,COD,Germany,DEU,14,26,135,59,234
2019,Comoros,COM,Germany,DEU,0,0,5,0,5
2019,Colombia,COL,Germany,DEU,0,0,235,5,240
2019,Cuba,CUB,Germany,DEU,0,0,25,14,39
2019,Cabo Verde,CPV,Germany,DEU,0,0,0,5,5
2019,Djibouti,DJI,Germany,DEU,0,0,5,5,10
2019,Dominican Rep.,DOM,Germany,DEU,0,0,5,5,10
2019,Ecuador,ECU,Germany,DEU,0,0,5,0,5
2019,Equatorial Guinea,GNQ,Germany,DEU,0,0,5,5,10
2019,Eritrea,ERI,Germany,DEU,2115,1141,362,633,4251
2019,Ethiopia,ETH,Germany,DEU,147,85,628,250,1110
2019,France,FRA,Germany,DEU,0,0,5,0,5
2019,Gabon,GAB,Germany,DEU,0,5,5,17,27
2019,Gambia,GMB,Germany,DEU,39,29,619,640,1327
2019,Georgia,GEO,Germany,DEU,5,16,2738,463,3222
2019,Ghana,GHA,Germany,DEU,5,16,502,421,944
2019,Guinea-Bissau,GNB,Germany,DEU,0,5,69,107,181
2019,Guatemala,GTM,Germany,DEU,0,0,10,0,10
2019,Guinea,GIN,Germany,DEU,353,183,1582,888,3006
2019,Haiti,HTI,Germany,DEU,0,0,5,0,5
2019,Honduras,HND,Germany,DEU,0,0,30,0,30
2019,Croatia,HRV,Germany,DEU,0,0,5,0,5
2019,Cote d'Ivoire,CIV,Germany,DEU,27,28,470,266,791
2019,India,IND,Germany,DEU,5,5,436,201,647
2019,Indonesia,IDN,Germany,DEU,0,0,5,0,5
2019,Iran (Islamic Rep. of),IRN,Germany,DEU,1753,158,5161,2200,9272
2019,Iraq,IRQ,Germany,DEU,4558,1452,5533,4225,15768
2019,Israel,ISR,Germany,DEU,0,0,5,5,10
2019,Italy,ITA,Germany,DEU,0,0,12,5,17
2019,Jamaica,JAM,Germany,DEU,10,0,15,5,30
2019,Jordan,JOR,Germany,DEU,5,10,116,122,253
2019,Kazakhstan,KAZ,Germany,DEU,0,0,62,30,92
2019,Kenya,KEN,Germany,DEU,0,5,140,88,233
2019,Kyrgyzstan,KGZ,Germany,DEU,5,10,58,19,92
2019,Rep. of Korea,KOR,Germany,DEU,0,0,10,0,10
2019,Dem. People's Rep. of Korea,PRK,Germany,DEU,0,0,5,0,5
2019,Kuwait,KWT,Germany,DEU,0,0,5,15,20
2019,Liberia,LBR,Germany,DEU,5,11,86,52,154
2019,Libya,LBY,Germany,DEU,54,110,274,261,699
2019,Lebanon,LBN,Germany,DEU,18,19,424,285,746
2019,Sri Lanka,LKA,Germany,DEU,37,14,172,74,297
2019,Lithuania,LTU,Germany,DEU,0,0,5,0,5
2019,Madagascar,MDG,Germany,DEU,0,0,5,5,10
2019,Mauritania,MRT,Germany,DEU,0,0,12,18,30
2019,North Macedonia,MKD,Germany,DEU,0,5,970,205,1180
2019,Rep. of Moldova,MDA,Germany,DEU,0,12,1300,262,1574
2019,Mexico,MEX,Germany,DEU,0,0,5,5,10
2019,Mali,MLI,Germany,DEU,19,24,121,157,321
2019,Malaysia,MYS,Germany,DEU,0,0,5,0,5
2019,Mongolia,MNG,Germany,DEU,5,15,86,47,153
2019,Morocco,MAR,Germany,DEU,10,27,590,403,1030
2019,Mozambique,MOZ,Germany,DEU,0,0,0,5,5
2019,Montenegro,MNE,Germany,DEU,0,0,83,18,101
2019,Mauritius,MUS,Germany,DEU,0,0,5,0,5
2019,Myanmar,MMR,Germany,DEU,27,5,40,20,92
2019,Namibia,NAM,Germany,DEU,0,0,11,0,11
2019,Nepal,NPL,Germany,DEU,0,5,11,5,21
2019,Niger,NER,Germany,DEU,0,0,38,45,83
2019,Nicaragua,NIC,Germany,DEU,0,0,76,5,81
2019,Nigeria,NGA,Germany,DEU,429,437,5337,5650,11853
2019,Pakistan,PAK,Germany,DEU,154,28,1368,816,2366
2019,Peru,PER,Germany,DEU,0,5,5,0,10
2019,Philippines,PHL,Germany,DEU,0,0,10,5,15
2019,Poland,POL,Germany,DEU,0,0,10,0,10
2019,Romania,ROU,Germany,DEU,0,0,5,0,5
2019,South Africa,ZAF,Germany,DEU,0,0,22,13,35
2019,Russian Federation,RUS,Germany,DEU,210,67,2087,1567,3931
2019,Rwanda,RWA,Germany,DEU,27,0,36,26,89
2019,El Salvador,SLV,Germany,DEU,0,44,5,0,49
2019,Saudi Arabia,SAU,Germany,DEU,21,0,5,5,31
2019,Serbia and Kosovo: S/RES/1244 (1999),SRB,Germany,DEU,0,5,1269,300,1574
2019,Senegal,SEN,Germany,DEU,10,5,139,173,327
2019,Sierra Leone,SLE,Germany,DEU,31,31,215,88,365
2019,Somalia,SOM,Germany,DEU,1604,501,959,1445,4509
2019,Spain,ESP,Germany,DEU,0,0,5,0,5
2019,Viet Nam,VNM,Germany,DEU,0,5,680,124,809
2019,Sudan,SDN,Germany,DEU,74,31,295,309,709
2019,South Sudan,SSD,Germany,DEU,5,0,14,10,29
2019,Eswatini,SWZ,Germany,DEU,0,0,5,0,5
2019,Sweden,SWE,Germany,DEU,0,0,5,0,5
2019,Syrian Arab Rep.,SYR,Germany,DEU,22158,15486,39,6340,44023
2019,United Rep. of Tanzania,TZA,Germany,DEU,0,0,65,120,185
2019,Thailand,THA,Germany,DEU,0,0,0,5,5
2019,Tajikistan,TJK,Germany,DEU,59,29,249,134,471
2019,Turkmenistan,TKM,Germany,DEU,0,0,52,5,57
2019,Togo,TGO,Germany,DEU,14,10,173,121,318
2019,Tunisia,TUN,Germany,DEU,5,0,293,234,532
2019,Turkey,TUR,Germany,DEU,4809,62,4251,658,9780
2019,Uganda,UGA,Germany,DEU,21,5,86,13,125
2019,Ukraine,UKR,Germany,DEU,10,41,808,240,1099
2019,United States of America,USA,Germany,DEU,0,0,12,5,17
2019,Uzbekistan,UZB,Germany,DEU,14,5,10,29,58
2019,Venezuela (Bolivarian Republic of),VEN,Germany,DEU,67,53,142,14,276
2019,Yemen,YEM,Germany,DEU,100,611,18,158,887
2019,Zambia,ZMB,Germany,DEU,0,0,5,0,5
2019,Zimbabwe,ZWE,Germany,DEU,5,0,46,44,95
2019,Stateless,XXA,Germany,DEU,536,73,66,128,803
2019,Unknown ,,Germany,DEU,2178,397,883,836,4294
2020,Afghanistan,AFG,Germany,DEU,1877,2079,1958,2638,8552
2020,Albania,ALB,Germany,DEU,5,5,185,820,1015
2020,Algeria,DZA,Germany,DEU,13,10,620,535,1178
2020,Angola,AGO,Germany,DEU,5,33,81,161,280
2020,Egypt,EGY,Germany,DEU,83,19,105,354,561
2020,Argentina,ARG,Germany,DEU,0,0,0,11,11
2020,Armenia,ARM,Germany,DEU,10,26,122,588,746
2020,Austria,AUT,Germany,DEU,0,0,5,0,5
2020,Azerbaijan,AZE,Germany,DEU,59,12,136,726,933
2020,Bahrain,BHR,Germany,DEU,5,0,0,0,5
2020,Burundi,BDI,Germany,DEU,0,0,0,14,14
2020,Belgium,BEL,Germany,DEU,0,0,0,5,5
2020,Benin,BEN,Germany,DEU,0,5,33,56,94
2020,Bangladesh,BGD,Germany,DEU,15,0,39,120,174
2020,Burkina Faso,BFA,Germany,DEU,10,5,23,56,94
2020,Belarus,BLR,Germany,DEU,5,0,88,25,118
2020,Brazil,BRA,Germany,DEU,5,0,5,24,34
2020,Bosnia and Herzegovina,BIH,Germany,DEU,0,5,41,138,184
2020,Bulgaria,BGR,Germany,DEU,0,0,5,5,10
2020,Cambodia,KHM,Germany,DEU,0,0,0,10,10
2020,Canada,CAN,Germany,DEU,0,0,0,5,5
2020,Central African Rep.,CAF,Germany,DEU,0,0,5,5,10
2020,Chad,TCD,Germany,DEU,5,0,25,51,81
2020,China,CHN,Germany,DEU,138,0,118,188,444
2020,Chile,CHL,Germany,DEU,0,0,0,5,5
2020,Cameroon,CMR,Germany,DEU,29,13,124,622,788
2020,Congo,COG,Germany,DEU,5,0,10,22,37
2020,Dem. Rep. of the Congo,COD,Germany,DEU,5,23,35,118,181
2020,Colombia,COL,Germany,DEU,0,0,11,509,520
2020,Costa Rica,CRI,Germany,DEU,0,0,0,5,5
2020,Cuba,CUB,Germany,DEU,0,0,5,35,40
2020,Djibouti,DJI,Germany,DEU,5,0,0,5,10
2020,Dominican Rep.,DOM,Germany,DEU,0,0,0,5,5
2020,Equatorial Guinea,GNQ,Germany,DEU,5,0,0,0,5
2020,Eritrea,ERI,Germany,DEU,2715,188,238,299,3440
2020,Ethiopia,ETH,Germany,DEU,153,82,88,470,793
2020,Gabon,GAB,Germany,DEU,0,0,0,12,12
2020,Gambia,GMB,Germany,DEU,58,16,347,413,834
2020,Palestinian,PSE,Germany,DEU,48,5,54,111,218
2020,United Kingdom of Great Britain and Northern Ireland,GBR,Germany,DEU,0,0,0,10,10
2020,Georgia,GEO,Germany,DEU,5,18,520,1709,2252
2020,Ghana,GHA,Germany,DEU,10,12,152,443,617
2020,Guinea-Bissau,GNB,Germany,DEU,0,0,32,42,74
2020,Guatemala,GTM,Germany,DEU,0,0,0,5,5
2020,Guinea,GIN,Germany,DEU,393,88,338,1084,1903
2020,Haiti,HTI,Germany,DEU,0,0,0,13,13
2020,Honduras,HND,Germany,DEU,5,0,5,35,45
2020,Cote d'Ivoire,CIV,Germany,DEU,36,13,107,341,497
2020,India,IND,Germany,DEU,0,5,89,303,397
2020,Indonesia,IDN,Germany,DEU,0,0,0,5,5
2020,Iran (Islamic Rep. of),IRN,Germany,DEU,1561,33,725,4458,6777
2020,Iraq,IRQ,Germany,DEU,3785,662,1792,4637,10876
2020,Israel,ISR,Germany,DEU,0,0,0,5,5
2020,Italy,ITA,Germany,DEU,0,0,0,5,5
2020,Jamaica,JAM,Germany,DEU,5,0,0,19,24
2020,Jordan,JOR,Germany,DEU,5,10,49,124,188
2020,Kazakhstan,KAZ,Germany,DEU,0,0,17,92,109
2020,Kenya,KEN,Germany,DEU,5,0,34,283,322
2020,Kyrgyzstan,KGZ,Germany,DEU,32,0,13,75,120
2020,Rep. of Korea,KOR,Germany,DEU,0,0,5,5,10
2020,Kuwait,KWT,Germany,DEU,0,0,5,0,5
2020,Liberia,LBR,Germany,DEU,12,5,34,78,129
2020,Libya,LBY,Germany,DEU,242,30,194,242,708
2020,Lebanon,LBN,Germany,DEU,28,18,224,551,821
2020,Sri Lanka,LKA,Germany,DEU,43,13,40,204,300
2020,Lithuania,LTU,Germany,DEU,0,0,0,5,5
2020,Madagascar,MDG,Germany,DEU,0,0,0,5,5
2020,Mauritania,MRT,Germany,DEU,10,0,10,22,42
2020,North Macedonia,MKD,Germany,DEU,0,0,97,365,462
2020,Rep. of Moldova,MDA,Germany,DEU,0,10,495,1069,1574
2020,Mexico,MEX,Germany,DEU,0,0,0,18,18
2020,Mali,MLI,Germany,DEU,26,10,65,106,207
2020,Malaysia,MYS,Germany,DEU,0,0,0,5,5
2020,Malawi,MWI,Germany,DEU,0,0,5,0,5
2020,Mongolia,MNG,Germany,DEU,5,0,27,104,136
2020,Morocco,MAR,Germany,DEU,12,11,374,580,977
2020,Mozambique,MOZ,Germany,DEU,0,13,0,0,13
2020,Montenegro,MNE,Germany,DEU,0,0,10,67,77
2020,Mauritius,MUS,Germany,DEU,0,0,0,5,5
2020,Myanmar,MMR,Germany,DEU,22,0,14,302,338
2020,Namibia,NAM,Germany,DEU,0,0,0,28,28
2020,Nepal,NPL,Germany,DEU,0,0,0,5,5
2020,Netherlands,NLD,Germany,DEU,0,0,0,12,12
2020,Niger,NER,Germany,DEU,0,5,15,29,49
2020,Nicaragua,NIC,Germany,DEU,0,0,0,72,72
2020,Nigeria,NGA,Germany,DEU,303,228,1343,3795,5669
2020,Norway,NOR,Germany,DEU,0,0,0,11,11
2020,Oman,OMN,Germany,DEU,0,0,0,5,5
2020,Pakistan,PAK,Germany,DEU,147,30,341,1088,1606
2020,Paraguay,PRY,Germany,DEU,0,0,0,10,10
2020,Peru,PER,Germany,DEU,0,0,0,17,17
2020,Philippines,PHL,Germany,DEU,0,0,0,12,12
2020,Poland,POL,Germany,DEU,0,0,0,5,5
2020,Romania,ROU,Germany,DEU,0,0,0,10,10
2020,South Africa,ZAF,Germany,DEU,0,0,5,16,21
2020,Russian Federation,RUS,Germany,DEU,148,27,959,1750,2884
2020,Rwanda,RWA,Germany,DEU,38,0,10,94,142
2020,El Salvador,SLV,Germany,DEU,33,0,0,15,48
2020,Saudi Arabia,SAU,Germany,DEU,20,0,5,5,30
2020,Serbia and Kosovo: S/RES/1244 (1999),SRB,Germany,DEU,0,5,224,764,993
2020,Senegal,SEN,Germany,DEU,5,0,61,122,188
2020,Sierra Leone,SLE,Germany,DEU,30,16,48,152,246
2020,Somalia,SOM,Germany,DEU,1599,165,760,521,3045
2020,Spain,ESP,Germany,DEU,0,0,0,12,12
2020,Viet Nam,VNM,Germany,DEU,0,5,285,812,1102
2020,Sudan,SDN,Germany,DEU,86,17,96,360,559
2020,South Sudan,SSD,Germany,DEU,12,5,5,19,41
2020,Syrian Arab Rep.,SYR,Germany,DEU,33940,92,3139,28,37199
2020,United Rep. of Tanzania,TZA,Germany,DEU,5,0,17,101,123
2020,Thailand,THA,Germany,DEU,0,5,0,11,16
2020,Tajikistan,TJK,Germany,DEU,67,5,105,298,475
2020,Turkmenistan,TKM,Germany,DEU,0,0,11,13,24
2020,Togo,TGO,Germany,DEU,0,5,57,138,200
2020,Trinidad and Tobago,TTO,Germany,DEU,0,0,0,5,5
2020,Tunisia,TUN,Germany,DEU,10,0,203,304,517
2020,Turkey,TUR,Germany,DEU,4162,27,577,4492,9258
2020,Uganda,UGA,Germany,DEU,10,0,12,73,95
2020,Ukraine,UKR,Germany,DEU,5,27,143,630,805
2020,United States of America,USA,Germany,DEU,0,5,0,10,15
2020,Uzbekistan,UZB,Germany,DEU,5,0,5,14,24
2020,Venezuela (Bolivarian Republic of),VEN,Germany,DEU,127,360,14,633,1134
2020,Yemen,YEM,Germany,DEU,373,23,56,120,572
2020,Zambia,ZMB,Germany,DEU,0,0,0,5,5
2020,Zimbabwe,ZWE,Germany,DEU,10,5,15,75,105
2020,Stateless,XXA,Germany,DEU,254,0,43,44,341
2020,Unknown ,,Germany,DEU,2499,65,556,746,3866
2000,Unknown ,,United Kingdom of Great Britain and Northern Ireland,GBR,250,180,605,125,1160
2001,Unknown ,,United Kingdom of Great Britain and Northern Ireland,GBR,3810,2950,14120,370,21250
2002,Unknown ,,United Kingdom of Great Britain and Northern Ireland,GBR,2005,975,1700,40,4720
2003,Unknown ,,United Kingdom of Great Britain and Northern Ireland,GBR,445,365,2950,70,3830
2004,Unknown ,,United Kingdom of Great Britain and Northern Ireland,GBR,530,215,3860,360,4965
2005,Unknown ,,United Kingdom of Great Britain and Northern Ireland,GBR,285,135,2215,225,2860
2007,Unknown ,,United Kingdom of Great Britain and Northern Ireland,GBR,340,190,850,70,1450
2014,Albania,ALB,Luxembourg,LUX,0,0,0,17,17
2014,Serbia and Kosovo: S/RES/1244 (1999),SRB,Luxembourg,LUX,0,0,0,17,17
2015,Albania,ALB,Luxembourg,LUX,0,0,0,16,16
2015,Montenegro,MNE,Luxembourg,LUX,0,0,0,5,5
2015,Serbia and Kosovo: S/RES/1244 (1999),SRB,Luxembourg,LUX,0,0,0,30,30
2016,Albania,ALB,Luxembourg,LUX,0,0,0,11,11
2016,Azerbaijan,AZE,Luxembourg,LUX,0,0,0,5,5
2016,Serbia and Kosovo: S/RES/1244 (1999),SRB,Luxembourg,LUX,0,0,0,5,5
2017,Afghanistan,AFG,Finland,FIN,5,0,42,65,112
2017,Bangladesh,BGD,Finland,FIN,0,0,0,5,5
2017,Cameroon,CMR,Finland,FIN,0,0,10,5,15
2017,Guinea,GIN,Finland,FIN,0,0,0,5,5
2017,Iran (Islamic Rep. of),IRN,Finland,FIN,0,0,5,5,10
2017,Iraq,IRQ,Finland,FIN,14,0,164,276,454
2017,Morocco,MAR,Finland,FIN,0,0,5,5,10
2017,Nigeria,NGA,Finland,FIN,0,0,5,12,17
2017,Russian Federation,RUS,Finland,FIN,0,0,5,5,10
2017,Somalia,SOM,Finland,FIN,0,0,5,23,28
2017,Syrian Arab Rep.,SYR,Finland,FIN,0,5,0,0,5
2017,Turkey,TUR,Finland,FIN,0,0,5,5,10
2017,Ukraine,UKR,Finland,FIN,0,0,0,5,5
2017,Unknown ,,Finland,FIN,0,0,0,5,5
2019,Afghanistan,AFG,Finland,FIN,38,13,154,98,303
2019,Albania,ALB,Finland,FIN,0,0,0,5,5
2019,Algeria,DZA,Finland,FIN,0,0,0,10,10
2019,Azerbaijan,AZE,Finland,FIN,0,0,0,5,5
2019,Bangladesh,BGD,Finland,FIN,0,0,0,5,5
2019,Cameroon,CMR,Finland,FIN,5,0,14,5,24
2019,Dem. Rep. of the Congo,COD,Finland,FIN,0,0,5,5,10
2019,Ethiopia,ETH,Finland,FIN,0,0,5,5,10
2019,Georgia,GEO,Finland,FIN,0,0,5,5,10
2019,Iran (Islamic Rep. of),IRN,Finland,FIN,10,0,46,29,85
2019,Iraq,IRQ,Finland,FIN,184,33,850,507,1574
2019,Jordan,JOR,Finland,FIN,0,0,5,0,5
2019,Lebanon,LBN,Finland,FIN,0,0,0,5,5
2019,Morocco,MAR,Finland,FIN,0,0,0,10,10
2019,Nigeria,NGA,Finland,FIN,0,0,12,5,17
2019,Pakistan,PAK,Finland,FIN,5,0,5,5,15
2019,Russian Federation,RUS,Finland,FIN,10,0,18,10,38
2019,Somalia,SOM,Finland,FIN,21,0,92,216,329
2019,Syrian Arab Rep.,SYR,Finland,FIN,0,0,0,5,5
2019,Turkey,TUR,Finland,FIN,10,0,11,10,31
2019,Ukraine,UKR,Finland,FIN,0,0,5,5,10
2019,Stateless,XXA,Finland,FIN,0,0,0,5,5
2019,Unknown ,,Finland,FIN,0,0,5,5,10
2000,Afghanistan,AFG,Germany,DEU,0,31,17,55,103
2000,Albania,ALB,Germany,DEU,0,0,0,158,158
2000,Algeria,DZA,Germany,DEU,5,5,21,429,460
2000,Angola,AGO,Germany,DEU,0,28,5,106,139
2000,Egypt,EGY,Germany,DEU,0,0,0,37,37
2000,Armenia,ARM,Germany,DEU,0,5,36,428,469
2000,Azerbaijan,AZE,Germany,DEU,5,0,5,153,163
2000,Benin,BEN,Germany,DEU,0,0,0,5,5
2000,Bangladesh,BGD,Germany,DEU,0,0,11,109,120
2000,Bhutan,BTN,Germany,DEU,0,0,0,5,5
2000,Burkina Faso,BFA,Germany,DEU,0,0,0,13,13
2000,Belarus,BLR,Germany,DEU,0,0,5,58,63
2000,Bosnia and Herzegovina,BIH,Germany,DEU,0,5,51,918,974
2000,Bulgaria,BGR,Germany,DEU,0,0,0,55,55
2000,China,CHN,Germany,DEU,0,0,13,122,135
2000,Cameroon,CMR,Germany,DEU,0,0,10,58,68
2000,Dem. Rep. of the Congo,COD,Germany,DEU,5,5,58,617,685
2000,Cuba,CUB,Germany,DEU,0,0,0,5,5
2000,Czechia,CZE,Germany,DEU,0,0,0,10,10
2000,Eritrea,ERI,Germany,DEU,0,0,5,25,30
2000,Ethiopia,ETH,Germany,DEU,5,5,5,99,114
2000,Gambia,GMB,Germany,DEU,0,0,0,5,5
2000,Georgia,GEO,Germany,DEU,0,0,20,259,279
2000,Ghana,GHA,Germany,DEU,0,0,11,112,123
2000,Guinea-Bissau,GNB,Germany,DEU,0,0,0,5,5
2000,Guinea,GIN,Germany,DEU,0,0,0,106,106
2000,Croatia,HRV,Germany,DEU,0,0,10,124,134
2000,Hungary,HUN,Germany,DEU,0,0,0,28,28
2000,Cote d'Ivoire,CIV,Germany,DEU,0,0,0,29,29
2000,India,IND,Germany,DEU,5,5,20,339,369
2000,Iran (Islamic Rep. of),IRN,Germany,DEU,52,12,73,711,848
2000,Iraq,IRQ,Germany,DEU,22,0,5,368,395
2000,Jordan,JOR,Germany,DEU,0,0,5,40,45
2000,Kazakhstan,KAZ,Germany,DEU,0,0,0,13,13
2000,Kenya,KEN,Germany,DEU,0,0,0,10,10
2000,Dem. People's Rep. of Korea,PRK,Germany,DEU,0,0,0,5,5
2000,Liberia,LBR,Germany,DEU,0,0,0,32,32
2000,Libya,LBY,Germany,DEU,0,0,0,10,10
2000,Lebanon,LBN,Germany,DEU,0,0,38,184,222
2000,Sri Lanka,LKA,Germany,DEU,5,0,44,717,766
2000,Lithuania,LTU,Germany,DEU,0,0,0,20,20
2000,Latvia,LVA,Germany,DEU,0,0,0,5,5
2000,North Macedonia,MKD,Germany,DEU,0,0,29,382,411
2000,Rep. of Moldova,MDA,Germany,DEU,0,0,5,58,63
2000,Mali,MLI,Germany,DEU,0,0,0,5,5
2000,Mongolia,MNG,Germany,DEU,0,0,0,20,20
2000,Morocco,MAR,Germany,DEU,0,0,0,81,81
2000,Nepal,NPL,Germany,DEU,0,0,0,57,57
2000,Niger,NER,Germany,DEU,0,0,0,14,14
2000,Nigeria,NGA,Germany,DEU,0,0,12,116,128
2000,Pakistan,PAK,Germany,DEU,17,5,39,815,876
2000,Peru,PER,Germany,DEU,0,0,0,5,5
2000,Philippines,PHL,Germany,DEU,0,0,0,5,5
2000,Poland,POL,Germany,DEU,0,0,46,37,83
2000,Romania,ROU,Germany,DEU,0,0,11,117,128
2000,Russian Federation,RUS,Germany,DEU,0,5,5,204,214
2000,Serbia and Kosovo: S/RES/1244 (1999),SRB,Germany,DEU,10,63,325,8629,9027
2000,Senegal,SEN,Germany,DEU,0,0,0,5,5
2000,Sierra Leone,SLE,Germany,DEU,0,0,5,26,31
2000,Somalia,SOM,Germany,DEU,0,0,0,15,15
2000,Viet Nam,VNM,Germany,DEU,0,0,21,462,483
2000,Sudan,SDN,Germany,DEU,5,0,5,37,47
2000,Slovakia,SVK,Germany,DEU,0,0,0,123,123
2000,Slovenia,SVN,Germany,DEU,0,0,0,10,10
2000,Syrian Arab Rep.,SYR,Germany,DEU,18,0,28,424,470
2000,Tajikistan,TJK,Germany,DEU,0,0,0,5,5
2000,Togo,TGO,Germany,DEU,12,5,43,348,408
2000,Tunisia,TUN,Germany,DEU,0,0,5,41,46
2000,Turkey,TUR,Germany,DEU,367,43,488,4742,5640
2000,Uganda,UGA,Germany,DEU,0,0,0,13,13
2000,Ukraine,UKR,Germany,DEU,0,0,10,102,112
2000,Uzbekistan,UZB,Germany,DEU,0,0,5,0,5
2000,Stateless,XXA,Germany,DEU,10,0,5,144,159
2000,Unknown ,,Germany,DEU,0,0,0,35,35
2001,Afghanistan,AFG,France,FRA,10,0,0,0,10
2001,Albania,ALB,France,FRA,42,0,0,0,42
2001,Algeria,DZA,France,FRA,113,0,0,0,113
2001,Angola,AGO,France,FRA,47,0,0,0,47
2001,Armenia,ARM,France,FRA,64,0,0,0,64
2001,Azerbaijan,AZE,France,FRA,49,0,0,0,49
2001,Burundi,BDI,France,FRA,5,0,0,0,5
2001,Bangladesh,BGD,France,FRA,126,0,0,0,126
2001,Belarus,BLR,France,FRA,10,0,0,0,10
2001,Bosnia and Herzegovina,BIH,France,FRA,34,0,0,0,34
2001,Bulgaria,BGR,France,FRA,5,0,0,0,5
2001,Central African Rep.,CAF,France,FRA,15,0,0,0,15
2001,China,CHN,France,FRA,10,0,0,0,10
2001,Cameroon,CMR,France,FRA,5,0,0,0,5
2001,Congo,COG,France,FRA,99,0,0,0,99
2001,Dem. Rep. of the Congo,COD,France,FRA,135,0,0,0,135
2001,Colombia,COL,France,FRA,5,0,0,0,5
2001,Ethiopia,ETH,France,FRA,5,0,0,0,5
2001,Georgia,GEO,France,FRA,56,0,0,0,56
2001,Guinea-Bissau,GNB,France,FRA,5,0,0,0,5
2001,Guinea,GIN,France,FRA,18,0,0,0,18
2001,Haiti,HTI,France,FRA,113,0,0,0,113
2001,Croatia,HRV,France,FRA,5,0,0,0,5
2001,India,IND,France,FRA,26,0,0,0,26
2001,Iran (Islamic Rep. of),IRN,France,FRA,14,0,0,0,14
2001,Iraq,IRQ,France,FRA,64,0,0,0,64
2001,Kazakhstan,KAZ,France,FRA,17,0,0,0,17
2001,Lebanon,LBN,France,FRA,5,0,0,0,5
2001,Sri Lanka,LKA,France,FRA,298,0,0,0,298
2001,Mauritania,MRT,France,FRA,113,0,0,0,113
2001,Rep. of Moldova,MDA,France,FRA,23,0,0,0,23
2001,Mali,MLI,France,FRA,12,0,0,0,12
2001,Myanmar,MMR,France,FRA,5,0,0,0,5
2001,Nigeria,NGA,France,FRA,10,0,0,0,10
2001,Pakistan,PAK,France,FRA,15,0,0,0,15
2001,Romania,ROU,France,FRA,5,0,0,0,5
2001,Russian Federation,RUS,France,FRA,95,0,0,0,95
2001,Rwanda,RWA,France,FRA,21,0,0,0,21
2001,Serbia and Kosovo: S/RES/1244 (1999),SRB,France,FRA,149,0,0,0,149
2001,Senegal,SEN,France,FRA,14,0,0,0,14
2001,Sierra Leone,SLE,France,FRA,11,0,0,0,11
2001,Somalia,SOM,France,FRA,10,0,0,0,10
2001,Viet Nam,VNM,France,FRA,5,0,0,0,5
2001,Sudan,SDN,France,FRA,5,0,0,0,5
2001,Slovakia,SVK,France,FRA,10,0,0,0,10
2001,Syrian Arab Rep.,SYR,France,FRA,10,0,0,0,10
2001,Togo,TGO,France,FRA,5,0,0,0,5
2001,Tunisia,TUN,France,FRA,5,0,0,0,5
2001,Turkey,TUR,France,FRA,272,0,0,0,272
2001,Ukraine,UKR,France,FRA,52,0,0,0,52
2001,Uzbekistan,UZB,France,FRA,5,0,0,0,5
2001,Unknown ,,France,FRA,14,0,0,0,14
2001,Afghanistan,AFG,Germany,DEU,4576,670,34,1006,6286
2001,Albania,ALB,Germany,DEU,0,0,5,141,146
2001,Algeria,DZA,Germany,DEU,0,0,15,368,383
2001,Angola,AGO,Germany,DEU,0,0,5,52,57
2001,Egypt,EGY,Germany,DEU,0,0,5,27,32
2001,Armenia,ARM,Germany,DEU,5,5,10,323,343
2001,Azerbaijan,AZE,Germany,DEU,5,0,11,174,190
2001,Burundi,BDI,Germany,DEU,0,0,0,5,5
2001,Benin,BEN,Germany,DEU,0,0,0,5,5
2001,Bangladesh,BGD,Germany,DEU,0,0,5,87,92
2001,Bhutan,BTN,Germany,DEU,0,0,0,5,5
2001,Burkina Faso,BFA,Germany,DEU,0,0,0,13,13
2001,Belarus,BLR,Germany,DEU,0,0,5,47,52
2001,Bosnia and Herzegovina,BIH,Germany,DEU,0,5,41,676,722
2001,Bulgaria,BGR,Germany,DEU,0,0,0,31,31
2001,Chad,TCD,Germany,DEU,0,0,0,5,5
2001,China,CHN,Germany,DEU,0,0,5,78,83
2001,Cameroon,CMR,Germany,DEU,0,0,5,44,49
2001,Congo,COG,Germany,DEU,0,0,0,5,5
2001,Dem. Rep. of the Congo,COD,Germany,DEU,10,17,15,222,264
2001,Colombia,COL,Germany,DEU,0,0,0,5,5
2001,Cuba,CUB,Germany,DEU,0,0,0,5,5
2001,Czechia,CZE,Germany,DEU,0,0,0,29,29
2001,Ecuador,ECU,Germany,DEU,0,0,0,5,5
2001,Eritrea,ERI,Germany,DEU,0,0,0,21,21
2001,Estonia,EST,Germany,DEU,0,0,0,5,5
2001,Ethiopia,ETH,Germany,DEU,5,5,5,45,60
2001,Gambia,GMB,Germany,DEU,0,0,5,10,15
2001,Georgia,GEO,Germany,DEU,0,0,20,260,280
2001,Ghana,GHA,Germany,DEU,0,0,5,82,87
2001,Guinea,GIN,Germany,DEU,0,0,0,49,49
2001,Croatia,HRV,Germany,DEU,0,0,5,109,114
2001,Hungary,HUN,Germany,DEU,0,0,0,5,5
2001,Cote d'Ivoire,CIV,Germany,DEU,0,0,0,21,21
2001,India,IND,Germany,DEU,5,0,19,327,351
2001,Iran (Islamic Rep. of),IRN,Germany,DEU,61,5,85,708,859
2001,Iraq,IRQ,Germany,DEU,20,10,12,427,469
2001,Jordan,JOR,Germany,DEU,0,0,0,32,32
2001,Kazakhstan,KAZ,Germany,DEU,0,0,0,16,16
2001,Kenya,KEN,Germany,DEU,0,0,0,5,5
2001,Kyrgyzstan,KGZ,Germany,DEU,0,0,0,10,10
2001,Dem. People's Rep. of Korea,PRK,Germany,DEU,0,0,0,18,18
2001,Liberia,LBR,Germany,DEU,0,0,0,17,17
2001,Libya,LBY,Germany,DEU,0,0,0,10,10
2001,Lebanon,LBN,Germany,DEU,0,0,30,147,177
2001,Sri Lanka,LKA,Germany,DEU,5,10,17,472,504
2001,Lithuania,LTU,Germany,DEU,0,0,0,18,18
2001,Latvia,LVA,Germany,DEU,0,0,0,5,5
2001,North Macedonia,MKD,Germany,DEU,0,0,61,853,914
2001,Rep. of Moldova,MDA,Germany,DEU,0,0,5,61,66
2001,Mongolia,MNG,Germany,DEU,0,0,0,35,35
2001,Morocco,MAR,Germany,DEU,0,0,5,39,44
2001,Nepal,NPL,Germany,DEU,0,0,0,33,33
2001,Niger,NER,Germany,DEU,0,0,0,13,13
2001,Nigeria,NGA,Germany,DEU,0,5,5,83,93
2001,Pakistan,PAK,Germany,DEU,23,10,17,582,632
2001,Peru,PER,Germany,DEU,0,0,0,5,5
2001,Poland,POL,Germany,DEU,0,0,32,60,92
2001,Romania,ROU,Germany,DEU,0,0,5,79,84
2001,Russian Federation,RUS,Germany,DEU,5,0,12,249,266
2001,Rwanda,RWA,Germany,DEU,0,0,0,5,5
2001,Serbia and Kosovo: S/RES/1244 (1999),SRB,Germany,DEU,5,110,131,6307,6553
2001,Senegal,SEN,Germany,DEU,0,0,0,5,5
2001,Sierra Leone,SLE,Germany,DEU,0,0,10,52,62
2001,Somalia,SOM,Germany,DEU,5,5,0,5,15
2001,Viet Nam,VNM,Germany,DEU,5,5,25,405,440
2001,Sudan,SDN,Germany,DEU,0,0,0,36,36
2001,Slovakia,SVK,Germany,DEU,0,0,0,93,93
2001,Slovenia,SVN,Germany,DEU,0,0,0,11,11
2001,Syrian Arab Rep.,SYR,Germany,DEU,14,12,20,335,381
2001,Tajikistan,TJK,Germany,DEU,0,0,0,10,10
2001,Togo,TGO,Germany,DEU,19,0,41,252,312
2001,Tunisia,TUN,Germany,DEU,0,0,0,40,40
2001,Turkey,TUR,Germany,DEU,387,92,347,4009,4835
2001,Uganda,UGA,Germany,DEU,0,0,0,11,11
2001,Ukraine,UKR,Germany,DEU,5,0,13,104,122
2001,Uzbekistan,UZB,Germany,DEU,0,0,0,13,13
2001,Yemen,YEM,Germany,DEU,0,0,0,5,5
2001,Stateless,XXA,Germany,DEU,0,0,0,19,19
2001,Unknown ,,Germany,DEU,10,0,20,208,238
2002,Afghanistan,AFG,France,FRA,5,0,0,0,5
2002,Albania,ALB,France,FRA,76,0,0,0,76
2002,Algeria,DZA,France,FRA,102,0,0,0,102
2002,Angola,AGO,France,FRA,35,0,0,0,35
2002,Armenia,ARM,France,FRA,56,0,0,0,56
2002,Azerbaijan,AZE,France,FRA,61,0,0,0,61
2002,Bangladesh,BGD,France,FRA,75,0,0,0,75
2002,Belarus,BLR,France,FRA,5,0,0,0,5
2002,Bosnia and Herzegovina,BIH,France,FRA,22,0,0,0,22
2002,Cambodia,KHM,France,FRA,5,0,0,0,5
2002,Central African Rep.,CAF,France,FRA,10,0,0,0,10
2002,Chad,TCD,France,FRA,5,0,0,0,5
2002,China,CHN,France,FRA,10,0,0,0,10
2002,Cameroon,CMR,France,FRA,10,0,0,0,10
2002,Congo,COG,France,FRA,80,0,0,0,80
2002,Dem. Rep. of the Congo,COD,France,FRA,178,0,0,0,178
2002,Ecuador,ECU,France,FRA,5,0,0,0,5
2002,Georgia,GEO,France,FRA,56,0,0,0,56
2002,Guinea,GIN,France,FRA,35,0,0,0,35
2002,Haiti,HTI,France,FRA,130,0,0,0,130
2002,Cote d'Ivoire,CIV,France,FRA,5,0,0,0,5
2002,India,IND,France,FRA,20,0,0,0,20
2002,Iran (Islamic Rep. of),IRN,France,FRA,34,0,0,0,34
2002,Iraq,IRQ,France,FRA,42,0,0,0,42
2002,Kazakhstan,KAZ,France,FRA,16,0,0,0,16
2002,Kyrgyzstan,KGZ,France,FRA,5,0,0,0,5
2002,Lebanon,LBN,France,FRA,5,0,0,0,5
2002,Sri Lanka,LKA,France,FRA,331,0,0,0,331
2002,Mauritania,MRT,France,FRA,107,0,0,0,107
2002,Rep. of Moldova,MDA,France,FRA,15,0,0,0,15
2002,Mali,MLI,France,FRA,5,0,0,0,5
2002,Myanmar,MMR,France,FRA,5,0,0,0,5
2002,Nigeria,NGA,France,FRA,5,0,0,0,5
2002,Pakistan,PAK,France,FRA,5,0,0,0,5
2002,Russian Federation,RUS,France,FRA,119,0,0,0,119
2002,Rwanda,RWA,France,FRA,12,0,0,0,12
2002,Serbia and Kosovo: S/RES/1244 (1999),SRB,France,FRA,102,0,0,0,102
2002,Senegal,SEN,France,FRA,18,0,0,0,18
2002,Sierra Leone,SLE,France,FRA,5,0,0,0,5
2002,Sudan,SDN,France,FRA,10,0,0,0,10
2002,Slovakia,SVK,France,FRA,10,0,0,0,10
2002,Syrian Arab Rep.,SYR,France,FRA,5,0,0,0,5
2002,Togo,TGO,France,FRA,5,0,0,0,5
2002,Tunisia,TUN,France,FRA,5,0,0,0,5
2002,Turkey,TUR,France,FRA,248,0,0,0,248
2002,Ukraine,UKR,France,FRA,36,0,0,0,36
2002,Uzbekistan,UZB,France,FRA,5,0,0,0,5
2002,Unknown ,,France,FRA,17,0,0,0,17
2002,Afghanistan,AFG,Germany,DEU,5,223,0,526,754
2002,Albania,ALB,Germany,DEU,0,5,12,95,112
2002,Algeria,DZA,Germany,DEU,5,0,10,276,291
2002,Angola,AGO,Germany,DEU,0,0,5,83,88
2002,Egypt,EGY,Germany,DEU,0,0,0,41,41
2002,Armenia,ARM,Germany,DEU,0,5,0,277,282
2002,Azerbaijan,AZE,Germany,DEU,0,5,5,187,197
2002,Benin,BEN,Germany,DEU,0,0,0,10,10
2002,Bangladesh,BGD,Germany,DEU,0,0,0,38,38
2002,Burkina Faso,BFA,Germany,DEU,0,0,0,11,11
2002,Belarus,BLR,Germany,DEU,0,0,5,67,72
2002,Bosnia and Herzegovina,BIH,Germany,DEU,0,10,31,531,572
2002,Bulgaria,BGR,Germany,DEU,0,0,13,118,131
2002,Central African Rep.,CAF,Germany,DEU,0,0,0,10,10
2002,China,CHN,Germany,DEU,0,0,10,95,105
2002,Cameroon,CMR,Germany,DEU,0,0,5,66,71
2002,Dem. Rep. of the Congo,COD,Germany,DEU,5,10,15,293,323
2002,Colombia,COL,Germany,DEU,0,0,0,5,5
2002,Cuba,CUB,Germany,DEU,0,0,0,5,5
2002,Czechia,CZE,Germany,DEU,0,0,0,19,19
2002,Ecuador,ECU,Germany,DEU,0,0,0,5,5
2002,Eritrea,ERI,Germany,DEU,0,0,0,21,21
2002,Ethiopia,ETH,Germany,DEU,5,11,5,36,57
2002,Gambia,GMB,Germany,DEU,0,0,0,5,5
2002,Georgia,GEO,Germany,DEU,0,0,12,237,249
2002,Ghana,GHA,Germany,DEU,0,0,5,79,84
2002,Guinea-Bissau,GNB,Germany,DEU,0,0,0,5,5
2002,Guinea,GIN,Germany,DEU,0,0,0,32,32
2002,Croatia,HRV,Germany,DEU,0,0,5,71,76
2002,Hungary,HUN,Germany,DEU,0,0,5,23,28
2002,Cote d'Ivoire,CIV,Germany,DEU,0,0,0,14,14
2002,India,IND,Germany,DEU,0,0,14,295,309
2002,Iran (Islamic Rep. of),IRN,Germany,DEU,76,5,67,772,920
2002,Iraq,IRQ,Germany,DEU,23,0,22,406,451
2002,Israel,ISR,Germany,DEU,0,0,0,5,5
2002,Jordan,JOR,Germany,DEU,0,0,5,21,26
2002,Kazakhstan,KAZ,Germany,DEU,0,0,0,19,19
2002,Kenya,KEN,Germany,DEU,0,0,0,12,12
2002,Kyrgyzstan,KGZ,Germany,DEU,0,0,0,5,5
2002,Dem. People's Rep. of Korea,PRK,Germany,DEU,0,0,0,11,11
2002,Liberia,LBR,Germany,DEU,0,0,0,25,25
2002,Libya,LBY,Germany,DEU,0,0,0,13,13
2002,Lebanon,LBN,Germany,DEU,0,0,23,167,190
2002,Sri Lanka,LKA,Germany,DEU,5,5,13,330,353
2002,Lithuania,LTU,Germany,DEU,0,0,0,20,20
2002,Latvia,LVA,Germany,DEU,0,0,0,5,5
2002,Mauritania,MRT,Germany,DEU,0,0,0,5,5
2002,North Macedonia,MKD,Germany,DEU,0,0,44,501,545
2002,Rep. of Moldova,MDA,Germany,DEU,0,0,0,41,41
2002,Mongolia,MNG,Germany,DEU,0,0,0,26,26
2002,Morocco,MAR,Germany,DEU,0,0,0,48,48
2002,Myanmar,MMR,Germany,DEU,0,0,0,5,5
2002,Nepal,NPL,Germany,DEU,0,0,0,30,30
2002,Niger,NER,Germany,DEU,0,0,0,10,10
2002,Nigeria,NGA,Germany,DEU,0,5,5,88,98
2002,Pakistan,PAK,Germany,DEU,10,5,11,301,327
2002,Poland,POL,Germany,DEU,0,0,5,12,17
2002,Romania,ROU,Germany,DEU,0,0,13,110,123
2002,Russian Federation,RUS,Germany,DEU,0,0,20,311,331
2002,Rwanda,RWA,Germany,DEU,0,0,0,5,5
2002,Serbia and Kosovo: S/RES/1244 (1999),SRB,Germany,DEU,0,183,943,23359,24485
2002,Senegal,SEN,Germany,DEU,0,0,0,5,5
2002,Sierra Leone,SLE,Germany,DEU,0,0,0,39,39
2002,Somalia,SOM,Germany,DEU,0,0,0,10,10
2002,Viet Nam,VNM,Germany,DEU,0,0,14,463,477
2002,Sudan,SDN,Germany,DEU,5,0,0,25,30
2002,Slovakia,SVK,Germany,DEU,0,0,5,211,216
2002,Syrian Arab Rep.,SYR,Germany,DEU,22,5,17,300,344
2002,Tajikistan,TJK,Germany,DEU,0,0,0,5,5
2002,Togo,TGO,Germany,DEU,5,5,23,366,399
2002,Tunisia,TUN,Germany,DEU,0,0,0,39,39
2002,Turkey,TUR,Germany,DEU,290,74,320,3968,4652
2002,Uganda,UGA,Germany,DEU,0,0,0,5,5
2002,Ukraine,UKR,Germany,DEU,0,0,5,69,74
2002,Uzbekistan,UZB,Germany,DEU,0,0,0,5,5
2002,Yemen,YEM,Germany,DEU,0,0,0,15,15
2002,Stateless,XXA,Germany,DEU,0,0,0,13,13
2002,Unknown ,,Germany,DEU,5,5,10,179,199
2003,Afghanistan,AFG,France,FRA,23,0,0,0,23
2003,Albania,ALB,France,FRA,121,0,0,0,121
2003,Algeria,DZA,France,FRA,111,0,0,0,111
2003,Angola,AGO,France,FRA,73,0,0,0,73
2003,Armenia,ARM,France,FRA,93,0,0,0,93
2003,Azerbaijan,AZE,France,FRA,104,0,0,0,104
2003,Burundi,BDI,France,FRA,5,0,0,0,5
2003,Bangladesh,BGD,France,FRA,60,0,0,0,60
2003,Belarus,BLR,France,FRA,30,0,0,0,30
2003,Bosnia and Herzegovina,BIH,France,FRA,23,0,0,0,23
2003,Cambodia,KHM,France,FRA,5,0,0,0,5
2003,Central African Rep.,CAF,France,FRA,13,0,0,0,13
2003,Chad,TCD,France,FRA,24,0,0,0,24
2003,China,CHN,France,FRA,5,0,0,0,5
2003,Cameroon,CMR,France,FRA,11,0,0,0,11
2003,Congo,COG,France,FRA,127,0,0,0,127
2003,Dem. Rep. of the Congo,COD,France,FRA,296,0,0,0,296
2003,Colombia,COL,France,FRA,13,0,0,0,13
2003,Georgia,GEO,France,FRA,173,0,0,0,173
2003,Guinea-Bissau,GNB,France,FRA,5,0,0,0,5
2003,Guinea,GIN,France,FRA,54,0,0,0,54
2003,Haiti,HTI,France,FRA,122,0,0,0,122
2003,India,IND,France,FRA,23,0,0,0,23
2003,Iran (Islamic Rep. of),IRN,France,FRA,33,0,0,0,33
2003,Iraq,IRQ,France,FRA,10,0,0,0,10
2003,Kazakhstan,KAZ,France,FRA,21,0,0,0,21
2003,Kyrgyzstan,KGZ,France,FRA,5,0,0,0,5
2003,Sri Lanka,LKA,France,FRA,342,0,0,0,342
2003,Madagascar,MDG,France,FRA,5,0,0,0,5
2003,Mauritania,MRT,France,FRA,277,0,0,0,277
2003,North Macedonia,MKD,France,FRA,30,0,0,0,30
2003,Rep. of Moldova,MDA,France,FRA,37,0,0,0,37
2003,Mali,MLI,France,FRA,5,0,0,0,5
2003,Mongolia,MNG,France,FRA,10,0,0,0,10
2003,Myanmar,MMR,France,FRA,5,0,0,0,5
2003,Nigeria,NGA,France,FRA,15,0,0,0,15
2003,Pakistan,PAK,France,FRA,16,0,0,0,16
2003,Russian Federation,RUS,France,FRA,230,0,0,0,230
2003,Rwanda,RWA,France,FRA,10,0,0,0,10
2003,Serbia and Kosovo: S/RES/1244 (1999),SRB,France,FRA,138,0,0,0,138
2003,Senegal,SEN,France,FRA,14,0,0,0,14
2003,Sierra Leone,SLE,France,FRA,21,0,0,0,21
2003,Somalia,SOM,France,FRA,5,0,0,0,5
2003,Sudan,SDN,France,FRA,19,0,0,0,19
2003,Slovakia,SVK,France,FRA,13,0,0,0,13
2003,Syrian Arab Rep.,SYR,France,FRA,5,0,0,0,5
2003,Togo,TGO,France,FRA,10,0,0,0,10
2003,Turkey,TUR,France,FRA,368,0,0,0,368
2003,Ukraine,UKR,France,FRA,70,0,0,0,70
2003,Uzbekistan,UZB,France,FRA,19,0,0,0,19
2003,Unknown ,,France,FRA,11,0,0,0,11
2003,Afghanistan,AFG,Germany,DEU,30,153,482,3432,4097
2003,Albania,ALB,Germany,DEU,0,5,0,59,64
2003,Algeria,DZA,Germany,DEU,0,5,12,309,326
2003,Angola,AGO,Germany,DEU,0,5,5,51,61
2003,Egypt,EGY,Germany,DEU,0,0,5,39,44
2003,Armenia,ARM,Germany,DEU,0,5,0,234,239
2003,Azerbaijan,AZE,Germany,DEU,0,0,0,142,142
2003,Burundi,BDI,Germany,DEU,0,0,0,5,5
2003,Benin,BEN,Germany,DEU,0,0,0,5,5
2003,Bangladesh,BGD,Germany,DEU,0,0,0,42,42
2003,Bhutan,BTN,Germany,DEU,0,0,0,5,5
2003,Burkina Faso,BFA,Germany,DEU,0,0,0,12,12
2003,Belarus,BLR,Germany,DEU,0,0,5,50,55
2003,Bosnia and Herzegovina,BIH,Germany,DEU,0,12,10,422,444
2003,Bulgaria,BGR,Germany,DEU,0,0,12,127,139
2003,China,CHN,Germany,DEU,5,0,10,111,126
2003,Cameroon,CMR,Germany,DEU,0,0,5,97,102
2003,Congo,COG,Germany,DEU,0,0,0,5,5
2003,Dem. Rep. of the Congo,COD,Germany,DEU,5,5,24,415,449
2003,Cuba,CUB,Germany,DEU,0,0,0,5,5
2003,Czechia,CZE,Germany,DEU,0,0,0,16,16
2003,Ecuador,ECU,Germany,DEU,0,0,0,5,5
2003,Eritrea,ERI,Germany,DEU,5,0,0,10,15
2003,Ethiopia,ETH,Germany,DEU,5,5,0,52,62
2003,Gambia,GMB,Germany,DEU,0,0,0,5,5
2003,Georgia,GEO,Germany,DEU,0,0,12,203,215
2003,Ghana,GHA,Germany,DEU,0,0,5,54,59
2003,Guinea,GIN,Germany,DEU,0,0,0,31,31
2003,Croatia,HRV,Germany,DEU,0,0,0,63,63
2003,Hungary,HUN,Germany,DEU,0,0,0,5,5
2003,Cote d'Ivoire,CIV,Germany,DEU,0,0,0,25,25
2003,India,IND,Germany,DEU,0,0,10,271,281
2003,Iran (Islamic Rep. of),IRN,Germany,DEU,41,5,53,756,855
2003,Iraq,IRQ,Germany,DEU,0,10,11,224,245
2003,Israel,ISR,Germany,DEU,0,0,0,5,5
2003,Jordan,JOR,Germany,DEU,0,0,5,25,30
2003,Kazakhstan,KAZ,Germany,DEU,0,0,0,10,10
2003,Kenya,KEN,Germany,DEU,0,0,0,5,5
2003,Kyrgyzstan,KGZ,Germany,DEU,0,0,0,10,10
2003,Dem. People's Rep. of Korea,PRK,Germany,DEU,5,0,0,0,5
2003,Liberia,LBR,Germany,DEU,0,0,0,16,16
2003,Libya,LBY,Germany,DEU,0,0,0,17,17
2003,Lebanon,LBN,Germany,DEU,10,0,15,177,202
2003,Sri Lanka,LKA,Germany,DEU,0,0,10,253,263
2003,Lithuania,LTU,Germany,DEU,0,0,0,5,5
2003,Latvia,LVA,Germany,DEU,0,0,0,5,5
2003,North Macedonia,MKD,Germany,DEU,0,0,28,328,356
2003,Rep. of Moldova,MDA,Germany,DEU,0,0,5,41,46
2003,Mali,MLI,Germany,DEU,0,0,0,5,5
2003,Mongolia,MNG,Germany,DEU,0,0,0,12,12
2003,Morocco,MAR,Germany,DEU,0,0,0,41,41
2003,Myanmar,MMR,Germany,DEU,0,0,0,5,5
2003,Nepal,NPL,Germany,DEU,0,0,0,31,31
2003,Niger,NER,Germany,DEU,0,0,0,10,10
2003,Nigeria,NGA,Germany,DEU,0,5,10,101,116
2003,Pakistan,PAK,Germany,DEU,5,0,13,312,330
2003,Poland,POL,Germany,DEU,0,0,0,10,10
2003,Romania,ROU,Germany,DEU,0,0,5,61,66
2003,Russian Federation,RUS,Germany,DEU,10,5,15,464,494
2003,Serbia and Kosovo: S/RES/1244 (1999),SRB,Germany,DEU,0,99,155,7317,7571
2003,Senegal,SEN,Germany,DEU,0,0,0,5,5
2003,Sierra Leone,SLE,Germany,DEU,0,0,5,48,53
2003,Somalia,SOM,Germany,DEU,0,0,0,5,5
2003,Viet Nam,VNM,Germany,DEU,0,0,24,424,448
2003,Sudan,SDN,Germany,DEU,5,0,0,30,35
2003,Slovakia,SVK,Germany,DEU,0,0,14,175,189
2003,Syrian Arab Rep.,SYR,Germany,DEU,20,0,14,274,308
2003,Tajikistan,TJK,Germany,DEU,0,0,0,5,5
2003,Togo,TGO,Germany,DEU,5,0,30,321,356
2003,Tunisia,TUN,Germany,DEU,0,0,5,31,36
2003,Turkey,TUR,Germany,DEU,131,54,246,3636,4067
2003,Uganda,UGA,Germany,DEU,0,0,0,5,5
2003,Ukraine,UKR,Germany,DEU,0,0,10,58,68
2003,Uzbekistan,UZB,Germany,DEU,0,0,0,5,5
2003,Yemen,YEM,Germany,DEU,0,0,0,20,20
2003,Stateless,XXA,Germany,DEU,0,0,0,12,12
2003,Unknown ,,Germany,DEU,0,0,5,165,170
2004,Afghanistan,AFG,France,FRA,28,0,0,0,28
2004,Albania,ALB,France,FRA,112,0,0,0,112
2004,Algeria,DZA,France,FRA,73,0,0,0,73
2004,Angola,AGO,France,FRA,213,0,0,0,213
2004,Egypt,EGY,France,FRA,10,0,0,0,10
2004,Armenia,ARM,France,FRA,190,0,0,0,190
2004,Azerbaijan,AZE,France,FRA,164,0,0,0,164
2004,Burundi,BDI,France,FRA,5,0,0,0,5
2004,Bangladesh,BGD,France,FRA,81,0,0,0,81
2004,Belarus,BLR,France,FRA,47,0,0,0,47
2004,Bosnia and Herzegovina,BIH,France,FRA,50,0,0,0,50
2004,Cambodia,KHM,France,FRA,5,0,0,0,5
2004,Central African Rep.,CAF,France,FRA,28,0,0,0,28
2004,Chad,TCD,France,FRA,68,0,0,0,68
2004,China,CHN,France,FRA,11,0,0,0,11
2004,Cameroon,CMR,France,FRA,36,0,0,0,36
2004,Congo,COG,France,FRA,229,0,0,0,229
2004,Dem. Rep. of the Congo,COD,France,FRA,600,0,0,0,600
2004,Colombia,COL,France,FRA,12,0,0,0,12
2004,Eritrea,ERI,France,FRA,5,0,0,0,5
2004,Ethiopia,ETH,France,FRA,5,0,0,0,5
2004,Georgia,GEO,France,FRA,313,0,0,0,313
2004,Guinea,GIN,France,FRA,90,0,0,0,90
2004,Haiti,HTI,France,FRA,59,0,0,0,59
2004,Cote d'Ivoire,CIV,France,FRA,112,0,0,0,112
2004,India,IND,France,FRA,17,0,0,0,17
2004,Iran (Islamic Rep. of),IRN,France,FRA,23,0,0,0,23
2004,Kazakhstan,KAZ,France,FRA,68,0,0,0,68
2004,Kyrgyzstan,KGZ,France,FRA,16,0,0,0,16
2004,Sri Lanka,LKA,France,FRA,391,0,0,0,391
2004,Madagascar,MDG,France,FRA,20,0,0,0,20
2004,Mauritania,MRT,France,FRA,474,0,0,0,474
2004,North Macedonia,MKD,France,FRA,20,0,0,0,20
2004,Rep. of Moldova,MDA,France,FRA,59,0,0,0,59
2004,Mali,MLI,France,FRA,5,0,0,0,5
2004,Mongolia,MNG,France,FRA,29,0,0,0,29
2004,Myanmar,MMR,France,FRA,5,0,0,0,5
2004,Niger,NER,France,FRA,5,0,0,0,5
2004,Nigeria,NGA,France,FRA,28,0,0,0,28
2004,Pakistan,PAK,France,FRA,19,0,0,0,19
2004,Peru,PER,France,FRA,5,0,0,0,5
2004,Russian Federation,RUS,France,FRA,262,0,0,0,262
2004,Rwanda,RWA,France,FRA,11,0,0,0,11
2004,Serbia and Kosovo: S/RES/1244 (1999),SRB,France,FRA,157,0,0,0,157
2004,Senegal,SEN,France,FRA,16,0,0,0,16
2004,Sierra Leone,SLE,France,FRA,20,0,0,0,20
2004,Somalia,SOM,France,FRA,5,0,0,0,5
2004,Sudan,SDN,France,FRA,20,0,0,0,20
2004,Slovakia,SVK,France,FRA,5,0,0,0,5
2004,Syrian Arab Rep.,SYR,France,FRA,5,0,0,0,5
2004,Tajikistan,TJK,France,FRA,5,0,0,0,5
2004,Togo,TGO,France,FRA,36,0,0,0,36
2004,Tunisia,TUN,France,FRA,5,0,0,0,5
2004,Turkey,TUR,France,FRA,563,0,0,0,563
2004,Ukraine,UKR,France,FRA,54,0,0,0,54
2004,Uzbekistan,UZB,France,FRA,37,0,0,0,37
2004,Unknown ,,France,FRA,10,0,0,0,10
2004,Afghanistan,AFG,Germany,DEU,49,57,112,608,826
2004,Albania,ALB,Germany,DEU,0,0,10,77,87
2004,Algeria,DZA,Germany,DEU,0,0,5,244,249
2004,Angola,AGO,Germany,DEU,0,5,0,45,50
2004,Egypt,EGY,Germany,DEU,5,0,0,28,33
2004,Armenia,ARM,Germany,DEU,0,0,10,185,195
2004,Azerbaijan,AZE,Germany,DEU,0,0,10,211,221
2004,Benin,BEN,Germany,DEU,0,0,0,5,5
2004,Bangladesh,BGD,Germany,DEU,0,0,0,32,32
2004,Burkina Faso,BFA,Germany,DEU,0,0,0,10,10
2004,Belarus,BLR,Germany,DEU,0,0,5,51,56
2004,Bosnia and Herzegovina,BIH,Germany,DEU,0,5,11,335,351
2004,Bulgaria,BGR,Germany,DEU,0,0,5,127,132
2004,Cambodia,KHM,Germany,DEU,0,0,0,5,5
2004,Chad,TCD,Germany,DEU,0,0,0,5,5
2004,China,CHN,Germany,DEU,20,0,0,128,148
2004,Cameroon,CMR,Germany,DEU,0,5,0,97,102
2004,Congo,COG,Germany,DEU,0,0,0,5,5
2004,Dem. Rep. of the Congo,COD,Germany,DEU,0,5,10,283,298
2004,Colombia,COL,Germany,DEU,0,0,0,5,5
2004,Cuba,CUB,Germany,DEU,0,0,0,5,5
2004,Eritrea,ERI,Germany,DEU,5,0,0,35,40
2004,Ethiopia,ETH,Germany,DEU,0,0,0,49,49
2004,Gambia,GMB,Germany,DEU,0,0,0,5,5
2004,Georgia,GEO,Germany,DEU,5,5,10,180,200
2004,Ghana,GHA,Germany,DEU,0,0,5,56,61
2004,Guinea,GIN,Germany,DEU,0,0,0,29,29
2004,Croatia,HRV,Germany,DEU,0,0,0,42,42
2004,Hungary,HUN,Germany,DEU,0,0,0,5,5
2004,Cote d'Ivoire,CIV,Germany,DEU,0,0,0,17,17
2004,India,IND,Germany,DEU,0,0,5,222,227
2004,Indonesia,IDN,Germany,DEU,0,0,0,5,5
2004,Iran (Islamic Rep. of),IRN,Germany,DEU,54,5,29,903,991
2004,Iraq,IRQ,Germany,DEU,0,5,10,199,214
2004,Israel,ISR,Germany,DEU,0,0,0,5,5
2004,Jordan,JOR,Germany,DEU,0,0,0,19,19
2004,Kazakhstan,KAZ,Germany,DEU,0,0,0,10,10
2004,Kyrgyzstan,KGZ,Germany,DEU,0,0,0,10,10
2004,Dem. People's Rep. of Korea,PRK,Germany,DEU,0,0,0,5,5
2004,Liberia,LBR,Germany,DEU,0,0,0,20,20
2004,Libya,LBY,Germany,DEU,0,0,0,11,11
2004,Lebanon,LBN,Germany,DEU,0,0,5,134,139
2004,Sri Lanka,LKA,Germany,DEU,0,0,0,151,151
2004,Mauritania,MRT,Germany,DEU,0,0,0,5,5
2004,North Macedonia,MKD,Germany,DEU,0,0,17,258,275
2004,Rep. of Moldova,MDA,Germany,DEU,0,0,0,16,16
2004,Mongolia,MNG,Germany,DEU,0,0,0,10,10
2004,Morocco,MAR,Germany,DEU,0,0,5,37,42
2004,Myanmar,MMR,Germany,DEU,0,0,0,10,10
2004,Nepal,NPL,Germany,DEU,0,0,0,29,29
2004,Nigeria,NGA,Germany,DEU,0,0,11,106,117
2004,Pakistan,PAK,Germany,DEU,5,0,5,274,284
2004,Poland,POL,Germany,DEU,0,0,0,5,5
2004,Romania,ROU,Germany,DEU,0,0,0,32,32
2004,Russian Federation,RUS,Germany,DEU,26,5,13,381,425
2004,Serbia and Kosovo: S/RES/1244 (1999),SRB,Germany,DEU,0,26,102,4933,5061
2004,Sierra Leone,SLE,Germany,DEU,0,0,5,37,42
2004,Somalia,SOM,Germany,DEU,0,0,0,13,13
2004,Viet Nam,VNM,Germany,DEU,0,5,20,321,346
2004,Sudan,SDN,Germany,DEU,0,0,0,21,21
2004,Slovakia,SVK,Germany,DEU,0,0,0,61,61
2004,Syrian Arab Rep.,SYR,Germany,DEU,10,5,22,367,404
2004,Tajikistan,TJK,Germany,DEU,0,0,0,5,5
2004,Turkmenistan,TKM,Germany,DEU,0,0,0,5,5
2004,Togo,TGO,Germany,DEU,5,0,13,284,302
2004,Tunisia,TUN,Germany,DEU,5,0,0,25,30
2004,Turkey,TUR,Germany,DEU,101,34,205,2767,3107
2004,Uganda,UGA,Germany,DEU,0,0,0,15,15
2004,Ukraine,UKR,Germany,DEU,0,0,5,82,87
2004,Uzbekistan,UZB,Germany,DEU,0,0,0,10,10
2004,Yemen,YEM,Germany,DEU,0,0,5,10,15
2004,Unknown ,,Germany,DEU,0,0,17,160,177
2005,Afghanistan,AFG,France,FRA,53,0,0,0,53
2005,Albania,ALB,France,FRA,208,0,0,0,208
2005,Algeria,DZA,France,FRA,224,0,0,0,224
2005,Angola,AGO,France,FRA,310,0,0,0,310
2005,Egypt,EGY,France,FRA,5,0,0,0,5
2005,Armenia,ARM,France,FRA,530,0,0,0,530
2005,Azerbaijan,AZE,France,FRA,359,0,0,0,359
2005,Burundi,BDI,France,FRA,10,0,0,0,10
2005,Bangladesh,BGD,France,FRA,340,0,0,0,340
2005,Belarus,BLR,France,FRA,72,0,0,0,72
2005,Bosnia and Herzegovina,BIH,France,FRA,165,0,0,0,165
2005,Cambodia,KHM,France,FRA,5,0,0,0,5
2005,Central African Rep.,CAF,France,FRA,41,0,0,0,41
2005,Chad,TCD,France,FRA,95,0,0,0,95
2005,China,CHN,France,FRA,31,0,0,0,31
2005,Cameroon,CMR,France,FRA,98,0,0,0,98
2005,Congo,COG,France,FRA,401,0,0,0,401
2005,Dem. Rep. of the Congo,COD,France,FRA,836,0,0,0,836
2005,Comoros,COM,France,FRA,5,0,0,0,5
2005,Colombia,COL,France,FRA,11,0,0,0,11
2005,Djibouti,DJI,France,FRA,5,0,0,0,5
2005,Eritrea,ERI,France,FRA,5,0,0,0,5
2005,Ethiopia,ETH,France,FRA,5,0,0,0,5
2005,Palestinian,PSE,France,FRA,5,0,0,0,5
2005,Georgia,GEO,France,FRA,566,0,0,0,566
2005,Guinea-Bissau,GNB,France,FRA,10,0,0,0,10
2005,Guinea,GIN,France,FRA,231,0,0,0,231
2005,Haiti,HTI,France,FRA,204,0,0,0,204
2005,Cote d'Ivoire,CIV,France,FRA,238,0,0,0,238
2005,India,IND,France,FRA,37,0,0,0,37
2005,Iran (Islamic Rep. of),IRN,France,FRA,31,0,0,0,31
2005,Iraq,IRQ,France,FRA,5,0,0,0,5
2005,Kazakhstan,KAZ,France,FRA,69,0,0,0,69
2005,Kyrgyzstan,KGZ,France,FRA,47,0,0,0,47
2005,Liberia,LBR,France,FRA,31,0,0,0,31
2005,Lebanon,LBN,France,FRA,5,0,0,0,5
2005,Sri Lanka,LKA,France,FRA,903,0,0,0,903
2005,Madagascar,MDG,France,FRA,33,0,0,0,33
2005,Mauritania,MRT,France,FRA,376,0,0,0,376
2005,North Macedonia,MKD,France,FRA,48,0,0,0,48
2005,Rep. of Moldova,MDA,France,FRA,82,0,0,0,82
2005,Mali,MLI,France,FRA,17,0,0,0,17
2005,Mongolia,MNG,France,FRA,88,0,0,0,88
2005,Morocco,MAR,France,FRA,5,0,0,0,5
2005,Myanmar,MMR,France,FRA,10,0,0,0,10
2005,Nepal,NPL,France,FRA,5,0,0,0,5
2005,Niger,NER,France,FRA,5,0,0,0,5
2005,Nigeria,NGA,France,FRA,139,0,0,0,139
2005,Pakistan,PAK,France,FRA,46,0,0,0,46
2005,Peru,PER,France,FRA,5,0,0,0,5
2005,Russian Federation,RUS,France,FRA,723,0,0,0,723
2005,Rwanda,RWA,France,FRA,74,0,0,0,74
2005,Serbia and Kosovo: S/RES/1244 (1999),SRB,France,FRA,544,0,0,0,544
2005,Senegal,SEN,France,FRA,15,0,0,0,15
2005,Sierra Leone,SLE,France,FRA,22,0,0,0,22
2005,Somalia,SOM,France,FRA,38,0,0,0,38
2005,Sudan,SDN,France,FRA,99,0,0,0,99
2005,Syrian Arab Rep.,SYR,France,FRA,10,0,0,0,10
2005,Togo,TGO,France,FRA,52,0,0,0,52
2005,Tunisia,TUN,France,FRA,5,0,0,0,5
2005,Turkey,TUR,France,FRA,786,0,0,0,786
2005,Ukraine,UKR,France,FRA,76,0,0,0,76
2005,Uzbekistan,UZB,France,FRA,51,0,0,0,51
2005,Unknown ,,France,FRA,29,0,0,0,29
2005,Afghanistan,AFG,Germany,DEU,43,22,10,317,392
2005,Albania,ALB,Germany,DEU,0,0,0,58,58
2005,Algeria,DZA,Germany,DEU,5,0,5,182,192
2005,Angola,AGO,Germany,DEU,0,0,0,26,26
2005,Egypt,EGY,Germany,DEU,0,0,0,14,14
2005,Armenia,ARM,Germany,DEU,10,0,18,115,143
2005,Azerbaijan,AZE,Germany,DEU,16,5,10,189,220
2005,Benin,BEN,Germany,DEU,0,0,0,11,11
2005,Bangladesh,BGD,Germany,DEU,0,0,0,21,21
2005,Burkina Faso,BFA,Germany,DEU,0,0,0,10,10
2005,Belarus,BLR,Germany,DEU,0,0,0,45,45
2005,Bosnia and Herzegovina,BIH,Germany,DEU,0,5,15,184,204
2005,Bulgaria,BGR,Germany,DEU,0,0,5,72,77
2005,Central African Rep.,CAF,Germany,DEU,0,0,0,5,5
2005,China,CHN,Germany,DEU,21,12,0,158,191
2005,Cameroon,CMR,Germany,DEU,0,0,0,104,104
2005,Congo,COG,Germany,DEU,0,0,0,5,5
2005,Dem. Rep. of the Congo,COD,Germany,DEU,0,5,5,177,187
2005,Colombia,COL,Germany,DEU,5,0,0,5,10
2005,Czechia,CZE,Germany,DEU,0,0,0,10,10
2005,Eritrea,ERI,Germany,DEU,63,5,0,58,126
2005,Ethiopia,ETH,Germany,DEU,18,0,0,66,84
2005,Gambia,GMB,Germany,DEU,0,0,0,10,10
2005,Georgia,GEO,Germany,DEU,0,5,0,112,117
2005,Ghana,GHA,Germany,DEU,0,0,5,64,69
2005,Guinea,GIN,Germany,DEU,0,0,0,29,29
2005,Croatia,HRV,Germany,DEU,0,0,0,11,11
2005,Hungary,HUN,Germany,DEU,0,0,0,5,5
2005,Cote d'Ivoire,CIV,Germany,DEU,0,0,0,21,21
2005,India,IND,Germany,DEU,0,0,10,158,168
2005,Iran (Islamic Rep. of),IRN,Germany,DEU,178,29,26,781,1014
2005,Iraq,IRQ,Germany,DEU,10,5,18,308,341
2005,Israel,ISR,Germany,DEU,0,0,0,5,5
2005,Jordan,JOR,Germany,DEU,0,0,0,19,19
2005,Kazakhstan,KAZ,Germany,DEU,0,0,0,10,10
2005,Kenya,KEN,Germany,DEU,0,0,0,5,5
2005,Kyrgyzstan,KGZ,Germany,DEU,0,0,0,10,10
2005,Dem. People's Rep. of Korea,PRK,Germany,DEU,0,0,10,5,15
2005,Liberia,LBR,Germany,DEU,0,0,0,13,13
2005,Libya,LBY,Germany,DEU,0,0,0,22,22
2005,Lebanon,LBN,Germany,DEU,5,0,5,89,99
2005,Sri Lanka,LKA,Germany,DEU,0,0,0,144,144
2005,North Macedonia,MKD,Germany,DEU,0,0,10,147,157
2005,Rep. of Moldova,MDA,Germany,DEU,0,0,0,12,12
2005,Mongolia,MNG,Germany,DEU,0,0,0,11,11
2005,Morocco,MAR,Germany,DEU,0,0,0,32,32
2005,Myanmar,MMR,Germany,DEU,0,0,0,5,5
2005,Nepal,NPL,Germany,DEU,0,0,0,28,28
2005,Niger,NER,Germany,DEU,0,0,0,10,10
2005,Nigeria,NGA,Germany,DEU,0,0,0,98,98
2005,Pakistan,PAK,Germany,DEU,21,0,5,161,187
2005,Poland,POL,Germany,DEU,0,0,5,5,10
2005,Romania,ROU,Germany,DEU,0,0,0,34,34
2005,Russian Federation,RUS,Germany,DEU,196,14,30,511,751
2005,Serbia and Kosovo: S/RES/1244 (1999),SRB,Germany,DEU,5,45,118,5316,5484
2005,Senegal,SEN,Germany,DEU,0,0,0,5,5
2005,Sierra Leone,SLE,Germany,DEU,0,0,0,23,23
2005,Somalia,SOM,Germany,DEU,5,0,0,18,23
2005,Viet Nam,VNM,Germany,DEU,5,5,10,250,270
2005,Sudan,SDN,Germany,DEU,0,0,0,33,33
2005,Slovakia,SVK,Germany,DEU,0,0,0,64,64
2005,Syrian Arab Rep.,SYR,Germany,DEU,136,10,17,296,459
2005,Turkmenistan,TKM,Germany,DEU,0,0,0,10,10
2005,Togo,TGO,Germany,DEU,15,0,5,359,379
2005,Tunisia,TUN,Germany,DEU,0,0,0,22,22
2005,Turkey,TUR,Germany,DEU,341,30,116,2006,2493
2005,Uganda,UGA,Germany,DEU,0,0,0,12,12
2005,Ukraine,UKR,Germany,DEU,0,0,5,61,66
2005,Uzbekistan,UZB,Germany,DEU,0,0,0,16,16
2005,Yemen,YEM,Germany,DEU,14,0,5,18,37
2005,Stateless,XXA,Germany,DEU,5,0,0,16,21
2005,Unknown ,,Germany,DEU,30,0,5,127,162
2006,Afghanistan,AFG,France,FRA,25,0,0,0,25
2006,Albania,ALB,France,FRA,51,32,0,0,83
2006,Algeria,DZA,France,FRA,73,25,0,0,98
2006,Angola,AGO,France,FRA,85,5,0,0,90
2006,Egypt,EGY,France,FRA,11,0,0,0,11
2006,Armenia,ARM,France,FRA,180,21,0,0,201
2006,Azerbaijan,AZE,France,FRA,111,0,0,0,111
2006,Burundi,BDI,France,FRA,12,0,0,0,12
2006,Bangladesh,BGD,France,FRA,126,5,0,0,131
2006,Belarus,BLR,France,FRA,48,5,0,0,53
2006,Bosnia and Herzegovina,BIH,France,FRA,241,5,0,0,246
2006,Central African Rep.,CAF,France,FRA,10,0,0,0,10
2006,Chad,TCD,France,FRA,36,0,0,0,36
2006,China,CHN,France,FRA,16,0,0,0,16
2006,Cameroon,CMR,France,FRA,38,5,0,0,43
2006,Congo,COG,France,FRA,74,5,0,0,79
2006,Dem. Rep. of the Congo,COD,France,FRA,255,14,0,0,269
2006,Comoros,COM,France,FRA,5,0,0,0,5
2006,Colombia,COL,France,FRA,5,10,0,0,15
2006,Djibouti,DJI,France,FRA,5,0,0,0,5
2006,Eritrea,ERI,France,FRA,10,0,0,0,10
2006,Ethiopia,ETH,France,FRA,5,0,0,0,5
2006,Palestinian,PSE,France,FRA,5,0,0,0,5
2006,Georgia,GEO,France,FRA,130,20,0,0,150
2006,Guinea-Bissau,GNB,France,FRA,5,0,0,0,5
2006,Guinea,GIN,France,FRA,150,11,0,0,161
2006,Haiti,HTI,France,FRA,158,39,0,0,197
2006,Cote d'Ivoire,CIV,France,FRA,101,5,0,0,106
2006,India,IND,France,FRA,11,0,0,0,11
2006,Iran (Islamic Rep. of),IRN,France,FRA,26,5,0,0,31
2006,Iraq,IRQ,France,FRA,40,19,0,0,59
2006,Kazakhstan,KAZ,France,FRA,13,5,0,0,18
2006,Kyrgyzstan,KGZ,France,FRA,15,0,0,0,15
2006,Liberia,LBR,France,FRA,5,5,0,0,10
2006,Sri Lanka,LKA,France,FRA,342,5,0,0,347
2006,Madagascar,MDG,France,FRA,22,5,0,0,27
2006,Mauritania,MRT,France,FRA,160,0,0,0,160
2006,North Macedonia,MKD,France,FRA,22,0,0,0,22
2006,Rep. of Moldova,MDA,France,FRA,23,12,0,0,35
2006,Mali,MLI,France,FRA,5,0,0,0,5
2006,Mongolia,MNG,France,FRA,28,11,0,0,39
2006,Myanmar,MMR,France,FRA,5,0,0,0,5
2006,Nepal,NPL,France,FRA,5,0,0,0,5
2006,Nigeria,NGA,France,FRA,53,16,0,0,69
2006,Pakistan,PAK,France,FRA,30,10,0,0,40
2006,Russian Federation,RUS,France,FRA,336,32,0,0,368
2006,Rwanda,RWA,France,FRA,68,0,0,0,68
2006,Serbia and Kosovo: S/RES/1244 (1999),SRB,France,FRA,356,11,0,0,367
2006,Senegal,SEN,France,FRA,5,0,0,0,5
2006,Sierra Leone,SLE,France,FRA,11,0,0,0,11
2006,Somalia,SOM,France,FRA,25,0,0,0,25
2006,Sudan,SDN,France,FRA,78,0,0,0,78
2006,Syrian Arab Rep.,SYR,France,FRA,5,0,0,0,5
2006,Togo,TGO,France,FRA,48,0,0,0,48
2006,Tunisia,TUN,France,FRA,5,0,0,0,5
2006,Turkey,TUR,France,FRA,292,5,0,0,297
2006,Ukraine,UKR,France,FRA,20,5,0,0,25
2006,Uzbekistan,UZB,France,FRA,10,5,0,0,15
2006,Unknown ,,France,FRA,27,5,0,0,32
2006,Afghanistan,AFG,Germany,DEU,38,94,5,840,977
2006,Albania,ALB,Germany,DEU,0,0,0,39,39
2006,Algeria,DZA,Germany,DEU,0,0,10,106,116
2006,Angola,AGO,Germany,DEU,0,0,0,34,34
2006,Egypt,EGY,Germany,DEU,0,0,0,20,20
2006,Armenia,ARM,Germany,DEU,0,0,0,122,122
2006,Azerbaijan,AZE,Germany,DEU,5,0,5,106,116
2006,Burundi,BDI,Germany,DEU,0,0,0,5,5
2006,Bangladesh,BGD,Germany,DEU,0,0,0,5,5
2006,Burkina Faso,BFA,Germany,DEU,0,0,0,10,10
2006,Belarus,BLR,Germany,DEU,5,0,0,39,44
2006,Bosnia and Herzegovina,BIH,Germany,DEU,0,0,5,129,134
2006,Bulgaria,BGR,Germany,DEU,0,0,5,57,62
2006,China,CHN,Germany,DEU,5,23,5,91,124
2006,Cameroon,CMR,Germany,DEU,0,0,5,60,65
2006,Congo,COG,Germany,DEU,0,0,0,5,5
2006,Dem. Rep. of the Congo,COD,Germany,DEU,5,0,0,121,126
2006,Czechia,CZE,Germany,DEU,0,0,0,10,10
2006,Eritrea,ERI,Germany,DEU,26,26,0,54,106
2006,Ethiopia,ETH,Germany,DEU,0,5,0,54,59
2006,Gambia,GMB,Germany,DEU,0,0,0,10,10
2006,Georgia,GEO,Germany,DEU,0,0,5,77,82
2006,Ghana,GHA,Germany,DEU,0,0,0,43,43
2006,Guinea,GIN,Germany,DEU,0,5,0,38,43
2006,Croatia,HRV,Germany,DEU,5,0,0,15,20
2006,Hungary,HUN,Germany,DEU,0,0,0,5,5
2006,Cote d'Ivoire,CIV,Germany,DEU,0,0,0,10,10
2006,India,IND,Germany,DEU,0,0,5,112,117
2006,Iran (Islamic Rep. of),IRN,Germany,DEU,51,31,23,542,647
2006,Iraq,IRQ,Germany,DEU,38,11,11,281,341
2006,Israel,ISR,Germany,DEU,0,0,0,5,5
2006,Jordan,JOR,Germany,DEU,5,0,0,17,22
2006,Kenya,KEN,Germany,DEU,0,0,0,5,5
2006,Liberia,LBR,Germany,DEU,0,0,0,10,10
2006,Libya,LBY,Germany,DEU,0,0,0,13,13
2006,Lebanon,LBN,Germany,DEU,0,0,10,85,95
2006,Sri Lanka,LKA,Germany,DEU,5,0,5,127,137
2006,North Macedonia,MKD,Germany,DEU,0,0,5,96,101
2006,Rep. of Moldova,MDA,Germany,DEU,0,0,0,10,10
2006,Mongolia,MNG,Germany,DEU,0,0,0,5,5
2006,Morocco,MAR,Germany,DEU,0,0,0,20,20
2006,Montenegro,MNE,Germany,DEU,0,0,0,35,35
2006,Myanmar,MMR,Germany,DEU,5,5,0,0,10
2006,Nepal,NPL,Germany,DEU,0,0,0,33,33
2006,Nigeria,NGA,Germany,DEU,0,0,10,90,100
2006,Pakistan,PAK,Germany,DEU,5,0,5,111,121
2006,Romania,ROU,Germany,DEU,0,0,5,13,18
2006,Russian Federation,RUS,Germany,DEU,58,5,10,278,351
2006,Serbia and Kosovo: S/RES/1244 (1999),SRB,Germany,DEU,11,38,52,2044,2145
2006,Sierra Leone,SLE,Germany,DEU,0,0,0,23,23
2006,Somalia,SOM,Germany,DEU,5,0,0,10,15
2006,Viet Nam,VNM,Germany,DEU,5,0,12,203,220
2006,Sudan,SDN,Germany,DEU,0,0,0,19,19
2006,Slovakia,SVK,Germany,DEU,0,0,5,120,125
2006,Syrian Arab Rep.,SYR,Germany,DEU,38,5,14,181,238
2006,Togo,TGO,Germany,DEU,5,5,5,116,131
2006,Tunisia,TUN,Germany,DEU,0,0,0,24,24
2006,Turkey,TUR,Germany,DEU,45,18,105,1028,1196
2006,Uganda,UGA,Germany,DEU,0,0,0,14,14
2006,Ukraine,UKR,Germany,DEU,0,0,0,28,28
2006,Uzbekistan,UZB,Germany,DEU,0,0,0,10,10
2006,Yemen,YEM,Germany,DEU,0,0,0,31,31
2006,Unknown ,,Germany,DEU,12,0,5,105,122
2006,Armenia,ARM,Croatia,HRV,0,0,0,5,5
2007,Afghanistan,AFG,France,FRA,23,0,0,0,23
2007,Albania,ALB,France,FRA,27,29,0,0,56
2007,Algeria,DZA,France,FRA,81,48,0,0,129
2007,Angola,AGO,France,FRA,112,5,0,0,117
2007,Armenia,ARM,France,FRA,192,40,0,0,232
2007,Azerbaijan,AZE,France,FRA,171,0,0,0,171
2007,Burundi,BDI,France,FRA,14,0,0,0,14
2007,Bangladesh,BGD,France,FRA,197,5,0,0,202
2007,Belarus,BLR,France,FRA,39,0,0,0,39
2007,Bolivia (Plurinational State of),BOL,France,FRA,5,0,0,0,5
2007,Bosnia and Herzegovina,BIH,France,FRA,176,5,0,0,181
2007,Cambodia,KHM,France,FRA,5,0,0,0,5
2007,Central African Rep.,CAF,France,FRA,15,0,0,0,15
2007,Chad,TCD,France,FRA,45,5,0,0,50
2007,China,CHN,France,FRA,12,0,0,0,12
2007,Cameroon,CMR,France,FRA,38,11,0,0,49
2007,Congo,COG,France,FRA,100,5,0,0,105
2007,Dem. Rep. of the Congo,COD,France,FRA,284,28,0,0,312
2007,Comoros,COM,France,FRA,16,0,0,0,16
2007,Colombia,COL,France,FRA,12,10,0,0,22
2007,Cuba,CUB,France,FRA,5,0,0,0,5
2007,Eritrea,ERI,France,FRA,5,0,0,0,5
2007,Ethiopia,ETH,France,FRA,24,0,0,0,24
2007,Gabon,GAB,France,FRA,5,0,0,0,5
2007,Palestinian,PSE,France,FRA,5,0,0,0,5
2007,Georgia,GEO,France,FRA,92,22,0,0,114
2007,Guinea-Bissau,GNB,France,FRA,5,0,0,0,5
2007,Guinea,GIN,France,FRA,210,24,0,0,234
2007,Haiti,HTI,France,FRA,172,69,0,0,241
2007,Cote d'Ivoire,CIV,France,FRA,84,5,0,0,89
2007,India,IND,France,FRA,5,0,0,0,5
2007,Iran (Islamic Rep. of),IRN,France,FRA,28,10,0,0,38
2007,Iraq,IRQ,France,FRA,40,12,0,0,52
2007,Kazakhstan,KAZ,France,FRA,19,10,0,0,29
2007,Kyrgyzstan,KGZ,France,FRA,10,5,0,0,15
2007,Liberia,LBR,France,FRA,5,0,0,0,5
2007,Sri Lanka,LKA,France,FRA,560,32,0,0,592
2007,Madagascar,MDG,France,FRA,19,5,0,0,24
2007,Mauritania,MRT,France,FRA,101,5,0,0,106
2007,North Macedonia,MKD,France,FRA,22,5,0,0,27
2007,Rep. of Moldova,MDA,France,FRA,27,5,0,0,32
2007,Mali,MLI,France,FRA,10,0,0,0,10
2007,Mongolia,MNG,France,FRA,10,5,0,0,15
2007,Morocco,MAR,France,FRA,5,0,0,0,5
2007,Myanmar,MMR,France,FRA,5,0,0,0,5
2007,Niger,NER,France,FRA,5,0,0,0,5
2007,Nigeria,NGA,France,FRA,35,10,0,0,45
2007,Pakistan,PAK,France,FRA,27,5,0,0,32
2007,Peru,PER,France,FRA,10,5,0,0,15
2007,Romania,ROU,France,FRA,5,0,0,0,5
2007,Russian Federation,RUS,France,FRA,454,48,0,0,502
2007,Rwanda,RWA,France,FRA,58,0,0,0,58
2007,Serbia and Kosovo: S/RES/1244 (1999),SRB,France,FRA,531,46,0,0,577
2007,Senegal,SEN,France,FRA,5,0,0,0,5
2007,Sierra Leone,SLE,France,FRA,11,0,0,0,11
2007,Somalia,SOM,France,FRA,16,0,0,0,16
2007,Sudan,SDN,France,FRA,54,5,0,0,59
2007,Syrian Arab Rep.,SYR,France,FRA,5,5,0,0,10
2007,Togo,TGO,France,FRA,44,0,0,0,44
2007,Turkey,TUR,France,FRA,465,11,0,0,476
2007,Ukraine,UKR,France,FRA,22,5,0,0,27
2007,Uzbekistan,UZB,France,FRA,5,5,0,0,10
2007,Unknown ,,France,FRA,33,11,0,0,44
2007,Afghanistan,AFG,Germany,DEU,38,58,10,239,345
2007,Albania,ALB,Germany,DEU,0,0,0,24,24
2007,Algeria,DZA,Germany,DEU,0,0,5,112,117
2007,Angola,AGO,Germany,DEU,0,0,0,13,13
2007,Egypt,EGY,Germany,DEU,0,0,0,14,14
2007,Armenia,ARM,Germany,DEU,10,0,5,71,86
2007,Azerbaijan,AZE,Germany,DEU,14,0,0,56,70
2007,Benin,BEN,Germany,DEU,0,0,0,5,5
2007,Bangladesh,BGD,Germany,DEU,0,0,0,5,5
2007,Burkina Faso,BFA,Germany,DEU,0,0,0,5,5
2007,Belarus,BLR,Germany,DEU,0,0,0,27,27
2007,Bosnia and Herzegovina,BIH,Germany,DEU,0,5,5,81,91
2007,Bulgaria,BGR,Germany,DEU,0,0,0,10,10
2007,China,CHN,Germany,DEU,0,5,5,59,69
2007,Cameroon,CMR,Germany,DEU,5,0,5,39,49
2007,Dem. Rep. of the Congo,COD,Germany,DEU,0,0,0,43,43
2007,Czechia,CZE,Germany,DEU,0,0,0,10,10
2007,Eritrea,ERI,Germany,DEU,48,65,5,36,154
2007,Ethiopia,ETH,Germany,DEU,0,11,0,65,76
2007,Gambia,GMB,Germany,DEU,0,0,0,10,10
2007,Georgia,GEO,Germany,DEU,0,5,5,49,59
2007,Ghana,GHA,Germany,DEU,0,0,5,42,47
2007,Guinea,GIN,Germany,DEU,0,0,0,25,25
2007,Croatia,HRV,Germany,DEU,0,0,0,5,5
2007,Hungary,HUN,Germany,DEU,0,0,5,10,15
2007,Cote d'Ivoire,CIV,Germany,DEU,0,0,0,15,15
2007,India,IND,Germany,DEU,0,0,5,80,85
2007,Iran (Islamic Rep. of),IRN,Germany,DEU,149,89,42,413,693
2007,Iraq,IRQ,Germany,DEU,3994,12,29,611,4646
2007,Israel,ISR,Germany,DEU,0,0,0,5,5
2007,Jordan,JOR,Germany,DEU,0,0,0,5,5
2007,Kenya,KEN,Germany,DEU,0,0,0,5,5
2007,Liberia,LBR,Germany,DEU,0,0,0,5,5
2007,Libya,LBY,Germany,DEU,0,0,0,12,12
2007,Lebanon,LBN,Germany,DEU,0,0,21,109,130
2007,Sri Lanka,LKA,Germany,DEU,10,18,5,62,95
2007,North Macedonia,MKD,Germany,DEU,0,0,10,64,74
2007,Rep. of Moldova,MDA,Germany,DEU,0,0,0,10,10
2007,Mongolia,MNG,Germany,DEU,0,0,0,5,5
2007,Morocco,MAR,Germany,DEU,0,0,5,30,35
2007,Montenegro,MNE,Germany,DEU,0,0,0,33,33
2007,Nepal,NPL,Germany,DEU,0,0,0,10,10
2007,Niger,NER,Germany,DEU,0,0,0,5,5
2007,Nigeria,NGA,Germany,DEU,0,0,5,70,75
2007,Pakistan,PAK,Germany,DEU,0,0,30,111,141
2007,Poland,POL,Germany,DEU,0,0,0,5,5
2007,Romania,ROU,Germany,DEU,0,0,0,5,5
2007,Russian Federation,RUS,Germany,DEU,86,5,10,238,339
2007,Serbia and Kosovo: S/RES/1244 (1999),SRB,Germany,DEU,11,18,33,962,1024
2007,Senegal,SEN,Germany,DEU,0,0,0,5,5
2007,Sierra Leone,SLE,Germany,DEU,0,0,0,24,24
2007,Somalia,SOM,Germany,DEU,15,17,0,16,48
2007,Viet Nam,VNM,Germany,DEU,0,0,5,143,148
2007,Sudan,SDN,Germany,DEU,0,0,0,10,10
2007,Slovakia,SVK,Germany,DEU,0,0,5,161,166
2007,Syrian Arab Rep.,SYR,Germany,DEU,35,13,12,126,186
2007,United Rep. of Tanzania,TZA,Germany,DEU,0,0,0,5,5
2007,Turkmenistan,TKM,Germany,DEU,0,0,0,5,5
2007,Togo,TGO,Germany,DEU,0,0,5,42,47
2007,Tunisia,TUN,Germany,DEU,0,0,5,20,25
2007,Turkey,TUR,Germany,DEU,29,10,43,621,703
2007,Uganda,UGA,Germany,DEU,0,0,0,5,5
2007,Ukraine,UKR,Germany,DEU,0,0,0,22,22
2007,Yemen,YEM,Germany,DEU,0,0,0,5,5
2007,Zimbabwe,ZWE,Germany,DEU,0,0,0,5,5
2007,Stateless,XXA,Germany,DEU,0,0,0,5,5
2007,Unknown ,,Germany,DEU,5,0,5,135,145
2007,Palestinian,PSE,Croatia,HRV,0,0,10,0,10
2008,Afghanistan,AFG,Germany,DEU,36,45,5,80,166
2008,Albania,ALB,Germany,DEU,0,5,0,10,15
2008,Algeria,DZA,Germany,DEU,0,0,5,74,79
2008,Angola,AGO,Germany,DEU,0,0,0,10,10
2008,Egypt,EGY,Germany,DEU,0,0,0,5,5
2008,Armenia,ARM,Germany,DEU,0,0,5,78,83
2008,Azerbaijan,AZE,Germany,DEU,39,0,5,65,109
2008,Bangladesh,BGD,Germany,DEU,0,0,0,10,10
2008,Belarus,BLR,Germany,DEU,0,0,0,10,10
2008,Bosnia and Herzegovina,BIH,Germany,DEU,0,0,0,62,62
2008,China,CHN,Germany,DEU,5,10,0,18,33
2008,Cameroon,CMR,Germany,DEU,0,0,0,18,18
2008,Dem. Rep. of the Congo,COD,Germany,DEU,0,0,0,14,14
2008,Czechia,CZE,Germany,DEU,0,0,0,5,5
2008,Eritrea,ERI,Germany,DEU,21,18,0,5,44
2008,Ethiopia,ETH,Germany,DEU,10,5,0,36,51
2008,Gambia,GMB,Germany,DEU,0,0,0,5,5
2008,Georgia,GEO,Germany,DEU,0,0,0,53,53
2008,Ghana,GHA,Germany,DEU,0,0,0,15,15
2008,Guinea,GIN,Germany,DEU,0,0,0,10,10
2008,Croatia,HRV,Germany,DEU,0,0,0,5,5
2008,India,IND,Germany,DEU,0,0,5,52,57
2008,Iran (Islamic Rep. of),IRN,Germany,DEU,210,14,28,198,450
2008,Iraq,IRQ,Germany,DEU,855,44,5,579,1483
2008,Kazakhstan,KAZ,Germany,DEU,0,0,0,5,5
2008,Libya,LBY,Germany,DEU,0,0,0,5,5
2008,Lebanon,LBN,Germany,DEU,5,0,10,37,52
2008,Sri Lanka,LKA,Germany,DEU,31,17,5,65,118
2008,North Macedonia,MKD,Germany,DEU,0,0,0,57,57
2008,Rep. of Moldova,MDA,Germany,DEU,0,0,0,5,5
2008,Morocco,MAR,Germany,DEU,5,0,0,16,21
2008,Montenegro,MNE,Germany,DEU,0,0,0,17,17
2008,Nepal,NPL,Germany,DEU,0,0,0,5,5
2008,Nigeria,NGA,Germany,DEU,5,0,0,47,52
2008,Pakistan,PAK,Germany,DEU,5,0,10,43,58
2008,Romania,ROU,Germany,DEU,0,0,0,5,5
2008,Russian Federation,RUS,Germany,DEU,46,15,0,113,174
2008,Serbia and Kosovo: S/RES/1244 (1999),SRB,Germany,DEU,5,15,26,550,596
2008,Sierra Leone,SLE,Germany,DEU,0,0,0,10,10
2008,Somalia,SOM,Germany,DEU,18,5,0,5,28
2008,Viet Nam,VNM,Germany,DEU,0,0,20,178,198
2008,Sudan,SDN,Germany,DEU,0,0,0,5,5
2008,Slovakia,SVK,Germany,DEU,0,0,0,34,34
2008,Syrian Arab Rep.,SYR,Germany,DEU,38,5,5,95,143
2008,Togo,TGO,Germany,DEU,0,0,5,22,27
2008,Tunisia,TUN,Germany,DEU,0,5,0,18,23
2008,Turkey,TUR,Germany,DEU,42,5,22,372,441
2008,Uganda,UGA,Germany,DEU,0,0,0,5,5
2008,Ukraine,UKR,Germany,DEU,0,0,0,10,10
2008,Uzbekistan,UZB,Germany,DEU,0,0,5,0,5
2008,Stateless,XXA,Germany,DEU,0,0,0,5,5
2008,Unknown ,,Germany,DEU,12,0,5,94,111
2009,Afghanistan,AFG,France,FRA,18,14,0,0,32
2009,Albania,ALB,France,FRA,19,27,0,0,46
2009,Algeria,DZA,France,FRA,17,10,0,0,27
2009,Angola,AGO,France,FRA,63,10,0,0,73
2009,Egypt,EGY,France,FRA,10,0,0,0,10
2009,Armenia,ARM,France,FRA,281,79,0,0,360
2009,Azerbaijan,AZE,France,FRA,205,0,0,0,205
2009,Bangladesh,BGD,France,FRA,291,5,0,0,296
2009,Bhutan,BTN,France,FRA,5,0,0,0,5
2009,Belarus,BLR,France,FRA,15,0,0,0,15
2009,Bosnia and Herzegovina,BIH,France,FRA,13,0,0,0,13
2009,Central African Rep.,CAF,France,FRA,10,0,0,0,10
2009,Chad,TCD,France,FRA,47,0,0,0,47
2009,China,CHN,France,FRA,10,0,0,0,10
2009,Cameroon,CMR,France,FRA,18,5,0,0,23
2009,Congo,COG,France,FRA,72,26,0,0,98
2009,Dem. Rep. of the Congo,COD,France,FRA,253,25,0,0,278
2009,Comoros,COM,France,FRA,49,0,0,0,49
2009,Colombia,COL,France,FRA,0,10,0,0,10
2009,Eritrea,ERI,France,FRA,10,0,0,0,10
2009,Ethiopia,ETH,France,FRA,5,0,0,0,5
2009,Palestinian,PSE,France,FRA,5,0,0,0,5
2009,Georgia,GEO,France,FRA,44,5,0,0,49
2009,Guinea,GIN,France,FRA,147,58,0,0,205
2009,Haiti,HTI,France,FRA,16,17,0,0,33
2009,Cote d'Ivoire,CIV,France,FRA,47,21,0,0,68
2009,Iran (Islamic Rep. of),IRN,France,FRA,20,10,0,0,30
2009,Iraq,IRQ,France,FRA,11,5,0,0,16
2009,Kazakhstan,KAZ,France,FRA,5,0,0,0,5
2009,Kyrgyzstan,KGZ,France,FRA,5,5,0,0,10
2009,Lebanon,LBN,France,FRA,5,0,0,0,5
2009,Sri Lanka,LKA,France,FRA,593,616,0,0,1209
2009,Mauritania,MRT,France,FRA,64,5,0,0,69
2009,North Macedonia,MKD,France,FRA,5,0,0,0,5
2009,Mali,MLI,France,FRA,15,88,0,0,103
2009,Mongolia,MNG,France,FRA,5,10,0,0,15
2009,Myanmar,MMR,France,FRA,10,0,0,0,10
2009,Nepal,NPL,France,FRA,5,0,0,0,5
2009,Nigeria,NGA,France,FRA,11,17,0,0,28
2009,Pakistan,PAK,France,FRA,15,5,0,0,20
2009,Russian Federation,RUS,France,FRA,713,49,0,0,762
2009,Rwanda,RWA,France,FRA,53,0,0,0,53
2009,Serbia and Kosovo: S/RES/1244 (1999),SRB,France,FRA,333,125,0,0,458
2009,Senegal,SEN,France,FRA,5,16,0,0,21
2009,Sierra Leone,SLE,France,FRA,5,0,0,0,5
2009,Somalia,SOM,France,FRA,0,5,0,0,5
2009,Sudan,SDN,France,FRA,84,10,0,0,94
2009,Togo,TGO,France,FRA,21,0,0,0,21
2009,Turkey,TUR,France,FRA,318,10,0,0,328
2009,Ukraine,UKR,France,FRA,10,0,0,0,10
2009,Uzbekistan,UZB,France,FRA,10,0,0,0,10
2009,Unknown ,,France,FRA,19,5,0,0,24
2009,Afghanistan,AFG,Germany,DEU,38,50,5,87,180
2009,Albania,ALB,Germany,DEU,0,0,0,11,11
2009,Algeria,DZA,Germany,DEU,0,0,5,85,90
2009,Angola,AGO,Germany,DEU,0,0,0,5,5
2009,Egypt,EGY,Germany,DEU,0,0,0,5,5
2009,Armenia,ARM,Germany,DEU,5,5,0,69,79
2009,Azerbaijan,AZE,Germany,DEU,23,5,0,80,108
2009,Burkina Faso,BFA,Germany,DEU,0,0,0,5,5
2009,Belarus,BLR,Germany,DEU,0,0,0,5,5
2009,Bosnia and Herzegovina,BIH,Germany,DEU,0,5,0,74,79
2009,Bulgaria,BGR,Germany,DEU,0,0,0,13,13
2009,China,CHN,Germany,DEU,5,11,0,28,44
2009,Cameroon,CMR,Germany,DEU,0,0,0,24,24
2009,Dem. Rep. of the Congo,COD,Germany,DEU,0,0,0,28,28
2009,Colombia,COL,Germany,DEU,0,0,0,5,5
2009,Czechia,CZE,Germany,DEU,0,0,0,5,5
2009,Eritrea,ERI,Germany,DEU,25,21,0,5,51
2009,Ethiopia,ETH,Germany,DEU,5,5,5,32,47
2009,Gambia,GMB,Germany,DEU,0,0,0,5,5
2009,Georgia,GEO,Germany,DEU,0,0,5,49,54
2009,Ghana,GHA,Germany,DEU,0,0,0,23,23
2009,Guinea,GIN,Germany,DEU,0,5,0,14,19
2009,Croatia,HRV,Germany,DEU,0,0,0,5,5
2009,Hungary,HUN,Germany,DEU,0,0,0,10,10
2009,Cote d'Ivoire,CIV,Germany,DEU,0,0,0,5,5
2009,India,IND,Germany,DEU,0,0,0,70,70
2009,Iran (Islamic Rep. of),IRN,Germany,DEU,248,19,28,133,428
2009,Iraq,IRQ,Germany,DEU,430,109,36,1097,1672
2009,Israel,ISR,Germany,DEU,0,0,0,5,5
2009,Jordan,JOR,Germany,DEU,0,0,0,18,18
2009,Kenya,KEN,Germany,DEU,0,0,0,5,5
2009,Liberia,LBR,Germany,DEU,0,0,0,5,5
2009,Lebanon,LBN,Germany,DEU,0,0,5,54,59
2009,Sri Lanka,LKA,Germany,DEU,25,21,5,23,74
2009,North Macedonia,MKD,Germany,DEU,0,0,5,25,30
2009,Rep. of Moldova,MDA,Germany,DEU,0,0,0,5,5
2009,Morocco,MAR,Germany,DEU,0,0,0,18,18
2009,Montenegro,MNE,Germany,DEU,5,0,0,32,37
2009,Nepal,NPL,Germany,DEU,0,0,0,5,5
2009,Nigeria,NGA,Germany,DEU,0,5,0,36,41
2009,Pakistan,PAK,Germany,DEU,13,0,5,38,56
2009,Russian Federation,RUS,Germany,DEU,48,11,0,141,200
2009,Rwanda,RWA,Germany,DEU,0,0,0,5,5
2009,Serbia and Kosovo: S/RES/1244 (1999),SRB,Germany,DEU,5,28,35,622,690
2009,Sierra Leone,SLE,Germany,DEU,0,0,0,20,20
2009,Somalia,SOM,Germany,DEU,11,5,0,5,21
2009,Viet Nam,VNM,Germany,DEU,0,5,22,221,248
2009,Sudan,SDN,Germany,DEU,0,0,0,12,12
2009,Slovakia,SVK,Germany,DEU,0,0,0,16,16
2009,Syrian Arab Rep.,SYR,Germany,DEU,39,10,5,201,255
2009,Togo,TGO,Germany,DEU,0,0,5,23,28
2009,Tunisia,TUN,Germany,DEU,0,0,0,23,23
2009,Turkey,TUR,Germany,DEU,47,15,21,371,454
2009,Uganda,UGA,Germany,DEU,0,0,0,5,5
2009,Ukraine,UKR,Germany,DEU,0,0,0,5,5
2009,Uzbekistan,UZB,Germany,DEU,0,0,0,5,5
2009,Stateless,XXA,Germany,DEU,5,0,0,5,10
2009,Unknown ,,Germany,DEU,10,5,5,118,138
2010,Afghanistan,AFG,France,FRA,36,50,0,0,86
2010,Albania,ALB,France,FRA,11,29,0,0,40
2010,Algeria,DZA,France,FRA,13,10,0,0,23
2010,Angola,AGO,France,FRA,44,5,0,0,49
2010,Egypt,EGY,France,FRA,10,0,0,0,10
2010,Armenia,ARM,France,FRA,149,49,0,0,198
2010,Azerbaijan,AZE,France,FRA,94,5,0,0,99
2010,Burundi,BDI,France,FRA,5,0,0,0,5
2010,Bangladesh,BGD,France,FRA,337,5,0,0,342
2010,Bhutan,BTN,France,FRA,10,0,0,0,10
2010,Belarus,BLR,France,FRA,5,5,0,0,10
2010,Bosnia and Herzegovina,BIH,France,FRA,28,0,0,0,28
2010,Cambodia,KHM,France,FRA,5,0,0,0,5
2010,Central African Rep.,CAF,France,FRA,12,0,0,0,12
2010,Chad,TCD,France,FRA,33,0,0,0,33
2010,China,CHN,France,FRA,12,0,0,0,12
2010,Cameroon,CMR,France,FRA,22,5,0,0,27
2010,Congo,COG,France,FRA,70,17,0,0,87
2010,Dem. Rep. of the Congo,COD,France,FRA,325,26,0,0,351
2010,Comoros,COM,France,FRA,11,0,0,0,11
2010,Colombia,COL,France,FRA,10,0,0,0,10
2010,Eritrea,ERI,France,FRA,10,0,0,0,10
2010,Gambia,GMB,France,FRA,0,5,0,0,5
2010,Palestinian,PSE,France,FRA,5,0,0,0,5
2010,Georgia,GEO,France,FRA,36,5,0,0,41
2010,Guinea-Bissau,GNB,France,FRA,5,0,0,0,5
2010,Guinea,GIN,France,FRA,174,66,0,0,240
2010,Haiti,HTI,France,FRA,14,21,0,0,35
2010,Cote d'Ivoire,CIV,France,FRA,28,10,0,0,38
2010,Iran (Islamic Rep. of),IRN,France,FRA,23,0,0,0,23
2010,Iraq,IRQ,France,FRA,13,0,0,0,13
2010,Kazakhstan,KAZ,France,FRA,5,0,0,0,5
2010,Kenya,KEN,France,FRA,0,5,0,0,5
2010,Kyrgyzstan,KGZ,France,FRA,5,0,0,0,5
2010,Sri Lanka,LKA,France,FRA,841,161,0,0,1002
2010,Mauritania,MRT,France,FRA,92,23,0,0,115
2010,North Macedonia,MKD,France,FRA,10,5,0,0,15
2010,Mali,MLI,France,FRA,10,176,0,0,186
2010,Mongolia,MNG,France,FRA,11,5,0,0,16
2010,Montenegro,MNE,France,FRA,10,0,0,0,10
2010,Myanmar,MMR,France,FRA,5,0,0,0,5
2010,Nepal,NPL,France,FRA,13,0,0,0,13
2010,Niger,NER,France,FRA,5,0,0,0,5
2010,Nigeria,NGA,France,FRA,22,27,0,0,49
2010,Pakistan,PAK,France,FRA,37,5,0,0,42
2010,Russian Federation,RUS,France,FRA,748,58,0,0,806
2010,Rwanda,RWA,France,FRA,31,0,0,0,31
2010,Serbia and Kosovo: S/RES/1244 (1999),SRB,France,FRA,327,157,0,0,484
2010,Senegal,SEN,France,FRA,0,19,0,0,19
2010,Sierra Leone,SLE,France,FRA,5,10,0,0,15
2010,Somalia,SOM,France,FRA,5,5,0,0,10
2010,Sudan,SDN,France,FRA,83,10,0,0,93
2010,Syrian Arab Rep.,SYR,France,FRA,11,0,0,0,11
2010,Togo,TGO,France,FRA,21,0,0,0,21
2010,Turkey,TUR,France,FRA,354,17,0,0,371
2010,Uganda,UGA,France,FRA,5,0,0,0,5
2010,Ukraine,UKR,France,FRA,5,0,0,0,5
2010,Unknown ,,France,FRA,15,13,0,0,28
2010,Afghanistan,AFG,United Kingdom of Great Britain and Northern Ireland,GBR,0,0,0,19,19
2010,Albania,ALB,United Kingdom of Great Britain and Northern Ireland,GBR,0,0,0,5,5
2010,Algeria,DZA,United Kingdom of Great Britain and Northern Ireland,GBR,0,0,5,10,15
2010,Egypt,EGY,United Kingdom of Great Britain and Northern Ireland,GBR,0,0,5,0,5
2010,Armenia,ARM,United Kingdom of Great Britain and Northern Ireland,GBR,0,0,5,0,5
2010,Bangladesh,BGD,United Kingdom of Great Britain and Northern Ireland,GBR,0,0,0,5,5
2010,China,CHN,United Kingdom of Great Britain and Northern Ireland,GBR,0,0,10,5,15
2010,Eritrea,ERI,United Kingdom of Great Britain and Northern Ireland,GBR,0,0,0,5,5
2010,Gambia,GMB,United Kingdom of Great Britain and Northern Ireland,GBR,0,0,5,5,10
2010,Palestinian,PSE,United Kingdom of Great Britain and Northern Ireland,GBR,0,0,0,5,5
2010,India,IND,United Kingdom of Great Britain and Northern Ireland,GBR,0,0,15,5,20
2010,Iran (Islamic Rep. of),IRN,United Kingdom of Great Britain and Northern Ireland,GBR,0,5,14,11,30
2010,Iraq,IRQ,United Kingdom of Great Britain and Northern Ireland,GBR,0,0,10,11,21
2010,Lebanon,LBN,United Kingdom of Great Britain and Northern Ireland,GBR,0,0,0,5,5
2010,Sri Lanka,LKA,United Kingdom of Great Britain and Northern Ireland,GBR,0,0,5,5,10
2010,Malawi,MWI,United Kingdom of Great Britain and Northern Ireland,GBR,0,0,0,5,5
2010,Nigeria,NGA,United Kingdom of Great Britain and Northern Ireland,GBR,0,0,15,11,26
2010,Pakistan,PAK,United Kingdom of Great Britain and Northern Ireland,GBR,0,0,21,10,31
2010,South Africa,ZAF,United Kingdom of Great Britain and Northern Ireland,GBR,0,0,5,0,5
2010,Serbia and Kosovo: S/RES/1244 (1999),SRB,United Kingdom of Great Britain and Northern Ireland,GBR,0,0,0,5,5
2010,Somalia,SOM,United Kingdom of Great Britain and Northern Ireland,GBR,5,0,0,5,10
2010,Viet Nam,VNM,United Kingdom of Great Britain and Northern Ireland,GBR,0,0,0,10,10
2010,Sudan,SDN,United Kingdom of Great Britain and Northern Ireland,GBR,5,0,0,10,15
2010,Syrian Arab Rep.,SYR,United Kingdom of Great Britain and Northern Ireland,GBR,0,0,0,5,5
2010,Uganda,UGA,United Kingdom of Great Britain and Northern Ireland,GBR,0,0,5,0,5
2010,Zimbabwe,ZWE,United Kingdom of Great Britain and Northern Ireland,GBR,10,0,10,0,20
2010,Unknown ,,United Kingdom of Great Britain and Northern Ireland,GBR,0,0,5,5,10
2010,Afghanistan,AFG,Germany,DEU,42,31,10,79,162
2010,Albania,ALB,Germany,DEU,0,0,0,5,5
2010,Algeria,DZA,Germany,DEU,0,0,15,110,125
2010,Angola,AGO,Germany,DEU,0,0,0,13,13
2010,Egypt,EGY,Germany,DEU,0,0,0,22,22
2010,Armenia,ARM,Germany,DEU,0,5,0,105,110
2010,Azerbaijan,AZE,Germany,DEU,5,5,5,96,111
2010,Bangladesh,BGD,Germany,DEU,0,0,0,16,16
2010,Burkina Faso,BFA,Germany,DEU,0,0,0,5,5
2010,Belarus,BLR,Germany,DEU,0,0,0,10,10
2010,Bosnia and Herzegovina,BIH,Germany,DEU,0,5,16,67,88
2010,China,CHN,Germany,DEU,5,5,5,50,65
2010,Cameroon,CMR,Germany,DEU,0,0,0,33,33
2010,Congo,COG,Germany,DEU,0,0,0,5,5
2010,Dem. Rep. of the Congo,COD,Germany,DEU,5,5,0,37,47
2010,Colombia,COL,Germany,DEU,0,0,0,5,5
2010,Czechia,CZE,Germany,DEU,0,0,0,5,5
2010,Eritrea,ERI,Germany,DEU,10,14,0,5,29
2010,Ethiopia,ETH,Germany,DEU,5,17,5,46,73
2010,Gambia,GMB,Germany,DEU,0,0,0,5,5
2010,Georgia,GEO,Germany,DEU,0,5,5,96,106
2010,Ghana,GHA,Germany,DEU,0,0,5,31,36
2010,Guinea,GIN,Germany,DEU,0,0,0,28,28
2010,Croatia,HRV,Germany,DEU,0,0,0,5,5
2010,Cote d'Ivoire,CIV,Germany,DEU,0,0,0,5,5
2010,India,IND,Germany,DEU,0,0,5,93,98
2010,Iran (Islamic Rep. of),IRN,Germany,DEU,425,52,31,312,820
2010,Iraq,IRQ,Germany,DEU,154,39,28,308,529
2010,Jordan,JOR,Germany,DEU,0,0,0,12,12
2010,Kazakhstan,KAZ,Germany,DEU,0,0,0,5,5
2010,Kenya,KEN,Germany,DEU,0,0,0,5,5
2010,Lebanon,LBN,Germany,DEU,5,0,17,78,100
2010,Sri Lanka,LKA,Germany,DEU,14,11,5,54,84
2010,North Macedonia,MKD,Germany,DEU,0,5,367,429,801
2010,Rep. of Moldova,MDA,Germany,DEU,0,0,0,5,5
2010,Mongolia,MNG,Germany,DEU,0,0,0,5,5
2010,Morocco,MAR,Germany,DEU,0,5,0,22,27
2010,Montenegro,MNE,Germany,DEU,0,0,5,44,49
2010,Nepal,NPL,Germany,DEU,0,0,0,5,5
2010,Nigeria,NGA,Germany,DEU,0,5,5,64,74
2010,Pakistan,PAK,Germany,DEU,5,5,10,94,114
2010,Poland,POL,Germany,DEU,0,0,0,5,5
2010,Russian Federation,RUS,Germany,DEU,53,16,11,180,260
2010,Serbia and Kosovo: S/RES/1244 (1999),SRB,Germany,DEU,5,54,495,1472,2026
2010,Sierra Leone,SLE,Germany,DEU,0,0,0,20,20
2010,Somalia,SOM,Germany,DEU,5,5,0,5,15
2010,Viet Nam,VNM,Germany,DEU,0,0,10,185,195
2010,Sudan,SDN,Germany,DEU,0,0,0,5,5
2010,Slovakia,SVK,Germany,DEU,0,0,0,5,5
2010,Syrian Arab Rep.,SYR,Germany,DEU,90,26,18,484,618
2010,Togo,TGO,Germany,DEU,0,0,5,21,26
2010,Tunisia,TUN,Germany,DEU,0,0,0,19,19
2010,Turkey,TUR,Germany,DEU,63,12,33,342,450
2010,Uganda,UGA,Germany,DEU,0,0,0,5,5
2010,Ukraine,UKR,Germany,DEU,0,0,0,10,10
2010,Yemen,YEM,Germany,DEU,0,0,0,5,5
2010,Zimbabwe,ZWE,Germany,DEU,0,0,0,5,5
2010,Stateless,XXA,Germany,DEU,0,0,0,18,18
2010,Unknown ,,Germany,DEU,19,5,5,200,229
2011,Afghanistan,AFG,United Kingdom of Great Britain and Northern Ireland,GBR,0,0,0,10,10
2011,Albania,ALB,United Kingdom of Great Britain and Northern Ireland,GBR,0,0,0,5,5
2011,Algeria,DZA,United Kingdom of Great Britain and Northern Ireland,GBR,0,0,0,5,5
2011,Egypt,EGY,United Kingdom of Great Britain and Northern Ireland,GBR,0,0,0,5,5
2011,Bangladesh,BGD,United Kingdom of Great Britain and Northern Ireland,GBR,0,0,5,5,10
2011,United Kingdom of Great Britain and Northern Ireland,GBR,United Kingdom of Great Britain and Northern Ireland,GBR,0,0,0,5,5
2011,Georgia,GEO,United Kingdom of Great Britain and Northern Ireland,GBR,0,0,5,0,5
2011,India,IND,United Kingdom of Great Britain and Northern Ireland,GBR,0,0,0,5,5
2011,Iran (Islamic Rep. of),IRN,United Kingdom of Great Britain and Northern Ireland,GBR,0,5,5,0,10
2011,Iraq,IRQ,United Kingdom of Great Britain and Northern Ireland,GBR,0,5,5,5,15
2011,Sri Lanka,LKA,United Kingdom of Great Britain and Northern Ireland,GBR,5,0,0,5,10
2011,Nigeria,NGA,United Kingdom of Great Britain and Northern Ireland,GBR,0,0,5,5,10
2011,Pakistan,PAK,United Kingdom of Great Britain and Northern Ireland,GBR,0,0,5,10,15
2011,Serbia and Kosovo: S/RES/1244 (1999),SRB,United Kingdom of Great Britain and Northern Ireland,GBR,0,0,0,5,5
2011,Somalia,SOM,United Kingdom of Great Britain and Northern Ireland,GBR,0,5,0,5,10
2011,Sudan,SDN,United Kingdom of Great Britain and Northern Ireland,GBR,0,0,0,5,5
2011,Zimbabwe,ZWE,United Kingdom of Great Britain and Northern Ireland,GBR,5,5,5,0,15
2011,Afghanistan,AFG,Germany,DEU,33,31,24,91,179
2011,Albania,ALB,Germany,DEU,0,0,0,5,5
2011,Algeria,DZA,Germany,DEU,0,0,10,76,86
2011,Angola,AGO,Germany,DEU,0,0,0,5,5
2011,Egypt,EGY,Germany,DEU,0,0,0,16,16
2011,Armenia,ARM,Germany,DEU,5,0,10,91,106
2011,Azerbaijan,AZE,Germany,DEU,10,5,0,71,86
2011,Bangladesh,BGD,Germany,DEU,0,0,0,10,10
2011,Belarus,BLR,Germany,DEU,0,0,0,15,15
2011,Bosnia and Herzegovina,BIH,Germany,DEU,0,0,10,62,72
2011,Bulgaria,BGR,Germany,DEU,0,0,0,11,11
2011,China,CHN,Germany,DEU,20,5,0,73,98
2011,Cameroon,CMR,Germany,DEU,0,0,0,10,10
2011,Dem. Rep. of the Congo,COD,Germany,DEU,0,0,0,16,16
2011,Colombia,COL,Germany,DEU,0,0,0,5,5
2011,Czechia,CZE,Germany,DEU,0,0,0,5,5
2011,Eritrea,ERI,Germany,DEU,15,5,0,5,25
2011,Ethiopia,ETH,Germany,DEU,0,5,5,21,31
2011,Gambia,GMB,Germany,DEU,0,0,0,5,5
2011,Georgia,GEO,Germany,DEU,0,0,0,66,66
2011,Ghana,GHA,Germany,DEU,0,0,5,18,23
2011,Guinea,GIN,Germany,DEU,0,0,5,24,29
2011,Croatia,HRV,Germany,DEU,0,0,0,5,5
2011,Cote d'Ivoire,CIV,Germany,DEU,0,0,0,5,5
2011,India,IND,Germany,DEU,0,0,0,75,75
2011,Iran (Islamic Rep. of),IRN,Germany,DEU,236,39,19,193,487
2011,Iraq,IRQ,Germany,DEU,110,27,27,191,355
2011,Israel,ISR,Germany,DEU,0,0,0,5,5
2011,Jordan,JOR,Germany,DEU,0,0,0,12,12
2011,Liberia,LBR,Germany,DEU,0,0,0,5,5
2011,Libya,LBY,Germany,DEU,0,0,0,5,5
2011,Lebanon,LBN,Germany,DEU,0,5,13,45,63
2011,Sri Lanka,LKA,Germany,DEU,0,5,5,25,35
2011,Latvia,LVA,Germany,DEU,0,0,0,5,5
2011,North Macedonia,MKD,Germany,DEU,0,5,286,436,727
2011,Rep. of Moldova,MDA,Germany,DEU,0,0,0,5,5
2011,Mongolia,MNG,Germany,DEU,0,0,0,5,5
2011,Morocco,MAR,Germany,DEU,0,0,0,29,29
2011,Montenegro,MNE,Germany,DEU,0,0,0,27,27
2011,Niger,NER,Germany,DEU,0,0,0,5,5
2011,Nigeria,NGA,Germany,DEU,0,5,0,42,47
2011,Pakistan,PAK,Germany,DEU,5,5,5,49,64
2011,Russian Federation,RUS,Germany,DEU,20,17,12,153,202
2011,Serbia and Kosovo: S/RES/1244 (1999),SRB,Germany,DEU,5,40,652,2237,2934
2011,Sierra Leone,SLE,Germany,DEU,0,5,0,13,18
2011,Somalia,SOM,Germany,DEU,5,5,0,11,21
2011,Viet Nam,VNM,Germany,DEU,0,5,5,123,133
2011,Sudan,SDN,Germany,DEU,0,0,0,5,5
2011,Slovakia,SVK,Germany,DEU,0,0,0,10,10
2011,Syrian Arab Rep.,SYR,Germany,DEU,106,23,0,98,227
2011,Tajikistan,TJK,Germany,DEU,0,0,0,5,5
2011,Togo,TGO,Germany,DEU,5,0,0,15,20
2011,Tunisia,TUN,Germany,DEU,0,0,0,23,23
2011,Turkey,TUR,Germany,DEU,15,11,39,259,324
2011,Uganda,UGA,Germany,DEU,0,0,0,5,5
2011,Ukraine,UKR,Germany,DEU,0,0,0,10,10
2011,Stateless,XXA,Germany,DEU,0,0,0,5,5
2011,Unknown ,,Germany,DEU,19,0,5,73,97
2012,Afghanistan,AFG,United Kingdom of Great Britain and Northern Ireland,GBR,0,5,5,18,28
2012,Albania,ALB,United Kingdom of Great Britain and Northern Ireland,GBR,0,0,5,5,10
2012,Algeria,DZA,United Kingdom of Great Britain and Northern Ireland,GBR,0,0,5,5,10
2012,Egypt,EGY,United Kingdom of Great Britain and Northern Ireland,GBR,0,0,0,5,5
2012,Bangladesh,BGD,United Kingdom of Great Britain and Northern Ireland,GBR,0,0,5,14,19
2012,China,CHN,United Kingdom of Great Britain and Northern Ireland,GBR,0,5,0,5,10
2012,Eritrea,ERI,United Kingdom of Great Britain and Northern Ireland,GBR,0,0,0,5,5
2012,India,IND,United Kingdom of Great Britain and Northern Ireland,GBR,0,0,0,30,30
2012,Iran (Islamic Rep. of),IRN,United Kingdom of Great Britain and Northern Ireland,GBR,5,0,13,5,23
2012,Iraq,IRQ,United Kingdom of Great Britain and Northern Ireland,GBR,0,5,5,5,15
2012,Sri Lanka,LKA,United Kingdom of Great Britain and Northern Ireland,GBR,0,5,0,5,10
2012,Nigeria,NGA,United Kingdom of Great Britain and Northern Ireland,GBR,0,0,10,5,15
2012,Pakistan,PAK,United Kingdom of Great Britain and Northern Ireland,GBR,0,0,24,26,50
2012,Somalia,SOM,United Kingdom of Great Britain and Northern Ireland,GBR,0,5,0,5,10
2012,Viet Nam,VNM,United Kingdom of Great Britain and Northern Ireland,GBR,0,0,0,5,5
2012,Sudan,SDN,United Kingdom of Great Britain and Northern Ireland,GBR,0,0,0,11,11
2012,Syrian Arab Rep.,SYR,United Kingdom of Great Britain and Northern Ireland,GBR,0,0,5,5,10
2012,Zimbabwe,ZWE,United Kingdom of Great Britain and Northern Ireland,GBR,5,10,5,0,20
2012,Afghanistan,AFG,Germany,DEU,34,20,12,102,168
2012,Albania,ALB,Germany,DEU,0,0,0,16,16
2012,Algeria,DZA,Germany,DEU,0,0,11,92,103
2012,Egypt,EGY,Germany,DEU,0,0,0,15,15
2012,Armenia,ARM,Germany,DEU,10,0,5,67,82
2012,Azerbaijan,AZE,Germany,DEU,0,5,5,41,51
2012,Bangladesh,BGD,Germany,DEU,0,0,0,5,5
2012,Belarus,BLR,Germany,DEU,0,0,0,12,12
2012,Bosnia and Herzegovina,BIH,Germany,DEU,0,5,54,218,277
2012,Bulgaria,BGR,Germany,DEU,0,0,0,15,15
2012,Cambodia,KHM,Germany,DEU,0,0,5,0,5
2012,China,CHN,Germany,DEU,5,5,5,56,71
2012,Cameroon,CMR,Germany,DEU,0,0,5,14,19
2012,Dem. Rep. of the Congo,COD,Germany,DEU,5,0,0,12,17
2012,Colombia,COL,Germany,DEU,0,0,0,5,5
2012,Czechia,CZE,Germany,DEU,0,0,0,5,5
2012,Eritrea,ERI,Germany,DEU,10,5,0,5,20
2012,Estonia,EST,Germany,DEU,0,0,0,10,10
2012,Ethiopia,ETH,Germany,DEU,0,5,0,22,27
2012,Gambia,GMB,Germany,DEU,0,0,0,13,13
2012,Georgia,GEO,Germany,DEU,0,0,5,73,78
2012,Ghana,GHA,Germany,DEU,0,0,0,14,14
2012,Guinea,GIN,Germany,DEU,0,5,0,26,31
2012,Croatia,HRV,Germany,DEU,0,0,0,5,5
2012,Hungary,HUN,Germany,DEU,0,0,5,0,5
2012,Cote d'Ivoire,CIV,Germany,DEU,0,0,0,10,10
2012,India,IND,Germany,DEU,0,0,0,44,44
2012,Iran (Islamic Rep. of),IRN,Germany,DEU,175,25,28,138,366
2012,Iraq,IRQ,Germany,DEU,63,25,19,165,272
2012,Jordan,JOR,Germany,DEU,5,0,0,5,10
2012,Libya,LBY,Germany,DEU,0,0,0,5,5
2012,Lebanon,LBN,Germany,DEU,0,0,5,48,53
2012,Sri Lanka,LKA,Germany,DEU,0,5,5,19,29
2012,North Macedonia,MKD,Germany,DEU,0,5,437,1735,2177
2012,Rep. of Moldova,MDA,Germany,DEU,0,0,0,5,5
2012,Morocco,MAR,Germany,DEU,0,0,5,29,34
2012,Montenegro,MNE,Germany,DEU,0,0,27,66,93
2012,Nigeria,NGA,Germany,DEU,0,5,5,52,62
2012,Pakistan,PAK,Germany,DEU,5,5,13,83,106
2012,Russian Federation,RUS,Germany,DEU,31,10,5,155,201
2012,Serbia and Kosovo: S/RES/1244 (1999),SRB,Germany,DEU,0,30,553,4512,5095
2012,Sierra Leone,SLE,Germany,DEU,0,0,0,5,5
2012,Somalia,SOM,Germany,DEU,0,5,0,30,35
2012,Viet Nam,VNM,Germany,DEU,0,0,5,78,83
2012,Sudan,SDN,Germany,DEU,0,0,0,5,5
2012,Slovakia,SVK,Germany,DEU,0,0,0,5,5
2012,Syrian Arab Rep.,SYR,Germany,DEU,279,1958,10,47,2294
2012,Togo,TGO,Germany,DEU,0,0,0,5,5
2012,Tunisia,TUN,Germany,DEU,0,0,5,29,34
2012,Turkey,TUR,Germany,DEU,21,13,21,233,288
2012,Ukraine,UKR,Germany,DEU,0,0,0,17,17
2012,Zimbabwe,ZWE,Germany,DEU,0,0,0,5,5
2012,Stateless,XXA,Germany,DEU,10,70,0,14,94
2012,Unknown ,,Germany,DEU,32,444,5,115,596
2013,Afghanistan,AFG,Belgium,BEL,0,0,0,71,71
2013,Albania,ALB,Belgium,BEL,0,0,0,42,42
2013,Algeria,DZA,Belgium,BEL,0,0,0,5,5
2013,Angola,AGO,Belgium,BEL,0,0,0,18,18
2013,Egypt,EGY,Belgium,BEL,0,0,0,24,24
2013,Armenia,ARM,Belgium,BEL,0,0,0,48,48
2013,Azerbaijan,AZE,Belgium,BEL,0,0,0,15,15
2013,Burundi,BDI,Belgium,BEL,0,0,0,22,22
2013,Bangladesh,BGD,Belgium,BEL,0,0,0,13,13
2013,Burkina Faso,BFA,Belgium,BEL,0,0,0,5,5
2013,Bosnia and Herzegovina,BIH,Belgium,BEL,0,0,0,12,12
2013,Cameroon,CMR,Belgium,BEL,0,0,0,22,22
2013,Dem. Rep. of the Congo,COD,Belgium,BEL,0,0,0,80,80
2013,Eritrea,ERI,Belgium,BEL,0,0,0,5,5
2013,Gambia,GMB,Belgium,BEL,0,0,0,5,5
2013,Georgia,GEO,Belgium,BEL,0,0,0,36,36
2013,Guinea,GIN,Belgium,BEL,0,0,0,102,102
2013,Croatia,HRV,Belgium,BEL,0,0,0,5,5
2013,Cote d'Ivoire,CIV,Belgium,BEL,0,0,0,22,22
2013,Iran (Islamic Rep. of),IRN,Belgium,BEL,0,0,0,51,51
2013,Iraq,IRQ,Belgium,BEL,0,0,0,94,94
2013,Kazakhstan,KAZ,Belgium,BEL,0,0,0,12,12
2013,Kenya,KEN,Belgium,BEL,0,0,0,5,5
2013,Kyrgyzstan,KGZ,Belgium,BEL,0,0,0,14,14
2013,Liberia,LBR,Belgium,BEL,0,0,0,5,5
2013,Lebanon,LBN,Belgium,BEL,0,0,0,11,11
2013,Sri Lanka,LKA,Belgium,BEL,0,0,0,12,12
2013,Mauritania,MRT,Belgium,BEL,0,0,0,37,37
2013,North Macedonia,MKD,Belgium,BEL,0,0,0,45,45
2013,Mongolia,MNG,Belgium,BEL,0,0,0,5,5
2013,Morocco,MAR,Belgium,BEL,0,0,0,10,10
2013,Nepal,NPL,Belgium,BEL,0,0,0,5,5
2013,Niger,NER,Belgium,BEL,0,0,0,5,5
2013,Nigeria,NGA,Belgium,BEL,0,0,0,16,16
2013,Pakistan,PAK,Belgium,BEL,0,0,0,34,34
2013,Russian Federation,RUS,Belgium,BEL,0,0,0,322,322
2013,Rwanda,RWA,Belgium,BEL,0,0,0,26,26
2013,Serbia and Kosovo: S/RES/1244 (1999),SRB,Belgium,BEL,0,0,0,185,185
2013,Senegal,SEN,Belgium,BEL,0,0,0,24,24
2013,Sierra Leone,SLE,Belgium,BEL,0,0,0,5,5
2013,Somalia,SOM,Belgium,BEL,0,0,0,17,17
2013,Sudan,SDN,Belgium,BEL,0,0,0,5,5
2013,Syrian Arab Rep.,SYR,Belgium,BEL,0,0,0,5,5
2013,United Rep. of Tanzania,TZA,Belgium,BEL,0,0,0,10,10
2013,Togo,TGO,Belgium,BEL,0,0,0,20,20
2013,Turkey,TUR,Belgium,BEL,0,0,0,20,20
2013,Ukraine,UKR,Belgium,BEL,0,0,0,5,5
2013,Afghanistan,AFG,United Kingdom of Great Britain and Northern Ireland,GBR,0,0,0,17,17
2013,Albania,ALB,United Kingdom of Great Britain and Northern Ireland,GBR,0,0,5,5,10
2013,Algeria,DZA,United Kingdom of Great Britain and Northern Ireland,GBR,0,0,0,5,5
2013,Bangladesh,BGD,United Kingdom of Great Britain and Northern Ireland,GBR,0,0,5,16,21
2013,China,CHN,United Kingdom of Great Britain and Northern Ireland,GBR,0,5,5,10,20
2013,Eritrea,ERI,United Kingdom of Great Britain and Northern Ireland,GBR,0,0,0,5,5
2013,India,IND,United Kingdom of Great Britain and Northern Ireland,GBR,0,0,0,17,17
2013,Iran (Islamic Rep. of),IRN,United Kingdom of Great Britain and Northern Ireland,GBR,5,0,5,5,15
2013,Iraq,IRQ,United Kingdom of Great Britain and Northern Ireland,GBR,0,0,0,5,5
2013,Sri Lanka,LKA,United Kingdom of Great Britain and Northern Ireland,GBR,0,0,0,5,5
2013,Malawi,MWI,United Kingdom of Great Britain and Northern Ireland,GBR,0,0,5,0,5
2013,Nigeria,NGA,United Kingdom of Great Britain and Northern Ireland,GBR,0,0,5,5,10
2013,Pakistan,PAK,United Kingdom of Great Britain and Northern Ireland,GBR,0,0,22,26,48
2013,Viet Nam,VNM,United Kingdom of Great Britain and Northern Ireland,GBR,0,0,0,5,5
2013,Sudan,SDN,United Kingdom of Great Britain and Northern Ireland,GBR,0,0,0,5,5
2013,Zimbabwe,ZWE,United Kingdom of Great Britain and Northern Ireland,GBR,0,5,0,0,5
2013,Afghanistan,AFG,Germany,DEU,109,60,12,174,355
2013,Albania,ALB,Germany,DEU,0,0,0,24,24
2013,Algeria,DZA,Germany,DEU,5,0,13,68,86
2013,Angola,AGO,Germany,DEU,0,0,0,5,5
2013,Egypt,EGY,Germany,DEU,0,0,0,12,12
2013,Armenia,ARM,Germany,DEU,5,5,0,87,97
2013,Azerbaijan,AZE,Germany,DEU,5,5,5,64,79
2013,Bangladesh,BGD,Germany,DEU,0,0,0,14,14
2013,Burkina Faso,BFA,Germany,DEU,0,0,0,5,5
2013,Belarus,BLR,Germany,DEU,0,0,0,13,13
2013,Bosnia and Herzegovina,BIH,Germany,DEU,0,0,70,933,1003
2013,Bulgaria,BGR,Germany,DEU,0,0,0,24,24
2013,Chad,TCD,Germany,DEU,0,0,0,5,5
2013,China,CHN,Germany,DEU,17,5,0,79,101
2013,Cameroon,CMR,Germany,DEU,0,5,0,16,21
2013,Dem. Rep. of the Congo,COD,Germany,DEU,0,5,5,13,23
2013,Colombia,COL,Germany,DEU,0,0,0,5,5
2013,Czechia,CZE,Germany,DEU,0,0,0,5,5
2013,Eritrea,ERI,Germany,DEU,5,5,0,10,20
2013,Ethiopia,ETH,Germany,DEU,0,0,0,20,20
2013,Gambia,GMB,Germany,DEU,0,0,0,10,10
2013,Georgia,GEO,Germany,DEU,0,0,5,126,131
2013,Ghana,GHA,Germany,DEU,0,0,0,16,16
2013,Guinea-Bissau,GNB,Germany,DEU,0,0,0,5,5
2013,Guinea,GIN,Germany,DEU,0,5,0,17,22
2013,Croatia,HRV,Germany,DEU,0,0,0,14,14
2013,Cote d'Ivoire,CIV,Germany,DEU,0,0,0,10,10
2013,India,IND,Germany,DEU,0,0,0,44,44
2013,Iran (Islamic Rep. of),IRN,Germany,DEU,139,34,17,108,298
2013,Iraq,IRQ,Germany,DEU,69,16,22,167,274
2013,Jordan,JOR,Germany,DEU,0,0,0,10,10
2013,Kazakhstan,KAZ,Germany,DEU,5,0,0,0,5
2013,Kenya,KEN,Germany,DEU,0,0,0,5,5
2013,Libya,LBY,Germany,DEU,0,0,0,13,13
2013,Lebanon,LBN,Germany,DEU,0,0,5,49,54
2013,Sri Lanka,LKA,Germany,DEU,10,5,0,39,54
2013,North Macedonia,MKD,Germany,DEU,0,0,354,2063,2417
2013,Morocco,MAR,Germany,DEU,0,5,0,34,39
2013,Montenegro,MNE,Germany,DEU,0,0,15,101,116
2013,Nigeria,NGA,Germany,DEU,0,5,0,50,55
2013,Pakistan,PAK,Germany,DEU,22,5,12,68,107
2013,Romania,ROU,Germany,DEU,0,0,0,5,5
2013,Russian Federation,RUS,Germany,DEU,14,26,19,412,471
2013,Serbia and Kosovo: S/RES/1244 (1999),SRB,Germany,DEU,0,20,431,4957,5408
2013,Sierra Leone,SLE,Germany,DEU,0,5,0,10,15
2013,Somalia,SOM,Germany,DEU,5,10,5,67,87
2013,Viet Nam,VNM,Germany,DEU,0,0,10,66,76
2013,Sudan,SDN,Germany,DEU,0,0,0,5,5
2013,Slovakia,SVK,Germany,DEU,0,0,0,19,19
2013,Syrian Arab Rep.,SYR,Germany,DEU,181,330,15,141,667
2013,Tajikistan,TJK,Germany,DEU,0,0,0,5,5
2013,Togo,TGO,Germany,DEU,0,0,5,11,16
2013,Tunisia,TUN,Germany,DEU,0,0,5,25,30
2013,Turkey,TUR,Germany,DEU,17,13,30,165,225
2013,Uganda,UGA,Germany,DEU,0,0,0,5,5
2013,Stateless,XXA,Germany,DEU,5,5,0,32,42
2013,Unknown ,,Germany,DEU,25,85,11,115,236
2013,Montenegro,MNE,Luxembourg,LUX,0,0,5,0,5
2013,Serbia and Kosovo: S/RES/1244 (1999),SRB,Luxembourg,LUX,0,0,14,0,14
2014,Iran (Islamic Rep. of),IRN,Armenia,ARM,0,0,5,0,5
2014,Afghanistan,AFG,Belgium,BEL,0,0,0,402,402
2014,Albania,ALB,Belgium,BEL,0,0,0,129,129
2014,Algeria,DZA,Belgium,BEL,0,0,0,36,36
2014,Angola,AGO,Belgium,BEL,0,0,0,25,25
2014,Egypt,EGY,Belgium,BEL,0,0,0,32,32
2014,Armenia,ARM,Belgium,BEL,0,0,0,97,97
2014,Azerbaijan,AZE,Belgium,BEL,0,0,0,51,51
2014,Burundi,BDI,Belgium,BEL,0,0,0,30,30
2014,Benin,BEN,Belgium,BEL,0,0,0,16,16
2014,Bangladesh,BGD,Belgium,BEL,0,0,0,86,86
2014,Burkina Faso,BFA,Belgium,BEL,0,0,0,13,13
2014,Belarus,BLR,Belgium,BEL,0,0,0,16,16
2014,Bosnia and Herzegovina,BIH,Belgium,BEL,0,0,0,27,27
2014,Bulgaria,BGR,Belgium,BEL,0,0,0,5,5
2014,Chad,TCD,Belgium,BEL,0,0,0,5,5
2014,China,CHN,Belgium,BEL,0,0,0,16,16
2014,Cameroon,CMR,Belgium,BEL,0,0,0,43,43
2014,Congo,COG,Belgium,BEL,0,0,0,5,5
2014,Dem. Rep. of the Congo,COD,Belgium,BEL,0,0,0,191,191
2014,Djibouti,DJI,Belgium,BEL,0,0,0,10,10
2014,Eritrea,ERI,Belgium,BEL,0,0,0,15,15
2014,Ethiopia,ETH,Belgium,BEL,0,0,0,5,5
2014,Gambia,GMB,Belgium,BEL,0,0,0,13,13
2014,Georgia,GEO,Belgium,BEL,0,0,0,98,98
2014,Ghana,GHA,Belgium,BEL,0,0,0,5,5
2014,Guinea-Bissau,GNB,Belgium,BEL,0,0,0,5,5
2014,Guinea,GIN,Belgium,BEL,0,0,0,444,444
2014,Croatia,HRV,Belgium,BEL,0,0,0,15,15
2014,Cote d'Ivoire,CIV,Belgium,BEL,0,0,0,31,31
2014,India,IND,Belgium,BEL,0,0,0,10,10
2014,Iran (Islamic Rep. of),IRN,Belgium,BEL,0,0,0,79,79
2014,Iraq,IRQ,Belgium,BEL,0,0,0,167,167
2014,Jordan,JOR,Belgium,BEL,0,0,0,5,5
2014,Kazakhstan,KAZ,Belgium,BEL,0,0,0,19,19
2014,Kenya,KEN,Belgium,BEL,0,0,0,5,5
2014,Kyrgyzstan,KGZ,Belgium,BEL,0,0,0,33,33
2014,Liberia,LBR,Belgium,BEL,0,0,0,18,18
2014,Lebanon,LBN,Belgium,BEL,0,0,0,23,23
2014,Sri Lanka,LKA,Belgium,BEL,0,0,0,29,29
2014,Mauritania,MRT,Belgium,BEL,0,0,0,70,70
2014,North Macedonia,MKD,Belgium,BEL,0,0,0,142,142
2014,Rep. of Moldova,MDA,Belgium,BEL,0,0,0,5,5
2014,Mali,MLI,Belgium,BEL,0,0,0,17,17
2014,Mongolia,MNG,Belgium,BEL,0,0,0,5,5
2014,Morocco,MAR,Belgium,BEL,0,0,0,45,45
2014,Myanmar,MMR,Belgium,BEL,0,0,0,10,10
2014,Nepal,NPL,Belgium,BEL,0,0,0,10,10
2014,Niger,NER,Belgium,BEL,0,0,0,15,15
2014,Nigeria,NGA,Belgium,BEL,0,0,0,32,32
2014,Pakistan,PAK,Belgium,BEL,0,0,0,147,147
2014,Russian Federation,RUS,Belgium,BEL,0,0,0,651,651
2014,Rwanda,RWA,Belgium,BEL,0,0,0,45,45
2014,Serbia and Kosovo: S/RES/1244 (1999),SRB,Belgium,BEL,0,0,0,428,428
2014,Senegal,SEN,Belgium,BEL,0,0,0,51,51
2014,Sierra Leone,SLE,Belgium,BEL,0,0,0,39,39
2014,Somalia,SOM,Belgium,BEL,0,0,0,53,53
2014,Sudan,SDN,Belgium,BEL,0,0,0,11,11
2014,Syrian Arab Rep.,SYR,Belgium,BEL,0,0,0,15,15
2014,United Rep. of Tanzania,TZA,Belgium,BEL,0,0,0,18,18
2014,Togo,TGO,Belgium,BEL,0,0,0,45,45
2014,Tunisia,TUN,Belgium,BEL,0,0,0,10,10
2014,Turkey,TUR,Belgium,BEL,0,0,0,107,107
2014,Uganda,UGA,Belgium,BEL,0,0,0,5,5
2014,Ukraine,UKR,Belgium,BEL,0,0,0,26,26
2014,Stateless,XXA,Belgium,BEL,0,0,0,5,5
2014,Unknown ,,Belgium,BEL,0,0,0,22,22
2014,Afghanistan,AFG,United Kingdom of Great Britain and Northern Ireland,GBR,0,0,5,5,10
2014,Albania,ALB,United Kingdom of Great Britain and Northern Ireland,GBR,0,0,0,5,5
2014,Bangladesh,BGD,United Kingdom of Great Britain and Northern Ireland,GBR,0,0,5,5,10
2014,Eritrea,ERI,United Kingdom of Great Britain and Northern Ireland,GBR,0,5,0,0,5
2014,India,IND,United Kingdom of Great Britain and Northern Ireland,GBR,0,0,0,5,5
2014,Iran (Islamic Rep. of),IRN,United Kingdom of Great Britain and Northern Ireland,GBR,5,0,5,10,20
2014,Iraq,IRQ,United Kingdom of Great Britain and Northern Ireland,GBR,0,0,5,10,15
2014,Lebanon,LBN,United Kingdom of Great Britain and Northern Ireland,GBR,0,0,0,5,5
2014,Pakistan,PAK,United Kingdom of Great Britain and Northern Ireland,GBR,0,0,11,22,33
2014,Somalia,SOM,United Kingdom of Great Britain and Northern Ireland,GBR,0,0,0,5,5
2014,Viet Nam,VNM,United Kingdom of Great Britain and Northern Ireland,GBR,0,0,0,5,5
2014,Afghanistan,AFG,Germany,DEU,196,70,15,130,411
2014,Albania,ALB,Germany,DEU,0,5,25,113,143
2014,Algeria,DZA,Germany,DEU,0,0,10,64,74
2014,Egypt,EGY,Germany,DEU,0,0,5,29,34
2014,Armenia,ARM,Germany,DEU,5,0,5,57,67
2014,Azerbaijan,AZE,Germany,DEU,5,5,5,34,49
2014,Bangladesh,BGD,Germany,DEU,5,0,0,15,20
2014,Burkina Faso,BFA,Germany,DEU,0,0,0,5,5
2014,Belarus,BLR,Germany,DEU,0,0,5,12,17
2014,Bosnia and Herzegovina,BIH,Germany,DEU,0,5,367,1735,2107
2014,Bulgaria,BGR,Germany,DEU,0,0,0,10,10
2014,Chad,TCD,Germany,DEU,0,0,0,28,28
2014,China,CHN,Germany,DEU,5,5,5,27,42
2014,Cameroon,CMR,Germany,DEU,0,0,5,10,15
2014,Dem. Rep. of the Congo,COD,Germany,DEU,0,0,0,10,10
2014,Eritrea,ERI,Germany,DEU,5,16,0,14,35
2014,Ethiopia,ETH,Germany,DEU,5,0,0,33,38
2014,Gambia,GMB,Germany,DEU,5,0,5,16,26
2014,Georgia,GEO,Germany,DEU,0,0,21,190,211
2014,Ghana,GHA,Germany,DEU,0,0,5,10,15
2014,Guinea-Bissau,GNB,Germany,DEU,0,0,0,10,10
2014,Guinea,GIN,Germany,DEU,0,5,5,25,35
2014,Croatia,HRV,Germany,DEU,0,0,0,5,5
2014,Hungary,HUN,Germany,DEU,0,0,0,10,10
2014,Cote d'Ivoire,CIV,Germany,DEU,0,0,0,12,12
2014,India,IND,Germany,DEU,0,0,5,25,30
2014,Iran (Islamic Rep. of),IRN,Germany,DEU,162,22,47,78,309
2014,Iraq,IRQ,Germany,DEU,620,22,21,78,741
2014,Israel,ISR,Germany,DEU,0,0,5,0,5
2014,Jordan,JOR,Germany,DEU,0,0,0,5,5
2014,Kazakhstan,KAZ,Germany,DEU,0,0,0,10,10
2014,Kenya,KEN,Germany,DEU,0,0,0,10,10
2014,Kyrgyzstan,KGZ,Germany,DEU,5,0,5,5,15
2014,Liberia,LBR,Germany,DEU,0,0,0,5,5
2014,Libya,LBY,Germany,DEU,5,0,5,10,20
2014,Lebanon,LBN,Germany,DEU,5,5,16,44,70
2014,Sri Lanka,LKA,Germany,DEU,5,5,5,31,46
2014,Mauritania,MRT,Germany,DEU,0,0,0,5,5
2014,North Macedonia,MKD,Germany,DEU,0,10,871,2058,2939
2014,Rep. of Moldova,MDA,Germany,DEU,0,0,5,5,10
2014,Mali,MLI,Germany,DEU,0,0,0,5,5
2014,Mongolia,MNG,Germany,DEU,0,0,0,5,5
2014,Morocco,MAR,Germany,DEU,0,0,10,46,56
2014,Montenegro,MNE,Germany,DEU,0,0,64,163,227
2014,Niger,NER,Germany,DEU,0,0,0,5,5
2014,Nigeria,NGA,Germany,DEU,5,5,5,31,46
2014,Pakistan,PAK,Germany,DEU,32,5,16,91,144
2014,Romania,ROU,Germany,DEU,0,0,5,0,5
2014,Russian Federation,RUS,Germany,DEU,10,65,45,891,1011
2014,Serbia and Kosovo: S/RES/1244 (1999),SRB,Germany,DEU,0,20,1755,7198,8973
2014,Sierra Leone,SLE,Germany,DEU,0,0,0,5,5
2014,Somalia,SOM,Germany,DEU,14,36,5,79,134
2014,Spain,ESP,Germany,DEU,0,0,0,5,5
2014,Viet Nam,VNM,Germany,DEU,0,0,11,33,44
2014,Sudan,SDN,Germany,DEU,0,0,0,12,12
2014,Slovakia,SVK,Germany,DEU,0,0,0,10,10
2014,Syrian Arab Rep.,SYR,Germany,DEU,947,354,10,366,1677
2014,Turkmenistan,TKM,Germany,DEU,0,0,0,5,5
2014,Togo,TGO,Germany,DEU,0,0,0,10,10
2014,Tunisia,TUN,Germany,DEU,0,0,18,59,77
2014,Turkey,TUR,Germany,DEU,5,10,39,114,168
2014,Ukraine,UKR,Germany,DEU,0,0,0,15,15
2014,Stateless,XXA,Germany,DEU,77,27,5,28,137
2014,Unknown ,,Germany,DEU,142,45,17,79,283
2014,Albania,ALB,Luxembourg,LUX,0,0,0,26,26
2014,Bosnia and Herzegovina,BIH,Luxembourg,LUX,0,0,0,5,5
2014,Montenegro,MNE,Luxembourg,LUX,0,0,0,10,10
2014,Serbia and Kosovo: S/RES/1244 (1999),SRB,Luxembourg,LUX,0,0,0,27,27
2014,Afghanistan,AFG,Sweden,SWE,5,39,14,17,75
2014,Algeria,DZA,Sweden,SWE,0,0,5,38,43
2014,Eritrea,ERI,Sweden,SWE,0,0,0,5,5
2014,Iraq,IRQ,Sweden,SWE,0,5,5,0,10
2014,Libya,LBY,Sweden,SWE,0,0,5,14,19
2014,Morocco,MAR,Sweden,SWE,0,0,24,69,93
2014,Montenegro,MNE,Sweden,SWE,0,5,5,0,10
2014,Russian Federation,RUS,Sweden,SWE,0,0,5,0,5
2014,Serbia and Kosovo: S/RES/1244 (1999),SRB,Sweden,SWE,0,0,10,0,10
2014,Somalia,SOM,Sweden,SWE,5,5,5,5,20
2014,Syrian Arab Rep.,SYR,Sweden,SWE,0,12,0,10,22
2014,Tunisia,TUN,Sweden,SWE,0,0,5,0,5
2014,Stateless,XXA,Sweden,SWE,0,5,0,10,15
2014,Unknown ,,Sweden,SWE,0,0,0,34,34
2015,Afghanistan,AFG,Belgium,BEL,0,0,0,238,238
2015,Albania,ALB,Belgium,BEL,0,0,0,68,68
2015,Algeria,DZA,Belgium,BEL,0,0,0,25,25
2015,Angola,AGO,Belgium,BEL,0,0,0,22,22
2015,Egypt,EGY,Belgium,BEL,0,0,0,26,26
2015,Armenia,ARM,Belgium,BEL,0,0,0,106,106
2015,Azerbaijan,AZE,Belgium,BEL,0,0,0,23,23
2015,Burundi,BDI,Belgium,BEL,0,0,0,5,5
2015,Benin,BEN,Belgium,BEL,0,0,0,14,14
2015,Bangladesh,BGD,Belgium,BEL,0,0,0,69,69
2015,Burkina Faso,BFA,Belgium,BEL,0,0,0,10,10
2015,Belarus,BLR,Belgium,BEL,0,0,0,5,5
2015,Bosnia and Herzegovina,BIH,Belgium,BEL,0,0,0,15,15
2015,Canada,CAN,Belgium,BEL,0,0,0,39,39
2015,China,CHN,Belgium,BEL,0,0,0,167,167
2015,Congo,COG,Belgium,BEL,0,0,0,117,117
2015,Djibouti,DJI,Belgium,BEL,0,0,0,12,12
2015,Eritrea,ERI,Belgium,BEL,0,0,0,22,22
2015,Ethiopia,ETH,Belgium,BEL,0,0,0,13,13
2015,Gambia,GMB,Belgium,BEL,0,0,0,10,10
2015,Georgia,GEO,Belgium,BEL,0,0,0,26,26
2015,Guinea-Bissau,GNB,Belgium,BEL,0,0,0,5,5
2015,Guinea,GIN,Belgium,BEL,0,0,0,183,183
2015,Honduras,HND,Belgium,BEL,0,0,0,5,5
2015,Cote d'Ivoire,CIV,Belgium,BEL,0,0,0,17,17
2015,Indonesia,IDN,Belgium,BEL,0,0,0,17,17
2015,Iran (Islamic Rep. of),IRN,Belgium,BEL,0,0,0,26,26
2015,Iraq,IRQ,Belgium,BEL,0,0,0,106,106
2015,Jamaica,JAM,Belgium,BEL,0,0,0,5,5
2015,Kenya,KEN,Belgium,BEL,0,0,0,5,5
2015,Kyrgyzstan,KGZ,Belgium,BEL,0,0,0,26,26
2015,Liberia,LBR,Belgium,BEL,0,0,0,5,5
2015,Lebanon,LBN,Belgium,BEL,0,0,0,21,21
2015,Sri Lanka,LKA,Belgium,BEL,0,0,0,5,5
2015,Mauritania,MRT,Belgium,BEL,0,0,0,21,21
2015,North Macedonia,MKD,Belgium,BEL,0,0,0,71,71
2015,Mali,MLI,Belgium,BEL,0,0,0,12,12
2015,Morocco,MAR,Belgium,BEL,0,0,0,39,39
2015,Myanmar,MMR,Belgium,BEL,0,0,0,5,5
2015,Nepal,NPL,Belgium,BEL,0,0,0,19,19
2015,Niger,NER,Belgium,BEL,0,0,0,18,18
2015,Nigeria,NGA,Belgium,BEL,0,0,0,17,17
2015,Pakistan,PAK,Belgium,BEL,0,0,0,127,127
2015,Russian Federation,RUS,Belgium,BEL,0,0,0,340,340
2015,Rwanda,RWA,Belgium,BEL,0,0,0,55,55
2015,Serbia and Kosovo: S/RES/1244 (1999),SRB,Belgium,BEL,0,0,0,238,238
2015,Senegal,SEN,Belgium,BEL,0,0,0,33,33
2015,Sierra Leone,SLE,Belgium,BEL,0,0,0,5,5
2015,Somalia,SOM,Belgium,BEL,0,0,0,34,34
2015,Sudan,SDN,Belgium,BEL,0,0,0,14,14
2015,Syrian Arab Rep.,SYR,Belgium,BEL,0,0,0,10,10
2015,United Rep. of Tanzania,TZA,Belgium,BEL,0,0,0,5,5
2015,Togo,TGO,Belgium,BEL,0,0,0,30,30
2015,Tunisia,TUN,Belgium,BEL,0,0,0,17,17
2015,Turkey,TUR,Belgium,BEL,0,0,0,60,60
2015,Uganda,UGA,Belgium,BEL,0,0,0,5,5
2015,Ukraine,UKR,Belgium,BEL,0,0,0,23,23
2015,Stateless,XXA,Belgium,BEL,0,0,0,5,5
2015,Unknown ,,Belgium,BEL,0,0,0,29,29
2015,Afghanistan,AFG,Finland,FIN,10,0,5,0,15
2015,Albania,ALB,Finland,FIN,0,0,5,0,5
2015,Algeria,DZA,Finland,FIN,0,0,5,0,5
2015,Armenia,ARM,Finland,FIN,0,0,5,0,5
2015,Ghana,GHA,Finland,FIN,0,0,5,0,5
2015,Iran (Islamic Rep. of),IRN,Finland,FIN,0,0,5,0,5
2015,Iraq,IRQ,Finland,FIN,0,5,5,13,23
2015,Nigeria,NGA,Finland,FIN,0,0,5,0,5
2015,Russian Federation,RUS,Finland,FIN,5,0,16,5,26
2015,Serbia and Kosovo: S/RES/1244 (1999),SRB,Finland,FIN,0,0,5,0,5
2015,Afghanistan,AFG,United Kingdom of Great Britain and Northern Ireland,GBR,0,0,0,5,5
2015,Albania,ALB,United Kingdom of Great Britain and Northern Ireland,GBR,0,0,0,5,5
2015,Egypt,EGY,United Kingdom of Great Britain and Northern Ireland,GBR,0,0,5,0,5
2015,Bangladesh,BGD,United Kingdom of Great Britain and Northern Ireland,GBR,0,0,5,0,5
2015,India,IND,United Kingdom of Great Britain and Northern Ireland,GBR,0,0,0,5,5
2015,Iran (Islamic Rep. of),IRN,United Kingdom of Great Britain and Northern Ireland,GBR,0,0,5,5,10
2015,Iraq,IRQ,United Kingdom of Great Britain and Northern Ireland,GBR,0,0,0,5,5
2015,Nigeria,NGA,United Kingdom of Great Britain and Northern Ireland,GBR,0,0,5,0,5
2015,Pakistan,PAK,United Kingdom of Great Britain and Northern Ireland,GBR,0,0,5,5,10
2015,Sudan,SDN,United Kingdom of Great Britain and Northern Ireland,GBR,0,0,5,0,5
2015,Afghanistan,AFG,Germany,DEU,158,133,10,173,474
2015,Albania,ALB,Germany,DEU,0,0,64,421,485
2015,Algeria,DZA,Germany,DEU,0,0,5,100,105
2015,Egypt,EGY,Germany,DEU,0,10,0,29,39
2015,Armenia,ARM,Germany,DEU,5,5,5,66,81
2015,Azerbaijan,AZE,Germany,DEU,0,5,5,27,37
2015,Benin,BEN,Germany,DEU,0,0,0,5,5
2015,Bangladesh,BGD,Germany,DEU,5,0,5,16,26
2015,Burkina Faso,BFA,Germany,DEU,0,0,0,14,14
2015,Belarus,BLR,Germany,DEU,0,0,0,10,10
2015,Bosnia and Herzegovina,BIH,Germany,DEU,0,0,258,2339,2597
2015,Chad,TCD,Germany,DEU,0,5,0,38,43
2015,China,CHN,Germany,DEU,0,0,5,14,19
2015,Cameroon,CMR,Germany,DEU,0,0,0,19,19
2015,Dem. Rep. of the Congo,COD,Germany,DEU,0,0,0,5,5
2015,Eritrea,ERI,Germany,DEU,19,19,0,33,71
2015,Ethiopia,ETH,Germany,DEU,0,5,5,20,30
2015,Gambia,GMB,Germany,DEU,0,0,0,14,14
2015,Georgia,GEO,Germany,DEU,0,0,55,288,343
2015,Ghana,GHA,Germany,DEU,0,0,5,23,28
2015,Guinea-Bissau,GNB,Germany,DEU,0,0,0,16,16
2015,Guinea,GIN,Germany,DEU,5,0,5,39,49
2015,Croatia,HRV,Germany,DEU,0,0,5,5,10
2015,Hungary,HUN,Germany,DEU,0,0,0,5,5
2015,Cote d'Ivoire,CIV,Germany,DEU,0,0,0,13,13
2015,India,IND,Germany,DEU,0,0,5,26,31
2015,Iran (Islamic Rep. of),IRN,Germany,DEU,109,17,18,62,206
2015,Iraq,IRQ,Germany,DEU,3778,141,17,121,4057
2015,Jordan,JOR,Germany,DEU,0,0,5,5,10
2015,Kazakhstan,KAZ,Germany,DEU,0,0,0,14,14
2015,Kenya,KEN,Germany,DEU,0,0,0,5,5
2015,Kyrgyzstan,KGZ,Germany,DEU,0,5,0,10,15
2015,Liberia,LBR,Germany,DEU,0,0,0,5,5
2015,Libya,LBY,Germany,DEU,0,0,0,14,14
2015,Lebanon,LBN,Germany,DEU,0,5,20,42,67
2015,Sri Lanka,LKA,Germany,DEU,0,5,0,25,30
2015,Mauritania,MRT,Germany,DEU,0,0,0,16,16
2015,North Macedonia,MKD,Germany,DEU,0,10,616,1947,2573
2015,Mali,MLI,Germany,DEU,0,0,0,21,21
2015,Mongolia,MNG,Germany,DEU,0,0,5,26,31
2015,Morocco,MAR,Germany,DEU,0,0,5,83,88
2015,Montenegro,MNE,Germany,DEU,0,0,80,247,327
2015,Niger,NER,Germany,DEU,0,0,0,16,16
2015,Nigeria,NGA,Germany,DEU,0,5,5,24,34
2015,Pakistan,PAK,Germany,DEU,19,10,13,114,156
2015,Russian Federation,RUS,Germany,DEU,27,92,107,955,1181
2015,Serbia and Kosovo: S/RES/1244 (1999),SRB,Germany,DEU,0,17,2620,8253,10890
2015,Somalia,SOM,Germany,DEU,27,35,5,119,186
2015,Viet Nam,VNM,Germany,DEU,0,5,10,28,43
2015,Sudan,SDN,Germany,DEU,0,10,0,26,36
2015,Syrian Arab Rep.,SYR,Germany,DEU,3481,85,0,116,3682
2015,Tajikistan,TJK,Germany,DEU,0,0,5,16,21
2015,Turkmenistan,TKM,Germany,DEU,0,0,0,5,5
2015,Togo,TGO,Germany,DEU,0,0,0,10,10
2015,Tunisia,TUN,Germany,DEU,0,0,10,64,74
2015,Turkey,TUR,Germany,DEU,23,5,28,93,149
2015,Ukraine,UKR,Germany,DEU,0,0,0,39,39
2015,Yemen,YEM,Germany,DEU,0,0,0,5,5
2015,Stateless,XXA,Germany,DEU,148,0,0,5,153
2015,Unknown ,,Germany,DEU,395,5,5,102,507
2015,Albania,ALB,Luxembourg,LUX,0,0,0,19,19
2015,Bosnia and Herzegovina,BIH,Luxembourg,LUX,0,0,0,5,5
2015,Montenegro,MNE,Luxembourg,LUX,0,0,0,5,5
2015,Serbia and Kosovo: S/RES/1244 (1999),SRB,Luxembourg,LUX,0,0,0,45,45
2015,Afghanistan,AFG,Netherlands,NLD,125,5,172,0,302
2015,Albania,ALB,Netherlands,NLD,0,0,5,0,5
2015,Algeria,DZA,Netherlands,NLD,0,0,5,0,5
2015,Egypt,EGY,Netherlands,NLD,0,0,25,0,25
2015,Armenia,ARM,Netherlands,NLD,0,0,35,0,35
2015,Azerbaijan,AZE,Netherlands,NLD,0,0,31,0,31
2015,Burundi,BDI,Netherlands,NLD,0,0,14,0,14
2015,Bangladesh,BGD,Netherlands,NLD,0,0,5,0,5
2015,Bosnia and Herzegovina,BIH,Netherlands,NLD,0,0,5,0,5
2015,Chad,TCD,Netherlands,NLD,0,0,5,0,5
2015,China,CHN,Netherlands,NLD,0,0,5,0,5
2015,Cameroon,CMR,Netherlands,NLD,5,0,0,0,5
2015,Congo,COG,Netherlands,NLD,5,0,12,0,17
2015,Eritrea,ERI,Netherlands,NLD,12,0,27,0,39
2015,Ethiopia,ETH,Netherlands,NLD,5,0,16,0,21
2015,Gambia,GMB,Netherlands,NLD,0,0,5,0,5
2015,Georgia,GEO,Netherlands,NLD,0,0,10,0,10
2015,Ghana,GHA,Netherlands,NLD,0,0,5,0,5
2015,Guinea,GIN,Netherlands,NLD,15,0,13,0,28
2015,Cote d'Ivoire,CIV,Netherlands,NLD,0,0,5,0,5
2015,Indonesia,IDN,Netherlands,NLD,0,0,5,0,5
2015,Iran (Islamic Rep. of),IRN,Netherlands,NLD,52,0,55,0,107
2015,Iraq,IRQ,Netherlands,NLD,64,5,101,0,170
2015,Jordan,JOR,Netherlands,NLD,0,0,5,0,5
2015,Liberia,LBR,Netherlands,NLD,0,0,5,0,5
2015,Libya,LBY,Netherlands,NLD,10,0,28,0,38
2015,Lebanon,LBN,Netherlands,NLD,0,0,5,0,5
2015,Sri Lanka,LKA,Netherlands,NLD,5,0,36,0,41
2015,Mali,MLI,Netherlands,NLD,0,0,5,0,5
2015,Mongolia,MNG,Netherlands,NLD,0,0,5,0,5
2015,Morocco,MAR,Netherlands,NLD,0,0,5,0,5
2015,Nepal,NPL,Netherlands,NLD,0,0,10,0,10
2015,Nigeria,NGA,Netherlands,NLD,5,0,25,0,30
2015,Pakistan,PAK,Netherlands,NLD,13,0,38,0,51
2015,Russian Federation,RUS,Netherlands,NLD,5,0,32,0,37
2015,Rwanda,RWA,Netherlands,NLD,0,0,5,0,5
2015,Serbia and Kosovo: S/RES/1244 (1999),SRB,Netherlands,NLD,0,0,11,0,11
2015,Sierra Leone,SLE,Netherlands,NLD,18,0,26,0,44
2015,Somalia,SOM,Netherlands,NLD,60,0,88,0,148
2015,Sudan,SDN,Netherlands,NLD,10,0,14,0,24
2015,Syrian Arab Rep.,SYR,Netherlands,NLD,10,0,29,0,39
2015,Togo,TGO,Netherlands,NLD,0,0,5,0,5
2015,Tunisia,TUN,Netherlands,NLD,0,0,5,0,5
2015,Turkey,TUR,Netherlands,NLD,0,0,12,0,12
2015,Uganda,UGA,Netherlands,NLD,11,0,10,0,21
2015,Ukraine,UKR,Netherlands,NLD,0,0,34,0,34
2015,Stateless,XXA,Netherlands,NLD,10,0,21,0,31
2015,Unknown ,,Netherlands,NLD,14,0,39,0,53
2015,Afghanistan,AFG,Norway,NOR,0,0,18,26,44
2015,Azerbaijan,AZE,Norway,NOR,0,0,5,0,5
2015,Belarus,BLR,Norway,NOR,0,0,5,0,5
2015,Bosnia and Herzegovina,BIH,Norway,NOR,0,0,5,0,5
2015,Congo,COG,Norway,NOR,0,0,13,0,13
2015,Eritrea,ERI,Norway,NOR,50,0,5,76,131
2015,Ethiopia,ETH,Norway,NOR,0,0,0,5,5
2015,Iran (Islamic Rep. of),IRN,Norway,NOR,0,0,0,10,10
2015,Iraq,IRQ,Norway,NOR,0,0,5,16,21
2015,Libya,LBY,Norway,NOR,0,0,0,5,5
2015,Sri Lanka,LKA,Norway,NOR,0,0,5,0,5
2015,Montenegro,MNE,Norway,NOR,0,0,5,5,10
2015,Myanmar,MMR,Norway,NOR,0,0,0,5,5
2015,Nigeria,NGA,Norway,NOR,0,0,13,5,18
2015,Russian Federation,RUS,Norway,NOR,0,0,16,5,21
2015,Serbia and Kosovo: S/RES/1244 (1999),SRB,Norway,NOR,0,0,0,10,10
2015,Somalia,SOM,Norway,NOR,5,0,23,42,70
2015,Sudan,SDN,Norway,NOR,0,0,0,10,10
2015,Syrian Arab Rep.,SYR,Norway,NOR,5,0,0,5,10
2015,Tajikistan,TJK,Norway,NOR,0,0,5,0,5
2015,Tunisia,TUN,Norway,NOR,0,0,0,5,5
2015,Turkey,TUR,Norway,NOR,0,0,5,0,5
2015,Uzbekistan,UZB,Norway,NOR,0,0,5,5,10
2015,Stateless,XXA,Norway,NOR,0,0,5,5,10
2015,Afghanistan,AFG,Sweden,SWE,47,19,27,41,134
2015,Albania,ALB,Sweden,SWE,0,0,28,21,49
2015,Algeria,DZA,Sweden,SWE,0,0,20,43,63
2015,Angola,AGO,Sweden,SWE,0,5,0,0,5
2015,Egypt,EGY,Sweden,SWE,0,0,12,5,17
2015,Armenia,ARM,Sweden,SWE,0,13,18,18,49
2015,Azerbaijan,AZE,Sweden,SWE,0,10,12,22,44
2015,Bangladesh,BGD,Sweden,SWE,0,5,5,5,15
2015,Belarus,BLR,Sweden,SWE,0,5,13,24,42
2015,Bolivia (Plurinational State of),BOL,Sweden,SWE,0,0,5,5,10
2015,Bosnia and Herzegovina,BIH,Sweden,SWE,0,5,21,14,40
2015,Chile,CHL,Sweden,SWE,0,0,5,0,5
2015,Dem. Rep. of the Congo,COD,Sweden,SWE,0,0,5,0,5
2015,Cuba,CUB,Sweden,SWE,0,0,10,0,10
2015,Eritrea,ERI,Sweden,SWE,178,14,0,242,434
2015,Ethiopia,ETH,Sweden,SWE,5,10,21,12,48
2015,Gambia,GMB,Sweden,SWE,0,0,5,0,5
2015,Palestinian,PSE,Sweden,SWE,0,11,10,5,26
2015,Georgia,GEO,Sweden,SWE,0,5,39,39,83
2015,Ghana,GHA,Sweden,SWE,0,0,5,5,10
2015,Guinea,GIN,Sweden,SWE,0,0,5,5,10
2015,Croatia,HRV,Sweden,SWE,0,0,10,0,10
2015,Iran (Islamic Rep. of),IRN,Sweden,SWE,38,13,24,22,97
2015,Iraq,IRQ,Sweden,SWE,102,147,197,109,555
2015,Israel,ISR,Sweden,SWE,0,5,0,5,10
2015,Jordan,JOR,Sweden,SWE,0,0,5,13,18
2015,Japan,JPN,Sweden,SWE,0,0,0,5,5
2015,Kazakhstan,KAZ,Sweden,SWE,0,5,19,13,37
2015,Kenya,KEN,Sweden,SWE,0,0,5,5,10
2015,Kyrgyzstan,KGZ,Sweden,SWE,0,0,10,0,10
2015,Libya,LBY,Sweden,SWE,5,10,16,42,73
2015,Lebanon,LBN,Sweden,SWE,0,22,41,5,68
2015,North Macedonia,MKD,Sweden,SWE,0,0,14,21,35
2015,Rep. of Moldova,MDA,Sweden,SWE,0,0,5,0,5
2015,Mongolia,MNG,Sweden,SWE,0,23,51,14,88
2015,Morocco,MAR,Sweden,SWE,0,5,33,84,122
2015,Montenegro,MNE,Sweden,SWE,0,0,10,5,15
2015,Nigeria,NGA,Sweden,SWE,0,5,0,14,19
2015,Pakistan,PAK,Sweden,SWE,0,0,0,10,10
2015,Poland,POL,Sweden,SWE,0,0,5,0,5
2015,Russian Federation,RUS,Sweden,SWE,5,18,48,37,108
2015,El Salvador,SLV,Sweden,SWE,0,5,5,5,15
2015,Serbia and Kosovo: S/RES/1244 (1999),SRB,Sweden,SWE,0,51,304,209,564
2015,Somalia,SOM,Sweden,SWE,52,32,87,623,794
2015,Viet Nam,VNM,Sweden,SWE,0,5,10,5,20
2015,Sudan,SDN,Sweden,SWE,0,0,5,10,15
2015,Slovenia,SVN,Sweden,SWE,0,0,5,0,5
2015,Syrian Arab Rep.,SYR,Sweden,SWE,23,235,0,74,332
2015,Tajikistan,TJK,Sweden,SWE,0,0,5,0,5
2015,Turkmenistan,TKM,Sweden,SWE,0,0,0,5,5
2015,Tunisia,TUN,Sweden,SWE,0,5,5,27,37
2015,Turkey,TUR,Sweden,SWE,0,5,10,5,20
2015,Ukraine,UKR,Sweden,SWE,0,5,21,20,46
2015,Uzbekistan,UZB,Sweden,SWE,10,5,10,10,35
2015,Yemen,YEM,Sweden,SWE,5,12,5,0,22
2015,Stateless,XXA,Sweden,SWE,41,53,18,49,161
2015,Unknown ,,Sweden,SWE,0,10,46,35,91
2016,Iran (Islamic Rep. of),IRN,Armenia,ARM,0,0,5,0,5
2016,Afghanistan,AFG,Belgium,BEL,0,0,0,381,381
2016,Albania,ALB,Belgium,BEL,0,0,0,133,133
2016,Algeria,DZA,Belgium,BEL,0,0,0,13,13
2016,Angola,AGO,Belgium,BEL,0,0,0,15,15
2016,Egypt,EGY,Belgium,BEL,0,0,0,16,16
2016,Armenia,ARM,Belgium,BEL,0,0,0,63,63
2016,Azerbaijan,AZE,Belgium,BEL,0,0,0,11,11
2016,Burundi,BDI,Belgium,BEL,0,0,0,5,5
2016,Benin,BEN,Belgium,BEL,0,0,0,11,11
2016,Bangladesh,BGD,Belgium,BEL,0,0,0,36,36
2016,Burkina Faso,BFA,Belgium,BEL,0,0,0,10,10
2016,Belarus,BLR,Belgium,BEL,0,0,0,5,5
2016,Bosnia and Herzegovina,BIH,Belgium,BEL,0,0,0,22,22
2016,Chad,TCD,Belgium,BEL,0,0,0,5,5
2016,China,CHN,Belgium,BEL,0,0,0,188,188
2016,Cameroon,CMR,Belgium,BEL,0,0,0,22,22
2016,Congo,COG,Belgium,BEL,0,0,0,5,5
2016,Dem. Rep. of the Congo,COD,Belgium,BEL,0,0,0,74,74
2016,Djibouti,DJI,Belgium,BEL,0,0,0,17,17
2016,Dominican Rep.,DOM,Belgium,BEL,0,0,0,5,5
2016,Eritrea,ERI,Belgium,BEL,0,0,0,19,19
2016,Ethiopia,ETH,Belgium,BEL,0,0,0,12,12
2016,Gambia,GMB,Belgium,BEL,0,0,0,10,10
2016,Georgia,GEO,Belgium,BEL,0,0,0,36,36
2016,Ghana,GHA,Belgium,BEL,0,0,0,12,12
2016,Guinea,GIN,Belgium,BEL,0,0,0,110,110
2016,Cote d'Ivoire,CIV,Belgium,BEL,0,0,0,11,11
2016,India,IND,Belgium,BEL,0,0,0,10,10
2016,Iran (Islamic Rep. of),IRN,Belgium,BEL,0,0,0,17,17
2016,Iraq,IRQ,Belgium,BEL,0,0,0,135,135
2016,Kenya,KEN,Belgium,BEL,0,0,0,10,10
2016,Kyrgyzstan,KGZ,Belgium,BEL,0,0,0,5,5
2016,Lebanon,LBN,Belgium,BEL,0,0,0,23,23
2016,Mauritania,MRT,Belgium,BEL,0,0,0,30,30
2016,North Macedonia,MKD,Belgium,BEL,0,0,0,55,55
2016,Mexico,MEX,Belgium,BEL,0,0,0,5,5
2016,Mali,MLI,Belgium,BEL,0,0,0,12,12
2016,Morocco,MAR,Belgium,BEL,0,0,0,44,44
2016,Montenegro,MNE,Belgium,BEL,0,0,0,5,5
2016,Nepal,NPL,Belgium,BEL,0,0,0,13,13
2016,Niger,NER,Belgium,BEL,0,0,0,10,10
2016,Nigeria,NGA,Belgium,BEL,0,0,0,22,22
2016,Pakistan,PAK,Belgium,BEL,0,0,0,89,89
2016,Russian Federation,RUS,Belgium,BEL,0,0,0,234,234
2016,Rwanda,RWA,Belgium,BEL,0,0,0,42,42
2016,Serbia and Kosovo: S/RES/1244 (1999),SRB,Belgium,BEL,0,0,0,184,184
2016,Senegal,SEN,Belgium,BEL,0,0,0,29,29
2016,Sierra Leone,SLE,Belgium,BEL,0,0,0,5,5
2016,Somalia,SOM,Belgium,BEL,0,0,0,95,95
2016,Sudan,SDN,Belgium,BEL,0,0,0,15,15
2016,Syrian Arab Rep.,SYR,Belgium,BEL,0,0,0,20,20
2016,United Rep. of Tanzania,TZA,Belgium,BEL,0,0,0,13,13
2016,Togo,TGO,Belgium,BEL,0,0,0,14,14
2016,Tunisia,TUN,Belgium,BEL,0,0,0,12,12
2016,Turkey,TUR,Belgium,BEL,0,0,0,18,18
2016,Uganda,UGA,Belgium,BEL,0,0,0,5,5
2016,Ukraine,UKR,Belgium,BEL,0,0,0,32,32
2016,Zimbabwe,ZWE,Belgium,BEL,0,0,0,5,5
2016,Unknown ,,Belgium,BEL,0,0,0,34,34
2016,Egypt,EGY,Cyprus,CYP,0,0,5,0,5
2016,Georgia,GEO,Cyprus,CYP,0,0,5,0,5
2016,India,IND,Cyprus,CYP,0,0,5,0,5
2016,Iran (Islamic Rep. of),IRN,Cyprus,CYP,0,0,16,14,30
2016,Iraq,IRQ,Cyprus,CYP,0,0,0,5,5
2016,Sri Lanka,LKA,Cyprus,CYP,0,0,0,5,5
2016,Philippines,PHL,Cyprus,CYP,0,0,5,0,5
2016,Viet Nam,VNM,Cyprus,CYP,0,0,5,0,5
2016,Syrian Arab Rep.,SYR,Cyprus,CYP,5,35,5,17,62
2016,Afghanistan,AFG,Finland,FIN,5,0,17,20,42
2016,Ethiopia,ETH,Finland,FIN,0,0,0,5,5
2016,Gambia,GMB,Finland,FIN,0,0,0,5,5
2016,Iran (Islamic Rep. of),IRN,Finland,FIN,0,0,0,5,5
2016,Iraq,IRQ,Finland,FIN,13,0,56,85,154
2016,Nigeria,NGA,Finland,FIN,0,0,5,5,10
2016,Russian Federation,RUS,Finland,FIN,0,0,10,20,30
2016,Serbia and Kosovo: S/RES/1244 (1999),SRB,Finland,FIN,0,0,10,5,15
2016,Somalia,SOM,Finland,FIN,0,0,0,5,5
2016,Turkey,TUR,Finland,FIN,0,0,5,0,5
2016,Ukraine,UKR,Finland,FIN,0,0,0,10,10
2016,Unknown ,,Finland,FIN,0,0,5,0,5
2016,Afghanistan,AFG,France,FRA,5,5,10,0,20
2016,Albania,ALB,France,FRA,0,10,120,310,440
2016,Algeria,DZA,France,FRA,0,0,5,19,24
2016,Angola,AGO,France,FRA,0,0,5,14,19
2016,Egypt,EGY,France,FRA,0,0,29,12,41
2016,Armenia,ARM,France,FRA,5,5,71,135,216
2016,Azerbaijan,AZE,France,FRA,5,0,18,76,99
2016,Bangladesh,BGD,France,FRA,13,0,138,642,793
2016,Belarus,BLR,France,FRA,0,0,0,10,10
2016,Bosnia and Herzegovina,BIH,France,FRA,0,0,10,36,46
2016,Chad,TCD,France,FRA,0,0,10,5,15
2016,China,CHN,France,FRA,0,0,5,14,19
2016,Cameroon,CMR,France,FRA,0,0,5,5,10
2016,Congo,COG,France,FRA,0,0,10,20,30
2016,Dem. Rep. of the Congo,COD,France,FRA,14,0,89,220,323
2016,Eritrea,ERI,France,FRA,0,0,5,0,5
2016,Georgia,GEO,France,FRA,0,0,54,136,190
2016,Guinea-Bissau,GNB,France,FRA,0,0,5,5,10
2016,Guinea,GIN,France,FRA,0,0,29,69,98
2016,Haiti,HTI,France,FRA,0,0,20,54,74
2016,Cote d'Ivoire,CIV,France,FRA,0,0,16,16,32
2016,Iran (Islamic Rep. of),IRN,France,FRA,5,0,5,0,10
2016,Kazakhstan,KAZ,France,FRA,0,0,5,12,17
2016,Kyrgyzstan,KGZ,France,FRA,0,0,0,5,5
2016,Dem. People's Rep. of Korea,PRK,France,FRA,0,0,5,0,5
2016,Sri Lanka,LKA,France,FRA,22,0,105,1012,1139
2016,Mauritania,MRT,France,FRA,5,0,31,127,163
2016,North Macedonia,MKD,France,FRA,0,0,5,16,21
2016,Mali,MLI,France,FRA,0,0,5,23,28
2016,Mongolia,MNG,France,FRA,0,0,10,10,20
2016,Morocco,MAR,France,FRA,0,0,0,5,5
2016,Montenegro,MNE,France,FRA,0,0,0,15,15
2016,Myanmar,MMR,France,FRA,0,0,10,30,40
2016,Nepal,NPL,France,FRA,0,0,5,5,10
2016,Nigeria,NGA,France,FRA,5,0,35,44,84
2016,Pakistan,PAK,France,FRA,0,0,19,47,66
2016,Russian Federation,RUS,France,FRA,35,5,191,434,665
2016,Rwanda,RWA,France,FRA,0,0,11,0,11
2016,Serbia and Kosovo: S/RES/1244 (1999),SRB,France,FRA,13,10,128,368,519
2016,Senegal,SEN,France,FRA,0,0,5,0,5
2016,Sierra Leone,SLE,France,FRA,0,0,5,0,5
2016,Somalia,SOM,France,FRA,5,5,5,0,15
2016,Sudan,SDN,France,FRA,0,0,21,5,26
2016,Syrian Arab Rep.,SYR,France,FRA,0,5,0,0,5
2016,Togo,TGO,France,FRA,0,0,0,5,5
2016,Turkey,TUR,France,FRA,26,0,162,157,345
2016,Ukraine,UKR,France,FRA,5,0,20,35,60
2016,Uzbekistan,UZB,France,FRA,0,0,0,5,5
2016,Western Sahara,ESH,France,FRA,0,0,5,5,10
2016,Afghanistan,AFG,United Kingdom of Great Britain and Northern Ireland,GBR,0,0,0,5,5
2016,Angola,AGO,United Kingdom of Great Britain and Northern Ireland,GBR,0,0,0,5,5
2016,China,CHN,United Kingdom of Great Britain and Northern Ireland,GBR,0,0,0,5,5
2016,Cote d'Ivoire,CIV,United Kingdom of Great Britain and Northern Ireland,GBR,0,0,0,5,5
2016,Iran (Islamic Rep. of),IRN,United Kingdom of Great Britain and Northern Ireland,GBR,0,0,0,5,5
2016,Iraq,IRQ,United Kingdom of Great Britain and Northern Ireland,GBR,0,0,5,10,15
2016,Serbia and Kosovo: S/RES/1244 (1999),SRB,United Kingdom of Great Britain and Northern Ireland,GBR,0,0,5,0,5
2016,Viet Nam,VNM,United Kingdom of Great Britain and Northern Ireland,GBR,0,0,12,0,12
2016,Sudan,SDN,United Kingdom of Great Britain and Northern Ireland,GBR,0,0,5,0,5
2016,Afghanistan,AFG,Germany,DEU,166,169,83,447,865
2016,Albania,ALB,Germany,DEU,0,12,339,2084,2435
2016,Algeria,DZA,Germany,DEU,0,0,75,207,282
2016,Egypt,EGY,Germany,DEU,5,10,19,101,135
2016,Armenia,ARM,Germany,DEU,5,5,67,148,225
2016,Azerbaijan,AZE,Germany,DEU,12,10,45,91,158
2016,Benin,BEN,Germany,DEU,0,0,0,18,18
2016,Bangladesh,BGD,Germany,DEU,0,0,5,30,35
2016,Burkina Faso,BFA,Germany,DEU,0,0,0,25,25
2016,Belarus,BLR,Germany,DEU,0,0,0,19,19
2016,Bosnia and Herzegovina,BIH,Germany,DEU,0,5,361,1930,2296
2016,Bulgaria,BGR,Germany,DEU,0,0,0,5,5
2016,Chad,TCD,Germany,DEU,0,10,5,24,39
2016,China,CHN,Germany,DEU,5,5,10,24,44
2016,Cameroon,CMR,Germany,DEU,0,0,5,34,39
2016,Congo,COG,Germany,DEU,0,5,0,0,5
2016,Dem. Rep. of the Congo,COD,Germany,DEU,0,0,0,11,11
2016,Czechia,CZE,Germany,DEU,0,0,0,5,5
2016,Eritrea,ERI,Germany,DEU,98,33,0,90,221
2016,Ethiopia,ETH,Germany,DEU,0,5,13,29,47
2016,Gambia,GMB,Germany,DEU,0,0,5,39,44
2016,Georgia,GEO,Germany,DEU,5,10,101,316,432
2016,Ghana,GHA,Germany,DEU,0,0,10,39,49
2016,Guinea-Bissau,GNB,Germany,DEU,0,0,0,56,56
2016,Guinea,GIN,Germany,DEU,0,5,10,52,67
2016,Croatia,HRV,Germany,DEU,0,0,0,11,11
2016,Cote d'Ivoire,CIV,Germany,DEU,0,0,5,14,19
2016,India,IND,Germany,DEU,0,0,10,48,58
2016,Iran (Islamic Rep. of),IRN,Germany,DEU,155,43,106,201,505
2016,Iraq,IRQ,Germany,DEU,652,212,174,405,1443
2016,Jordan,JOR,Germany,DEU,0,0,10,10,20
2016,Kazakhstan,KAZ,Germany,DEU,0,0,0,18,18
2016,Kenya,KEN,Germany,DEU,0,0,0,12,12
2016,Kyrgyzstan,KGZ,Germany,DEU,0,0,5,5,10
2016,Liberia,LBR,Germany,DEU,0,0,0,5,5
2016,Libya,LBY,Germany,DEU,5,0,10,31,46
2016,Lebanon,LBN,Germany,DEU,5,10,69,96,180
2016,Sri Lanka,LKA,Germany,DEU,5,0,5,41,51
2016,Mauritania,MRT,Germany,DEU,0,0,0,10,10
2016,North Macedonia,MKD,Germany,DEU,0,10,1361,3918,5289
2016,Rep. of Moldova,MDA,Germany,DEU,0,0,10,62,72
2016,Mali,MLI,Germany,DEU,0,0,5,30,35
2016,Mongolia,MNG,Germany,DEU,0,0,0,37,37
2016,Morocco,MAR,Germany,DEU,5,5,33,142,185
2016,Montenegro,MNE,Germany,DEU,0,5,137,288,430
2016,Niger,NER,Germany,DEU,0,0,5,31,36
2016,Nigeria,NGA,Germany,DEU,5,10,13,72,100
2016,Pakistan,PAK,Germany,DEU,12,10,92,1749,1863
2016,Romania,ROU,Germany,DEU,0,0,0,5,5
2016,Russian Federation,RUS,Germany,DEU,32,56,253,1392,1733
2016,Serbia and Kosovo: S/RES/1244 (1999),SRB,Germany,DEU,0,43,3190,9567,12800
2016,Senegal,SEN,Germany,DEU,0,0,0,15,15
2016,Sierra Leone,SLE,Germany,DEU,0,0,0,5,5
2016,Somalia,SOM,Germany,DEU,38,297,12,201,548
2016,Viet Nam,VNM,Germany,DEU,0,5,12,60,77
2016,Sudan,SDN,Germany,DEU,5,0,0,30,35
2016,South Sudan,SSD,Germany,DEU,0,0,0,5,5
2016,Syrian Arab Rep.,SYR,Germany,DEU,1594,1290,10,483,3377
2016,United Rep. of Tanzania,TZA,Germany,DEU,0,0,5,0,5
2016,Tajikistan,TJK,Germany,DEU,0,0,0,15,15
2016,Turkmenistan,TKM,Germany,DEU,0,0,0,14,14
2016,Togo,TGO,Germany,DEU,0,0,0,5,5
2016,Tunisia,TUN,Germany,DEU,0,0,31,187,218
2016,Turkey,TUR,Germany,DEU,5,5,62,127,199
2016,Uganda,UGA,Germany,DEU,0,0,0,5,5
2016,Ukraine,UKR,Germany,DEU,0,0,20,93,113
2016,Yemen,YEM,Germany,DEU,0,31,0,0,31
2016,Stateless,XXA,Germany,DEU,38,22,5,13,78
2016,Unknown ,,Germany,DEU,174,103,25,158,460
2016,Albania,ALB,Luxembourg,LUX,0,0,0,10,10
2016,Azerbaijan,AZE,Luxembourg,LUX,0,0,0,10,10
2016,Bosnia and Herzegovina,BIH,Luxembourg,LUX,0,0,0,5,5
2016,Montenegro,MNE,Luxembourg,LUX,0,0,0,5,5
2016,Serbia and Kosovo: S/RES/1244 (1999),SRB,Luxembourg,LUX,0,0,0,14,14
2016,Afghanistan,AFG,Netherlands,NLD,57,0,155,11,223
2016,Albania,ALB,Netherlands,NLD,0,0,10,12,22
2016,Algeria,DZA,Netherlands,NLD,0,0,5,0,5
2016,Egypt,EGY,Netherlands,NLD,0,0,19,0,19
2016,Armenia,ARM,Netherlands,NLD,5,0,21,5,31
2016,Azerbaijan,AZE,Netherlands,NLD,0,0,10,0,10
2016,Burundi,BDI,Netherlands,NLD,0,0,10,0,10
2016,Belarus,BLR,Netherlands,NLD,0,0,5,0,5
2016,China,CHN,Netherlands,NLD,0,0,5,0,5
2016,Congo,COG,Netherlands,NLD,5,0,20,0,25
2016,Eritrea,ERI,Netherlands,NLD,16,0,24,16,56
2016,Ethiopia,ETH,Netherlands,NLD,12,0,11,0,23
2016,Georgia,GEO,Netherlands,NLD,0,0,11,5,16
2016,Guinea,GIN,Netherlands,NLD,11,0,19,0,30
2016,Cote d'Ivoire,CIV,Netherlands,NLD,0,0,5,0,5
2016,India,IND,Netherlands,NLD,0,0,5,0,5
2016,Iran (Islamic Rep. of),IRN,Netherlands,NLD,27,0,51,5,83
2016,Iraq,IRQ,Netherlands,NLD,123,0,217,19,359
2016,Jamaica,JAM,Netherlands,NLD,0,0,5,0,5
2016,Kyrgyzstan,KGZ,Netherlands,NLD,0,0,5,0,5
2016,Libya,LBY,Netherlands,NLD,0,0,14,5,19
2016,Sri Lanka,LKA,Netherlands,NLD,0,0,28,0,28
2016,North Macedonia,MKD,Netherlands,NLD,0,0,0,5,5
2016,Morocco,MAR,Netherlands,NLD,0,0,5,5,10
2016,Nepal,NPL,Netherlands,NLD,0,0,5,0,5
2016,Nigeria,NGA,Netherlands,NLD,14,0,44,0,58
2016,Pakistan,PAK,Netherlands,NLD,5,0,11,0,16
2016,Russian Federation,RUS,Netherlands,NLD,0,0,10,0,10
2016,Rwanda,RWA,Netherlands,NLD,0,0,5,0,5
2016,Serbia and Kosovo: S/RES/1244 (1999),SRB,Netherlands,NLD,0,0,0,5,5
2016,Sierra Leone,SLE,Netherlands,NLD,16,0,16,0,32
2016,Somalia,SOM,Netherlands,NLD,32,0,55,0,87
2016,Sudan,SDN,Netherlands,NLD,5,0,12,10,27
2016,Syrian Arab Rep.,SYR,Netherlands,NLD,10,0,5,25,40
2016,United Rep. of Tanzania,TZA,Netherlands,NLD,0,0,5,0,5
2016,Tajikistan,TJK,Netherlands,NLD,5,0,5,0,10
2016,Turkey,TUR,Netherlands,NLD,0,0,0,5,5
2016,Uganda,UGA,Netherlands,NLD,0,0,5,0,5
2016,Ukraine,UKR,Netherlands,NLD,0,0,18,0,18
2016,Stateless,XXA,Netherlands,NLD,0,0,13,0,13
2016,Unknown ,,Netherlands,NLD,11,0,37,0,48
2016,Afghanistan,AFG,Norway,NOR,0,0,16,20,36
2016,Albania,ALB,Norway,NOR,0,0,5,0,5
2016,Algeria,DZA,Norway,NOR,0,0,0,5,5
2016,Azerbaijan,AZE,Norway,NOR,0,0,0,5,5
2016,Belarus,BLR,Norway,NOR,0,0,5,0,5
2016,Eritrea,ERI,Norway,NOR,52,0,11,20,83
2016,Ethiopia,ETH,Norway,NOR,5,0,12,5,22
2016,Iran (Islamic Rep. of),IRN,Norway,NOR,0,0,20,10,30
2016,Iraq,IRQ,Norway,NOR,0,0,37,14,51
2016,Jordan,JOR,Norway,NOR,0,0,0,5,5
2016,Libya,LBY,Norway,NOR,0,5,5,5,15
2016,Morocco,MAR,Norway,NOR,0,0,0,5,5
2016,Nigeria,NGA,Norway,NOR,0,0,5,0,5
2016,Russian Federation,RUS,Norway,NOR,0,0,5,10,15
2016,El Salvador,SLV,Norway,NOR,0,0,5,0,5
2016,Serbia and Kosovo: S/RES/1244 (1999),SRB,Norway,NOR,0,0,5,0,5
2016,Somalia,SOM,Norway,NOR,0,0,22,11,33
2016,Sudan,SDN,Norway,NOR,0,0,5,0,5
2016,Syrian Arab Rep.,SYR,Norway,NOR,12,0,0,12,24
2016,Turkey,TUR,Norway,NOR,0,0,5,5,10
2016,Uzbekistan,UZB,Norway,NOR,10,0,0,5,15
2016,Yemen,YEM,Norway,NOR,5,0,0,0,5
2016,Afghanistan,AFG,Sweden,SWE,69,28,122,158,377
2016,Albania,ALB,Sweden,SWE,0,5,42,17,64
2016,Algeria,DZA,Sweden,SWE,0,0,47,37,84
2016,Angola,AGO,Sweden,SWE,0,5,5,0,10
2016,Egypt,EGY,Sweden,SWE,5,5,29,10,49
2016,Armenia,ARM,Sweden,SWE,0,15,63,14,92
2016,Azerbaijan,AZE,Sweden,SWE,5,38,74,17,134
2016,Burundi,BDI,Sweden,SWE,0,5,0,0,5
2016,Benin,BEN,Sweden,SWE,0,0,5,0,5
2016,Bangladesh,BGD,Sweden,SWE,0,0,16,5,21
2016,Belarus,BLR,Sweden,SWE,0,10,33,34,77
2016,Bolivia (Plurinational State of),BOL,Sweden,SWE,0,0,20,0,20
2016,Bosnia and Herzegovina,BIH,Sweden,SWE,0,0,35,10,45
2016,China,CHN,Sweden,SWE,0,0,5,0,5
2016,Chile,CHL,Sweden,SWE,0,0,5,0,5
2016,Dem. Rep. of the Congo,COD,Sweden,SWE,5,0,5,0,10
2016,Colombia,COL,Sweden,SWE,0,0,5,0,5
2016,Cuba,CUB,Sweden,SWE,0,0,17,5,22
2016,Djibouti,DJI,Sweden,SWE,5,0,10,0,15
2016,Ecuador,ECU,Sweden,SWE,0,0,5,0,5
2016,Eritrea,ERI,Sweden,SWE,335,262,10,187,794
2016,Ethiopia,ETH,Sweden,SWE,23,13,82,25,143
2016,Palestinian,PSE,Sweden,SWE,5,12,13,0,30
2016,Georgia,GEO,Sweden,SWE,0,5,78,49,132
2016,Guinea,GIN,Sweden,SWE,0,0,10,0,10
2016,India,IND,Sweden,SWE,0,0,14,5,19
2016,Indonesia,IDN,Sweden,SWE,0,0,5,0,5
2016,Iran (Islamic Rep. of),IRN,Sweden,SWE,149,28,113,36,326
2016,Iraq,IRQ,Sweden,SWE,73,156,350,248,827
2016,Israel,ISR,Sweden,SWE,0,5,0,0,5
2016,Jordan,JOR,Sweden,SWE,5,10,53,20,88
2016,Kazakhstan,KAZ,Sweden,SWE,0,12,52,27,91
2016,Kenya,KEN,Sweden,SWE,5,0,26,5,36
2016,Kyrgyzstan,KGZ,Sweden,SWE,0,10,36,12,58
2016,Libya,LBY,Sweden,SWE,10,0,54,27,91
2016,Lebanon,LBN,Sweden,SWE,5,24,54,17,100
2016,Sri Lanka,LKA,Sweden,SWE,0,5,10,0,15
2016,North Macedonia,MKD,Sweden,SWE,0,0,33,13,46
2016,Rep. of Moldova,MDA,Sweden,SWE,0,0,5,0,5
2016,Mongolia,MNG,Sweden,SWE,0,26,253,15,294
2016,Morocco,MAR,Sweden,SWE,0,0,36,70,106
2016,Montenegro,MNE,Sweden,SWE,0,0,5,0,5
2016,Nepal,NPL,Sweden,SWE,0,0,10,5,15
2016,Nigeria,NGA,Sweden,SWE,5,5,37,14,61
2016,Pakistan,PAK,Sweden,SWE,0,0,25,5,30
2016,Peru,PER,Sweden,SWE,0,0,5,0,5
2016,Romania,ROU,Sweden,SWE,0,0,0,5,5
2016,South Africa,ZAF,Sweden,SWE,0,0,5,0,5
2016,Russian Federation,RUS,Sweden,SWE,10,33,126,36,205
2016,El Salvador,SLV,Sweden,SWE,0,0,17,0,17
2016,Serbia and Kosovo: S/RES/1244 (1999),SRB,Sweden,SWE,0,27,270,94,391
2016,Senegal,SEN,Sweden,SWE,0,0,5,0,5
2016,Somalia,SOM,Sweden,SWE,81,60,198,372,711
2016,Viet Nam,VNM,Sweden,SWE,0,0,12,0,12
2016,Sudan,SDN,Sweden,SWE,10,10,13,21,54
2016,Syrian Arab Rep.,SYR,Sweden,SWE,63,702,5,205,975
2016,United Rep. of Tanzania,TZA,Sweden,SWE,0,0,12,0,12
2016,Thailand,THA,Sweden,SWE,0,0,5,0,5
2016,Tajikistan,TJK,Sweden,SWE,0,0,5,5,10
2016,Turkmenistan,TKM,Sweden,SWE,0,0,5,0,5
2016,Tunisia,TUN,Sweden,SWE,0,5,17,21,43
2016,Turkey,TUR,Sweden,SWE,0,0,28,10,38
2016,Uganda,UGA,Sweden,SWE,10,0,5,0,15
2016,Ukraine,UKR,Sweden,SWE,0,5,46,32,83
2016,Uzbekistan,UZB,Sweden,SWE,13,0,61,13,87
2016,Yemen,YEM,Sweden,SWE,5,45,5,5,60
2016,Zimbabwe,ZWE,Sweden,SWE,0,0,5,0,5
2016,Stateless,XXA,Sweden,SWE,120,68,49,82,319
2016,Unknown ,,Sweden,SWE,5,12,107,56,180
2017,Afghanistan,AFG,Belgium,BEL,0,0,0,454,454
2017,Egypt,EGY,Cyprus,CYP,0,0,0,10,10
2017,Bangladesh,BGD,Cyprus,CYP,0,0,0,10,10
2017,Cameroon,CMR,Cyprus,CYP,0,0,0,5,5
2017,India,IND,Cyprus,CYP,0,0,0,5,5
2017,Iran (Islamic Rep. of),IRN,Cyprus,CYP,0,0,0,32,32
2017,Sri Lanka,LKA,Cyprus,CYP,0,0,0,5,5
2017,Pakistan,PAK,Cyprus,CYP,0,0,0,10,10
2017,Russian Federation,RUS,Cyprus,CYP,0,0,0,5,5
2017,Viet Nam,VNM,Cyprus,CYP,0,0,0,10,10
2017,Syrian Arab Rep.,SYR,Cyprus,CYP,0,0,0,37,37
2017,Turkey,TUR,Cyprus,CYP,0,0,0,5,5
2017,Afghanistan,AFG,United Kingdom of Great Britain and Northern Ireland,GBR,0,0,5,5,10
2017,Canada,CAN,United Kingdom of Great Britain and Northern Ireland,GBR,0,0,0,5,5
2017,Iran (Islamic Rep. of),IRN,United Kingdom of Great Britain and Northern Ireland,GBR,0,0,10,5,15
2017,Iraq,IRQ,United Kingdom of Great Britain and Northern Ireland,GBR,0,0,10,5,15
2017,Afghanistan,AFG,Germany,DEU,214,590,413,1728,2945
2017,Albania,ALB,Germany,DEU,0,10,244,2511,2765
2017,Algeria,DZA,Germany,DEU,0,5,101,414,520
2017,Angola,AGO,Germany,DEU,0,0,0,5,5
2017,Egypt,EGY,Germany,DEU,11,10,33,133,187
2017,Armenia,ARM,Germany,DEU,5,34,209,446,694
2017,Azerbaijan,AZE,Germany,DEU,17,22,189,362,590
2017,Burundi,BDI,Germany,DEU,0,0,0,5,5
2017,Benin,BEN,Germany,DEU,0,0,11,21,32
2017,Bangladesh,BGD,Germany,DEU,5,5,28,157,195
2017,Burkina Faso,BFA,Germany,DEU,0,0,10,21,31
2017,Belarus,BLR,Germany,DEU,0,0,5,83,88
2017,Bosnia and Herzegovina,BIH,Germany,DEU,0,13,143,862,1018
2017,Central African Rep.,CAF,Germany,DEU,0,0,0,5,5
2017,Chad,TCD,Germany,DEU,0,5,5,33,43
2017,China,CHN,Germany,DEU,5,5,27,68,105
2017,Cameroon,CMR,Germany,DEU,0,0,25,88,113
2017,Congo,COG,Germany,DEU,0,0,0,10,10
2017,Dem. Rep. of the Congo,COD,Germany,DEU,0,17,21,56,94
2017,Cuba,CUB,Germany,DEU,0,0,0,12,12
2017,Czechia,CZE,Germany,DEU,0,0,0,5,5
2017,Djibouti,DJI,Germany,DEU,0,0,0,5,5
2017,Eritrea,ERI,Germany,DEU,62,162,5,321,550
2017,Ethiopia,ETH,Germany,DEU,16,28,41,244,329
2017,Gambia,GMB,Germany,DEU,0,10,84,301,395
2017,Georgia,GEO,Germany,DEU,0,14,184,588,786
2017,Ghana,GHA,Germany,DEU,0,5,36,91,132
2017,Guinea-Bissau,GNB,Germany,DEU,0,5,10,53,68
2017,Guinea,GIN,Germany,DEU,10,24,49,256,339
2017,Croatia,HRV,Germany,DEU,0,0,0,5,5
2017,Cote d'Ivoire,CIV,Germany,DEU,0,0,13,45,58
2017,India,IND,Germany,DEU,0,0,31,127,158
2017,Iran (Islamic Rep. of),IRN,Germany,DEU,261,67,212,490,1030
2017,Iraq,IRQ,Germany,DEU,311,448,419,1563,2741
2017,Israel,ISR,Germany,DEU,0,0,0,5,5
2017,Jamaica,JAM,Germany,DEU,0,0,0,5,5
2017,Jordan,JOR,Germany,DEU,0,5,13,24,42
2017,Kazakhstan,KAZ,Germany,DEU,0,0,16,69,85
2017,Kenya,KEN,Germany,DEU,0,0,5,17,22
2017,Kyrgyzstan,KGZ,Germany,DEU,5,0,5,12,22
2017,Kuwait,KWT,Germany,DEU,0,0,0,5,5
2017,Liberia,LBR,Germany,DEU,0,0,5,5,10
2017,Libya,LBY,Germany,DEU,24,11,13,72,120
2017,Lebanon,LBN,Germany,DEU,10,10,166,147,333
2017,Sri Lanka,LKA,Germany,DEU,5,0,21,175,201
2017,Madagascar,MDG,Germany,DEU,0,0,0,5,5
2017,Mauritania,MRT,Germany,DEU,0,0,5,11,16
2017,North Macedonia,MKD,Germany,DEU,0,13,586,2498,3097
2017,Rep. of Moldova,MDA,Germany,DEU,0,0,24,109,133
2017,Mali,MLI,Germany,DEU,0,0,17,80,97
2017,Mongolia,MNG,Germany,DEU,0,0,14,112,126
2017,Morocco,MAR,Germany,DEU,5,13,76,401,495
2017,Montenegro,MNE,Germany,DEU,0,5,44,383,432
2017,Myanmar,MMR,Germany,DEU,5,0,0,5,10
2017,Nepal,NPL,Germany,DEU,0,0,0,5,5
2017,Niger,NER,Germany,DEU,0,0,10,20,30
2017,Nigeria,NGA,Germany,DEU,38,116,127,619,900
2017,Pakistan,PAK,Germany,DEU,14,26,306,1076,1422
2017,Poland,POL,Germany,DEU,0,0,0,5,5
2017,Romania,ROU,Germany,DEU,0,0,0,5,5
2017,Russian Federation,RUS,Germany,DEU,72,158,744,2056,3030
2017,Rwanda,RWA,Germany,DEU,0,5,0,5,10
2017,Serbia and Kosovo: S/RES/1244 (1999),SRB,Germany,DEU,0,38,892,4443,5373
2017,Senegal,SEN,Germany,DEU,0,5,44,164,213
2017,Sierra Leone,SLE,Germany,DEU,0,5,29,71,105
2017,Somalia,SOM,Germany,DEU,92,309,62,823,1286
2017,Viet Nam,VNM,Germany,DEU,0,0,28,56,84
2017,Sudan,SDN,Germany,DEU,5,16,15,165,201
2017,South Sudan,SSD,Germany,DEU,0,0,0,5,5
2017,Syrian Arab Rep.,SYR,Germany,DEU,679,957,26,974,2636
2017,United Rep. of Tanzania,TZA,Germany,DEU,0,5,0,25,30
2017,Tajikistan,TJK,Germany,DEU,0,5,17,75,97
2017,Turkmenistan,TKM,Germany,DEU,0,0,5,5,10
2017,Togo,TGO,Germany,DEU,0,5,5,24,34
2017,Tunisia,TUN,Germany,DEU,0,0,26,158,184
2017,Turkey,TUR,Germany,DEU,31,19,388,430,868
2017,Uganda,UGA,Germany,DEU,0,0,5,14,19
2017,Ukraine,UKR,Germany,DEU,0,5,97,276,378
2017,Uzbekistan,UZB,Germany,DEU,0,0,0,5,5
2017,Venezuela (Bolivarian Republic of),VEN,Germany,DEU,0,0,0,5,5
2017,Yemen,YEM,Germany,DEU,0,29,0,14,43
2017,Zimbabwe,ZWE,Germany,DEU,0,0,0,5,5
2017,Stateless,XXA,Germany,DEU,25,20,10,70,125
2017,Unknown ,,Germany,DEU,45,82,120,510,757
2017,Afghanistan,AFG,Netherlands,NLD,93,22,307,30,452
2017,Albania,ALB,Netherlands,NLD,0,0,5,0,5
2017,Algeria,DZA,Netherlands,NLD,0,0,10,10,20
2017,Egypt,EGY,Netherlands,NLD,0,0,11,0,11
2017,Armenia,ARM,Netherlands,NLD,0,0,40,0,40
2017,Burundi,BDI,Netherlands,NLD,0,0,20,0,20
2017,Congo,COG,Netherlands,NLD,0,0,16,0,16
2017,Eritrea,ERI,Netherlands,NLD,490,0,35,0,525
2017,Ethiopia,ETH,Netherlands,NLD,10,0,12,0,22
2017,Gambia,GMB,Netherlands,NLD,0,0,5,0,5
2017,Georgia,GEO,Netherlands,NLD,0,0,10,11,21
2017,Guinea,GIN,Netherlands,NLD,0,0,20,0,20
2017,Iran (Islamic Rep. of),IRN,Netherlands,NLD,34,0,88,5,127
2017,Iraq,IRQ,Netherlands,NLD,187,5,190,19,401
2017,Libya,LBY,Netherlands,NLD,0,0,23,0,23
2017,Sri Lanka,LKA,Netherlands,NLD,0,0,24,0,24
2017,Morocco,MAR,Netherlands,NLD,0,0,10,5,15
2017,Nigeria,NGA,Netherlands,NLD,14,0,52,0,66
2017,Pakistan,PAK,Netherlands,NLD,0,0,19,0,19
2017,Russian Federation,RUS,Netherlands,NLD,0,0,10,0,10
2017,Serbia and Kosovo: S/RES/1244 (1999),SRB,Netherlands,NLD,0,0,22,0,22
2017,Sierra Leone,SLE,Netherlands,NLD,0,0,28,0,28
2017,Somalia,SOM,Netherlands,NLD,26,0,64,0,90
2017,Viet Nam,VNM,Netherlands,NLD,0,0,10,0,10
2017,Sudan,SDN,Netherlands,NLD,5,0,20,0,25
2017,Syrian Arab Rep.,SYR,Netherlands,NLD,763,0,10,0,773
2017,Turkey,TUR,Netherlands,NLD,0,0,5,0,5
2017,Uganda,UGA,Netherlands,NLD,0,0,20,0,20
2017,Ukraine,UKR,Netherlands,NLD,0,0,23,0,23
2017,Yemen,YEM,Netherlands,NLD,15,0,0,0,15
2017,Stateless,XXA,Netherlands,NLD,16,0,14,0,30
2017,Unknown ,,Netherlands,NLD,30,0,24,5,59
2017,Afghanistan,AFG,Norway,NOR,0,0,20,5,25
2017,Angola,AGO,Norway,NOR,0,0,0,5,5
2017,Azerbaijan,AZE,Norway,NOR,0,0,0,5,5
2017,Eritrea,ERI,Norway,NOR,22,0,5,10,37
2017,Ethiopia,ETH,Norway,NOR,0,0,5,0,5
2017,Cote d'Ivoire,CIV,Norway,NOR,0,0,0,5,5
2017,Iran (Islamic Rep. of),IRN,Norway,NOR,0,0,5,5,10
2017,Iraq,IRQ,Norway,NOR,5,0,15,10,30
2017,Nigeria,NGA,Norway,NOR,0,0,5,5,10
2017,Pakistan,PAK,Norway,NOR,0,0,0,5,5
2017,Russian Federation,RUS,Norway,NOR,0,0,5,5,10
2017,Somalia,SOM,Norway,NOR,0,0,5,5,10
2017,Syrian Arab Rep.,SYR,Norway,NOR,24,0,0,0,24
2017,Uzbekistan,UZB,Norway,NOR,0,0,5,0,5
2017,Stateless,XXA,Norway,NOR,0,0,5,5,10
2017,Afghanistan,AFG,Sweden,SWE,136,44,362,228,770
2017,Albania,ALB,Sweden,SWE,0,0,37,23,60
2017,Algeria,DZA,Sweden,SWE,0,0,35,19,54
2017,Angola,AGO,Sweden,SWE,0,0,5,0,5
2017,Egypt,EGY,Sweden,SWE,0,0,10,13,23
2017,Armenia,ARM,Sweden,SWE,5,0,79,11,95
2017,Azerbaijan,AZE,Sweden,SWE,10,0,47,18,75
2017,Bangladesh,BGD,Sweden,SWE,0,0,11,5,16
2017,Belarus,BLR,Sweden,SWE,0,0,27,34,61
2017,Bolivia (Plurinational State of),BOL,Sweden,SWE,0,0,11,0,11
2017,Bosnia and Herzegovina,BIH,Sweden,SWE,0,0,32,5,37
2017,Cameroon,CMR,Sweden,SWE,0,0,5,0,5
2017,Dem. Rep. of the Congo,COD,Sweden,SWE,0,0,14,0,14
2017,Colombia,COL,Sweden,SWE,0,0,0,10,10
2017,Cuba,CUB,Sweden,SWE,0,0,10,10,20
2017,Djibouti,DJI,Sweden,SWE,0,0,10,5,15
2017,Eritrea,ERI,Sweden,SWE,129,47,29,49,254
2017,Ethiopia,ETH,Sweden,SWE,18,0,64,25,107
2017,Gambia,GMB,Sweden,SWE,0,0,5,5,10
2017,Palestinian,PSE,Sweden,SWE,5,0,22,17,44
2017,Georgia,GEO,Sweden,SWE,0,0,70,29,99
2017,Ghana,GHA,Sweden,SWE,0,0,10,0,10
2017,Cote d'Ivoire,CIV,Sweden,SWE,0,0,5,0,5
2017,India,IND,Sweden,SWE,0,0,18,5,23
2017,Iran (Islamic Rep. of),IRN,Sweden,SWE,72,0,104,32,208
2017,Iraq,IRQ,Sweden,SWE,49,40,305,201,595
2017,Italy,ITA,Sweden,SWE,0,0,5,0,5
2017,Jordan,JOR,Sweden,SWE,0,0,47,11,58
2017,Kazakhstan,KAZ,Sweden,SWE,0,0,73,24,97
2017,Kenya,KEN,Sweden,SWE,0,0,14,5,19
2017,Kyrgyzstan,KGZ,Sweden,SWE,5,0,37,10,52
2017,Dem. People's Rep. of Korea,PRK,Sweden,SWE,0,0,5,0,5
2017,Kuwait,KWT,Sweden,SWE,0,0,5,0,5
2017,Libya,LBY,Sweden,SWE,0,0,25,27,52
2017,Lebanon,LBN,Sweden,SWE,5,0,73,11,89
2017,Sri Lanka,LKA,Sweden,SWE,0,0,5,0,5
2017,North Macedonia,MKD,Sweden,SWE,0,0,15,15,30
2017,Mongolia,MNG,Sweden,SWE,0,0,122,23,145
2017,Morocco,MAR,Sweden,SWE,0,0,62,72,134
2017,Montenegro,MNE,Sweden,SWE,0,0,10,5,15
2017,Nepal,NPL,Sweden,SWE,0,0,5,0,5
2017,Nicaragua,NIC,Sweden,SWE,0,0,12,0,12
2017,Nigeria,NGA,Sweden,SWE,10,0,26,19,55
2017,Pakistan,PAK,Sweden,SWE,0,0,27,10,37
2017,Russian Federation,RUS,Sweden,SWE,0,5,65,36,106
2017,El Salvador,SLV,Sweden,SWE,0,0,14,0,14
2017,Serbia and Kosovo: S/RES/1244 (1999),SRB,Sweden,SWE,0,11,149,65,225
2017,Senegal,SEN,Sweden,SWE,0,0,5,0,5
2017,Sierra Leone,SLE,Sweden,SWE,0,0,5,0,5
2017,Somalia,SOM,Sweden,SWE,38,5,130,183,356
2017,Viet Nam,VNM,Sweden,SWE,0,0,10,0,10
2017,Sudan,SDN,Sweden,SWE,13,0,16,14,43
2017,Syrian Arab Rep.,SYR,Sweden,SWE,28,267,10,88,393
2017,United Rep. of Tanzania,TZA,Sweden,SWE,0,0,5,5,10
2017,Tajikistan,TJK,Sweden,SWE,5,0,5,5,15
2017,Tunisia,TUN,Sweden,SWE,0,0,13,5,18
2017,Turkey,TUR,Sweden,SWE,0,0,25,17,42
2017,United Arab Emirates,ARE,Sweden,SWE,0,0,5,0,5
2017,Uganda,UGA,Sweden,SWE,10,0,5,0,15
2017,Ukraine,UKR,Sweden,SWE,0,0,35,20,55
2017,Uzbekistan,UZB,Sweden,SWE,5,0,30,16,51
2017,Yemen,YEM,Sweden,SWE,0,13,0,14,27
2017,Stateless,XXA,Sweden,SWE,80,13,113,63,269
2017,Unknown ,,Sweden,SWE,0,10,143,32,185
2018,Afghanistan,AFG,Belgium,BEL,15,5,1155,0,1175
2018,Albania,ALB,Belgium,BEL,25,0,295,0,320
2018,Algeria,DZA,Belgium,BEL,0,0,35,0,35
2018,Angola,AGO,Belgium,BEL,0,0,70,0,70
2018,Egypt,EGY,Belgium,BEL,5,0,40,0,45
2018,Armenia,ARM,Belgium,BEL,0,0,95,0,95
2018,Azerbaijan,AZE,Belgium,BEL,0,0,10,0,10
2018,Burundi,BDI,Belgium,BEL,95,0,30,0,125
2018,Benin,BEN,Belgium,BEL,0,0,20,0,20
2018,Bangladesh,BGD,Belgium,BEL,0,0,15,0,15
2018,Burkina Faso,BFA,Belgium,BEL,0,0,20,0,20
2018,Belarus,BLR,Belgium,BEL,0,0,15,0,15
2018,Brazil,BRA,Belgium,BEL,0,0,5,0,5
2018,Bosnia and Herzegovina,BIH,Belgium,BEL,0,0,20,0,20
2018,China,CHN,Belgium,BEL,0,0,25,0,25
2018,Cameroon,CMR,Belgium,BEL,10,0,145,0,155
2018,Congo,COG,Belgium,BEL,0,0,10,0,10
2018,Dem. Rep. of the Congo,COD,Belgium,BEL,15,0,290,0,305
2018,Djibouti,DJI,Belgium,BEL,5,0,45,0,50
2018,Eritrea,ERI,Belgium,BEL,0,0,40,0,40
2018,Ethiopia,ETH,Belgium,BEL,0,0,25,0,25
2018,Gambia,GMB,Belgium,BEL,0,0,15,0,15
2018,Georgia,GEO,Belgium,BEL,5,10,55,0,70
2018,Ghana,GHA,Belgium,BEL,0,0,30,0,30
2018,Guinea,GIN,Belgium,BEL,30,5,220,0,255
2018,Cote d'Ivoire,CIV,Belgium,BEL,0,0,45,0,45
2018,India,IND,Belgium,BEL,0,0,25,0,25
2018,Iran (Islamic Rep. of),IRN,Belgium,BEL,0,0,65,0,65
2018,Iraq,IRQ,Belgium,BEL,155,60,875,0,1090
2018,Jordan,JOR,Belgium,BEL,0,0,15,0,15
2018,Kazakhstan,KAZ,Belgium,BEL,0,0,10,0,10
2018,Kenya,KEN,Belgium,BEL,0,0,5,0,5
2018,Kyrgyzstan,KGZ,Belgium,BEL,0,0,20,0,20
2018,Liberia,LBR,Belgium,BEL,0,0,10,0,10
2018,Lebanon,LBN,Belgium,BEL,0,0,30,0,30
2018,Sri Lanka,LKA,Belgium,BEL,0,0,70,0,70
2018,Mauritania,MRT,Belgium,BEL,10,0,60,0,70
2018,North Macedonia,MKD,Belgium,BEL,5,0,85,0,90
2018,Mali,MLI,Belgium,BEL,0,0,10,0,10
2018,Mongolia,MNG,Belgium,BEL,0,0,10,0,10
2018,Morocco,MAR,Belgium,BEL,0,0,75,0,75
2018,Montenegro,MNE,Belgium,BEL,0,0,5,0,5
2018,Nepal,NPL,Belgium,BEL,0,0,20,0,20
2018,Niger,NER,Belgium,BEL,0,0,20,0,20
2018,Nigeria,NGA,Belgium,BEL,0,0,50,0,50
2018,Peru,PER,Belgium,BEL,0,0,5,0,5
2018,Afghanistan,AFG,Finland,FIN,41,11,84,83,219
2018,Albania,ALB,Finland,FIN,0,0,0,5,5
2018,Algeria,DZA,Finland,FIN,0,0,5,5,10
2018,Egypt,EGY,Finland,FIN,0,0,5,0,5
2018,Bangladesh,BGD,Finland,FIN,0,0,5,5,10
2018,Belarus,BLR,Finland,FIN,0,0,0,5,5
2018,Cameroon,CMR,Finland,FIN,0,0,5,5,10
2018,Ethiopia,ETH,Finland,FIN,0,0,0,10,10
2018,Gambia,GMB,Finland,FIN,0,0,0,5,5
2018,Ghana,GHA,Finland,FIN,0,0,5,5,10
2018,Iran (Islamic Rep. of),IRN,Finland,FIN,0,0,14,34,48
2018,Iraq,IRQ,Finland,FIN,87,15,502,558,1162
2018,Lebanon,LBN,Finland,FIN,0,0,0,5,5
2018,Nigeria,NGA,Finland,FIN,5,0,28,10,43
2018,Pakistan,PAK,Finland,FIN,0,0,0,5,5
2018,Philippines,PHL,Finland,FIN,0,0,0,5,5
2018,Russian Federation,RUS,Finland,FIN,5,0,15,33,53
2018,Serbia and Kosovo: S/RES/1244 (1999),SRB,Finland,FIN,0,0,5,0,5
2018,Somalia,SOM,Finland,FIN,19,0,26,161,206
2018,Sudan,SDN,Finland,FIN,0,0,0,5,5
2018,Turkey,TUR,Finland,FIN,0,0,5,15,20
2018,Stateless,XXA,Finland,FIN,0,0,0,5,5
2018,Unknown ,,Finland,FIN,0,0,5,0,5
2018,Afghanistan,AFG,United Kingdom of Great Britain and Northern Ireland,GBR,5,0,0,0,5
2018,Iran (Islamic Rep. of),IRN,United Kingdom of Great Britain and Northern Ireland,GBR,0,0,5,5,10
2018,Iraq,IRQ,United Kingdom of Great Britain and Northern Ireland,GBR,0,0,0,5,5
2018,Nigeria,NGA,United Kingdom of Great Britain and Northern Ireland,GBR,0,0,0,5,5
2018,Pakistan,PAK,United Kingdom of Great Britain and Northern Ireland,GBR,0,0,5,0,5
2018,Ukraine,UKR,United Kingdom of Great Britain and Northern Ireland,GBR,0,0,5,0,5
2018,Afghanistan,AFG,Germany,DEU,296,561,263,2011,3131
2018,Albania,ALB,Germany,DEU,5,11,93,1057,1166
2018,Algeria,DZA,Germany,DEU,0,5,60,310,375
2018,Angola,AGO,Germany,DEU,0,5,0,5,10
2018,Egypt,EGY,Germany,DEU,10,0,31,113,154
2018,Armenia,ARM,Germany,DEU,5,18,85,477,585
2018,Azerbaijan,AZE,Germany,DEU,5,5,78,456,544
2018,Benin,BEN,Germany,DEU,0,5,5,5,15
2018,Bangladesh,BGD,Germany,DEU,0,0,17,143,160
2018,Burkina Faso,BFA,Germany,DEU,5,0,5,13,23
2018,Belarus,BLR,Germany,DEU,0,0,14,57,71
2018,Bosnia and Herzegovina,BIH,Germany,DEU,0,0,38,411,449
2018,Chad,TCD,Germany,DEU,0,0,5,36,41
2018,China,CHN,Germany,DEU,0,5,13,32,50
2018,Cameroon,CMR,Germany,DEU,0,5,14,87,106
2018,Congo,COG,Germany,DEU,0,0,0,5,5
2018,Dem. Rep. of the Congo,COD,Germany,DEU,5,10,11,41,67
2018,Cuba,CUB,Germany,DEU,0,0,0,5,5
2018,Djibouti,DJI,Germany,DEU,0,0,0,5,5
2018,Eritrea,ERI,Germany,DEU,21,130,5,252,408
2018,Ethiopia,ETH,Germany,DEU,11,13,43,195,262
2018,Gambia,GMB,Germany,DEU,0,11,89,374,474
2018,Georgia,GEO,Germany,DEU,0,5,106,483,594
2018,Ghana,GHA,Germany,DEU,5,0,17,108,130
2018,Guinea-Bissau,GNB,Germany,DEU,0,0,5,34,39
2018,Guinea,GIN,Germany,DEU,12,24,33,277,346
2018,Cote d'Ivoire,CIV,Germany,DEU,0,5,10,52,67
2018,India,IND,Germany,DEU,5,0,19,99,123
2018,Iran (Islamic Rep. of),IRN,Germany,DEU,131,43,169,682,1025
2018,Iraq,IRQ,Germany,DEU,62,136,263,1664,2125
2018,Jamaica,JAM,Germany,DEU,0,0,0,5,5
2018,Jordan,JOR,Germany,DEU,5,0,11,18,34
2018,Kazakhstan,KAZ,Germany,DEU,0,0,0,15,15
2018,Kenya,KEN,Germany,DEU,0,0,5,10,15
2018,Kyrgyzstan,KGZ,Germany,DEU,0,0,5,49,54
2018,Rep. of Korea,KOR,Germany,DEU,0,0,0,5,5
2018,Kuwait,KWT,Germany,DEU,0,0,0,5,5
2018,Liberia,LBR,Germany,DEU,0,0,5,10,15
2018,Libya,LBY,Germany,DEU,0,16,15,65,96
2018,Lebanon,LBN,Germany,DEU,0,5,40,149,194
2018,Sri Lanka,LKA,Germany,DEU,5,10,20,130,165
2018,Madagascar,MDG,Germany,DEU,0,0,0,5,5
2018,Mauritania,MRT,Germany,DEU,0,0,0,5,5
2018,North Macedonia,MKD,Germany,DEU,0,10,175,1082,1267
2018,Rep. of Moldova,MDA,Germany,DEU,0,0,62,551,613
2018,Mali,MLI,Germany,DEU,0,0,10,72,82
2018,Mongolia,MNG,Germany,DEU,0,5,12,36,53
2018,Morocco,MAR,Germany,DEU,5,0,29,297,331
2018,Montenegro,MNE,Germany,DEU,0,0,35,192,227
2018,Nepal,NPL,Germany,DEU,0,0,5,5,10
2018,Niger,NER,Germany,DEU,0,0,5,28,33
2018,Nigeria,NGA,Germany,DEU,42,70,137,822,1071
2018,Pakistan,PAK,Germany,DEU,10,13,180,1106,1309
2018,Philippines,PHL,Germany,DEU,0,0,0,5,5
2018,Poland,POL,Germany,DEU,0,0,0,5,5
2018,Russian Federation,RUS,Germany,DEU,48,102,300,1374,1824
2018,Rwanda,RWA,Germany,DEU,0,5,0,5,10
2018,Saudi Arabia,SAU,Germany,DEU,0,0,0,5,5
2018,Serbia and Kosovo: S/RES/1244 (1999),SRB,Germany,DEU,0,15,277,2006,2298
2018,Senegal,SEN,Germany,DEU,0,0,15,93,108
2018,Sierra Leone,SLE,Germany,DEU,5,5,12,52,74
2018,Somalia,SOM,Germany,DEU,67,188,62,773,1090
2018,Viet Nam,VNM,Germany,DEU,0,5,18,34,57
2018,Sudan,SDN,Germany,DEU,10,21,12,252,295
2018,South Sudan,SSD,Germany,DEU,0,0,0,10,10
2018,Syrian Arab Rep.,SYR,Germany,DEU,742,234,22,1021,2019
2018,United Rep. of Tanzania,TZA,Germany,DEU,0,0,0,16,16
2018,Tajikistan,TJK,Germany,DEU,5,5,21,121,152
2018,Togo,TGO,Germany,DEU,0,5,10,39,54
2018,Tunisia,TUN,Germany,DEU,0,0,20,126,146
2018,Turkey,TUR,Germany,DEU,22,14,217,245,498
2018,United Arab Emirates,ARE,Germany,DEU,0,5,0,0,5
2018,Uganda,UGA,Germany,DEU,0,5,0,11,16
2018,Ukraine,UKR,Germany,DEU,0,0,61,264,325
2018,Uzbekistan,UZB,Germany,DEU,0,0,0,11,11
2018,Yemen,YEM,Germany,DEU,0,17,0,16,33
2018,Stateless,XXA,Germany,DEU,23,13,5,63,104
2018,Unknown ,,Germany,DEU,153,41,58,459,711
2018,Afghanistan,AFG,Netherlands,NLD,126,22,263,26,437
2018,Algeria,DZA,Netherlands,NLD,0,0,17,10,27
2018,Egypt,EGY,Netherlands,NLD,0,0,43,0,43
2018,Armenia,ARM,Netherlands,NLD,0,0,32,0,32
2018,Azerbaijan,AZE,Netherlands,NLD,0,0,22,5,27
2018,Burundi,BDI,Netherlands,NLD,0,0,11,0,11
2018,Congo,COG,Netherlands,NLD,0,0,11,0,11
2018,Eritrea,ERI,Netherlands,NLD,106,0,40,0,146
2018,Ethiopia,ETH,Netherlands,NLD,19,0,13,0,32
2018,Gambia,GMB,Netherlands,NLD,0,0,5,0,5
2018,Georgia,GEO,Netherlands,NLD,0,0,10,0,10
2018,Guinea,GIN,Netherlands,NLD,0,0,17,0,17
2018,Cote d'Ivoire,CIV,Netherlands,NLD,0,0,10,0,10
2018,Iran (Islamic Rep. of),IRN,Netherlands,NLD,43,0,167,12,222
2018,Iraq,IRQ,Netherlands,NLD,30,5,289,16,340
2018,Libya,LBY,Netherlands,NLD,0,0,23,5,28
2018,Sri Lanka,LKA,Netherlands,NLD,0,0,15,0,15
2018,Morocco,MAR,Netherlands,NLD,0,0,25,19,44
2018,Nigeria,NGA,Netherlands,NLD,5,0,43,0,48
2018,Pakistan,PAK,Netherlands,NLD,0,0,23,0,23
2018,Russian Federation,RUS,Netherlands,NLD,0,0,10,0,10
2018,Serbia and Kosovo: S/RES/1244 (1999),SRB,Netherlands,NLD,0,0,22,0,22
2018,Sierra Leone,SLE,Netherlands,NLD,0,0,20,0,20
2018,Somalia,SOM,Netherlands,NLD,11,0,56,0,67
2018,Sudan,SDN,Netherlands,NLD,28,0,21,0,49
2018,Syrian Arab Rep.,SYR,Netherlands,NLD,0,0,20,0,20
2018,Tunisia,TUN,Netherlands,NLD,0,0,10,0,10
2018,Turkey,TUR,Netherlands,NLD,0,0,21,0,21
2018,Uganda,UGA,Netherlands,NLD,0,0,26,0,26
2018,Ukraine,UKR,Netherlands,NLD,0,0,11,0,11
2018,Stateless,XXA,Netherlands,NLD,0,0,17,0,17
2018,Unknown ,,Netherlands,NLD,0,44,135,43,222
2018,Afghanistan,AFG,Norway,NOR,0,0,0,5,5
2018,Azerbaijan,AZE,Norway,NOR,0,0,0,5,5
2018,Eritrea,ERI,Norway,NOR,31,0,0,5,36
2018,Ethiopia,ETH,Norway,NOR,0,0,5,5,10
2018,Iran (Islamic Rep. of),IRN,Norway,NOR,0,0,0,5,5
2018,Iraq,IRQ,Norway,NOR,0,0,5,5,10
2018,Nigeria,NGA,Norway,NOR,0,0,5,0,5
2018,Russian Federation,RUS,Norway,NOR,0,0,5,10,15
2018,Serbia and Kosovo: S/RES/1244 (1999),SRB,Norway,NOR,0,0,5,0,5
2018,Somalia,SOM,Norway,NOR,0,0,5,0,5
2018,Syrian Arab Rep.,SYR,Norway,NOR,5,0,0,0,5
2018,Turkey,TUR,Norway,NOR,0,0,0,5,5
2018,Ukraine,UKR,Norway,NOR,0,0,5,0,5
2018,Stateless,XXA,Norway,NOR,5,0,0,0,5
2018,Afghanistan,AFG,Sweden,SWE,134,13,380,150,677
2018,Albania,ALB,Sweden,SWE,0,0,54,14,68
2018,Algeria,DZA,Sweden,SWE,0,0,14,18,32
2018,Angola,AGO,Sweden,SWE,0,0,5,0,5
2018,Egypt,EGY,Sweden,SWE,0,0,36,12,48
2018,Argentina,ARG,Sweden,SWE,0,0,0,5,5
2018,Armenia,ARM,Sweden,SWE,0,0,67,20,87
2018,Azerbaijan,AZE,Sweden,SWE,5,0,46,23,74
2018,Bangladesh,BGD,Sweden,SWE,0,0,26,12,38
2018,Belarus,BLR,Sweden,SWE,0,0,17,27,44
2018,Bolivia (Plurinational State of),BOL,Sweden,SWE,0,0,11,0,11
2018,Bosnia and Herzegovina,BIH,Sweden,SWE,0,0,10,15,25
2018,China,CHN,Sweden,SWE,5,0,0,5,10
2018,Chile,CHL,Sweden,SWE,0,0,5,0,5
2018,Cameroon,CMR,Sweden,SWE,0,0,5,0,5
2018,Dem. Rep. of the Congo,COD,Sweden,SWE,0,0,17,0,17
2018,Colombia,COL,Sweden,SWE,0,0,5,0,5
2018,Cuba,CUB,Sweden,SWE,0,0,5,5,10
2018,Djibouti,DJI,Sweden,SWE,0,0,10,5,15
2018,Eritrea,ERI,Sweden,SWE,128,10,26,57,221
2018,Ethiopia,ETH,Sweden,SWE,14,0,98,29,141
2018,Gambia,GMB,Sweden,SWE,0,0,5,10,15
2018,Palestinian,PSE,Sweden,SWE,13,0,26,11,50
2018,Georgia,GEO,Sweden,SWE,0,0,77,45,122
2018,Ghana,GHA,Sweden,SWE,0,0,10,0,10
2018,Guinea,GIN,Sweden,SWE,0,0,10,5,15
2018,Cote d'Ivoire,CIV,Sweden,SWE,0,0,5,5,10
2018,India,IND,Sweden,SWE,0,0,14,5,19
2018,Iran (Islamic Rep. of),IRN,Sweden,SWE,77,0,212,42,331
2018,Iraq,IRQ,Sweden,SWE,44,38,363,159,604
2018,Jordan,JOR,Sweden,SWE,0,0,34,5,39
2018,Kazakhstan,KAZ,Sweden,SWE,0,0,49,39,88
2018,Kenya,KEN,Sweden,SWE,5,0,12,0,17
2018,Kyrgyzstan,KGZ,Sweden,SWE,0,0,57,13,70
2018,Dem. People's Rep. of Korea,PRK,Sweden,SWE,0,0,5,0,5
2018,Kuwait,KWT,Sweden,SWE,0,0,5,0,5
2018,Libya,LBY,Sweden,SWE,5,0,24,20,49
2018,Lebanon,LBN,Sweden,SWE,0,5,110,12,127
2018,Sri Lanka,LKA,Sweden,SWE,0,0,5,0,5
2018,North Macedonia,MKD,Sweden,SWE,0,0,12,13,25
2018,Mongolia,MNG,Sweden,SWE,0,0,130,38,168
2018,Morocco,MAR,Sweden,SWE,0,0,58,42,100
2018,Montenegro,MNE,Sweden,SWE,0,0,5,0,5
2018,Nicaragua,NIC,Sweden,SWE,0,0,19,0,19
2018,Nigeria,NGA,Sweden,SWE,10,0,66,25,101
2018,Pakistan,PAK,Sweden,SWE,0,0,27,10,37
2018,Peru,PER,Sweden,SWE,0,0,0,5,5
2018,Russian Federation,RUS,Sweden,SWE,0,5,134,27,166
2018,Rwanda,RWA,Sweden,SWE,0,0,5,0,5
2018,El Salvador,SLV,Sweden,SWE,0,0,5,0,5
2018,Serbia and Kosovo: S/RES/1244 (1999),SRB,Sweden,SWE,0,0,73,25,98
2018,Senegal,SEN,Sweden,SWE,0,0,10,0,10
2018,Sierra Leone,SLE,Sweden,SWE,0,0,5,0,5
2018,Somalia,SOM,Sweden,SWE,45,5,143,118,311
2018,Viet Nam,VNM,Sweden,SWE,0,0,10,5,15
2018,Sudan,SDN,Sweden,SWE,5,0,18,5,28
2018,Syrian Arab Rep.,SYR,Sweden,SWE,16,123,15,121,275
2018,United Rep. of Tanzania,TZA,Sweden,SWE,0,0,14,0,14
2018,Tajikistan,TJK,Sweden,SWE,0,0,10,5,15
2018,Tunisia,TUN,Sweden,SWE,0,0,19,10,29
2018,Turkey,TUR,Sweden,SWE,5,0,40,24,69
2018,Uganda,UGA,Sweden,SWE,13,0,5,5,23
2018,Ukraine,UKR,Sweden,SWE,0,0,40,10,50
2018,Uzbekistan,UZB,Sweden,SWE,5,0,51,21,77
2018,Yemen,YEM,Sweden,SWE,5,13,0,5,23
2018,Stateless,XXA,Sweden,SWE,29,12,109,55,205
2018,Unknown ,,Sweden,SWE,0,0,131,24,155
2019,Afghanistan,AFG,Belgium,BEL,30,25,511,73,639
2019,Albania,ALB,Belgium,BEL,10,0,68,31,109
2019,Algeria,DZA,Belgium,BEL,0,0,10,0,10
2019,Angola,AGO,Belgium,BEL,0,0,11,0,11
2019,Egypt,EGY,Belgium,BEL,0,0,18,5,23
2019,Armenia,ARM,Belgium,BEL,0,0,26,5,31
2019,Azerbaijan,AZE,Belgium,BEL,0,0,5,5,10
2019,Burundi,BDI,Belgium,BEL,0,0,17,0,17
2019,Benin,BEN,Belgium,BEL,5,0,5,0,10
2019,Bangladesh,BGD,Belgium,BEL,0,0,5,0,5
2019,Burkina Faso,BFA,Belgium,BEL,0,0,18,0,18
2019,Belarus,BLR,Belgium,BEL,0,0,0,5,5
2019,China,CHN,Belgium,BEL,0,0,5,0,5
2019,Cameroon,CMR,Belgium,BEL,10,0,53,5,68
2019,Dem. Rep. of the Congo,COD,Belgium,BEL,5,0,126,21,152
2019,Colombia,COL,Belgium,BEL,0,0,15,0,15
2019,Djibouti,DJI,Belgium,BEL,0,0,10,0,10
2019,Eritrea,ERI,Belgium,BEL,0,0,5,0,5
2019,Ethiopia,ETH,Belgium,BEL,0,0,5,0,5
2019,Gambia,GMB,Belgium,BEL,0,0,5,0,5
2019,Palestinian,PSE,Belgium,BEL,10,0,23,5,38
2019,Georgia,GEO,Belgium,BEL,0,0,12,5,17
2019,Ghana,GHA,Belgium,BEL,0,0,10,0,10
2019,Guinea,GIN,Belgium,BEL,25,10,159,23,217
2019,Cote d'Ivoire,CIV,Belgium,BEL,0,0,34,5,39
2019,Iran (Islamic Rep. of),IRN,Belgium,BEL,0,0,11,0,11
2019,Iraq,IRQ,Belgium,BEL,11,5,147,27,190
2019,Jordan,JOR,Belgium,BEL,0,0,5,0,5
2019,Kyrgyzstan,KGZ,Belgium,BEL,0,0,5,0,5
2019,Lebanon,LBN,Belgium,BEL,0,0,11,0,11
2019,Sri Lanka,LKA,Belgium,BEL,0,0,21,0,21
2019,Mauritania,MRT,Belgium,BEL,5,0,19,5,29
2019,North Macedonia,MKD,Belgium,BEL,0,0,11,5,16
2019,Mali,MLI,Belgium,BEL,0,0,5,0,5
2019,Morocco,MAR,Belgium,BEL,0,0,22,0,22
2019,Niger,NER,Belgium,BEL,0,0,15,5,20
2019,Nigeria,NGA,Belgium,BEL,0,0,13,0,13
2019,Pakistan,PAK,Belgium,BEL,0,0,15,5,20
2019,Russian Federation,RUS,Belgium,BEL,0,0,49,11,60
2019,Rwanda,RWA,Belgium,BEL,10,0,53,13,76
2019,Serbia and Kosovo: S/RES/1244 (1999),SRB,Belgium,BEL,0,0,43,21,64
2019,Senegal,SEN,Belgium,BEL,5,0,16,0,21
2019,Sierra Leone,SLE,Belgium,BEL,0,0,10,0,10
2019,Somalia,SOM,Belgium,BEL,0,0,37,10,47
2019,Sudan,SDN,Belgium,BEL,0,0,15,0,15
2019,Syrian Arab Rep.,SYR,Belgium,BEL,0,0,64,22,86
2019,Togo,TGO,Belgium,BEL,5,0,33,0,38
2019,Tunisia,TUN,Belgium,BEL,0,0,5,0,5
2019,Turkey,TUR,Belgium,BEL,5,0,54,14,73
2019,Ukraine,UKR,Belgium,BEL,0,0,16,5,21
2019,Venezuela (Bolivarian Republic of),VEN,Belgium,BEL,0,0,10,0,10
2019,Stateless,XXA,Belgium,BEL,0,0,5,0,5
2019,Unknown ,,Belgium,BEL,0,0,35,12,47
2019,Afghanistan,AFG,United Kingdom of Great Britain and Northern Ireland,GBR,5,0,0,5,10
2019,Bangladesh,BGD,United Kingdom of Great Britain and Northern Ireland,GBR,0,0,5,0,5
2019,Eritrea,ERI,United Kingdom of Great Britain and Northern Ireland,GBR,5,0,0,0,5
2019,Palestinian,PSE,United Kingdom of Great Britain and Northern Ireland,GBR,0,0,5,5,10
2019,India,IND,United Kingdom of Great Britain and Northern Ireland,GBR,0,0,5,5,10
2019,Iran (Islamic Rep. of),IRN,United Kingdom of Great Britain and Northern Ireland,GBR,12,0,5,0,17
2019,Iraq,IRQ,United Kingdom of Great Britain and Northern Ireland,GBR,0,0,10,5,15
2019,Pakistan,PAK,United Kingdom of Great Britain and Northern Ireland,GBR,0,0,5,0,5
2019,El Salvador,SLV,United Kingdom of Great Britain and Northern Ireland,GBR,0,0,0,5,5
2019,Turkey,TUR,United Kingdom of Great Britain and Northern Ireland,GBR,0,0,0,5,5
2019,Stateless,XXA,United Kingdom of Great Britain and Northern Ireland,GBR,0,0,0,10,10
2019,Afghanistan,AFG,Germany,DEU,115,508,145,1720,2488
2019,Albania,ALB,Germany,DEU,0,5,92,830,927
2019,Algeria,DZA,Germany,DEU,0,5,59,281,345
2019,Angola,AGO,Germany,DEU,0,0,5,17,22
2019,Egypt,EGY,Germany,DEU,10,0,10,129,149
2019,Armenia,ARM,Germany,DEU,5,11,34,313,363
2019,Azerbaijan,AZE,Germany,DEU,0,14,71,462,547
2019,Benin,BEN,Germany,DEU,0,0,5,17,22
2019,Bangladesh,BGD,Germany,DEU,0,0,10,146,156
2019,Burkina Faso,BFA,Germany,DEU,0,0,5,20,25
2019,Belarus,BLR,Germany,DEU,0,0,5,90,95
2019,Bosnia and Herzegovina,BIH,Germany,DEU,0,0,50,311,361
2019,Central African Rep.,CAF,Germany,DEU,0,0,0,5,5
2019,Chad,TCD,Germany,DEU,0,0,0,27,27
2019,China,CHN,Germany,DEU,5,0,0,36,41
2019,Cameroon,CMR,Germany,DEU,0,0,23,83,106
2019,Congo,COG,Germany,DEU,0,0,0,5,5
2019,Dem. Rep. of the Congo,COD,Germany,DEU,0,0,5,31,36
2019,Colombia,COL,Germany,DEU,0,0,0,10,10
2019,Cuba,CUB,Germany,DEU,0,0,0,10,10
2019,Eritrea,ERI,Germany,DEU,10,113,14,182,319
2019,Ethiopia,ETH,Germany,DEU,5,13,27,198,243
2019,Gambia,GMB,Germany,DEU,5,10,50,311,376
2019,Georgia,GEO,Germany,DEU,0,0,89,463,552
2019,Ghana,GHA,Germany,DEU,0,5,12,107,124
2019,Guinea-Bissau,GNB,Germany,DEU,0,5,11,26,42
2019,Guinea,GIN,Germany,DEU,15,5,51,312,383
2019,Cote d'Ivoire,CIV,Germany,DEU,0,0,11,55,66
2019,India,IND,Germany,DEU,0,0,10,107,117
2019,Iran (Islamic Rep. of),IRN,Germany,DEU,153,28,173,730,1084
2019,Iraq,IRQ,Germany,DEU,81,94,228,1523,1926
2019,Jamaica,JAM,Germany,DEU,0,0,0,5,5
2019,Jordan,JOR,Germany,DEU,0,0,10,24,34
2019,Kazakhstan,KAZ,Germany,DEU,0,0,0,18,18
2019,Kenya,KEN,Germany,DEU,0,0,0,5,5
2019,Kyrgyzstan,KGZ,Germany,DEU,0,0,5,5,10
2019,Liberia,LBR,Germany,DEU,0,0,5,21,26
2019,Libya,LBY,Germany,DEU,5,20,5,97,127
2019,Lebanon,LBN,Germany,DEU,0,5,23,180,208
2019,Sri Lanka,LKA,Germany,DEU,0,0,5,48,53
2019,Madagascar,MDG,Germany,DEU,0,0,0,5,5
2019,Mauritania,MRT,Germany,DEU,0,0,0,10,10
2019,North Macedonia,MKD,Germany,DEU,0,0,141,1039,1180
2019,Rep. of Moldova,MDA,Germany,DEU,0,0,24,999,1023
2019,Mali,MLI,Germany,DEU,0,0,11,75,86
2019,Mongolia,MNG,Germany,DEU,0,0,0,38,38
2019,Morocco,MAR,Germany,DEU,0,0,38,287,325
2019,Montenegro,MNE,Germany,DEU,0,0,12,105,117
2019,Niger,NER,Germany,DEU,0,0,5,20,25
2019,Nigeria,NGA,Germany,DEU,17,50,143,1504,1714
2019,Pakistan,PAK,Germany,DEU,13,10,104,1146,1273
2019,Philippines,PHL,Germany,DEU,0,0,0,5,5
2019,Russian Federation,RUS,Germany,DEU,41,42,214,1342,1639
2019,Serbia and Kosovo: S/RES/1244 (1999),SRB,Germany,DEU,0,5,254,1837,2096
2019,Senegal,SEN,Germany,DEU,0,0,10,76,86
2019,Sierra Leone,SLE,Germany,DEU,0,0,14,41,55
2019,Somalia,SOM,Germany,DEU,59,83,38,676,856
2019,Viet Nam,VNM,Germany,DEU,0,0,10,33,43
2019,Sudan,SDN,Germany,DEU,5,5,20,178,208
2019,South Sudan,SSD,Germany,DEU,0,0,0,5,5
2019,Syrian Arab Rep.,SYR,Germany,DEU,547,176,18,1074,1815
2019,United Rep. of Tanzania,TZA,Germany,DEU,0,0,0,12,12
2019,Thailand,THA,Germany,DEU,0,0,0,5,5
2019,Tajikistan,TJK,Germany,DEU,5,16,19,180,220
2019,Togo,TGO,Germany,DEU,0,0,5,28,33
2019,Tunisia,TUN,Germany,DEU,0,0,18,96,114
2019,Turkey,TUR,Germany,DEU,62,10,184,390,646
2019,Uganda,UGA,Germany,DEU,0,0,0,16,16
2019,Ukraine,UKR,Germany,DEU,5,5,52,269,331
2019,Uzbekistan,UZB,Germany,DEU,0,0,0,10,10
2019,Yemen,YEM,Germany,DEU,5,29,0,10,44
2019,Zimbabwe,ZWE,Germany,DEU,0,0,0,5,5
2019,Stateless,XXA,Germany,DEU,17,5,0,35,57
2019,Unknown ,,Germany,DEU,54,22,45,441,562
2019,Afghanistan,AFG,Netherlands,NLD,91,13,293,117,514
2019,Albania,ALB,Netherlands,NLD,0,0,19,69,88
2019,Algeria,DZA,Netherlands,NLD,0,0,26,66,92
2019,Angola,AGO,Netherlands,NLD,0,0,0,5,5
2019,Egypt,EGY,Netherlands,NLD,0,0,32,17,49
2019,Armenia,ARM,Netherlands,NLD,0,0,29,10,39
2019,Azerbaijan,AZE,Netherlands,NLD,0,0,21,24,45
2019,Burundi,BDI,Netherlands,NLD,0,0,13,5,18
2019,Bangladesh,BGD,Netherlands,NLD,0,0,5,0,5
2019,Burkina Faso,BFA,Netherlands,NLD,0,0,5,0,5
2019,Belarus,BLR,Netherlands,NLD,0,0,0,5,5
2019,Bosnia and Herzegovina,BIH,Netherlands,NLD,0,0,5,24,29
2019,China,CHN,Netherlands,NLD,13,0,5,0,18
2019,Cameroon,CMR,Netherlands,NLD,0,0,5,0,5
2019,Congo,COG,Netherlands,NLD,0,0,14,10,24
2019,Dem. Rep. of the Congo,COD,Netherlands,NLD,0,0,5,0,5
2019,Cuba,CUB,Netherlands,NLD,10,0,0,0,10
2019,Eritrea,ERI,Netherlands,NLD,5,0,39,33,77
2019,Ethiopia,ETH,Netherlands,NLD,5,0,14,10,29
2019,Gambia,GMB,Netherlands,NLD,0,0,10,16,26
2019,Palestinian,PSE,Netherlands,NLD,0,0,5,0,5
2019,Georgia,GEO,Netherlands,NLD,0,0,27,33,60
2019,Ghana,GHA,Netherlands,NLD,0,0,0,5,5
2019,Guinea,GIN,Netherlands,NLD,5,0,15,22,42
2019,Cote d'Ivoire,CIV,Netherlands,NLD,0,0,5,0,5
2019,India,IND,Netherlands,NLD,0,0,5,0,5
2019,Iran (Islamic Rep. of),IRN,Netherlands,NLD,67,22,188,94,371
2019,Iraq,IRQ,Netherlands,NLD,46,12,252,235,545
2019,Jordan,JOR,Netherlands,NLD,0,0,5,5,10
2019,Liberia,LBR,Netherlands,NLD,0,0,0,5,5
2019,Libya,LBY,Netherlands,NLD,5,0,17,32,54
2019,Lebanon,LBN,Netherlands,NLD,0,0,5,5,10
2019,Sri Lanka,LKA,Netherlands,NLD,0,0,26,24,50
2019,North Macedonia,MKD,Netherlands,NLD,0,0,0,35,35
2019,Rep. of Moldova,MDA,Netherlands,NLD,0,0,5,23,28
2019,Mongolia,MNG,Netherlands,NLD,0,0,0,5,5
2019,Morocco,MAR,Netherlands,NLD,0,5,25,87,117
2019,Myanmar,MMR,Netherlands,NLD,0,0,10,5,15
2019,Nepal,NPL,Netherlands,NLD,0,0,10,0,10
2019,Nigeria,NGA,Netherlands,NLD,5,0,38,33,76
2019,Pakistan,PAK,Netherlands,NLD,5,0,22,22,49
2019,Russian Federation,RUS,Netherlands,NLD,0,0,19,14,33
2019,Rwanda,RWA,Netherlands,NLD,0,0,5,0,5
2019,Serbia and Kosovo: S/RES/1244 (1999),SRB,Netherlands,NLD,0,0,21,23,44
2019,Senegal,SEN,Netherlands,NLD,0,0,0,5,5
2019,Sierra Leone,SLE,Netherlands,NLD,5,0,18,19,42
2019,Somalia,SOM,Netherlands,NLD,5,5,32,44,86
2019,Viet Nam,VNM,Netherlands,NLD,0,0,5,0,5
2019,Sudan,SDN,Netherlands,NLD,0,0,25,21,46
2019,Syrian Arab Rep.,SYR,Netherlands,NLD,10,0,59,50,119
2019,United Rep. of Tanzania,TZA,Netherlands,NLD,0,0,5,0,5
2019,Tunisia,TUN,Netherlands,NLD,0,0,10,25,35
2019,Turkey,TUR,Netherlands,NLD,0,0,28,12,40
2019,Uganda,UGA,Netherlands,NLD,0,0,18,12,30
2019,Ukraine,UKR,Netherlands,NLD,0,0,15,12,27
2019,United States of America,USA,Netherlands,NLD,0,0,5,5,10
2019,Uzbekistan,UZB,Netherlands,NLD,0,0,5,0,5
2019,Venezuela (Bolivarian Republic of),VEN,Netherlands,NLD,0,0,12,12,24
2019,Yemen,YEM,Netherlands,NLD,5,0,5,0,10
2019,Zimbabwe,ZWE,Netherlands,NLD,0,0,5,0,5
2019,Stateless,XXA,Netherlands,NLD,0,0,45,12,57
2019,Unknown ,,Netherlands,NLD,0,0,10,19,29
2019,Afghanistan,AFG,Norway,NOR,5,0,0,0,5
2019,Belarus,BLR,Norway,NOR,0,0,5,0,5
2019,Eritrea,ERI,Norway,NOR,5,0,0,5,10
2019,Iran (Islamic Rep. of),IRN,Norway,NOR,5,0,0,5,10
2019,Iraq,IRQ,Norway,NOR,0,0,5,5,10
2019,Lebanon,LBN,Norway,NOR,5,0,0,0,5
2019,Nigeria,NGA,Norway,NOR,0,0,0,5,5
2019,Russian Federation,RUS,Norway,NOR,0,0,5,14,19
2019,El Salvador,SLV,Norway,NOR,5,0,0,0,5
2019,Serbia and Kosovo: S/RES/1244 (1999),SRB,Norway,NOR,0,0,5,0,5
2019,Somalia,SOM,Norway,NOR,0,0,5,5,10
2019,Syrian Arab Rep.,SYR,Norway,NOR,10,0,0,0,10
2019,Afghanistan,AFG,Sweden,SWE,58,10,168,78,314
2019,Albania,ALB,Sweden,SWE,0,0,30,21,51
2019,Algeria,DZA,Sweden,SWE,0,0,13,10,23
2019,Egypt,EGY,Sweden,SWE,5,5,29,5,44
2019,Armenia,ARM,Sweden,SWE,0,0,94,15,109
2019,Azerbaijan,AZE,Sweden,SWE,11,0,61,35,107
2019,Burundi,BDI,Sweden,SWE,0,0,5,0,5
2019,Bangladesh,BGD,Sweden,SWE,0,0,31,5,36
2019,Belarus,BLR,Sweden,SWE,0,0,19,20,39
2019,Bolivia (Plurinational State of),BOL,Sweden,SWE,0,0,16,0,16
2019,Bosnia and Herzegovina,BIH,Sweden,SWE,0,0,16,5,21
2019,China,CHN,Sweden,SWE,0,0,5,0,5
2019,Cameroon,CMR,Sweden,SWE,0,0,5,5,10
2019,Dem. Rep. of the Congo,COD,Sweden,SWE,0,0,18,5,23
2019,Colombia,COL,Sweden,SWE,0,0,10,0,10
2019,Cuba,CUB,Sweden,SWE,0,0,11,10,21
2019,Djibouti,DJI,Sweden,SWE,0,0,5,0,5
2019,Ecuador,ECU,Sweden,SWE,0,0,5,5,10
2019,Eritrea,ERI,Sweden,SWE,82,5,13,50,150
2019,Ethiopia,ETH,Sweden,SWE,12,5,107,17,141
2019,Gambia,GMB,Sweden,SWE,0,0,10,11,21
2019,Palestinian,PSE,Sweden,SWE,5,5,86,15,111
2019,Georgia,GEO,Sweden,SWE,0,0,56,21,77
2019,Ghana,GHA,Sweden,SWE,0,0,11,0,11
2019,Guatemala,GTM,Sweden,SWE,0,0,5,0,5
2019,Guinea,GIN,Sweden,SWE,0,0,5,0,5
2019,Cote d'Ivoire,CIV,Sweden,SWE,0,0,5,0,5
2019,India,IND,Sweden,SWE,0,0,10,5,15
2019,Iran (Islamic Rep. of),IRN,Sweden,SWE,57,0,94,41,192
2019,Iraq,IRQ,Sweden,SWE,23,20,281,126,450
2019,Jamaica,JAM,Sweden,SWE,0,0,5,0,5
2019,Jordan,JOR,Sweden,SWE,0,5,29,5,39
2019,Kazakhstan,KAZ,Sweden,SWE,0,0,47,28,75
2019,Kenya,KEN,Sweden,SWE,0,0,19,0,19
2019,Kyrgyzstan,KGZ,Sweden,SWE,0,0,34,18,52
2019,Kuwait,KWT,Sweden,SWE,0,0,5,0,5
2019,Libya,LBY,Sweden,SWE,0,0,10,14,24
2019,Lebanon,LBN,Sweden,SWE,0,5,129,16,150
2019,Sri Lanka,LKA,Sweden,SWE,0,0,5,0,5
2019,Mauritania,MRT,Sweden,SWE,0,0,5,0,5
2019,North Macedonia,MKD,Sweden,SWE,0,0,17,0,17
2019,Mongolia,MNG,Sweden,SWE,0,0,54,24,78
2019,Morocco,MAR,Sweden,SWE,0,0,47,46,93
2019,Montenegro,MNE,Sweden,SWE,0,5,0,5,10
2019,Nicaragua,NIC,Sweden,SWE,0,0,13,0,13
2019,Nigeria,NGA,Sweden,SWE,10,0,66,31,107
2019,Pakistan,PAK,Sweden,SWE,5,0,21,15,41
2019,Peru,PER,Sweden,SWE,0,0,5,5,10
2019,Russian Federation,RUS,Sweden,SWE,0,0,108,33,141
2019,El Salvador,SLV,Sweden,SWE,0,5,22,5,32
2019,Serbia and Kosovo: S/RES/1244 (1999),SRB,Sweden,SWE,0,0,97,18,115
2019,Senegal,SEN,Sweden,SWE,0,0,5,0,5
2019,Sierra Leone,SLE,Sweden,SWE,0,0,5,0,5
2019,Somalia,SOM,Sweden,SWE,14,10,191,116,331
2019,Viet Nam,VNM,Sweden,SWE,0,0,10,5,15
2019,Sudan,SDN,Sweden,SWE,0,0,5,5,10
2019,Syrian Arab Rep.,SYR,Sweden,SWE,5,76,21,222,324
2019,United Rep. of Tanzania,TZA,Sweden,SWE,0,0,11,0,11
2019,Tajikistan,TJK,Sweden,SWE,0,0,5,5,10
2019,Tunisia,TUN,Sweden,SWE,0,0,14,10,24
2019,Turkey,TUR,Sweden,SWE,5,0,28,14,47
2019,Uganda,UGA,Sweden,SWE,5,0,5,5,15
2019,Ukraine,UKR,Sweden,SWE,0,0,18,17,35
2019,United States of America,USA,Sweden,SWE,0,0,5,5,10
2019,Uzbekistan,UZB,Sweden,SWE,0,0,28,20,48
2019,Yemen,YEM,Sweden,SWE,0,10,0,5,15
2019,Stateless,XXA,Sweden,SWE,21,10,109,127,267
2019,Unknown ,,Sweden,SWE,0,5,96,17,118
2020,Afghanistan,AFG,Belgium,BEL,25,20,680,0,725
2020,Albania,ALB,Belgium,BEL,10,0,340,0,350
2020,Algeria,DZA,Belgium,BEL,5,0,30,0,35
2020,Angola,AGO,Belgium,BEL,0,0,25,0,25
2020,Egypt,EGY,Belgium,BEL,0,0,15,0,15
2020,Armenia,ARM,Belgium,BEL,0,0,40,0,40
2020,Azerbaijan,AZE,Belgium,BEL,0,0,10,0,10
2020,Burundi,BDI,Belgium,BEL,5,0,30,0,35
2020,Benin,BEN,Belgium,BEL,0,0,15,0,15
2020,Bangladesh,BGD,Belgium,BEL,0,0,5,0,5
2020,Burkina Faso,BFA,Belgium,BEL,0,0,10,0,10
2020,Belarus,BLR,Belgium,BEL,0,0,5,0,5
2020,Brazil,BRA,Belgium,BEL,0,0,5,0,5
2020,Bosnia and Herzegovina,BIH,Belgium,BEL,0,0,10,0,10
2020,China,CHN,Belgium,BEL,0,0,15,0,15
2020,Chile,CHL,Belgium,BEL,0,0,5,0,5
2020,Cameroon,CMR,Belgium,BEL,10,0,115,0,125
2020,Congo,COG,Belgium,BEL,0,0,5,0,5
2020,Dem. Rep. of the Congo,COD,Belgium,BEL,10,0,170,0,180
2020,Colombia,COL,Belgium,BEL,0,0,130,0,130
2020,Djibouti,DJI,Belgium,BEL,5,0,25,0,30
2020,Eritrea,ERI,Belgium,BEL,0,0,95,0,95
2020,Ethiopia,ETH,Belgium,BEL,0,0,20,0,20
2020,Gabon,GAB,Belgium,BEL,0,0,5,0,5
2020,Gambia,GMB,Belgium,BEL,0,0,15,0,15
2020,Palestinian,PSE,Belgium,BEL,25,5,695,0,725
2020,Georgia,GEO,Belgium,BEL,0,0,60,0,60
2020,Ghana,GHA,Belgium,BEL,0,0,5,0,5
2020,Guinea-Bissau,GNB,Belgium,BEL,0,0,5,0,5
2020,Guinea,GIN,Belgium,BEL,55,5,480,0,540
2020,Cote d'Ivoire,CIV,Belgium,BEL,5,0,25,0,30
2020,India,IND,Belgium,BEL,5,0,5,0,10
2020,Iran (Islamic Rep. of),IRN,Belgium,BEL,0,0,45,0,45
2020,Iraq,IRQ,Belgium,BEL,10,10,590,0,610
2020,Jordan,JOR,Belgium,BEL,0,0,15,0,15
2020,Kazakhstan,KAZ,Belgium,BEL,0,0,5,0,5
2020,Kyrgyzstan,KGZ,Belgium,BEL,0,0,10,0,10
2020,Liberia,LBR,Belgium,BEL,0,0,5,0,5
2020,Libya,LBY,Belgium,BEL,0,0,5,0,5
2020,Lebanon,LBN,Belgium,BEL,5,0,35,0,40
2020,Sri Lanka,LKA,Belgium,BEL,0,0,25,0,25
2020,Lithuania,LTU,Belgium,BEL,0,0,5,0,5
2020,Mauritania,MRT,Belgium,BEL,5,0,40,0,45
2020,North Macedonia,MKD,Belgium,BEL,0,0,75,0,75
2020,Mexico,MEX,Belgium,BEL,0,0,5,0,5
2020,Mali,MLI,Belgium,BEL,0,0,15,0,15
2020,Morocco,MAR,Belgium,BEL,0,0,35,0,35
2020,Myanmar,MMR,Belgium,BEL,0,0,5,0,5
2020,Niger,NER,Belgium,BEL,0,0,15,0,15
2020,Nicaragua,NIC,Belgium,BEL,0,0,5,0,5
2020,Nigeria,NGA,Belgium,BEL,0,0,25,0,25
2020,Pakistan,PAK,Belgium,BEL,0,0,50,0,50
2020,Peru,PER,Belgium,BEL,0,0,5,0,5
2020,Romania,ROU,Belgium,BEL,0,0,5,0,5
2020,Russian Federation,RUS,Belgium,BEL,5,0,175,0,180
2020,Rwanda,RWA,Belgium,BEL,5,0,80,0,85
2020,El Salvador,SLV,Belgium,BEL,0,0,120,0,120
2020,Serbia and Kosovo: S/RES/1244 (1999),SRB,Belgium,BEL,10,0,130,0,140
2020,Senegal,SEN,Belgium,BEL,5,0,60,0,65
2020,Sierra Leone,SLE,Belgium,BEL,0,0,15,0,15
2020,Somalia,SOM,Belgium,BEL,0,0,175,0,175
2020,Viet Nam,VNM,Belgium,BEL,0,0,5,0,5
2020,Sudan,SDN,Belgium,BEL,0,0,35,0,35
2020,Suriname,SUR,Belgium,BEL,0,0,20,0,20
2020,Syrian Arab Rep.,SYR,Belgium,BEL,0,0,715,0,715
2020,United Rep. of Tanzania,TZA,Belgium,BEL,0,0,10,0,10
2020,Tajikistan,TJK,Belgium,BEL,0,0,5,0,5
2020,Togo,TGO,Belgium,BEL,0,0,25,0,25
2020,Tunisia,TUN,Belgium,BEL,0,0,10,0,10
2020,Turkey,TUR,Belgium,BEL,45,0,150,0,195
2020,Uganda,UGA,Belgium,BEL,0,0,5,0,5
2020,Ukraine,UKR,Belgium,BEL,0,0,50,0,50
2020,Venezuela (Bolivarian Republic of),VEN,Belgium,BEL,5,0,280,0,285
2020,Yemen,YEM,Belgium,BEL,0,0,65,0,65
2020,Zimbabwe,ZWE,Belgium,BEL,0,0,5,0,5
2020,Stateless,XXA,Belgium,BEL,0,0,10,0,10
2020,Unknown ,,Belgium,BEL,10,0,90,0,100
2020,Afghanistan,AFG,Finland,FIN,35,13,96,88,232
2020,Albania,ALB,Finland,FIN,0,0,0,5,5
2020,Algeria,DZA,Finland,FIN,0,0,0,5,5
2020,Bangladesh,BGD,Finland,FIN,0,0,5,5,10
2020,Cameroon,CMR,Finland,FIN,0,0,0,13,13
2020,Dem. Rep. of the Congo,COD,Finland,FIN,0,0,0,5,5
2020,Ethiopia,ETH,Finland,FIN,0,0,5,0,5
2020,Gambia,GMB,Finland,FIN,0,0,0,5,5
2020,Georgia,GEO,Finland,FIN,0,0,0,5,5
2020,Ghana,GHA,Finland,FIN,0,0,5,5,10
2020,Cote d'Ivoire,CIV,Finland,FIN,0,0,5,0,5
2020,India,IND,Finland,FIN,0,0,0,5,5
2020,Iran (Islamic Rep. of),IRN,Finland,FIN,10,0,16,21,47
2020,Iraq,IRQ,Finland,FIN,193,37,369,493,1092
2020,Lebanon,LBN,Finland,FIN,0,5,0,0,5
2020,Sri Lanka,LKA,Finland,FIN,0,0,0,14,14
2020,Morocco,MAR,Finland,FIN,0,0,0,5,5
2020,Nigeria,NGA,Finland,FIN,5,0,14,5,24
2020,Russian Federation,RUS,Finland,FIN,5,0,28,68,101
2020,Rwanda,RWA,Finland,FIN,0,0,0,5,5
2020,Somalia,SOM,Finland,FIN,30,5,52,224,311
2020,Turkey,TUR,Finland,FIN,0,0,0,12,12
2020,Ukraine,UKR,Finland,FIN,0,0,5,17,22
2020,Yemen,YEM,Finland,FIN,5,0,0,0,5
2020,Stateless,XXA,Finland,FIN,0,0,0,10,10
2020,Unknown ,,Finland,FIN,0,0,5,0,5
2020,Albania,ALB,United Kingdom of Great Britain and Northern Ireland,GBR,5,0,0,0,5
2020,Eritrea,ERI,United Kingdom of Great Britain and Northern Ireland,GBR,0,0,0,5,5
2020,Iran (Islamic Rep. of),IRN,United Kingdom of Great Britain and Northern Ireland,GBR,0,0,0,5,5
2020,Iraq,IRQ,United Kingdom of Great Britain and Northern Ireland,GBR,0,0,0,14,14
2020,Nigeria,NGA,United Kingdom of Great Britain and Northern Ireland,GBR,0,0,5,0,5
2020,Viet Nam,VNM,United Kingdom of Great Britain and Northern Ireland,GBR,0,0,0,5,5
2020,Sudan,SDN,United Kingdom of Great Britain and Northern Ireland,GBR,5,0,0,0,5
2020,Syrian Arab Rep.,SYR,United Kingdom of Great Britain and Northern Ireland,GBR,5,0,0,0,5
2020,Stateless,XXA,United Kingdom of Great Britain and Northern Ireland,GBR,0,0,5,0,5
2020,Afghanistan,AFG,Germany,DEU,159,471,171,1450,2251
2020,Albania,ALB,Germany,DEU,0,0,40,414,454
2020,Algeria,DZA,Germany,DEU,0,0,49,227,276
2020,Angola,AGO,Germany,DEU,0,0,0,15,15
2020,Egypt,EGY,Germany,DEU,14,0,19,98,131
2020,Armenia,ARM,Germany,DEU,0,0,44,197,241
2020,Azerbaijan,AZE,Germany,DEU,10,5,85,268,368
2020,Benin,BEN,Germany,DEU,0,0,0,17,17
2020,Bangladesh,BGD,Germany,DEU,0,5,5,79,89
2020,Burkina Faso,BFA,Germany,DEU,0,0,5,16,21
2020,Belarus,BLR,Germany,DEU,0,0,5,26,31
2020,Bosnia and Herzegovina,BIH,Germany,DEU,0,0,19,212,231
2020,Chad,TCD,Germany,DEU,0,0,5,13,18
2020,China,CHN,Germany,DEU,5,0,14,44,63
2020,Cameroon,CMR,Germany,DEU,0,0,21,65,86
2020,Dem. Rep. of the Congo,COD,Germany,DEU,0,5,0,18,23
2020,Colombia,COL,Germany,DEU,0,0,0,29,29
2020,Cuba,CUB,Germany,DEU,0,0,0,16,16
2020,Djibouti,DJI,Germany,DEU,0,0,0,5,5
2020,Eritrea,ERI,Germany,DEU,43,64,16,120,243
2020,Ethiopia,ETH,Germany,DEU,22,17,26,335,400
2020,Gambia,GMB,Germany,DEU,0,11,29,342,382
2020,Palestinian,PSE,Germany,DEU,0,10,5,16,31
2020,Georgia,GEO,Germany,DEU,5,0,68,462,535
2020,Ghana,GHA,Germany,DEU,0,5,19,103,127
2020,Guinea-Bissau,GNB,Germany,DEU,0,5,0,24,29
2020,Guinea,GIN,Germany,DEU,14,10,97,256,377
2020,Cote d'Ivoire,CIV,Germany,DEU,5,0,21,71,97
2020,India,IND,Germany,DEU,0,5,5,56,66
2020,Iran (Islamic Rep. of),IRN,Germany,DEU,175,31,192,742,1140
2020,Iraq,IRQ,Germany,DEU,157,92,275,1452,1976
2020,Jordan,JOR,Germany,DEU,0,0,5,28,33
2020,Kazakhstan,KAZ,Germany,DEU,0,0,0,12,12
2020,Kenya,KEN,Germany,DEU,0,0,11,16,27
2020,Kyrgyzstan,KGZ,Germany,DEU,5,0,0,19,24
2020,Liberia,LBR,Germany,DEU,0,5,0,26,31
2020,Libya,LBY,Germany,DEU,16,10,10,52,88
2020,Lebanon,LBN,Germany,DEU,0,0,44,127,171
2020,Sri Lanka,LKA,Germany,DEU,0,5,13,31,49
2020,Mauritania,MRT,Germany,DEU,0,0,0,15,15
2020,North Macedonia,MKD,Germany,DEU,0,0,77,378,455
2020,Rep. of Moldova,MDA,Germany,DEU,0,5,22,956,983
2020,Mali,MLI,Germany,DEU,0,5,10,59,74
2020,Mongolia,MNG,Germany,DEU,0,0,10,42,52
2020,Morocco,MAR,Germany,DEU,0,5,26,196,227
2020,Mozambique,MOZ,Germany,DEU,0,0,0,5,5
2020,Montenegro,MNE,Germany,DEU,0,0,10,131,141
2020,Myanmar,MMR,Germany,DEU,0,0,0,5,5
2020,Niger,NER,Germany,DEU,0,0,10,15,25
2020,Nigeria,NGA,Germany,DEU,33,59,185,1611,1888
2020,Pakistan,PAK,Germany,DEU,23,10,73,813,919
2020,Russian Federation,RUS,Germany,DEU,91,20,203,1135,1449
2020,Rwanda,RWA,Germany,DEU,0,0,0,14,14
2020,Serbia and Kosovo: S/RES/1244 (1999),SRB,Germany,DEU,0,5,134,863,1002
2020,Senegal,SEN,Germany,DEU,0,5,5,50,60
2020,Sierra Leone,SLE,Germany,DEU,0,5,10,53,68
2020,Somalia,SOM,Germany,DEU,58,61,43,507,669
2020,Viet Nam,VNM,Germany,DEU,0,0,11,57,68
2020,Sudan,SDN,Germany,DEU,0,5,36,134,175
2020,South Sudan,SSD,Germany,DEU,0,0,0,5,5
2020,Syrian Arab Rep.,SYR,Germany,DEU,357,100,27,1027,1511
2020,United Rep. of Tanzania,TZA,Germany,DEU,0,0,0,5,5
2020,Tajikistan,TJK,Germany,DEU,21,0,15,158,194
2020,Togo,TGO,Germany,DEU,0,0,5,28,33
2020,Tunisia,TUN,Germany,DEU,5,0,17,92,114
2020,Turkey,TUR,Germany,DEU,89,11,219,400,719
2020,Uganda,UGA,Germany,DEU,0,0,0,10,10
2020,Ukraine,UKR,Germany,DEU,0,0,33,217,250
2020,Uzbekistan,UZB,Germany,DEU,0,0,0,10,10
2020,Venezuela (Bolivarian Republic of),VEN,Germany,DEU,5,5,0,14,24
2020,Yemen,YEM,Germany,DEU,0,5,0,15,20
2020,Zimbabwe,ZWE,Germany,DEU,5,0,0,5,10
2020,Stateless,XXA,Germany,DEU,13,5,5,31,54
2020,Unknown ,,Germany,DEU,40,24,39,334,437
2020,Afghanistan,AFG,Netherlands,NLD,34,5,139,31,209
2020,Albania,ALB,Netherlands,NLD,0,0,5,0,5
2020,Algeria,DZA,Netherlands,NLD,0,0,15,47,62
2020,Angola,AGO,Netherlands,NLD,0,0,5,0,5
2020,Egypt,EGY,Netherlands,NLD,0,0,15,0,15
2020,Armenia,ARM,Netherlands,NLD,0,0,5,0,5
2020,Azerbaijan,AZE,Netherlands,NLD,5,0,13,0,18
2020,Burundi,BDI,Netherlands,NLD,0,0,5,0,5
2020,Burkina Faso,BFA,Netherlands,NLD,0,0,0,5,5
2020,Bosnia and Herzegovina,BIH,Netherlands,NLD,0,0,0,5,5
2020,China,CHN,Netherlands,NLD,0,0,0,5,5
2020,Congo,COG,Netherlands,NLD,0,0,5,0,5
2020,Dem. Rep. of the Congo,COD,Netherlands,NLD,0,0,5,0,5
2020,Colombia,COL,Netherlands,NLD,0,0,0,5,5
2020,Cuba,CUB,Netherlands,NLD,11,0,0,0,11
2020,Eritrea,ERI,Netherlands,NLD,11,0,26,11,48
2020,Ethiopia,ETH,Netherlands,NLD,5,0,15,0,20
2020,Gambia,GMB,Netherlands,NLD,0,0,11,5,16
2020,Georgia,GEO,Netherlands,NLD,0,0,12,5,17
2020,Ghana,GHA,Netherlands,NLD,0,0,0,5,5
2020,Guinea,GIN,Netherlands,NLD,0,0,15,5,20
2020,Cote d'Ivoire,CIV,Netherlands,NLD,0,0,5,0,5
2020,India,IND,Netherlands,NLD,0,0,0,10,10
2020,Iran (Islamic Rep. of),IRN,Netherlands,NLD,33,14,73,20,140
2020,Iraq,IRQ,Netherlands,NLD,19,5,75,46,145
2020,Jordan,JOR,Netherlands,NLD,0,0,5,0,5
2020,Liberia,LBR,Netherlands,NLD,0,0,0,5,5
2020,Libya,LBY,Netherlands,NLD,0,0,18,5,23
2020,Lebanon,LBN,Netherlands,NLD,5,0,5,0,10
2020,Sri Lanka,LKA,Netherlands,NLD,0,0,13,5,18
2020,North Macedonia,MKD,Netherlands,NLD,0,0,0,5,5
2020,Morocco,MAR,Netherlands,NLD,0,0,22,50,72
2020,Myanmar,MMR,Netherlands,NLD,0,0,10,0,10
2020,Nigeria,NGA,Netherlands,NLD,5,0,32,5,42
2020,Pakistan,PAK,Netherlands,NLD,5,5,17,5,32
2020,Russian Federation,RUS,Netherlands,NLD,0,0,5,11,16
2020,Serbia and Kosovo: S/RES/1244 (1999),SRB,Netherlands,NLD,0,0,10,22,32
2020,Senegal,SEN,Netherlands,NLD,0,0,5,0,5
2020,Sierra Leone,SLE,Netherlands,NLD,0,0,10,0,10
2020,Somalia,SOM,Netherlands,NLD,5,0,17,19,41
2020,Sudan,SDN,Netherlands,NLD,0,0,5,5,10
2020,Syrian Arab Rep.,SYR,Netherlands,NLD,53,5,58,19,135
2020,United Rep. of Tanzania,TZA,Netherlands,NLD,0,0,5,0,5
2020,Tunisia,TUN,Netherlands,NLD,0,0,0,13,13
2020,Turkey,TUR,Netherlands,NLD,0,0,14,5,19
2020,Uganda,UGA,Netherlands,NLD,0,0,11,0,11
2020,Ukraine,UKR,Netherlands,NLD,0,0,10,0,10
2020,Uzbekistan,UZB,Netherlands,NLD,0,0,0,5,5
2020,Venezuela (Bolivarian Republic of),VEN,Netherlands,NLD,0,0,11,5,16
2020,Yemen,YEM,Netherlands,NLD,0,0,5,5,10
2020,Zimbabwe,ZWE,Netherlands,NLD,5,0,0,0,5
2020,Stateless,XXA,Netherlands,NLD,5,0,15,5,25
2020,Unknown ,,Netherlands,NLD,0,0,14,5,19
2020,Afghanistan,AFG,Norway,NOR,0,14,0,0,14
2020,China,CHN,Norway,NOR,0,0,0,5,5
2020,Colombia,COL,Norway,NOR,0,0,5,0,5
2020,Eritrea,ERI,Norway,NOR,10,0,0,5,15
2020,Iran (Islamic Rep. of),IRN,Norway,NOR,0,0,5,5,10
2020,Iraq,IRQ,Norway,NOR,5,0,5,0,10
2020,Russian Federation,RUS,Norway,NOR,0,0,0,5,5
2020,Somalia,SOM,Norway,NOR,5,0,0,5,10
2020,Syrian Arab Rep.,SYR,Norway,NOR,12,5,0,0,17
2020,Afghanistan,AFG,Sweden,SWE,30,10,123,34,197
2020,Albania,ALB,Sweden,SWE,0,0,38,5,43
2020,Algeria,DZA,Sweden,SWE,0,0,5,17,22
2020,Angola,AGO,Sweden,SWE,0,0,5,0,5
2020,Egypt,EGY,Sweden,SWE,0,5,39,23,67
2020,Armenia,ARM,Sweden,SWE,5,0,73,5,83
2020,Azerbaijan,AZE,Sweden,SWE,0,0,55,14,69
2020,Burundi,BDI,Sweden,SWE,0,0,5,0,5
2020,Bangladesh,BGD,Sweden,SWE,0,0,30,5,35
2020,Burkina Faso,BFA,Sweden,SWE,0,0,0,5,5
2020,Belarus,BLR,Sweden,SWE,0,0,13,13,26
2020,Bolivia (Plurinational State of),BOL,Sweden,SWE,0,0,5,0,5
2020,Brazil,BRA,Sweden,SWE,0,0,0,5,5
2020,Bosnia and Herzegovina,BIH,Sweden,SWE,0,0,16,5,21
2020,Cameroon,CMR,Sweden,SWE,0,0,0,13,13
2020,Dem. Rep. of the Congo,COD,Sweden,SWE,0,5,20,5,30
2020,Colombia,COL,Sweden,SWE,0,0,5,5,10
2020,Cuba,CUB,Sweden,SWE,5,0,12,5,22
2020,Djibouti,DJI,Sweden,SWE,0,0,12,0,12
2020,Equatorial Guinea,GNQ,Sweden,SWE,0,0,5,0,5
2020,Eritrea,ERI,Sweden,SWE,36,5,13,32,86
2020,Ethiopia,ETH,Sweden,SWE,0,5,121,19,145
2020,Gambia,GMB,Sweden,SWE,0,0,12,5,17
2020,Palestinian,PSE,Sweden,SWE,5,0,107,34,146
2020,Georgia,GEO,Sweden,SWE,0,5,25,13,43
2020,Ghana,GHA,Sweden,SWE,0,0,19,0,19
2020,Guinea,GIN,Sweden,SWE,0,0,0,5,5
2020,Cote d'Ivoire,CIV,Sweden,SWE,0,0,5,0,5
2020,India,IND,Sweden,SWE,0,0,10,5,15
2020,Iran (Islamic Rep. of),IRN,Sweden,SWE,27,0,102,62,191
2020,Iraq,IRQ,Sweden,SWE,29,5,245,64,343
2020,Israel,ISR,Sweden,SWE,0,0,10,0,10
2020,Jordan,JOR,Sweden,SWE,0,0,29,0,29
2020,Japan,JPN,Sweden,SWE,0,0,0,5,5
2020,Kazakhstan,KAZ,Sweden,SWE,5,0,55,10,70
2020,Kenya,KEN,Sweden,SWE,0,0,12,0,12
2020,Kyrgyzstan,KGZ,Sweden,SWE,0,5,17,11,33
2020,Liberia,LBR,Sweden,SWE,0,0,0,5,5
2020,Libya,LBY,Sweden,SWE,0,0,13,13,26
2020,Lebanon,LBN,Sweden,SWE,0,0,83,5,88
2020,Sri Lanka,LKA,Sweden,SWE,0,0,0,5,5
2020,North Macedonia,MKD,Sweden,SWE,0,0,5,0,5
2020,Mali,MLI,Sweden,SWE,0,0,5,0,5
2020,Mongolia,MNG,Sweden,SWE,0,0,70,15,85
2020,Morocco,MAR,Sweden,SWE,0,0,26,32,58
2020,Nicaragua,NIC,Sweden,SWE,0,0,10,0,10
2020,Nigeria,NGA,Sweden,SWE,10,0,65,20,95
2020,Pakistan,PAK,Sweden,SWE,0,5,24,5,34
2020,Peru,PER,Sweden,SWE,0,0,5,0,5
2020,South Africa,ZAF,Sweden,SWE,0,0,0,5,5
2020,Russian Federation,RUS,Sweden,SWE,5,0,94,30,129
2020,Rwanda,RWA,Sweden,SWE,0,0,5,0,5
2020,El Salvador,SLV,Sweden,SWE,0,0,12,5,17
2020,Serbia and Kosovo: S/RES/1244 (1999),SRB,Sweden,SWE,0,0,47,5,52
2020,Senegal,SEN,Sweden,SWE,0,0,0,5,5
2020,Sierra Leone,SLE,Sweden,SWE,0,0,5,0,5
2020,Somalia,SOM,Sweden,SWE,24,15,187,80,306
2020,Viet Nam,VNM,Sweden,SWE,0,0,5,0,5
2020,Sudan,SDN,Sweden,SWE,0,0,13,0,13
2020,Syrian Arab Rep.,SYR,Sweden,SWE,23,74,50,111,258
2020,United Rep. of Tanzania,TZA,Sweden,SWE,0,0,11,0,11
2020,Thailand,THA,Sweden,SWE,0,0,5,0,5
2020,Tajikistan,TJK,Sweden,SWE,0,0,11,0,11
2020,Tunisia,TUN,Sweden,SWE,0,0,17,0,17
2020,Turkey,TUR,Sweden,SWE,0,0,32,10,42
2020,Uganda,UGA,Sweden,SWE,5,0,17,5,27
2020,Ukraine,UKR,Sweden,SWE,0,5,31,11,47
2020,United States of America,USA,Sweden,SWE,0,0,5,0,5
2020,Uzbekistan,UZB,Sweden,SWE,0,5,125,32,162
2020,Venezuela (Bolivarian Republic of),VEN,Sweden,SWE,0,0,5,0,5
2020,Yemen,YEM,Sweden,SWE,0,13,0,5,18
2020,Stateless,XXA,Sweden,SWE,12,14,114,54,194
2020,Unknown ,,Sweden,SWE,0,0,57,19,76
2007,Unknown ,,Belgium,BEL,0,116,13,56,185
2008,Unknown ,,Belgium,BEL,0,10,5,25,40
2010,Afghanistan,AFG,Ireland,IRL,0,0,10,0,10
2010,Albania,ALB,Ireland,IRL,0,0,10,0,10
2010,Angola,AGO,Ireland,IRL,0,0,5,0,5
2010,Burundi,BDI,Ireland,IRL,0,0,5,0,5
2010,Benin,BEN,Ireland,IRL,0,0,5,0,5
2010,Bangladesh,BGD,Ireland,IRL,0,0,5,0,5
2010,Cameroon,CMR,Ireland,IRL,0,0,43,0,43
2010,Dem. Rep. of the Congo,COD,Ireland,IRL,0,0,14,0,14
2010,Georgia,GEO,Ireland,IRL,0,0,70,0,70
2010,Ghana,GHA,Ireland,IRL,0,0,18,0,18
2010,Cote d'Ivoire,CIV,Ireland,IRL,0,0,5,0,5
2010,Iraq,IRQ,Ireland,IRL,0,0,5,0,5
2010,Kenya,KEN,Ireland,IRL,0,0,16,0,16
2010,Liberia,LBR,Ireland,IRL,0,0,15,0,15
2010,Rep. of Moldova,MDA,Ireland,IRL,0,0,26,0,26
2010,Morocco,MAR,Ireland,IRL,0,0,5,0,5
2010,Niger,NER,Ireland,IRL,0,0,5,0,5
2010,Nigeria,NGA,Ireland,IRL,0,0,191,0,191
2010,Pakistan,PAK,Ireland,IRL,0,0,16,0,16
2010,South Africa,ZAF,Ireland,IRL,0,0,21,0,21
2010,Rwanda,RWA,Ireland,IRL,0,0,10,0,10
2010,Sierra Leone,SLE,Ireland,IRL,0,0,5,0,5
2010,Somalia,SOM,Ireland,IRL,0,0,12,0,12
2010,Viet Nam,VNM,Ireland,IRL,0,0,5,0,5
2010,Zimbabwe,ZWE,Ireland,IRL,0,0,5,0,5
2011,Afghanistan,AFG,Ireland,IRL,0,0,10,0,10
2011,Albania,ALB,Ireland,IRL,0,0,27,0,27
2011,Algeria,DZA,Ireland,IRL,0,0,12,0,12
2011,Angola,AGO,Ireland,IRL,0,0,17,0,17
2011,Armenia,ARM,Ireland,IRL,0,0,5,0,5
2011,Burundi,BDI,Ireland,IRL,0,0,13,0,13
2011,Bangladesh,BGD,Ireland,IRL,0,0,30,0,30
2011,Cameroon,CMR,Ireland,IRL,0,0,27,0,27
2011,Congo,COG,Ireland,IRL,0,0,11,0,11
2011,Dem. Rep. of the Congo,COD,Ireland,IRL,0,0,153,0,153
2011,Ethiopia,ETH,Ireland,IRL,0,0,5,0,5
2011,Palestinian,PSE,Ireland,IRL,0,5,0,0,5
2011,Georgia,GEO,Ireland,IRL,0,0,30,0,30
2011,Ghana,GHA,Ireland,IRL,0,0,50,0,50
2011,Guinea,GIN,Ireland,IRL,0,0,10,0,10
2011,Croatia,HRV,Ireland,IRL,0,0,5,0,5
2011,India,IND,Ireland,IRL,0,0,5,0,5
2011,Iran (Islamic Rep. of),IRN,Ireland,IRL,0,0,10,0,10
2011,Iraq,IRQ,Ireland,IRL,0,0,5,0,5
2011,Israel,ISR,Ireland,IRL,0,0,5,0,5
2011,Kenya,KEN,Ireland,IRL,0,0,10,0,10
2011,Liberia,LBR,Ireland,IRL,0,0,5,0,5
2011,Lebanon,LBN,Ireland,IRL,0,0,5,0,5
2011,Rep. of Moldova,MDA,Ireland,IRL,0,0,5,0,5
2011,Malawi,MWI,Ireland,IRL,0,0,5,0,5
2011,Nigeria,NGA,Ireland,IRL,0,0,230,0,230
2011,Pakistan,PAK,Ireland,IRL,0,0,70,0,70
2011,South Africa,ZAF,Ireland,IRL,0,0,12,0,12
2011,Rwanda,RWA,Ireland,IRL,0,0,5,0,5
2011,Sierra Leone,SLE,Ireland,IRL,0,0,17,0,17
2011,Somalia,SOM,Ireland,IRL,0,0,27,0,27
2011,Sudan,SDN,Ireland,IRL,0,0,10,0,10
2011,Togo,TGO,Ireland,IRL,0,0,5,0,5
2011,Uganda,UGA,Ireland,IRL,0,0,16,0,16
2011,Zimbabwe,ZWE,Ireland,IRL,0,0,5,0,5
2012,Afghanistan,AFG,Ireland,IRL,0,0,10,0,10
2012,Algeria,DZA,Ireland,IRL,0,0,5,0,5
2012,Angola,AGO,Ireland,IRL,0,0,10,0,10
2012,Bangladesh,BGD,Ireland,IRL,0,0,5,0,5
2012,Bhutan,BTN,Ireland,IRL,0,0,5,0,5
2012,China,CHN,Ireland,IRL,0,0,5,0,5
2012,Cameroon,CMR,Ireland,IRL,0,0,14,0,14
2012,Dem. Rep. of the Congo,COD,Ireland,IRL,0,0,5,0,5
2012,Georgia,GEO,Ireland,IRL,0,0,17,0,17
2012,Ghana,GHA,Ireland,IRL,0,0,43,0,43
2012,Israel,ISR,Ireland,IRL,0,0,5,0,5
2012,Kenya,KEN,Ireland,IRL,0,0,10,0,10
2012,Liberia,LBR,Ireland,IRL,0,0,5,0,5
2012,Rep. of Moldova,MDA,Ireland,IRL,0,0,5,0,5
2012,Nigeria,NGA,Ireland,IRL,0,0,69,0,69
2012,Pakistan,PAK,Ireland,IRL,0,11,93,0,104
2012,Rwanda,RWA,Ireland,IRL,0,0,5,0,5
2012,Serbia and Kosovo: S/RES/1244 (1999),SRB,Ireland,IRL,0,0,5,0,5
2012,Sierra Leone,SLE,Ireland,IRL,0,0,5,0,5
2012,Somalia,SOM,Ireland,IRL,0,10,17,0,27
2012,Sudan,SDN,Ireland,IRL,0,0,5,0,5
2012,Togo,TGO,Ireland,IRL,0,0,5,0,5
2012,Uganda,UGA,Ireland,IRL,0,0,5,0,5
2012,Zimbabwe,ZWE,Ireland,IRL,0,0,13,0,13
2013,Afghanistan,AFG,Ireland,IRL,0,0,41,0,41
2013,Albania,ALB,Ireland,IRL,0,0,5,0,5
2013,Algeria,DZA,Ireland,IRL,0,0,10,0,10
2013,Angola,AGO,Ireland,IRL,0,0,13,0,13
2013,Armenia,ARM,Ireland,IRL,0,5,0,0,5
2013,Benin,BEN,Ireland,IRL,0,0,5,0,5
2013,Bangladesh,BGD,Ireland,IRL,0,0,5,0,5
2013,Bhutan,BTN,Ireland,IRL,0,0,5,0,5
2013,Belarus,BLR,Ireland,IRL,0,0,5,0,5
2013,Brazil,BRA,Ireland,IRL,0,0,5,0,5
2013,China,CHN,Ireland,IRL,0,0,5,0,5
2013,Cameroon,CMR,Ireland,IRL,0,0,18,5,23
2013,Congo,COG,Ireland,IRL,0,0,10,0,10
2013,Dem. Rep. of the Congo,COD,Ireland,IRL,0,0,43,0,43
2013,Eritrea,ERI,Ireland,IRL,0,0,5,0,5
2013,Ethiopia,ETH,Ireland,IRL,0,0,5,0,5
2013,Georgia,GEO,Ireland,IRL,0,0,10,5,15
2013,Ghana,GHA,Ireland,IRL,0,0,31,5,36
2013,Guinea,GIN,Ireland,IRL,0,0,5,0,5
2013,Croatia,HRV,Ireland,IRL,0,0,5,0,5
2013,Cote d'Ivoire,CIV,Ireland,IRL,0,0,5,0,5
2013,India,IND,Ireland,IRL,0,0,5,0,5
2013,Iran (Islamic Rep. of),IRN,Ireland,IRL,0,0,5,10,15
2013,Iraq,IRQ,Ireland,IRL,0,0,18,10,28
2013,Israel,ISR,Ireland,IRL,0,0,0,5,5
2013,Kenya,KEN,Ireland,IRL,0,0,14,0,14
2013,Liberia,LBR,Ireland,IRL,0,0,11,0,11
2013,Lebanon,LBN,Ireland,IRL,0,0,10,0,10
2013,Rep. of Moldova,MDA,Ireland,IRL,0,0,20,0,20
2013,Malawi,MWI,Ireland,IRL,0,0,5,0,5
2013,Niger,NER,Ireland,IRL,0,0,5,0,5
2013,Nigeria,NGA,Ireland,IRL,0,0,72,34,106
2013,Pakistan,PAK,Ireland,IRL,0,5,26,5,36
2013,South Africa,ZAF,Ireland,IRL,0,0,5,0,5
2013,Serbia and Kosovo: S/RES/1244 (1999),SRB,Ireland,IRL,0,0,19,0,19
2013,Sierra Leone,SLE,Ireland,IRL,0,0,5,0,5
2013,Somalia,SOM,Ireland,IRL,0,5,10,5,20
2013,Sudan,SDN,Ireland,IRL,0,0,21,0,21
2013,Syrian Arab Rep.,SYR,Ireland,IRL,0,5,0,0,5
2013,Togo,TGO,Ireland,IRL,0,0,10,0,10
2013,Uganda,UGA,Ireland,IRL,0,0,11,0,11
2013,Ukraine,UKR,Ireland,IRL,0,0,5,0,5
2013,Venezuela (Bolivarian Republic of),VEN,Ireland,IRL,0,0,5,0,5
2013,Zimbabwe,ZWE,Ireland,IRL,0,0,47,0,47
2014,Afghanistan,AFG,Ireland,IRL,42,0,32,35,109
2014,Albania,ALB,Ireland,IRL,0,0,10,28,38
2014,Algeria,DZA,Ireland,IRL,0,0,23,50,73
2014,Angola,AGO,Ireland,IRL,0,0,5,15,20
2014,Egypt,EGY,Ireland,IRL,0,0,5,5,10
2014,Armenia,ARM,Ireland,IRL,0,0,5,5,10
2014,Benin,BEN,Ireland,IRL,0,0,10,5,15
2014,Bangladesh,BGD,Ireland,IRL,0,0,21,24,45
2014,Bhutan,BTN,Ireland,IRL,5,0,5,20,30
2014,Belarus,BLR,Ireland,IRL,0,0,0,5,5
2014,Bolivia (Plurinational State of),BOL,Ireland,IRL,5,0,0,0,5
2014,Botswana,BWA,Ireland,IRL,0,0,0,5,5
2014,Brazil,BRA,Ireland,IRL,0,0,0,5,5
2014,China,CHN,Ireland,IRL,0,0,11,42,53
2014,Cameroon,CMR,Ireland,IRL,5,0,25,45,75
2014,Congo,COG,Ireland,IRL,0,0,10,14,24
2014,Dem. Rep. of the Congo,COD,Ireland,IRL,22,0,36,74,132
2014,Cabo Verde,CPV,Ireland,IRL,0,0,5,0,5
2014,Eritrea,ERI,Ireland,IRL,10,0,13,10,33
2014,Ethiopia,ETH,Ireland,IRL,5,0,5,10,20
2014,Palestinian,PSE,Ireland,IRL,10,0,0,5,15
2014,Georgia,GEO,Ireland,IRL,5,0,27,82,114
2014,Ghana,GHA,Ireland,IRL,0,0,22,57,79
2014,Guinea,GIN,Ireland,IRL,0,0,5,16,21
2014,Guyana,GUY,Ireland,IRL,0,0,0,5,5
2014,Cote d'Ivoire,CIV,Ireland,IRL,0,0,5,11,16
2014,India,IND,Ireland,IRL,0,0,0,16,16
2014,Iran (Islamic Rep. of),IRN,Ireland,IRL,12,0,10,27,49
2014,Iraq,IRQ,Ireland,IRL,33,0,5,32,70
2014,Israel,ISR,Ireland,IRL,0,0,5,0,5
2014,Kenya,KEN,Ireland,IRL,0,0,10,21,31
2014,Kuwait,KWT,Ireland,IRL,5,0,0,5,10
2014,Liberia,LBR,Ireland,IRL,0,0,5,18,23
2014,Libya,LBY,Ireland,IRL,0,0,0,5,5
2014,Sri Lanka,LKA,Ireland,IRL,0,0,0,5,5
2014,Rep. of Moldova,MDA,Ireland,IRL,0,0,5,36,41
2014,Malawi,MWI,Ireland,IRL,0,0,10,10,20
2014,Mongolia,MNG,Ireland,IRL,0,0,0,5,5
2014,Morocco,MAR,Ireland,IRL,0,0,10,5,15
2014,Mauritius,MUS,Ireland,IRL,0,0,10,5,15
2014,Myanmar,MMR,Ireland,IRL,5,0,0,0,5
2014,Nepal,NPL,Ireland,IRL,0,0,5,16,21
2014,Niger,NER,Ireland,IRL,0,0,5,0,5
2014,Nigeria,NGA,Ireland,IRL,5,0,66,267,338
2014,Pakistan,PAK,Ireland,IRL,18,0,43,109,170
2014,South Africa,ZAF,Ireland,IRL,0,0,14,17,31
2014,Russian Federation,RUS,Ireland,IRL,5,0,5,20,30
2014,Rwanda,RWA,Ireland,IRL,0,0,0,5,5
2014,Serbia and Kosovo: S/RES/1244 (1999),SRB,Ireland,IRL,0,0,5,26,31
2014,Sierra Leone,SLE,Ireland,IRL,0,0,5,17,22
2014,Somalia,SOM,Ireland,IRL,26,0,5,36,67
2014,Sudan,SDN,Ireland,IRL,29,0,10,62,101
2014,Eswatini,SWZ,Ireland,IRL,0,0,0,5,5
2014,Syrian Arab Rep.,SYR,Ireland,IRL,5,0,0,0,5
2014,Togo,TGO,Ireland,IRL,0,0,5,11,16
2014,Turkey,TUR,Ireland,IRL,0,0,0,5,5
2014,Uganda,UGA,Ireland,IRL,5,0,15,19,39
2014,Ukraine,UKR,Ireland,IRL,0,0,10,16,26
2014,Zimbabwe,ZWE,Ireland,IRL,13,0,48,49,110
2015,Afghanistan,AFG,Ireland,IRL,38,0,15,16,69
2015,Albania,ALB,Ireland,IRL,0,0,55,17,72
2015,Algeria,DZA,Ireland,IRL,5,0,38,36,79
2015,Angola,AGO,Ireland,IRL,5,0,5,0,10
2015,Egypt,EGY,Ireland,IRL,0,0,10,0,10
2015,Armenia,ARM,Ireland,IRL,0,0,5,0,5
2015,Benin,BEN,Ireland,IRL,0,0,0,5,5
2015,Bangladesh,BGD,Ireland,IRL,0,0,25,22,47
2015,Bhutan,BTN,Ireland,IRL,0,0,5,10,15
2015,Belarus,BLR,Ireland,IRL,0,0,0,5,5
2015,Bolivia (Plurinational State of),BOL,Ireland,IRL,0,0,5,0,5
2015,Brazil,BRA,Ireland,IRL,0,0,5,5,10
2015,China,CHN,Ireland,IRL,0,0,14,11,25
2015,Cameroon,CMR,Ireland,IRL,0,0,19,15,34
2015,Congo,COG,Ireland,IRL,5,0,5,15,25
2015,Dem. Rep. of the Congo,COD,Ireland,IRL,21,0,68,24,113
2015,Cabo Verde,CPV,Ireland,IRL,0,0,0,5,5
2015,Eritrea,ERI,Ireland,IRL,5,0,0,5,10
2015,Ethiopia,ETH,Ireland,IRL,0,0,5,5,10
2015,Georgia,GEO,Ireland,IRL,0,0,15,29,44
2015,Ghana,GHA,Ireland,IRL,0,0,18,15,33
2015,Guinea,GIN,Ireland,IRL,0,0,5,5,10
2015,Guyana,GUY,Ireland,IRL,0,0,0,5,5
2015,Cote d'Ivoire,CIV,Ireland,IRL,0,0,5,5,10
2015,India,IND,Ireland,IRL,0,0,5,5,10
2015,Iran (Islamic Rep. of),IRN,Ireland,IRL,12,0,5,10,27
2015,Iraq,IRQ,Ireland,IRL,14,0,0,13,27
2015,Kenya,KEN,Ireland,IRL,0,0,0,5,5
2015,Kuwait,KWT,Ireland,IRL,0,0,0,5,5
2015,Liberia,LBR,Ireland,IRL,0,0,5,5,10
2015,Libya,LBY,Ireland,IRL,5,0,0,0,5
2015,Lesotho,LSO,Ireland,IRL,0,0,5,0,5
2015,Sri Lanka,LKA,Ireland,IRL,0,0,5,5,10
2015,Rep. of Moldova,MDA,Ireland,IRL,0,0,5,19,24
2015,Malawi,MWI,Ireland,IRL,0,0,28,15,43
2015,Mauritius,MUS,Ireland,IRL,0,0,10,10,20
2015,Nepal,NPL,Ireland,IRL,0,0,10,5,15
2015,Niger,NER,Ireland,IRL,0,0,5,5,10
2015,Nigeria,NGA,Ireland,IRL,0,0,111,171,282
2015,Pakistan,PAK,Ireland,IRL,16,0,72,74,162
2015,Philippines,PHL,Ireland,IRL,0,0,5,0,5
2015,South Africa,ZAF,Ireland,IRL,5,0,18,13,36
2015,Russian Federation,RUS,Ireland,IRL,0,0,0,5,5
2015,Rwanda,RWA,Ireland,IRL,0,0,5,0,5
2015,Serbia and Kosovo: S/RES/1244 (1999),SRB,Ireland,IRL,0,0,5,5,10
2015,Sierra Leone,SLE,Ireland,IRL,0,0,10,10,20
2015,Somalia,SOM,Ireland,IRL,13,0,10,16,39
2015,Viet Nam,VNM,Ireland,IRL,0,0,5,5,10
2015,Sudan,SDN,Ireland,IRL,5,0,10,15,30
2015,Syrian Arab Rep.,SYR,Ireland,IRL,5,0,0,0,5
2015,Togo,TGO,Ireland,IRL,0,0,5,0,5
2015,Uganda,UGA,Ireland,IRL,10,0,5,5,20
2015,Ukraine,UKR,Ireland,IRL,0,0,12,5,17
2015,Zimbabwe,ZWE,Ireland,IRL,10,0,71,41,122
2016,Afghanistan,AFG,Ireland,IRL,19,0,5,10,34
2016,Albania,ALB,Ireland,IRL,0,0,44,11,55
2016,Algeria,DZA,Ireland,IRL,5,0,33,20,58
2016,Angola,AGO,Ireland,IRL,0,0,0,5,5
2016,Egypt,EGY,Ireland,IRL,0,0,5,10,15
2016,Armenia,ARM,Ireland,IRL,5,0,5,0,10
2016,Bangladesh,BGD,Ireland,IRL,5,0,16,10,31
2016,Bhutan,BTN,Ireland,IRL,0,0,5,0,5
2016,Belarus,BLR,Ireland,IRL,0,0,0,5,5
2016,Cameroon,CMR,Ireland,IRL,0,0,5,5,10
2016,Congo,COG,Ireland,IRL,0,0,0,5,5
2016,Dem. Rep. of the Congo,COD,Ireland,IRL,10,0,26,26,62
2016,Ethiopia,ETH,Ireland,IRL,5,0,0,5,10
2016,Palestinian,PSE,Ireland,IRL,0,0,0,5,5
2016,Georgia,GEO,Ireland,IRL,5,0,0,19,24
2016,Ghana,GHA,Ireland,IRL,5,0,5,5,15
2016,"China, Hong Kong SAR",HKG,Ireland,IRL,0,0,15,5,20
2016,Cote d'Ivoire,CIV,Ireland,IRL,0,0,5,0,5
2016,India,IND,Ireland,IRL,0,0,5,5,10
2016,Iran (Islamic Rep. of),IRN,Ireland,IRL,0,0,0,10,10
2016,Iraq,IRQ,Ireland,IRL,0,0,0,10,10
2016,Israel,ISR,Ireland,IRL,5,0,0,0,5
2016,Kenya,KEN,Ireland,IRL,0,0,5,0,5
2016,Sri Lanka,LKA,Ireland,IRL,5,0,0,0,5
2016,Rep. of Moldova,MDA,Ireland,IRL,0,0,0,13,13
2016,Malawi,MWI,Ireland,IRL,0,0,26,0,26
2016,Mauritius,MUS,Ireland,IRL,0,0,5,10,15
2016,Nepal,NPL,Ireland,IRL,0,0,5,5,10
2016,Nigeria,NGA,Ireland,IRL,10,0,59,94,163
2016,Pakistan,PAK,Ireland,IRL,16,0,86,66,168
2016,South Africa,ZAF,Ireland,IRL,0,0,20,10,30
2016,Rwanda,RWA,Ireland,IRL,0,0,5,5,10
2016,Serbia and Kosovo: S/RES/1244 (1999),SRB,Ireland,IRL,0,0,0,5,5
2016,Sierra Leone,SLE,Ireland,IRL,0,0,10,5,15
2016,Somalia,SOM,Ireland,IRL,0,0,0,5,5
2016,Sudan,SDN,Ireland,IRL,0,0,0,21,21
2016,Uganda,UGA,Ireland,IRL,5,0,0,5,10
2016,Ukraine,UKR,Ireland,IRL,5,0,5,5,15
2016,Venezuela (Bolivarian Republic of),VEN,Ireland,IRL,0,0,5,0,5
2016,Zimbabwe,ZWE,Ireland,IRL,22,0,43,17,82
2020,Algeria,DZA,Ireland,IRL,0,0,5,0,5
2020,Pakistan,PAK,Ireland,IRL,0,0,5,0,5
2010,Afghanistan,AFG,Russian Federation,RUS,0,392,398,0,790
2010,Angola,AGO,Russian Federation,RUS,0,5,0,0,5
2010,Azerbaijan,AZE,Russian Federation,RUS,0,0,5,0,5
2010,Eritrea,ERI,Russian Federation,RUS,0,0,5,0,5
2010,Palestinian,PSE,Russian Federation,RUS,0,5,5,0,10
2010,Georgia,GEO,Russian Federation,RUS,0,525,362,0,887
2010,Guinea,GIN,Russian Federation,RUS,0,0,5,0,5
2010,India,IND,Russian Federation,RUS,0,5,0,0,5
2010,Iraq,IRQ,Russian Federation,RUS,0,5,10,0,15
2010,Kyrgyzstan,KGZ,Russian Federation,RUS,0,0,32,0,32
2010,Dem. People's Rep. of Korea,PRK,Russian Federation,RUS,0,5,20,0,25
2010,Pakistan,PAK,Russian Federation,RUS,0,0,5,0,5
2010,Somalia,SOM,Russian Federation,RUS,0,5,5,0,10
2010,Sudan,SDN,Russian Federation,RUS,0,5,5,0,10
2010,Syrian Arab Rep.,SYR,Russian Federation,RUS,0,0,5,0,5
2010,Tajikistan,TJK,Russian Federation,RUS,0,5,10,0,15
2010,Turkmenistan,TKM,Russian Federation,RUS,0,10,5,0,15
2010,Ukraine,UKR,Russian Federation,RUS,0,10,0,0,10
2010,Uzbekistan,UZB,Russian Federation,RUS,0,52,40,0,92
2010,Unknown ,,Russian Federation,RUS,0,0,17,0,17
2011,Afghanistan,AFG,Russian Federation,RUS,277,0,0,184,461
2011,Angola,AGO,Russian Federation,RUS,5,0,0,5,10
2011,Armenia,ARM,Russian Federation,RUS,0,0,0,5,5
2011,Azerbaijan,AZE,Russian Federation,RUS,5,0,0,5,10
2011,Cambodia,KHM,Russian Federation,RUS,0,0,0,5,5
2011,Congo,COG,Russian Federation,RUS,0,0,0,5,5
2011,Dem. Rep. of the Congo,COD,Russian Federation,RUS,5,0,0,5,10
2011,Cuba,CUB,Russian Federation,RUS,0,0,0,5,5
2011,Ethiopia,ETH,Russian Federation,RUS,0,0,0,5,5
2011,Georgia,GEO,Russian Federation,RUS,286,0,0,95,381
2011,Cote d'Ivoire,CIV,Russian Federation,RUS,5,0,0,5,10
2011,Iraq,IRQ,Russian Federation,RUS,0,0,0,5,5
2011,Kyrgyzstan,KGZ,Russian Federation,RUS,20,0,0,20,40
2011,Dem. People's Rep. of Korea,PRK,Russian Federation,RUS,13,0,0,24,37
2011,Somalia,SOM,Russian Federation,RUS,0,0,0,5,5
2011,Sudan,SDN,Russian Federation,RUS,0,0,0,5,5
2011,Syrian Arab Rep.,SYR,Russian Federation,RUS,0,0,0,10,10
2011,Tajikistan,TJK,Russian Federation,RUS,0,0,0,15,15
2011,Ukraine,UKR,Russian Federation,RUS,0,0,0,5,5
2011,Uzbekistan,UZB,Russian Federation,RUS,23,0,0,21,44
2011,Unknown ,,Russian Federation,RUS,0,0,0,5,5
2012,Afghanistan,AFG,Russian Federation,RUS,229,0,258,0,487
2012,Angola,AGO,Russian Federation,RUS,0,0,5,0,5
2012,Egypt,EGY,Russian Federation,RUS,0,0,5,0,5
2012,Belarus,BLR,Russian Federation,RUS,0,0,5,0,5
2012,China,CHN,Russian Federation,RUS,5,0,5,0,10
2012,Dem. Rep. of the Congo,COD,Russian Federation,RUS,5,0,5,0,10
2012,Georgia,GEO,Russian Federation,RUS,176,0,37,0,213
2012,Guinea,GIN,Russian Federation,RUS,0,0,5,0,5
2012,Iran (Islamic Rep. of),IRN,Russian Federation,RUS,0,0,5,0,5
2012,Kazakhstan,KAZ,Russian Federation,RUS,5,0,10,0,15
2012,Kyrgyzstan,KGZ,Russian Federation,RUS,21,0,5,0,26
2012,Dem. People's Rep. of Korea,PRK,Russian Federation,RUS,47,0,17,0,64
2012,Rep. of Moldova,MDA,Russian Federation,RUS,0,0,5,0,5
2012,Nigeria,NGA,Russian Federation,RUS,5,0,0,0,5
2012,Sudan,SDN,Russian Federation,RUS,0,0,5,0,5
2012,Syrian Arab Rep.,SYR,Russian Federation,RUS,49,0,46,0,95
2012,Tajikistan,TJK,Russian Federation,RUS,14,0,10,0,24
2012,Turkmenistan,TKM,Russian Federation,RUS,10,0,5,0,15
2012,Ukraine,UKR,Russian Federation,RUS,0,0,5,0,5
2012,Uzbekistan,UZB,Russian Federation,RUS,49,0,18,0,67
2012,Unknown ,,Russian Federation,RUS,31,0,0,0,31
2013,Afghanistan,AFG,Russian Federation,RUS,0,222,241,94,557
2013,Egypt,EGY,Russian Federation,RUS,0,5,5,10,20
2013,Cambodia,KHM,Russian Federation,RUS,0,0,0,5,5
2013,China,CHN,Russian Federation,RUS,0,5,0,0,5
2013,Georgia,GEO,Russian Federation,RUS,0,104,29,38,171
2013,Iran (Islamic Rep. of),IRN,Russian Federation,RUS,0,0,0,5,5
2013,Iraq,IRQ,Russian Federation,RUS,0,5,0,10,15
2013,Kazakhstan,KAZ,Russian Federation,RUS,0,0,0,5,5
2013,Kyrgyzstan,KGZ,Russian Federation,RUS,0,5,11,0,16
2013,Dem. People's Rep. of Korea,PRK,Russian Federation,RUS,0,20,5,5,30
2013,Rep. of Moldova,MDA,Russian Federation,RUS,0,0,0,5,5
2013,Pakistan,PAK,Russian Federation,RUS,0,5,0,0,5
2013,Syrian Arab Rep.,SYR,Russian Federation,RUS,0,1191,55,71,1317
2013,Ukraine,UKR,Russian Federation,RUS,0,0,5,0,5
2013,Uzbekistan,UZB,Russian Federation,RUS,0,39,5,5,49
2013,Unknown ,,Russian Federation,RUS,0,37,36,0,73
2014,Afghanistan,AFG,Russian Federation,RUS,0,248,167,0,415
2014,Egypt,EGY,Russian Federation,RUS,0,12,24,0,36
2014,Armenia,ARM,Russian Federation,RUS,0,0,13,0,13
2014,Bangladesh,BGD,Russian Federation,RUS,0,5,0,0,5
2014,China,CHN,Russian Federation,RUS,0,0,5,0,5
2014,Congo,COG,Russian Federation,RUS,0,5,5,0,10
2014,Ethiopia,ETH,Russian Federation,RUS,0,0,5,0,5
2014,Palestinian,PSE,Russian Federation,RUS,0,5,5,0,10
2014,Georgia,GEO,Russian Federation,RUS,0,103,34,0,137
2014,Cote d'Ivoire,CIV,Russian Federation,RUS,0,0,5,0,5
2014,Iraq,IRQ,Russian Federation,RUS,0,5,10,0,15
2014,Jordan,JOR,Russian Federation,RUS,0,5,0,0,5
2014,Kazakhstan,KAZ,Russian Federation,RUS,0,0,5,0,5
2014,Kyrgyzstan,KGZ,Russian Federation,RUS,0,17,10,0,27
2014,Dem. People's Rep. of Korea,PRK,Russian Federation,RUS,0,26,5,0,31
2014,Rep. of Moldova,MDA,Russian Federation,RUS,0,5,10,0,15
2014,Viet Nam,VNM,Russian Federation,RUS,0,0,5,0,5
2014,Sudan,SDN,Russian Federation,RUS,0,0,10,0,10
2014,Syrian Arab Rep.,SYR,Russian Federation,RUS,0,1369,384,0,1753
2014,Tajikistan,TJK,Russian Federation,RUS,0,5,5,0,10
2014,Turkmenistan,TKM,Russian Federation,RUS,0,5,5,0,10
2014,Ukraine,UKR,Russian Federation,RUS,0,248201,0,16687,264888
2014,Uzbekistan,UZB,Russian Federation,RUS,0,24,41,0,65
2014,Unknown ,,Russian Federation,RUS,0,5,18,0,23
2015,Afghanistan,AFG,Russian Federation,RUS,0,220,269,0,489
2015,Egypt,EGY,Russian Federation,RUS,0,0,14,0,14
2015,Armenia,ARM,Russian Federation,RUS,0,0,5,0,5
2015,Azerbaijan,AZE,Russian Federation,RUS,0,10,5,0,15
2015,Bangladesh,BGD,Russian Federation,RUS,0,0,5,0,5
2015,Belarus,BLR,Russian Federation,RUS,0,0,14,0,14
2015,Central African Rep.,CAF,Russian Federation,RUS,0,0,5,0,5
2015,China,CHN,Russian Federation,RUS,0,0,5,0,5
2015,Congo,COG,Russian Federation,RUS,0,0,5,0,5
2015,Dem. Rep. of the Congo,COD,Russian Federation,RUS,0,0,5,0,5
2015,Palestinian,PSE,Russian Federation,RUS,0,10,5,0,15
2015,Georgia,GEO,Russian Federation,RUS,0,68,16,0,84
2015,Guinea,GIN,Russian Federation,RUS,0,0,5,0,5
2015,Cote d'Ivoire,CIV,Russian Federation,RUS,0,0,5,0,5
2015,Iran (Islamic Rep. of),IRN,Russian Federation,RUS,0,0,5,0,5
2015,Iraq,IRQ,Russian Federation,RUS,0,5,21,0,26
2015,Kazakhstan,KAZ,Russian Federation,RUS,0,5,5,0,10
2015,Kyrgyzstan,KGZ,Russian Federation,RUS,0,11,10,0,21
2015,Dem. People's Rep. of Korea,PRK,Russian Federation,RUS,0,31,5,0,36
2015,Latvia,LVA,Russian Federation,RUS,0,5,0,0,5
2015,Rep. of Moldova,MDA,Russian Federation,RUS,0,13,13,0,26
2015,Nepal,NPL,Russian Federation,RUS,0,0,5,0,5
2015,Nigeria,NGA,Russian Federation,RUS,0,5,0,0,5
2015,Pakistan,PAK,Russian Federation,RUS,0,0,5,0,5
2015,Sudan,SDN,Russian Federation,RUS,0,0,5,0,5
2015,Syrian Arab Rep.,SYR,Russian Federation,RUS,0,695,395,0,1090
2015,Tajikistan,TJK,Russian Federation,RUS,0,5,19,0,24
2015,Turkmenistan,TKM,Russian Federation,RUS,0,10,5,0,15
2015,Turkey,TUR,Russian Federation,RUS,0,0,5,0,5
2015,Ukraine,UKR,Russian Federation,RUS,0,148379,0,21,148400
2015,Uzbekistan,UZB,Russian Federation,RUS,0,22,40,0,62
2015,Yemen,YEM,Russian Federation,RUS,0,42,34,0,76
2015,Stateless,XXA,Russian Federation,RUS,0,5,5,0,10
2015,Unknown ,,Russian Federation,RUS,0,0,10,0,10
2016,Afghanistan,AFG,Russian Federation,RUS,0,151,0,0,151
2016,Egypt,EGY,Russian Federation,RUS,0,0,0,10,10
2016,Armenia,ARM,Russian Federation,RUS,0,0,0,5,5
2016,Azerbaijan,AZE,Russian Federation,RUS,0,0,0,12,12
2016,Bangladesh,BGD,Russian Federation,RUS,0,0,0,5,5
2016,Belarus,BLR,Russian Federation,RUS,0,0,0,19,19
2016,Cameroon,CMR,Russian Federation,RUS,0,0,0,5,5
2016,Congo,COG,Russian Federation,RUS,0,0,0,5,5
2016,Dem. Rep. of the Congo,COD,Russian Federation,RUS,0,0,0,15,15
2016,Palestinian,PSE,Russian Federation,RUS,0,5,0,10,15
2016,Georgia,GEO,Russian Federation,RUS,0,45,0,31,76
2016,Cote d'Ivoire,CIV,Russian Federation,RUS,0,5,0,0,5
2016,Iran (Islamic Rep. of),IRN,Russian Federation,RUS,0,14,0,0,14
2016,Iraq,IRQ,Russian Federation,RUS,0,0,0,16,16
2016,Kazakhstan,KAZ,Russian Federation,RUS,0,0,0,5,5
2016,Kyrgyzstan,KGZ,Russian Federation,RUS,0,5,0,10,15
2016,Dem. People's Rep. of Korea,PRK,Russian Federation,RUS,0,23,0,5,28
2016,Rep. of Moldova,MDA,Russian Federation,RUS,0,0,0,17,17
2016,Pakistan,PAK,Russian Federation,RUS,0,5,0,5,10
2016,Sudan,SDN,Russian Federation,RUS,0,0,0,10,10
2016,Syrian Arab Rep.,SYR,Russian Federation,RUS,0,542,0,369,911
2016,Tajikistan,TJK,Russian Federation,RUS,0,12,0,17,29
2016,Turkmenistan,TKM,Russian Federation,RUS,0,5,0,5,10
2016,Turkey,TUR,Russian Federation,RUS,0,0,0,5,5
2016,Ukraine,UKR,Russian Federation,RUS,0,21095,0,1018,22113
2016,United States of America,USA,Russian Federation,RUS,0,0,0,5,5
2016,Uzbekistan,UZB,Russian Federation,RUS,0,30,0,50,80
2016,Yemen,YEM,Russian Federation,RUS,0,25,0,37,62
2016,Stateless,XXA,Russian Federation,RUS,0,19,0,0,19
2016,Unknown ,,Russian Federation,RUS,0,5,0,5,10
2017,Afghanistan,AFG,Russian Federation,RUS,0,194,0,241,435
2017,Egypt,EGY,Russian Federation,RUS,0,0,0,5,5
2017,Armenia,ARM,Russian Federation,RUS,0,0,0,5,5
2017,Azerbaijan,AZE,Russian Federation,RUS,0,0,0,5,5
2017,Bangladesh,BGD,Russian Federation,RUS,0,0,0,5,5
2017,Belarus,BLR,Russian Federation,RUS,0,0,0,19,19
2017,Cameroon,CMR,Russian Federation,RUS,0,0,0,5,5
2017,Congo,COG,Russian Federation,RUS,0,0,0,5,5
2017,Dem. Rep. of the Congo,COD,Russian Federation,RUS,0,10,0,12,22
2017,Palestinian,PSE,Russian Federation,RUS,0,5,0,5,10
2017,Georgia,GEO,Russian Federation,RUS,0,34,0,14,48
2017,Germany,DEU,Russian Federation,RUS,0,10,0,5,15
2017,Iran (Islamic Rep. of),IRN,Russian Federation,RUS,0,0,0,5,5
2017,Iraq,IRQ,Russian Federation,RUS,0,15,0,16,31
2017,Kazakhstan,KAZ,Russian Federation,RUS,0,0,0,13,13
2017,Kyrgyzstan,KGZ,Russian Federation,RUS,0,0,0,12,12
2017,Dem. People's Rep. of Korea,PRK,Russian Federation,RUS,0,25,0,10,35
2017,Latvia,LVA,Russian Federation,RUS,0,0,0,5,5
2017,Rep. of Moldova,MDA,Russian Federation,RUS,0,0,0,13,13
2017,Pakistan,PAK,Russian Federation,RUS,0,0,0,5,5
2017,Sudan,SDN,Russian Federation,RUS,0,0,0,5,5
2017,Syrian Arab Rep.,SYR,Russian Federation,RUS,0,352,0,444,796
2017,Tajikistan,TJK,Russian Federation,RUS,0,5,0,21,26
2017,Turkmenistan,TKM,Russian Federation,RUS,0,0,0,5,5
2017,Turkey,TUR,Russian Federation,RUS,0,0,0,5,5
2017,Ukraine,UKR,Russian Federation,RUS,0,9678,0,2932,12610
2017,Uzbekistan,UZB,Russian Federation,RUS,0,12,0,41,53
2017,Venezuela (Bolivarian Republic of),VEN,Russian Federation,RUS,0,0,0,5,5
2017,Yemen,YEM,Russian Federation,RUS,0,36,0,36,72
2017,Stateless,XXA,Russian Federation,RUS,0,5,0,5,10
2017,Unknown ,,Russian Federation,RUS,0,0,0,13,13
2018,Afghanistan,AFG,Russian Federation,RUS,0,293,0,419,712
2018,Egypt,EGY,Russian Federation,RUS,0,0,0,5,5
2018,Argentina,ARG,Russian Federation,RUS,0,5,0,0,5
2018,Armenia,ARM,Russian Federation,RUS,0,0,0,5,5
2018,Azerbaijan,AZE,Russian Federation,RUS,0,0,0,14,14
2018,Belgium,BEL,Russian Federation,RUS,0,0,0,31,31
2018,Bangladesh,BGD,Russian Federation,RUS,0,0,0,10,10
2018,Cameroon,CMR,Russian Federation,RUS,0,0,0,11,11
2018,Congo,COG,Russian Federation,RUS,0,0,0,5,5
2018,Dem. Rep. of the Congo,COD,Russian Federation,RUS,0,0,0,10,10
2018,Cuba,CUB,Russian Federation,RUS,0,0,0,5,5
2018,Eritrea,ERI,Russian Federation,RUS,0,0,0,10,10
2018,Palestinian,PSE,Russian Federation,RUS,0,5,0,10,15
2018,Georgia,GEO,Russian Federation,RUS,0,22,0,13,35
2018,Germany,DEU,Russian Federation,RUS,0,0,0,10,10
2018,Cote d'Ivoire,CIV,Russian Federation,RUS,0,0,0,5,5
2018,India,IND,Russian Federation,RUS,0,0,0,5,5
2018,Iran (Islamic Rep. of),IRN,Russian Federation,RUS,0,0,0,5,5
2018,Iraq,IRQ,Russian Federation,RUS,0,0,0,10,10
2018,Kazakhstan,KAZ,Russian Federation,RUS,0,5,0,14,19
2018,Kyrgyzstan,KGZ,Russian Federation,RUS,0,5,0,14,19
2018,Dem. People's Rep. of Korea,PRK,Russian Federation,RUS,0,16,0,0,16
2018,Rep. of Moldova,MDA,Russian Federation,RUS,0,5,0,20,25
2018,Nigeria,NGA,Russian Federation,RUS,0,0,0,10,10
2018,Pakistan,PAK,Russian Federation,RUS,0,0,0,5,5
2018,Somalia,SOM,Russian Federation,RUS,0,0,0,10,10
2018,Sudan,SDN,Russian Federation,RUS,0,0,0,10,10
2018,Syrian Arab Rep.,SYR,Russian Federation,RUS,0,165,0,210,375
2018,Tajikistan,TJK,Russian Federation,RUS,0,0,0,26,26
2018,Turkmenistan,TKM,Russian Federation,RUS,0,5,0,5,10
2018,Ukraine,UKR,Russian Federation,RUS,0,5383,0,1120,6503
2018,Uzbekistan,UZB,Russian Federation,RUS,0,13,0,38,51
2018,Yemen,YEM,Russian Federation,RUS,0,56,0,20,76
2018,Stateless,XXA,Russian Federation,RUS,0,10,0,10,20
2018,Unknown ,,Russian Federation,RUS,0,0,0,5,5
2019,Afghanistan,AFG,Russian Federation,RUS,335,0,0,450,785
2019,Egypt,EGY,Russian Federation,RUS,0,0,0,5,5
2019,Armenia,ARM,Russian Federation,RUS,0,0,0,10,10
2019,Azerbaijan,AZE,Russian Federation,RUS,10,0,0,21,31
2019,Belgium,BEL,Russian Federation,RUS,0,0,0,25,25
2019,Bangladesh,BGD,Russian Federation,RUS,0,0,0,5,5
2019,China,CHN,Russian Federation,RUS,0,0,0,5,5
2019,Cameroon,CMR,Russian Federation,RUS,0,0,0,5,5
2019,Dem. Rep. of the Congo,COD,Russian Federation,RUS,0,0,0,10,10
2019,Eritrea,ERI,Russian Federation,RUS,0,0,0,5,5
2019,Palestinian,PSE,Russian Federation,RUS,5,0,0,5,10
2019,Georgia,GEO,Russian Federation,RUS,25,0,0,10,35
2019,Germany,DEU,Russian Federation,RUS,10,0,0,10,20
2019,Cote d'Ivoire,CIV,Russian Federation,RUS,0,0,0,5,5
2019,Iraq,IRQ,Russian Federation,RUS,0,0,0,10,10
2019,Kazakhstan,KAZ,Russian Federation,RUS,5,0,0,15,20
2019,Kyrgyzstan,KGZ,Russian Federation,RUS,11,0,0,16,27
2019,Rep. of Korea,KOR,Russian Federation,RUS,5,0,0,0,5
2019,Dem. People's Rep. of Korea,PRK,Russian Federation,RUS,12,0,0,10,22
2019,Rep. of Moldova,MDA,Russian Federation,RUS,5,0,0,16,21
2019,Nigeria,NGA,Russian Federation,RUS,0,0,0,10,10
2019,Pakistan,PAK,Russian Federation,RUS,0,0,0,5,5
2019,Somalia,SOM,Russian Federation,RUS,0,0,0,5,5
2019,Viet Nam,VNM,Russian Federation,RUS,0,0,0,5,5
2019,Sudan,SDN,Russian Federation,RUS,0,0,0,11,11
2019,Syrian Arab Rep.,SYR,Russian Federation,RUS,127,0,0,209,336
2019,Tajikistan,TJK,Russian Federation,RUS,18,0,0,40,58
2019,Turkmenistan,TKM,Russian Federation,RUS,10,0,0,10,20
2019,Turkey,TUR,Russian Federation,RUS,0,0,0,5,5
2019,Ukraine,UKR,Russian Federation,RUS,5300,0,0,650,5950
2019,United States of America,USA,Russian Federation,RUS,0,0,0,5,5
2019,Uzbekistan,UZB,Russian Federation,RUS,5,0,0,40,45
2019,Yemen,YEM,Russian Federation,RUS,40,0,0,25,65
2019,Stateless,XXA,Russian Federation,RUS,21,0,0,0,21
2019,Unknown ,,Russian Federation,RUS,0,0,0,5,5
2020,Afghanistan,AFG,Russian Federation,RUS,207,0,0,347,554
2020,Egypt,EGY,Russian Federation,RUS,0,0,0,5,5
2020,Armenia,ARM,Russian Federation,RUS,0,0,0,14,14
2020,Azerbaijan,AZE,Russian Federation,RUS,5,0,0,16,21
2020,Belgium,BEL,Russian Federation,RUS,0,0,0,32,32
2020,China,CHN,Russian Federation,RUS,18,0,0,589,607
2020,Cameroon,CMR,Russian Federation,RUS,0,0,0,10,10
2020,Dem. Rep. of the Congo,COD,Russian Federation,RUS,12,0,0,0,12
2020,Cuba,CUB,Russian Federation,RUS,5,0,0,5,10
2020,Eritrea,ERI,Russian Federation,RUS,0,0,0,5,5
2020,Estonia,EST,Russian Federation,RUS,5,0,0,0,5
2020,Ethiopia,ETH,Russian Federation,RUS,0,0,0,5,5
2020,Georgia,GEO,Russian Federation,RUS,25,0,0,10,35
2020,Germany,DEU,Russian Federation,RUS,0,0,0,5,5
2020,Guinea,GIN,Russian Federation,RUS,0,0,0,5,5
2020,Iran (Islamic Rep. of),IRN,Russian Federation,RUS,0,0,0,5,5
2020,Iraq,IRQ,Russian Federation,RUS,0,0,0,5,5
2020,Israel,ISR,Russian Federation,RUS,5,0,0,0,5
2020,Italy,ITA,Russian Federation,RUS,0,0,0,5,5
2020,Kazakhstan,KAZ,Russian Federation,RUS,5,0,0,19,24
2020,Kyrgyzstan,KGZ,Russian Federation,RUS,5,0,0,13,18
2020,Dem. People's Rep. of Korea,PRK,Russian Federation,RUS,13,0,0,5,18
2020,Latvia,LVA,Russian Federation,RUS,5,0,0,0,5
2020,Rep. of Moldova,MDA,Russian Federation,RUS,0,0,0,11,11
2020,Nigeria,NGA,Russian Federation,RUS,0,0,0,12,12
2020,Pakistan,PAK,Russian Federation,RUS,0,0,0,5,5
2020,Philippines,PHL,Russian Federation,RUS,5,0,0,0,5
2020,Sudan,SDN,Russian Federation,RUS,0,0,0,5,5
2020,Syrian Arab Rep.,SYR,Russian Federation,RUS,50,0,0,195,245
2020,Tajikistan,TJK,Russian Federation,RUS,5,0,0,28,33
2020,Turkmenistan,TKM,Russian Federation,RUS,14,0,0,10,24
2020,Ukraine,UKR,Russian Federation,RUS,5079,0,0,320,5399
2020,United States of America,USA,Russian Federation,RUS,0,0,0,5,5
2020,Uzbekistan,UZB,Russian Federation,RUS,33,0,0,33,66
2020,Yemen,YEM,Russian Federation,RUS,41,0,0,20,61
2020,Stateless,XXA,Russian Federation,RUS,10,0,0,20,30
2020,Unknown ,,Russian Federation,RUS,0,0,0,10,10
2010,Afghanistan,AFG,Switzerland,CHE,0,43,0,0,43
2010,Algeria,DZA,Switzerland,CHE,0,26,0,0,26
2010,Angola,AGO,Switzerland,CHE,0,28,0,0,28
2010,Armenia,ARM,Switzerland,CHE,0,11,0,0,11
2010,Azerbaijan,AZE,Switzerland,CHE,0,5,0,0,5
2010,Bangladesh,BGD,Switzerland,CHE,0,16,0,0,16
2010,Belarus,BLR,Switzerland,CHE,0,5,0,0,5
2010,Bosnia and Herzegovina,BIH,Switzerland,CHE,0,53,0,0,53
2010,Bulgaria,BGR,Switzerland,CHE,0,5,0,0,5
2010,Cambodia,KHM,Switzerland,CHE,0,5,0,0,5
2010,China,CHN,Switzerland,CHE,0,46,0,0,46
2010,Cameroon,CMR,Switzerland,CHE,0,16,0,0,16
2010,Congo,COG,Switzerland,CHE,0,5,0,0,5
2010,Dem. Rep. of the Congo,COD,Switzerland,CHE,0,61,0,0,61
2010,Cuba,CUB,Switzerland,CHE,0,5,0,0,5
2010,Eritrea,ERI,Switzerland,CHE,0,47,0,0,47
2010,Ethiopia,ETH,Switzerland,CHE,0,37,0,0,37
2010,Palestinian,PSE,Switzerland,CHE,0,5,0,0,5
2010,Georgia,GEO,Switzerland,CHE,0,5,0,0,5
2010,Cote d'Ivoire,CIV,Switzerland,CHE,0,5,0,0,5
2010,Iran (Islamic Rep. of),IRN,Switzerland,CHE,0,22,0,0,22
2010,Iraq,IRQ,Switzerland,CHE,0,43,0,0,43
2010,Kenya,KEN,Switzerland,CHE,0,5,0,0,5
2010,Sri Lanka,LKA,Switzerland,CHE,0,19,0,0,19
2010,North Macedonia,MKD,Switzerland,CHE,0,15,0,0,15
2010,Mongolia,MNG,Switzerland,CHE,0,5,0,0,5
2010,Morocco,MAR,Switzerland,CHE,0,5,0,0,5
2010,Mozambique,MOZ,Switzerland,CHE,0,5,0,0,5
2010,Montenegro,MNE,Switzerland,CHE,0,5,0,0,5
2010,Nigeria,NGA,Switzerland,CHE,0,10,0,0,10
2010,Russian Federation,RUS,Switzerland,CHE,0,14,0,0,14
2010,Serbia and Kosovo: S/RES/1244 (1999),SRB,Switzerland,CHE,0,177,0,0,177
2010,Somalia,SOM,Switzerland,CHE,0,5,0,0,5
2010,Viet Nam,VNM,Switzerland,CHE,0,5,0,0,5
2010,Sudan,SDN,Switzerland,CHE,0,5,0,0,5
2010,Syrian Arab Rep.,SYR,Switzerland,CHE,0,5,0,0,5
2010,Togo,TGO,Switzerland,CHE,0,5,0,0,5
2010,Tunisia,TUN,Switzerland,CHE,0,5,0,0,5
2010,Turkey,TUR,Switzerland,CHE,0,55,0,0,55
2010,Uganda,UGA,Switzerland,CHE,0,5,0,0,5
2010,Ukraine,UKR,Switzerland,CHE,0,16,0,0,16
2010,Yemen,YEM,Switzerland,CHE,0,5,0,0,5
2010,Unknown ,,Switzerland,CHE,0,31,0,0,31
2011,Afghanistan,AFG,Switzerland,CHE,0,199,0,0,199
2011,Algeria,DZA,Switzerland,CHE,0,11,0,0,11
2011,Angola,AGO,Switzerland,CHE,0,26,0,0,26
2011,Armenia,ARM,Switzerland,CHE,0,5,0,0,5
2011,Azerbaijan,AZE,Switzerland,CHE,0,5,0,0,5
2011,Benin,BEN,Switzerland,CHE,0,5,0,0,5
2011,Bangladesh,BGD,Switzerland,CHE,0,10,0,0,10
2011,Bosnia and Herzegovina,BIH,Switzerland,CHE,0,19,0,0,19
2011,China,CHN,Switzerland,CHE,0,5,0,0,5
2011,Cameroon,CMR,Switzerland,CHE,0,13,0,0,13
2011,Congo,COG,Switzerland,CHE,0,5,0,0,5
2011,Dem. Rep. of the Congo,COD,Switzerland,CHE,0,80,0,0,80
2011,Ecuador,ECU,Switzerland,CHE,0,5,0,0,5
2011,Eritrea,ERI,Switzerland,CHE,0,46,0,0,46
2011,Ethiopia,ETH,Switzerland,CHE,0,16,0,0,16
2011,Palestinian,PSE,Switzerland,CHE,0,10,0,0,10
2011,Georgia,GEO,Switzerland,CHE,0,5,0,0,5
2011,Ghana,GHA,Switzerland,CHE,0,5,0,0,5
2011,Guinea-Bissau,GNB,Switzerland,CHE,0,5,0,0,5
2011,Guinea,GIN,Switzerland,CHE,0,5,0,0,5
2011,Croatia,HRV,Switzerland,CHE,0,5,0,0,5
2011,Cote d'Ivoire,CIV,Switzerland,CHE,0,10,0,0,10
2011,India,IND,Switzerland,CHE,0,10,0,0,10
2011,Iran (Islamic Rep. of),IRN,Switzerland,CHE,0,23,0,0,23
2011,Iraq,IRQ,Switzerland,CHE,0,38,0,0,38
2011,Sri Lanka,LKA,Switzerland,CHE,0,10,0,0,10
2011,Mali,MLI,Switzerland,CHE,0,5,0,0,5
2011,Morocco,MAR,Switzerland,CHE,0,5,0,0,5
2011,Nepal,NPL,Switzerland,CHE,0,5,0,0,5
2011,Nigeria,NGA,Switzerland,CHE,0,19,0,0,19
2011,Poland,POL,Switzerland,CHE,0,5,0,0,5
2011,Russian Federation,RUS,Switzerland,CHE,0,20,0,0,20
2011,Serbia and Kosovo: S/RES/1244 (1999),SRB,Switzerland,CHE,0,116,0,0,116
2011,Somalia,SOM,Switzerland,CHE,0,10,0,0,10
2011,Sudan,SDN,Switzerland,CHE,0,5,0,0,5
2011,Syrian Arab Rep.,SYR,Switzerland,CHE,0,140,0,0,140
2011,Togo,TGO,Switzerland,CHE,0,10,0,0,10
2011,Turkey,TUR,Switzerland,CHE,0,28,0,0,28
2011,Stateless,XXA,Switzerland,CHE,0,5,0,0,5
2011,Unknown ,,Switzerland,CHE,0,38,0,0,38
2000,Somalia,SOM,Ireland,IRL,0,5,0,0,5
2003,Bhutan,BTN,Nepal,NPL,0,24,0,0,24
2004,Bhutan,BTN,Nepal,NPL,0,102,10,40,152
2008,Cote d'Ivoire,CIV,Israel,ISR,0,0,30,0,30
2008,Liberia,LBR,Israel,ISR,0,0,31,0,31
2008,Nigeria,NGA,Israel,ISR,0,0,5,0,5
2008,Turkey,TUR,Israel,ISR,0,0,55,0,55
2015,Burundi,BDI,Kenya,KEN,0,0,0,10,10
2015,Dem. Rep. of the Congo,COD,Kenya,KEN,54,0,0,11,65
2015,Ethiopia,ETH,Kenya,KEN,114,0,10,139,263
2015,Rwanda,RWA,Kenya,KEN,0,0,5,14,19
2015,Somalia,SOM,Kenya,KEN,5,0,0,16,21
2015,Sudan,SDN,Kenya,KEN,0,0,0,40,40
2015,South Sudan,SSD,Kenya,KEN,5,0,10,50,65
2015,Uganda,UGA,Kenya,KEN,0,0,0,5,5
2016,Burundi,BDI,Kenya,KEN,10,0,0,5,15
2016,Dem. Rep. of the Congo,COD,Kenya,KEN,18,0,0,10,28
2016,Ethiopia,ETH,Kenya,KEN,43,0,0,102,145
2016,Rwanda,RWA,Kenya,KEN,0,0,0,10,10
2016,Somalia,SOM,Kenya,KEN,5,0,0,0,5
2016,Sudan,SDN,Kenya,KEN,0,0,0,26,26
2016,South Sudan,SSD,Kenya,KEN,0,0,0,21,21
2016,United Rep. of Tanzania,TZA,Kenya,KEN,0,0,0,13,13
2016,Uganda,UGA,Kenya,KEN,0,0,0,5,5
2017,Burundi,BDI,Kenya,KEN,0,0,0,86,86
2017,Dem. Rep. of the Congo,COD,Kenya,KEN,20,0,0,44,64
2017,Eritrea,ERI,Kenya,KEN,0,0,0,14,14
2017,Ethiopia,ETH,Kenya,KEN,15,0,0,580,595
2017,Liberia,LBR,Kenya,KEN,0,0,0,5,5
2017,Rwanda,RWA,Kenya,KEN,0,0,0,22,22
2017,Sudan,SDN,Kenya,KEN,0,0,0,35,35
2017,United Rep. of Tanzania,TZA,Kenya,KEN,0,0,0,5,5
2017,Uganda,UGA,Kenya,KEN,0,0,0,5,5
2019,Eritrea,ERI,Niger,NER,20,0,0,0,20
2019,Ethiopia,ETH,Niger,NER,10,0,0,0,10
2019,Somalia,SOM,Niger,NER,32,0,0,0,32
2020,Eritrea,ERI,Niger,NER,19,0,0,0,19
2020,Ethiopia,ETH,Niger,NER,15,0,0,0,15
2020,Somalia,SOM,Niger,NER,21,0,0,0,21
2006,Angola,AGO,Congo,COG,0,0,5,0,5
2006,Burundi,BDI,Congo,COG,0,0,0,5,5
2006,Central African Rep.,CAF,Congo,COG,0,0,17,12,29
2006,Chad,TCD,Congo,COG,5,0,13,22,40
2006,Dem. Rep. of the Congo,COD,Congo,COG,26,0,65,41,132
2006,Cote d'Ivoire,CIV,Congo,COG,0,0,29,19,48
2006,Mauritania,MRT,Congo,COG,0,0,5,0,5
2006,Sudan,SDN,Congo,COG,0,0,5,5,10
2006,Unknown ,,Congo,COG,5,0,14,10,29
2006,Cameroon,CMR,Israel,ISR,0,0,10,5,15
2006,Dem. Rep. of the Congo,COD,Israel,ISR,0,5,5,0,10
2006,Colombia,COL,Israel,ISR,0,0,10,21,31
2006,Eritrea,ERI,Israel,ISR,0,0,0,27,27
2006,Ethiopia,ETH,Israel,ISR,0,0,60,27,87
2006,Georgia,GEO,Israel,ISR,0,0,0,5,5
2006,Ghana,GHA,Israel,ISR,0,0,46,28,74
2006,Guinea-Bissau,GNB,Israel,ISR,0,0,10,0,10
2006,Guinea,GIN,Israel,ISR,0,0,254,49,303
2006,Cote d'Ivoire,CIV,Israel,ISR,0,66,14,0,80
2006,India,IND,Israel,ISR,0,0,5,0,5
2006,Kenya,KEN,Israel,ISR,0,0,5,0,5
2006,Liberia,LBR,Israel,ISR,0,5,17,0,22
2006,Sri Lanka,LKA,Israel,ISR,0,0,5,0,5
2006,Mali,MLI,Israel,ISR,0,0,10,0,10
2006,Nigeria,NGA,Israel,ISR,0,0,231,88,319
2006,Philippines,PHL,Israel,ISR,0,0,5,0,5
2006,South Africa,ZAF,Israel,ISR,0,0,5,0,5
2006,Senegal,SEN,Israel,ISR,0,0,5,0,5
2006,Sierra Leone,SLE,Israel,ISR,0,0,10,0,10
2006,Sudan,SDN,Israel,ISR,0,262,0,0,262
2006,Togo,TGO,Israel,ISR,0,0,12,0,12
2006,Turkey,TUR,Israel,ISR,0,0,43,5,48
2006,Uganda,UGA,Israel,ISR,0,0,5,0,5
2006,Zimbabwe,ZWE,Israel,ISR,0,0,17,5,22
2007,Angola,AGO,Congo,COG,0,0,5,0,5
2007,Burundi,BDI,Congo,COG,5,0,0,0,5
2007,Central African Rep.,CAF,Congo,COG,0,0,5,0,5
2007,Chad,TCD,Congo,COG,0,0,13,0,13
2007,Dem. Rep. of the Congo,COD,Congo,COG,47,0,88,0,135
2007,Cote d'Ivoire,CIV,Congo,COG,0,0,46,0,46
2007,Unknown ,,Congo,COG,10,0,52,0,62
2008,Central African Rep.,CAF,Congo,COG,0,0,18,39,57
2008,Chad,TCD,Congo,COG,5,0,50,66,121
2008,Dem. Rep. of the Congo,COD,Congo,COG,11,0,262,2451,2724
2008,Guinea,GIN,Congo,COG,0,0,0,36,36
2008,Cote d'Ivoire,CIV,Congo,COG,0,0,67,311,378
2008,Liberia,LBR,Congo,COG,0,0,0,48,48
2008,Nigeria,NGA,Congo,COG,0,0,0,18,18
2008,Senegal,SEN,Congo,COG,0,0,0,13,13
2008,Sierra Leone,SLE,Congo,COG,0,0,5,32,37
2008,Sudan,SDN,Congo,COG,5,0,5,13,23
2008,Uganda,UGA,Congo,COG,0,0,0,10,10
2008,Unknown ,,Congo,COG,5,0,27,21,53
2009,Central African Rep.,CAF,Congo,COG,0,0,0,5,5
2009,Chad,TCD,Congo,COG,5,0,5,10,20
2009,Dem. Rep. of the Congo,COD,Congo,COG,33,0,57,27,117
2009,Cote d'Ivoire,CIV,Congo,COG,0,0,12,16,28
2009,Unknown ,,Congo,COG,0,0,10,5,15
2007,Burundi,BDI,Israel,ISR,0,0,5,0,5
2007,Central African Rep.,CAF,Israel,ISR,0,0,5,0,5
2007,Cameroon,CMR,Israel,ISR,0,0,5,5,10
2007,Colombia,COL,Israel,ISR,0,0,0,5,5
2007,Ethiopia,ETH,Israel,ISR,0,0,15,0,15
2007,Gambia,GMB,Israel,ISR,0,0,0,5,5
2007,Georgia,GEO,Israel,ISR,0,0,5,5,10
2007,Ghana,GHA,Israel,ISR,0,0,10,10,20
2007,Guinea,GIN,Israel,ISR,0,0,5,5,10
2007,Cote d'Ivoire,CIV,Israel,ISR,0,0,5,5,10
2007,Kenya,KEN,Israel,ISR,0,0,10,5,15
2007,Liberia,LBR,Israel,ISR,0,0,33,0,33
2007,Mali,MLI,Israel,ISR,0,0,5,0,5
2007,Nepal,NPL,Israel,ISR,0,0,5,0,5
2007,Nigeria,NGA,Israel,ISR,0,0,155,60,215
2007,Philippines,PHL,Israel,ISR,0,0,5,5,10
2007,Togo,TGO,Israel,ISR,0,0,5,5,10
2007,Turkey,TUR,Israel,ISR,0,0,70,10,80
2007,Dem. Rep. of the Congo,COD,Eswatini,SWZ,19,0,0,0,19
2007,Rwanda,RWA,Eswatini,SWZ,20,0,0,0,20
2008,Central African Rep.,CAF,Mauritania,MRT,0,0,5,0,5
2008,Congo,COG,Mauritania,MRT,0,0,11,0,11
2008,Dem. Rep. of the Congo,COD,Mauritania,MRT,16,0,14,0,30
2008,Guinea,GIN,Mauritania,MRT,0,0,11,0,11
2008,Cote d'Ivoire,CIV,Mauritania,MRT,36,0,76,18,130
2008,Liberia,LBR,Mauritania,MRT,10,0,30,0,40
2008,Senegal,SEN,Mauritania,MRT,5,0,0,0,5
2008,Sierra Leone,SLE,Mauritania,MRT,0,0,10,5,15
2008,Sudan,SDN,Mauritania,MRT,0,0,5,0,5
2008,Togo,TGO,Mauritania,MRT,0,0,5,0,5
2008,Afghanistan,AFG,Tajikistan,TJK,828,0,634,0,1462
2008,Iran (Islamic Rep. of),IRN,Tajikistan,TJK,0,0,5,0,5
2009,Afghanistan,AFG,Kazakhstan,KAZ,64,0,74,0,138
2009,China,CHN,Kazakhstan,KAZ,5,0,0,0,5
2009,Kyrgyzstan,KGZ,Kazakhstan,KAZ,29,0,0,0,29
2009,Uzbekistan,UZB,Kazakhstan,KAZ,166,0,10,5,181
2009,Central African Rep.,CAF,Mauritania,MRT,0,0,5,0,5
2009,Chad,TCD,Mauritania,MRT,0,0,5,0,5
2009,Cameroon,CMR,Mauritania,MRT,0,0,5,5,10
2009,Congo,COG,Mauritania,MRT,0,0,5,10,15
2009,Dem. Rep. of the Congo,COD,Mauritania,MRT,10,0,45,10,65
2009,Gambia,GMB,Mauritania,MRT,0,0,5,0,5
2009,Palestinian,PSE,Mauritania,MRT,13,0,0,0,13
2009,Guinea,GIN,Mauritania,MRT,0,0,5,0,5
2009,Cote d'Ivoire,CIV,Mauritania,MRT,36,0,104,20,160
2009,Liberia,LBR,Mauritania,MRT,0,0,14,13,27
2009,Nigeria,NGA,Mauritania,MRT,0,0,0,5,5
2009,Senegal,SEN,Mauritania,MRT,5,0,5,0,10
2009,Togo,TGO,Mauritania,MRT,0,0,12,0,12
2009,Sri Lanka,LKA,Papua New Guinea,PNG,5,0,0,0,5
2009,Nigeria,NGA,Papua New Guinea,PNG,0,0,5,0,5
2010,Afghanistan,AFG,Kazakhstan,KAZ,31,0,63,5,99
2010,China,CHN,Kazakhstan,KAZ,5,0,13,5,23
2010,Kyrgyzstan,KGZ,Kazakhstan,KAZ,10,0,31,31,72
2010,Tajikistan,TJK,Kazakhstan,KAZ,0,0,10,0,10
2010,Uzbekistan,UZB,Kazakhstan,KAZ,20,0,90,29,139
2010,Cote d'Ivoire,CIV,Liberia,LBR,0,10,0,0,10
2010,Sierra Leone,SLE,Liberia,LBR,170,0,330,0,500
2010,Cameroon,CMR,Mauritania,MRT,0,0,5,0,5
2010,Congo,COG,Mauritania,MRT,0,0,5,0,5
2010,Dem. Rep. of the Congo,COD,Mauritania,MRT,17,0,33,0,50
2010,Guinea,GIN,Mauritania,MRT,0,0,22,0,22
2010,Cote d'Ivoire,CIV,Mauritania,MRT,12,0,40,0,52
2010,Liberia,LBR,Mauritania,MRT,0,0,5,0,5
2010,Mali,MLI,Mauritania,MRT,0,0,5,0,5
2010,Switzerland,CHE,Mauritania,MRT,0,0,5,0,5
2010,Togo,TGO,Mauritania,MRT,0,0,5,0,5
2010,Sri Lanka,LKA,Papua New Guinea,PNG,0,0,5,0,5
2010,Dem. Rep. of the Congo,COD,United Rep. of Tanzania,TZA,24,0,0,0,24
2010,Rwanda,RWA,United Rep. of Tanzania,TZA,11,0,0,0,11
2011,Afghanistan,AFG,Fiji,FJI,5,0,0,0,5
2011,Iraq,IRQ,Fiji,FJI,0,0,0,5,5
2011,Cote d'Ivoire,CIV,Ghana,GHA,0,0,0,8233,8233
2011,Liberia,LBR,Ghana,GHA,0,0,0,5,5
2011,Sudan,SDN,Ghana,GHA,5,0,0,0,5
2011,Central African Rep.,CAF,Cote d'Ivoire,CIV,0,0,5,0,5
2011,Congo,COG,Cote d'Ivoire,CIV,5,0,5,0,10
2011,Dem. Rep. of the Congo,COD,Cote d'Ivoire,CIV,5,0,0,0,5
2011,Liberia,LBR,Cote d'Ivoire,CIV,0,0,169,0,169
2011,Nigeria,NGA,Cote d'Ivoire,CIV,0,0,22,0,22
2011,Togo,TGO,Cote d'Ivoire,CIV,0,0,10,0,10
2011,Cote d'Ivoire,CIV,Liberia,LBR,5,0,0,0,5
2011,Sudan,SDN,Liberia,LBR,5,0,0,0,5
2011,Togo,TGO,Liberia,LBR,0,0,10,5,15
2011,Sri Lanka,LKA,Papua New Guinea,PNG,0,0,5,0,5
2012,Guinea,GIN,Liberia,LBR,23,0,540,0,563
2012,Syrian Arab Rep.,SYR,"China, Macao SAR",MAC,5,0,0,0,5
2013,Mali,MLI,Liberia,LBR,5,0,0,0,5
2013,Togo,TGO,Liberia,LBR,5,0,5,0,10
2014,Central African Rep.,CAF,Cote d'Ivoire,CIV,192,0,0,0,192
2014,Dem. Rep. of the Congo,COD,Cote d'Ivoire,CIV,5,0,0,5,10
2014,Guinea,GIN,Cote d'Ivoire,CIV,0,0,0,5,5
2014,Liberia,LBR,Cote d'Ivoire,CIV,0,0,0,13,13
2014,Rwanda,RWA,Cote d'Ivoire,CIV,5,0,0,0,5
2015,Central African Rep.,CAF,Cote d'Ivoire,CIV,77,0,35,0,112
2015,Liberia,LBR,Cote d'Ivoire,CIV,0,0,0,5,5
2015,Mali,MLI,Cote d'Ivoire,CIV,5,0,0,5,10
2015,Syrian Arab Rep.,SYR,Cote d'Ivoire,CIV,17,0,0,0,17
2015,Yemen,YEM,Cote d'Ivoire,CIV,5,0,0,0,5
2016,Burundi,BDI,Cote d'Ivoire,CIV,5,0,0,0,5
2016,Central African Rep.,CAF,Cote d'Ivoire,CIV,33,0,0,0,33
2016,Chad,TCD,Cote d'Ivoire,CIV,0,0,0,5,5
2016,Cameroon,CMR,Cote d'Ivoire,CIV,0,0,0,10,10
2016,Congo,COG,Cote d'Ivoire,CIV,0,0,0,10,10
2016,Dem. Rep. of the Congo,COD,Cote d'Ivoire,CIV,0,0,0,32,32
2016,Gabon,GAB,Cote d'Ivoire,CIV,0,0,0,5,5
2016,Ghana,GHA,Cote d'Ivoire,CIV,0,0,0,10,10
2016,Liberia,LBR,Cote d'Ivoire,CIV,0,0,0,232,232
2016,Nigeria,NGA,Cote d'Ivoire,CIV,0,0,0,68,68
2016,Rwanda,RWA,Cote d'Ivoire,CIV,0,0,0,10,10
2016,Sierra Leone,SLE,Cote d'Ivoire,CIV,0,0,0,10,10
2016,Togo,TGO,Cote d'Ivoire,CIV,0,0,0,12,12
2017,Burundi,BDI,Cote d'Ivoire,CIV,5,0,0,0,5
2017,Central African Rep.,CAF,Cote d'Ivoire,CIV,62,0,0,0,62
2017,Dem. Rep. of the Congo,COD,Cote d'Ivoire,CIV,5,0,0,0,5
2017,Liberia,LBR,Cote d'Ivoire,CIV,5,0,0,0,5
2017,Rwanda,RWA,Cote d'Ivoire,CIV,5,0,0,0,5
2017,Syrian Arab Rep.,SYR,Cote d'Ivoire,CIV,10,0,0,0,10
2017,Turkey,TUR,Cote d'Ivoire,CIV,20,0,0,0,20
2001,Ethiopia,ETH,Sudan,SDN,287,0,2913,0,3200
2002,Burundi,BDI,Cote d'Ivoire,CIV,5,0,5,0,10
2002,Central African Rep.,CAF,Cote d'Ivoire,CIV,20,0,10,0,30
2002,Chad,TCD,Cote d'Ivoire,CIV,0,0,5,0,5
2002,Congo,COG,Cote d'Ivoire,CIV,68,0,23,0,91
2002,Dem. Rep. of the Congo,COD,Cote d'Ivoire,CIV,10,0,22,0,32
2002,Liberia,LBR,Cote d'Ivoire,CIV,0,0,0,1328,1328
2002,Rwanda,RWA,Cote d'Ivoire,CIV,19,0,0,0,19
2003,Burundi,BDI,Cote d'Ivoire,CIV,5,0,5,0,10
2003,Cambodia,KHM,Cote d'Ivoire,CIV,5,0,0,0,5
2003,Central African Rep.,CAF,Cote d'Ivoire,CIV,10,0,0,0,10
2003,Congo,COG,Cote d'Ivoire,CIV,37,0,23,0,60
2003,Dem. Rep. of the Congo,COD,Cote d'Ivoire,CIV,33,0,60,0,93
2003,Guinea,GIN,Cote d'Ivoire,CIV,5,0,0,0,5
2003,Rwanda,RWA,Cote d'Ivoire,CIV,11,0,5,0,16
2003,China,CHN,Nepal,NPL,0,0,0,5,5
2004,Afghanistan,AFG,Cote d'Ivoire,CIV,0,0,10,0,10
2004,Central African Rep.,CAF,Cote d'Ivoire,CIV,0,0,21,0,21
2004,Congo,COG,Cote d'Ivoire,CIV,22,5,37,0,64
2004,Dem. Rep. of the Congo,COD,Cote d'Ivoire,CIV,47,5,42,0,94
2004,Guinea,GIN,Cote d'Ivoire,CIV,0,0,5,0,5
2004,Kenya,KEN,Cote d'Ivoire,CIV,0,0,5,0,5
2004,Rwanda,RWA,Cote d'Ivoire,CIV,0,0,10,0,10
2004,Sierra Leone,SLE,Cote d'Ivoire,CIV,5,0,146,0,151
2004,Iraq,IRQ,Nepal,NPL,0,0,0,10,10
2004,Niger,NER,Nepal,NPL,0,0,5,0,5
2004,Pakistan,PAK,Nepal,NPL,0,0,0,43,43
2005,Armenia,ARM,Ecuador,ECU,5,0,0,0,5
2005,Colombia,COL,Ecuador,ECU,2442,0,2395,1078,5915
2005,Cuba,CUB,Ecuador,ECU,12,0,0,0,12
2005,Palestinian,PSE,Ecuador,ECU,0,0,0,5,5
2005,Haiti,HTI,Ecuador,ECU,5,0,0,0,5
2005,Iraq,IRQ,Ecuador,ECU,0,0,0,5,5
2005,Pakistan,PAK,Ecuador,ECU,0,0,0,5,5
2005,Peru,PER,Ecuador,ECU,13,0,259,0,272
2005,Russian Federation,RUS,Ecuador,ECU,0,0,5,0,5
2005,Somalia,SOM,Ecuador,ECU,5,0,0,0,5
2005,Angola,AGO,Mozambique,MOZ,0,0,0,61,61
2005,Burundi,BDI,Mozambique,MOZ,0,0,0,646,646
2005,Dem. Rep. of the Congo,COD,Mozambique,MOZ,0,0,0,558,558
2005,Ethiopia,ETH,Mozambique,MOZ,0,0,0,28,28
2005,Rwanda,RWA,Mozambique,MOZ,0,0,0,433,433
2005,Sudan,SDN,Mozambique,MOZ,0,0,0,10,10
2006,Rwanda,RWA,Burundi,BDI,206,0,7837,11297,19340
2006,Afghanistan,AFG,Ecuador,ECU,5,0,0,0,5
2006,Colombia,COL,Ecuador,ECU,1943,0,2184,49,4176
2006,Cuba,CUB,Ecuador,ECU,29,0,0,0,29
2006,Haiti,HTI,Ecuador,ECU,5,0,0,0,5
2006,Nepal,NPL,Ecuador,ECU,0,0,5,0,5
2006,Peru,PER,Ecuador,ECU,5,0,506,0,511
2006,Russian Federation,RUS,Ecuador,ECU,5,0,0,0,5
2006,Venezuela (Bolivarian Republic of),VEN,Ecuador,ECU,0,0,5,0,5
2006,Burundi,BDI,Ethiopia,ETH,5,0,0,0,5
2006,Dem. Rep. of the Congo,COD,Ethiopia,ETH,30,0,0,0,30
2006,Eritrea,ERI,Ethiopia,ETH,2655,0,0,0,2655
2006,Sudan,SDN,Ethiopia,ETH,10,0,0,0,10
2007,Burundi,BDI,Ethiopia,ETH,49,0,0,12,61
2007,Dem. Rep. of the Congo,COD,Ethiopia,ETH,77,0,10,25,112
2007,Eritrea,ERI,Ethiopia,ETH,7806,0,0,0,7806
2007,Kenya,KEN,Ethiopia,ETH,2644,0,0,0,2644
2007,Nigeria,NGA,Ethiopia,ETH,5,0,5,5,15
2007,Rwanda,RWA,Ethiopia,ETH,5,0,0,5,10
2007,Somalia,SOM,Ethiopia,ETH,9251,0,0,5,9256
2007,Sudan,SDN,Ethiopia,ETH,54,0,0,16,70
2007,Uganda,UGA,Ethiopia,ETH,5,0,0,0,5
2008,Central African Rep.,CAF,Chad,TCD,0,0,5,0,5
2008,Cameroon,CMR,Chad,TCD,0,0,5,0,5
2008,Dem. Rep. of the Congo,COD,Chad,TCD,0,0,19,0,19
2008,Liberia,LBR,Chad,TCD,0,0,10,0,10
2008,Rwanda,RWA,Chad,TCD,0,0,5,0,5
2008,Somalia,SOM,Chad,TCD,0,0,5,0,5
2008,Sudan,SDN,Chad,TCD,0,0,51,0,51
2008,Chad,TCD,Ethiopia,ETH,0,0,5,5,10
2008,Cameroon,CMR,Ethiopia,ETH,0,0,0,5,5
2008,Dem. Rep. of the Congo,COD,Ethiopia,ETH,14,0,0,0,14
2008,Eritrea,ERI,Ethiopia,ETH,7895,0,105,0,8000
2008,Nigeria,NGA,Ethiopia,ETH,0,0,5,10,15
2008,Somalia,SOM,Ethiopia,ETH,8883,0,2416,2731,14030
2008,Sudan,SDN,Ethiopia,ETH,139,0,0,12,151
2008,Cameroon,CMR,Israel,ISR,0,0,5,0,5
2008,Colombia,COL,Israel,ISR,0,0,5,10,15
2008,Eritrea,ERI,Israel,ISR,0,4417,0,0,4417
2008,Ethiopia,ETH,Israel,ISR,0,0,5,12,17
2008,Georgia,GEO,Israel,ISR,0,0,0,5,5
2008,Ghana,GHA,Israel,ISR,0,0,71,25,96
2008,Guinea,GIN,Israel,ISR,0,0,5,5,10
2008,Cote d'Ivoire,CIV,Israel,ISR,0,234,506,76,816
2008,Kenya,KEN,Israel,ISR,0,0,12,14,26
2008,Dem. People's Rep. of Korea,PRK,Israel,ISR,0,0,5,0,5
2008,Liberia,LBR,Israel,ISR,0,0,0,10,10
2008,Mali,MLI,Israel,ISR,0,0,5,0,5
2008,Nigeria,NGA,Israel,ISR,0,0,194,66,260
2008,Philippines,PHL,Israel,ISR,0,0,12,10,22
2008,Sudan,SDN,Israel,ISR,0,3767,0,261,4028
2008,Togo,TGO,Israel,ISR,0,0,0,5,5
2008,Turkey,TUR,Israel,ISR,0,0,51,42,93
2008,Unknown ,,Israel,ISR,0,0,0,5,5
2008,Myanmar,MMR,Papua New Guinea,PNG,5,0,0,0,5
2009,Central African Rep.,CAF,Chad,TCD,0,0,5,0,5
2009,Dem. Rep. of the Congo,COD,Chad,TCD,5,0,86,0,91
2009,Sudan,SDN,Chad,TCD,0,0,35,0,35
2009,Burundi,BDI,Ethiopia,ETH,14,0,0,28,42
2009,Cameroon,CMR,Ethiopia,ETH,0,0,0,12,12
2009,Dem. Rep. of the Congo,COD,Ethiopia,ETH,35,0,0,23,58
2009,Djibouti,DJI,Ethiopia,ETH,12,0,0,0,12
2009,Eritrea,ERI,Ethiopia,ETH,16724,0,359,495,17578
2009,Kenya,KEN,Ethiopia,ETH,118,0,0,0,118
2009,Rwanda,RWA,Ethiopia,ETH,5,0,0,0,5
2009,Somalia,SOM,Ethiopia,ETH,2201,0,492,851,3544
2009,Sudan,SDN,Ethiopia,ETH,26,0,0,13,39
2009,Yemen,YEM,Ethiopia,ETH,5,0,0,0,5
2009,Russian Federation,RUS,Fiji,FJI,0,0,5,0,5
2009,Cote d'Ivoire,CIV,Liberia,LBR,43,0,10,0,53
2009,Pakistan,PAK,"China, Macao SAR",MAC,5,0,0,0,5
2010,Central African Rep.,CAF,Chad,TCD,0,0,0,5,5
2010,Dem. Rep. of the Congo,COD,Chad,TCD,10,0,5,0,15
2010,Liberia,LBR,Chad,TCD,0,0,0,10,10
2010,Sudan,SDN,Chad,TCD,12,0,0,5,17
2010,Eritrea,ERI,Djibouti,DJI,111,0,0,71,182
2010,Ethiopia,ETH,Djibouti,DJI,22,0,0,61,83
2010,Somalia,SOM,Djibouti,DJI,0,0,0,24,24
2010,Burundi,BDI,Ethiopia,ETH,0,0,0,5,5
2010,Congo,COG,Ethiopia,ETH,5,0,0,0,5
2010,Dem. Rep. of the Congo,COD,Ethiopia,ETH,98,0,0,52,150
2010,Djibouti,DJI,Ethiopia,ETH,0,0,5,5,10
2010,Eritrea,ERI,Ethiopia,ETH,0,0,0,324,324
2010,Cote d'Ivoire,CIV,Ethiopia,ETH,0,0,5,0,5
2010,Kenya,KEN,Ethiopia,ETH,0,0,0,1109,1109
2010,Somalia,SOM,Ethiopia,ETH,2928,0,691,491,4110
2010,Sudan,SDN,Ethiopia,ETH,112,0,0,22,134
2011,Central African Rep.,CAF,Chad,TCD,947,0,0,0,947
2011,Dem. Rep. of the Congo,COD,Chad,TCD,19,0,0,0,19
2011,Sudan,SDN,Chad,TCD,4884,0,0,0,4884
2011,Burundi,BDI,Ethiopia,ETH,5,0,0,0,5
2011,Dem. Rep. of the Congo,COD,Ethiopia,ETH,99,0,0,0,99
2011,Djibouti,DJI,Ethiopia,ETH,10,0,0,0,10
2011,Eritrea,ERI,Ethiopia,ETH,0,0,0,93,93
2011,Kenya,KEN,Ethiopia,ETH,0,0,0,31,31
2011,Somalia,SOM,Ethiopia,ETH,36,0,0,122,158
2011,Sudan,SDN,Ethiopia,ETH,98,0,0,5,103
2011,Yemen,YEM,Ethiopia,ETH,12,0,0,0,12
2011,Cote d'Ivoire,CIV,Sierra Leone,SLE,0,17,0,0,17
2011,Nigeria,NGA,Sierra Leone,SLE,0,0,0,142,142
2011,Sudan,SDN,Sierra Leone,SLE,0,5,0,0,5
2011,Burundi,BDI,United Rep. of Tanzania,TZA,0,0,5,17,22
2011,Dem. Rep. of the Congo,COD,United Rep. of Tanzania,TZA,0,0,0,906,906
2011,Eritrea,ERI,United Rep. of Tanzania,TZA,13,0,0,0,13
2011,Rwanda,RWA,United Rep. of Tanzania,TZA,0,0,0,23,23
2011,Sudan,SDN,United Rep. of Tanzania,TZA,0,0,0,5,5
2011,Uganda,UGA,United Rep. of Tanzania,TZA,0,0,0,5,5
2012,Cuba,CUB,Bahamas,BHS,17,0,31,0,48
2012,Burundi,BDI,Botswana,BWA,5,0,0,0,5
2012,Dem. Rep. of the Congo,COD,Botswana,BWA,38,0,0,0,38
2012,Namibia,NAM,Botswana,BWA,0,0,0,16,16
2012,Rwanda,RWA,Botswana,BWA,0,0,0,5,5
2012,Somalia,SOM,Botswana,BWA,30,0,0,0,30
2012,Zimbabwe,ZWE,Botswana,BWA,10,5,0,16,31
2012,Eritrea,ERI,Djibouti,DJI,107,0,0,0,107
2012,Dem. Rep. of the Congo,COD,Ethiopia,ETH,68,0,0,5,73
2012,Eritrea,ERI,Ethiopia,ETH,15,0,0,0,15
2012,Kenya,KEN,Ethiopia,ETH,302,0,0,0,302
2012,Somalia,SOM,Ethiopia,ETH,744,0,14,10,768
2012,Sudan,SDN,Ethiopia,ETH,39,0,0,496,535
2012,Yemen,YEM,Ethiopia,ETH,17,0,0,0,17
2012,Angola,AGO,Cote d'Ivoire,CIV,5,0,0,0,5
2012,Congo,COG,Cote d'Ivoire,CIV,10,0,0,0,10
2012,Ghana,GHA,Cote d'Ivoire,CIV,0,0,5,0,5
2012,Liberia,LBR,Cote d'Ivoire,CIV,0,0,180,5,185
2012,Nigeria,NGA,Cote d'Ivoire,CIV,5,0,5,0,10
2012,Dem. Rep. of the Congo,COD,Rwanda,RWA,15108,0,795,0,15903
2012,Bangladesh,BGD,United Rep. of Tanzania,TZA,0,0,0,11,11
2012,Dem. Rep. of the Congo,COD,United Rep. of Tanzania,TZA,5,0,0,70,75
2012,Ethiopia,ETH,United Rep. of Tanzania,TZA,0,0,0,5,5
2012,Somalia,SOM,United Rep. of Tanzania,TZA,0,0,0,295,295
2013,Cuba,CUB,Bahamas,BHS,15,0,66,0,81
2013,Haiti,HTI,Bahamas,BHS,0,0,5,5,10
2013,Sri Lanka,LKA,Bahamas,BHS,0,0,0,5,5
2013,Guatemala,GTM,Belize,BLZ,0,0,0,17,17
2013,Honduras,HND,Belize,BLZ,0,0,0,12,12
2013,El Salvador,SLV,Belize,BLZ,0,0,0,32,32
2013,Burundi,BDI,Ethiopia,ETH,10,0,0,0,10
2013,Dem. Rep. of the Congo,COD,Ethiopia,ETH,10,0,0,5,15
2013,Eritrea,ERI,Ethiopia,ETH,15,0,0,28,43
2013,Somalia,SOM,Ethiopia,ETH,204,0,0,0,204
2013,Sudan,SDN,Ethiopia,ETH,19,0,0,0,19
2013,South Sudan,SSD,Ethiopia,ETH,11,0,0,0,11
2013,Yemen,YEM,Ethiopia,ETH,16,0,0,25,41
2013,Central African Rep.,CAF,Cote d'Ivoire,CIV,27,0,0,0,27
2013,Dem. Rep. of the Congo,COD,Cote d'Ivoire,CIV,5,0,0,0,5
2013,Liberia,LBR,Cote d'Ivoire,CIV,5,0,0,0,5
2013,Sudan,SDN,Cote d'Ivoire,CIV,5,0,0,0,5
2013,Cuba,CUB,Turks and Caicos Islands,TCA,5,0,0,22,27
2014,Honduras,HND,Belize,BLZ,0,0,0,10,10
2014,El Salvador,SLV,Belize,BLZ,0,0,0,12,12
2014,Dem. Rep. of the Congo,COD,Ethiopia,ETH,22,0,0,0,22
2014,Eritrea,ERI,Ethiopia,ETH,13,0,0,34,47
2014,Kenya,KEN,Ethiopia,ETH,0,0,0,10,10
2014,Sudan,SDN,Ethiopia,ETH,0,0,0,73,73
2014,South Sudan,SSD,Ethiopia,ETH,13,0,0,25,38
2014,Yemen,YEM,Ethiopia,ETH,5,0,0,10,15
2014,Afghanistan,AFG,Fiji,FJI,5,0,0,0,5
2014,Burundi,BDI,Kenya,KEN,40,0,44,405,489
2014,Cameroon,CMR,Kenya,KEN,0,0,0,10,10
2014,Congo,COG,Kenya,KEN,0,0,0,13,13
2014,Dem. Rep. of the Congo,COD,Kenya,KEN,2727,0,109,614,3450
2014,Eritrea,ERI,Kenya,KEN,82,0,5,0,87
2014,Ethiopia,ETH,Kenya,KEN,536,0,288,866,1690
2014,Iran (Islamic Rep. of),IRN,Kenya,KEN,5,0,0,0,5
2014,Mozambique,MOZ,Kenya,KEN,0,0,10,0,10
2014,Pakistan,PAK,Kenya,KEN,0,0,0,5,5
2014,Rwanda,RWA,Kenya,KEN,10,0,12,118,140
2014,Sierra Leone,SLE,Kenya,KEN,0,0,0,5,5
2014,Somalia,SOM,Kenya,KEN,45,0,29,1248,1322
2014,Sudan,SDN,Kenya,KEN,5,0,0,743,748
2014,South Sudan,SSD,Kenya,KEN,48,0,0,327,375
2014,United Rep. of Tanzania,TZA,Kenya,KEN,0,0,0,24,24
2014,Uganda,UGA,Kenya,KEN,104,0,21,99,224
2014,Cote d'Ivoire,CIV,Liberia,LBR,0,0,0,11,11
2014,Mali,MLI,Liberia,LBR,14,0,0,0,14
2014,Syrian Arab Rep.,SYR,Liberia,LBR,5,0,0,0,5
2015,Syrian Arab Rep.,SYR,Antigua and Barbuda,ATG,15,0,0,0,15
2015,Central African Rep.,CAF,Burkina Faso,BFA,113,0,0,0,113
2015,Chad,TCD,Burkina Faso,BFA,5,0,0,0,5
2015,El Salvador,SLV,Belize,BLZ,34,0,0,0,34
2015,Egypt,EGY,Ethiopia,ETH,5,0,0,0,5
2015,Burundi,BDI,Ethiopia,ETH,0,0,5,5,10
2015,Congo,COG,Ethiopia,ETH,0,0,0,5,5
2015,Dem. Rep. of the Congo,COD,Ethiopia,ETH,14,0,5,11,30
2015,Eritrea,ERI,Ethiopia,ETH,10,0,0,5,15
2015,Somalia,SOM,Ethiopia,ETH,5,0,0,0,5
2015,Sudan,SDN,Ethiopia,ETH,11,0,0,37,48
2015,South Sudan,SSD,Ethiopia,ETH,5,0,5,57,67
2015,Syrian Arab Rep.,SYR,Ethiopia,ETH,10,0,0,0,10
2015,Yemen,YEM,Ethiopia,ETH,69,0,0,0,69
2015,Lebanon,LBN,Fiji,FJI,0,0,0,5,5
2015,Burundi,BDI,Kenya,KEN,178,5,5,433,621
2015,Congo,COG,Kenya,KEN,10,0,0,14,24
2015,Dem. Rep. of the Congo,COD,Kenya,KEN,2704,14,5,868,3591
2015,Eritrea,ERI,Kenya,KEN,37,0,0,5,42
2015,Ethiopia,ETH,Kenya,KEN,863,22,45,945,1875
2015,Iran (Islamic Rep. of),IRN,Kenya,KEN,5,0,0,0,5
2015,Rwanda,RWA,Kenya,KEN,10,0,12,0,22
2015,Somalia,SOM,Kenya,KEN,75,1263,5,770,2113
2015,Sudan,SDN,Kenya,KEN,149,138,0,292,579
2015,South Sudan,SSD,Kenya,KEN,22,47,0,330,399
2015,Syrian Arab Rep.,SYR,Kenya,KEN,0,0,0,14,14
2015,United Rep. of Tanzania,TZA,Kenya,KEN,0,0,0,10,10
2015,Uganda,UGA,Kenya,KEN,89,0,5,131,225
2015,Yemen,YEM,Kenya,KEN,0,0,0,5,5
2015,Mali,MLI,Liberia,LBR,0,0,0,5,5
2015,Nigeria,NGA,Liberia,LBR,0,0,0,10,10
2015,Sierra Leone,SLE,Liberia,LBR,0,0,0,5,5
2015,Togo,TGO,Liberia,LBR,0,0,0,10,10
2015,Cuba,CUB,Turks and Caicos Islands,TCA,0,0,0,5,5
2016,China,CHN,Bahamas,BHS,0,0,0,5,5
2016,Central African Rep.,CAF,Burkina Faso,BFA,78,0,0,0,78
2016,Chad,TCD,Burkina Faso,BFA,5,0,0,0,5
2016,Dem. Rep. of the Congo,COD,Burkina Faso,BFA,5,0,0,0,5
2016,Rwanda,RWA,Burkina Faso,BFA,5,0,0,0,5
2016,Burundi,BDI,Ethiopia,ETH,5,0,0,0,5
2016,Dem. Rep. of the Congo,COD,Ethiopia,ETH,57,0,0,0,57
2016,Cuba,CUB,Ethiopia,ETH,5,0,0,0,5
2016,Eritrea,ERI,Ethiopia,ETH,5,0,0,0,5
2016,Iraq,IRQ,Ethiopia,ETH,10,0,0,0,10
2016,Liberia,LBR,Ethiopia,ETH,0,0,0,5,5
2016,Somalia,SOM,Ethiopia,ETH,13,0,0,0,13
2016,Sudan,SDN,Ethiopia,ETH,17,0,0,0,17
2016,South Sudan,SSD,Ethiopia,ETH,0,0,0,439,439
2016,Yemen,YEM,Ethiopia,ETH,51,0,0,10,61
2016,Afghanistan,AFG,Kenya,KEN,5,0,0,0,5
2016,Burundi,BDI,Kenya,KEN,985,22,0,2073,3080
2016,Congo,COG,Kenya,KEN,0,0,0,10,10
2016,Dem. Rep. of the Congo,COD,Kenya,KEN,2480,260,0,1307,4047
2016,Eritrea,ERI,Kenya,KEN,19,10,0,60,89
2016,Ethiopia,ETH,Kenya,KEN,1076,107,0,2341,3524
2016,Cote d'Ivoire,CIV,Kenya,KEN,0,0,0,5,5
2016,Iraq,IRQ,Kenya,KEN,0,5,0,0,5
2016,Rwanda,RWA,Kenya,KEN,12,12,0,120,144
2016,Somalia,SOM,Kenya,KEN,45,5,0,487,537
2016,Sudan,SDN,Kenya,KEN,364,5,0,1527,1896
2016,South Sudan,SSD,Kenya,KEN,5,83,0,83,171
2016,United Rep. of Tanzania,TZA,Kenya,KEN,0,0,0,18,18
2016,Uganda,UGA,Kenya,KEN,81,15,10,491,597
2016,Yemen,YEM,Kenya,KEN,18,0,0,10,28
2016,Tibetan,TIB,Kenya,KEN,5,0,0,0,5
2016,Pakistan,PAK,Liberia,LBR,0,5,0,0,5
2017,Cuba,CUB,Bahamas,BHS,0,0,0,5,5
2017,Burundi,BDI,Burkina Faso,BFA,10,0,0,0,10
2017,Central African Rep.,CAF,Burkina Faso,BFA,40,0,0,76,116
2017,Chad,TCD,Burkina Faso,BFA,0,0,0,5,5
2017,Dem. Rep. of the Congo,COD,Burkina Faso,BFA,10,0,0,0,10
2017,Cote d'Ivoire,CIV,Burkina Faso,BFA,0,0,0,5,5
2017,Rwanda,RWA,Burkina Faso,BFA,5,0,0,0,5
2017,Togo,TGO,Burkina Faso,BFA,0,0,0,5,5
2017,Burundi,BDI,Ethiopia,ETH,0,0,0,10,10
2017,Dem. Rep. of the Congo,COD,Ethiopia,ETH,75,0,0,123,198
2017,Eritrea,ERI,Ethiopia,ETH,17,0,0,13,30
2017,Sudan,SDN,Ethiopia,ETH,21,0,0,0,21
2017,Yemen,YEM,Ethiopia,ETH,11,0,0,0,11
2017,Burundi,BDI,Kenya,KEN,258,0,0,111,369
2017,Congo,COG,Kenya,KEN,0,0,0,12,12
2017,Dem. Rep. of the Congo,COD,Kenya,KEN,1419,0,0,186,1605
2017,Eritrea,ERI,Kenya,KEN,32,0,0,41,73
2017,Ethiopia,ETH,Kenya,KEN,418,0,0,1019,1437
2017,Mozambique,MOZ,Kenya,KEN,5,0,0,0,5
2017,Rwanda,RWA,Kenya,KEN,21,0,0,110,131
2017,Sierra Leone,SLE,Kenya,KEN,5,0,0,0,5
2017,Somalia,SOM,Kenya,KEN,35,0,0,1001,1036
2017,Sudan,SDN,Kenya,KEN,35,0,0,13,48
2017,South Sudan,SSD,Kenya,KEN,5,0,0,1215,1220
2017,Uganda,UGA,Kenya,KEN,50,0,0,114,164
2017,Yemen,YEM,Kenya,KEN,44,0,0,22,66
2018,Colombia,COL,Bahamas,BHS,5,0,0,0,5
2018,Central African Rep.,CAF,Congo,COG,760,0,0,0,760
2018,Dem. Rep. of the Congo,COD,Congo,COG,5,0,131,0,136
2018,Mauritania,MRT,Congo,COG,0,0,19,0,19
2018,Rwanda,RWA,Congo,COG,0,0,66,0,66
2018,Syrian Arab Rep.,SYR,Congo,COG,5,0,0,0,5
2018,Eritrea,ERI,Djibouti,DJI,0,0,0,354,354
2018,Ethiopia,ETH,Djibouti,DJI,0,0,0,698,698
2018,Burundi,BDI,Ethiopia,ETH,0,0,0,5,5
2018,Dem. Rep. of the Congo,COD,Ethiopia,ETH,0,5,0,226,231
2018,Eritrea,ERI,Ethiopia,ETH,0,0,0,106,106
2018,Sudan,SDN,Ethiopia,ETH,0,0,0,61,61
2018,South Sudan,SSD,Ethiopia,ETH,0,0,0,428,428
2018,Central African Rep.,CAF,Niger,NER,15,0,0,14,29
2018,Chad,TCD,Niger,NER,0,0,0,23,23
2018,Cameroon,CMR,Niger,NER,5,0,0,40,45
2018,Dem. Rep. of the Congo,COD,Niger,NER,0,0,0,5,5
2018,Eritrea,ERI,Niger,NER,1296,0,0,0,1296
2018,Ethiopia,ETH,Niger,NER,73,0,0,0,73
2018,Guinea-Bissau,GNB,Niger,NER,0,0,0,5,5
2018,Guinea,GIN,Niger,NER,0,0,0,13,13
2018,Cote d'Ivoire,CIV,Niger,NER,0,0,0,5,5
2018,Liberia,LBR,Niger,NER,0,0,0,5,5
2018,Libya,LBY,Niger,NER,0,0,0,14,14
2018,Mali,MLI,Niger,NER,0,0,0,14,14
2018,Nigeria,NGA,Niger,NER,0,0,0,83,83
2018,Pakistan,PAK,Niger,NER,0,0,0,5,5
2018,Sierra Leone,SLE,Niger,NER,0,0,0,5,5
2018,Somalia,SOM,Niger,NER,161,0,0,5,166
2018,Sudan,SDN,Niger,NER,26,0,0,696,722
2018,Syrian Arab Rep.,SYR,Niger,NER,5,0,0,0,5
2018,Togo,TGO,Niger,NER,0,0,0,5,5
2019,Dem. Rep. of the Congo,COD,Ethiopia,ETH,0,0,0,49,49
2019,Djibouti,DJI,Ethiopia,ETH,0,0,0,5,5
2019,Eritrea,ERI,Ethiopia,ETH,5,0,0,90,95
2019,Kenya,KEN,Ethiopia,ETH,0,0,0,429,429
2019,Somalia,SOM,Ethiopia,ETH,0,0,0,29,29
2019,South Sudan,SSD,Ethiopia,ETH,0,0,0,232,232
2019,Yemen,YEM,Ethiopia,ETH,0,0,0,66,66
2019,Eritrea,ERI,Niger,NER,734,0,26,5,765
2019,Ethiopia,ETH,Niger,NER,64,0,24,0,88
2019,Somalia,SOM,Niger,NER,208,0,17,10,235
2019,Sudan,SDN,Niger,NER,93,0,0,0,93
2019,Syrian Arab Rep.,SYR,Niger,NER,5,0,0,0,5
2019,Indonesia,IDN,Solomon Islands,SLB,0,0,0,5,5
2020,Burundi,BDI,Ethiopia,ETH,5,0,0,0,5
2020,Dem. Rep. of the Congo,COD,Ethiopia,ETH,10,0,0,14,24
2020,Eritrea,ERI,Ethiopia,ETH,10,0,0,0,10
2020,Somalia,SOM,Ethiopia,ETH,12,0,0,0,12
2020,South Sudan,SSD,Ethiopia,ETH,5,0,0,0,5
2020,Syrian Arab Rep.,SYR,Ethiopia,ETH,5,0,0,0,5
2020,Yemen,YEM,Ethiopia,ETH,10,0,0,0,10
2020,Eritrea,ERI,Niger,NER,211,0,0,24,235
2020,Ethiopia,ETH,Niger,NER,5,0,0,0,5
2020,Somalia,SOM,Niger,NER,26,0,0,20,46
2020,Sudan,SDN,Niger,NER,29,0,0,21,50
2006,Ethiopia,ETH,Somalia,SOM,5,0,29,0,34
2007,Ethiopia,ETH,Somalia,SOM,29,0,10,0,39
2014,Cuba,CUB,Haiti,HTI,0,0,0,5,5
2000,Cambodia,KHM,Thailand,THA,5,0,10,0,15
2000,China,CHN,Thailand,THA,5,0,18,0,23
2000,Iran (Islamic Rep. of),IRN,Thailand,THA,5,0,10,0,15
2000,Iraq,IRQ,Thailand,THA,5,0,40,0,45
2000,Sri Lanka,LKA,Thailand,THA,0,0,5,0,5
2000,Myanmar,MMR,Thailand,THA,170,0,172,0,342
2000,Somalia,SOM,Thailand,THA,0,0,5,0,5
2000,Unknown ,,Thailand,THA,5,0,30,0,35
2002,Afghanistan,AFG,India,IND,63,0,10,0,73
2002,Ethiopia,ETH,India,IND,0,0,5,0,5
2002,Iran (Islamic Rep. of),IRN,India,IND,5,0,0,0,5
2002,Myanmar,MMR,India,IND,14,0,18,0,32
2002,Somalia,SOM,India,IND,0,0,5,0,5
2002,Sudan,SDN,India,IND,10,0,13,0,23
2003,Afghanistan,AFG,India,IND,0,0,17,0,17
2003,Eritrea,ERI,India,IND,0,0,5,0,5
2003,Ethiopia,ETH,India,IND,0,0,5,0,5
2003,Iran (Islamic Rep. of),IRN,India,IND,5,0,5,0,10
2003,Myanmar,MMR,India,IND,14,0,85,0,99
2003,Somalia,SOM,India,IND,5,0,5,0,10
2003,Sudan,SDN,India,IND,5,0,16,0,21
2003,Burundi,BDI,Kenya,KEN,0,0,5,0,5
2003,Dem. Rep. of the Congo,COD,Kenya,KEN,11,0,31,0,42
2003,Eritrea,ERI,Kenya,KEN,5,0,5,0,10
2003,Ethiopia,ETH,Kenya,KEN,24,0,130,0,154
2003,Rwanda,RWA,Kenya,KEN,0,0,26,0,26
2003,Uganda,UGA,Kenya,KEN,0,0,33,0,33
2003,Dem. Rep. of the Congo,COD,Niger,NER,0,0,27,0,27
2003,Iran (Islamic Rep. of),IRN,United Arab Emirates,ARE,0,0,5,0,5
2004,Afghanistan,AFG,India,IND,10,0,17,0,27
2004,Eritrea,ERI,India,IND,5,0,0,5,10
2004,Ethiopia,ETH,India,IND,0,0,5,0,5
2004,Iran (Islamic Rep. of),IRN,India,IND,0,0,5,0,5
2004,Myanmar,MMR,India,IND,47,0,121,12,180
2004,Somalia,SOM,India,IND,10,0,5,12,27
2004,Sudan,SDN,India,IND,0,0,23,0,23
2004,China,CHN,Kazakhstan,KAZ,10,0,0,0,10
2004,Turkmenistan,TKM,Kazakhstan,KAZ,10,0,0,0,10
2004,Uzbekistan,UZB,Kazakhstan,KAZ,5,0,0,0,5
2004,Burundi,BDI,Kenya,KEN,0,0,5,0,5
2004,Dem. Rep. of the Congo,COD,Kenya,KEN,13,0,17,0,30
2004,Eritrea,ERI,Kenya,KEN,5,0,0,0,5
2004,Ethiopia,ETH,Kenya,KEN,16,0,176,0,192
2004,Rwanda,RWA,Kenya,KEN,0,0,26,0,26
2004,Somalia,SOM,Kenya,KEN,12,0,5,0,17
2004,Uganda,UGA,Kenya,KEN,5,0,19,0,24
2004,Mauritania,MRT,United Arab Emirates,ARE,0,0,5,0,5
2005,Viet Nam,VNM,Cambodia,KHM,63,0,157,34,254
2005,Angola,AGO,"China, Hong Kong SAR",HKG,0,0,5,0,5
2005,Bangladesh,BGD,"China, Hong Kong SAR",HKG,0,0,5,0,5
2005,Cameroon,CMR,"China, Hong Kong SAR",HKG,0,0,10,0,10
2005,Congo,COG,"China, Hong Kong SAR",HKG,0,0,5,0,5
2005,Dem. Rep. of the Congo,COD,"China, Hong Kong SAR",HKG,5,0,12,0,17
2005,Ethiopia,ETH,"China, Hong Kong SAR",HKG,0,0,5,0,5
2005,Ghana,GHA,"China, Hong Kong SAR",HKG,0,0,5,0,5
2005,Iran (Islamic Rep. of),IRN,"China, Hong Kong SAR",HKG,5,0,0,0,5
2005,Liberia,LBR,"China, Hong Kong SAR",HKG,0,0,5,0,5
2005,Sri Lanka,LKA,"China, Hong Kong SAR",HKG,0,0,27,0,27
2005,Nepal,NPL,"China, Hong Kong SAR",HKG,0,0,5,0,5
2005,Nigeria,NGA,"China, Hong Kong SAR",HKG,0,0,20,0,20
2005,Pakistan,PAK,"China, Hong Kong SAR",HKG,5,0,28,0,33
2005,Viet Nam,VNM,"China, Hong Kong SAR",HKG,5,0,0,0,5
2005,Zimbabwe,ZWE,"China, Hong Kong SAR",HKG,0,0,5,0,5
2005,Afghanistan,AFG,India,IND,5,0,5,11,21
2005,Ethiopia,ETH,India,IND,0,0,0,5,5
2005,Iran (Islamic Rep. of),IRN,India,IND,0,0,5,0,5
2005,Myanmar,MMR,India,IND,89,0,49,23,161
2005,Somalia,SOM,India,IND,21,0,5,0,26
2005,Sudan,SDN,India,IND,0,0,5,5,10
2005,Burundi,BDI,Kenya,KEN,5,0,0,0,5
2005,Dem. Rep. of the Congo,COD,Kenya,KEN,20,0,10,0,30
2005,Eritrea,ERI,Kenya,KEN,0,0,5,0,5
2005,Ethiopia,ETH,Kenya,KEN,19,0,125,0,144
2005,Rwanda,RWA,Kenya,KEN,10,0,58,0,68
2005,Somalia,SOM,Kenya,KEN,5,0,5,0,10
2005,Uganda,UGA,Kenya,KEN,0,0,15,0,15
2005,Cambodia,KHM,Thailand,THA,0,0,67,0,67
2005,China,CHN,Thailand,THA,0,0,20,0,20
2005,Cote d'Ivoire,CIV,Thailand,THA,5,0,0,0,5
2005,Iran (Islamic Rep. of),IRN,Thailand,THA,5,0,15,0,20
2005,Lao People's Dem. Rep.,LAO,Thailand,THA,0,0,5,0,5
2005,Sri Lanka,LKA,Thailand,THA,0,0,5,0,5
2005,Myanmar,MMR,Thailand,THA,5,0,23,0,28
2005,Nepal,NPL,Thailand,THA,0,0,5,0,5
2005,Nigeria,NGA,Thailand,THA,0,0,5,0,5
2005,Pakistan,PAK,Thailand,THA,0,0,5,0,5
2005,Viet Nam,VNM,Thailand,THA,0,0,29,0,29
2006,Eritrea,ERI,Egypt,EGY,0,0,10,0,10
2006,Ethiopia,ETH,Egypt,EGY,0,0,27,0,27
2006,Jordan,JOR,Egypt,EGY,0,0,5,0,5
2006,Somalia,SOM,Egypt,EGY,17,0,0,0,17
2006,Tajikistan,TJK,Egypt,EGY,0,0,5,0,5
2006,Viet Nam,VNM,Cambodia,KHM,14,0,93,18,125
2006,Ethiopia,ETH,Djibouti,DJI,19,0,61,0,80
2006,Bangladesh,BGD,"China, Hong Kong SAR",HKG,0,0,10,5,15
2006,Cameroon,CMR,"China, Hong Kong SAR",HKG,0,0,14,5,19
2006,Congo,COG,"China, Hong Kong SAR",HKG,0,0,10,0,10
2006,Dem. Rep. of the Congo,COD,"China, Hong Kong SAR",HKG,0,0,5,0,5
2006,Ghana,GHA,"China, Hong Kong SAR",HKG,0,0,46,16,62
2006,India,IND,"China, Hong Kong SAR",HKG,0,0,33,29,62
2006,Liberia,LBR,"China, Hong Kong SAR",HKG,0,0,10,5,15
2006,Sri Lanka,LKA,"China, Hong Kong SAR",HKG,0,0,48,54,102
2006,Nepal,NPL,"China, Hong Kong SAR",HKG,0,0,10,27,37
2006,Nigeria,NGA,"China, Hong Kong SAR",HKG,0,0,30,10,40
2006,Pakistan,PAK,"China, Hong Kong SAR",HKG,0,0,45,11,56
2006,Philippines,PHL,"China, Hong Kong SAR",HKG,0,0,0,5,5
2006,Togo,TGO,"China, Hong Kong SAR",HKG,0,0,10,0,10
2006,Afghanistan,AFG,India,IND,0,0,12,5,17
2006,Congo,COG,India,IND,0,0,0,5,5
2006,Dem. Rep. of the Congo,COD,India,IND,5,0,0,0,5
2006,Iran (Islamic Rep. of),IRN,India,IND,5,0,5,0,10
2006,Myanmar,MMR,India,IND,34,0,24,5,63
2006,Somalia,SOM,India,IND,0,0,0,5,5
2006,Sudan,SDN,India,IND,5,0,10,0,15
2006,Burundi,BDI,Kenya,KEN,0,0,5,0,5
2006,Dem. Rep. of the Congo,COD,Kenya,KEN,13,0,13,0,26
2006,Eritrea,ERI,Kenya,KEN,5,0,0,0,5
2006,Ethiopia,ETH,Kenya,KEN,93,0,220,0,313
2006,Rwanda,RWA,Kenya,KEN,37,0,46,0,83
2006,Sierra Leone,SLE,Kenya,KEN,0,0,0,5,5
2006,Somalia,SOM,Kenya,KEN,5,0,12,0,17
2006,United Rep. of Tanzania,TZA,Kenya,KEN,5,0,0,0,5
2006,Uganda,UGA,Kenya,KEN,5,0,5,0,10
2006,Algeria,DZA,Lebanon,LBN,0,0,5,0,5
2006,Egypt,EGY,Lebanon,LBN,0,0,5,0,5
2006,Iraq,IRQ,Lebanon,LBN,12,0,85,0,97
2006,Somalia,SOM,Lebanon,LBN,0,0,5,0,5
2006,Sudan,SDN,Lebanon,LBN,0,0,29,0,29
2006,Syrian Arab Rep.,SYR,Lebanon,LBN,0,0,12,0,12
2006,Iraq,IRQ,Nepal,NPL,5,0,0,0,5
2006,Pakistan,PAK,Nepal,NPL,68,0,64,5,137
2006,Burundi,BDI,Rwanda,RWA,5,0,0,71,76
2006,Dem. Rep. of the Congo,COD,Rwanda,RWA,129,0,0,121,250
2006,Somalia,SOM,Rwanda,RWA,0,0,0,5,5
2006,Uganda,UGA,Rwanda,RWA,0,0,0,11,11
2006,Afghanistan,AFG,Syrian Arab Rep.,SYR,41,0,0,0,41
2006,Eritrea,ERI,Syrian Arab Rep.,SYR,5,0,0,0,5
2006,Iran (Islamic Rep. of),IRN,Syrian Arab Rep.,SYR,12,0,17,0,29
2006,Kenya,KEN,Syrian Arab Rep.,SYR,0,0,0,5,5
2006,Somalia,SOM,Syrian Arab Rep.,SYR,135,0,19,0,154
2006,Sudan,SDN,Syrian Arab Rep.,SYR,11,0,22,0,33
2006,Cambodia,KHM,Thailand,THA,0,0,93,16,109
2006,China,CHN,Thailand,THA,5,0,11,5,21
2006,Dem. Rep. of the Congo,COD,Thailand,THA,0,0,5,0,5
2006,India,IND,Thailand,THA,0,0,5,0,5
2006,Lao People's Dem. Rep.,LAO,Thailand,THA,12,0,0,0,12
2006,Sri Lanka,LKA,Thailand,THA,5,0,18,0,23
2006,Myanmar,MMR,Thailand,THA,5,0,0,0,5
2006,Nepal,NPL,Thailand,THA,0,0,15,0,15
2006,Sierra Leone,SLE,Thailand,THA,0,0,5,0,5
2006,Somalia,SOM,Thailand,THA,5,0,0,0,5
2006,Viet Nam,VNM,Thailand,THA,15,0,24,5,44
2006,Afghanistan,AFG,Turkey,TUR,20,0,0,0,20
2006,Eritrea,ERI,Turkey,TUR,5,0,0,0,5
2006,Iran (Islamic Rep. of),IRN,Turkey,TUR,185,0,112,0,297
2006,Iraq,IRQ,Turkey,TUR,5,0,0,0,5
2006,Somalia,SOM,Turkey,TUR,12,0,36,0,48
2006,Sudan,SDN,Turkey,TUR,0,0,5,0,5
2006,Tunisia,TUN,Turkey,TUR,0,0,5,0,5
2007,Dem. Rep. of the Congo,COD,Egypt,EGY,0,0,0,5,5
2007,Eritrea,ERI,Egypt,EGY,0,0,24,5,29
2007,Ethiopia,ETH,Egypt,EGY,0,0,79,5,84
2007,Cote d'Ivoire,CIV,Egypt,EGY,0,0,5,0,5
2007,Iraq,IRQ,Egypt,EGY,5,0,0,0,5
2007,Somalia,SOM,Egypt,EGY,58,0,0,0,58
2007,Sudan,SDN,Egypt,EGY,18,0,204,0,222
2007,Uzbekistan,UZB,Egypt,EGY,5,0,0,0,5
2007,Viet Nam,VNM,Cambodia,KHM,24,0,137,10,171
2007,Angola,AGO,"China, Hong Kong SAR",HKG,0,0,5,0,5
2007,Bangladesh,BGD,"China, Hong Kong SAR",HKG,0,0,63,0,63
2007,Congo,COG,"China, Hong Kong SAR",HKG,0,0,5,0,5
2007,Ghana,GHA,"China, Hong Kong SAR",HKG,0,0,14,10,24
2007,Guinea,GIN,"China, Hong Kong SAR",HKG,0,0,5,0,5
2007,India,IND,"China, Hong Kong SAR",HKG,0,0,98,0,98
2007,Indonesia,IDN,"China, Hong Kong SAR",HKG,0,0,5,0,5
2007,Sri Lanka,LKA,"China, Hong Kong SAR",HKG,0,0,18,43,61
2007,Nepal,NPL,"China, Hong Kong SAR",HKG,0,0,127,80,207
2007,Nigeria,NGA,"China, Hong Kong SAR",HKG,0,0,5,10,15
2007,Pakistan,PAK,"China, Hong Kong SAR",HKG,0,0,151,11,162
2007,Philippines,PHL,"China, Hong Kong SAR",HKG,0,0,5,0,5
2007,Togo,TGO,"China, Hong Kong SAR",HKG,0,0,10,0,10
2007,Afghanistan,AFG,India,IND,5,0,26,5,36
2007,Dem. Rep. of the Congo,COD,India,IND,0,0,5,0,5
2007,Iran (Islamic Rep. of),IRN,India,IND,0,0,5,0,5
2007,Myanmar,MMR,India,IND,10,0,5,5,20
2007,Somalia,SOM,India,IND,0,0,5,5,10
2007,Burundi,BDI,Kenya,KEN,0,0,5,0,5
2007,Dem. Rep. of the Congo,COD,Kenya,KEN,23,0,24,10,57
2007,Eritrea,ERI,Kenya,KEN,0,0,5,0,5
2007,Ethiopia,ETH,Kenya,KEN,72,0,233,82,387
2007,Rwanda,RWA,Kenya,KEN,19,0,46,5,70
2007,Somalia,SOM,Kenya,KEN,17,0,0,0,17
2007,Sudan,SDN,Kenya,KEN,0,0,10,0,10
2007,Uganda,UGA,Kenya,KEN,0,0,53,22,75
2007,Egypt,EGY,Lebanon,LBN,5,0,0,0,5
2007,Bangladesh,BGD,Lebanon,LBN,0,0,5,0,5
2007,Iran (Islamic Rep. of),IRN,Lebanon,LBN,0,0,5,0,5
2007,Iraq,IRQ,Lebanon,LBN,5,0,10,0,15
2007,Somalia,SOM,Lebanon,LBN,0,0,5,0,5
2007,Sudan,SDN,Lebanon,LBN,0,0,37,0,37
2007,Syrian Arab Rep.,SYR,Lebanon,LBN,10,0,5,0,15
2007,Benin,BEN,Morocco,MAR,0,0,5,0,5
2007,Cameroon,CMR,Morocco,MAR,0,0,12,0,12
2007,Congo,COG,Morocco,MAR,0,0,16,0,16
2007,Dem. Rep. of the Congo,COD,Morocco,MAR,0,0,247,0,247
2007,Gambia,GMB,Morocco,MAR,0,0,12,0,12
2007,Ghana,GHA,Morocco,MAR,0,0,22,0,22
2007,Guinea,GIN,Morocco,MAR,0,0,5,0,5
2007,Cote d'Ivoire,CIV,Morocco,MAR,0,0,10,0,10
2007,Liberia,LBR,Morocco,MAR,0,0,32,0,32
2007,Mali,MLI,Morocco,MAR,0,0,5,0,5
2007,Niger,NER,Morocco,MAR,0,0,5,0,5
2007,Nigeria,NGA,Morocco,MAR,0,0,177,0,177
2007,Rwanda,RWA,Morocco,MAR,0,0,5,0,5
2007,Sierra Leone,SLE,Morocco,MAR,0,0,14,0,14
2007,Pakistan,PAK,Nepal,NPL,5,0,29,0,34
2007,Burundi,BDI,Rwanda,RWA,25,0,0,0,25
2007,Dem. Rep. of the Congo,COD,Rwanda,RWA,44,0,0,0,44
2007,Afghanistan,AFG,Syrian Arab Rep.,SYR,19,0,14,0,33
2007,Ethiopia,ETH,Syrian Arab Rep.,SYR,0,0,5,0,5
2007,Iran (Islamic Rep. of),IRN,Syrian Arab Rep.,SYR,0,0,18,0,18
2007,Somalia,SOM,Syrian Arab Rep.,SYR,62,0,12,0,74
2007,Sudan,SDN,Syrian Arab Rep.,SYR,16,0,14,0,30
2007,Syrian Arab Rep.,SYR,Syrian Arab Rep.,SYR,0,0,0,5,5
2007,Cambodia,KHM,Thailand,THA,5,0,31,5,41
2007,China,CHN,Thailand,THA,5,0,5,0,10
2007,Cameroon,CMR,Thailand,THA,0,0,5,0,5
2007,Dem. Rep. of the Congo,COD,Thailand,THA,0,0,10,14,24
2007,Iran (Islamic Rep. of),IRN,Thailand,THA,0,0,0,5,5
2007,Sri Lanka,LKA,Thailand,THA,5,0,0,5,10
2007,Nepal,NPL,Thailand,THA,0,0,19,5,24
2007,Nigeria,NGA,Thailand,THA,0,0,5,5,10
2007,Viet Nam,VNM,Thailand,THA,0,0,22,0,22
2007,Afghanistan,AFG,Turkey,TUR,17,0,18,0,35
2007,Eritrea,ERI,Turkey,TUR,0,0,5,0,5
2007,Ethiopia,ETH,Turkey,TUR,0,0,5,10,15
2007,Palestinian,PSE,Turkey,TUR,0,0,0,5,5
2007,Iran (Islamic Rep. of),IRN,Turkey,TUR,76,0,68,121,265
2007,Iraq,IRQ,Turkey,TUR,27,0,0,30,57
2007,Liberia,LBR,Turkey,TUR,0,0,0,5,5
2007,Somalia,SOM,Turkey,TUR,23,0,12,22,57
2007,Sudan,SDN,Turkey,TUR,0,0,5,5,10
2007,Syrian Arab Rep.,SYR,Turkey,TUR,0,0,0,5,5
2008,Chad,TCD,Egypt,EGY,0,0,0,5,5
2008,Eritrea,ERI,Egypt,EGY,5,0,99,0,104
2008,Ethiopia,ETH,Egypt,EGY,5,0,74,5,84
2008,Sudan,SDN,Egypt,EGY,20,0,77,5,102
2008,Viet Nam,VNM,Cambodia,KHM,0,0,278,12,290
2008,Bangladesh,BGD,"China, Hong Kong SAR",HKG,0,0,137,5,142
2008,Cameroon,CMR,"China, Hong Kong SAR",HKG,0,0,5,0,5
2008,Congo,COG,"China, Hong Kong SAR",HKG,0,0,5,0,5
2008,Dem. Rep. of the Congo,COD,"China, Hong Kong SAR",HKG,0,0,5,0,5
2008,Ghana,GHA,"China, Hong Kong SAR",HKG,0,0,5,5,10
2008,India,IND,"China, Hong Kong SAR",HKG,0,0,74,12,86
2008,Indonesia,IDN,"China, Hong Kong SAR",HKG,0,0,5,0,5
2008,Liberia,LBR,"China, Hong Kong SAR",HKG,0,0,5,0,5
2008,Sri Lanka,LKA,"China, Hong Kong SAR",HKG,0,0,29,5,34
2008,Nepal,NPL,"China, Hong Kong SAR",HKG,0,0,140,21,161
2008,Nigeria,NGA,"China, Hong Kong SAR",HKG,0,0,5,0,5
2008,Pakistan,PAK,"China, Hong Kong SAR",HKG,0,0,145,17,162
2008,Philippines,PHL,"China, Hong Kong SAR",HKG,0,0,65,5,70
2008,Somalia,SOM,"China, Hong Kong SAR",HKG,5,0,0,0,5
2008,Togo,TGO,"China, Hong Kong SAR",HKG,0,0,23,0,23
2008,Afghanistan,AFG,India,IND,23,0,114,10,147
2008,Dem. Rep. of the Congo,COD,India,IND,0,0,0,5,5
2008,Iran (Islamic Rep. of),IRN,India,IND,10,0,5,5,20
2008,Myanmar,MMR,India,IND,12,0,11,33,56
2008,Somalia,SOM,India,IND,16,0,0,13,29
2008,Sudan,SDN,Jordan,JOR,0,0,5,0,5
2008,Burundi,BDI,Kenya,KEN,5,0,5,5,15
2008,Dem. Rep. of the Congo,COD,Kenya,KEN,14,0,0,0,14
2008,Eritrea,ERI,Kenya,KEN,11,0,0,0,11
2008,Ethiopia,ETH,Kenya,KEN,201,0,60,51,312
2008,Rwanda,RWA,Kenya,KEN,0,0,33,0,33
2008,Somalia,SOM,Kenya,KEN,16,0,0,0,16
2008,Sudan,SDN,Kenya,KEN,65,0,38,0,103
2008,Uganda,UGA,Kenya,KEN,5,0,49,5,59
2008,Dem. Rep. of the Congo,COD,Libya,LBY,0,0,10,0,10
2008,Eritrea,ERI,Libya,LBY,5,0,0,0,5
2008,Ethiopia,ETH,Libya,LBY,5,0,0,0,5
2008,Iraq,IRQ,Libya,LBY,37,0,0,0,37
2008,Somalia,SOM,Libya,LBY,5,0,0,0,5
2008,Sudan,SDN,Libya,LBY,23,0,0,0,23
2008,Ethiopia,ETH,Lebanon,LBN,0,0,5,0,5
2008,Somalia,SOM,Lebanon,LBN,0,0,11,0,11
2008,Sudan,SDN,Lebanon,LBN,5,0,88,0,93
2008,Syrian Arab Rep.,SYR,Lebanon,LBN,0,0,5,0,5
2008,Chad,TCD,Morocco,MAR,0,0,5,0,5
2008,Cameroon,CMR,Morocco,MAR,0,0,13,0,13
2008,Congo,COG,Morocco,MAR,0,0,5,0,5
2008,Dem. Rep. of the Congo,COD,Morocco,MAR,0,0,188,0,188
2008,Ghana,GHA,Morocco,MAR,0,0,5,0,5
2008,Cote d'Ivoire,CIV,Morocco,MAR,0,0,21,0,21
2008,Liberia,LBR,Morocco,MAR,0,0,10,0,10
2008,Niger,NER,Morocco,MAR,0,0,5,0,5
2008,Nigeria,NGA,Morocco,MAR,0,0,63,0,63
2008,Sierra Leone,SLE,Morocco,MAR,0,0,10,0,10
2008,Uganda,UGA,Morocco,MAR,0,0,5,0,5
2008,Pakistan,PAK,Nepal,NPL,0,0,5,0,5
2008,Burundi,BDI,Rwanda,RWA,0,0,0,14,14
2008,Dem. Rep. of the Congo,COD,Rwanda,RWA,5,0,0,18,23
2008,Afghanistan,AFG,Syrian Arab Rep.,SYR,21,0,0,0,21
2008,Algeria,DZA,Syrian Arab Rep.,SYR,0,0,5,0,5
2008,Egypt,EGY,Syrian Arab Rep.,SYR,0,0,10,0,10
2008,Eritrea,ERI,Syrian Arab Rep.,SYR,0,0,0,5,5
2008,Ethiopia,ETH,Syrian Arab Rep.,SYR,0,0,5,0,5
2008,Iran (Islamic Rep. of),IRN,Syrian Arab Rep.,SYR,10,0,22,0,32
2008,Jordan,JOR,Syrian Arab Rep.,SYR,0,0,5,0,5
2008,Kuwait,KWT,Syrian Arab Rep.,SYR,0,0,0,12,12
2008,Sri Lanka,LKA,Syrian Arab Rep.,SYR,0,0,5,0,5
2008,Somalia,SOM,Syrian Arab Rep.,SYR,52,0,10,34,96
2008,Sudan,SDN,Syrian Arab Rep.,SYR,5,0,38,10,53
2008,Stateless,XXA,Syrian Arab Rep.,SYR,5,0,0,5,10
2008,Cambodia,KHM,Thailand,THA,0,0,10,0,10
2008,China,CHN,Thailand,THA,5,0,29,5,39
2008,Ethiopia,ETH,Thailand,THA,0,0,5,0,5
2008,Iran (Islamic Rep. of),IRN,Thailand,THA,0,0,5,0,5
2008,Iraq,IRQ,Thailand,THA,5,0,0,0,5
2008,Sri Lanka,LKA,Thailand,THA,5,0,41,5,51
2008,Nepal,NPL,Thailand,THA,0,0,10,0,10
2008,Somalia,SOM,Thailand,THA,0,0,0,10,10
2008,Viet Nam,VNM,Thailand,THA,0,0,10,0,10
2008,Afghanistan,AFG,Turkey,TUR,41,0,5,63,109
2008,China,CHN,Turkey,TUR,0,0,0,5,5
2008,Dem. Rep. of the Congo,COD,Turkey,TUR,5,0,0,30,35
2008,Eritrea,ERI,Turkey,TUR,5,0,0,11,16
2008,Ethiopia,ETH,Turkey,TUR,0,0,11,20,31
2008,Palestinian,PSE,Turkey,TUR,0,0,0,12,12
2008,Guinea,GIN,Turkey,TUR,0,0,0,5,5
2008,Cote d'Ivoire,CIV,Turkey,TUR,5,0,5,5,15
2008,Iran (Islamic Rep. of),IRN,Turkey,TUR,109,0,95,103,307
2008,Iraq,IRQ,Turkey,TUR,27,0,5,54,86
2008,Sri Lanka,LKA,Turkey,TUR,0,0,0,5,5
2008,Mauritania,MRT,Turkey,TUR,0,0,5,5,10
2008,Morocco,MAR,Turkey,TUR,0,0,5,0,5
2008,Nigeria,NGA,Turkey,TUR,0,0,0,5,5
2008,Pakistan,PAK,Turkey,TUR,0,0,10,0,10
2008,Somalia,SOM,Turkey,TUR,57,0,11,157,225
2008,Sudan,SDN,Turkey,TUR,10,0,10,25,45
2008,United States of America,USA,Turkey,TUR,0,0,5,0,5
2008,Uzbekistan,UZB,Turkey,TUR,0,0,5,0,5
2009,Chad,TCD,Algeria,DZA,0,0,19,0,19
2009,Cameroon,CMR,Algeria,DZA,0,0,63,0,63
2009,Congo,COG,Algeria,DZA,0,0,10,0,10
2009,Dem. Rep. of the Congo,COD,Algeria,DZA,0,0,85,0,85
2009,Cote d'Ivoire,CIV,Algeria,DZA,0,0,45,0,45
2009,Liberia,LBR,Algeria,DZA,0,0,95,0,95
2009,Nigeria,NGA,Algeria,DZA,0,0,73,0,73
2009,Eritrea,ERI,Egypt,EGY,23,0,10,18,51
2009,Ethiopia,ETH,Egypt,EGY,10,0,20,27,57
2009,Cote d'Ivoire,CIV,Egypt,EGY,0,0,10,0,10
2009,Somalia,SOM,Egypt,EGY,5,0,0,15,20
2009,Sudan,SDN,Egypt,EGY,20,0,146,30,196
2009,Myanmar,MMR,Cambodia,KHM,0,0,5,0,5
2009,Viet Nam,VNM,Cambodia,KHM,0,0,49,0,49
2009,Bangladesh,BGD,"China, Hong Kong SAR",HKG,0,0,62,24,86
2009,Congo,COG,"China, Hong Kong SAR",HKG,0,0,5,0,5
2009,Dem. Rep. of the Congo,COD,"China, Hong Kong SAR",HKG,0,0,5,5,10
2009,Cote d'Ivoire,CIV,"China, Hong Kong SAR",HKG,0,0,5,0,5
2009,India,IND,"China, Hong Kong SAR",HKG,0,0,37,0,37
2009,Indonesia,IDN,"China, Hong Kong SAR",HKG,0,0,95,0,95
2009,Kenya,KEN,"China, Hong Kong SAR",HKG,0,0,5,0,5
2009,Sri Lanka,LKA,"China, Hong Kong SAR",HKG,0,0,15,5,20
2009,Nepal,NPL,"China, Hong Kong SAR",HKG,0,0,28,5,33
2009,Niger,NER,"China, Hong Kong SAR",HKG,0,0,5,0,5
2009,Nigeria,NGA,"China, Hong Kong SAR",HKG,0,0,11,5,16
2009,Pakistan,PAK,"China, Hong Kong SAR",HKG,5,0,57,27,89
2009,Philippines,PHL,"China, Hong Kong SAR",HKG,0,0,113,17,130
2009,Togo,TGO,"China, Hong Kong SAR",HKG,0,0,5,0,5
2009,Afghanistan,AFG,India,IND,74,0,212,0,286
2009,Eritrea,ERI,India,IND,5,0,0,0,5
2009,Ethiopia,ETH,India,IND,0,0,5,0,5
2009,Iran (Islamic Rep. of),IRN,India,IND,0,0,13,0,13
2009,Iraq,IRQ,India,IND,0,0,0,10,10
2009,Myanmar,MMR,India,IND,24,0,0,0,24
2009,Somalia,SOM,India,IND,40,0,5,0,45
2009,Afghanistan,AFG,Indonesia,IDN,0,0,10,0,10
2009,Algeria,DZA,Indonesia,IDN,0,0,5,0,5
2009,Iran (Islamic Rep. of),IRN,Indonesia,IDN,5,0,0,0,5
2009,Pakistan,PAK,Indonesia,IDN,0,0,5,0,5
2009,Somalia,SOM,Indonesia,IDN,0,0,5,0,5
2009,Viet Nam,VNM,Indonesia,IDN,0,0,10,0,10
2009,Burundi,BDI,Israel,ISR,0,0,0,5,5
2009,Cameroon,CMR,Israel,ISR,0,0,0,5,5
2009,Colombia,COL,Israel,ISR,0,0,0,10,10
2009,Ethiopia,ETH,Israel,ISR,0,0,0,12,12
2009,Georgia,GEO,Israel,ISR,0,0,0,5,5
2009,Ghana,GHA,Israel,ISR,0,0,0,63,63
2009,Guinea,GIN,Israel,ISR,0,0,0,5,5
2009,Cote d'Ivoire,CIV,Israel,ISR,0,0,0,412,412
2009,Kenya,KEN,Israel,ISR,0,0,0,12,12
2009,Liberia,LBR,Israel,ISR,0,0,0,10,10
2009,Mali,MLI,Israel,ISR,0,0,0,5,5
2009,Myanmar,MMR,Israel,ISR,0,0,0,5,5
2009,Nigeria,NGA,Israel,ISR,0,0,0,182,182
2009,Philippines,PHL,Israel,ISR,0,0,0,12,12
2009,Togo,TGO,Israel,ISR,0,0,0,5,5
2009,Turkey,TUR,Israel,ISR,0,0,0,27,27
2009,Egypt,EGY,Jordan,JOR,0,0,27,0,27
2009,Ghana,GHA,Jordan,JOR,0,0,10,0,10
2009,Lebanon,LBN,Jordan,JOR,0,0,5,0,5
2009,Saudi Arabia,SAU,Jordan,JOR,0,0,5,0,5
2009,Sudan,SDN,Jordan,JOR,14,0,24,0,38
2009,Syrian Arab Rep.,SYR,Jordan,JOR,5,0,0,0,5
2009,Burundi,BDI,Kenya,KEN,23,0,20,5,48
2009,Dem. Rep. of the Congo,COD,Kenya,KEN,45,0,56,5,106
2009,Eritrea,ERI,Kenya,KEN,5,0,0,0,5
2009,Ethiopia,ETH,Kenya,KEN,281,0,83,41,405
2009,Rwanda,RWA,Kenya,KEN,24,0,81,0,105
2009,Somalia,SOM,Kenya,KEN,12,0,0,5,17
2009,Sudan,SDN,Kenya,KEN,62,0,71,5,138
2009,Uganda,UGA,Kenya,KEN,0,0,20,5,25
2009,Afghanistan,AFG,Kyrgyzstan,KGZ,73,0,17,60,150
2009,Uzbekistan,UZB,Kyrgyzstan,KGZ,93,0,0,5,98
2009,Chad,TCD,Libya,LBY,0,0,0,5,5
2009,Dem. Rep. of the Congo,COD,Libya,LBY,0,0,0,5,5
2009,Ethiopia,ETH,Libya,LBY,0,0,0,5,5
2009,Iraq,IRQ,Libya,LBY,0,0,0,5,5
2009,Somalia,SOM,Libya,LBY,0,0,0,5,5
2009,Sudan,SDN,Libya,LBY,11,0,10,0,21
2009,Iran (Islamic Rep. of),IRN,Lebanon,LBN,0,0,5,0,5
2009,Iraq,IRQ,Lebanon,LBN,0,0,5,59,64
2009,Sudan,SDN,Lebanon,LBN,0,0,53,17,70
2009,Syrian Arab Rep.,SYR,Lebanon,LBN,0,0,15,0,15
2009,Angola,AGO,Morocco,MAR,0,0,5,0,5
2009,Cameroon,CMR,Morocco,MAR,0,0,5,0,5
2009,Dem. Rep. of the Congo,COD,Morocco,MAR,5,0,87,0,92
2009,Eritrea,ERI,Morocco,MAR,0,0,5,0,5
2009,Guinea,GIN,Morocco,MAR,0,0,5,0,5
2009,Cote d'Ivoire,CIV,Morocco,MAR,5,0,13,0,18
2009,Kenya,KEN,Morocco,MAR,0,0,5,0,5
2009,Liberia,LBR,Morocco,MAR,0,0,10,0,10
2009,Nigeria,NGA,Morocco,MAR,0,0,22,0,22
2009,Sudan,SDN,Morocco,MAR,0,0,5,0,5
2009,Somalia,SOM,Nepal,NPL,5,0,0,0,5
2009,Afghanistan,AFG,Syrian Arab Rep.,SYR,10,0,0,5,15
2009,Ethiopia,ETH,Syrian Arab Rep.,SYR,0,0,5,0,5
2009,Iran (Islamic Rep. of),IRN,Syrian Arab Rep.,SYR,5,0,16,0,21
2009,Jordan,JOR,Syrian Arab Rep.,SYR,0,0,5,0,5
2009,Somalia,SOM,Syrian Arab Rep.,SYR,10,0,0,0,10
2009,Sudan,SDN,Syrian Arab Rep.,SYR,0,0,18,0,18
2009,Bangladesh,BGD,Thailand,THA,0,0,5,0,5
2009,Cambodia,KHM,Thailand,THA,0,0,5,0,5
2009,China,CHN,Thailand,THA,5,0,15,0,20
2009,Dem. Rep. of the Congo,COD,Thailand,THA,5,0,5,0,10
2009,Cote d'Ivoire,CIV,Thailand,THA,0,0,5,0,5
2009,India,IND,Thailand,THA,0,0,5,0,5
2009,Iran (Islamic Rep. of),IRN,Thailand,THA,0,0,5,0,5
2009,Iraq,IRQ,Thailand,THA,0,0,5,0,5
2009,Sri Lanka,LKA,Thailand,THA,70,0,10,5,85
2009,Somalia,SOM,Thailand,THA,16,0,0,0,16
2009,Viet Nam,VNM,Thailand,THA,0,0,10,12,22
2009,Afghanistan,AFG,Turkey,TUR,20,0,5,170,195
2009,Egypt,EGY,Turkey,TUR,0,0,0,5,5
2009,Congo,COG,Turkey,TUR,0,0,0,5,5
2009,Dem. Rep. of the Congo,COD,Turkey,TUR,0,0,0,5,5
2009,Ethiopia,ETH,Turkey,TUR,0,0,0,5,5
2009,Palestinian,PSE,Turkey,TUR,0,0,0,5,5
2009,Guinea,GIN,Turkey,TUR,0,0,0,5,5
2009,Cote d'Ivoire,CIV,Turkey,TUR,0,0,5,0,5
2009,Iran (Islamic Rep. of),IRN,Turkey,TUR,58,0,60,62,180
2009,Iraq,IRQ,Turkey,TUR,5,0,5,23,33
2009,Sri Lanka,LKA,Turkey,TUR,10,0,0,5,15
2009,Nigeria,NGA,Turkey,TUR,0,0,0,5,5
2009,Sierra Leone,SLE,Turkey,TUR,0,0,0,5,5
2009,Somalia,SOM,Turkey,TUR,12,0,17,10,39
2009,Sudan,SDN,Turkey,TUR,5,0,5,5,15
2010,Cameroon,CMR,Algeria,DZA,0,0,35,0,35
2010,Congo,COG,Algeria,DZA,0,0,5,0,5
2010,Dem. Rep. of the Congo,COD,Algeria,DZA,0,0,16,0,16
2010,Cote d'Ivoire,CIV,Algeria,DZA,0,0,15,0,15
2010,Liberia,LBR,Algeria,DZA,0,0,27,0,27
2010,Niger,NER,Algeria,DZA,0,0,5,0,5
2010,Nigeria,NGA,Algeria,DZA,0,0,22,0,22
2010,Sierra Leone,SLE,Algeria,DZA,0,0,5,0,5
2010,Eritrea,ERI,Egypt,EGY,10,0,36,0,46
2010,Ethiopia,ETH,Egypt,EGY,10,0,44,0,54
2010,Somalia,SOM,Egypt,EGY,0,0,0,5,5
2010,Sudan,SDN,Egypt,EGY,5,0,67,0,72
2010,Viet Nam,VNM,Cambodia,KHM,0,0,5,0,5
2010,Bangladesh,BGD,"China, Hong Kong SAR",HKG,0,0,15,5,20
2010,Cameroon,CMR,"China, Hong Kong SAR",HKG,0,0,5,0,5
2010,Dem. Rep. of the Congo,COD,"China, Hong Kong SAR",HKG,0,0,5,0,5
2010,India,IND,"China, Hong Kong SAR",HKG,0,0,22,0,22
2010,Indonesia,IDN,"China, Hong Kong SAR",HKG,0,0,38,0,38
2010,Liberia,LBR,"China, Hong Kong SAR",HKG,0,0,5,0,5
2010,Sri Lanka,LKA,"China, Hong Kong SAR",HKG,0,0,28,0,28
2010,Nepal,NPL,"China, Hong Kong SAR",HKG,0,0,23,0,23
2010,Nigeria,NGA,"China, Hong Kong SAR",HKG,0,0,5,0,5
2010,Pakistan,PAK,"China, Hong Kong SAR",HKG,0,0,30,0,30
2010,Philippines,PHL,"China, Hong Kong SAR",HKG,0,0,19,0,19
2010,Togo,TGO,"China, Hong Kong SAR",HKG,0,0,5,0,5
2010,Afghanistan,AFG,India,IND,90,0,439,582,1111
2010,Egypt,EGY,India,IND,0,0,5,0,5
2010,Dem. Rep. of the Congo,COD,India,IND,0,0,11,0,11
2010,Palestinian,PSE,India,IND,0,0,0,5,5
2010,Iran (Islamic Rep. of),IRN,India,IND,5,0,5,0,10
2010,Iraq,IRQ,India,IND,0,0,0,5,5
2010,Myanmar,MMR,India,IND,13,0,0,46,59
2010,Somalia,SOM,India,IND,0,0,0,5,5
2010,Sudan,SDN,India,IND,0,0,0,5,5
2010,Afghanistan,AFG,Jordan,JOR,0,0,5,5,10
2010,Algeria,DZA,Jordan,JOR,0,0,5,0,5
2010,Egypt,EGY,Jordan,JOR,0,0,49,0,49
2010,Iraq,IRQ,Jordan,JOR,0,10,38,11,59
2010,Pakistan,PAK,Jordan,JOR,0,0,10,0,10
2010,Somalia,SOM,Jordan,JOR,5,0,0,0,5
2010,Sudan,SDN,Jordan,JOR,10,5,38,0,53
2010,Syrian Arab Rep.,SYR,Jordan,JOR,5,0,19,0,24
2010,Tunisia,TUN,Jordan,JOR,0,0,5,5,10
2010,Turkey,TUR,Jordan,JOR,0,0,10,0,10
2010,Yemen,YEM,Jordan,JOR,0,0,0,10,10
2010,Burundi,BDI,Kenya,KEN,0,0,5,0,5
2010,Dem. Rep. of the Congo,COD,Kenya,KEN,20,0,10,0,30
2010,Eritrea,ERI,Kenya,KEN,0,0,5,0,5
2010,Ethiopia,ETH,Kenya,KEN,135,0,85,12,232
2010,Pakistan,PAK,Kenya,KEN,5,0,5,0,10
2010,Rwanda,RWA,Kenya,KEN,26,0,10,0,36
2010,Somalia,SOM,Kenya,KEN,33,0,0,0,33
2010,Sudan,SDN,Kenya,KEN,26,0,64,0,90
2010,United Rep. of Tanzania,TZA,Kenya,KEN,0,0,0,5,5
2010,Uganda,UGA,Kenya,KEN,10,0,5,0,15
2010,Ethiopia,ETH,Lebanon,LBN,0,0,5,0,5
2010,Iraq,IRQ,Lebanon,LBN,0,0,10,5,15
2010,Saudi Arabia,SAU,Lebanon,LBN,0,0,0,5,5
2010,Somalia,SOM,Lebanon,LBN,0,0,0,5,5
2010,Sudan,SDN,Lebanon,LBN,10,0,103,26,139
2010,Syrian Arab Rep.,SYR,Lebanon,LBN,0,0,38,5,43
2010,Afghanistan,AFG,Malaysia,MYS,58,0,0,0,58
2010,Cambodia,KHM,Malaysia,MYS,0,0,15,0,15
2010,China,CHN,Malaysia,MYS,5,0,5,0,10
2010,Cameroon,CMR,Malaysia,MYS,0,0,5,0,5
2010,Sri Lanka,LKA,Malaysia,MYS,0,0,74,0,74
2010,Myanmar,MMR,Malaysia,MYS,68,0,29,5,102
2010,Nepal,NPL,Malaysia,MYS,0,0,5,0,5
2010,Pakistan,PAK,Malaysia,MYS,0,0,5,0,5
2010,Sierra Leone,SLE,Malaysia,MYS,5,0,0,0,5
2010,Somalia,SOM,Malaysia,MYS,5,0,0,0,5
2010,Viet Nam,VNM,Malaysia,MYS,0,0,10,0,10
2010,Algeria,DZA,Morocco,MAR,0,0,5,0,5
2010,Benin,BEN,Morocco,MAR,0,0,5,0,5
2010,Bangladesh,BGD,Morocco,MAR,0,0,5,0,5
2010,Cameroon,CMR,Morocco,MAR,0,0,17,0,17
2010,Congo,COG,Morocco,MAR,0,0,10,0,10
2010,Dem. Rep. of the Congo,COD,Morocco,MAR,10,0,149,0,159
2010,Eritrea,ERI,Morocco,MAR,0,0,5,0,5
2010,Palestinian,PSE,Morocco,MAR,0,0,10,0,10
2010,Ghana,GHA,Morocco,MAR,0,0,5,0,5
2010,Iraq,IRQ,Morocco,MAR,0,0,32,0,32
2010,Liberia,LBR,Morocco,MAR,0,0,5,0,5
2010,Mali,MLI,Morocco,MAR,0,0,19,0,19
2010,Nigeria,NGA,Morocco,MAR,0,0,44,0,44
2010,Senegal,SEN,Morocco,MAR,0,0,5,0,5
2010,Somalia,SOM,Morocco,MAR,0,0,14,0,14
2010,Sudan,SDN,Morocco,MAR,0,0,5,0,5
2010,Tunisia,TUN,Morocco,MAR,0,0,12,0,12
2010,Uganda,UGA,Morocco,MAR,0,0,12,0,12
2010,Zimbabwe,ZWE,Morocco,MAR,0,0,5,0,5
2010,Myanmar,MMR,Nepal,NPL,5,0,5,0,10
2010,Pakistan,PAK,Nepal,NPL,5,0,0,0,5
2010,Afghanistan,AFG,Syrian Arab Rep.,SYR,0,0,0,13,13
2010,Egypt,EGY,Syrian Arab Rep.,SYR,0,0,5,0,5
2010,Iran (Islamic Rep. of),IRN,Syrian Arab Rep.,SYR,0,0,5,5,10
2010,Iraq,IRQ,Syrian Arab Rep.,SYR,5,0,11,0,16
2010,Mauritania,MRT,Syrian Arab Rep.,SYR,0,0,0,5,5
2010,Pakistan,PAK,Syrian Arab Rep.,SYR,5,0,0,0,5
2010,Sierra Leone,SLE,Syrian Arab Rep.,SYR,0,0,5,0,5
2010,Somalia,SOM,Syrian Arab Rep.,SYR,5,0,0,25,30
2010,Sudan,SDN,Syrian Arab Rep.,SYR,5,0,42,23,70
2010,Tunisia,TUN,Syrian Arab Rep.,SYR,0,0,5,0,5
2010,China,CHN,Thailand,THA,0,0,5,0,5
2010,Dem. Rep. of the Congo,COD,Thailand,THA,0,0,5,5,10
2010,Iran (Islamic Rep. of),IRN,Thailand,THA,5,0,0,0,5
2010,Sri Lanka,LKA,Thailand,THA,5,0,10,31,46
2010,Pakistan,PAK,Thailand,THA,0,0,5,10,15
2010,Somalia,SOM,Thailand,THA,44,0,0,23,67
2010,Viet Nam,VNM,Thailand,THA,0,0,18,25,43
2010,Afghanistan,AFG,Turkey,TUR,116,0,65,289,470
2010,Egypt,EGY,Turkey,TUR,0,0,5,0,5
2010,China,CHN,Turkey,TUR,0,0,0,5,5
2010,Dem. Rep. of the Congo,COD,Turkey,TUR,0,0,0,5,5
2010,Eritrea,ERI,Turkey,TUR,0,0,0,5,5
2010,Ethiopia,ETH,Turkey,TUR,5,0,0,5,10
2010,Palestinian,PSE,Turkey,TUR,0,0,0,5,5
2010,Guinea,GIN,Turkey,TUR,0,0,5,10,15
2010,Cote d'Ivoire,CIV,Turkey,TUR,0,0,0,5,5
2010,Iran (Islamic Rep. of),IRN,Turkey,TUR,87,0,159,372,618
2010,Iraq,IRQ,Turkey,TUR,5,0,11,107,123
2010,Sri Lanka,LKA,Turkey,TUR,0,0,0,5,5
2010,Myanmar,MMR,Turkey,TUR,0,0,0,5,5
2010,Nigeria,NGA,Turkey,TUR,0,0,0,5,5
2010,Pakistan,PAK,Turkey,TUR,0,0,0,5,5
2010,Somalia,SOM,Turkey,TUR,15,0,0,17,32
2010,Sudan,SDN,Turkey,TUR,21,0,10,0,31
2010,Syrian Arab Rep.,SYR,Turkey,TUR,5,0,0,5,10
2011,Benin,BEN,Algeria,DZA,0,0,5,0,5
2011,Cameroon,CMR,Algeria,DZA,0,0,22,5,27
2011,Dem. Rep. of the Congo,COD,Algeria,DZA,0,0,5,0,5
2011,Guinea,GIN,Algeria,DZA,0,0,5,0,5
2011,Liberia,LBR,Algeria,DZA,0,0,5,0,5
2011,Nigeria,NGA,Algeria,DZA,0,0,5,0,5
2011,Eritrea,ERI,Egypt,EGY,14,0,10,0,24
2011,Ethiopia,ETH,Egypt,EGY,5,0,10,0,15
2011,Iraq,IRQ,Egypt,EGY,0,0,0,5,5
2011,Somalia,SOM,Egypt,EGY,5,0,11,0,16
2011,Sudan,SDN,Egypt,EGY,18,0,5,0,23
2011,Afghanistan,AFG,"China, Hong Kong SAR",HKG,0,0,5,0,5
2011,Bangladesh,BGD,"China, Hong Kong SAR",HKG,0,0,5,0,5
2011,India,IND,"China, Hong Kong SAR",HKG,0,0,21,0,21
2011,Indonesia,IDN,"China, Hong Kong SAR",HKG,0,0,34,0,34
2011,Sri Lanka,LKA,"China, Hong Kong SAR",HKG,0,0,29,26,55
2011,Nepal,NPL,"China, Hong Kong SAR",HKG,0,0,13,0,13
2011,Nigeria,NGA,"China, Hong Kong SAR",HKG,0,0,5,5,10
2011,Pakistan,PAK,"China, Hong Kong SAR",HKG,0,0,29,10,39
2011,Philippines,PHL,"China, Hong Kong SAR",HKG,0,0,22,0,22
2011,Togo,TGO,"China, Hong Kong SAR",HKG,0,0,5,0,5
2011,Afghanistan,AFG,India,IND,131,0,566,0,697
2011,Dem. Rep. of the Congo,COD,India,IND,0,0,10,0,10
2011,Palestinian,PSE,India,IND,0,0,0,5,5
2011,Iran (Islamic Rep. of),IRN,India,IND,5,0,0,10,15
2011,Iraq,IRQ,India,IND,0,0,5,0,5
2011,Myanmar,MMR,India,IND,10,0,13,0,23
2011,Egypt,EGY,Kenya,KEN,0,0,0,5,5
2011,Burundi,BDI,Kenya,KEN,110,0,96,0,206
2011,Congo,COG,Kenya,KEN,0,0,0,16,16
2011,Dem. Rep. of the Congo,COD,Kenya,KEN,518,0,395,34,947
2011,Eritrea,ERI,Kenya,KEN,141,0,33,0,174
2011,Ethiopia,ETH,Kenya,KEN,910,0,846,85,1841
2011,Mozambique,MOZ,Kenya,KEN,0,0,0,5,5
2011,Rwanda,RWA,Kenya,KEN,40,0,224,5,269
2011,Somalia,SOM,Kenya,KEN,162,0,35,0,197
2011,Sudan,SDN,Kenya,KEN,74,0,129,18,221
2011,United Rep. of Tanzania,TZA,Kenya,KEN,0,0,0,5,5
2011,Uganda,UGA,Kenya,KEN,19,0,38,0,57
2011,Egypt,EGY,Lebanon,LBN,0,0,5,0,5
2011,Iraq,IRQ,Lebanon,LBN,5,0,17,0,22
2011,Sudan,SDN,Lebanon,LBN,0,0,63,17,80
2011,Syrian Arab Rep.,SYR,Lebanon,LBN,0,0,5,0,5
2011,China,CHN,Malaysia,MYS,12,0,13,0,25
2011,India,IND,Malaysia,MYS,0,0,5,0,5
2011,Iran (Islamic Rep. of),IRN,Malaysia,MYS,0,0,11,0,11
2011,Sri Lanka,LKA,Malaysia,MYS,0,0,142,0,142
2011,Myanmar,MMR,Malaysia,MYS,334,0,117,0,451
2011,Somalia,SOM,Malaysia,MYS,5,0,5,0,10
2011,Angola,AGO,Morocco,MAR,0,0,0,5,5
2011,Cameroon,CMR,Morocco,MAR,0,0,10,0,10
2011,Dem. Rep. of the Congo,COD,Morocco,MAR,5,0,54,11,70
2011,Gambia,GMB,Morocco,MAR,0,0,5,0,5
2011,Ghana,GHA,Morocco,MAR,0,0,5,0,5
2011,Cote d'Ivoire,CIV,Morocco,MAR,0,0,5,0,5
2011,Liberia,LBR,Morocco,MAR,0,0,5,0,5
2011,Nigeria,NGA,Morocco,MAR,0,0,35,5,40
2011,Togo,TGO,Morocco,MAR,0,0,5,0,5
2011,Uganda,UGA,Morocco,MAR,0,0,5,0,5
2011,Afghanistan,AFG,Syrian Arab Rep.,SYR,0,0,5,10,15
2011,Algeria,DZA,Syrian Arab Rep.,SYR,0,0,10,0,10
2011,Ethiopia,ETH,Syrian Arab Rep.,SYR,0,0,5,5,10
2011,Palestinian,PSE,Syrian Arab Rep.,SYR,0,0,5,0,5
2011,Iran (Islamic Rep. of),IRN,Syrian Arab Rep.,SYR,0,0,12,0,12
2011,Iraq,IRQ,Syrian Arab Rep.,SYR,12,0,61,0,73
2011,Pakistan,PAK,Syrian Arab Rep.,SYR,0,0,5,10,15
2011,Sudan,SDN,Syrian Arab Rep.,SYR,10,0,33,10,53
2011,Stateless,XXA,Syrian Arab Rep.,SYR,0,0,5,0,5
2011,Dem. Rep. of the Congo,COD,Thailand,THA,0,0,5,10,15
2011,Sri Lanka,LKA,Thailand,THA,0,0,11,25,36
2011,Pakistan,PAK,Thailand,THA,5,0,0,10,15
2011,Viet Nam,VNM,Thailand,THA,0,0,10,12,22
2011,Afghanistan,AFG,Turkey,TUR,447,0,123,532,1102
2011,Dem. Rep. of the Congo,COD,Turkey,TUR,11,0,0,5,16
2011,Eritrea,ERI,Turkey,TUR,0,0,0,5,5
2011,Ethiopia,ETH,Turkey,TUR,5,0,5,16,26
2011,Palestinian,PSE,Turkey,TUR,0,0,0,10,10
2011,Guinea,GIN,Turkey,TUR,0,0,5,10,15
2011,Iran (Islamic Rep. of),IRN,Turkey,TUR,595,0,174,770,1539
2011,Iraq,IRQ,Turkey,TUR,40,0,30,86,156
2011,Jordan,JOR,Turkey,TUR,0,0,5,0,5
2011,Sri Lanka,LKA,Turkey,TUR,0,0,0,5,5
2011,Morocco,MAR,Turkey,TUR,0,0,5,5,10
2011,Nigeria,NGA,Turkey,TUR,0,0,5,5,10
2011,Sierra Leone,SLE,Turkey,TUR,0,0,0,10,10
2011,Somalia,SOM,Turkey,TUR,20,0,0,23,43
2011,Sudan,SDN,Turkey,TUR,5,0,5,15,25
2011,Syrian Arab Rep.,SYR,Turkey,TUR,0,0,0,13,13
2012,Chad,TCD,Algeria,DZA,0,0,5,0,5
2012,Cameroon,CMR,Algeria,DZA,0,0,33,0,33
2012,Niger,NER,Algeria,DZA,0,0,0,5,5
2012,Nigeria,NGA,Algeria,DZA,0,0,5,0,5
2012,Egypt,EGY,"China, Hong Kong SAR",HKG,0,0,0,5,5
2012,Benin,BEN,"China, Hong Kong SAR",HKG,0,0,0,5,5
2012,Bangladesh,BGD,"China, Hong Kong SAR",HKG,0,0,10,0,10
2012,India,IND,"China, Hong Kong SAR",HKG,0,0,18,0,18
2012,Indonesia,IDN,"China, Hong Kong SAR",HKG,0,0,112,5,117
2012,Sri Lanka,LKA,"China, Hong Kong SAR",HKG,0,0,21,5,26
2012,Pakistan,PAK,"China, Hong Kong SAR",HKG,0,0,14,0,14
2012,Philippines,PHL,"China, Hong Kong SAR",HKG,0,0,23,0,23
2012,Togo,TGO,"China, Hong Kong SAR",HKG,0,0,5,0,5
2012,Afghanistan,AFG,India,IND,99,0,379,0,478
2012,Dem. Rep. of the Congo,COD,India,IND,5,0,10,0,15
2012,Iran (Islamic Rep. of),IRN,India,IND,0,0,12,0,12
2012,Myanmar,MMR,India,IND,5,0,5,10,20
2012,Sudan,SDN,India,IND,0,0,5,0,5
2012,Burundi,BDI,Kenya,KEN,0,0,13,0,13
2012,Dem. Rep. of the Congo,COD,Kenya,KEN,25,0,36,0,61
2012,Ethiopia,ETH,Kenya,KEN,35,0,139,0,174
2012,Rwanda,RWA,Kenya,KEN,0,0,20,0,20
2012,Somalia,SOM,Kenya,KEN,5,0,5,0,10
2012,Sudan,SDN,Kenya,KEN,5,0,0,0,5
2012,South Sudan,SSD,Kenya,KEN,5,0,0,22,27
2012,United Rep. of Tanzania,TZA,Kenya,KEN,0,0,10,0,10
2012,Uganda,UGA,Kenya,KEN,0,0,14,5,19
2012,Egypt,EGY,Lebanon,LBN,0,0,5,0,5
2012,Ethiopia,ETH,Lebanon,LBN,0,0,5,5,10
2012,Iraq,IRQ,Lebanon,LBN,13,0,46,5,64
2012,Sudan,SDN,Lebanon,LBN,14,0,140,10,164
2012,Syrian Arab Rep.,SYR,Lebanon,LBN,5,0,0,0,5
2012,Afghanistan,AFG,Malaysia,MYS,0,0,0,5,5
2012,China,CHN,Malaysia,MYS,5,0,5,0,10
2012,Iran (Islamic Rep. of),IRN,Malaysia,MYS,5,0,10,0,15
2012,Liberia,LBR,Malaysia,MYS,0,0,5,0,5
2012,Sri Lanka,LKA,Malaysia,MYS,5,0,169,0,174
2012,Myanmar,MMR,Malaysia,MYS,250,0,222,0,472
2012,Pakistan,PAK,Malaysia,MYS,10,0,5,0,15
2012,Yemen,YEM,Malaysia,MYS,0,0,5,0,5
2012,Benin,BEN,Morocco,MAR,0,0,5,5,10
2012,Central African Rep.,CAF,Morocco,MAR,0,0,5,0,5
2012,Chad,TCD,Morocco,MAR,0,0,5,0,5
2012,Cameroon,CMR,Morocco,MAR,0,0,13,0,13
2012,Dem. Rep. of the Congo,COD,Morocco,MAR,0,0,59,18,77
2012,Eritrea,ERI,Morocco,MAR,0,0,5,0,5
2012,Ghana,GHA,Morocco,MAR,0,0,10,0,10
2012,Guinea,GIN,Morocco,MAR,0,0,15,5,20
2012,Cote d'Ivoire,CIV,Morocco,MAR,0,0,10,5,15
2012,Liberia,LBR,Morocco,MAR,0,0,10,0,10
2012,Nigeria,NGA,Morocco,MAR,0,0,65,5,70
2012,Togo,TGO,Morocco,MAR,0,0,5,0,5
2012,Afghanistan,AFG,Syrian Arab Rep.,SYR,21,0,15,0,36
2012,Iran (Islamic Rep. of),IRN,Syrian Arab Rep.,SYR,0,0,5,0,5
2012,Iraq,IRQ,Syrian Arab Rep.,SYR,10,0,58,0,68
2012,Pakistan,PAK,Syrian Arab Rep.,SYR,0,0,10,0,10
2012,Sudan,SDN,Syrian Arab Rep.,SYR,5,0,28,0,33
2012,Bangladesh,BGD,Thailand,THA,0,0,10,0,10
2012,Cambodia,KHM,Thailand,THA,0,0,10,5,15
2012,China,CHN,Thailand,THA,5,0,17,0,22
2012,Cameroon,CMR,Thailand,THA,0,0,5,0,5
2012,Dem. Rep. of the Congo,COD,Thailand,THA,10,0,32,0,42
2012,Guinea,GIN,Thailand,THA,0,0,11,0,11
2012,Cote d'Ivoire,CIV,Thailand,THA,0,0,5,0,5
2012,Iran (Islamic Rep. of),IRN,Thailand,THA,0,0,10,0,10
2012,Iraq,IRQ,Thailand,THA,0,0,5,0,5
2012,Kuwait,KWT,Thailand,THA,0,0,0,5,5
2012,Lao People's Dem. Rep.,LAO,Thailand,THA,0,0,5,0,5
2012,Liberia,LBR,Thailand,THA,0,0,5,0,5
2012,Sri Lanka,LKA,Thailand,THA,27,0,98,12,137
2012,Nepal,NPL,Thailand,THA,0,0,5,0,5
2012,Pakistan,PAK,Thailand,THA,23,0,5,0,28
2012,Sierra Leone,SLE,Thailand,THA,0,0,5,0,5
2012,Somalia,SOM,Thailand,THA,0,0,5,0,5
2012,Viet Nam,VNM,Thailand,THA,0,0,179,0,179
2012,Chad,TCD,Tunisia,TUN,5,0,50,13,68
2012,Ethiopia,ETH,Tunisia,TUN,21,0,10,0,31
2012,Gambia,GMB,Tunisia,TUN,0,0,5,0,5
2012,Cote d'Ivoire,CIV,Tunisia,TUN,0,0,14,0,14
2012,Jordan,JOR,Tunisia,TUN,0,0,5,0,5
2012,Nigeria,NGA,Tunisia,TUN,0,0,5,0,5
2012,Pakistan,PAK,Tunisia,TUN,0,0,5,0,5
2012,Somalia,SOM,Tunisia,TUN,5,0,5,0,10
2012,Sudan,SDN,Tunisia,TUN,5,0,56,5,66
2012,Afghanistan,AFG,Turkey,TUR,29,0,34,247,310
2012,Bangladesh,BGD,Turkey,TUR,0,0,0,5,5
2012,China,CHN,Turkey,TUR,0,0,0,5,5
2012,Dem. Rep. of the Congo,COD,Turkey,TUR,0,0,0,5,5
2012,Eritrea,ERI,Turkey,TUR,0,0,0,10,10
2012,Ethiopia,ETH,Turkey,TUR,0,0,0,5,5
2012,Palestinian,PSE,Turkey,TUR,0,0,0,19,19
2012,Guinea,GIN,Turkey,TUR,0,0,0,5,5
2012,Iran (Islamic Rep. of),IRN,Turkey,TUR,74,0,23,188,285
2012,Iraq,IRQ,Turkey,TUR,16,0,21,53,90
2012,Kazakhstan,KAZ,Turkey,TUR,0,0,5,0,5
2012,Liberia,LBR,Turkey,TUR,0,0,0,5,5
2012,Morocco,MAR,Turkey,TUR,0,0,0,10,10
2012,Myanmar,MMR,Turkey,TUR,0,0,0,5,5
2012,Pakistan,PAK,Turkey,TUR,0,0,5,10,15
2012,Somalia,SOM,Turkey,TUR,32,0,0,5,37
2012,Sudan,SDN,Turkey,TUR,17,0,10,16,43
2012,Syrian Arab Rep.,SYR,Turkey,TUR,0,0,0,15,15
2012,Uzbekistan,UZB,Turkey,TUR,0,0,20,47,67
2013,Benin,BEN,Algeria,DZA,0,0,23,0,23
2013,Cameroon,CMR,Algeria,DZA,0,0,254,5,259
2013,Congo,COG,Algeria,DZA,0,0,10,0,10
2013,Dem. Rep. of the Congo,COD,Algeria,DZA,0,0,26,0,26
2013,Guinea,GIN,Algeria,DZA,0,0,42,0,42
2013,Cote d'Ivoire,CIV,Algeria,DZA,0,0,111,5,116
2013,Liberia,LBR,Algeria,DZA,0,0,11,0,11
2013,Mali,MLI,Algeria,DZA,0,0,5,0,5
2013,Niger,NER,Algeria,DZA,0,0,19,0,19
2013,Nigeria,NGA,Algeria,DZA,0,0,41,0,41
2013,Sierra Leone,SLE,Algeria,DZA,0,0,5,0,5
2013,Central African Rep.,CAF,Cameroon,CMR,5,0,26,29,60
2013,Chad,TCD,Cameroon,CMR,0,0,16,5,21
2013,Dem. Rep. of the Congo,COD,Cameroon,CMR,0,0,13,0,13
2013,Guinea-Bissau,GNB,Cameroon,CMR,0,0,5,0,5
2013,Guinea,GIN,Cameroon,CMR,0,0,33,31,64
2013,Cote d'Ivoire,CIV,Cameroon,CMR,0,0,5,0,5
2013,Mali,MLI,Cameroon,CMR,0,0,5,5,10
2013,Rwanda,RWA,Cameroon,CMR,0,0,10,5,15
2013,Senegal,SEN,Cameroon,CMR,0,0,24,15,39
2013,India,IND,"China, Hong Kong SAR",HKG,0,0,5,0,5
2013,Indonesia,IDN,"China, Hong Kong SAR",HKG,0,0,48,17,65
2013,Sri Lanka,LKA,"China, Hong Kong SAR",HKG,0,0,25,5,30
2013,Nepal,NPL,"China, Hong Kong SAR",HKG,0,0,5,0,5
2013,Pakistan,PAK,"China, Hong Kong SAR",HKG,5,0,5,10,20
2013,Philippines,PHL,"China, Hong Kong SAR",HKG,0,0,12,10,22
2013,Afghanistan,AFG,India,IND,45,0,111,113,269
2013,Cameroon,CMR,India,IND,0,0,5,0,5
2013,Dem. Rep. of the Congo,COD,India,IND,0,0,19,0,19
2013,Myanmar,MMR,India,IND,10,0,5,0,15
2013,Sudan,SDN,India,IND,0,0,5,0,5
2013,Afghanistan,AFG,Indonesia,IDN,14,0,35,41,90
2013,Iran (Islamic Rep. of),IRN,Indonesia,IDN,13,0,44,28,85
2013,Iraq,IRQ,Indonesia,IDN,0,0,5,5,10
2013,Sri Lanka,LKA,Indonesia,IDN,17,0,5,24,46
2013,Pakistan,PAK,Indonesia,IDN,0,0,0,5,5
2013,Somalia,SOM,Indonesia,IDN,0,0,0,5,5
2013,Sudan,SDN,Indonesia,IDN,0,0,0,5,5
2013,Yemen,YEM,Indonesia,IDN,0,0,0,5,5
2013,Burundi,BDI,Kenya,KEN,13,0,56,0,69
2013,Dem. Rep. of the Congo,COD,Kenya,KEN,162,0,44,0,206
2013,Eritrea,ERI,Kenya,KEN,5,0,13,0,18
2013,Ethiopia,ETH,Kenya,KEN,509,0,183,25,717
2013,Rwanda,RWA,Kenya,KEN,0,0,35,0,35
2013,Somalia,SOM,Kenya,KEN,5,0,5,0,10
2013,Sudan,SDN,Kenya,KEN,0,0,5,0,5
2013,South Sudan,SSD,Kenya,KEN,0,0,5,0,5
2013,Uganda,UGA,Kenya,KEN,0,0,13,5,18
2013,Egypt,EGY,Lebanon,LBN,0,0,26,0,26
2013,Ethiopia,ETH,Lebanon,LBN,0,0,5,0,5
2013,India,IND,Lebanon,LBN,0,0,5,0,5
2013,Iran (Islamic Rep. of),IRN,Lebanon,LBN,0,0,5,0,5
2013,Iraq,IRQ,Lebanon,LBN,15,0,40,5,60
2013,Madagascar,MDG,Lebanon,LBN,0,0,5,0,5
2013,Sudan,SDN,Lebanon,LBN,5,0,69,43,117
2013,Syrian Arab Rep.,SYR,Lebanon,LBN,45,0,0,0,45
2013,Indonesia,IDN,Malaysia,MYS,0,0,5,0,5
2013,Iran (Islamic Rep. of),IRN,Malaysia,MYS,0,0,19,0,19
2013,Sri Lanka,LKA,Malaysia,MYS,10,0,206,0,216
2013,Myanmar,MMR,Malaysia,MYS,123,0,285,5,413
2013,Pakistan,PAK,Malaysia,MYS,0,0,5,0,5
2013,Somalia,SOM,Malaysia,MYS,5,0,5,0,10
2013,Benin,BEN,Morocco,MAR,0,0,5,0,5
2013,Cameroon,CMR,Morocco,MAR,0,0,10,0,10
2013,Dem. Rep. of the Congo,COD,Morocco,MAR,0,0,17,0,17
2013,Cote d'Ivoire,CIV,Morocco,MAR,0,0,5,0,5
2013,Iraq,IRQ,Morocco,MAR,0,0,0,5,5
2013,Nigeria,NGA,Morocco,MAR,0,0,14,0,14
2013,Pakistan,PAK,Nepal,NPL,0,0,0,5,5
2013,Egypt,EGY,Syrian Arab Rep.,SYR,0,0,5,0,5
2013,Bangladesh,BGD,Syrian Arab Rep.,SYR,0,0,5,0,5
2013,Iran (Islamic Rep. of),IRN,Syrian Arab Rep.,SYR,0,0,5,5,10
2013,Iraq,IRQ,Syrian Arab Rep.,SYR,0,0,11,0,11
2013,Jordan,JOR,Syrian Arab Rep.,SYR,0,0,11,0,11
2013,Lebanon,LBN,Syrian Arab Rep.,SYR,0,0,11,0,11
2013,Pakistan,PAK,Syrian Arab Rep.,SYR,0,0,5,0,5
2013,Philippines,PHL,Syrian Arab Rep.,SYR,0,0,5,0,5
2013,Sudan,SDN,Syrian Arab Rep.,SYR,13,0,5,0,18
2013,South Sudan,SSD,Syrian Arab Rep.,SYR,5,0,0,0,5
2013,Yemen,YEM,Syrian Arab Rep.,SYR,0,0,0,5,5
2013,Cambodia,KHM,Thailand,THA,5,0,5,0,10
2013,China,CHN,Thailand,THA,5,0,5,0,10
2013,Dem. Rep. of the Congo,COD,Thailand,THA,10,0,11,0,21
2013,Iran (Islamic Rep. of),IRN,Thailand,THA,5,0,5,5,15
2013,Sri Lanka,LKA,Thailand,THA,14,0,0,0,14
2013,Pakistan,PAK,Thailand,THA,5,0,5,0,10
2013,Viet Nam,VNM,Thailand,THA,17,0,23,20,60
2013,Cote d'Ivoire,CIV,Tunisia,TUN,0,0,17,0,17
2013,Sudan,SDN,Tunisia,TUN,0,0,5,5,10
2013,Afghanistan,AFG,Turkey,TUR,24,0,29,68,121
2013,Dem. Rep. of the Congo,COD,Turkey,TUR,0,0,0,5,5
2013,Eritrea,ERI,Turkey,TUR,5,0,0,0,5
2013,Ethiopia,ETH,Turkey,TUR,5,0,0,0,5
2013,Palestinian,PSE,Turkey,TUR,5,0,0,10,15
2013,Iran (Islamic Rep. of),IRN,Turkey,TUR,52,0,98,138,288
2013,Iraq,IRQ,Turkey,TUR,0,0,5,37,42
2013,Kazakhstan,KAZ,Turkey,TUR,0,0,0,10,10
2013,Kyrgyzstan,KGZ,Turkey,TUR,0,0,0,22,22
2013,Libya,LBY,Turkey,TUR,0,0,0,5,5
2013,Nigeria,NGA,Turkey,TUR,0,0,0,5,5
2013,Pakistan,PAK,Turkey,TUR,0,0,5,5,10
2013,Senegal,SEN,Turkey,TUR,0,0,0,5,5
2013,Sierra Leone,SLE,Turkey,TUR,0,0,0,5,5
2013,Somalia,SOM,Turkey,TUR,5,0,0,14,19
2013,Syrian Arab Rep.,SYR,Turkey,TUR,0,0,0,5,5
2013,Tajikistan,TJK,Turkey,TUR,0,0,0,13,13
2013,Turkmenistan,TKM,Turkey,TUR,0,0,0,17,17
2013,Uganda,UGA,Turkey,TUR,0,0,0,5,5
2013,Uzbekistan,UZB,Turkey,TUR,0,0,0,32,32
2013,Yemen,YEM,Turkey,TUR,0,0,0,10,10
2013,Ethiopia,ETH,Yemen,YEM,0,0,35,37,72
2014,Benin,BEN,Algeria,DZA,0,0,14,0,14
2014,Central African Rep.,CAF,Algeria,DZA,0,0,5,0,5
2014,Chad,TCD,Algeria,DZA,0,0,5,0,5
2014,Cameroon,CMR,Algeria,DZA,0,0,38,5,43
2014,Dem. Rep. of the Congo,COD,Algeria,DZA,0,0,12,0,12
2014,Guinea,GIN,Algeria,DZA,0,0,14,0,14
2014,Cote d'Ivoire,CIV,Algeria,DZA,0,0,39,10,49
2014,Liberia,LBR,Algeria,DZA,0,0,5,0,5
2014,Mali,MLI,Algeria,DZA,0,0,93,5,98
2014,Niger,NER,Algeria,DZA,0,0,5,0,5
2014,Nigeria,NGA,Algeria,DZA,0,0,10,0,10
2014,Chad,TCD,Egypt,EGY,0,0,5,0,5
2014,Eritrea,ERI,Egypt,EGY,5,0,5,0,10
2014,Ethiopia,ETH,Egypt,EGY,5,0,55,0,60
2014,Nigeria,NGA,Egypt,EGY,0,0,10,0,10
2014,Somalia,SOM,Egypt,EGY,0,0,14,0,14
2014,Sudan,SDN,Egypt,EGY,31,0,118,0,149
2014,South Sudan,SSD,Egypt,EGY,13,0,0,0,13
2014,Nigeria,NGA,China,CHN,0,0,5,5,10
2014,Somalia,SOM,China,CHN,12,0,23,12,47
2014,Burundi,BDI,Cameroon,CMR,0,0,5,0,5
2014,Central African Rep.,CAF,Cameroon,CMR,67,0,0,0,67
2014,Chad,TCD,Cameroon,CMR,0,0,33,5,38
2014,Dem. Rep. of the Congo,COD,Cameroon,CMR,0,0,44,5,49
2014,Guinea,GIN,Cameroon,CMR,0,0,15,0,15
2014,Cote d'Ivoire,CIV,Cameroon,CMR,0,0,5,0,5
2014,Mali,MLI,Cameroon,CMR,0,0,5,0,5
2014,Niger,NER,Cameroon,CMR,0,0,0,5,5
2014,Rwanda,RWA,Cameroon,CMR,5,0,45,0,50
2014,Senegal,SEN,Cameroon,CMR,0,0,5,0,5
2014,Egypt,EGY,"China, Hong Kong SAR",HKG,0,0,5,0,5
2014,Dem. Rep. of the Congo,COD,"China, Hong Kong SAR",HKG,0,0,5,0,5
2014,India,IND,"China, Hong Kong SAR",HKG,0,0,5,0,5
2014,Indonesia,IDN,"China, Hong Kong SAR",HKG,0,0,5,0,5
2014,Sri Lanka,LKA,"China, Hong Kong SAR",HKG,0,0,5,0,5
2014,Namibia,NAM,"China, Hong Kong SAR",HKG,0,0,5,0,5
2014,Pakistan,PAK,"China, Hong Kong SAR",HKG,0,0,5,0,5
2014,Somalia,SOM,"China, Hong Kong SAR",HKG,0,0,5,0,5
2014,Togo,TGO,"China, Hong Kong SAR",HKG,0,0,5,0,5
2014,Uganda,UGA,"China, Hong Kong SAR",HKG,0,0,5,0,5
2014,Afghanistan,AFG,India,IND,22,0,140,109,271
2014,Dem. Rep. of the Congo,COD,India,IND,5,0,5,5,15
2014,Myanmar,MMR,India,IND,5,0,24,73,102
2014,Nigeria,NGA,India,IND,0,0,15,14,29
2014,Afghanistan,AFG,Indonesia,IDN,24,0,66,0,90
2014,Iran (Islamic Rep. of),IRN,Indonesia,IDN,0,0,66,13,79
2014,Iraq,IRQ,Indonesia,IDN,5,0,0,0,5
2014,Sri Lanka,LKA,Indonesia,IDN,5,0,17,0,22
2014,Pakistan,PAK,Indonesia,IDN,0,0,0,5,5
2014,Sudan,SDN,Indonesia,IDN,0,0,0,5,5
2014,Yemen,YEM,Indonesia,IDN,0,0,0,5,5
2014,Iraq,IRQ,Jordan,JOR,30,0,5,0,35
2014,Sudan,SDN,Jordan,JOR,22,0,10,0,32
2014,South Sudan,SSD,Jordan,JOR,5,0,0,0,5
2014,Burundi,BDI,Kenya,KEN,5,0,26,12,43
2014,Dem. Rep. of the Congo,COD,Kenya,KEN,112,0,14,22,148
2014,Ethiopia,ETH,Kenya,KEN,85,0,172,330,587
2014,Rwanda,RWA,Kenya,KEN,0,0,22,50,72
2014,Somalia,SOM,Kenya,KEN,20,0,11,28,59
2014,Sudan,SDN,Kenya,KEN,5,0,0,0,5
2014,South Sudan,SSD,Kenya,KEN,10,0,0,42,52
2014,Uganda,UGA,Kenya,KEN,0,0,11,5,16
2014,Afghanistan,AFG,Kyrgyzstan,KGZ,0,0,19,0,19
2014,Iran (Islamic Rep. of),IRN,Kyrgyzstan,KGZ,0,0,5,0,5
2014,Uzbekistan,UZB,Kyrgyzstan,KGZ,0,0,0,5,5
2014,Afghanistan,AFG,Lebanon,LBN,0,0,5,0,5
2014,Egypt,EGY,Lebanon,LBN,0,0,39,0,39
2014,Ethiopia,ETH,Lebanon,LBN,0,0,10,0,10
2014,Iran (Islamic Rep. of),IRN,Lebanon,LBN,0,0,10,0,10
2014,Iraq,IRQ,Lebanon,LBN,88,0,50,0,138
2014,Mali,MLI,Lebanon,LBN,0,0,5,0,5
2014,Sudan,SDN,Lebanon,LBN,21,0,97,0,118
2014,Maldives,MDV,Sri Lanka,LKA,0,0,0,10,10
2014,Pakistan,PAK,Sri Lanka,LKA,38,0,54,0,92
2014,Egypt,EGY,Malaysia,MYS,0,0,5,0,5
2014,Palestinian,PSE,Malaysia,MYS,0,0,5,0,5
2014,Iran (Islamic Rep. of),IRN,Malaysia,MYS,10,0,30,0,40
2014,Iraq,IRQ,Malaysia,MYS,0,0,5,0,5
2014,Sri Lanka,LKA,Malaysia,MYS,13,0,252,0,265
2014,Myanmar,MMR,Malaysia,MYS,77,0,430,0,507
2014,Pakistan,PAK,Malaysia,MYS,0,0,41,0,41
2014,Somalia,SOM,Malaysia,MYS,0,0,11,0,11
2014,Sudan,SDN,Malaysia,MYS,0,0,10,0,10
2014,Syrian Arab Rep.,SYR,Malaysia,MYS,5,0,0,0,5
2014,Yemen,YEM,Malaysia,MYS,0,0,0,5,5
2014,Cameroon,CMR,Morocco,MAR,0,0,12,5,17
2014,Congo,COG,Morocco,MAR,0,0,10,5,15
2014,Dem. Rep. of the Congo,COD,Morocco,MAR,5,0,33,28,66
2014,Guinea,GIN,Morocco,MAR,0,0,5,5,10
2014,Cote d'Ivoire,CIV,Morocco,MAR,0,0,29,23,52
2014,Liberia,LBR,Morocco,MAR,0,0,0,5,5
2014,Niger,NER,Morocco,MAR,0,0,0,5,5
2014,Nigeria,NGA,Morocco,MAR,0,0,53,47,100
2014,Sudan,SDN,Morocco,MAR,0,0,5,0,5
2014,Uganda,UGA,Morocco,MAR,0,0,5,0,5
2014,Pakistan,PAK,Nepal,NPL,70,0,5,0,75
2014,Afghanistan,AFG,Pakistan,PAK,205,0,836,0,1041
2014,Iran (Islamic Rep. of),IRN,Pakistan,PAK,12,0,5,0,17
2014,Somalia,SOM,Pakistan,PAK,0,0,11,0,11
2014,Afghanistan,AFG,Syrian Arab Rep.,SYR,5,0,0,11,16
2014,Algeria,DZA,Syrian Arab Rep.,SYR,0,0,0,5,5
2014,Egypt,EGY,Syrian Arab Rep.,SYR,0,0,31,5,36
2014,Ethiopia,ETH,Syrian Arab Rep.,SYR,5,0,10,5,20
2014,Guinea,GIN,Syrian Arab Rep.,SYR,18,0,0,0,18
2014,Iran (Islamic Rep. of),IRN,Syrian Arab Rep.,SYR,0,0,88,0,88
2014,Iraq,IRQ,Syrian Arab Rep.,SYR,31,0,0,38,69
2014,Jordan,JOR,Syrian Arab Rep.,SYR,0,0,13,0,13
2014,Kenya,KEN,Syrian Arab Rep.,SYR,0,0,10,0,10
2014,Libya,LBY,Syrian Arab Rep.,SYR,0,0,5,0,5
2014,Lebanon,LBN,Syrian Arab Rep.,SYR,0,0,24,5,29
2014,Morocco,MAR,Syrian Arab Rep.,SYR,0,0,5,0,5
2014,Pakistan,PAK,Syrian Arab Rep.,SYR,0,0,17,0,17
2014,Philippines,PHL,Syrian Arab Rep.,SYR,0,0,12,0,12
2014,Sudan,SDN,Syrian Arab Rep.,SYR,43,0,31,5,79
2014,South Sudan,SSD,Syrian Arab Rep.,SYR,0,0,0,5,5
2014,Tajikistan,TJK,Syrian Arab Rep.,SYR,0,0,5,0,5
2014,Tunisia,TUN,Syrian Arab Rep.,SYR,0,0,5,0,5
2014,Turkey,TUR,Syrian Arab Rep.,SYR,0,0,5,0,5
2014,Yemen,YEM,Syrian Arab Rep.,SYR,0,0,20,5,25
2014,China,CHN,Thailand,THA,0,0,5,0,5
2014,Dem. Rep. of the Congo,COD,Thailand,THA,5,0,0,0,5
2014,Iran (Islamic Rep. of),IRN,Thailand,THA,0,0,5,0,5
2014,Sri Lanka,LKA,Thailand,THA,0,0,5,0,5
2014,Pakistan,PAK,Thailand,THA,0,0,10,5,15
2014,Viet Nam,VNM,Thailand,THA,27,0,21,0,48
2014,Afghanistan,AFG,Tajikistan,TJK,39,0,80,0,119
2014,Pakistan,PAK,Tajikistan,TJK,0,0,11,0,11
2014,Eritrea,ERI,Tunisia,TUN,0,0,10,0,10
2014,Cote d'Ivoire,CIV,Tunisia,TUN,0,0,71,0,71
2014,Somalia,SOM,Tunisia,TUN,0,0,5,0,5
2014,Sudan,SDN,Tunisia,TUN,0,0,10,0,10
2014,Afghanistan,AFG,Turkey,TUR,5,0,5,91,101
2014,Algeria,DZA,Turkey,TUR,0,0,5,0,5
2014,Bangladesh,BGD,Turkey,TUR,0,0,0,5,5
2014,Dem. Rep. of the Congo,COD,Turkey,TUR,0,0,5,0,5
2014,Iran (Islamic Rep. of),IRN,Turkey,TUR,111,0,92,145,348
2014,Iraq,IRQ,Turkey,TUR,31,0,10,0,41
2014,Kyrgyzstan,KGZ,Turkey,TUR,0,0,5,0,5
2014,Nigeria,NGA,Turkey,TUR,0,0,0,5,5
2014,Senegal,SEN,Turkey,TUR,0,0,5,0,5
2014,Somalia,SOM,Turkey,TUR,0,0,5,0,5
2014,Tajikistan,TJK,Turkey,TUR,0,0,5,0,5
2014,Turkmenistan,TKM,Turkey,TUR,0,0,5,0,5
2014,Uzbekistan,UZB,Turkey,TUR,0,0,5,0,5
2014,Afghanistan,AFG,Ukraine,UKR,0,0,5,0,5
2014,Dem. Rep. of the Congo,COD,Ukraine,UKR,0,0,5,0,5
2014,Iran (Islamic Rep. of),IRN,Ukraine,UKR,0,0,5,0,5
2014,Ethiopia,ETH,Yemen,YEM,0,0,55,34,89
2015,Iran (Islamic Rep. of),IRN,Afghanistan,AFG,0,0,0,5,5
2015,Pakistan,PAK,Afghanistan,AFG,10,0,0,0,10
2015,Chad,TCD,Algeria,DZA,0,0,5,0,5
2015,Cameroon,CMR,Algeria,DZA,0,0,10,5,15
2015,Dem. Rep. of the Congo,COD,Algeria,DZA,0,0,13,0,13
2015,Guinea,GIN,Algeria,DZA,0,0,16,0,16
2015,Cote d'Ivoire,CIV,Algeria,DZA,0,0,19,5,24
2015,Liberia,LBR,Algeria,DZA,0,0,5,0,5
2015,Mali,MLI,Algeria,DZA,0,0,48,5,53
2015,Nigeria,NGA,Algeria,DZA,0,0,0,5,5
2015,Eritrea,ERI,Egypt,EGY,0,0,5,0,5
2015,Ethiopia,ETH,Egypt,EGY,5,0,18,0,23
2015,Somalia,SOM,Egypt,EGY,10,0,0,0,10
2015,Sudan,SDN,Egypt,EGY,51,0,49,0,100
2015,South Sudan,SSD,Egypt,EGY,10,0,0,0,10
2015,Uzbekistan,UZB,Egypt,EGY,0,0,5,0,5
2015,Nigeria,NGA,China,CHN,0,0,15,17,32
2015,Pakistan,PAK,China,CHN,0,0,5,0,5
2015,Somalia,SOM,China,CHN,5,0,10,0,15
2015,Central African Rep.,CAF,Cameroon,CMR,58,0,12,10,80
2015,Chad,TCD,Cameroon,CMR,5,0,89,5,99
2015,Dem. Rep. of the Congo,COD,Cameroon,CMR,0,0,78,19,97
2015,Gambia,GMB,Cameroon,CMR,0,0,0,5,5
2015,Guinea-Bissau,GNB,Cameroon,CMR,0,0,10,5,15
2015,Guinea,GIN,Cameroon,CMR,0,0,49,42,91
2015,Cote d'Ivoire,CIV,Cameroon,CMR,0,0,20,5,25
2015,Rwanda,RWA,Cameroon,CMR,5,0,72,0,77
2015,Senegal,SEN,Cameroon,CMR,0,0,10,13,23
2015,Sierra Leone,SLE,Cameroon,CMR,0,0,5,5,10
2015,India,IND,Micronesia (Federated States of),FSM,0,0,10,0,10
2015,Nepal,NPL,Micronesia (Federated States of),FSM,0,0,5,0,5
2015,Pakistan,PAK,"China, Hong Kong SAR",HKG,0,0,5,0,5
2015,Afghanistan,AFG,India,IND,28,0,266,0,294
2015,Cameroon,CMR,India,IND,0,0,5,0,5
2015,Dem. Rep. of the Congo,COD,India,IND,0,0,10,0,10
2015,Myanmar,MMR,India,IND,5,0,83,0,88
2015,Nigeria,NGA,India,IND,0,0,42,0,42
2015,Somalia,SOM,India,IND,0,0,5,0,5
2015,Sudan,SDN,India,IND,5,0,10,0,15
2015,Afghanistan,AFG,Indonesia,IDN,50,0,54,0,104
2015,Ethiopia,ETH,Indonesia,IDN,5,0,0,0,5
2015,Iran (Islamic Rep. of),IRN,Indonesia,IDN,5,0,72,0,77
2015,Iraq,IRQ,Indonesia,IDN,21,0,0,0,21
2015,Sri Lanka,LKA,Indonesia,IDN,12,0,20,0,32
2015,Sudan,SDN,Indonesia,IDN,0,0,5,0,5
2015,Egypt,EGY,Jordan,JOR,0,0,5,0,5
2015,Iraq,IRQ,Jordan,JOR,123,0,0,0,123
2015,Sudan,SDN,Jordan,JOR,30,0,10,0,40
2015,Afghanistan,AFG,Kyrgyzstan,KGZ,0,0,11,0,11
2015,Uzbekistan,UZB,Kyrgyzstan,KGZ,0,0,5,5,10
2015,Afghanistan,AFG,Lebanon,LBN,0,0,0,5,5
2015,Egypt,EGY,Lebanon,LBN,0,0,10,0,10
2015,Eritrea,ERI,Lebanon,LBN,0,0,5,0,5
2015,Ethiopia,ETH,Lebanon,LBN,0,0,23,0,23
2015,Iran (Islamic Rep. of),IRN,Lebanon,LBN,5,0,10,0,15
2015,Iraq,IRQ,Lebanon,LBN,24,0,0,5,29
2015,Somalia,SOM,Lebanon,LBN,0,0,5,0,5
2015,Sudan,SDN,Lebanon,LBN,37,0,156,0,193
2015,Syrian Arab Rep.,SYR,Lebanon,LBN,5,0,0,0,5
2015,Pakistan,PAK,Sri Lanka,LKA,37,0,82,0,119
2015,Central African Rep.,CAF,Mauritania,MRT,11,0,5,0,16
2015,Cameroon,CMR,Mauritania,MRT,0,0,5,0,5
2015,Dem. Rep. of the Congo,COD,Mauritania,MRT,0,0,16,0,16
2015,Cote d'Ivoire,CIV,Mauritania,MRT,0,0,42,5,47
2015,Liberia,LBR,Mauritania,MRT,0,0,0,5,5
2015,Senegal,SEN,Mauritania,MRT,11,0,0,0,11
2015,Afghanistan,AFG,Malaysia,MYS,5,0,0,0,5
2015,Egypt,EGY,Malaysia,MYS,0,0,5,0,5
2015,Palestinian,PSE,Malaysia,MYS,5,0,0,0,5
2015,Indonesia,IDN,Malaysia,MYS,0,0,5,0,5
2015,Iran (Islamic Rep. of),IRN,Malaysia,MYS,0,0,41,0,41
2015,Liberia,LBR,Malaysia,MYS,0,0,5,0,5
2015,Lebanon,LBN,Malaysia,MYS,0,0,5,0,5
2015,Sri Lanka,LKA,Malaysia,MYS,5,0,240,0,245
2015,Mali,MLI,Malaysia,MYS,0,0,5,0,5
2015,Myanmar,MMR,Malaysia,MYS,5,0,185,0,190
2015,Pakistan,PAK,Malaysia,MYS,5,0,110,0,115
2015,Somalia,SOM,Malaysia,MYS,5,0,21,0,26
2015,Sudan,SDN,Malaysia,MYS,0,0,5,0,5
2015,Syrian Arab Rep.,SYR,Malaysia,MYS,0,0,0,5,5
2015,Cameroon,CMR,Morocco,MAR,5,0,5,5,15
2015,Congo,COG,Morocco,MAR,0,0,5,0,5
2015,Dem. Rep. of the Congo,COD,Morocco,MAR,5,0,42,30,77
2015,Ghana,GHA,Morocco,MAR,0,0,5,0,5
2015,Guinea,GIN,Morocco,MAR,0,0,5,10,15
2015,Cote d'Ivoire,CIV,Morocco,MAR,0,0,33,28,61
2015,Liberia,LBR,Morocco,MAR,0,0,0,5,5
2015,Mali,MLI,Morocco,MAR,0,0,0,5,5
2015,Niger,NER,Morocco,MAR,0,0,0,5,5
2015,Nigeria,NGA,Morocco,MAR,0,0,5,16,21
2015,Rwanda,RWA,Morocco,MAR,0,0,0,5,5
2015,China,CHN,Nepal,NPL,0,0,5,0,5
2015,Sri Lanka,LKA,Nepal,NPL,0,0,10,0,10
2015,Pakistan,PAK,Nepal,NPL,34,0,23,0,57
2015,Afghanistan,AFG,Pakistan,PAK,117,0,1501,5,1623
2015,Algeria,DZA,Pakistan,PAK,0,0,5,0,5
2015,Nigeria,NGA,Pakistan,PAK,0,0,5,0,5
2015,Somalia,SOM,Pakistan,PAK,0,0,5,0,5
2015,Afghanistan,AFG,Syrian Arab Rep.,SYR,0,0,35,0,35
2015,Algeria,DZA,Syrian Arab Rep.,SYR,0,0,13,0,13
2015,Egypt,EGY,Syrian Arab Rep.,SYR,0,0,20,0,20
2015,Burkina Faso,BFA,Syrian Arab Rep.,SYR,0,0,0,5,5
2015,Ethiopia,ETH,Syrian Arab Rep.,SYR,0,0,5,0,5
2015,Guinea,GIN,Syrian Arab Rep.,SYR,0,0,5,0,5
2015,India,IND,Syrian Arab Rep.,SYR,0,0,5,0,5
2015,Iran (Islamic Rep. of),IRN,Syrian Arab Rep.,SYR,0,0,84,0,84
2015,Iraq,IRQ,Syrian Arab Rep.,SYR,20,0,5,0,25
2015,Jordan,JOR,Syrian Arab Rep.,SYR,0,0,5,0,5
2015,Lebanon,LBN,Syrian Arab Rep.,SYR,0,0,47,0,47
2015,Sri Lanka,LKA,Syrian Arab Rep.,SYR,0,0,0,5,5
2015,Nigeria,NGA,Syrian Arab Rep.,SYR,0,0,0,5,5
2015,Pakistan,PAK,Syrian Arab Rep.,SYR,0,0,32,0,32
2015,Philippines,PHL,Syrian Arab Rep.,SYR,0,0,10,0,10
2015,Sierra Leone,SLE,Syrian Arab Rep.,SYR,0,0,5,0,5
2015,Sudan,SDN,Syrian Arab Rep.,SYR,35,0,20,0,55
2015,South Sudan,SSD,Syrian Arab Rep.,SYR,5,0,0,0,5
2015,Tunisia,TUN,Syrian Arab Rep.,SYR,0,0,5,0,5
2015,Iran (Islamic Rep. of),IRN,Thailand,THA,0,0,10,0,10
2015,Sri Lanka,LKA,Thailand,THA,0,0,5,0,5
2015,Pakistan,PAK,Thailand,THA,27,0,22,12,61
2015,Viet Nam,VNM,Thailand,THA,27,0,21,0,48
2015,Bangladesh,BGD,Trinidad and Tobago,TTO,5,0,5,0,10
2015,Cuba,CUB,Trinidad and Tobago,TTO,0,0,0,5,5
2015,Nigeria,NGA,Trinidad and Tobago,TTO,0,0,10,0,10
2015,Syrian Arab Rep.,SYR,Trinidad and Tobago,TTO,0,0,5,0,5
2015,Eritrea,ERI,Tunisia,TUN,0,0,0,5,5
2015,Cote d'Ivoire,CIV,Tunisia,TUN,0,0,13,0,13
2015,Somalia,SOM,Tunisia,TUN,0,0,5,25,30
2015,Sudan,SDN,Tunisia,TUN,0,0,5,5,10
2015,Afghanistan,AFG,Turkey,TUR,141,0,28,38,207
2015,Egypt,EGY,Turkey,TUR,0,0,5,0,5
2015,Cameroon,CMR,Turkey,TUR,0,0,0,5,5
2015,Congo,COG,Turkey,TUR,0,0,0,10,10
2015,Dem. Rep. of the Congo,COD,Turkey,TUR,0,0,0,10,10
2015,Eritrea,ERI,Turkey,TUR,0,0,0,5,5
2015,Ethiopia,ETH,Turkey,TUR,0,0,0,5,5
2015,Cote d'Ivoire,CIV,Turkey,TUR,0,0,5,5,10
2015,Iran (Islamic Rep. of),IRN,Turkey,TUR,355,0,313,160,828
2015,Iraq,IRQ,Turkey,TUR,11,0,5,23,39
2015,Kyrgyzstan,KGZ,Turkey,TUR,0,0,5,0,5
2015,Lebanon,LBN,Turkey,TUR,0,0,0,5,5
2015,Morocco,MAR,Turkey,TUR,10,0,5,0,15
2015,Nigeria,NGA,Turkey,TUR,0,0,5,10,15
2015,Pakistan,PAK,Turkey,TUR,0,0,0,5,5
2015,Somalia,SOM,Turkey,TUR,0,0,0,12,12
2015,Sudan,SDN,Turkey,TUR,0,0,5,5,10
2015,Uganda,UGA,Turkey,TUR,0,0,0,10,10
2015,Uzbekistan,UZB,Turkey,TUR,0,0,0,16,16
2015,Yemen,YEM,Turkey,TUR,25,0,0,5,30
2015,Iraq,IRQ,United Arab Emirates,ARE,335,0,0,10,345
2015,Syrian Arab Rep.,SYR,United Arab Emirates,ARE,18,0,0,5,23
2015,Stateless,XXA,United Arab Emirates,ARE,5,0,0,0,5
2015,Afghanistan,AFG,Ukraine,UKR,0,0,10,0,10
2015,Ethiopia,ETH,Yemen,YEM,0,0,5,36,41
2016,Cameroon,CMR,Algeria,DZA,0,0,5,0,5
2016,Dem. Rep. of the Congo,COD,Algeria,DZA,0,0,10,0,10
2016,Guinea,GIN,Algeria,DZA,0,0,18,0,18
2016,Cote d'Ivoire,CIV,Algeria,DZA,0,0,19,0,19
2016,Mali,MLI,Algeria,DZA,0,0,30,5,35
2016,Cameroon,CMR,Egypt,EGY,0,0,0,5,5
2016,Congo,COG,Egypt,EGY,0,0,0,5,5
2016,Eritrea,ERI,Egypt,EGY,0,0,5,17,22
2016,Ethiopia,ETH,Egypt,EGY,5,0,45,106,156
2016,Ghana,GHA,Egypt,EGY,0,0,0,5,5
2016,Guinea-Bissau,GNB,Egypt,EGY,0,0,5,0,5
2016,Iraq,IRQ,Egypt,EGY,0,0,0,5,5
2016,Nigeria,NGA,Egypt,EGY,0,0,11,13,24
2016,Russian Federation,RUS,Egypt,EGY,0,0,11,5,16
2016,Somalia,SOM,Egypt,EGY,0,0,5,31,36
2016,Sudan,SDN,Egypt,EGY,41,0,119,285,445
2016,South Sudan,SSD,Egypt,EGY,0,0,0,15,15
2016,Uzbekistan,UZB,Egypt,EGY,0,0,10,10,20
2016,Cameroon,CMR,China,CHN,0,0,5,0,5
2016,Ghana,GHA,China,CHN,0,0,5,12,17
2016,Guinea,GIN,China,CHN,0,0,0,5,5
2016,Cote d'Ivoire,CIV,China,CHN,0,0,0,5,5
2016,Liberia,LBR,China,CHN,0,0,5,5,10
2016,Mali,MLI,China,CHN,0,0,0,5,5
2016,Nigeria,NGA,China,CHN,0,0,5,31,36
2016,Philippines,PHL,China,CHN,0,0,5,10,15
2016,Sierra Leone,SLE,China,CHN,0,0,0,5,5
2016,Somalia,SOM,China,CHN,0,0,0,5,5
2016,Uganda,UGA,China,CHN,0,0,0,5,5
2016,Zimbabwe,ZWE,China,CHN,0,0,0,5,5
2016,Central African Rep.,CAF,Cameroon,CMR,5,0,16,228,249
2016,Chad,TCD,Cameroon,CMR,0,0,46,116,162
2016,Congo,COG,Cameroon,CMR,0,0,0,5,5
2016,Dem. Rep. of the Congo,COD,Cameroon,CMR,12,0,37,79,128
2016,Guinea-Bissau,GNB,Cameroon,CMR,0,0,5,10,15
2016,Guinea,GIN,Cameroon,CMR,0,0,10,137,147
2016,Cote d'Ivoire,CIV,Cameroon,CMR,0,0,10,53,63
2016,Mali,MLI,Cameroon,CMR,0,0,0,12,12
2016,Nigeria,NGA,Cameroon,CMR,0,0,0,5,5
2016,Rwanda,RWA,Cameroon,CMR,5,0,19,37,61
2016,Senegal,SEN,Cameroon,CMR,0,0,5,37,42
2016,Sierra Leone,SLE,Cameroon,CMR,0,0,0,5,5
2016,Sudan,SDN,Cameroon,CMR,0,0,0,10,10
2016,Nepal,NPL,Micronesia (Federated States of),FSM,0,0,5,0,5
2016,Afghanistan,AFG,India,IND,159,0,50,256,465
2016,Cameroon,CMR,India,IND,0,0,0,5,5
2016,Dem. Rep. of the Congo,COD,India,IND,0,0,0,5,5
2016,Mexico,MEX,India,IND,0,0,5,5,10
2016,Myanmar,MMR,India,IND,24,0,12,20,56
2016,Nigeria,NGA,India,IND,0,0,5,0,5
2016,Somalia,SOM,India,IND,21,0,5,0,26
2016,Sudan,SDN,India,IND,5,0,0,5,10
2016,Afghanistan,AFG,Indonesia,IDN,84,0,10,0,94
2016,Cote d'Ivoire,CIV,Indonesia,IDN,0,0,0,5,5
2016,India,IND,Indonesia,IDN,0,0,5,0,5
2016,Iran (Islamic Rep. of),IRN,Indonesia,IDN,10,0,58,23,91
2016,Sri Lanka,LKA,Indonesia,IDN,11,0,62,12,85
2016,Somalia,SOM,Indonesia,IDN,0,0,5,0,5
2016,Sudan,SDN,Indonesia,IDN,0,0,5,0,5
2016,Iraq,IRQ,Jordan,JOR,5,0,0,0,5
2016,Sudan,SDN,Jordan,JOR,5,0,0,0,5
2016,Afghanistan,AFG,Kyrgyzstan,KGZ,0,0,23,0,23
2016,Egypt,EGY,Lebanon,LBN,5,0,14,0,19
2016,Cameroon,CMR,Lebanon,LBN,0,0,5,0,5
2016,Eritrea,ERI,Lebanon,LBN,0,0,5,0,5
2016,Ethiopia,ETH,Lebanon,LBN,0,0,27,0,27
2016,Iran (Islamic Rep. of),IRN,Lebanon,LBN,5,0,0,0,5
2016,Jordan,JOR,Lebanon,LBN,5,0,0,0,5
2016,Sudan,SDN,Lebanon,LBN,23,0,250,98,371
2016,Pakistan,PAK,Sri Lanka,LKA,56,0,57,0,113
2016,Chad,TCD,Mauritania,MRT,0,0,5,0,5
2016,Guinea,GIN,Mauritania,MRT,0,0,5,0,5
2016,Nigeria,NGA,Mauritania,MRT,0,0,5,0,5
2016,Senegal,SEN,Mauritania,MRT,0,0,5,0,5
2016,Afghanistan,AFG,Malaysia,MYS,12,0,14,0,26
2016,Bangladesh,BGD,Malaysia,MYS,0,0,5,0,5
2016,Iran (Islamic Rep. of),IRN,Malaysia,MYS,15,0,25,0,40
2016,Iraq,IRQ,Malaysia,MYS,5,0,0,0,5
2016,Sri Lanka,LKA,Malaysia,MYS,5,0,179,0,184
2016,Myanmar,MMR,Malaysia,MYS,0,0,201,0,201
2016,Pakistan,PAK,Malaysia,MYS,10,0,100,0,110
2016,Somalia,SOM,Malaysia,MYS,5,0,10,0,15
2016,Cameroon,CMR,Morocco,MAR,0,0,38,5,43
2016,Congo,COG,Morocco,MAR,0,0,14,0,14
2016,Dem. Rep. of the Congo,COD,Morocco,MAR,5,0,113,33,151
2016,Guinea,GIN,Morocco,MAR,0,0,36,5,41
2016,Cote d'Ivoire,CIV,Morocco,MAR,11,0,109,0,120
2016,Liberia,LBR,Morocco,MAR,0,0,5,0,5
2016,Mali,MLI,Morocco,MAR,0,0,21,10,31
2016,Nigeria,NGA,Morocco,MAR,0,0,16,10,26
2016,Rwanda,RWA,Morocco,MAR,0,0,5,0,5
2016,Senegal,SEN,Morocco,MAR,0,0,5,0,5
2016,Sierra Leone,SLE,Morocco,MAR,0,0,5,0,5
2016,Togo,TGO,Morocco,MAR,0,0,5,0,5
2016,Myanmar,MMR,Nepal,NPL,0,0,5,0,5
2016,Pakistan,PAK,Nepal,NPL,5,0,0,0,5
2016,Afghanistan,AFG,Pakistan,PAK,0,0,1734,1125,2859
2016,Somalia,SOM,Pakistan,PAK,0,0,5,0,5
2016,Afghanistan,AFG,Thailand,THA,5,0,0,0,5
2016,Cambodia,KHM,Thailand,THA,0,0,0,5,5
2016,China,CHN,Thailand,THA,0,0,5,0,5
2016,Iran (Islamic Rep. of),IRN,Thailand,THA,0,0,16,5,21
2016,Sri Lanka,LKA,Thailand,THA,0,0,5,0,5
2016,Pakistan,PAK,Thailand,THA,92,0,285,15,392
2016,Somalia,SOM,Thailand,THA,0,0,10,0,10
2016,Viet Nam,VNM,Thailand,THA,5,0,23,0,28
2016,Central African Rep.,CAF,Tunisia,TUN,5,0,0,0,5
2016,Cote d'Ivoire,CIV,Tunisia,TUN,0,0,5,5,10
2016,Afghanistan,AFG,Turkey,TUR,36,0,5,67,108
2016,Algeria,DZA,Turkey,TUR,0,0,0,5,5
2016,Egypt,EGY,Turkey,TUR,0,0,0,5,5
2016,Cameroon,CMR,Turkey,TUR,0,0,0,5,5
2016,Dem. Rep. of the Congo,COD,Turkey,TUR,0,0,0,5,5
2016,Iran (Islamic Rep. of),IRN,Turkey,TUR,143,0,48,164,355
2016,Iraq,IRQ,Turkey,TUR,0,0,5,5,10
2016,Kyrgyzstan,KGZ,Turkey,TUR,0,0,0,10,10
2016,Pakistan,PAK,Turkey,TUR,0,0,0,14,14
2016,Somalia,SOM,Turkey,TUR,5,0,0,13,18
2016,Syrian Arab Rep.,SYR,Turkey,TUR,0,0,0,14,14
2016,Uganda,UGA,Turkey,TUR,0,0,0,5,5
2016,Uzbekistan,UZB,Turkey,TUR,0,0,0,5,5
2016,Afghanistan,AFG,Ukraine,UKR,0,0,5,0,5
2016,Kyrgyzstan,KGZ,Ukraine,UKR,0,0,5,0,5
2017,Iran (Islamic Rep. of),IRN,Afghanistan,AFG,0,0,5,0,5
2017,Pakistan,PAK,Afghanistan,AFG,0,0,0,14,14
2017,Cameroon,CMR,Algeria,DZA,0,0,10,0,10
2017,Dem. Rep. of the Congo,COD,Algeria,DZA,0,0,5,0,5
2017,Guinea,GIN,Algeria,DZA,0,0,5,0,5
2017,Cote d'Ivoire,CIV,Algeria,DZA,0,0,5,0,5
2017,Mali,MLI,Algeria,DZA,5,0,5,0,10
2017,Azerbaijan,AZE,Egypt,EGY,0,0,0,5,5
2017,Chad,TCD,Egypt,EGY,10,0,0,0,10
2017,Eritrea,ERI,Egypt,EGY,5,0,5,0,10
2017,Ethiopia,ETH,Egypt,EGY,24,0,190,0,214
2017,Somalia,SOM,Egypt,EGY,5,0,5,0,10
2017,Sudan,SDN,Egypt,EGY,114,0,672,0,786
2017,South Sudan,SSD,Egypt,EGY,11,0,5,0,16
2017,Uzbekistan,UZB,Egypt,EGY,0,0,0,15,15
2017,Benin,BEN,China,CHN,0,0,0,5,5
2017,Cameroon,CMR,China,CHN,0,0,5,5,10
2017,Ghana,GHA,China,CHN,0,0,5,10,15
2017,Guinea,GIN,China,CHN,0,0,5,5,10
2017,Cote d'Ivoire,CIV,China,CHN,0,0,0,5,5
2017,Liberia,LBR,China,CHN,0,0,21,11,32
2017,Mali,MLI,China,CHN,0,0,0,5,5
2017,Nigeria,NGA,China,CHN,0,0,23,11,34
2017,Pakistan,PAK,China,CHN,5,0,0,0,5
2017,Somalia,SOM,China,CHN,0,0,5,5,10
2017,Uganda,UGA,China,CHN,0,0,5,5,10
2017,Zimbabwe,ZWE,China,CHN,0,0,0,5,5
2017,Central African Rep.,CAF,Cameroon,CMR,16,0,45,28,89
2017,Chad,TCD,Cameroon,CMR,0,0,27,16,43
2017,Dem. Rep. of the Congo,COD,Cameroon,CMR,0,0,25,5,30
2017,Guinea,GIN,Cameroon,CMR,0,0,5,0,5
2017,Cote d'Ivoire,CIV,Cameroon,CMR,0,0,10,0,10
2017,Rwanda,RWA,Cameroon,CMR,0,0,19,0,19
2017,Angola,AGO,Cuba,CUB,0,0,5,0,5
2017,Dem. Rep. of the Congo,COD,Cuba,CUB,0,0,5,0,5
2017,Afghanistan,AFG,India,IND,116,0,156,10,282
2017,Angola,AGO,India,IND,0,0,5,0,5
2017,Cameroon,CMR,India,IND,0,0,12,0,12
2017,Dem. Rep. of the Congo,COD,India,IND,0,0,5,0,5
2017,Myanmar,MMR,India,IND,12,0,29,5,46
2017,Nigeria,NGA,India,IND,0,0,10,0,10
2017,Somalia,SOM,India,IND,10,0,5,0,15
2017,Ukraine,UKR,India,IND,0,0,5,0,5
2017,Uzbekistan,UZB,India,IND,0,0,5,0,5
2017,Afghanistan,AFG,Indonesia,IDN,59,0,5,22,86
2017,Bangladesh,BGD,Indonesia,IDN,0,0,0,5,5
2017,China,CHN,Indonesia,IDN,0,0,5,0,5
2017,Cameroon,CMR,Indonesia,IDN,0,0,5,16,21
2017,Dem. Rep. of the Congo,COD,Indonesia,IDN,0,0,5,0,5
2017,Ethiopia,ETH,Indonesia,IDN,0,0,44,0,44
2017,Ghana,GHA,Indonesia,IDN,0,0,0,5,5
2017,Guinea,GIN,Indonesia,IDN,0,0,0,5,5
2017,Cote d'Ivoire,CIV,Indonesia,IDN,0,0,5,0,5
2017,Iran (Islamic Rep. of),IRN,Indonesia,IDN,11,0,36,22,69
2017,Liberia,LBR,Indonesia,IDN,0,0,0,5,5
2017,Sri Lanka,LKA,Indonesia,IDN,0,0,26,12,38
2017,Mali,MLI,Indonesia,IDN,0,0,0,5,5
2017,Myanmar,MMR,Indonesia,IDN,0,0,0,5,5
2017,Nigeria,NGA,Indonesia,IDN,0,0,20,126,146
2017,Pakistan,PAK,Indonesia,IDN,0,0,10,10,20
2017,Iraq,IRQ,Jordan,JOR,5,0,0,0,5
2017,Somalia,SOM,Jordan,JOR,5,0,0,0,5
2017,Sudan,SDN,Jordan,JOR,10,0,0,0,10
2017,Egypt,EGY,Lebanon,LBN,0,0,17,10,27
2017,Ethiopia,ETH,Lebanon,LBN,0,0,43,5,48
2017,Cote d'Ivoire,CIV,Lebanon,LBN,0,0,5,0,5
2017,Iran (Islamic Rep. of),IRN,Lebanon,LBN,0,0,0,5,5
2017,Iraq,IRQ,Lebanon,LBN,0,0,22,0,22
2017,Kenya,KEN,Lebanon,LBN,0,0,5,0,5
2017,Madagascar,MDG,Lebanon,LBN,0,0,5,0,5
2017,Pakistan,PAK,Lebanon,LBN,0,0,5,0,5
2017,Sudan,SDN,Lebanon,LBN,5,0,196,38,239
2017,Afghanistan,AFG,Sri Lanka,LKA,10,0,0,0,10
2017,Pakistan,PAK,Sri Lanka,LKA,78,0,0,0,78
2017,Cameroon,CMR,Mauritania,MRT,0,0,5,0,5
2017,Guinea,GIN,Mauritania,MRT,0,0,5,0,5
2017,Cote d'Ivoire,CIV,Mauritania,MRT,0,0,5,24,29
2017,Nigeria,NGA,Mauritania,MRT,0,0,12,5,17
2017,Senegal,SEN,Mauritania,MRT,5,0,10,0,15
2017,Togo,TGO,Mauritania,MRT,0,0,0,5,5
2017,Afghanistan,AFG,Malaysia,MYS,18,0,0,0,18
2017,Cote d'Ivoire,CIV,Malaysia,MYS,0,0,5,0,5
2017,Iran (Islamic Rep. of),IRN,Malaysia,MYS,0,0,10,0,10
2017,Iraq,IRQ,Malaysia,MYS,0,0,0,5,5
2017,Liberia,LBR,Malaysia,MYS,0,0,5,0,5
2017,Sri Lanka,LKA,Malaysia,MYS,0,0,109,0,109
2017,Myanmar,MMR,Malaysia,MYS,0,0,944,0,944
2017,Nigeria,NGA,Malaysia,MYS,0,0,5,0,5
2017,Pakistan,PAK,Malaysia,MYS,46,0,61,0,107
2017,Russian Federation,RUS,Malaysia,MYS,0,0,5,0,5
2017,Sierra Leone,SLE,Malaysia,MYS,0,0,5,0,5
2017,Somalia,SOM,Malaysia,MYS,10,0,5,0,15
2017,Sudan,SDN,Malaysia,MYS,5,0,0,0,5
2017,Tunisia,TUN,Malaysia,MYS,0,0,5,0,5
2017,Benin,BEN,Morocco,MAR,0,0,0,5,5
2017,Central African Rep.,CAF,Morocco,MAR,0,0,5,0,5
2017,Cameroon,CMR,Morocco,MAR,0,0,14,10,24
2017,Congo,COG,Morocco,MAR,0,0,5,5,10
2017,Dem. Rep. of the Congo,COD,Morocco,MAR,0,0,26,5,31
2017,Guinea,GIN,Morocco,MAR,0,0,17,14,31
2017,Cote d'Ivoire,CIV,Morocco,MAR,0,0,17,11,28
2017,Liberia,LBR,Morocco,MAR,0,0,5,5,10
2017,Mali,MLI,Morocco,MAR,0,0,5,5,10
2017,Senegal,SEN,Morocco,MAR,0,0,5,5,10
2017,Afghanistan,AFG,Pakistan,PAK,0,0,1495,141,1636
2017,Iran (Islamic Rep. of),IRN,Pakistan,PAK,0,0,10,0,10
2017,Somalia,SOM,Pakistan,PAK,0,0,5,0,5
2017,Egypt,EGY,Thailand,THA,0,0,5,0,5
2017,Cambodia,KHM,Thailand,THA,0,0,5,0,5
2017,China,CHN,Thailand,THA,0,0,5,0,5
2017,Dem. Rep. of the Congo,COD,Thailand,THA,0,0,5,0,5
2017,Ethiopia,ETH,Thailand,THA,0,0,5,0,5
2017,Palestinian,PSE,Thailand,THA,0,0,5,0,5
2017,India,IND,Thailand,THA,0,0,15,0,15
2017,Iran (Islamic Rep. of),IRN,Thailand,THA,5,0,21,5,31
2017,Sri Lanka,LKA,Thailand,THA,0,0,26,0,26
2017,Nepal,NPL,Thailand,THA,0,0,5,0,5
2017,Nigeria,NGA,Thailand,THA,0,0,5,0,5
2017,Pakistan,PAK,Thailand,THA,36,0,1273,55,1364
2017,Somalia,SOM,Thailand,THA,5,0,18,0,23
2017,Viet Nam,VNM,Thailand,THA,5,0,29,10,44
2017,Cuba,CUB,Trinidad and Tobago,TTO,5,0,0,0,5
2017,Afghanistan,AFG,Turkey,TUR,16,0,0,12,28
2017,Iran (Islamic Rep. of),IRN,Turkey,TUR,54,0,18,85,157
2017,Iraq,IRQ,Turkey,TUR,5,0,0,0,5
2017,Libya,LBY,Turkey,TUR,0,0,0,10,10
2017,Somalia,SOM,Turkey,TUR,5,0,0,0,5
2017,Uganda,UGA,Turkey,TUR,0,0,0,5,5
2018,Pakistan,PAK,Afghanistan,AFG,0,0,5,0,5
2018,Burkina Faso,BFA,Algeria,DZA,0,0,5,0,5
2018,Cameroon,CMR,Algeria,DZA,5,0,5,0,10
2018,Congo,COG,Algeria,DZA,0,0,0,5,5
2018,Dem. Rep. of the Congo,COD,Algeria,DZA,0,0,23,0,23
2018,Guinea,GIN,Algeria,DZA,0,0,49,5,54
2018,Cote d'Ivoire,CIV,Algeria,DZA,0,0,36,0,36
2018,Mali,MLI,Algeria,DZA,0,0,34,5,39
2018,Senegal,SEN,Algeria,DZA,0,0,5,0,5
2018,Djibouti,DJI,Egypt,EGY,0,0,5,0,5
2018,Ethiopia,ETH,Egypt,EGY,44,0,359,5,408
2018,Somalia,SOM,Egypt,EGY,0,0,5,0,5
2018,Sudan,SDN,Egypt,EGY,103,0,576,19,698
2018,Uzbekistan,UZB,Egypt,EGY,0,0,10,0,10
2018,Afghanistan,AFG,Azerbaijan,AZE,0,0,0,5,5
2018,Burundi,BDI,China,CHN,0,0,0,5,5
2018,Benin,BEN,China,CHN,0,0,0,5,5
2018,Cameroon,CMR,China,CHN,0,0,20,5,25
2018,Colombia,COL,China,CHN,0,0,5,0,5
2018,Gambia,GMB,China,CHN,0,0,5,0,5
2018,Ghana,GHA,China,CHN,0,0,13,10,23
2018,Guinea,GIN,China,CHN,0,0,5,0,5
2018,Cote d'Ivoire,CIV,China,CHN,0,0,0,5,5
2018,Kenya,KEN,China,CHN,0,0,5,0,5
2018,Liberia,LBR,China,CHN,0,0,26,38,64
2018,Nigeria,NGA,China,CHN,0,0,12,21,33
2018,Sierra Leone,SLE,China,CHN,0,0,5,0,5
2018,Somalia,SOM,China,CHN,0,0,5,0,5
2018,Uganda,UGA,China,CHN,0,0,14,5,19
2018,Zimbabwe,ZWE,China,CHN,0,0,12,5,17
2018,Central African Rep.,CAF,Cameroon,CMR,39,0,31,0,70
2018,Chad,TCD,Cameroon,CMR,0,0,17,5,22
2018,Dem. Rep. of the Congo,COD,Cameroon,CMR,0,0,10,10,20
2018,Mali,MLI,Cameroon,CMR,0,0,5,0,5
2018,Rwanda,RWA,Cameroon,CMR,0,0,13,0,13
2018,Iran (Islamic Rep. of),IRN,Cuba,CUB,0,0,5,0,5
2018,Afghanistan,AFG,India,IND,36,0,240,150,426
2018,Myanmar,MMR,India,IND,10,0,24,0,34
2018,Somalia,SOM,India,IND,0,0,5,0,5
2018,Algeria,DZA,Indonesia,IDN,0,0,0,5,5
2018,Egypt,EGY,Indonesia,IDN,0,0,0,5,5
2018,Bangladesh,BGD,Indonesia,IDN,0,0,5,5,10
2018,Cameroon,CMR,Indonesia,IDN,0,0,21,17,38
2018,Dem. Rep. of the Congo,COD,Indonesia,IDN,0,0,5,5,10
2018,Ethiopia,ETH,Indonesia,IDN,5,0,10,25,40
2018,Cote d'Ivoire,CIV,Indonesia,IDN,0,0,5,5,10
2018,India,IND,Indonesia,IDN,0,0,0,5,5
2018,Iran (Islamic Rep. of),IRN,Indonesia,IDN,42,0,20,5,67
2018,Iraq,IRQ,Indonesia,IDN,0,0,0,5,5
2018,Sri Lanka,LKA,Indonesia,IDN,0,0,31,41,72
2018,Morocco,MAR,Indonesia,IDN,0,0,5,0,5
2018,Nigeria,NGA,Indonesia,IDN,0,0,11,13,24
2018,Sierra Leone,SLE,Indonesia,IDN,0,0,0,5,5
2018,Somalia,SOM,Indonesia,IDN,5,0,5,0,10
2018,Sudan,SDN,Indonesia,IDN,0,0,0,5,5
2018,Egypt,EGY,Lebanon,LBN,0,0,10,0,10
2018,Eritrea,ERI,Lebanon,LBN,0,0,5,0,5
2018,Ethiopia,ETH,Lebanon,LBN,0,0,55,0,55
2018,Iraq,IRQ,Lebanon,LBN,0,0,5,5,10
2018,Sudan,SDN,Lebanon,LBN,5,0,85,11,101
2018,Pakistan,PAK,Sri Lanka,LKA,22,0,0,0,22
2018,Cameroon,CMR,Mauritania,MRT,0,0,5,0,5
2018,Guinea,GIN,Mauritania,MRT,0,0,10,5,15
2018,Cote d'Ivoire,CIV,Mauritania,MRT,0,0,5,10,15
2018,Mali,MLI,Mauritania,MRT,0,0,11,0,11
2018,Nigeria,NGA,Mauritania,MRT,0,0,10,10,20
2018,Senegal,SEN,Mauritania,MRT,0,0,0,5,5
2018,Afghanistan,AFG,Malaysia,MYS,25,0,32,0,57
2018,China,CHN,Malaysia,MYS,5,0,0,0,5
2018,Guinea,GIN,Malaysia,MYS,0,0,5,0,5
2018,India,IND,Malaysia,MYS,0,0,5,0,5
2018,Iran (Islamic Rep. of),IRN,Malaysia,MYS,0,0,12,0,12
2018,Liberia,LBR,Malaysia,MYS,0,0,5,0,5
2018,Sri Lanka,LKA,Malaysia,MYS,5,0,113,0,118
2018,Mali,MLI,Malaysia,MYS,0,0,5,0,5
2018,Myanmar,MMR,Malaysia,MYS,5,0,3524,0,3529
2018,Nigeria,NGA,Malaysia,MYS,0,0,5,0,5
2018,Pakistan,PAK,Malaysia,MYS,31,0,145,0,176
2018,Somalia,SOM,Malaysia,MYS,5,0,37,0,42
2018,Sudan,SDN,Malaysia,MYS,0,0,5,0,5
2018,Uzbekistan,UZB,Malaysia,MYS,0,0,5,0,5
2018,Burkina Faso,BFA,Morocco,MAR,0,0,5,0,5
2018,Central African Rep.,CAF,Morocco,MAR,0,0,5,0,5
2018,Cameroon,CMR,Morocco,MAR,0,0,25,21,46
2018,Congo,COG,Morocco,MAR,0,0,20,5,25
2018,Dem. Rep. of the Congo,COD,Morocco,MAR,0,0,49,10,59
2018,Guinea,GIN,Morocco,MAR,0,0,32,26,58
2018,Cote d'Ivoire,CIV,Morocco,MAR,5,0,29,21,55
2018,Liberia,LBR,Morocco,MAR,0,0,5,0,5
2018,Mali,MLI,Morocco,MAR,0,0,5,5,10
2018,Nigeria,NGA,Morocco,MAR,0,0,10,12,22
2018,Senegal,SEN,Morocco,MAR,5,0,5,5,15
2018,Sierra Leone,SLE,Morocco,MAR,0,0,0,5,5
2018,Sudan,SDN,Morocco,MAR,0,0,0,5,5
2018,Myanmar,MMR,Nepal,NPL,0,0,0,5,5
2018,Cambodia,KHM,Thailand,THA,0,0,39,5,44
2018,China,CHN,Thailand,THA,0,0,10,5,15
2018,Ethiopia,ETH,Thailand,THA,0,0,5,0,5
2018,Palestinian,PSE,Thailand,THA,0,0,5,0,5
2018,Guinea,GIN,Thailand,THA,0,0,0,5,5
2018,Iran (Islamic Rep. of),IRN,Thailand,THA,0,0,20,0,20
2018,Lao People's Dem. Rep.,LAO,Thailand,THA,0,0,5,0,5
2018,Sri Lanka,LKA,Thailand,THA,5,0,15,5,25
2018,Pakistan,PAK,Thailand,THA,56,0,470,35,561
2018,Somalia,SOM,Thailand,THA,5,0,35,5,45
2018,Viet Nam,VNM,Thailand,THA,40,0,125,5,170
2018,Dem. Rep. of the Congo,COD,Tunisia,TUN,0,0,5,0,5
2018,Guinea,GIN,Tunisia,TUN,0,0,5,0,5
2018,Mali,MLI,Tunisia,TUN,0,0,5,0,5
2018,Nigeria,NGA,Tunisia,TUN,0,0,5,0,5
2018,Iran (Islamic Rep. of),IRN,Turkey,TUR,31,0,17,19,67
2019,Cameroon,CMR,Algeria,DZA,5,0,10,5,20
2019,Dem. Rep. of the Congo,COD,Algeria,DZA,0,0,16,0,16
2019,Guinea,GIN,Algeria,DZA,0,0,35,5,40
2019,Cote d'Ivoire,CIV,Algeria,DZA,5,0,26,10,41
2019,Mali,MLI,Algeria,DZA,5,0,19,5,29
2019,Nigeria,NGA,Algeria,DZA,0,0,5,0,5
2019,Ethiopia,ETH,Egypt,EGY,53,0,533,13,599
2019,Russian Federation,RUS,Egypt,EGY,0,0,11,0,11
2019,Somalia,SOM,Egypt,EGY,0,0,10,0,10
2019,Sudan,SDN,Egypt,EGY,358,0,401,5,764
2019,Tajikistan,TJK,Egypt,EGY,0,0,5,0,5
2019,Uzbekistan,UZB,Egypt,EGY,0,0,32,0,32
2019,Zimbabwe,ZWE,Egypt,EGY,5,0,5,0,10
2019,Russian Federation,RUS,Azerbaijan,AZE,0,0,0,5,5
2019,Cameroon,CMR,China,CHN,0,0,10,5,15
2019,Ghana,GHA,China,CHN,0,0,0,5,5
2019,Cote d'Ivoire,CIV,China,CHN,0,0,0,5,5
2019,Kenya,KEN,China,CHN,0,0,15,0,15
2019,Nigeria,NGA,China,CHN,0,0,5,0,5
2019,Uganda,UGA,China,CHN,0,0,17,5,22
2019,Zimbabwe,ZWE,China,CHN,0,0,10,10,20
2019,Central African Rep.,CAF,Cameroon,CMR,52,0,5,24,81
2019,Chad,TCD,Cameroon,CMR,0,0,5,0,5
2019,Congo,COG,Cameroon,CMR,0,0,5,0,5
2019,Dem. Rep. of the Congo,COD,Cameroon,CMR,0,0,0,5,5
2019,Cote d'Ivoire,CIV,Cameroon,CMR,0,0,5,0,5
2019,Iran (Islamic Rep. of),IRN,Cuba,CUB,0,0,5,0,5
2019,Philippines,PHL,"China, Hong Kong SAR",HKG,5,0,0,0,5
2019,Sudan,SDN,"China, Hong Kong SAR",HKG,5,0,0,0,5
2019,Afghanistan,AFG,India,IND,54,0,114,144,312
2019,Myanmar,MMR,India,IND,0,0,0,18,18
2019,Somalia,SOM,India,IND,5,0,5,14,24
2019,Egypt,EGY,Indonesia,IDN,0,0,0,5,5
2019,Bangladesh,BGD,Indonesia,IDN,0,0,5,5,10
2019,Cameroon,CMR,Indonesia,IDN,0,0,10,0,10
2019,Dem. Rep. of the Congo,COD,Indonesia,IDN,0,0,5,0,5
2019,Ethiopia,ETH,Indonesia,IDN,0,0,10,5,15
2019,Cote d'Ivoire,CIV,Indonesia,IDN,0,0,5,5,10
2019,Iran (Islamic Rep. of),IRN,Indonesia,IDN,30,0,10,13,53
2019,Sri Lanka,LKA,Indonesia,IDN,0,0,5,20,25
2019,Somalia,SOM,Indonesia,IDN,5,0,0,0,5
2019,Sudan,SDN,Indonesia,IDN,0,0,0,5,5
2019,Egypt,EGY,Jordan,JOR,0,0,14,0,14
2019,Iraq,IRQ,Jordan,JOR,5,0,0,15,20
2019,Sudan,SDN,Jordan,JOR,10,0,17,0,27
2019,Yemen,YEM,Jordan,JOR,0,0,0,5,5
2019,Egypt,EGY,Lebanon,LBN,0,0,14,12,26
2019,Bahrain,BHR,Lebanon,LBN,0,0,0,5,5
2019,Eritrea,ERI,Lebanon,LBN,0,0,5,0,5
2019,Ethiopia,ETH,Lebanon,LBN,0,0,78,68,146
2019,Iran (Islamic Rep. of),IRN,Lebanon,LBN,0,0,0,5,5
2019,Iraq,IRQ,Lebanon,LBN,5,0,0,656,661
2019,Jordan,JOR,Lebanon,LBN,0,0,0,26,26
2019,Nigeria,NGA,Lebanon,LBN,0,0,19,0,19
2019,Philippines,PHL,Lebanon,LBN,0,0,12,0,12
2019,Sudan,SDN,Lebanon,LBN,5,0,51,32,88
2019,Syrian Arab Rep.,SYR,Lebanon,LBN,0,0,0,26,26
2019,Yemen,YEM,Lebanon,LBN,0,0,0,5,5
2019,Iran (Islamic Rep. of),IRN,Sri Lanka,LKA,5,0,0,0,5
2019,Pakistan,PAK,Sri Lanka,LKA,0,0,14,0,14
2019,Guinea-Bissau,GNB,Mauritania,MRT,0,0,0,5,5
2019,Guinea,GIN,Mauritania,MRT,0,0,5,0,5
2019,Nigeria,NGA,Mauritania,MRT,0,0,10,5,15
2019,Senegal,SEN,Mauritania,MRT,0,0,5,0,5
2019,Sierra Leone,SLE,Mauritania,MRT,0,0,14,5,19
2019,Togo,TGO,Mauritania,MRT,0,0,5,0,5
2019,Afghanistan,AFG,Malaysia,MYS,66,0,10,0,76
2019,Central African Rep.,CAF,Malaysia,MYS,5,0,0,0,5
2019,Iran (Islamic Rep. of),IRN,Malaysia,MYS,5,0,5,0,10
2019,Liberia,LBR,Malaysia,MYS,0,0,5,0,5
2019,Sri Lanka,LKA,Malaysia,MYS,0,0,54,0,54
2019,Myanmar,MMR,Malaysia,MYS,77,0,218,0,295
2019,Pakistan,PAK,Malaysia,MYS,23,0,59,0,82
2019,Somalia,SOM,Malaysia,MYS,19,0,0,0,19
2019,Sudan,SDN,Malaysia,MYS,0,0,5,0,5
2019,Central African Rep.,CAF,Morocco,MAR,0,0,5,0,5
2019,Cameroon,CMR,Morocco,MAR,0,0,32,10,42
2019,Congo,COG,Morocco,MAR,0,0,0,5,5
2019,Dem. Rep. of the Congo,COD,Morocco,MAR,0,0,11,10,21
2019,Guinea,GIN,Morocco,MAR,0,0,27,24,51
2019,Cote d'Ivoire,CIV,Morocco,MAR,0,0,18,11,29
2019,Liberia,LBR,Morocco,MAR,0,0,0,5,5
2019,Mali,MLI,Morocco,MAR,0,0,10,5,15
2019,Nigeria,NGA,Morocco,MAR,0,0,0,5,5
2019,Senegal,SEN,Morocco,MAR,0,0,10,0,10
2019,Sierra Leone,SLE,Morocco,MAR,0,0,0,5,5
2019,Togo,TGO,Morocco,MAR,0,0,5,5,10
2019,Afghanistan,AFG,Pakistan,PAK,0,0,0,5,5
2019,Cambodia,KHM,Thailand,THA,5,0,44,5,54
2019,Cameroon,CMR,Thailand,THA,5,0,0,0,5
2019,Iran (Islamic Rep. of),IRN,Thailand,THA,5,0,0,0,5
2019,Pakistan,PAK,Thailand,THA,0,0,19,5,24
2019,Russian Federation,RUS,Thailand,THA,0,0,5,0,5
2019,Somalia,SOM,Thailand,THA,0,0,10,0,10
2019,Viet Nam,VNM,Thailand,THA,5,0,96,0,101
2019,Cameroon,CMR,Tunisia,TUN,0,0,5,0,5
2019,Cote d'Ivoire,CIV,Tunisia,TUN,0,0,5,0,5
2019,Nigeria,NGA,Tunisia,TUN,0,0,5,0,5
2020,Cameroon,CMR,Algeria,DZA,0,0,19,0,19
2020,Dem. Rep. of the Congo,COD,Algeria,DZA,0,0,11,0,11
2020,Guinea,GIN,Algeria,DZA,0,0,13,5,18
2020,Cote d'Ivoire,CIV,Algeria,DZA,0,0,11,5,16
2020,Mali,MLI,Algeria,DZA,0,0,13,0,13
2020,Nigeria,NGA,Algeria,DZA,0,0,0,5,5
2020,Togo,TGO,Algeria,DZA,0,0,5,0,5
2020,Ethiopia,ETH,Egypt,EGY,24,0,58,0,82
2020,Sudan,SDN,Egypt,EGY,329,0,69,0,398
2020,Uzbekistan,UZB,Egypt,EGY,0,0,10,0,10
2020,Afghanistan,AFG,Azerbaijan,AZE,5,0,0,0,5
2020,Ghana,GHA,China,CHN,0,0,11,0,11
2020,Kenya,KEN,China,CHN,0,0,10,0,10
2020,Liberia,LBR,China,CHN,0,0,5,0,5
2020,Nigeria,NGA,China,CHN,0,0,5,0,5
2020,Uganda,UGA,China,CHN,0,0,26,0,26
2020,Zimbabwe,ZWE,China,CHN,0,0,18,0,18
2020,Central African Rep.,CAF,Cameroon,CMR,14,0,0,64,78
2020,Chad,TCD,Cameroon,CMR,0,0,0,128,128
2020,Congo,COG,Cameroon,CMR,0,0,0,5,5
2020,Dem. Rep. of the Congo,COD,Cameroon,CMR,0,0,0,36,36
2020,Guinea,GIN,Cameroon,CMR,0,0,0,5,5
2020,Cote d'Ivoire,CIV,Cameroon,CMR,0,0,0,12,12
2020,Mali,MLI,Cameroon,CMR,0,0,0,5,5
2020,Rwanda,RWA,Cameroon,CMR,0,0,0,28,28
2020,Senegal,SEN,Cameroon,CMR,0,0,0,5,5
2020,Iran (Islamic Rep. of),IRN,Cuba,CUB,0,0,13,0,13
2020,Afghanistan,AFG,India,IND,30,0,46,243,319
2020,Dem. Rep. of the Congo,COD,India,IND,0,0,0,5,5
2020,Myanmar,MMR,India,IND,14,0,0,5,19
2020,Somalia,SOM,India,IND,0,0,0,11,11
2020,Sudan,SDN,India,IND,0,0,0,5,5
2020,Iran (Islamic Rep. of),IRN,Indonesia,IDN,0,0,0,5,5
2020,Egypt,EGY,Jordan,JOR,0,0,0,5,5
2020,Sudan,SDN,Jordan,JOR,5,0,0,0,5
2020,Egypt,EGY,Lebanon,LBN,0,0,5,24,29
2020,Bangladesh,BGD,Lebanon,LBN,0,0,5,0,5
2020,Eritrea,ERI,Lebanon,LBN,0,0,0,5,5
2020,Ethiopia,ETH,Lebanon,LBN,5,0,26,12,43
2020,Iran (Islamic Rep. of),IRN,Lebanon,LBN,0,0,0,5,5
2020,Iraq,IRQ,Lebanon,LBN,0,0,5,249,254
2020,Nigeria,NGA,Lebanon,LBN,0,0,5,0,5
2020,Sudan,SDN,Lebanon,LBN,5,0,12,65,82
2020,Central African Rep.,CAF,Mauritania,MRT,0,0,5,5,10
2020,Cameroon,CMR,Mauritania,MRT,0,0,5,0,5
2020,Dem. Rep. of the Congo,COD,Mauritania,MRT,0,0,5,0,5
2020,Guinea,GIN,Mauritania,MRT,0,0,15,0,15
2020,Cote d'Ivoire,CIV,Mauritania,MRT,0,0,5,0,5
2020,Mali,MLI,Mauritania,MRT,0,0,10,0,10
2020,Nigeria,NGA,Mauritania,MRT,0,0,5,0,5
2020,Senegal,SEN,Mauritania,MRT,11,0,5,0,16
2020,Sierra Leone,SLE,Mauritania,MRT,0,0,16,0,16
2020,Togo,TGO,Mauritania,MRT,0,0,14,0,14
2020,Afghanistan,AFG,Malaysia,MYS,20,0,0,5,25
2020,Iran (Islamic Rep. of),IRN,Malaysia,MYS,14,0,0,0,14
2020,Sri Lanka,LKA,Malaysia,MYS,0,0,10,66,76
2020,Myanmar,MMR,Malaysia,MYS,228,0,22,248,498
2020,Pakistan,PAK,Malaysia,MYS,0,0,11,15,26
2020,Sierra Leone,SLE,Malaysia,MYS,0,0,5,0,5
2020,Somalia,SOM,Malaysia,MYS,71,0,10,0,81
2020,Sudan,SDN,Malaysia,MYS,12,0,5,0,17
2020,Yemen,YEM,Malaysia,MYS,0,0,0,5,5
2020,Cameroon,CMR,Morocco,MAR,5,0,21,38,64
2020,Congo,COG,Morocco,MAR,0,0,0,5,5
2020,Dem. Rep. of the Congo,COD,Morocco,MAR,0,0,10,11,21
2020,Guinea,GIN,Morocco,MAR,0,0,46,28,74
2020,Cote d'Ivoire,CIV,Morocco,MAR,0,0,13,5,18
2020,Liberia,LBR,Morocco,MAR,0,0,5,0,5
2020,Mali,MLI,Morocco,MAR,0,0,5,0,5
2020,Nigeria,NGA,Morocco,MAR,0,0,13,5,18
2020,Senegal,SEN,Morocco,MAR,0,0,12,0,12
2020,Pakistan,PAK,Nepal,NPL,0,0,12,0,12
2020,Egypt,EGY,Thailand,THA,5,0,0,0,5
2020,Cambodia,KHM,Thailand,THA,12,0,0,5,17
2020,Kuwait,KWT,Thailand,THA,0,0,5,0,5
2020,Sri Lanka,LKA,Thailand,THA,0,0,11,0,11
2020,Pakistan,PAK,Thailand,THA,5,0,13,0,18
2020,Somalia,SOM,Thailand,THA,5,0,5,0,10
2020,Viet Nam,VNM,Thailand,THA,10,0,14,0,24
2020,Eritrea,ERI,Tunisia,TUN,0,0,10,0,10
2020,Ethiopia,ETH,Tunisia,TUN,0,0,5,0,5
2020,Cote d'Ivoire,CIV,Tunisia,TUN,0,0,5,0,5
2020,Somalia,SOM,Tunisia,TUN,0,0,5,0,5
2004,Angola,AGO,Dem. Rep. of the Congo,COD,0,0,10,0,10
2004,Burundi,BDI,Dem. Rep. of the Congo,COD,48,0,14,17,79
2004,Central African Rep.,CAF,Dem. Rep. of the Congo,COD,0,0,5,5,10
2004,Congo,COG,Dem. Rep. of the Congo,COD,0,0,11,14,25
2004,Kenya,KEN,Dem. Rep. of the Congo,COD,0,0,0,5,5
2004,Liberia,LBR,Dem. Rep. of the Congo,COD,0,0,24,18,42
2004,Rwanda,RWA,Dem. Rep. of the Congo,COD,5,0,13,131,149
2004,Sierra Leone,SLE,Dem. Rep. of the Congo,COD,0,0,0,10,10
2004,Uganda,UGA,Dem. Rep. of the Congo,COD,0,0,0,5,5
2004,Afghanistan,AFG,Syrian Arab Rep.,SYR,10,0,5,0,15
2004,Congo,COG,Syrian Arab Rep.,SYR,0,0,0,5,5
2004,Eritrea,ERI,Syrian Arab Rep.,SYR,5,0,0,0,5
2004,Palestinian,PSE,Syrian Arab Rep.,SYR,0,0,5,0,5
2004,Ghana,GHA,Syrian Arab Rep.,SYR,0,0,0,5,5
2004,Iran (Islamic Rep. of),IRN,Syrian Arab Rep.,SYR,0,0,5,0,5
2004,Iraq,IRQ,Syrian Arab Rep.,SYR,16,0,5,5438,5459
2004,Mauritania,MRT,Syrian Arab Rep.,SYR,0,0,5,0,5
2004,Somalia,SOM,Syrian Arab Rep.,SYR,58,0,44,78,180
2004,Sudan,SDN,Syrian Arab Rep.,SYR,34,0,57,0,91
2004,Stateless,XXA,Syrian Arab Rep.,SYR,0,0,5,277,282
2005,Angola,AGO,Dem. Rep. of the Congo,COD,5,0,5,21,31
2005,Burundi,BDI,Dem. Rep. of the Congo,COD,57,0,10,41,108
2005,Central African Rep.,CAF,Dem. Rep. of the Congo,COD,0,0,5,5,10
2005,Congo,COG,Dem. Rep. of the Congo,COD,0,0,11,13,24
2005,Cote d'Ivoire,CIV,Dem. Rep. of the Congo,COD,0,0,0,11,11
2005,Kenya,KEN,Dem. Rep. of the Congo,COD,0,0,0,5,5
2005,Liberia,LBR,Dem. Rep. of the Congo,COD,0,0,14,77,91
2005,Rwanda,RWA,Dem. Rep. of the Congo,COD,33,0,12,33,78
2005,Sierra Leone,SLE,Dem. Rep. of the Congo,COD,0,0,0,5,5
2005,Somalia,SOM,Dem. Rep. of the Congo,COD,0,0,0,15,15
2005,Sudan,SDN,Dem. Rep. of the Congo,COD,0,0,0,10,10
2005,Uganda,UGA,Dem. Rep. of the Congo,COD,0,0,0,5,5
2005,Eritrea,ERI,Sudan,SDN,36,0,0,0,36
2005,Ethiopia,ETH,Sudan,SDN,5,0,0,0,5
2005,Somalia,SOM,Sudan,SDN,5,0,0,0,5
2005,Afghanistan,AFG,Syrian Arab Rep.,SYR,5,0,54,0,59
2005,Chad,TCD,Syrian Arab Rep.,SYR,0,0,5,0,5
2005,Eritrea,ERI,Syrian Arab Rep.,SYR,0,0,10,0,10
2005,Iran (Islamic Rep. of),IRN,Syrian Arab Rep.,SYR,13,0,30,0,43
2005,Jordan,JOR,Syrian Arab Rep.,SYR,0,0,5,0,5
2005,Liberia,LBR,Syrian Arab Rep.,SYR,0,0,5,0,5
2005,Morocco,MAR,Syrian Arab Rep.,SYR,0,0,5,0,5
2005,Pakistan,PAK,Syrian Arab Rep.,SYR,0,0,5,0,5
2005,Somalia,SOM,Syrian Arab Rep.,SYR,103,0,219,0,322
2005,Sudan,SDN,Syrian Arab Rep.,SYR,20,0,176,0,196
2005,Turkey,TUR,Syrian Arab Rep.,SYR,0,0,5,0,5
2005,Stateless,XXA,Syrian Arab Rep.,SYR,0,0,5,0,5
2006,Burundi,BDI,Dem. Rep. of the Congo,COD,5,0,0,25,30
2006,Congo,COG,Dem. Rep. of the Congo,COD,0,0,5,5,10
2006,Cote d'Ivoire,CIV,Dem. Rep. of the Congo,COD,0,0,0,5,5
2006,Liberia,LBR,Dem. Rep. of the Congo,COD,0,0,0,10,10
2006,Rwanda,RWA,Dem. Rep. of the Congo,COD,12,0,0,54,66
2001,Afghanistan,AFG,Thailand,THA,17,0,5,5,27
2001,Cambodia,KHM,Thailand,THA,28,0,57,5,90
2001,China,CHN,Thailand,THA,27,0,32,5,64
2001,Palestinian,PSE,Thailand,THA,5,0,0,0,5
2001,Iran (Islamic Rep. of),IRN,Thailand,THA,5,0,32,17,54
2001,Iraq,IRQ,Thailand,THA,29,0,49,28,106
2001,Dem. People's Rep. of Korea,PRK,Thailand,THA,0,0,0,62,62
2001,Sri Lanka,LKA,Thailand,THA,5,0,13,5,23
2001,Myanmar,MMR,Thailand,THA,480,0,269,95,844
2001,Unknown ,,Thailand,THA,55,0,76,68,199
2002,Afghanistan,AFG,Azerbaijan,AZE,69,0,0,19,88
2002,Palestinian,PSE,Azerbaijan,AZE,10,0,0,0,10
2002,Iran (Islamic Rep. of),IRN,Azerbaijan,AZE,28,0,32,0,60
2002,Iraq,IRQ,Azerbaijan,AZE,14,0,13,5,32
2002,Sri Lanka,LKA,Azerbaijan,AZE,0,0,0,10,10
2002,Pakistan,PAK,Azerbaijan,AZE,0,0,0,10,10
2002,Russian Federation,RUS,Azerbaijan,AZE,48,0,0,0,48
2002,Turkey,TUR,Azerbaijan,AZE,0,0,0,5,5
2002,Yemen,YEM,Azerbaijan,AZE,0,0,0,10,10
2002,Afghanistan,AFG,Thailand,THA,0,0,12,5,17
2002,Cambodia,KHM,Thailand,THA,19,0,32,0,51
2002,China,CHN,Thailand,THA,21,0,22,14,57
2002,Iran (Islamic Rep. of),IRN,Thailand,THA,10,0,36,18,64
2002,Iraq,IRQ,Thailand,THA,13,0,49,50,112
2002,Dem. People's Rep. of Korea,PRK,Thailand,THA,0,0,0,174,174
2002,Sri Lanka,LKA,Thailand,THA,10,0,32,22,64
2002,Myanmar,MMR,Thailand,THA,455,0,465,300,1220
2002,Viet Nam,VNM,Thailand,THA,5,0,37,11,53
2002,Unknown ,,Thailand,THA,24,0,261,228,513
2003,Cambodia,KHM,Thailand,THA,23,0,5,5,33
2003,China,CHN,Thailand,THA,0,0,17,17,34
2003,Cameroon,CMR,Thailand,THA,5,0,0,14,19
2003,Congo,COG,Thailand,THA,0,0,0,10,10
2003,Palestinian,PSE,Thailand,THA,10,0,0,0,10
2003,Germany,DEU,Thailand,THA,0,0,5,0,5
2003,Guinea,GIN,Thailand,THA,0,0,0,5,5
2003,Cote d'Ivoire,CIV,Thailand,THA,0,0,0,10,10
2003,India,IND,Thailand,THA,5,0,0,5,10
2003,Indonesia,IDN,Thailand,THA,5,0,0,0,5
2003,Iran (Islamic Rep. of),IRN,Thailand,THA,10,0,14,12,36
2003,Iraq,IRQ,Thailand,THA,12,0,10,41,63
2003,Dem. People's Rep. of Korea,PRK,Thailand,THA,0,0,0,123,123
2003,Lao People's Dem. Rep.,LAO,Thailand,THA,5,0,0,44,49
2003,Liberia,LBR,Thailand,THA,5,0,48,96,149
2003,Sri Lanka,LKA,Thailand,THA,5,0,11,69,85
2003,Myanmar,MMR,Thailand,THA,657,0,161,758,1576
2003,Nigeria,NGA,Thailand,THA,0,0,39,40,79
2003,Pakistan,PAK,Thailand,THA,5,0,12,16,33
2003,Sierra Leone,SLE,Thailand,THA,0,0,10,20,30
2003,Somalia,SOM,Thailand,THA,5,0,0,5,10
2003,Viet Nam,VNM,Thailand,THA,0,0,11,5,16
2003,Sudan,SDN,Thailand,THA,0,0,5,0,5
2004,Burundi,BDI,Cameroon,CMR,12,0,0,0,12
2004,Central African Rep.,CAF,Cameroon,CMR,256,0,344,24,624
2004,Chad,TCD,Cameroon,CMR,31,0,195,0,226
2004,Congo,COG,Cameroon,CMR,22,0,17,0,39
2004,Dem. Rep. of the Congo,COD,Cameroon,CMR,254,0,211,10,475
2004,Cote d'Ivoire,CIV,Cameroon,CMR,10,0,14,0,24
2004,Liberia,LBR,Cameroon,CMR,5,0,12,5,22
2004,Rwanda,RWA,Cameroon,CMR,69,0,79,0,148
2004,Unknown ,,Cameroon,CMR,16,0,21,0,37
2004,Afghanistan,AFG,Cyprus,CYP,5,0,0,5,10
2004,Egypt,EGY,Cyprus,CYP,0,0,5,0,5
2004,Bangladesh,BGD,Cyprus,CYP,0,0,0,5,5
2004,Bosnia and Herzegovina,BIH,Cyprus,CYP,0,0,5,0,5
2004,Palestinian,PSE,Cyprus,CYP,5,10,10,5,30
2004,Georgia,GEO,Cyprus,CYP,0,0,5,0,5
2004,Iran (Islamic Rep. of),IRN,Cyprus,CYP,14,25,5,12,56
2004,Iraq,IRQ,Cyprus,CYP,0,0,0,68,68
2004,Kyrgyzstan,KGZ,Cyprus,CYP,5,0,5,0,10
2004,Pakistan,PAK,Cyprus,CYP,0,0,10,5,15
2004,Russian Federation,RUS,Cyprus,CYP,0,0,11,0,11
2004,Serbia and Kosovo: S/RES/1244 (1999),SRB,Cyprus,CYP,0,11,10,0,21
2004,Turkey,TUR,Cyprus,CYP,5,0,12,5,22
2004,Burundi,BDI,"China, Hong Kong SAR",HKG,5,0,0,0,5
2004,Cameroon,CMR,"China, Hong Kong SAR",HKG,10,0,18,5,33
2004,Congo,COG,"China, Hong Kong SAR",HKG,0,0,5,0,5
2004,Dem. Rep. of the Congo,COD,"China, Hong Kong SAR",HKG,0,0,5,5,10
2004,Ethiopia,ETH,"China, Hong Kong SAR",HKG,5,0,5,0,10
2004,Ghana,GHA,"China, Hong Kong SAR",HKG,0,0,0,5,5
2004,India,IND,"China, Hong Kong SAR",HKG,0,0,0,5,5
2004,Liberia,LBR,"China, Hong Kong SAR",HKG,5,0,5,5,15
2004,Sri Lanka,LKA,"China, Hong Kong SAR",HKG,0,0,24,46,70
2004,Nepal,NPL,"China, Hong Kong SAR",HKG,0,0,17,49,66
2004,Nigeria,NGA,"China, Hong Kong SAR",HKG,0,0,5,5,10
2004,Pakistan,PAK,"China, Hong Kong SAR",HKG,18,0,29,17,64
2004,Somalia,SOM,"China, Hong Kong SAR",HKG,5,0,0,0,5
2004,Viet Nam,VNM,"China, Hong Kong SAR",HKG,5,0,0,0,5
2004,Togo,TGO,"China, Hong Kong SAR",HKG,0,0,5,0,5
2004,Afghanistan,AFG,Indonesia,IDN,31,0,0,5,36
2004,China,CHN,Indonesia,IDN,0,0,5,0,5
2004,Dem. Rep. of the Congo,COD,Indonesia,IDN,0,0,5,0,5
2004,Iran (Islamic Rep. of),IRN,Indonesia,IDN,36,0,0,0,36
2004,Iraq,IRQ,Indonesia,IDN,0,0,0,10,10
2004,Liberia,LBR,Indonesia,IDN,0,0,5,5,10
2004,Myanmar,MMR,Indonesia,IDN,0,10,0,0,10
2004,Somalia,SOM,Indonesia,IDN,0,5,0,0,5
2004,Viet Nam,VNM,Indonesia,IDN,5,0,0,0,5
2004,Turkey,TUR,Indonesia,IDN,0,0,0,5,5
2004,Algeria,DZA,Lebanon,LBN,0,0,0,10,10
2004,Egypt,EGY,Lebanon,LBN,0,0,5,0,5
2004,Burundi,BDI,Lebanon,LBN,0,0,0,5,5
2004,Ethiopia,ETH,Lebanon,LBN,0,0,5,0,5
2004,Cote d'Ivoire,CIV,Lebanon,LBN,0,0,5,0,5
2004,Iraq,IRQ,Lebanon,LBN,0,0,5,262,267
2004,Jordan,JOR,Lebanon,LBN,0,0,0,5,5
2004,Liberia,LBR,Lebanon,LBN,0,0,0,5,5
2004,Sri Lanka,LKA,Lebanon,LBN,0,0,5,0,5
2004,Somalia,SOM,Lebanon,LBN,0,0,5,5,10
2004,Sudan,SDN,Lebanon,LBN,0,0,89,0,89
2004,Turkey,TUR,Lebanon,LBN,5,0,5,5,15
2004,Stateless,XXA,Lebanon,LBN,5,0,15,0,20
2004,Unknown ,,Lebanon,LBN,0,0,5,5,10
2004,Afghanistan,AFG,Sri Lanka,LKA,5,0,0,0,5
2004,Maldives,MDV,Sri Lanka,LKA,0,0,0,5,5
2004,Pakistan,PAK,Sri Lanka,LKA,40,0,35,10,85
2004,Afghanistan,AFG,Malaysia,MYS,10,0,0,0,10
2004,Bangladesh,BGD,Malaysia,MYS,0,0,0,30,30
2004,Cambodia,KHM,Malaysia,MYS,0,0,0,23,23
2004,China,CHN,Malaysia,MYS,5,0,0,0,5
2004,Palestinian,PSE,Malaysia,MYS,0,0,0,5,5
2004,India,IND,Malaysia,MYS,0,0,0,5,5
2004,Indonesia,IDN,Malaysia,MYS,524,11627,0,138,12289
2004,Iran (Islamic Rep. of),IRN,Malaysia,MYS,11,0,0,0,11
2004,Iraq,IRQ,Malaysia,MYS,18,0,0,0,18
2004,Liberia,LBR,Malaysia,MYS,5,0,0,5,10
2004,Sri Lanka,LKA,Malaysia,MYS,5,0,0,10,15
2004,Myanmar,MMR,Malaysia,MYS,896,4910,47,1203,7056
2004,Pakistan,PAK,Malaysia,MYS,5,0,5,0,10
2004,Russian Federation,RUS,Malaysia,MYS,5,0,0,0,5
2004,Sierra Leone,SLE,Malaysia,MYS,0,0,0,5,5
2004,Somalia,SOM,Malaysia,MYS,5,0,0,0,5
2004,Syrian Arab Rep.,SYR,Oman,OMN,5,0,0,0,5
2004,Afghanistan,AFG,Pakistan,PAK,121,0,3444,4410,7975
2004,Algeria,DZA,Pakistan,PAK,0,0,0,11,11
2004,Burundi,BDI,Pakistan,PAK,0,0,17,0,17
2004,China,CHN,Pakistan,PAK,0,0,5,5,10
2004,Congo,COG,Pakistan,PAK,0,0,19,5,24
2004,Palestinian,PSE,Pakistan,PAK,0,0,0,5,5
2004,Ghana,GHA,Pakistan,PAK,0,0,5,0,5
2004,Cote d'Ivoire,CIV,Pakistan,PAK,0,0,12,5,17
2004,Iran (Islamic Rep. of),IRN,Pakistan,PAK,14,0,41,0,55
2004,Iraq,IRQ,Pakistan,PAK,0,0,0,13,13
2004,Kenya,KEN,Pakistan,PAK,0,0,5,0,5
2004,Liberia,LBR,Pakistan,PAK,0,0,11,5,16
2004,Nigeria,NGA,Pakistan,PAK,0,0,253,75,328
2004,Rwanda,RWA,Pakistan,PAK,0,0,5,0,5
2004,Sierra Leone,SLE,Pakistan,PAK,0,0,20,10,30
2004,Somalia,SOM,Pakistan,PAK,18,0,29,47,94
2004,United Rep. of Tanzania,TZA,Pakistan,PAK,0,0,75,11,86
2004,Tunisia,TUN,Pakistan,PAK,0,0,0,5,5
2004,Palestinian,PSE,Qatar,QAT,0,0,0,10,10
2004,Pakistan,PAK,Qatar,QAT,0,0,0,15,15
2004,Afghanistan,AFG,Saudi Arabia,SAU,0,0,0,10,10
2004,Eritrea,ERI,Saudi Arabia,SAU,52,0,14,0,66
2004,Palestinian,PSE,Saudi Arabia,SAU,0,5,0,0,5
2004,Liberia,LBR,Saudi Arabia,SAU,0,18,0,0,18
2004,Somalia,SOM,Saudi Arabia,SAU,0,0,26,0,26
2004,Sudan,SDN,Saudi Arabia,SAU,0,10,5,0,15
2004,Syrian Arab Rep.,SYR,Saudi Arabia,SAU,5,0,0,0,5
2004,Stateless,XXA,Saudi Arabia,SAU,0,0,0,5,5
2004,Unknown ,,Sudan,SDN,66,0,76,0,142
2004,Cambodia,KHM,Thailand,THA,59,0,40,17,116
2004,China,CHN,Thailand,THA,26,0,22,11,59
2004,Congo,COG,Thailand,THA,0,0,0,27,27
2004,Dem. Rep. of the Congo,COD,Thailand,THA,23,0,0,0,23
2004,Palestinian,PSE,Thailand,THA,0,0,0,5,5
2004,Ghana,GHA,Thailand,THA,0,0,0,5,5
2004,Cote d'Ivoire,CIV,Thailand,THA,5,0,5,5,15
2004,India,IND,Thailand,THA,0,0,5,5,10
2004,Indonesia,IDN,Thailand,THA,5,0,0,5,10
2004,Iran (Islamic Rep. of),IRN,Thailand,THA,5,0,19,27,51
2004,Iraq,IRQ,Thailand,THA,5,0,5,10,20
2004,Kenya,KEN,Thailand,THA,0,0,0,5,5
2004,Dem. People's Rep. of Korea,PRK,Thailand,THA,0,0,0,58,58
2004,Kuwait,KWT,Thailand,THA,0,0,0,5,5
2004,Lao People's Dem. Rep.,LAO,Thailand,THA,44,0,12,391,447
2004,Liberia,LBR,Thailand,THA,14,0,5,43,62
2004,Sri Lanka,LKA,Thailand,THA,10,0,12,0,22
2004,Myanmar,MMR,Thailand,THA,2695,0,486,394,3575
2004,Nepal,NPL,Thailand,THA,5,0,10,18,33
2004,Nigeria,NGA,Thailand,THA,0,0,12,53,65
2004,Pakistan,PAK,Thailand,THA,0,0,11,10,21
2004,Philippines,PHL,Thailand,THA,0,0,5,0,5
2004,Sierra Leone,SLE,Thailand,THA,0,0,0,15,15
2004,Somalia,SOM,Thailand,THA,5,0,0,5,10
2004,Viet Nam,VNM,Thailand,THA,25,0,23,5,53
2004,Sudan,SDN,Thailand,THA,5,0,5,0,10
2004,Afghanistan,AFG,Uzbekistan,UZB,66,0,65,529,660
2004,Kyrgyzstan,KGZ,Uzbekistan,UZB,0,0,0,10,10
2004,Tajikistan,TJK,Uzbekistan,UZB,0,0,0,10,10
2004,Turkmenistan,TKM,Uzbekistan,UZB,5,0,0,0,5
2005,Burundi,BDI,Egypt,EGY,0,0,0,5,5
2005,Chad,TCD,Egypt,EGY,0,0,0,5,5
2005,China,CHN,Egypt,EGY,0,0,5,0,5
2005,Cameroon,CMR,Egypt,EGY,0,0,0,10,10
2005,Dem. Rep. of the Congo,COD,Egypt,EGY,0,0,0,10,10
2005,Eritrea,ERI,Egypt,EGY,35,0,43,17,95
2005,Ethiopia,ETH,Egypt,EGY,38,0,118,69,225
2005,Palestinian,PSE,Egypt,EGY,10,0,0,0,10
2005,Iraq,IRQ,Egypt,EGY,0,0,0,10,10
2005,Jordan,JOR,Egypt,EGY,0,0,0,5,5
2005,Liberia,LBR,Egypt,EGY,0,0,0,5,5
2005,Libya,LBY,Egypt,EGY,0,0,0,5,5
2005,Nigeria,NGA,Egypt,EGY,0,0,5,0,5
2005,Sierra Leone,SLE,Egypt,EGY,0,0,0,5,5
2005,Somalia,SOM,Egypt,EGY,374,0,11,56,441
2005,Sudan,SDN,Egypt,EGY,0,0,0,327,327
2005,Tajikistan,TJK,Egypt,EGY,0,0,5,5,10
2005,Uganda,UGA,Egypt,EGY,0,0,5,0,5
2005,Yemen,YEM,Egypt,EGY,0,0,0,5,5
2005,Myanmar,MMR,Bangladesh,BGD,5,0,5,10,20
2005,Palestinian,PSE,Bosnia and Herzegovina,BIH,5,0,0,0,5
2005,North Macedonia,MKD,Bosnia and Herzegovina,BIH,0,0,19,5,24
2005,Rep. of Moldova,MDA,Bosnia and Herzegovina,BIH,0,0,5,0,5
2005,Serbia and Kosovo: S/RES/1244 (1999),SRB,Bosnia and Herzegovina,BIH,159,0,74,41,274
2005,Iraq,IRQ,China,CHN,0,5,0,0,5
2005,Liberia,LBR,China,CHN,0,0,5,5,10
2005,Pakistan,PAK,China,CHN,47,0,14,5,66
2005,Somalia,SOM,China,CHN,0,10,0,5,15
2005,Zimbabwe,ZWE,China,CHN,0,5,0,0,5
2005,Burundi,BDI,Cameroon,CMR,5,0,0,21,26
2005,Central African Rep.,CAF,Cameroon,CMR,103,0,152,182,437
2005,Chad,TCD,Cameroon,CMR,28,0,170,165,363
2005,Congo,COG,Cameroon,CMR,20,0,51,112,183
2005,Dem. Rep. of the Congo,COD,Cameroon,CMR,78,0,211,649,938
2005,Guinea-Bissau,GNB,Cameroon,CMR,0,0,17,14,31
2005,Cote d'Ivoire,CIV,Cameroon,CMR,10,0,47,117,174
2005,Liberia,LBR,Cameroon,CMR,0,0,17,21,38
2005,Nigeria,NGA,Cameroon,CMR,5,0,0,0,5
2005,Rwanda,RWA,Cameroon,CMR,32,0,76,83,191
2005,Togo,TGO,Cameroon,CMR,5,0,5,10,20
2005,Unknown ,,Cameroon,CMR,12,0,25,55,92
2005,Syrian Arab Rep.,SYR,Cyprus,CYP,0,0,0,14,14
2005,Ethiopia,ETH,Eritrea,ERI,47,0,0,18,65
2005,Sudan,SDN,Eritrea,ERI,0,0,5,0,5
2005,Afghanistan,AFG,Indonesia,IDN,0,0,0,5,5
2005,Cameroon,CMR,Indonesia,IDN,0,0,5,0,5
2005,Dem. Rep. of the Congo,COD,Indonesia,IDN,5,0,0,0,5
2005,Cote d'Ivoire,CIV,Indonesia,IDN,0,0,5,5,10
2005,Liberia,LBR,Indonesia,IDN,0,0,5,10,15
2005,Myanmar,MMR,Indonesia,IDN,0,0,0,5,5
2005,Pakistan,PAK,Indonesia,IDN,0,0,0,5,5
2005,Somalia,SOM,Indonesia,IDN,0,0,0,13,13
2005,Iraq,IRQ,Kuwait,KWT,0,5,0,0,5
2005,Algeria,DZA,Lebanon,LBN,0,0,5,0,5
2005,Egypt,EGY,Lebanon,LBN,0,0,5,5,10
2005,Ethiopia,ETH,Lebanon,LBN,0,0,5,0,5
2005,Iran (Islamic Rep. of),IRN,Lebanon,LBN,0,0,0,10,10
2005,Iraq,IRQ,Lebanon,LBN,18,0,86,35,139
2005,Somalia,SOM,Lebanon,LBN,0,0,5,0,5
2005,Sudan,SDN,Lebanon,LBN,0,0,24,28,52
2005,Turkey,TUR,Lebanon,LBN,0,0,5,0,5
2005,Stateless,XXA,Lebanon,LBN,0,0,11,5,16
2005,Unknown ,,Lebanon,LBN,0,0,5,0,5
2005,Maldives,MDV,Sri Lanka,LKA,0,0,0,5,5
2005,Pakistan,PAK,Sri Lanka,LKA,63,0,16,5,84
2005,Afghanistan,AFG,Malaysia,MYS,27,0,0,10,37
2005,Algeria,DZA,Malaysia,MYS,5,0,0,0,5
2005,Bangladesh,BGD,Malaysia,MYS,0,0,5,134,139
2005,Cambodia,KHM,Malaysia,MYS,5,0,0,34,39
2005,China,CHN,Malaysia,MYS,11,0,0,5,16
2005,Congo,COG,Malaysia,MYS,0,0,0,5,5
2005,India,IND,Malaysia,MYS,0,0,0,10,10
2005,Indonesia,IDN,Malaysia,MYS,5424,0,0,176,5600
2005,Iran (Islamic Rep. of),IRN,Malaysia,MYS,5,0,0,0,5
2005,Iraq,IRQ,Malaysia,MYS,5,0,0,10,15
2005,Liberia,LBR,Malaysia,MYS,5,0,0,28,33
2005,Libya,LBY,Malaysia,MYS,0,0,0,5,5
2005,Sri Lanka,LKA,Malaysia,MYS,24,0,0,116,140
2005,Myanmar,MMR,Malaysia,MYS,5276,0,10,3040,8326
2005,Nepal,NPL,Malaysia,MYS,10,0,0,13,23
2005,Nigeria,NGA,Malaysia,MYS,0,0,5,26,31
2005,Pakistan,PAK,Malaysia,MYS,5,0,0,25,30
2005,Russian Federation,RUS,Malaysia,MYS,5,0,0,0,5
2005,Somalia,SOM,Malaysia,MYS,10,0,0,14,24
2005,Viet Nam,VNM,Malaysia,MYS,0,0,0,5,5
2005,Sudan,SDN,Malaysia,MYS,14,0,0,0,14
2005,Syrian Arab Rep.,SYR,Malaysia,MYS,0,0,0,5,5
2005,Thailand,THA,Malaysia,MYS,87,0,0,11,98
2005,Zimbabwe,ZWE,Malaysia,MYS,5,0,0,0,5
2005,Afghanistan,AFG,Oman,OMN,0,0,0,16,16
2005,Pakistan,PAK,Oman,OMN,0,0,0,5,5
2005,Afghanistan,AFG,Pakistan,PAK,327,0,3014,2508,5849
2005,Angola,AGO,Pakistan,PAK,0,0,0,5,5
2005,Burundi,BDI,Pakistan,PAK,0,0,0,5,5
2005,Congo,COG,Pakistan,PAK,0,0,0,10,10
2005,Ethiopia,ETH,Pakistan,PAK,0,0,5,0,5
2005,Gambia,GMB,Pakistan,PAK,0,0,0,5,5
2005,Palestinian,PSE,Pakistan,PAK,0,0,0,5,5
2005,Ghana,GHA,Pakistan,PAK,0,0,0,10,10
2005,Cote d'Ivoire,CIV,Pakistan,PAK,0,0,0,13,13
2005,Iran (Islamic Rep. of),IRN,Pakistan,PAK,14,0,32,0,46
2005,Iraq,IRQ,Pakistan,PAK,0,0,12,0,12
2005,Liberia,LBR,Pakistan,PAK,0,0,5,30,35
2005,Nigeria,NGA,Pakistan,PAK,0,0,18,246,264
2005,South Africa,ZAF,Pakistan,PAK,0,0,0,10,10
2005,Russian Federation,RUS,Pakistan,PAK,10,0,0,0,10
2005,Rwanda,RWA,Pakistan,PAK,0,0,0,14,14
2005,Senegal,SEN,Pakistan,PAK,0,0,0,5,5
2005,Sierra Leone,SLE,Pakistan,PAK,0,0,0,49,49
2005,Somalia,SOM,Pakistan,PAK,5,0,5,0,10
2005,Sudan,SDN,Pakistan,PAK,0,0,5,10,15
2005,United Rep. of Tanzania,TZA,Pakistan,PAK,0,0,0,39,39
2005,Uzbekistan,UZB,Pakistan,PAK,30,0,0,0,30
2005,Zimbabwe,ZWE,Pakistan,PAK,0,0,0,10,10
2005,Egypt,EGY,Saudi Arabia,SAU,0,0,5,0,5
2005,China,CHN,Saudi Arabia,SAU,5,0,0,0,5
2005,Eritrea,ERI,Saudi Arabia,SAU,163,0,0,5,168
2005,Ethiopia,ETH,Saudi Arabia,SAU,0,0,0,13,13
2005,Palestinian,PSE,Saudi Arabia,SAU,0,10,0,0,10
2005,Myanmar,MMR,Saudi Arabia,SAU,0,0,0,10,10
2005,Pakistan,PAK,Saudi Arabia,SAU,0,0,0,5,5
2005,Somalia,SOM,Saudi Arabia,SAU,0,0,5,0,5
2005,Sudan,SDN,Saudi Arabia,SAU,17,0,11,47,75
2005,Afghanistan,AFG,Turkmenistan,TKM,10,0,0,0,10
2005,Armenia,ARM,Turkmenistan,TKM,5,0,0,0,5
2005,Azerbaijan,AZE,Turkmenistan,TKM,5,0,12,0,17
2005,Afghanistan,AFG,Uzbekistan,UZB,37,0,28,0,65
2005,Azerbaijan,AZE,Uzbekistan,UZB,0,0,0,5,5
2005,Kyrgyzstan,KGZ,Uzbekistan,UZB,0,0,0,5,5
2005,Russian Federation,RUS,Uzbekistan,UZB,0,0,5,0,5
2005,Syrian Arab Rep.,SYR,Uzbekistan,UZB,0,0,0,5,5
2005,Tajikistan,TJK,Uzbekistan,UZB,0,0,0,5,5
2005,Stateless,XXA,Uzbekistan,UZB,0,0,12,0,12
2006,North Macedonia,MKD,Bosnia and Herzegovina,BIH,0,0,32,0,32
2006,Serbia and Kosovo: S/RES/1244 (1999),SRB,Bosnia and Herzegovina,BIH,5,0,14,0,19
2006,Dem. Rep. of the Congo,COD,China,CHN,0,0,0,5,5
2006,Eritrea,ERI,China,CHN,5,0,0,0,5
2006,Liberia,LBR,China,CHN,0,0,0,10,10
2006,Sri Lanka,LKA,China,CHN,0,0,5,5,10
2006,Pakistan,PAK,China,CHN,16,0,22,12,50
2006,Angola,AGO,Cameroon,CMR,0,0,0,5,5
2006,Burundi,BDI,Cameroon,CMR,5,0,5,5,15
2006,Central African Rep.,CAF,Cameroon,CMR,1019,0,506,447,1972
2006,Chad,TCD,Cameroon,CMR,196,0,934,826,1956
2006,Congo,COG,Cameroon,CMR,5,0,36,81,122
2006,Dem. Rep. of the Congo,COD,Cameroon,CMR,93,0,284,531,908
2006,Equatorial Guinea,GNQ,Cameroon,CMR,10,0,0,0,10
2006,Guinea-Bissau,GNB,Cameroon,CMR,0,0,21,13,34
2006,Cote d'Ivoire,CIV,Cameroon,CMR,18,0,183,143,344
2006,Liberia,LBR,Cameroon,CMR,0,0,11,125,136
2006,Nigeria,NGA,Cameroon,CMR,0,0,0,13,13
2006,Rwanda,RWA,Cameroon,CMR,50,0,228,113,391
2006,Sierra Leone,SLE,Cameroon,CMR,0,0,5,5,10
2006,Sudan,SDN,Cameroon,CMR,10,0,0,5,15
2006,Togo,TGO,Cameroon,CMR,10,0,41,43,94
2006,Unknown ,,Cameroon,CMR,5,0,266,133,404
2006,Ethiopia,ETH,Cuba,CUB,23,0,0,0,23
2006,Ethiopia,ETH,Eritrea,ERI,31,0,19,5,55
2006,Sudan,SDN,Eritrea,ERI,0,0,5,0,5
2006,Afghanistan,AFG,Indonesia,IDN,0,0,0,5,5
2006,Iraq,IRQ,Indonesia,IDN,5,5,0,0,10
2006,Liberia,LBR,Indonesia,IDN,0,0,0,5,5
2006,Sri Lanka,LKA,Indonesia,IDN,0,0,0,38,38
2006,Myanmar,MMR,Indonesia,IDN,92,0,0,0,92
2006,Nigeria,NGA,Indonesia,IDN,0,0,10,19,29
2006,Somalia,SOM,Indonesia,IDN,0,0,10,0,10
2006,Iraq,IRQ,Kazakhstan,KAZ,5,0,0,0,5
2006,Kyrgyzstan,KGZ,Kazakhstan,KAZ,5,0,0,0,5
2006,Russian Federation,RUS,Kazakhstan,KAZ,0,0,0,5,5
2006,Uzbekistan,UZB,Kazakhstan,KAZ,159,0,5,10,174
2006,Uzbekistan,UZB,Kyrgyzstan,KGZ,120,0,0,13,133
2006,Algeria,DZA,Libya,LBY,5,0,0,0,5
2006,Chad,TCD,Libya,LBY,0,0,10,0,10
2006,Congo,COG,Libya,LBY,0,0,0,10,10
2006,Dem. Rep. of the Congo,COD,Libya,LBY,5,0,0,186,191
2006,Eritrea,ERI,Libya,LBY,0,0,5,0,5
2006,Ethiopia,ETH,Libya,LBY,0,0,5,0,5
2006,Palestinian,PSE,Libya,LBY,33,0,0,515,548
2006,Iraq,IRQ,Libya,LBY,5,0,14,280,299
2006,Liberia,LBR,Libya,LBY,0,0,5,26,31
2006,Morocco,MAR,Libya,LBY,0,0,5,0,5
2006,Nigeria,NGA,Libya,LBY,0,0,0,15,15
2006,Sierra Leone,SLE,Libya,LBY,0,0,0,79,79
2006,Somalia,SOM,Libya,LBY,0,0,10,345,355
2006,Sudan,SDN,Libya,LBY,5,0,205,0,210
2006,Liberia,LBR,Sri Lanka,LKA,0,0,0,5,5
2006,Pakistan,PAK,Sri Lanka,LKA,76,0,51,20,147
2006,Dem. Rep. of the Congo,COD,Mauritania,MRT,15,0,5,0,20
2006,Guinea,GIN,Mauritania,MRT,0,0,5,0,5
2006,Cote d'Ivoire,CIV,Mauritania,MRT,63,0,35,0,98
2006,Iraq,IRQ,Mauritania,MRT,5,0,0,0,5
2006,Liberia,LBR,Mauritania,MRT,17,0,80,0,97
2006,Sierra Leone,SLE,Mauritania,MRT,0,0,35,0,35
2006,Sudan,SDN,Mauritania,MRT,5,0,0,0,5
2006,Togo,TGO,Mauritania,MRT,10,0,0,0,10
2006,Unknown ,,Mauritania,MRT,0,0,23,0,23
2006,Afghanistan,AFG,Malaysia,MYS,10,0,0,10,20
2006,Algeria,DZA,Malaysia,MYS,0,0,0,5,5
2006,Egypt,EGY,Malaysia,MYS,0,0,0,5,5
2006,Bangladesh,BGD,Malaysia,MYS,0,0,62,29,91
2006,Cambodia,KHM,Malaysia,MYS,0,0,10,39,49
2006,China,CHN,Malaysia,MYS,5,0,0,5,10
2006,Cameroon,CMR,Malaysia,MYS,0,0,0,12,12
2006,Congo,COG,Malaysia,MYS,0,0,0,5,5
2006,Dem. Rep. of the Congo,COD,Malaysia,MYS,0,0,0,5,5
2006,Palestinian,PSE,Malaysia,MYS,0,0,0,5,5
2006,Cote d'Ivoire,CIV,Malaysia,MYS,0,0,0,11,11
2006,India,IND,Malaysia,MYS,0,0,5,5,10
2006,Indonesia,IDN,Malaysia,MYS,514,0,301,10,825
2006,Iran (Islamic Rep. of),IRN,Malaysia,MYS,5,0,5,0,10
2006,Iraq,IRQ,Malaysia,MYS,29,0,0,11,40
2006,Liberia,LBR,Malaysia,MYS,0,0,5,66,71
2006,Lebanon,LBN,Malaysia,MYS,5,0,0,0,5
2006,Sri Lanka,LKA,Malaysia,MYS,19,0,20,174,213
2006,Myanmar,MMR,Malaysia,MYS,8632,0,116,324,9072
2006,Nepal,NPL,Malaysia,MYS,10,0,0,33,43
2006,Nigeria,NGA,Malaysia,MYS,0,0,29,26,55
2006,Pakistan,PAK,Malaysia,MYS,5,0,5,15,25
2006,Russian Federation,RUS,Malaysia,MYS,0,0,5,0,5
2006,Sierra Leone,SLE,Malaysia,MYS,0,0,0,5,5
2006,Somalia,SOM,Malaysia,MYS,28,0,0,11,39
2006,Viet Nam,VNM,Malaysia,MYS,0,0,0,5,5
2006,Sudan,SDN,Malaysia,MYS,14,0,0,12,26
2006,Thailand,THA,Malaysia,MYS,36,0,0,21,57
2006,China,CHN,Mongolia,MNG,5,0,0,0,5
2006,Benin,BEN,Morocco,MAR,0,0,10,0,10
2006,Central African Rep.,CAF,Morocco,MAR,0,0,5,0,5
2006,Cameroon,CMR,Morocco,MAR,5,0,21,0,26
2006,Congo,COG,Morocco,MAR,5,0,10,0,15
2006,Dem. Rep. of the Congo,COD,Morocco,MAR,92,0,160,24,276
2006,Gambia,GMB,Morocco,MAR,0,0,37,0,37
2006,Ghana,GHA,Morocco,MAR,0,0,43,0,43
2006,Guinea,GIN,Morocco,MAR,0,0,18,0,18
2006,Cote d'Ivoire,CIV,Morocco,MAR,184,0,10,0,194
2006,Kenya,KEN,Morocco,MAR,0,0,5,0,5
2006,Liberia,LBR,Morocco,MAR,0,0,87,5,92
2006,Mali,MLI,Morocco,MAR,0,0,5,0,5
2006,Niger,NER,Morocco,MAR,0,0,10,0,10
2006,Nigeria,NGA,Morocco,MAR,5,0,241,115,361
2006,Rwanda,RWA,Morocco,MAR,0,0,5,0,5
2006,Sierra Leone,SLE,Morocco,MAR,0,0,12,0,12
2006,Sudan,SDN,Morocco,MAR,0,0,11,0,11
2006,Togo,TGO,Morocco,MAR,5,0,5,0,10
2006,Afghanistan,AFG,Pakistan,PAK,284,0,1528,766,2578
2006,India,IND,Pakistan,PAK,0,0,0,5,5
2006,Iran (Islamic Rep. of),IRN,Pakistan,PAK,11,0,18,32,61
2006,Iraq,IRQ,Pakistan,PAK,5,0,0,53,58
2006,Nigeria,NGA,Pakistan,PAK,0,0,0,5,5
2006,Somalia,SOM,Pakistan,PAK,5,0,0,29,34
2006,United Rep. of Tanzania,TZA,Pakistan,PAK,0,0,0,5,5
2006,Tajikistan,TJK,Pakistan,PAK,5,0,0,0,5
2006,Tunisia,TUN,Pakistan,PAK,0,0,0,10,10
2006,Chad,TCD,Sudan,SDN,0,0,0,5,5
2006,Eritrea,ERI,Sudan,SDN,72,0,0,79,151
2006,Ethiopia,ETH,Sudan,SDN,14,0,0,202,216
2006,Somalia,SOM,Sudan,SDN,5,0,0,0,5
2006,Unknown ,,Sudan,SDN,0,0,0,21,21
2006,Algeria,DZA,Tunisia,TUN,0,0,0,5,5
2006,Dem. Rep. of the Congo,COD,Tunisia,TUN,0,0,0,5,5
2006,Iraq,IRQ,Tunisia,TUN,5,0,0,0,5
2006,Liberia,LBR,Tunisia,TUN,0,0,0,5,5
2006,Rwanda,RWA,Tunisia,TUN,5,0,0,0,5
2006,Afghanistan,AFG,United Arab Emirates,ARE,5,0,0,0,5
2006,Ethiopia,ETH,United Arab Emirates,ARE,5,0,0,0,5
2006,Iran (Islamic Rep. of),IRN,United Arab Emirates,ARE,15,0,11,0,26
2006,Iraq,IRQ,United Arab Emirates,ARE,5,0,0,10,15
2006,Somalia,SOM,United Arab Emirates,ARE,11,0,0,0,11
2006,Sudan,SDN,United Arab Emirates,ARE,14,0,5,0,19
2006,Syrian Arab Rep.,SYR,United Arab Emirates,ARE,69,0,0,0,69
2006,Uzbekistan,UZB,United Arab Emirates,ARE,5,0,0,0,5
2006,China,CHN,Yemen,YEM,5,0,0,0,5
2006,Eritrea,ERI,Yemen,YEM,84,0,5,5,94
2006,Ethiopia,ETH,Yemen,YEM,152,0,254,520,926
2006,Iraq,IRQ,Yemen,YEM,483,0,0,0,483
2006,Sudan,SDN,Yemen,YEM,14,0,18,0,32
2007,Liberia,LBR,Bangladesh,BGD,0,0,0,5,5
2007,Myanmar,MMR,Bangladesh,BGD,42,0,0,35,77
2007,Egypt,EGY,China,CHN,0,0,0,5,5
2007,Eritrea,ERI,China,CHN,5,0,0,0,5
2007,Iraq,IRQ,China,CHN,40,0,0,5,45
2007,Rep. of Korea,KOR,China,CHN,0,0,0,5,5
2007,Sri Lanka,LKA,China,CHN,0,0,0,10,10
2007,Pakistan,PAK,China,CHN,62,0,5,5,72
2007,Burundi,BDI,Cameroon,CMR,0,0,10,0,10
2007,Central African Rep.,CAF,Cameroon,CMR,998,0,441,622,2061
2007,Chad,TCD,Cameroon,CMR,318,0,404,730,1452
2007,Congo,COG,Cameroon,CMR,0,0,10,31,41
2007,Dem. Rep. of the Congo,COD,Cameroon,CMR,50,0,189,211,450
2007,Gabon,GAB,Cameroon,CMR,5,0,5,0,10
2007,Ghana,GHA,Cameroon,CMR,0,0,0,5,5
2007,Guinea-Bissau,GNB,Cameroon,CMR,0,0,10,31,41
2007,Guinea,GIN,Cameroon,CMR,0,0,5,10,15
2007,Cote d'Ivoire,CIV,Cameroon,CMR,5,0,27,261,293
2007,Liberia,LBR,Cameroon,CMR,0,0,0,20,20
2007,Morocco,MAR,Cameroon,CMR,0,0,0,5,5
2007,Niger,NER,Cameroon,CMR,0,0,0,5,5
2007,Nigeria,NGA,Cameroon,CMR,0,0,0,5,5
2007,Rwanda,RWA,Cameroon,CMR,99,0,160,31,290
2007,Sierra Leone,SLE,Cameroon,CMR,5,0,0,5,10
2007,Sudan,SDN,Cameroon,CMR,10,0,0,15,25
2007,Togo,TGO,Cameroon,CMR,0,0,19,26,45
2007,Congo,COG,Dem. Rep. of the Congo,COD,0,0,5,0,5
2007,Cote d'Ivoire,CIV,Dem. Rep. of the Congo,COD,0,0,5,5,10
2007,Rwanda,RWA,Dem. Rep. of the Congo,COD,5,0,5,25,35
2007,Somalia,SOM,Dem. Rep. of the Congo,COD,0,0,0,10,10
2007,Afghanistan,AFG,Cuba,CUB,0,0,5,0,5
2007,Eritrea,ERI,Cuba,CUB,5,0,0,0,5
2007,Ethiopia,ETH,Cuba,CUB,5,0,5,0,10
2007,Iran (Islamic Rep. of),IRN,Cuba,CUB,5,0,0,0,5
2007,Liberia,LBR,Cuba,CUB,0,0,0,5,5
2007,Ethiopia,ETH,Eritrea,ERI,31,0,55,0,86
2007,Afghanistan,AFG,Indonesia,IDN,5,0,0,5,10
2007,China,CHN,Indonesia,IDN,5,0,0,0,5
2007,Iran (Islamic Rep. of),IRN,Indonesia,IDN,0,0,0,5,5
2007,Iraq,IRQ,Indonesia,IDN,10,0,0,0,10
2007,Sri Lanka,LKA,Indonesia,IDN,97,0,0,80,177
2007,Myanmar,MMR,Indonesia,IDN,10,0,5,12,27
2007,Nepal,NPL,Indonesia,IDN,0,0,0,16,16
2007,Nigeria,NGA,Indonesia,IDN,0,0,5,21,26
2007,Somalia,SOM,Indonesia,IDN,5,0,0,0,5
2007,Viet Nam,VNM,Indonesia,IDN,0,0,33,0,33
2007,Algeria,DZA,Jordan,JOR,0,0,0,5,5
2007,Egypt,EGY,Jordan,JOR,5,0,5,5,15
2007,Palestinian,PSE,Jordan,JOR,0,0,0,5,5
2007,Lebanon,LBN,Jordan,JOR,0,0,0,5,5
2007,Russian Federation,RUS,Jordan,JOR,5,0,0,0,5
2007,Somalia,SOM,Jordan,JOR,31,0,0,0,31
2007,Sudan,SDN,Jordan,JOR,14,0,5,5,24
2007,Syrian Arab Rep.,SYR,Jordan,JOR,5,0,5,17,27
2007,Yemen,YEM,Jordan,JOR,0,0,0,5,5
2007,Stateless,XXA,Jordan,JOR,0,0,0,10,10
2007,China,CHN,Kazakhstan,KAZ,5,0,0,5,10
2007,Kyrgyzstan,KGZ,Kazakhstan,KAZ,13,0,0,5,18
2007,Uzbekistan,UZB,Kazakhstan,KAZ,137,0,24,12,173
2007,Afghanistan,AFG,Kyrgyzstan,KGZ,5,0,0,12,17
2007,China,CHN,Kyrgyzstan,KGZ,5,0,0,5,10
2007,Uzbekistan,UZB,Kyrgyzstan,KGZ,128,0,0,25,153
2007,Chad,TCD,Libya,LBY,0,0,5,0,5
2007,Cameroon,CMR,Libya,LBY,0,0,5,0,5
2007,Dem. Rep. of the Congo,COD,Libya,LBY,5,0,13,18,36
2007,Eritrea,ERI,Libya,LBY,78,0,10,10,98
2007,Ethiopia,ETH,Libya,LBY,5,0,5,5,15
2007,Palestinian,PSE,Libya,LBY,92,0,0,0,92
2007,Cote d'Ivoire,CIV,Libya,LBY,0,0,5,0,5
2007,Iraq,IRQ,Libya,LBY,1176,0,191,44,1411
2007,Liberia,LBR,Libya,LBY,5,0,5,24,34
2007,Sierra Leone,SLE,Libya,LBY,0,0,5,11,16
2007,Somalia,SOM,Libya,LBY,5,0,5,10,20
2007,Sudan,SDN,Libya,LBY,17,0,78,12,107
2007,Palestinian,PSE,Sri Lanka,LKA,5,0,0,0,5
2007,Pakistan,PAK,Sri Lanka,LKA,42,0,51,45,138
2007,Congo,COG,Mauritania,MRT,5,0,5,0,10
2007,Dem. Rep. of the Congo,COD,Mauritania,MRT,12,0,18,0,30
2007,Cote d'Ivoire,CIV,Mauritania,MRT,108,0,110,0,218
2007,India,IND,Mauritania,MRT,0,0,13,10,23
2007,Iraq,IRQ,Mauritania,MRT,45,0,0,0,45
2007,Liberia,LBR,Mauritania,MRT,13,0,191,0,204
2007,Lebanon,LBN,Mauritania,MRT,0,0,5,0,5
2007,Sierra Leone,SLE,Mauritania,MRT,11,0,61,0,72
2007,Togo,TGO,Mauritania,MRT,12,0,10,0,22
2007,Western Sahara,ESH,Mauritania,MRT,0,0,0,10,10
2007,Afghanistan,AFG,Pakistan,PAK,505,0,662,335,1502
2007,Ethiopia,ETH,Pakistan,PAK,5,0,0,0,5
2007,Iran (Islamic Rep. of),IRN,Pakistan,PAK,10,0,69,5,84
2007,Iraq,IRQ,Pakistan,PAK,10,0,0,0,10
2007,Somalia,SOM,Pakistan,PAK,129,0,5,0,134
2007,Uzbekistan,UZB,Pakistan,PAK,0,0,5,0,5
2007,Eritrea,ERI,Sudan,SDN,44,0,5,0,49
2007,Ethiopia,ETH,Sudan,SDN,13,18,11,10,52
2007,Guinea,GIN,Tunisia,TUN,0,0,0,5,5
2007,Cote d'Ivoire,CIV,Tunisia,TUN,15,0,10,28,53
2007,Iraq,IRQ,Tunisia,TUN,5,0,0,0,5
2007,Liberia,LBR,Tunisia,TUN,0,0,21,26,47
2007,Palestinian,PSE,United Arab Emirates,ARE,0,0,0,5,5
2007,Iraq,IRQ,United Arab Emirates,ARE,93,0,0,0,93
2007,Eritrea,ERI,Yemen,YEM,233,0,5,10,248
2007,Ethiopia,ETH,Yemen,YEM,215,0,286,106,607
2007,Iraq,IRQ,Yemen,YEM,2237,0,0,5,2242
2007,Sudan,SDN,Yemen,YEM,5,0,0,10,15
2008,Central African Rep.,CAF,Algeria,DZA,0,0,0,17,17
2008,Chad,TCD,Algeria,DZA,0,0,0,32,32
2008,Cameroon,CMR,Algeria,DZA,0,0,5,115,120
2008,Dem. Rep. of the Congo,COD,Algeria,DZA,25,0,18,120,163
2008,Guinea,GIN,Algeria,DZA,0,0,0,5,5
2008,Cote d'Ivoire,CIV,Algeria,DZA,0,0,5,234,239
2008,Iraq,IRQ,Algeria,DZA,0,0,0,23,23
2008,Liberia,LBR,Algeria,DZA,0,0,17,85,102
2008,Morocco,MAR,Algeria,DZA,0,0,0,5,5
2008,Niger,NER,Algeria,DZA,0,0,0,5,5
2008,Nigeria,NGA,Algeria,DZA,0,0,0,31,31
2008,Sierra Leone,SLE,Algeria,DZA,0,0,0,5,5
2008,Togo,TGO,Algeria,DZA,0,0,0,10,10
2008,Iraq,IRQ,Bangladesh,BGD,5,0,0,0,5
2008,Sri Lanka,LKA,Bangladesh,BGD,0,0,5,0,5
2008,Myanmar,MMR,Bangladesh,BGD,64,0,42,10,116
2008,Pakistan,PAK,Bangladesh,BGD,0,0,13,0,13
2008,Somalia,SOM,Bangladesh,BGD,11,0,0,0,11
2008,Angola,AGO,Cameroon,CMR,0,0,5,5,10
2008,Central African Rep.,CAF,Cameroon,CMR,688,0,187,495,1370
2008,Chad,TCD,Cameroon,CMR,318,0,477,481,1276
2008,Congo,COG,Cameroon,CMR,0,0,10,23,33
2008,Dem. Rep. of the Congo,COD,Cameroon,CMR,54,0,141,180,375
2008,Guinea-Bissau,GNB,Cameroon,CMR,0,0,12,31,43
2008,Guinea,GIN,Cameroon,CMR,0,0,83,196,279
2008,Cote d'Ivoire,CIV,Cameroon,CMR,0,0,31,196,227
2008,Liberia,LBR,Cameroon,CMR,0,0,5,19,24
2008,Mauritania,MRT,Cameroon,CMR,0,0,0,5,5
2008,Rwanda,RWA,Cameroon,CMR,23,0,202,29,254
2008,Sierra Leone,SLE,Cameroon,CMR,0,0,0,5,5
2008,Sudan,SDN,Cameroon,CMR,18,0,12,5,35
2008,Togo,TGO,Cameroon,CMR,0,0,5,15,20
2008,Burundi,BDI,Dem. Rep. of the Congo,COD,0,0,0,5,5
2008,Central African Rep.,CAF,Dem. Rep. of the Congo,COD,0,0,5,0,5
2008,Congo,COG,Dem. Rep. of the Congo,COD,0,0,0,10,10
2008,Guinea,GIN,Dem. Rep. of the Congo,COD,0,0,0,5,5
2008,Cote d'Ivoire,CIV,Dem. Rep. of the Congo,COD,0,0,0,5,5
2008,Rwanda,RWA,Dem. Rep. of the Congo,COD,0,0,0,16,16
2008,Ethiopia,ETH,Cuba,CUB,0,0,5,0,5
2008,Palestinian,PSE,Cyprus,CYP,10,0,0,0,10
2008,Iraq,IRQ,Cyprus,CYP,0,0,0,21,21
2008,Ethiopia,ETH,Eritrea,ERI,0,0,0,1900,1900
2008,Sudan,SDN,Eritrea,ERI,0,0,0,63,63
2008,Afghanistan,AFG,Kazakhstan,KAZ,49,0,45,0,94
2008,China,CHN,Kazakhstan,KAZ,10,0,0,0,10
2008,Kyrgyzstan,KGZ,Kazakhstan,KAZ,5,0,0,5,10
2008,Russian Federation,RUS,Kazakhstan,KAZ,0,0,5,5,10
2008,Uzbekistan,UZB,Kazakhstan,KAZ,65,0,11,0,76
2008,Afghanistan,AFG,Kyrgyzstan,KGZ,29,0,0,10,39
2008,Uzbekistan,UZB,Kyrgyzstan,KGZ,173,0,0,17,190
2008,Palestinian,PSE,Sri Lanka,LKA,16,0,0,0,16
2008,India,IND,Sri Lanka,LKA,0,0,5,0,5
2008,Iran (Islamic Rep. of),IRN,Sri Lanka,LKA,0,0,0,5,5
2008,Myanmar,MMR,Sri Lanka,LKA,55,0,0,0,55
2008,Pakistan,PAK,Sri Lanka,LKA,56,0,38,51,145
2008,Iraq,IRQ,Oman,OMN,5,0,0,0,5
2008,Afghanistan,AFG,Pakistan,PAK,374,0,491,262,1127
2008,Angola,AGO,Pakistan,PAK,0,0,0,5,5
2008,Congo,COG,Pakistan,PAK,0,0,0,12,12
2008,Ghana,GHA,Pakistan,PAK,0,0,0,5,5
2008,Cote d'Ivoire,CIV,Pakistan,PAK,0,0,0,5,5
2008,Iran (Islamic Rep. of),IRN,Pakistan,PAK,13,0,17,11,41
2008,Iraq,IRQ,Pakistan,PAK,27,0,0,67,94
2008,Liberia,LBR,Pakistan,PAK,0,0,0,5,5
2008,Morocco,MAR,Pakistan,PAK,0,0,0,5,5
2008,Niger,NER,Pakistan,PAK,0,0,0,5,5
2008,Nigeria,NGA,Pakistan,PAK,0,0,0,98,98
2008,Sierra Leone,SLE,Pakistan,PAK,0,0,0,14,14
2008,Somalia,SOM,Pakistan,PAK,158,0,0,17,175
2008,United Rep. of Tanzania,TZA,Pakistan,PAK,0,0,0,21,21
2008,Zimbabwe,ZWE,Pakistan,PAK,0,0,0,5,5
2008,Eritrea,ERI,Sudan,SDN,110,0,0,0,110
2008,Ethiopia,ETH,Sudan,SDN,131,0,0,0,131
2008,Palestinian,PSE,Sudan,SDN,0,5,0,0,5
2008,Somalia,SOM,Sudan,SDN,5,0,0,19,24
2008,Ghana,GHA,Trinidad and Tobago,TTO,0,0,5,0,5
2008,Cote d'Ivoire,CIV,Trinidad and Tobago,TTO,0,0,0,5,5
2008,Liberia,LBR,Trinidad and Tobago,TTO,0,0,0,14,14
2008,Nigeria,NGA,Trinidad and Tobago,TTO,0,0,0,5,5
2008,Senegal,SEN,Trinidad and Tobago,TTO,0,0,11,0,11
2008,Somalia,SOM,Trinidad and Tobago,TTO,5,0,0,0,5
2008,Guinea,GIN,Tunisia,TUN,0,0,5,5,10
2008,Cote d'Ivoire,CIV,Tunisia,TUN,0,0,14,31,45
2008,Liberia,LBR,Tunisia,TUN,0,0,5,5,10
2008,Egypt,EGY,United Arab Emirates,ARE,0,0,5,0,5
2008,Iran (Islamic Rep. of),IRN,United Arab Emirates,ARE,10,0,0,5,15
2008,Iraq,IRQ,United Arab Emirates,ARE,90,5,0,0,95
2008,Russian Federation,RUS,United Arab Emirates,ARE,0,0,5,0,5
2008,Sudan,SDN,United Arab Emirates,ARE,5,0,0,0,5
2008,Eritrea,ERI,Yemen,YEM,192,0,31,12,235
2008,Ethiopia,ETH,Yemen,YEM,173,0,308,224,705
2008,Palestinian,PSE,Yemen,YEM,77,0,0,0,77
2008,Iran (Islamic Rep. of),IRN,Yemen,YEM,5,0,0,0,5
2008,Iraq,IRQ,Yemen,YEM,928,0,0,106,1034
2008,Sudan,SDN,Yemen,YEM,10,0,36,13,59
2008,Stateless,XXA,Yemen,YEM,5,0,0,0,5
2009,Sri Lanka,LKA,Bangladesh,BGD,5,0,0,0,5
2009,Myanmar,MMR,Bangladesh,BGD,18,0,15,0,33
2009,Pakistan,PAK,Bangladesh,BGD,0,0,5,0,5
2009,Somalia,SOM,Bangladesh,BGD,5,0,0,0,5
2009,Palestinian,PSE,China,CHN,0,0,5,0,5
2009,Iraq,IRQ,China,CHN,11,0,0,5,16
2009,Pakistan,PAK,China,CHN,14,0,0,0,14
2009,Burundi,BDI,Cameroon,CMR,5,0,0,0,5
2009,Central African Rep.,CAF,Cameroon,CMR,1238,0,92,485,1815
2009,Chad,TCD,Cameroon,CMR,358,0,249,534,1141
2009,Congo,COG,Cameroon,CMR,13,0,5,0,18
2009,Dem. Rep. of the Congo,COD,Cameroon,CMR,78,0,138,86,302
2009,Gabon,GAB,Cameroon,CMR,0,0,0,5,5
2009,Guinea-Bissau,GNB,Cameroon,CMR,0,0,10,26,36
2009,Guinea,GIN,Cameroon,CMR,5,0,21,129,155
2009,Cote d'Ivoire,CIV,Cameroon,CMR,0,0,28,139,167
2009,Liberia,LBR,Cameroon,CMR,0,0,0,5,5
2009,Mauritania,MRT,Cameroon,CMR,0,0,5,0,5
2009,Mali,MLI,Cameroon,CMR,0,0,0,5,5
2009,Rwanda,RWA,Cameroon,CMR,49,0,63,11,123
2009,Sierra Leone,SLE,Cameroon,CMR,0,0,0,5,5
2009,Sudan,SDN,Cameroon,CMR,10,0,0,10,20
2009,Colombia,COL,Cuba,CUB,5,0,0,0,5
2009,Ethiopia,ETH,Cuba,CUB,0,0,5,0,5
2009,Cuba,CUB,Haiti,HTI,0,0,0,10,10
2009,Myanmar,MMR,Sri Lanka,LKA,0,0,0,5,5
2009,Pakistan,PAK,Sri Lanka,LKA,59,0,40,93,192
2009,Afghanistan,AFG,Malaysia,MYS,211,0,70,0,281
2009,Bangladesh,BGD,Malaysia,MYS,0,0,5,5,10
2009,Cambodia,KHM,Malaysia,MYS,5,5,21,0,31
2009,China,CHN,Malaysia,MYS,15,0,5,0,20
2009,Cameroon,CMR,Malaysia,MYS,0,0,12,5,17
2009,Dem. Rep. of the Congo,COD,Malaysia,MYS,0,0,5,5,10
2009,Palestinian,PSE,Malaysia,MYS,53,0,0,15,68
2009,Guinea,GIN,Malaysia,MYS,0,0,5,0,5
2009,Cote d'Ivoire,CIV,Malaysia,MYS,0,0,10,0,10
2009,India,IND,Malaysia,MYS,0,0,0,5,5
2009,Indonesia,IDN,Malaysia,MYS,13,153,57,60,283
2009,Iran (Islamic Rep. of),IRN,Malaysia,MYS,5,0,15,0,20
2009,Iraq,IRQ,Malaysia,MYS,127,0,0,86,213
2009,Liberia,LBR,Malaysia,MYS,0,0,11,0,11
2009,Sri Lanka,LKA,Malaysia,MYS,983,0,93,228,1304
2009,Myanmar,MMR,Malaysia,MYS,33802,0,411,2084,36297
2009,Nepal,NPL,Malaysia,MYS,0,0,16,24,40
2009,Nigeria,NGA,Malaysia,MYS,0,0,5,0,5
2009,Pakistan,PAK,Malaysia,MYS,0,0,26,5,31
2009,Somalia,SOM,Malaysia,MYS,283,0,20,56,359
2009,Viet Nam,VNM,Malaysia,MYS,0,0,11,5,16
2009,Sudan,SDN,Malaysia,MYS,25,0,0,0,25
2009,Thailand,THA,Malaysia,MYS,5,0,0,26,31
2009,China,CHN,Mongolia,MNG,0,0,0,5,5
2009,Afghanistan,AFG,Pakistan,PAK,380,0,122,1022,1524
2009,Bangladesh,BGD,Pakistan,PAK,0,0,0,5,5
2009,Bosnia and Herzegovina,BIH,Pakistan,PAK,0,0,0,5,5
2009,China,CHN,Pakistan,PAK,0,0,0,5,5
2009,Palestinian,PSE,Pakistan,PAK,0,0,0,10,10
2009,Iran (Islamic Rep. of),IRN,Pakistan,PAK,5,0,10,0,15
2009,Iraq,IRQ,Pakistan,PAK,13,0,5,10,28
2009,Jordan,JOR,Pakistan,PAK,0,0,0,5,5
2009,Kenya,KEN,Pakistan,PAK,0,0,0,5,5
2009,Sri Lanka,LKA,Pakistan,PAK,5,0,0,5,10
2009,Somalia,SOM,Pakistan,PAK,80,0,10,107,197
2009,Turkmenistan,TKM,Pakistan,PAK,0,0,0,5,5
2009,Turkey,TUR,Pakistan,PAK,5,0,0,0,5
2009,Uzbekistan,UZB,Pakistan,PAK,0,0,0,5,5
2009,Ethiopia,ETH,Trinidad and Tobago,TTO,0,0,0,5,5
2009,Ghana,GHA,Trinidad and Tobago,TTO,0,0,5,10,15
2009,Iran (Islamic Rep. of),IRN,Trinidad and Tobago,TTO,5,0,0,0,5
2009,Liberia,LBR,Trinidad and Tobago,TTO,0,0,0,5,5
2009,Nigeria,NGA,Trinidad and Tobago,TTO,0,0,5,12,17
2009,Senegal,SEN,Trinidad and Tobago,TTO,0,0,5,0,5
2009,Guinea,GIN,Tunisia,TUN,0,0,5,0,5
2009,Cote d'Ivoire,CIV,Tunisia,TUN,5,0,18,33,56
2009,Palestinian,PSE,United Arab Emirates,ARE,29,0,0,0,29
2009,Iran (Islamic Rep. of),IRN,United Arab Emirates,ARE,0,0,10,0,10
2009,Iraq,IRQ,United Arab Emirates,ARE,139,0,0,0,139
2009,Libya,LBY,United Arab Emirates,ARE,0,0,5,0,5
2009,Russian Federation,RUS,United Arab Emirates,ARE,0,0,5,0,5
2009,Sudan,SDN,United Arab Emirates,ARE,0,0,5,0,5
2009,Eritrea,ERI,Yemen,YEM,155,0,5,5,165
2009,Ethiopia,ETH,Yemen,YEM,908,0,129,42,1079
2009,Palestinian,PSE,Yemen,YEM,86,0,0,21,107
2009,Iraq,IRQ,Yemen,YEM,376,0,0,154,530
2009,Liberia,LBR,Yemen,YEM,0,0,0,10,10
2009,Sudan,SDN,Yemen,YEM,17,0,0,5,22
2009,Syrian Arab Rep.,SYR,Yemen,YEM,17,0,0,0,17
2009,Tunisia,TUN,Yemen,YEM,0,0,0,14,14
2010,Palestinian,PSE,China,CHN,5,0,0,0,5
2010,Iraq,IRQ,China,CHN,5,0,0,0,5
2010,Pakistan,PAK,China,CHN,11,0,22,26,59
2010,Somalia,SOM,China,CHN,5,0,0,5,10
2010,Eritrea,ERI,Cuba,CUB,5,0,0,5,10
2010,Afghanistan,AFG,Indonesia,IDN,329,0,0,2398,2727
2010,China,CHN,Indonesia,IDN,5,0,0,0,5
2010,Palestinian,PSE,Indonesia,IDN,0,0,0,10,10
2010,Guinea,GIN,Indonesia,IDN,0,0,5,5,10
2010,Iran (Islamic Rep. of),IRN,Indonesia,IDN,31,0,5,70,106
2010,Iraq,IRQ,Indonesia,IDN,24,0,0,305,329
2010,Sri Lanka,LKA,Indonesia,IDN,183,0,5,135,323
2010,Myanmar,MMR,Indonesia,IDN,37,0,0,5,42
2010,Pakistan,PAK,Indonesia,IDN,0,0,5,0,5
2010,Somalia,SOM,Indonesia,IDN,20,0,0,5,25
2010,Afghanistan,AFG,Kyrgyzstan,KGZ,146,0,12,16,174
2010,China,CHN,Kyrgyzstan,KGZ,5,0,0,0,5
2010,Syrian Arab Rep.,SYR,Kyrgyzstan,KGZ,5,0,0,0,5
2010,Uzbekistan,UZB,Kyrgyzstan,KGZ,121,0,0,5,126
2010,Afghanistan,AFG,Sri Lanka,LKA,0,0,5,0,5
2010,Pakistan,PAK,Sri Lanka,LKA,54,0,98,145,297
2010,Afghanistan,AFG,Pakistan,PAK,261,0,309,558,1128
2010,China,CHN,Pakistan,PAK,5,0,0,0,5
2010,Indonesia,IDN,Pakistan,PAK,0,0,0,5,5
2010,Iran (Islamic Rep. of),IRN,Pakistan,PAK,18,0,20,0,38
2010,Iraq,IRQ,Pakistan,PAK,0,0,0,10,10
2010,Somalia,SOM,Pakistan,PAK,50,0,5,34,89
2010,Algeria,DZA,Tunisia,TUN,0,0,5,0,5
2010,Dem. Rep. of the Congo,COD,Tunisia,TUN,0,0,5,0,5
2010,Guinea,GIN,Tunisia,TUN,0,0,5,14,19
2010,Cote d'Ivoire,CIV,Tunisia,TUN,0,0,10,18,28
2010,Iraq,IRQ,Tunisia,TUN,0,0,0,5,5
2010,Rwanda,RWA,Tunisia,TUN,5,0,0,0,5
2010,Palestinian,PSE,United Arab Emirates,ARE,10,0,0,0,10
2010,Iran (Islamic Rep. of),IRN,United Arab Emirates,ARE,5,0,0,5,10
2010,Iraq,IRQ,United Arab Emirates,ARE,347,0,0,5,352
2010,Pakistan,PAK,United Arab Emirates,ARE,5,0,0,0,5
2010,Somalia,SOM,United Arab Emirates,ARE,5,0,0,0,5
2010,Sudan,SDN,United Arab Emirates,ARE,0,0,12,0,12
2010,Syrian Arab Rep.,SYR,United Arab Emirates,ARE,13,0,5,5,23
2010,Egypt,EGY,Yemen,YEM,14,0,0,0,14
2010,Eritrea,ERI,Yemen,YEM,166,0,0,31,197
2010,Ethiopia,ETH,Yemen,YEM,769,0,448,540,1757
2010,Palestinian,PSE,Yemen,YEM,41,0,0,19,60
2010,Iran (Islamic Rep. of),IRN,Yemen,YEM,5,0,5,0,10
2010,Iraq,IRQ,Yemen,YEM,61,83,5,311,460
2010,Jordan,JOR,Yemen,YEM,5,0,0,0,5
2010,Sudan,SDN,Yemen,YEM,10,0,10,10,30
2010,Syrian Arab Rep.,SYR,Yemen,YEM,12,0,0,0,12
2011,Iran (Islamic Rep. of),IRN,Afghanistan,AFG,5,0,0,5,10
2011,Pakistan,PAK,Afghanistan,AFG,21,0,0,5,26
2011,Palestinian,PSE,China,CHN,0,0,0,5,5
2011,Iran (Islamic Rep. of),IRN,China,CHN,0,0,0,5,5
2011,Iraq,IRQ,China,CHN,0,0,0,11,11
2011,Pakistan,PAK,China,CHN,35,0,49,5,89
2011,Somalia,SOM,China,CHN,11,5,5,0,21
2011,Central African Rep.,CAF,Cameroon,CMR,468,0,160,181,809
2011,Chad,TCD,Cameroon,CMR,52,0,128,120,300
2011,Congo,COG,Cameroon,CMR,0,0,5,0,5
2011,Dem. Rep. of the Congo,COD,Cameroon,CMR,20,0,87,23,130
2011,Equatorial Guinea,GNQ,Cameroon,CMR,10,0,0,0,10
2011,Eritrea,ERI,Cameroon,CMR,5,0,0,0,5
2011,Ghana,GHA,Cameroon,CMR,0,0,5,0,5
2011,Guinea-Bissau,GNB,Cameroon,CMR,0,0,10,10,20
2011,Guinea,GIN,Cameroon,CMR,0,0,48,266,314
2011,Cote d'Ivoire,CIV,Cameroon,CMR,70,0,0,27,97
2011,Rwanda,RWA,Cameroon,CMR,29,0,70,14,113
2011,Senegal,SEN,Cameroon,CMR,0,0,5,5,10
2011,Sudan,SDN,Cameroon,CMR,14,0,0,5,19
2011,Togo,TGO,Cameroon,CMR,0,0,0,5,5
2011,Eritrea,ERI,Cuba,CUB,5,0,0,0,5
2011,Iran (Islamic Rep. of),IRN,Cuba,CUB,5,0,0,0,5
2011,Syrian Arab Rep.,SYR,Cyprus,CYP,0,0,0,15,15
2011,Afghanistan,AFG,Indonesia,IDN,388,0,11,1277,1676
2011,Algeria,DZA,Indonesia,IDN,0,0,0,5,5
2011,China,CHN,Indonesia,IDN,15,0,0,0,15
2011,Cameroon,CMR,Indonesia,IDN,0,0,0,17,17
2011,Gambia,GMB,Indonesia,IDN,0,0,0,5,5
2011,Palestinian,PSE,Indonesia,IDN,0,0,0,5,5
2011,Guinea,GIN,Indonesia,IDN,0,0,5,5,10
2011,Iran (Islamic Rep. of),IRN,Indonesia,IDN,48,0,5,224,277
2011,Iraq,IRQ,Indonesia,IDN,41,0,5,415,461
2011,Sri Lanka,LKA,Indonesia,IDN,46,0,0,98,144
2011,Morocco,MAR,Indonesia,IDN,0,0,0,5,5
2011,Myanmar,MMR,Indonesia,IDN,55,0,0,92,147
2011,Pakistan,PAK,Indonesia,IDN,5,0,0,58,63
2011,Senegal,SEN,Indonesia,IDN,0,0,0,5,5
2011,Somalia,SOM,Indonesia,IDN,36,0,0,5,41
2011,Thailand,THA,Indonesia,IDN,5,0,0,0,5
2011,Afghanistan,AFG,Jordan,JOR,5,0,21,23,49
2011,Egypt,EGY,Jordan,JOR,10,0,71,27,108
2011,Bangladesh,BGD,Jordan,JOR,0,0,5,0,5
2011,Dem. Rep. of the Congo,COD,Jordan,JOR,0,0,10,0,10
2011,Eritrea,ERI,Jordan,JOR,5,0,0,0,5
2011,India,IND,Jordan,JOR,0,0,5,5,10
2011,Iraq,IRQ,Jordan,JOR,201,0,331,506,1038
2011,Libya,LBY,Jordan,JOR,0,0,0,10,10
2011,Sri Lanka,LKA,Jordan,JOR,0,0,5,14,19
2011,Morocco,MAR,Jordan,JOR,0,0,11,0,11
2011,Pakistan,PAK,Jordan,JOR,0,0,14,0,14
2011,Philippines,PHL,Jordan,JOR,0,0,5,0,5
2011,Romania,ROU,Jordan,JOR,0,0,5,0,5
2011,Russian Federation,RUS,Jordan,JOR,0,0,0,5,5
2011,Somalia,SOM,Jordan,JOR,41,0,10,23,74
2011,Sudan,SDN,Jordan,JOR,99,0,54,113,266
2011,Syrian Arab Rep.,SYR,Jordan,JOR,5,0,28,34,67
2011,Tunisia,TUN,Jordan,JOR,5,0,5,0,10
2011,Yemen,YEM,Jordan,JOR,0,0,16,16,32
2011,Afghanistan,AFG,Kyrgyzstan,KGZ,30,0,41,18,89
2011,Kazakhstan,KAZ,Kyrgyzstan,KGZ,0,0,5,10,15
2011,Uzbekistan,UZB,Kyrgyzstan,KGZ,115,0,5,16,136
2011,Pakistan,PAK,Sri Lanka,LKA,22,0,75,0,97
2011,Central African Rep.,CAF,Mauritania,MRT,0,0,5,0,5
2011,Cameroon,CMR,Mauritania,MRT,0,0,5,11,16
2011,Dem. Rep. of the Congo,COD,Mauritania,MRT,12,0,16,49,77
2011,Guinea,GIN,Mauritania,MRT,0,0,5,46,51
2011,Cote d'Ivoire,CIV,Mauritania,MRT,21,0,0,117,138
2011,Liberia,LBR,Mauritania,MRT,0,0,0,22,22
2011,Nigeria,NGA,Mauritania,MRT,0,0,0,5,5
2011,Senegal,SEN,Mauritania,MRT,10,0,5,0,15
2011,Togo,TGO,Mauritania,MRT,0,0,5,0,5
2011,Afghanistan,AFG,Pakistan,PAK,395,0,282,674,1351
2011,Egypt,EGY,Pakistan,PAK,0,0,0,5,5
2011,Iran (Islamic Rep. of),IRN,Pakistan,PAK,10,0,10,14,34
2011,Iraq,IRQ,Pakistan,PAK,5,0,0,0,5
2011,Somalia,SOM,Pakistan,PAK,23,0,0,30,53
2011,Chad,TCD,Tunisia,TUN,18,0,81,0,99
2011,Congo,COG,Tunisia,TUN,5,0,0,0,5
2011,Dem. Rep. of the Congo,COD,Tunisia,TUN,5,0,0,0,5
2011,Eritrea,ERI,Tunisia,TUN,982,0,5,57,1044
2011,Ethiopia,ETH,Tunisia,TUN,256,0,34,0,290
2011,Gambia,GMB,Tunisia,TUN,0,0,5,0,5
2011,Palestinian,PSE,Tunisia,TUN,21,0,0,0,21
2011,Ghana,GHA,Tunisia,TUN,0,0,10,0,10
2011,Cote d'Ivoire,CIV,Tunisia,TUN,16,0,32,0,48
2011,Iraq,IRQ,Tunisia,TUN,316,0,0,0,316
2011,Liberia,LBR,Tunisia,TUN,5,0,5,0,10
2011,Mali,MLI,Tunisia,TUN,5,0,10,0,15
2011,Morocco,MAR,Tunisia,TUN,5,0,5,0,10
2011,Nigeria,NGA,Tunisia,TUN,5,0,42,0,47
2011,Pakistan,PAK,Tunisia,TUN,11,0,0,0,11
2011,Somalia,SOM,Tunisia,TUN,1052,0,14,0,1066
2011,Sudan,SDN,Tunisia,TUN,869,0,76,0,945
2011,Syrian Arab Rep.,SYR,Tunisia,TUN,5,0,0,0,5
2011,Afghanistan,AFG,United Arab Emirates,ARE,0,0,5,14,19
2011,Iran (Islamic Rep. of),IRN,United Arab Emirates,ARE,5,0,0,5,10
2011,Iraq,IRQ,United Arab Emirates,ARE,185,5,0,0,190
2011,Sudan,SDN,United Arab Emirates,ARE,0,0,5,0,5
2011,Syrian Arab Rep.,SYR,United Arab Emirates,ARE,5,0,0,10,15
2011,Tunisia,TUN,United Arab Emirates,ARE,0,0,0,10,10
2011,Algeria,DZA,Yemen,YEM,0,0,0,5,5
2011,Egypt,EGY,Yemen,YEM,0,0,0,5,5
2011,Dem. Rep. of the Congo,COD,Yemen,YEM,0,0,0,5,5
2011,Eritrea,ERI,Yemen,YEM,109,0,5,19,133
2011,Ethiopia,ETH,Yemen,YEM,966,0,518,101,1585
2011,Palestinian,PSE,Yemen,YEM,70,0,0,134,204
2011,Greece,GRC,Yemen,YEM,0,0,0,5,5
2011,Iraq,IRQ,Yemen,YEM,32,0,5,0,37
2011,Jordan,JOR,Yemen,YEM,5,0,0,5,10
2011,Russian Federation,RUS,Yemen,YEM,0,0,0,5,5
2011,Sudan,SDN,Yemen,YEM,5,0,5,0,10
2011,Syrian Arab Rep.,SYR,Yemen,YEM,5,0,0,23,28
2012,Iran (Islamic Rep. of),IRN,Afghanistan,AFG,5,0,10,0,15
2012,Pakistan,PAK,Afghanistan,AFG,5,0,0,0,5
2012,Iraq,IRQ,China,CHN,5,0,0,0,5
2012,Pakistan,PAK,China,CHN,5,0,0,0,5
2012,Rwanda,RWA,China,CHN,5,0,0,0,5
2012,Somalia,SOM,China,CHN,32,0,0,5,37
2012,Burundi,BDI,Cameroon,CMR,0,0,0,5,5
2012,Burkina Faso,BFA,Cameroon,CMR,0,0,0,11,11
2012,Central African Rep.,CAF,Cameroon,CMR,69,0,261,1220,1550
2012,Chad,TCD,Cameroon,CMR,15,0,80,277,372
2012,Congo,COG,Cameroon,CMR,0,0,5,12,17
2012,Dem. Rep. of the Congo,COD,Cameroon,CMR,13,0,39,107,159
2012,Equatorial Guinea,GNQ,Cameroon,CMR,5,0,0,0,5
2012,Gambia,GMB,Cameroon,CMR,0,0,0,31,31
2012,Ghana,GHA,Cameroon,CMR,0,0,0,5,5
2012,Guinea-Bissau,GNB,Cameroon,CMR,0,0,0,37,37
2012,Guinea,GIN,Cameroon,CMR,0,0,47,612,659
2012,Cote d'Ivoire,CIV,Cameroon,CMR,20,0,5,181,206
2012,Liberia,LBR,Cameroon,CMR,0,0,0,10,10
2012,Sri Lanka,LKA,Cameroon,CMR,0,0,0,5,5
2012,Mali,MLI,Cameroon,CMR,0,0,0,15,15
2012,Niger,NER,Cameroon,CMR,0,0,0,5,5
2012,Nigeria,NGA,Cameroon,CMR,0,0,0,5,5
2012,Rwanda,RWA,Cameroon,CMR,12,0,85,10,107
2012,Senegal,SEN,Cameroon,CMR,0,0,21,323,344
2012,Sierra Leone,SLE,Cameroon,CMR,0,0,0,10,10
2012,Sudan,SDN,Cameroon,CMR,18,0,0,33,51
2012,Togo,TGO,Cameroon,CMR,0,0,0,5,5
2012,Syrian Arab Rep.,SYR,Cuba,CUB,59,0,0,0,59
2012,Iran (Islamic Rep. of),IRN,Cyprus,CYP,0,0,0,10,10
2012,Pakistan,PAK,Cyprus,CYP,0,0,0,5,5
2012,Sierra Leone,SLE,Cyprus,CYP,0,0,0,10,10
2012,Syrian Arab Rep.,SYR,Cyprus,CYP,0,0,0,45,45
2012,Afghanistan,AFG,Indonesia,IDN,654,0,33,2023,2710
2012,Egypt,EGY,Indonesia,IDN,0,0,0,11,11
2012,China,CHN,Indonesia,IDN,5,0,0,0,5
2012,Cameroon,CMR,Indonesia,IDN,0,0,5,5,10
2012,Dem. Rep. of the Congo,COD,Indonesia,IDN,0,0,5,0,5
2012,Ethiopia,ETH,Indonesia,IDN,5,0,0,0,5
2012,Palestinian,PSE,Indonesia,IDN,12,0,0,110,122
2012,Cote d'Ivoire,CIV,Indonesia,IDN,0,0,5,0,5
2012,India,IND,Indonesia,IDN,0,0,0,5,5
2012,Iran (Islamic Rep. of),IRN,Indonesia,IDN,99,0,5,235,339
2012,Iraq,IRQ,Indonesia,IDN,101,0,11,183,295
2012,Kuwait,KWT,Indonesia,IDN,0,0,0,5,5
2012,Libya,LBY,Indonesia,IDN,0,0,0,5,5
2012,Sri Lanka,LKA,Indonesia,IDN,67,0,5,198,270
2012,Myanmar,MMR,Indonesia,IDN,147,0,0,5,152
2012,Pakistan,PAK,Indonesia,IDN,17,0,5,227,249
2012,Philippines,PHL,Indonesia,IDN,5,0,0,0,5
2012,Senegal,SEN,Indonesia,IDN,0,0,0,5,5
2012,Somalia,SOM,Indonesia,IDN,101,0,0,5,106
2012,Syrian Arab Rep.,SYR,Indonesia,IDN,5,0,0,5,10
2012,Egypt,EGY,Jordan,JOR,0,0,173,0,173
2012,Eritrea,ERI,Jordan,JOR,5,0,0,5,10
2012,Germany,DEU,Jordan,JOR,0,0,0,5,5
2012,Iraq,IRQ,Jordan,JOR,680,0,420,461,1561
2012,Libya,LBY,Jordan,JOR,0,0,0,36,36
2012,Sri Lanka,LKA,Jordan,JOR,0,0,5,0,5
2012,Pakistan,PAK,Jordan,JOR,0,0,5,5,10
2012,Philippines,PHL,Jordan,JOR,0,0,5,0,5
2012,Somalia,SOM,Jordan,JOR,144,0,20,17,181
2012,Sudan,SDN,Jordan,JOR,102,0,134,29,265
2012,Syrian Arab Rep.,SYR,Jordan,JOR,12,0,13,2102,2127
2012,Tunisia,TUN,Jordan,JOR,0,0,0,5,5
2012,Yemen,YEM,Jordan,JOR,5,0,108,5,118
2012,Afghanistan,AFG,Kyrgyzstan,KGZ,5,0,16,18,39
2012,China,CHN,Kyrgyzstan,KGZ,0,0,0,5,5
2012,Kazakhstan,KAZ,Kyrgyzstan,KGZ,0,0,0,10,10
2012,Syrian Arab Rep.,SYR,Kyrgyzstan,KGZ,0,0,0,5,5
2012,Uzbekistan,UZB,Kyrgyzstan,KGZ,13,0,0,5,18
2012,Eritrea,ERI,Kuwait,KWT,0,0,0,5,5
2012,Iran (Islamic Rep. of),IRN,Kuwait,KWT,0,0,10,10,20
2012,Iraq,IRQ,Kuwait,KWT,77,0,0,381,458
2012,Jordan,JOR,Kuwait,KWT,0,0,0,5,5
2012,Somalia,SOM,Kuwait,KWT,29,0,0,22,51
2012,Afghanistan,AFG,Sri Lanka,LKA,5,0,0,0,5
2012,Pakistan,PAK,Sri Lanka,LKA,88,0,17,22,127
2012,Somalia,SOM,Sri Lanka,LKA,0,0,0,5,5
2012,Dem. Rep. of the Congo,COD,Mauritania,MRT,0,0,53,0,53
2012,Cote d'Ivoire,CIV,Mauritania,MRT,5,5,0,5,15
2012,Senegal,SEN,Mauritania,MRT,5,0,0,0,5
2012,Afghanistan,AFG,Pakistan,PAK,1653,0,374,206,2233
2012,Iran (Islamic Rep. of),IRN,Pakistan,PAK,10,0,5,0,15
2012,Somalia,SOM,Pakistan,PAK,13,0,0,10,23
2012,Palestinian,PSE,United Arab Emirates,ARE,0,0,0,5,5
2012,Iraq,IRQ,United Arab Emirates,ARE,126,13,0,0,139
2012,Sri Lanka,LKA,United Arab Emirates,ARE,39,0,5,0,44
2012,Syrian Arab Rep.,SYR,United Arab Emirates,ARE,5,0,0,0,5
2012,Afghanistan,AFG,Ukraine,UKR,10,0,0,51,61
2012,Angola,AGO,Ukraine,UKR,0,0,0,5,5
2012,Azerbaijan,AZE,Ukraine,UKR,0,0,0,5,5
2012,Cameroon,CMR,Ukraine,UKR,0,0,0,5,5
2012,Congo,COG,Ukraine,UKR,0,0,0,5,5
2012,Dem. Rep. of the Congo,COD,Ukraine,UKR,5,0,0,0,5
2012,Georgia,GEO,Ukraine,UKR,0,0,0,5,5
2012,Iran (Islamic Rep. of),IRN,Ukraine,UKR,0,0,0,10,10
2012,Iraq,IRQ,Ukraine,UKR,5,0,0,5,10
2012,Kyrgyzstan,KGZ,Ukraine,UKR,5,0,5,0,10
2012,Sri Lanka,LKA,Ukraine,UKR,0,0,0,10,10
2012,Russian Federation,RUS,Ukraine,UKR,5,0,0,0,5
2012,Somalia,SOM,Ukraine,UKR,5,0,0,0,5
2012,Uzbekistan,UZB,Ukraine,UKR,12,0,5,0,17
2012,Congo,COG,Yemen,YEM,5,0,0,0,5
2012,Dem. Rep. of the Congo,COD,Yemen,YEM,0,0,0,5,5
2012,Comoros,COM,Yemen,YEM,0,0,0,5,5
2012,Eritrea,ERI,Yemen,YEM,255,0,0,87,342
2012,Ethiopia,ETH,Yemen,YEM,593,0,156,1516,2265
2012,Palestinian,PSE,Yemen,YEM,5,0,0,24,29
2012,Iran (Islamic Rep. of),IRN,Yemen,YEM,0,0,0,5,5
2012,Iraq,IRQ,Yemen,YEM,26,0,0,75,101
2012,Sudan,SDN,Yemen,YEM,0,0,0,20,20
2012,Syrian Arab Rep.,SYR,Yemen,YEM,0,0,0,5,5
2013,Chad,TCD,Egypt,EGY,5,0,0,5,10
2013,Eritrea,ERI,Egypt,EGY,553,0,13,0,566
2013,Ethiopia,ETH,Egypt,EGY,368,0,96,5,469
2013,Palestinian,PSE,Egypt,EGY,0,0,0,5,5
2013,Cote d'Ivoire,CIV,Egypt,EGY,17,0,0,0,17
2013,Iraq,IRQ,Egypt,EGY,159,0,0,17,176
2013,Nigeria,NGA,Egypt,EGY,0,0,0,5,5
2013,Somalia,SOM,Egypt,EGY,503,0,38,17,558
2013,Sudan,SDN,Egypt,EGY,2329,0,164,0,2493
2013,South Sudan,SSD,Egypt,EGY,170,0,5,0,175
2013,Uzbekistan,UZB,Egypt,EGY,0,0,0,12,12
2013,Yemen,YEM,Egypt,EGY,10,0,0,0,10
2013,Zimbabwe,ZWE,Egypt,EGY,5,0,0,0,5
2013,Iraq,IRQ,China,CHN,5,0,0,0,5
2013,Liberia,LBR,China,CHN,0,0,15,12,27
2013,Somalia,SOM,China,CHN,41,0,30,25,96
2013,Uganda,UGA,China,CHN,0,0,0,5,5
2013,Syrian Arab Rep.,SYR,Cuba,CUB,24,0,0,0,24
2013,Yemen,YEM,Eritrea,ERI,5,0,0,0,5
2013,Egypt,EGY,Jordan,JOR,17,0,53,10,80
2013,Eritrea,ERI,Jordan,JOR,5,0,0,0,5
2013,Iraq,IRQ,Jordan,JOR,2117,0,277,800,3194
2013,Lebanon,LBN,Jordan,JOR,0,0,5,0,5
2013,Somalia,SOM,Jordan,JOR,184,0,32,0,216
2013,Sudan,SDN,Jordan,JOR,129,0,52,126,307
2013,Syrian Arab Rep.,SYR,Jordan,JOR,800,0,0,491,1291
2013,Tunisia,TUN,Jordan,JOR,0,0,0,5,5
2013,Yemen,YEM,Jordan,JOR,0,0,28,38,66
2013,Stateless,XXA,Jordan,JOR,0,0,0,10,10
2013,Afghanistan,AFG,Kyrgyzstan,KGZ,42,0,44,12,98
2013,China,CHN,Kyrgyzstan,KGZ,0,0,0,5,5
2013,Iran (Islamic Rep. of),IRN,Kyrgyzstan,KGZ,0,0,10,0,10
2013,Russian Federation,RUS,Kyrgyzstan,KGZ,0,0,0,5,5
2013,Uzbekistan,UZB,Kyrgyzstan,KGZ,13,0,5,21,39
2013,Afghanistan,AFG,Pakistan,PAK,2117,0,638,229,2984
2013,China,CHN,Pakistan,PAK,0,0,0,5,5
2013,Palestinian,PSE,Pakistan,PAK,5,0,0,0,5
2013,Iran (Islamic Rep. of),IRN,Pakistan,PAK,19,0,0,5,24
2013,Somalia,SOM,Pakistan,PAK,42,0,10,0,52
2013,United Rep. of Tanzania,TZA,Pakistan,PAK,0,0,5,0,5
2013,Afghanistan,AFG,Tajikistan,TJK,57,0,53,17,127
2013,Pakistan,PAK,Tajikistan,TJK,5,0,0,5,10
2013,Afghanistan,AFG,United Arab Emirates,ARE,0,0,5,0,5
2013,Iran (Islamic Rep. of),IRN,United Arab Emirates,ARE,5,0,0,5,10
2013,Iraq,IRQ,United Arab Emirates,ARE,225,0,0,5,230
2013,Pakistan,PAK,United Arab Emirates,ARE,5,0,0,0,5
2013,Somalia,SOM,United Arab Emirates,ARE,10,0,0,0,10
2013,Sudan,SDN,United Arab Emirates,ARE,0,0,14,0,14
2013,Afghanistan,AFG,Ukraine,UKR,10,0,5,10,25
2013,Azerbaijan,AZE,Ukraine,UKR,5,0,0,5,10
2013,Dem. Rep. of the Congo,COD,Ukraine,UKR,5,0,0,0,5
2013,Palestinian,PSE,Ukraine,UKR,0,0,0,5,5
2013,Iran (Islamic Rep. of),IRN,Ukraine,UKR,0,0,5,5,10
2013,Iraq,IRQ,Ukraine,UKR,0,0,0,5,5
2013,Kyrgyzstan,KGZ,Ukraine,UKR,0,0,0,5,5
2013,Russian Federation,RUS,Ukraine,UKR,5,0,0,0,5
2013,Somalia,SOM,Ukraine,UKR,0,0,0,5,5
2013,Syrian Arab Rep.,SYR,Ukraine,UKR,0,0,0,5,5
2013,Uzbekistan,UZB,Ukraine,UKR,14,0,0,0,14
2014,Afghanistan,AFG,Cuba,CUB,5,0,0,0,5
2014,Iran (Islamic Rep. of),IRN,Cuba,CUB,5,0,0,0,5
2014,Syrian Arab Rep.,SYR,Cuba,CUB,5,0,0,0,5
2014,Burundi,BDI,Mauritania,MRT,0,0,0,5,5
2014,Central African Rep.,CAF,Mauritania,MRT,216,0,0,45,261
2014,Cameroon,CMR,Mauritania,MRT,0,0,14,5,19
2014,Congo,COG,Mauritania,MRT,0,0,0,10,10
2014,Dem. Rep. of the Congo,COD,Mauritania,MRT,5,0,26,18,49
2014,Guinea,GIN,Mauritania,MRT,5,0,5,0,10
2014,Cote d'Ivoire,CIV,Mauritania,MRT,56,0,202,261,519
2014,Iraq,IRQ,Mauritania,MRT,5,0,0,0,5
2014,Liberia,LBR,Mauritania,MRT,0,0,0,5,5
2014,Mali,MLI,Mauritania,MRT,0,0,0,5,5
2014,Nigeria,NGA,Mauritania,MRT,0,0,0,11,11
2014,Senegal,SEN,Mauritania,MRT,26,0,33,0,59
2014,Somalia,SOM,Mauritania,MRT,5,0,0,0,5
2014,Sudan,SDN,Mauritania,MRT,5,0,0,0,5
2014,Syrian Arab Rep.,SYR,Mauritania,MRT,39,0,0,5,44
2014,Togo,TGO,Mauritania,MRT,0,0,5,5,10
2014,Afghanistan,AFG,United Arab Emirates,ARE,5,0,0,0,5
2014,Ethiopia,ETH,United Arab Emirates,ARE,5,0,0,0,5
2014,Iran (Islamic Rep. of),IRN,United Arab Emirates,ARE,5,0,0,0,5
2014,Iraq,IRQ,United Arab Emirates,ARE,85,0,0,0,85
2014,Somalia,SOM,United Arab Emirates,ARE,5,0,0,10,15
2014,Syrian Arab Rep.,SYR,United Arab Emirates,ARE,5,0,0,0,5
2015,Afghanistan,AFG,Cuba,CUB,10,0,5,5,20
2015,Eritrea,ERI,Cuba,CUB,16,0,0,0,16
2015,Ethiopia,ETH,Cuba,CUB,5,0,0,0,5
2015,Iran (Islamic Rep. of),IRN,Cuba,CUB,26,0,0,0,26
2015,Syrian Arab Rep.,SYR,Cuba,CUB,22,0,0,5,27
2015,Yemen,YEM,Cuba,CUB,11,0,0,0,11
2015,Cameroon,CMR,Cyprus,CYP,0,0,5,0,5
2015,Guinea,GIN,Cyprus,CYP,0,0,5,0,5
2015,Cote d'Ivoire,CIV,Cyprus,CYP,0,0,5,0,5
2015,Iran (Islamic Rep. of),IRN,Cyprus,CYP,0,0,5,0,5
2015,Syrian Arab Rep.,SYR,Cyprus,CYP,54,0,0,0,54
2015,Togo,TGO,Cyprus,CYP,0,0,5,0,5
2015,Central African Rep.,CAF,Mauritania,MRT,203,0,23,0,226
2015,Cameroon,CMR,Mauritania,MRT,5,0,21,0,26
2015,Congo,COG,Mauritania,MRT,0,0,5,0,5
2015,Dem. Rep. of the Congo,COD,Mauritania,MRT,0,0,5,27,32
2015,Palestinian,PSE,Mauritania,MRT,18,0,0,0,18
2015,Guinea,GIN,Mauritania,MRT,0,0,10,0,10
2015,Cote d'Ivoire,CIV,Mauritania,MRT,5,0,136,24,165
2015,Iraq,IRQ,Mauritania,MRT,5,0,0,0,5
2015,Liberia,LBR,Mauritania,MRT,0,0,5,0,5
2015,Mali,MLI,Mauritania,MRT,5,0,5,0,10
2015,Nigeria,NGA,Mauritania,MRT,10,0,19,0,29
2015,Senegal,SEN,Mauritania,MRT,20,0,5,0,25
2015,Syrian Arab Rep.,SYR,Mauritania,MRT,184,0,0,0,184
2015,Togo,TGO,Mauritania,MRT,0,0,5,0,5
2015,Ukraine,UKR,Mauritania,MRT,5,0,0,0,5
2015,Western Sahara,ESH,Mauritania,MRT,5,0,0,0,5
2016,Afghanistan,AFG,Cuba,CUB,35,0,10,10,55
2016,Eritrea,ERI,Cuba,CUB,5,0,0,0,5
2016,Iran (Islamic Rep. of),IRN,Cuba,CUB,0,0,5,0,5
2016,Syrian Arab Rep.,SYR,Cuba,CUB,5,0,0,0,5
2017,Ethiopia,ETH,Eritrea,ERI,10,0,0,0,10
2017,Eritrea,ERI,Yemen,YEM,34,0,0,0,34
2017,Ethiopia,ETH,Yemen,YEM,388,0,0,34,422
2017,Palestinian,PSE,Yemen,YEM,45,0,0,5,50
2017,Iraq,IRQ,Yemen,YEM,11,0,0,5,16
2017,Sudan,SDN,Yemen,YEM,19,0,0,5,24
2017,Syrian Arab Rep.,SYR,Yemen,YEM,0,0,0,5,5
2018,Eritrea,ERI,Yemen,YEM,88,0,0,18,106
2018,Ethiopia,ETH,Yemen,YEM,167,0,0,2375,2542
2018,Palestinian,PSE,Yemen,YEM,0,0,0,24,24
2018,Somalia,SOM,Yemen,YEM,0,0,0,5,5
2018,Sudan,SDN,Yemen,YEM,0,0,0,5,5
2018,Syrian Arab Rep.,SYR,Yemen,YEM,0,0,0,90,90
2019,Eritrea,ERI,Yemen,YEM,0,0,0,10,10
2019,Ethiopia,ETH,Yemen,YEM,32,0,23,492,547
2019,Palestinian,PSE,Yemen,YEM,0,0,0,13,13
2019,Somalia,SOM,Yemen,YEM,0,0,0,5,5
2019,Sudan,SDN,Yemen,YEM,0,0,0,25,25
2000,Cameroon,CMR,Algeria,DZA,5,0,0,0,5
2000,Dem. Rep. of the Congo,COD,Algeria,DZA,0,0,42,0,42
2000,Iraq,IRQ,Algeria,DZA,5,0,0,0,5
2000,Liberia,LBR,Algeria,DZA,0,0,0,13,13
2000,Libya,LBY,Algeria,DZA,5,0,0,0,5
2000,Sudan,SDN,Algeria,DZA,0,0,5,0,5
2000,Syrian Arab Rep.,SYR,Algeria,DZA,5,0,0,0,5
2000,Burundi,BDI,Congo,COG,5,0,0,0,5
2000,Chad,TCD,Congo,COG,0,0,0,11,11
2000,Dem. Rep. of the Congo,COD,Congo,COG,44,0,96,100,240
2000,Mauritania,MRT,Congo,COG,0,0,0,5,5
2000,Sudan,SDN,Congo,COG,0,0,5,10,15
2000,Uganda,UGA,Congo,COG,0,0,5,0,5
2000,Angola,AGO,Dem. Rep. of the Congo,COD,79,0,5,0,84
2000,Burundi,BDI,Dem. Rep. of the Congo,COD,10,0,0,10,20
2000,Central African Rep.,CAF,Dem. Rep. of the Congo,COD,0,0,0,5,5
2000,Congo,COG,Dem. Rep. of the Congo,COD,14,0,84,36,134
2000,Rwanda,RWA,Dem. Rep. of the Congo,COD,5,0,11,26,42
2000,Sierra Leone,SLE,Dem. Rep. of the Congo,COD,5,0,0,5,10
2000,Uganda,UGA,Dem. Rep. of the Congo,COD,0,0,0,5,5
2000,Chad,TCD,Morocco,MAR,5,0,0,0,5
2000,China,CHN,Morocco,MAR,5,0,0,0,5
2000,Congo,COG,Morocco,MAR,0,0,40,0,40
2000,Iraq,IRQ,Morocco,MAR,0,0,5,0,5
2000,Liberia,LBR,Morocco,MAR,0,0,12,0,12
2000,Nigeria,NGA,Morocco,MAR,0,0,32,0,32
2000,Sierra Leone,SLE,Morocco,MAR,18,0,5,0,23
2000,Sudan,SDN,Morocco,MAR,0,0,5,0,5
2000,Eritrea,ERI,Sudan,SDN,0,0,120,0,120
2000,Afghanistan,AFG,Syrian Arab Rep.,SYR,62,0,138,180,380
2000,Algeria,DZA,Syrian Arab Rep.,SYR,5,0,12,12,29
2000,Congo,COG,Syrian Arab Rep.,SYR,0,0,5,0,5
2000,Eritrea,ERI,Syrian Arab Rep.,SYR,5,0,12,0,17
2000,Iran (Islamic Rep. of),IRN,Syrian Arab Rep.,SYR,5,0,34,60,99
2000,Iraq,IRQ,Syrian Arab Rep.,SYR,778,86,1901,2085,4850
2000,Jordan,JOR,Syrian Arab Rep.,SYR,0,0,0,5,5
2000,Lebanon,LBN,Syrian Arab Rep.,SYR,0,0,11,0,11
2000,Pakistan,PAK,Syrian Arab Rep.,SYR,0,0,0,10,10
2000,Somalia,SOM,Syrian Arab Rep.,SYR,25,0,191,209,425
2000,Sudan,SDN,Syrian Arab Rep.,SYR,41,0,240,353,634
2000,Tunisia,TUN,Syrian Arab Rep.,SYR,30,0,5,5,40
2000,Turkey,TUR,Syrian Arab Rep.,SYR,0,0,0,10,10
2000,Yemen,YEM,Syrian Arab Rep.,SYR,10,0,61,57,128
2000,Stateless,XXA,Syrian Arab Rep.,SYR,5,0,0,0,5
2000,Unknown ,,Syrian Arab Rep.,SYR,10,0,20,35,65
2000,Algeria,DZA,Tunisia,TUN,0,0,5,21,26
2000,Palestinian,PSE,Tunisia,TUN,0,0,0,5,5
2000,Iraq,IRQ,Tunisia,TUN,0,0,0,5,5
2001,Chad,TCD,Algeria,DZA,0,0,15,0,15
2001,Cameroon,CMR,Algeria,DZA,5,0,0,0,5
2001,Congo,COG,Algeria,DZA,0,0,11,0,11
2001,Dem. Rep. of the Congo,COD,Algeria,DZA,0,0,100,0,100
2001,Guinea,GIN,Algeria,DZA,0,0,35,0,35
2001,Iraq,IRQ,Algeria,DZA,5,0,0,0,5
2001,Liberia,LBR,Algeria,DZA,5,0,0,5,10
2001,Libya,LBY,Algeria,DZA,5,0,0,0,5
2001,Rwanda,RWA,Algeria,DZA,0,0,0,20,20
2001,Sierra Leone,SLE,Algeria,DZA,0,0,30,0,30
2001,Somalia,SOM,Algeria,DZA,5,0,10,0,15
2001,Sudan,SDN,Algeria,DZA,0,0,5,0,5
2001,Syrian Arab Rep.,SYR,Algeria,DZA,5,0,0,0,5
2001,Central African Rep.,CAF,Congo,COG,1585,0,0,0,1585
2001,Dem. Rep. of the Congo,COD,Congo,COG,105,0,100,0,205
2001,Angola,AGO,Dem. Rep. of the Congo,COD,10,195,38,0,243
2001,Burundi,BDI,Dem. Rep. of the Congo,COD,5,5,0,0,10
2001,Central African Rep.,CAF,Dem. Rep. of the Congo,COD,5,0,0,0,5
2001,Congo,COG,Dem. Rep. of the Congo,COD,12,0,35,0,47
2001,Iran (Islamic Rep. of),IRN,Dem. Rep. of the Congo,COD,0,0,0,5,5
2001,Liberia,LBR,Dem. Rep. of the Congo,COD,0,0,83,0,83
2001,Rwanda,RWA,Dem. Rep. of the Congo,COD,11,23,15,0,49
2001,Sierra Leone,SLE,Dem. Rep. of the Congo,COD,0,0,18,0,18
2001,Sudan,SDN,Dem. Rep. of the Congo,COD,19,0,0,0,19
2001,Tunisia,TUN,Sudan,SDN,5,0,0,0,5
2001,Afghanistan,AFG,Syrian Arab Rep.,SYR,38,0,87,36,161
2001,Algeria,DZA,Syrian Arab Rep.,SYR,0,0,10,5,15
2001,Azerbaijan,AZE,Syrian Arab Rep.,SYR,0,0,5,0,5
2001,Bahrain,BHR,Syrian Arab Rep.,SYR,0,0,5,0,5
2001,Eritrea,ERI,Syrian Arab Rep.,SYR,0,0,5,0,5
2001,Iran (Islamic Rep. of),IRN,Syrian Arab Rep.,SYR,5,0,50,41,96
2001,Iraq,IRQ,Syrian Arab Rep.,SYR,180,0,1054,494,1728
2001,Jordan,JOR,Syrian Arab Rep.,SYR,0,0,5,0,5
2001,Russian Federation,RUS,Syrian Arab Rep.,SYR,0,0,5,5,10
2001,Somalia,SOM,Syrian Arab Rep.,SYR,15,0,62,25,102
2001,Sudan,SDN,Syrian Arab Rep.,SYR,25,0,201,89,315
2001,Yemen,YEM,Syrian Arab Rep.,SYR,0,0,5,10,15
2001,Unknown ,,Syrian Arab Rep.,SYR,0,0,5,0,5
2001,Algeria,DZA,Tunisia,TUN,0,0,0,5,5
2001,Iraq,IRQ,Tunisia,TUN,0,0,0,5,5
2002,Congo,COG,Algeria,DZA,0,0,0,27,27
2002,Dem. Rep. of the Congo,COD,Algeria,DZA,0,0,0,58,58
2002,Guinea,GIN,Algeria,DZA,0,0,0,10,10
2002,Liberia,LBR,Algeria,DZA,0,0,0,10,10
2002,Morocco,MAR,Algeria,DZA,0,0,0,5,5
2002,Sierra Leone,SLE,Algeria,DZA,0,0,0,5,5
2002,Angola,AGO,Congo,COG,0,0,0,5,5
2002,Chad,TCD,Congo,COG,0,0,5,0,5
2002,Dem. Rep. of the Congo,COD,Congo,COG,40,0,120,0,160
2002,Guinea,GIN,Congo,COG,0,0,5,0,5
2002,Rwanda,RWA,Congo,COG,0,0,5,50,55
2002,Sierra Leone,SLE,Congo,COG,0,0,5,0,5
2002,Sudan,SDN,Congo,COG,0,0,5,0,5
2002,Angola,AGO,Dem. Rep. of the Congo,COD,221,0,73,95,389
2002,Burundi,BDI,Dem. Rep. of the Congo,COD,5,0,0,5,10
2002,Central African Rep.,CAF,Dem. Rep. of the Congo,COD,13,0,0,10,23
2002,Congo,COG,Dem. Rep. of the Congo,COD,5,0,25,0,30
2002,Liberia,LBR,Dem. Rep. of the Congo,COD,0,0,54,10,64
2002,Rwanda,RWA,Dem. Rep. of the Congo,COD,0,0,41,0,41
2002,Sierra Leone,SLE,Dem. Rep. of the Congo,COD,0,0,10,20,30
2002,Sudan,SDN,Dem. Rep. of the Congo,COD,0,0,11,5,16
2002,Uganda,UGA,Dem. Rep. of the Congo,COD,0,0,5,0,5
2002,Bosnia and Herzegovina,BIH,Libya,LBY,5,0,0,0,5
2002,Dem. Rep. of the Congo,COD,Libya,LBY,0,0,5,0,5
2002,Eritrea,ERI,Libya,LBY,0,0,0,5,5
2002,Palestinian,PSE,Libya,LBY,20,0,0,0,20
2002,Iraq,IRQ,Libya,LBY,5,0,20,0,25
2002,Somalia,SOM,Libya,LBY,0,0,0,70,70
2002,Sudan,SDN,Libya,LBY,5,0,0,0,5
2002,Syrian Arab Rep.,SYR,Libya,LBY,0,0,10,0,10
2002,Stateless,XXA,Libya,LBY,5,0,0,0,5
2002,Chad,TCD,Morocco,MAR,0,0,0,5,5
2002,Congo,COG,Morocco,MAR,5,0,5,107,117
2002,Dem. Rep. of the Congo,COD,Morocco,MAR,5,0,0,31,36
2002,Palestinian,PSE,Morocco,MAR,13,0,0,0,13
2002,Ghana,GHA,Morocco,MAR,0,0,0,5,5
2002,Cote d'Ivoire,CIV,Morocco,MAR,5,0,0,0,5
2002,Iraq,IRQ,Morocco,MAR,0,0,0,10,10
2002,Liberia,LBR,Morocco,MAR,0,0,5,0,5
2002,Niger,NER,Morocco,MAR,0,0,0,5,5
2002,Nigeria,NGA,Morocco,MAR,0,0,0,210,210
2002,Pakistan,PAK,Morocco,MAR,5,0,0,5,10
2002,Sierra Leone,SLE,Morocco,MAR,0,0,0,5,5
2002,Eritrea,ERI,Sudan,SDN,2106,0,1303,0,3409
2002,Ethiopia,ETH,Sudan,SDN,53,0,12,0,65
2002,Uganda,UGA,Sudan,SDN,84,0,16,0,100
2002,Afghanistan,AFG,Syrian Arab Rep.,SYR,5,0,5,0,10
2002,Algeria,DZA,Syrian Arab Rep.,SYR,5,0,11,5,21
2002,Eritrea,ERI,Syrian Arab Rep.,SYR,0,0,5,0,5
2002,Iran (Islamic Rep. of),IRN,Syrian Arab Rep.,SYR,5,0,41,5,51
2002,Iraq,IRQ,Syrian Arab Rep.,SYR,140,0,958,305,1403
2002,Somalia,SOM,Syrian Arab Rep.,SYR,5,0,82,46,133
2002,Sudan,SDN,Syrian Arab Rep.,SYR,18,0,146,46,210
2002,Tunisia,TUN,Syrian Arab Rep.,SYR,0,0,5,0,5
2002,Turkey,TUR,Syrian Arab Rep.,SYR,0,0,5,0,5
2002,Yemen,YEM,Syrian Arab Rep.,SYR,0,0,0,17,17
2002,Algeria,DZA,Tunisia,TUN,5,0,0,21,26
2003,Chad,TCD,Congo,COG,5,0,0,0,5
2003,Dem. Rep. of the Congo,COD,Congo,COG,5,0,53,0,58
2003,Angola,AGO,Dem. Rep. of the Congo,COD,18,0,18,134,170
2003,Burundi,BDI,Dem. Rep. of the Congo,COD,10,0,5,68,83
2003,Central African Rep.,CAF,Dem. Rep. of the Congo,COD,5,0,16,5,26
2003,Chad,TCD,Dem. Rep. of the Congo,COD,0,0,0,5,5
2003,Congo,COG,Dem. Rep. of the Congo,COD,0,0,49,50,99
2003,Cote d'Ivoire,CIV,Dem. Rep. of the Congo,COD,0,0,5,0,5
2003,Liberia,LBR,Dem. Rep. of the Congo,COD,0,0,27,44,71
2003,Rwanda,RWA,Dem. Rep. of the Congo,COD,5,0,0,73,78
2003,Sierra Leone,SLE,Dem. Rep. of the Congo,COD,0,0,5,20,25
2003,Somalia,SOM,Dem. Rep. of the Congo,COD,0,0,0,5,5
2003,Sudan,SDN,Dem. Rep. of the Congo,COD,5,0,5,0,10
2003,Uganda,UGA,Dem. Rep. of the Congo,COD,0,0,5,0,5
2003,Cote d'Ivoire,CIV,Mauritania,MRT,10,0,0,0,10
2003,Liberia,LBR,Mauritania,MRT,65,0,0,0,65
2003,Sierra Leone,SLE,Mauritania,MRT,11,0,5,0,16
2003,Ethiopia,ETH,Somalia,SOM,74,0,155,105,334
2003,Eritrea,ERI,Sudan,SDN,28,0,0,23442,23470
2003,Ethiopia,ETH,Sudan,SDN,16,0,33,0,49
2003,Afghanistan,AFG,Syrian Arab Rep.,SYR,0,0,5,0,5
2003,Algeria,DZA,Syrian Arab Rep.,SYR,0,0,10,0,10
2003,Chad,TCD,Syrian Arab Rep.,SYR,0,0,5,0,5
2003,Iran (Islamic Rep. of),IRN,Syrian Arab Rep.,SYR,0,0,44,5,49
2003,Iraq,IRQ,Syrian Arab Rep.,SYR,54,0,576,38,668
2003,Jordan,JOR,Syrian Arab Rep.,SYR,0,0,5,0,5
2003,Somalia,SOM,Syrian Arab Rep.,SYR,30,0,79,5,114
2003,Sudan,SDN,Syrian Arab Rep.,SYR,40,0,115,5,160
2003,Turkey,TUR,Syrian Arab Rep.,SYR,0,0,10,0,10
2003,Stateless,XXA,Syrian Arab Rep.,SYR,5,0,0,0,5
2003,Unknown ,,Syrian Arab Rep.,SYR,0,0,5,0,5
2003,Algeria,DZA,Tunisia,TUN,0,0,0,43,43
2003,Cote d'Ivoire,CIV,Tunisia,TUN,5,0,0,14,19
2003,Iraq,IRQ,Tunisia,TUN,0,0,0,5,5
2004,Myanmar,MMR,Bangladesh,BGD,0,0,10,5,15
2004,Chad,TCD,Congo,COG,5,0,0,0,5
2004,Dem. Rep. of the Congo,COD,Congo,COG,47,0,238,0,285
2004,Cote d'Ivoire,CIV,Congo,COG,0,0,5,0,5
2004,Mauritania,MRT,Congo,COG,0,0,5,0,5
2004,Sudan,SDN,Congo,COG,0,0,5,0,5
2004,Unknown ,,Congo,COG,0,0,5,0,5
2004,Ethiopia,ETH,Somalia,SOM,5,0,28,0,33
2004,Algeria,DZA,Tunisia,TUN,0,0,0,38,38
2004,Dem. Rep. of the Congo,COD,Tunisia,TUN,0,0,0,5,5
2004,Cote d'Ivoire,CIV,Tunisia,TUN,0,0,0,11,11
2004,Iraq,IRQ,Tunisia,TUN,0,0,0,10,10
2004,Sierra Leone,SLE,Tunisia,TUN,0,0,0,5,5
2005,Angola,AGO,Congo,COG,0,0,10,0,10
2005,Burundi,BDI,Congo,COG,0,0,10,0,10
2005,Central African Rep.,CAF,Congo,COG,0,0,16,0,16
2005,Chad,TCD,Congo,COG,0,0,18,0,18
2005,Dem. Rep. of the Congo,COD,Congo,COG,28,0,152,0,180
2005,Cote d'Ivoire,CIV,Congo,COG,0,0,42,0,42
2005,Liberia,LBR,Congo,COG,0,0,14,0,14
2005,Mauritania,MRT,Congo,COG,0,0,30,0,30
2005,Sierra Leone,SLE,Congo,COG,0,0,13,0,13
2005,Unknown ,,Congo,COG,5,0,15,0,20
2005,Dem. Rep. of the Congo,COD,Somalia,SOM,5,0,0,0,5
2005,Eritrea,ERI,Somalia,SOM,5,0,0,0,5
2005,Ethiopia,ETH,Somalia,SOM,42,0,169,247,458
2005,Sudan,SDN,Somalia,SOM,0,0,5,0,5
2005,Unknown ,,Somalia,SOM,0,0,0,10,10
2006,Ethiopia,ETH,Somalia,SOM,112,0,149,0,261
2007,Ethiopia,ETH,Somalia,SOM,173,0,277,165,615
2013,Central African Rep.,CAF,South Sudan,SSD,0,0,0,5,5
2013,Dem. Rep. of the Congo,COD,South Sudan,SSD,0,0,0,5,5
2013,Eritrea,ERI,South Sudan,SSD,0,0,0,5,5
2013,Ethiopia,ETH,South Sudan,SSD,5,0,0,5,10
2014,Congo,COG,South Sudan,SSD,0,0,0,10,10
2014,Ethiopia,ETH,South Sudan,SSD,0,0,0,5,5
2014,Rwanda,RWA,South Sudan,SSD,0,0,0,5,5
2015,Burundi,BDI,South Sudan,SSD,0,0,0,5,5
2015,Central African Rep.,CAF,South Sudan,SSD,0,0,0,5,5
2015,Dem. Rep. of the Congo,COD,South Sudan,SSD,0,0,0,5,5
2015,Eritrea,ERI,South Sudan,SSD,13,0,0,10,23
2015,Ethiopia,ETH,South Sudan,SSD,16,0,5,10,31
2015,Somalia,SOM,South Sudan,SSD,0,0,0,12,12
2015,Sudan,SDN,South Sudan,SSD,0,0,0,5,5
2016,Cuba,CUB,Haiti,HTI,0,0,0,5,5
2016,Ethiopia,ETH,Haiti,HTI,5,0,0,0,5
2018,Yemen,YEM,Haiti,HTI,5,0,0,0,5
2000,Iraq,IRQ,Afghanistan,AFG,0,0,10,0,10
2000,Chad,TCD,Angola,AGO,5,0,5,0,10
2000,Congo,COG,Angola,AGO,5,0,5,0,10
2000,Dem. Rep. of the Congo,COD,Angola,AGO,35,0,49,0,84
2000,Rwanda,RWA,Angola,AGO,12,0,0,0,12
2000,Sierra Leone,SLE,Angola,AGO,5,0,5,0,10
2000,Afghanistan,AFG,Egypt,EGY,31,0,77,0,108
2000,Burundi,BDI,Egypt,EGY,5,0,15,0,20
2000,Central African Rep.,CAF,Egypt,EGY,0,0,5,0,5
2000,Chad,TCD,Egypt,EGY,0,0,5,0,5
2000,Congo,COG,Egypt,EGY,10,0,0,0,10
2000,Dem. Rep. of the Congo,COD,Egypt,EGY,5,0,5,0,10
2000,Djibouti,DJI,Egypt,EGY,5,0,10,0,15
2000,Eritrea,ERI,Egypt,EGY,10,0,65,0,75
2000,Ethiopia,ETH,Egypt,EGY,46,0,141,0,187
2000,Palestinian,PSE,Egypt,EGY,0,24,0,0,24
2000,Iraq,IRQ,Egypt,EGY,19,0,22,0,41
2000,Liberia,LBR,Egypt,EGY,0,0,17,0,17
2000,Libya,LBY,Egypt,EGY,5,0,5,0,10
2000,Rwanda,RWA,Egypt,EGY,0,0,10,0,10
2000,Sierra Leone,SLE,Egypt,EGY,5,0,5,0,10
2000,Somalia,SOM,Egypt,EGY,467,10,380,0,857
2000,Sudan,SDN,Egypt,EGY,2742,14,4395,0,7151
2000,Syrian Arab Rep.,SYR,Egypt,EGY,0,0,5,0,5
2000,Ukraine,UKR,Egypt,EGY,0,0,5,0,5
2000,Yemen,YEM,Egypt,EGY,29,0,28,0,57
2000,Afghanistan,AFG,Azerbaijan,AZE,239,0,24,12,275
2000,Iran (Islamic Rep. of),IRN,Azerbaijan,AZE,27,0,46,38,111
2000,Iraq,IRQ,Azerbaijan,AZE,16,0,5,11,32
2000,Russian Federation,RUS,Azerbaijan,AZE,64,0,0,0,64
2000,Syrian Arab Rep.,SYR,Azerbaijan,AZE,0,0,0,5,5
2000,Ukraine,UKR,Azerbaijan,AZE,0,0,5,0,5
2000,Iraq,IRQ,Bangladesh,BGD,0,0,5,0,5
2000,Myanmar,MMR,Bangladesh,BGD,10,0,0,19,29
2000,Sierra Leone,SLE,Bangladesh,BGD,5,0,0,0,5
2000,Cuba,CUB,Bahamas,BHS,0,0,328,0,328
2000,Haiti,HTI,Bahamas,BHS,0,0,10,0,10
2000,Bangladesh,BGD,Bosnia and Herzegovina,BIH,0,0,0,18,18
2000,Iran (Islamic Rep. of),IRN,Bosnia and Herzegovina,BIH,13,0,10,127,150
2000,Iraq,IRQ,Bosnia and Herzegovina,BIH,10,0,0,5,15
2000,Sri Lanka,LKA,Bosnia and Herzegovina,BIH,0,0,0,10,10
2000,Pakistan,PAK,Bosnia and Herzegovina,BIH,0,0,0,5,5
2000,Turkey,TUR,Bosnia and Herzegovina,BIH,0,0,0,5,5
2000,China,CHN,Cambodia,KHM,5,0,0,0,5
2000,Iraq,IRQ,Cambodia,KHM,5,0,0,5,10
2000,Sri Lanka,LKA,Cambodia,KHM,0,0,0,5,5
2000,Pakistan,PAK,Cambodia,KHM,0,0,5,0,5
2000,Viet Nam,VNM,Cambodia,KHM,5,0,48,11,64
2000,Congo,COG,Chad,TCD,0,0,5,0,5
2000,Dem. Rep. of the Congo,COD,Chad,TCD,90,0,25,0,115
2000,Rwanda,RWA,Chad,TCD,5,0,5,0,10
2000,Sudan,SDN,Chad,TCD,49,0,68,0,117
2000,Afghanistan,AFG,China,CHN,5,0,0,0,5
2000,Burundi,BDI,China,CHN,0,0,5,0,5
2000,Congo,COG,China,CHN,0,0,5,0,5
2000,Iraq,IRQ,China,CHN,0,0,0,5,5
2000,Rwanda,RWA,China,CHN,0,0,16,0,16
2000,Somalia,SOM,China,CHN,0,5,0,0,5
2000,Burundi,BDI,Cameroon,CMR,5,0,0,0,5
2000,Chad,TCD,Cameroon,CMR,0,0,49,5,54
2000,Congo,COG,Cameroon,CMR,5,0,35,0,40
2000,Dem. Rep. of the Congo,COD,Cameroon,CMR,5,0,142,0,147
2000,Rwanda,RWA,Cameroon,CMR,11,0,27,0,38
2000,Unknown ,,Cameroon,CMR,5,0,23,0,28
2000,Afghanistan,AFG,Cuba,CUB,18,0,0,0,18
2000,Eritrea,ERI,Cuba,CUB,5,0,0,0,5
2000,Ethiopia,ETH,Cuba,CUB,23,0,0,0,23
2000,Iran (Islamic Rep. of),IRN,Cuba,CUB,17,0,5,0,22
2000,Iraq,IRQ,Cuba,CUB,0,0,10,0,10
2000,Pakistan,PAK,Cuba,CUB,0,0,12,0,12
2000,Syrian Arab Rep.,SYR,Cuba,CUB,5,0,0,0,5
2000,Afghanistan,AFG,Cyprus,CYP,0,0,5,0,5
2000,Bangladesh,BGD,Cyprus,CYP,0,0,5,0,5
2000,Cuba,CUB,Cyprus,CYP,0,0,5,0,5
2000,Palestinian,PSE,Cyprus,CYP,5,0,0,0,5
2000,Iran (Islamic Rep. of),IRN,Cyprus,CYP,11,0,52,34,97
2000,Iraq,IRQ,Cyprus,CYP,13,0,17,0,30
2000,Lebanon,LBN,Cyprus,CYP,0,0,5,5,10
2000,Sri Lanka,LKA,Cyprus,CYP,5,0,10,0,15
2000,Pakistan,PAK,Cyprus,CYP,0,0,5,0,5
2000,Russian Federation,RUS,Cyprus,CYP,0,0,5,0,5
2000,Serbia and Kosovo: S/RES/1244 (1999),SRB,Cyprus,CYP,0,0,81,25,106
2000,Sierra Leone,SLE,Cyprus,CYP,5,0,5,0,10
2000,Sudan,SDN,Cyprus,CYP,0,0,5,0,5
2000,Syrian Arab Rep.,SYR,Cyprus,CYP,0,0,10,26,36
2000,Turkey,TUR,Cyprus,CYP,0,0,5,0,5
2000,Colombia,COL,Ecuador,ECU,560,698,234,0,1492
2000,Cuba,CUB,Ecuador,ECU,5,0,0,0,5
2000,Iran (Islamic Rep. of),IRN,Ecuador,ECU,5,0,0,0,5
2000,Peru,PER,Ecuador,ECU,5,0,5,0,10
2000,Somalia,SOM,Eritrea,ERI,0,171,0,0,171
2000,Sudan,SDN,Eritrea,ERI,0,211,0,0,211
2000,Senegal,SEN,Gabon,GAB,0,0,0,5,5
2000,Sierra Leone,SLE,Gambia,GMB,458,0,0,0,458
2000,Liberia,LBR,Guinea-Bissau,GNB,5,0,0,0,5
2000,Sierra Leone,SLE,Guinea-Bissau,GNB,116,0,10,0,126
2000,Unknown ,,Guinea-Bissau,GNB,0,0,0,5,5
2000,Colombia,COL,Guatemala,GTM,5,0,0,0,5
2000,Nicaragua,NIC,Guatemala,GTM,0,5,5,0,10
2000,Russian Federation,RUS,Guatemala,GTM,5,0,5,0,10
2000,El Salvador,SLV,Guatemala,GTM,10,0,5,0,15
2000,Unknown ,,Guatemala,GTM,0,0,5,0,5
2000,Pakistan,PAK,"China, Hong Kong SAR",HKG,0,0,11,0,11
2000,Afghanistan,AFG,India,IND,154,0,178,0,332
2000,Belarus,BLR,India,IND,0,0,5,0,5
2000,Eritrea,ERI,India,IND,0,0,5,0,5
2000,Ethiopia,ETH,India,IND,10,0,0,5,15
2000,Iran (Islamic Rep. of),IRN,India,IND,10,0,11,0,21
2000,Iraq,IRQ,India,IND,10,0,0,0,10
2000,Myanmar,MMR,India,IND,172,0,105,15,292
2000,Rwanda,RWA,India,IND,5,0,5,0,10
2000,Somalia,SOM,India,IND,10,0,5,0,15
2000,Sudan,SDN,India,IND,23,0,44,0,67
2000,Afghanistan,AFG,Indonesia,IDN,29,0,12,49,90
2000,Palestinian,PSE,Indonesia,IDN,5,0,0,0,5
2000,Iran (Islamic Rep. of),IRN,Indonesia,IDN,5,0,38,43,86
2000,Iraq,IRQ,Indonesia,IDN,379,0,17,85,481
2000,Somalia,SOM,Indonesia,IDN,5,0,0,5,10
2000,Iran (Islamic Rep. of),IRN,Iraq,IRQ,295,0,111,169,575
2000,Syrian Arab Rep.,SYR,Iraq,IRQ,49,0,0,0,49
2000,Congo,COG,Israel,ISR,5,0,0,5,10
2000,Eritrea,ERI,Israel,ISR,0,0,5,11,16
2000,Ethiopia,ETH,Israel,ISR,0,0,5,20,25
2000,Lebanon,LBN,Israel,ISR,0,5895,0,0,5895
2000,Russian Federation,RUS,Israel,ISR,0,90,5,0,95
2000,Sierra Leone,SLE,Israel,ISR,0,13,0,26,39
2000,Cuba,CUB,Jamaica,JAM,0,0,15,0,15
2000,Afghanistan,AFG,Jordan,JOR,0,0,5,0,5
2000,Egypt,EGY,Jordan,JOR,0,0,19,10,29
2000,Dem. Rep. of the Congo,COD,Jordan,JOR,0,0,5,0,5
2000,Eritrea,ERI,Jordan,JOR,0,0,5,0,5
2000,Ethiopia,ETH,Jordan,JOR,0,0,0,10,10
2000,Iraq,IRQ,Jordan,JOR,1790,0,2911,5568,10269
2000,Libya,LBY,Jordan,JOR,0,0,5,0,5
2000,Netherlands,NLD,Jordan,JOR,0,0,0,5,5
2000,Russian Federation,RUS,Jordan,JOR,83,0,40,5,128
2000,Somalia,SOM,Jordan,JOR,10,0,0,0,10
2000,Sudan,SDN,Jordan,JOR,10,0,151,120,281
2000,Syrian Arab Rep.,SYR,Jordan,JOR,0,0,65,26,91
2000,Yemen,YEM,Jordan,JOR,0,0,10,0,10
2000,Stateless,XXA,Jordan,JOR,14,0,5,10,29
2000,China,CHN,Kazakhstan,KAZ,5,0,5,0,10
2000,Burundi,BDI,Kenya,KEN,50,0,105,5,160
2000,Dem. Rep. of the Congo,COD,Kenya,KEN,98,0,241,10,349
2000,Eritrea,ERI,Kenya,KEN,163,0,245,10,418
2000,Ethiopia,ETH,Kenya,KEN,2024,0,1923,171,4118
2000,Rwanda,RWA,Kenya,KEN,72,0,366,5,443
2000,Sierra Leone,SLE,Kenya,KEN,0,0,5,0,5
2000,Somalia,SOM,Kenya,KEN,10,0,0,5,15
2000,Sudan,SDN,Kenya,KEN,39,0,19,11,69
2000,Uganda,UGA,Kenya,KEN,5,0,47,10,62
2000,Unknown ,,Kenya,KEN,0,0,5,0,5
2000,Afghanistan,AFG,Kuwait,KWT,32,0,97,0,129
2000,Palestinian,PSE,Kuwait,KWT,95,0,0,0,95
2000,Iraq,IRQ,Kuwait,KWT,157,0,80,5,242
2000,Somalia,SOM,Kuwait,KWT,50,0,99,0,149
2000,Unknown ,,Kuwait,KWT,36,0,47,0,83
2000,Dem. Rep. of the Congo,COD,Libya,LBY,0,0,0,5,5
2000,Iraq,IRQ,Libya,LBY,10,0,0,0,10
2000,Sierra Leone,SLE,Libya,LBY,100,0,0,31,131
2000,Afghanistan,AFG,Lebanon,LBN,5,0,12,0,17
2000,Algeria,DZA,Lebanon,LBN,0,0,20,24,44
2000,Ethiopia,ETH,Lebanon,LBN,0,0,12,200,212
2000,Iraq,IRQ,Lebanon,LBN,463,0,543,69,1075
2000,Jordan,JOR,Lebanon,LBN,5,0,5,5,15
2000,Sierra Leone,SLE,Lebanon,LBN,17,0,23,0,40
2000,Somalia,SOM,Lebanon,LBN,5,0,37,17,59
2000,Sudan,SDN,Lebanon,LBN,247,0,1173,70,1490
2000,Unknown ,,Lebanon,LBN,24,0,91,14,129
2000,Iraq,IRQ,Sri Lanka,LKA,5,0,5,0,10
2000,Pakistan,PAK,Sri Lanka,LKA,0,0,5,0,5
2000,Congo,COG,Mauritania,MRT,5,0,5,0,10
2000,Dem. Rep. of the Congo,COD,Mauritania,MRT,10,0,5,0,15
2000,Guinea,GIN,Mauritania,MRT,5,0,0,0,5
2000,Liberia,LBR,Mauritania,MRT,20,0,0,0,20
2000,Sierra Leone,SLE,Mauritania,MRT,95,0,15,0,110
2000,Afghanistan,AFG,Rep. of Moldova,MDA,0,0,0,35,35
2000,Georgia,GEO,Rep. of Moldova,MDA,0,0,0,5,5
2000,Iraq,IRQ,Rep. of Moldova,MDA,5,0,0,61,66
2000,Nigeria,NGA,Rep. of Moldova,MDA,0,0,0,5,5
2000,Russian Federation,RUS,Rep. of Moldova,MDA,51,0,0,102,153
2000,Somalia,SOM,Rep. of Moldova,MDA,0,0,0,10,10
2000,Sudan,SDN,Rep. of Moldova,MDA,0,0,11,46,57
2000,Algeria,DZA,Mexico,MEX,0,0,5,0,5
2000,Armenia,ARM,Mexico,MEX,0,0,10,0,10
2000,Chile,CHL,Mexico,MEX,0,0,0,5,5
2000,Colombia,COL,Mexico,MEX,10,0,10,5,25
2000,Cuba,CUB,Mexico,MEX,5,0,13,0,18
2000,Guatemala,GTM,Mexico,MEX,10,0,12,0,22
2000,Iran (Islamic Rep. of),IRN,Mexico,MEX,12,0,0,5,17
2000,Iraq,IRQ,Mexico,MEX,5,0,16,5,26
2000,Liberia,LBR,Mexico,MEX,0,0,5,0,5
2000,Sri Lanka,LKA,Mexico,MEX,5,0,10,5,20
2000,Nicaragua,NIC,Mexico,MEX,0,0,5,0,5
2000,Peru,PER,Mexico,MEX,0,0,5,0,5
2000,Russian Federation,RUS,Mexico,MEX,0,0,5,0,5
2000,Serbia and Kosovo: S/RES/1244 (1999),SRB,Mexico,MEX,5,0,0,0,5
2000,Sierra Leone,SLE,Mexico,MEX,5,0,12,0,17
2000,Somalia,SOM,Mexico,MEX,13,0,5,0,18
2000,Ukraine,UKR,Mexico,MEX,0,0,5,0,5
2000,United States of America,USA,Mexico,MEX,0,0,5,0,5
2000,Venezuela (Bolivarian Republic of),VEN,Mexico,MEX,0,0,18,0,18
2000,Afghanistan,AFG,Malaysia,MYS,23,5,79,20,127
2000,China,CHN,Malaysia,MYS,0,0,5,0,5
2000,Dem. Rep. of the Congo,COD,Malaysia,MYS,0,0,5,0,5
2000,Indonesia,IDN,Malaysia,MYS,71,13,12,0,96
2000,Iran (Islamic Rep. of),IRN,Malaysia,MYS,5,0,14,0,19
2000,Iraq,IRQ,Malaysia,MYS,10,0,38,21,69
2000,Liberia,LBR,Malaysia,MYS,0,0,5,0,5
2000,Sri Lanka,LKA,Malaysia,MYS,0,0,18,0,18
2000,Myanmar,MMR,Malaysia,MYS,5,0,70,5,80
2000,Pakistan,PAK,Malaysia,MYS,0,0,5,5,10
2000,Romania,ROU,Malaysia,MYS,0,0,5,0,5
2000,Somalia,SOM,Malaysia,MYS,0,0,5,5,10
2000,Congo,COG,Niger,NER,5,0,0,0,5
2000,Dem. Rep. of the Congo,COD,Niger,NER,5,0,0,0,5
2000,Iran (Islamic Rep. of),IRN,Pakistan,PAK,195,0,213,0,408
2000,Iraq,IRQ,Pakistan,PAK,59,0,82,0,141
2000,Somalia,SOM,Pakistan,PAK,127,0,31,0,158
2000,Cuba,CUB,Peru,PER,0,0,5,0,5
2000,Iraq,IRQ,Qatar,QAT,5,0,19,0,24
2000,Somalia,SOM,Qatar,QAT,0,15,0,0,15
2000,Syrian Arab Rep.,SYR,Qatar,QAT,5,0,0,0,5
2000,Unknown ,,Qatar,QAT,0,0,12,0,12
2000,Burundi,BDI,Rwanda,RWA,0,0,0,37,37
2000,Dem. Rep. of the Congo,COD,Rwanda,RWA,0,0,0,5,5
2000,Ethiopia,ETH,Saudi Arabia,SAU,0,0,5,24,29
2000,Iraq,IRQ,Saudi Arabia,SAU,10,0,28,20,58
2000,Somalia,SOM,Saudi Arabia,SAU,15,0,27,0,42
2000,Sudan,SDN,Saudi Arabia,SAU,0,0,22,17,39
2000,Syrian Arab Rep.,SYR,Saudi Arabia,SAU,5,0,0,11,16
2000,Unknown ,,Saudi Arabia,SAU,0,10,64,0,74
2000,Afghanistan,AFG,Serbia and Kosovo: S/RES/1244 (1999),SRB,0,0,5,0,5
2000,Bulgaria,BGR,Serbia and Kosovo: S/RES/1244 (1999),SRB,0,0,5,0,5
2000,Palestinian,PSE,Serbia and Kosovo: S/RES/1244 (1999),SRB,5,0,0,0,5
2000,Iraq,IRQ,Serbia and Kosovo: S/RES/1244 (1999),SRB,5,0,21,5,31
2000,Russian Federation,RUS,Serbia and Kosovo: S/RES/1244 (1999),SRB,0,0,0,5,5
2000,Iran (Islamic Rep. of),IRN,Singapore,SGP,0,0,5,0,5
2000,Sri Lanka,LKA,Singapore,SGP,0,0,5,0,5
2000,Pakistan,PAK,Singapore,SGP,0,0,0,5,5
2000,Ethiopia,ETH,Somalia,SOM,5,0,0,0,5
2000,Afghanistan,AFG,Thailand,THA,14,0,0,5,19
2000,Cambodia,KHM,Thailand,THA,25,5,31,17,78
2000,China,CHN,Thailand,THA,5,0,16,10,31
2000,Iran (Islamic Rep. of),IRN,Thailand,THA,10,0,12,12,34
2000,Iraq,IRQ,Thailand,THA,21,0,58,50,129
2000,Dem. People's Rep. of Korea,PRK,Thailand,THA,0,0,0,28,28
2000,Sri Lanka,LKA,Thailand,THA,10,0,15,14,39
2000,Myanmar,MMR,Thailand,THA,289,98,183,176,746
2000,Somalia,SOM,Thailand,THA,0,0,10,10,20
2000,Unknown ,,Thailand,THA,25,0,57,78,160
2000,Afghanistan,AFG,Turkmenistan,TKM,126,0,121,210,457
2000,Azerbaijan,AZE,Turkmenistan,TKM,5,0,0,33,38
2000,Iran (Islamic Rep. of),IRN,Turkmenistan,TKM,0,0,0,5,5
2000,Iraq,IRQ,Turkmenistan,TKM,11,0,0,0,11
2000,Russian Federation,RUS,Turkmenistan,TKM,5,0,0,11,16
2000,Tajikistan,TJK,Turkmenistan,TKM,0,0,0,71,71
2000,Burundi,BDI,Togo,TGO,5,0,0,13,18
2000,Congo,COG,Togo,TGO,33,0,0,5,38
2000,Rwanda,RWA,Togo,TGO,102,0,12,41,155
2000,Unknown ,,Togo,TGO,0,0,0,5,5
2000,Afghanistan,AFG,Turkey,TUR,29,0,24,49,102
2000,Algeria,DZA,Turkey,TUR,0,0,0,5,5
2000,China,CHN,Turkey,TUR,11,0,5,0,16
2000,Eritrea,ERI,Turkey,TUR,0,0,10,5,15
2000,Ethiopia,ETH,Turkey,TUR,0,0,10,18,28
2000,Palestinian,PSE,Turkey,TUR,5,0,5,5,15
2000,Iran (Islamic Rep. of),IRN,Turkey,TUR,2197,0,774,528,3499
2000,Iraq,IRQ,Turkey,TUR,454,0,865,563,1882
2000,Pakistan,PAK,Turkey,TUR,0,0,0,5,5
2000,Sierra Leone,SLE,Turkey,TUR,0,0,5,0,5
2000,Somalia,SOM,Turkey,TUR,5,0,0,5,10
2000,Sudan,SDN,Turkey,TUR,0,0,0,5,5
2000,Uzbekistan,UZB,Turkey,TUR,5,0,0,0,5
2000,Afghanistan,AFG,United Arab Emirates,ARE,5,0,10,0,15
2000,Algeria,DZA,United Arab Emirates,ARE,0,0,5,0,5
2000,Palestinian,PSE,United Arab Emirates,ARE,14,0,0,0,14
2000,Iran (Islamic Rep. of),IRN,United Arab Emirates,ARE,0,0,16,0,16
2000,Iraq,IRQ,United Arab Emirates,ARE,10,0,40,0,50
2000,Libya,LBY,United Arab Emirates,ARE,0,0,10,0,10
2000,Somalia,SOM,United Arab Emirates,ARE,10,0,12,0,22
2000,Sudan,SDN,United Arab Emirates,ARE,0,0,17,0,17
2000,Syrian Arab Rep.,SYR,United Arab Emirates,ARE,43,0,27,0,70
2000,Tunisia,TUN,United Arab Emirates,ARE,0,0,5,0,5
2000,Colombia,COL,Uruguay,URY,0,0,0,5,5
2000,Afghanistan,AFG,Uzbekistan,UZB,747,0,112,327,1186
2000,Azerbaijan,AZE,Uzbekistan,UZB,0,0,5,0,5
2000,Tajikistan,TJK,Uzbekistan,UZB,0,0,5,0,5
2000,Algeria,DZA,Yemen,YEM,0,0,0,21,21
2000,Eritrea,ERI,Yemen,YEM,24,0,173,0,197
2000,Ethiopia,ETH,Yemen,YEM,14,0,24,0,38
2000,Iraq,IRQ,Yemen,YEM,18,0,135,10,163
2000,Sudan,SDN,Yemen,YEM,26,0,159,10,195
2001,Iran (Islamic Rep. of),IRN,Afghanistan,AFG,21,0,68,21,110
2001,Iraq,IRQ,Afghanistan,AFG,5,0,5,5,15
2001,Tajikistan,TJK,Afghanistan,AFG,0,0,5,0,5
2001,Congo,COG,Angola,AGO,0,0,12,0,12
2001,Dem. Rep. of the Congo,COD,Angola,AGO,24,0,58,5,87
2001,Rwanda,RWA,Angola,AGO,12,0,0,0,12
2001,Sierra Leone,SLE,Angola,AGO,0,0,21,0,21
2001,Afghanistan,AFG,Egypt,EGY,21,0,18,0,39
2001,Burundi,BDI,Egypt,EGY,14,0,10,0,24
2001,China,CHN,Egypt,EGY,0,0,5,0,5
2001,Dem. Rep. of the Congo,COD,Egypt,EGY,0,0,10,0,10
2001,Djibouti,DJI,Egypt,EGY,5,0,10,0,15
2001,Eritrea,ERI,Egypt,EGY,31,0,67,0,98
2001,Ethiopia,ETH,Egypt,EGY,89,0,166,0,255
2001,Palestinian,PSE,Egypt,EGY,0,63,0,0,63
2001,Iraq,IRQ,Egypt,EGY,15,0,14,0,29
2001,Jordan,JOR,Egypt,EGY,0,0,5,0,5
2001,Kuwait,KWT,Egypt,EGY,10,0,0,0,10
2001,Liberia,LBR,Egypt,EGY,10,0,0,0,10
2001,Libya,LBY,Egypt,EGY,5,0,0,0,5
2001,Rwanda,RWA,Egypt,EGY,5,0,5,0,10
2001,Sierra Leone,SLE,Egypt,EGY,17,0,0,0,17
2001,Somalia,SOM,Egypt,EGY,506,0,594,0,1100
2001,Sudan,SDN,Egypt,EGY,3400,0,3563,0,6963
2001,Syrian Arab Rep.,SYR,Egypt,EGY,0,0,5,0,5
2001,Yemen,YEM,Egypt,EGY,5,0,21,0,26
2001,Afghanistan,AFG,Azerbaijan,AZE,226,0,45,0,271
2001,Palestinian,PSE,Azerbaijan,AZE,5,0,0,0,5
2001,Iran (Islamic Rep. of),IRN,Azerbaijan,AZE,21,0,11,0,32
2001,Iraq,IRQ,Azerbaijan,AZE,18,0,10,0,28
2001,Russian Federation,RUS,Azerbaijan,AZE,23,0,0,0,23
2001,Iraq,IRQ,Bahrain,BHR,0,0,0,5,5
2001,Zimbabwe,ZWE,Bahrain,BHR,0,0,5,0,5
2001,Myanmar,MMR,Bangladesh,BGD,5,0,0,0,5
2001,Bangladesh,BGD,Bosnia and Herzegovina,BIH,0,0,0,11,11
2001,China,CHN,Bosnia and Herzegovina,BIH,0,0,0,30,30
2001,India,IND,Bosnia and Herzegovina,BIH,0,0,0,5,5
2001,Iran (Islamic Rep. of),IRN,Bosnia and Herzegovina,BIH,21,0,52,81,154
2001,Iraq,IRQ,Bosnia and Herzegovina,BIH,10,0,10,24,44
2001,North Macedonia,MKD,Bosnia and Herzegovina,BIH,0,0,0,13,13
2001,Pakistan,PAK,Bosnia and Herzegovina,BIH,0,0,0,28,28
2001,Romania,ROU,Bosnia and Herzegovina,BIH,0,0,0,5,5
2001,Sierra Leone,SLE,Bosnia and Herzegovina,BIH,0,0,0,5,5
2001,Turkey,TUR,Bosnia and Herzegovina,BIH,5,0,12,94,111
2001,Afghanistan,AFG,Cambodia,KHM,13,0,0,19,32
2001,China,CHN,Cambodia,KHM,5,0,5,5,15
2001,Palestinian,PSE,Cambodia,KHM,0,0,5,0,5
2001,Iraq,IRQ,Cambodia,KHM,0,0,5,0,5
2001,Pakistan,PAK,Cambodia,KHM,0,0,0,10,10
2001,Viet Nam,VNM,Cambodia,KHM,42,0,28,36,106
2001,Sudan,SDN,Cambodia,KHM,0,0,0,5,5
2001,Congo,COG,China,CHN,0,0,0,5,5
2001,Dem. Rep. of the Congo,COD,China,CHN,0,0,5,0,5
2001,Burundi,BDI,Cameroon,CMR,20,0,0,0,20
2001,Central African Rep.,CAF,Cameroon,CMR,348,0,0,0,348
2001,Chad,TCD,Cameroon,CMR,21,0,35,0,56
2001,Congo,COG,Cameroon,CMR,26,0,5,0,31
2001,Dem. Rep. of the Congo,COD,Cameroon,CMR,102,0,44,0,146
2001,Liberia,LBR,Cameroon,CMR,0,0,10,0,10
2001,Rwanda,RWA,Cameroon,CMR,103,0,26,0,129
2001,Unknown ,,Cameroon,CMR,10,0,21,0,31
2001,Afghanistan,AFG,Cuba,CUB,5,0,10,0,15
2001,Algeria,DZA,Cuba,CUB,0,0,0,5,5
2001,Colombia,COL,Cuba,CUB,0,0,5,0,5
2001,Ethiopia,ETH,Cuba,CUB,12,0,10,0,22
2001,Palestinian,PSE,Cuba,CUB,5,0,0,0,5
2001,Iran (Islamic Rep. of),IRN,Cuba,CUB,0,0,11,0,11
2001,Iraq,IRQ,Cuba,CUB,5,0,10,0,15
2001,Sierra Leone,SLE,Cuba,CUB,0,0,5,0,5
2001,Sudan,SDN,Cuba,CUB,0,0,5,0,5
2001,Egypt,EGY,Cyprus,CYP,0,0,5,0,5
2001,Bulgaria,BGR,Cyprus,CYP,0,0,5,0,5
2001,Palestinian,PSE,Cyprus,CYP,0,0,0,5,5
2001,Iran (Islamic Rep. of),IRN,Cyprus,CYP,20,0,130,20,170
2001,Iraq,IRQ,Cyprus,CYP,10,0,0,0,10
2001,Jordan,JOR,Cyprus,CYP,0,0,5,0,5
2001,Lebanon,LBN,Cyprus,CYP,5,0,10,5,20
2001,Sri Lanka,LKA,Cyprus,CYP,0,0,10,0,10
2001,Russian Federation,RUS,Cyprus,CYP,0,0,10,0,10
2001,Serbia and Kosovo: S/RES/1244 (1999),SRB,Cyprus,CYP,0,0,77,40,117
2001,Sierra Leone,SLE,Cyprus,CYP,0,0,5,0,5
2001,Sudan,SDN,Cyprus,CYP,0,0,5,0,5
2001,Syrian Arab Rep.,SYR,Cyprus,CYP,0,0,24,0,24
2001,Turkey,TUR,Cyprus,CYP,0,0,0,5,5
2001,Ukraine,UKR,Cyprus,CYP,0,0,5,0,5
2001,Sudan,SDN,Gabon,GAB,0,0,0,5,5
2001,Colombia,COL,Guatemala,GTM,5,0,11,5,21
2001,India,IND,Guatemala,GTM,0,0,0,10,10
2001,Sri Lanka,LKA,Guatemala,GTM,10,0,0,0,10
2001,El Salvador,SLV,Guatemala,GTM,0,0,14,0,14
2001,Sierra Leone,SLE,Guatemala,GTM,0,0,5,0,5
2001,India,IND,"China, Hong Kong SAR",HKG,0,0,5,0,5
2001,Iran (Islamic Rep. of),IRN,"China, Hong Kong SAR",HKG,5,0,0,0,5
2001,Iraq,IRQ,"China, Hong Kong SAR",HKG,5,0,0,0,5
2001,Liberia,LBR,"China, Hong Kong SAR",HKG,0,0,5,0,5
2001,Sri Lanka,LKA,"China, Hong Kong SAR",HKG,10,0,10,19,39
2001,Pakistan,PAK,"China, Hong Kong SAR",HKG,10,0,55,56,121
2001,Sierra Leone,SLE,"China, Hong Kong SAR",HKG,0,5,0,0,5
2001,Sudan,SDN,"China, Hong Kong SAR",HKG,10,0,0,0,10
2001,Afghanistan,AFG,Croatia,HRV,0,0,0,11,11
2001,Congo,COG,Croatia,HRV,0,0,0,5,5
2001,Iran (Islamic Rep. of),IRN,Croatia,HRV,0,0,0,27,27
2001,Iraq,IRQ,Croatia,HRV,0,0,0,10,10
2001,Rep. of Moldova,MDA,Croatia,HRV,0,0,0,5,5
2001,Pakistan,PAK,Croatia,HRV,0,0,0,5,5
2001,Sierra Leone,SLE,Croatia,HRV,0,0,0,5,5
2001,Somalia,SOM,Croatia,HRV,0,0,0,5,5
2001,Afghanistan,AFG,India,IND,340,0,53,0,393
2001,Bangladesh,BGD,India,IND,0,0,5,0,5
2001,Cuba,CUB,India,IND,5,0,0,0,5
2001,Ethiopia,ETH,India,IND,5,0,5,0,10
2001,Iran (Islamic Rep. of),IRN,India,IND,24,0,13,0,37
2001,Iraq,IRQ,India,IND,5,0,5,0,10
2001,Israel,ISR,India,IND,0,0,5,0,5
2001,Myanmar,MMR,India,IND,130,0,81,0,211
2001,Nigeria,NGA,India,IND,0,0,5,0,5
2001,Russian Federation,RUS,India,IND,5,0,5,0,10
2001,Somalia,SOM,India,IND,0,0,5,0,5
2001,Sudan,SDN,India,IND,30,0,35,0,65
2001,Afghanistan,AFG,Indonesia,IDN,12,0,14,324,350
2001,Iran (Islamic Rep. of),IRN,Indonesia,IDN,0,0,0,80,80
2001,Iraq,IRQ,Indonesia,IDN,122,0,10,252,384
2001,Liberia,LBR,Indonesia,IDN,0,0,0,5,5
2001,Sri Lanka,LKA,Indonesia,IDN,0,0,0,5,5
2001,Pakistan,PAK,Indonesia,IDN,0,0,0,21,21
2001,Rwanda,RWA,Indonesia,IDN,0,0,0,5,5
2001,Afghanistan,AFG,Iraq,IRQ,18,0,0,0,18
2001,Iran (Islamic Rep. of),IRN,Iraq,IRQ,304,0,260,389,953
2001,Syrian Arab Rep.,SYR,Iraq,IRQ,24,0,49,0,73
2001,Armenia,ARM,Israel,ISR,0,0,5,0,5
2001,Colombia,COL,Israel,ISR,5,0,0,0,5
2001,Eritrea,ERI,Israel,ISR,0,0,5,5,10
2001,Ethiopia,ETH,Israel,ISR,58,0,152,15,225
2001,Ghana,GHA,Israel,ISR,0,0,5,0,5
2001,Iran (Islamic Rep. of),IRN,Israel,ISR,5,0,0,0,5
2001,Liberia,LBR,Israel,ISR,5,0,0,0,5
2001,Russian Federation,RUS,Israel,ISR,0,0,5,0,5
2001,Serbia and Kosovo: S/RES/1244 (1999),SRB,Israel,ISR,0,0,5,0,5
2001,Sierra Leone,SLE,Israel,ISR,0,0,0,5,5
2001,Sudan,SDN,Israel,ISR,5,0,0,0,5
2001,Tajikistan,TJK,Israel,ISR,0,0,5,0,5
2001,Afghanistan,AFG,Jordan,JOR,0,0,0,5,5
2001,Algeria,DZA,Jordan,JOR,0,0,14,0,14
2001,Egypt,EGY,Jordan,JOR,0,0,41,0,41
2001,Bangladesh,BGD,Jordan,JOR,0,0,10,10,20
2001,Bosnia and Herzegovina,BIH,Jordan,JOR,0,0,0,22,22
2001,Eritrea,ERI,Jordan,JOR,0,0,10,0,10
2001,Ethiopia,ETH,Jordan,JOR,0,0,10,5,15
2001,Iraq,IRQ,Jordan,JOR,1879,0,2442,2413,6734
2001,Libya,LBY,Jordan,JOR,0,0,0,10,10
2001,Lebanon,LBN,Jordan,JOR,0,0,10,10,20
2001,Sri Lanka,LKA,Jordan,JOR,0,0,18,5,23
2001,Pakistan,PAK,Jordan,JOR,0,0,5,5,10
2001,Russian Federation,RUS,Jordan,JOR,10,0,0,21,31
2001,Somalia,SOM,Jordan,JOR,11,0,5,0,16
2001,Sudan,SDN,Jordan,JOR,5,0,88,13,106
2001,Syrian Arab Rep.,SYR,Jordan,JOR,0,0,12,29,41
2001,Yemen,YEM,Jordan,JOR,0,0,19,5,24
2001,Stateless,XXA,Jordan,JOR,19,0,0,0,19
2001,Afghanistan,AFG,Kazakhstan,KAZ,11,0,0,0,11
2001,China,CHN,Kazakhstan,KAZ,11,0,5,0,16
2001,Burundi,BDI,Kenya,KEN,124,0,52,19,195
2001,Dem. Rep. of the Congo,COD,Kenya,KEN,570,0,267,76,913
2001,Eritrea,ERI,Kenya,KEN,71,0,194,19,284
2001,Ethiopia,ETH,Kenya,KEN,2121,0,2433,352,4906
2001,Iraq,IRQ,Kenya,KEN,5,0,0,0,5
2001,Liberia,LBR,Kenya,KEN,5,0,0,0,5
2001,Rwanda,RWA,Kenya,KEN,172,0,373,0,545
2001,Somalia,SOM,Kenya,KEN,839,0,103,5,947
2001,Sudan,SDN,Kenya,KEN,30,0,0,142,172
2001,United Rep. of Tanzania,TZA,Kenya,KEN,0,0,5,0,5
2001,Uganda,UGA,Kenya,KEN,25,0,28,71,124
2001,Unknown ,,Kenya,KEN,0,0,0,15,15
2001,Afghanistan,AFG,Kuwait,KWT,5,0,0,5,10
2001,Egypt,EGY,Kuwait,KWT,0,0,5,0,5
2001,Dominican Rep.,DOM,Kuwait,KWT,0,0,5,0,5
2001,Eritrea,ERI,Kuwait,KWT,5,0,0,0,5
2001,Ethiopia,ETH,Kuwait,KWT,5,0,5,0,10
2001,Palestinian,PSE,Kuwait,KWT,25,0,0,0,25
2001,Iran (Islamic Rep. of),IRN,Kuwait,KWT,5,0,0,0,5
2001,Iraq,IRQ,Kuwait,KWT,57,0,76,5,138
2001,Nigeria,NGA,Kuwait,KWT,0,0,5,0,5
2001,Saudi Arabia,SAU,Kuwait,KWT,0,0,15,0,15
2001,Somalia,SOM,Kuwait,KWT,5,0,22,5,32
2001,Dem. Rep. of the Congo,COD,Libya,LBY,0,0,16,144,160
2001,Iraq,IRQ,Libya,LBY,5,0,0,14,19
2001,Sudan,SDN,Libya,LBY,0,0,0,16,16
2001,Unknown ,,Libya,LBY,0,0,0,14,14
2001,Afghanistan,AFG,Lebanon,LBN,15,0,0,0,15
2001,Algeria,DZA,Lebanon,LBN,0,0,17,10,27
2001,Egypt,EGY,Lebanon,LBN,0,0,47,10,57
2001,Burundi,BDI,Lebanon,LBN,0,0,5,5,10
2001,Dem. Rep. of the Congo,COD,Lebanon,LBN,0,0,5,0,5
2001,Eritrea,ERI,Lebanon,LBN,0,0,0,42,42
2001,Ethiopia,ETH,Lebanon,LBN,0,0,5,17,22
2001,Iran (Islamic Rep. of),IRN,Lebanon,LBN,10,0,5,0,15
2001,Iraq,IRQ,Lebanon,LBN,443,0,981,439,1863
2001,Jordan,JOR,Lebanon,LBN,5,0,10,0,15
2001,Liberia,LBR,Lebanon,LBN,0,0,5,10,15
2001,Nigeria,NGA,Lebanon,LBN,0,0,24,14,38
2001,Rwanda,RWA,Lebanon,LBN,0,0,12,0,12
2001,Sierra Leone,SLE,Lebanon,LBN,23,0,27,0,50
2001,Somalia,SOM,Lebanon,LBN,5,0,34,73,112
2001,Sudan,SDN,Lebanon,LBN,192,0,1315,661,2168
2001,Tunisia,TUN,Lebanon,LBN,5,0,11,0,16
2001,Turkey,TUR,Lebanon,LBN,5,0,0,17,22
2001,Yemen,YEM,Lebanon,LBN,5,0,10,13,28
2001,Unknown ,,Lebanon,LBN,10,0,31,65,106
2001,Iraq,IRQ,Sri Lanka,LKA,10,0,5,0,15
2001,Pakistan,PAK,Sri Lanka,LKA,0,0,0,5,5
2001,Congo,COG,Mauritania,MRT,0,0,0,5,5
2001,Dem. Rep. of the Congo,COD,Mauritania,MRT,0,0,5,10,15
2001,Guinea,GIN,Mauritania,MRT,0,0,0,5,5
2001,Cote d'Ivoire,CIV,Mauritania,MRT,5,0,0,0,5
2001,Liberia,LBR,Mauritania,MRT,0,0,13,0,13
2001,Sierra Leone,SLE,Mauritania,MRT,5,0,10,0,15
2001,Afghanistan,AFG,Rep. of Moldova,MDA,5,0,0,13,18
2001,Burkina Faso,BFA,Rep. of Moldova,MDA,0,0,5,5,10
2001,Eritrea,ERI,Rep. of Moldova,MDA,0,0,5,0,5
2001,Iraq,IRQ,Rep. of Moldova,MDA,10,0,19,23,52
2001,Kyrgyzstan,KGZ,Rep. of Moldova,MDA,10,0,0,0,10
2001,Nigeria,NGA,Rep. of Moldova,MDA,0,0,10,5,15
2001,Pakistan,PAK,Rep. of Moldova,MDA,0,0,5,0,5
2001,Russian Federation,RUS,Rep. of Moldova,MDA,116,0,0,15,131
2001,Sierra Leone,SLE,Rep. of Moldova,MDA,0,0,0,5,5
2001,Somalia,SOM,Rep. of Moldova,MDA,0,0,5,11,16
2001,Sudan,SDN,Rep. of Moldova,MDA,0,0,30,13,43
2001,Stateless,XXA,Rep. of Moldova,MDA,0,0,0,5,5
2001,Albania,ALB,Mexico,MEX,5,0,5,0,10
2001,Bangladesh,BGD,Mexico,MEX,0,0,5,5,10
2001,China,CHN,Mexico,MEX,0,0,10,26,36
2001,Chile,CHL,Mexico,MEX,0,0,5,0,5
2001,Colombia,COL,Mexico,MEX,30,0,15,10,55
2001,Cuba,CUB,Mexico,MEX,0,0,28,0,28
2001,Czechia,CZE,Mexico,MEX,0,0,5,0,5
2001,Eritrea,ERI,Mexico,MEX,5,0,0,0,5
2001,Ethiopia,ETH,Mexico,MEX,5,0,0,0,5
2001,Palestinian,PSE,Mexico,MEX,5,0,0,0,5
2001,Guatemala,GTM,Mexico,MEX,28,0,5,0,33
2001,Honduras,HND,Mexico,MEX,5,0,0,0,5
2001,India,IND,Mexico,MEX,0,0,11,21,32
2001,Iran (Islamic Rep. of),IRN,Mexico,MEX,5,0,5,5,15
2001,Iraq,IRQ,Mexico,MEX,0,0,5,10,15
2001,Sri Lanka,LKA,Mexico,MEX,18,0,10,0,28
2001,Myanmar,MMR,Mexico,MEX,0,0,5,0,5
2001,Nicaragua,NIC,Mexico,MEX,0,0,5,0,5
2001,Pakistan,PAK,Mexico,MEX,5,0,0,0,5
2001,Peru,PER,Mexico,MEX,0,0,5,0,5
2001,Romania,ROU,Mexico,MEX,0,0,5,10,15
2001,Russian Federation,RUS,Mexico,MEX,5,0,5,0,10
2001,Sierra Leone,SLE,Mexico,MEX,12,0,5,5,22
2001,Somalia,SOM,Mexico,MEX,12,0,0,0,12
2001,Sudan,SDN,Mexico,MEX,5,0,0,0,5
2001,Yemen,YEM,Mexico,MEX,0,0,10,5,15
2001,Afghanistan,AFG,Malaysia,MYS,27,0,25,16,68
2001,Indonesia,IDN,Malaysia,MYS,31,10,120,19,180
2001,Iran (Islamic Rep. of),IRN,Malaysia,MYS,0,0,14,13,27
2001,Iraq,IRQ,Malaysia,MYS,17,0,26,0,43
2001,Sri Lanka,LKA,Malaysia,MYS,0,0,5,0,5
2001,Myanmar,MMR,Malaysia,MYS,24,5,283,65,377
2001,Nigeria,NGA,Malaysia,MYS,0,0,5,0,5
2001,Pakistan,PAK,Malaysia,MYS,0,0,10,0,10
2001,Chad,TCD,Niger,NER,0,0,5,0,5
2001,Congo,COG,Niger,NER,5,0,5,0,10
2001,Dem. Rep. of the Congo,COD,Niger,NER,16,0,41,0,57
2001,Sierra Leone,SLE,Niger,NER,0,0,5,0,5
2001,Algeria,DZA,Pakistan,PAK,0,0,5,0,5
2001,Egypt,EGY,Pakistan,PAK,0,0,10,0,10
2001,Azerbaijan,AZE,Pakistan,PAK,0,0,5,0,5
2001,Iran (Islamic Rep. of),IRN,Pakistan,PAK,69,0,521,35,625
2001,Iraq,IRQ,Pakistan,PAK,38,0,190,5,233
2001,Libya,LBY,Pakistan,PAK,5,0,0,0,5
2001,Sri Lanka,LKA,Pakistan,PAK,0,0,5,0,5
2001,Russian Federation,RUS,Pakistan,PAK,0,0,5,0,5
2001,Rwanda,RWA,Pakistan,PAK,0,0,5,0,5
2001,Saudi Arabia,SAU,Pakistan,PAK,0,0,5,0,5
2001,Sierra Leone,SLE,Pakistan,PAK,0,0,5,0,5
2001,Somalia,SOM,Pakistan,PAK,39,0,290,0,329
2001,United Rep. of Tanzania,TZA,Pakistan,PAK,0,0,10,11,21
2001,Tunisia,TUN,Pakistan,PAK,0,0,5,0,5
2001,Cuba,CUB,Paraguay,PRY,0,0,0,5,5
2001,Afghanistan,AFG,Qatar,QAT,0,40,0,0,40
2001,Iraq,IRQ,Qatar,QAT,0,0,5,0,5
2001,Somalia,SOM,Qatar,QAT,0,0,13,0,13
2001,Sudan,SDN,Qatar,QAT,0,0,5,0,5
2001,Angola,AGO,Rwanda,RWA,14,0,0,0,14
2001,Burundi,BDI,Rwanda,RWA,165,0,0,0,165
2001,Chad,TCD,Rwanda,RWA,5,0,0,0,5
2001,Congo,COG,Rwanda,RWA,5,0,0,0,5
2001,Dem. Rep. of the Congo,COD,Rwanda,RWA,4600,0,0,0,4600
2001,Eritrea,ERI,Rwanda,RWA,5,0,0,0,5
2001,Ethiopia,ETH,Rwanda,RWA,12,0,0,0,12
2001,Somalia,SOM,Rwanda,RWA,15,0,0,0,15
2001,Colombia,COL,El Salvador,SLV,13,0,0,0,13
2001,Nigeria,NGA,El Salvador,SLV,0,0,5,0,5
2001,Afghanistan,AFG,Saudi Arabia,SAU,0,40,0,0,40
2001,Iraq,IRQ,Saudi Arabia,SAU,0,0,12,10,22
2001,Somalia,SOM,Saudi Arabia,SAU,5,0,82,11,98
2001,Sudan,SDN,Saudi Arabia,SAU,0,0,25,5,30
2001,Unknown ,,Saudi Arabia,SAU,0,0,28,19,47
2001,China,CHN,Singapore,SGP,19,0,0,0,19
2001,Sri Lanka,LKA,Singapore,SGP,0,0,5,0,5
2001,Liberia,LBR,Sierra Leone,SLE,721,0,150,132,1003
2001,Burundi,BDI,Somalia,SOM,5,0,0,0,5
2001,Dem. Rep. of the Congo,COD,Somalia,SOM,5,0,0,0,5
2001,Eritrea,ERI,Somalia,SOM,5,0,0,0,5
2001,Ethiopia,ETH,Somalia,SOM,20,0,100,0,120
2001,Sudan,SDN,Somalia,SOM,5,0,0,0,5
2001,Afghanistan,AFG,Turkmenistan,TKM,190,0,190,41,421
2001,Azerbaijan,AZE,Turkmenistan,TKM,13,0,0,13,26
2001,Russian Federation,RUS,Turkmenistan,TKM,5,0,0,0,5
2001,Tajikistan,TJK,Turkmenistan,TKM,0,0,0,276,276
2001,Central African Rep.,CAF,Togo,TGO,5,0,0,0,5
2001,Congo,COG,Togo,TGO,15,0,0,0,15
2001,Rwanda,RWA,Togo,TGO,0,0,31,0,31
2001,Afghanistan,AFG,Turkey,TUR,107,0,21,42,170
2001,Algeria,DZA,Turkey,TUR,0,0,0,5,5
2001,Egypt,EGY,Turkey,TUR,5,0,5,0,10
2001,China,CHN,Turkey,TUR,0,0,5,15,20
2001,Eritrea,ERI,Turkey,TUR,0,0,0,5,5
2001,Ethiopia,ETH,Turkey,TUR,0,0,0,5,5
2001,Palestinian,PSE,Turkey,TUR,0,0,0,5,5
2001,Iran (Islamic Rep. of),IRN,Turkey,TUR,2248,0,967,512,3727
2001,Iraq,IRQ,Turkey,TUR,455,0,1074,450,1979
2001,Jordan,JOR,Turkey,TUR,5,0,5,0,10
2001,Kazakhstan,KAZ,Turkey,TUR,0,0,5,0,5
2001,Libya,LBY,Turkey,TUR,0,0,0,5,5
2001,Sri Lanka,LKA,Turkey,TUR,0,0,5,5,10
2001,Nigeria,NGA,Turkey,TUR,0,0,0,5,5
2001,Pakistan,PAK,Turkey,TUR,0,0,0,5,5
2001,Rwanda,RWA,Turkey,TUR,5,0,0,0,5
2001,Sierra Leone,SLE,Turkey,TUR,0,0,0,5,5
2001,Somalia,SOM,Turkey,TUR,10,0,11,5,26
2001,Sudan,SDN,Turkey,TUR,0,0,0,5,5
2001,Syrian Arab Rep.,SYR,Turkey,TUR,5,0,0,5,10
2001,Tajikistan,TJK,Turkey,TUR,0,0,0,5,5
2001,Uzbekistan,UZB,Turkey,TUR,18,0,10,0,28
2001,Afghanistan,AFG,United Arab Emirates,ARE,0,0,5,5,10
2001,Algeria,DZA,United Arab Emirates,ARE,0,0,5,0,5
2001,India,IND,United Arab Emirates,ARE,0,0,0,5,5
2001,Iran (Islamic Rep. of),IRN,United Arab Emirates,ARE,0,0,5,0,5
2001,Somalia,SOM,United Arab Emirates,ARE,0,0,10,0,10
2001,Sudan,SDN,United Arab Emirates,ARE,0,0,0,5,5
2001,Argentina,ARG,Uruguay,URY,5,0,0,0,5
2001,Afghanistan,AFG,Uzbekistan,UZB,1573,0,247,189,2009
2001,Azerbaijan,AZE,Uzbekistan,UZB,0,0,5,0,5
2001,China,CHN,Uzbekistan,UZB,0,0,5,0,5
2001,Iraq,IRQ,Uzbekistan,UZB,5,0,0,0,5
2001,Serbia and Kosovo: S/RES/1244 (1999),SRB,Uzbekistan,UZB,5,0,0,0,5
2001,Tajikistan,TJK,Uzbekistan,UZB,0,0,0,5,5
2001,Djibouti,DJI,Yemen,YEM,0,0,5,0,5
2001,Eritrea,ERI,Yemen,YEM,12,0,10,23,45
2001,Ethiopia,ETH,Yemen,YEM,33,0,231,459,723
2001,Palestinian,PSE,Yemen,YEM,45,0,5,27,77
2001,Iraq,IRQ,Yemen,YEM,123,0,91,69,283
2001,Kenya,KEN,Yemen,YEM,0,0,0,5,5
2001,Sudan,SDN,Yemen,YEM,12,0,95,120,227
2001,Syrian Arab Rep.,SYR,Yemen,YEM,5,0,0,0,5
2002,Iran (Islamic Rep. of),IRN,Afghanistan,AFG,0,0,13,0,13
2002,Iraq,IRQ,Afghanistan,AFG,0,0,13,0,13
2002,Pakistan,PAK,Afghanistan,AFG,0,0,5,0,5
2002,Tajikistan,TJK,Afghanistan,AFG,0,0,5,0,5
2002,Afghanistan,AFG,Egypt,EGY,0,0,34,0,34
2002,Burundi,BDI,Egypt,EGY,5,0,16,0,21
2002,Chad,TCD,Egypt,EGY,0,0,10,0,10
2002,Congo,COG,Egypt,EGY,0,0,5,0,5
2002,Dem. Rep. of the Congo,COD,Egypt,EGY,0,0,5,0,5
2002,Djibouti,DJI,Egypt,EGY,0,0,5,0,5
2002,Eritrea,ERI,Egypt,EGY,15,0,111,0,126
2002,Ethiopia,ETH,Egypt,EGY,57,0,437,0,494
2002,Palestinian,PSE,Egypt,EGY,55,0,0,0,55
2002,Iraq,IRQ,Egypt,EGY,5,0,26,0,31
2002,Liberia,LBR,Egypt,EGY,10,0,12,0,22
2002,Sri Lanka,LKA,Egypt,EGY,0,0,5,0,5
2002,Russian Federation,RUS,Egypt,EGY,0,0,5,0,5
2002,Rwanda,RWA,Egypt,EGY,0,0,5,0,5
2002,Sierra Leone,SLE,Egypt,EGY,0,0,15,0,15
2002,Somalia,SOM,Egypt,EGY,592,0,952,0,1544
2002,Sudan,SDN,Egypt,EGY,4245,0,5897,0,10142
2002,United Rep. of Tanzania,TZA,Egypt,EGY,0,0,5,0,5
2002,Yemen,YEM,Egypt,EGY,0,0,11,0,11
2002,Myanmar,MMR,Bangladesh,BGD,21,0,0,10,31
2002,India,IND,Bosnia and Herzegovina,BIH,0,0,0,5,5
2002,Iran (Islamic Rep. of),IRN,Bosnia and Herzegovina,BIH,5,0,26,0,31
2002,Iraq,IRQ,Bosnia and Herzegovina,BIH,5,0,0,0,5
2002,North Macedonia,MKD,Bosnia and Herzegovina,BIH,0,0,0,210,210
2002,Pakistan,PAK,Bosnia and Herzegovina,BIH,0,0,5,5,10
2002,Serbia and Kosovo: S/RES/1244 (1999),SRB,Bosnia and Herzegovina,BIH,79,0,60,79,218
2002,Stateless,XXA,Bosnia and Herzegovina,BIH,0,0,0,10,10
2002,Cuba,CUB,Belize,BLZ,0,0,13,0,13
2002,Nigeria,NGA,Belize,BLZ,0,0,0,5,5
2002,Sierra Leone,SLE,Belize,BLZ,0,0,0,10,10
2002,Afghanistan,AFG,Cambodia,KHM,0,0,0,10,10
2002,China,CHN,Cambodia,KHM,5,0,5,0,10
2002,Iran (Islamic Rep. of),IRN,Cambodia,KHM,0,0,5,0,5
2002,Sri Lanka,LKA,Cambodia,KHM,5,0,5,0,10
2002,Pakistan,PAK,Cambodia,KHM,0,0,10,5,15
2002,Viet Nam,VNM,Cambodia,KHM,930,0,92,78,1100
2002,Afghanistan,AFG,China,CHN,5,0,0,0,5
2002,Burundi,BDI,China,CHN,5,0,0,0,5
2002,Liberia,LBR,China,CHN,0,0,5,0,5
2002,Nigeria,NGA,China,CHN,0,0,5,0,5
2002,Central African Rep.,CAF,Cameroon,CMR,17,0,0,0,17
2002,Chad,TCD,Cameroon,CMR,5,0,0,0,5
2002,Congo,COG,Cameroon,CMR,5,0,0,0,5
2002,Dem. Rep. of the Congo,COD,Cameroon,CMR,19,0,0,0,19
2002,Liberia,LBR,Cameroon,CMR,0,0,5,0,5
2002,Rwanda,RWA,Cameroon,CMR,111,0,0,0,111
2002,Cuba,CUB,Colombia,COL,0,0,5,5,10
2002,Iraq,IRQ,Colombia,COL,0,0,0,5,5
2002,Colombia,COL,Cuba,CUB,5,0,0,0,5
2002,Ethiopia,ETH,Cuba,CUB,0,0,5,0,5
2002,Haiti,HTI,Cuba,CUB,0,0,5,0,5
2002,Iraq,IRQ,Cuba,CUB,5,0,0,0,5
2002,Syrian Arab Rep.,SYR,Cuba,CUB,0,0,16,0,16
2002,Egypt,EGY,Cyprus,CYP,10,0,42,16,68
2002,Dem. Rep. of the Congo,COD,Cyprus,CYP,0,0,5,0,5
2002,Palestinian,PSE,Cyprus,CYP,0,0,0,5,5
2002,Georgia,GEO,Cyprus,CYP,0,0,0,5,5
2002,Iran (Islamic Rep. of),IRN,Cyprus,CYP,62,0,162,114,338
2002,Iraq,IRQ,Cyprus,CYP,5,0,14,15,34
2002,Jordan,JOR,Cyprus,CYP,0,0,10,10,20
2002,Lebanon,LBN,Cyprus,CYP,5,0,24,21,50
2002,Sri Lanka,LKA,Cyprus,CYP,0,0,10,5,15
2002,Nigeria,NGA,Cyprus,CYP,0,0,5,0,5
2002,Pakistan,PAK,Cyprus,CYP,0,0,16,5,21
2002,Russian Federation,RUS,Cyprus,CYP,0,0,24,10,34
2002,Serbia and Kosovo: S/RES/1244 (1999),SRB,Cyprus,CYP,10,0,298,76,384
2002,Syrian Arab Rep.,SYR,Cyprus,CYP,5,0,5,11,21
2002,Turkey,TUR,Cyprus,CYP,0,0,0,10,10
2002,Ethiopia,ETH,Djibouti,DJI,0,0,0,5,5
2002,Ethiopia,ETH,Eritrea,ERI,5,0,0,0,5
2002,Sudan,SDN,Eritrea,ERI,5,0,0,0,5
2002,Sierra Leone,SLE,Gambia,GMB,0,0,0,223,223
2002,Honduras,HND,Guatemala,GTM,5,0,0,0,5
2002,India,IND,Guatemala,GTM,0,0,15,18,33
2002,Nicaragua,NIC,Guatemala,GTM,0,0,0,5,5
2002,Bangladesh,BGD,"China, Hong Kong SAR",HKG,0,0,5,10,15
2002,Eritrea,ERI,"China, Hong Kong SAR",HKG,10,0,0,0,10
2002,Ethiopia,ETH,"China, Hong Kong SAR",HKG,5,0,0,0,5
2002,India,IND,"China, Hong Kong SAR",HKG,0,0,10,10,20
2002,Sri Lanka,LKA,"China, Hong Kong SAR",HKG,12,0,42,47,101
2002,Mongolia,MNG,"China, Hong Kong SAR",HKG,0,0,0,5,5
2002,Pakistan,PAK,"China, Hong Kong SAR",HKG,57,0,158,194,409
2002,Afghanistan,AFG,Croatia,HRV,0,0,0,5,5
2002,Palestinian,PSE,Croatia,HRV,0,0,0,5,5
2002,Iran (Islamic Rep. of),IRN,Croatia,HRV,0,0,0,13,13
2002,Nigeria,NGA,Croatia,HRV,0,0,0,5,5
2002,Russian Federation,RUS,Croatia,HRV,0,0,0,18,18
2002,Serbia and Kosovo: S/RES/1244 (1999),SRB,Croatia,HRV,0,0,5,11,16
2002,Sierra Leone,SLE,Croatia,HRV,0,0,0,5,5
2002,Ukraine,UKR,Croatia,HRV,0,0,0,5,5
2002,Afghanistan,AFG,India,IND,280,0,66,0,346
2002,Eritrea,ERI,India,IND,5,0,13,0,18
2002,Ethiopia,ETH,India,IND,16,0,10,0,26
2002,Iran (Islamic Rep. of),IRN,India,IND,5,0,0,0,5
2002,Iraq,IRQ,India,IND,5,0,5,0,10
2002,Israel,ISR,India,IND,11,0,0,0,11
2002,Myanmar,MMR,India,IND,135,0,318,0,453
2002,Nigeria,NGA,India,IND,0,0,5,0,5
2002,Sierra Leone,SLE,India,IND,0,0,5,0,5
2002,Somalia,SOM,India,IND,12,0,93,0,105
2002,Sudan,SDN,India,IND,24,0,45,0,69
2002,Afghanistan,AFG,Indonesia,IDN,133,10,139,401,683
2002,Algeria,DZA,Indonesia,IDN,5,0,0,5,10
2002,Angola,AGO,Indonesia,IDN,0,0,0,5,5
2002,Palestinian,PSE,Indonesia,IDN,5,0,0,0,5
2002,Iran (Islamic Rep. of),IRN,Indonesia,IDN,15,0,20,5,40
2002,Iraq,IRQ,Indonesia,IDN,244,26,140,61,471
2002,Sri Lanka,LKA,Indonesia,IDN,0,0,0,13,13
2002,United Rep. of Tanzania,TZA,Indonesia,IDN,0,0,0,5,5
2002,China,CHN,Iran (Islamic Rep. of),IRN,18,0,5,0,23
2002,Turkey,TUR,Iran (Islamic Rep. of),IRN,0,0,0,10,10
2002,Iran (Islamic Rep. of),IRN,Iraq,IRQ,95,0,201,95,391
2002,Syrian Arab Rep.,SYR,Iraq,IRQ,11,0,0,0,11
2002,Turkey,TUR,Iraq,IRQ,284,0,0,0,284
2002,Algeria,DZA,Jordan,JOR,0,0,0,10,10
2002,Egypt,EGY,Jordan,JOR,0,0,11,87,98
2002,Congo,COG,Jordan,JOR,0,0,5,0,5
2002,Djibouti,DJI,Jordan,JOR,0,0,5,0,5
2002,Eritrea,ERI,Jordan,JOR,0,0,5,0,5
2002,India,IND,Jordan,JOR,0,0,0,21,21
2002,Iraq,IRQ,Jordan,JOR,654,0,1939,795,3388
2002,Sri Lanka,LKA,Jordan,JOR,0,0,0,39,39
2002,North Macedonia,MKD,Jordan,JOR,0,0,0,5,5
2002,Morocco,MAR,Jordan,JOR,0,0,0,5,5
2002,Pakistan,PAK,Jordan,JOR,0,0,0,5,5
2002,Russian Federation,RUS,Jordan,JOR,10,0,0,0,10
2002,Serbia and Kosovo: S/RES/1244 (1999),SRB,Jordan,JOR,0,0,0,5,5
2002,Somalia,SOM,Jordan,JOR,0,0,17,5,22
2002,Sudan,SDN,Jordan,JOR,0,0,93,122,215
2002,Syrian Arab Rep.,SYR,Jordan,JOR,5,0,64,53,122
2002,Tunisia,TUN,Jordan,JOR,0,0,0,5,5
2002,Yemen,YEM,Jordan,JOR,0,0,0,5,5
2002,Stateless,XXA,Jordan,JOR,5,0,0,5,10
2002,China,CHN,Kazakhstan,KAZ,5,0,15,0,20
2002,Iraq,IRQ,Kazakhstan,KAZ,0,0,5,0,5
2002,Burundi,BDI,Kenya,KEN,72,0,35,32,139
2002,Dem. Rep. of the Congo,COD,Kenya,KEN,238,0,195,355,788
2002,Eritrea,ERI,Kenya,KEN,20,0,36,836,892
2002,Ethiopia,ETH,Kenya,KEN,578,0,731,5174,6483
2002,Iraq,IRQ,Kenya,KEN,0,0,0,10,10
2002,Rwanda,RWA,Kenya,KEN,102,0,110,639,851
2002,Sierra Leone,SLE,Kenya,KEN,0,0,0,5,5
2002,Somalia,SOM,Kenya,KEN,200,0,5,3360,3565
2002,Sudan,SDN,Kenya,KEN,16,0,5,941,962
2002,United Rep. of Tanzania,TZA,Kenya,KEN,0,0,0,18,18
2002,Uganda,UGA,Kenya,KEN,31,0,45,16,92
2002,Unknown ,,Kenya,KEN,0,0,0,24,24
2002,Palestinian,PSE,Kuwait,KWT,10,0,0,0,10
2002,Iraq,IRQ,Kuwait,KWT,0,0,0,5,5
2002,Afghanistan,AFG,Lebanon,LBN,0,0,5,5,10
2002,Algeria,DZA,Lebanon,LBN,10,0,20,59,89
2002,Egypt,EGY,Lebanon,LBN,0,0,24,72,96
2002,Burundi,BDI,Lebanon,LBN,0,0,5,10,15
2002,Chad,TCD,Lebanon,LBN,0,0,5,10,15
2002,Congo,COG,Lebanon,LBN,0,0,10,5,15
2002,Dem. Rep. of the Congo,COD,Lebanon,LBN,0,0,5,0,5
2002,Eritrea,ERI,Lebanon,LBN,0,0,5,35,40
2002,Ethiopia,ETH,Lebanon,LBN,0,0,0,119,119
2002,Iran (Islamic Rep. of),IRN,Lebanon,LBN,0,0,5,10,15
2002,Iraq,IRQ,Lebanon,LBN,133,0,1374,1605,3112
2002,Jordan,JOR,Lebanon,LBN,0,0,10,17,27
2002,Liberia,LBR,Lebanon,LBN,0,0,10,24,34
2002,Nigeria,NGA,Lebanon,LBN,0,0,10,81,91
2002,Rwanda,RWA,Lebanon,LBN,0,0,10,33,43
2002,Sierra Leone,SLE,Lebanon,LBN,0,0,5,49,54
2002,Somalia,SOM,Lebanon,LBN,0,0,18,51,69
2002,Sudan,SDN,Lebanon,LBN,37,0,627,440,1104
2002,Tunisia,TUN,Lebanon,LBN,0,0,0,5,5
2002,Turkey,TUR,Lebanon,LBN,0,0,14,32,46
2002,Yemen,YEM,Lebanon,LBN,0,0,5,5,10
2002,Stateless,XXA,Lebanon,LBN,0,0,5,5,10
2002,Unknown ,,Lebanon,LBN,0,0,32,80,112
2002,Iraq,IRQ,Sri Lanka,LKA,10,0,10,0,20
2002,Liberia,LBR,Mauritania,MRT,12,0,0,0,12
2002,Sierra Leone,SLE,Mauritania,MRT,39,0,0,0,39
2002,Unknown ,,Mauritania,MRT,5,0,0,0,5
2002,Serbia and Kosovo: S/RES/1244 (1999),SRB,North Macedonia,MKD,0,0,75,31,106
2002,Afghanistan,AFG,Rep. of Moldova,MDA,0,0,5,5,10
2002,Palestinian,PSE,Rep. of Moldova,MDA,0,0,0,5,5
2002,Georgia,GEO,Rep. of Moldova,MDA,0,0,0,5,5
2002,Iran (Islamic Rep. of),IRN,Rep. of Moldova,MDA,0,0,5,0,5
2002,Iraq,IRQ,Rep. of Moldova,MDA,0,0,5,14,19
2002,Russian Federation,RUS,Rep. of Moldova,MDA,44,0,0,28,72
2002,Somalia,SOM,Rep. of Moldova,MDA,0,0,0,5,5
2002,Sudan,SDN,Rep. of Moldova,MDA,0,0,5,0,5
2002,Colombia,COL,Mexico,MEX,10,0,0,0,10
2002,Cuba,CUB,Mexico,MEX,0,0,5,0,5
2002,Palestinian,PSE,Mexico,MEX,0,0,0,5,5
2002,Romania,ROU,Mexico,MEX,0,0,0,5,5
2002,Yemen,YEM,Mexico,MEX,0,0,0,5,5
2002,Afghanistan,AFG,Malaysia,MYS,0,0,35,13,48
2002,Bangladesh,BGD,Malaysia,MYS,0,0,13,5,18
2002,China,CHN,Malaysia,MYS,5,0,0,0,5
2002,Indonesia,IDN,Malaysia,MYS,86,16,206,52,360
2002,Iran (Islamic Rep. of),IRN,Malaysia,MYS,0,0,0,5,5
2002,Iraq,IRQ,Malaysia,MYS,21,0,5,0,26
2002,Myanmar,MMR,Malaysia,MYS,108,5,160,23,296
2002,Philippines,PHL,Malaysia,MYS,12,0,0,0,12
2002,Somalia,SOM,Malaysia,MYS,5,0,0,0,5
2002,Uzbekistan,UZB,Malaysia,MYS,0,0,5,0,5
2002,Palestinian,PSE,Malta,MLT,0,0,5,0,5
2002,Ghana,GHA,Malta,MLT,0,0,5,0,5
2002,Iran (Islamic Rep. of),IRN,Malta,MLT,5,0,0,0,5
2002,Iraq,IRQ,Malta,MLT,0,0,10,0,10
2002,Libya,LBY,Malta,MLT,0,0,0,5,5
2002,Sudan,SDN,Malta,MLT,5,0,49,0,54
2002,Turkey,TUR,Malta,MLT,0,0,5,0,5
2002,Algeria,DZA,Niger,NER,0,0,0,5,5
2002,Chad,TCD,Niger,NER,0,0,5,5,10
2002,Cameroon,CMR,Niger,NER,0,0,0,48,48
2002,Congo,COG,Niger,NER,0,0,5,18,23
2002,Dem. Rep. of the Congo,COD,Niger,NER,13,0,31,238,282
2002,Comoros,COM,Niger,NER,0,0,0,5,5
2002,Guinea-Bissau,GNB,Niger,NER,0,0,0,5,5
2002,Cote d'Ivoire,CIV,Niger,NER,0,0,0,10,10
2002,Liberia,LBR,Niger,NER,0,0,0,5,5
2002,Rwanda,RWA,Niger,NER,5,0,0,5,10
2002,Sierra Leone,SLE,Niger,NER,5,0,5,12,22
2002,Somalia,SOM,Niger,NER,0,0,0,19,19
2002,Sudan,SDN,Niger,NER,0,0,0,5,5
2002,Algeria,DZA,Pakistan,PAK,0,0,0,5,5
2002,Egypt,EGY,Pakistan,PAK,0,0,0,13,13
2002,Azerbaijan,AZE,Pakistan,PAK,0,0,0,5,5
2002,Burundi,BDI,Pakistan,PAK,0,0,0,5,5
2002,China,CHN,Pakistan,PAK,17,0,0,5,22
2002,Congo,COG,Pakistan,PAK,0,0,0,5,5
2002,Ethiopia,ETH,Pakistan,PAK,0,0,0,5,5
2002,Palestinian,PSE,Pakistan,PAK,0,0,0,5,5
2002,Guinea-Bissau,GNB,Pakistan,PAK,0,0,0,5,5
2002,Iran (Islamic Rep. of),IRN,Pakistan,PAK,55,0,123,149,327
2002,Iraq,IRQ,Pakistan,PAK,5,0,96,93,194
2002,Kenya,KEN,Pakistan,PAK,0,0,0,5,5
2002,Liberia,LBR,Pakistan,PAK,0,0,0,16,16
2002,Libya,LBY,Pakistan,PAK,0,0,0,10,10
2002,Niger,NER,Pakistan,PAK,0,0,0,10,10
2002,Nigeria,NGA,Pakistan,PAK,0,0,0,109,109
2002,Russian Federation,RUS,Pakistan,PAK,0,0,0,10,10
2002,Rwanda,RWA,Pakistan,PAK,0,0,0,5,5
2002,Saudi Arabia,SAU,Pakistan,PAK,0,0,0,5,5
2002,Sierra Leone,SLE,Pakistan,PAK,0,0,0,28,28
2002,Somalia,SOM,Pakistan,PAK,0,0,96,161,257
2002,Syrian Arab Rep.,SYR,Pakistan,PAK,0,0,0,18,18
2002,United Rep. of Tanzania,TZA,Pakistan,PAK,0,0,64,40,104
2002,Tajikistan,TJK,Pakistan,PAK,0,0,0,5,5
2002,Togo,TGO,Pakistan,PAK,0,0,0,5,5
2002,Uganda,UGA,Pakistan,PAK,0,0,0,5,5
2002,Zimbabwe,ZWE,Pakistan,PAK,0,0,0,5,5
2002,Cuba,CUB,Paraguay,PRY,0,0,0,10,10
2002,Iraq,IRQ,Qatar,QAT,0,0,5,0,5
2002,Sudan,SDN,Qatar,QAT,0,0,5,0,5
2002,Unknown ,,Qatar,QAT,0,0,0,5,5
2002,Burundi,BDI,Rwanda,RWA,199,0,0,58,257
2002,Dem. Rep. of the Congo,COD,Rwanda,RWA,424,0,0,236,660
2002,Afghanistan,AFG,Saudi Arabia,SAU,0,0,19,5,24
2002,Ethiopia,ETH,Saudi Arabia,SAU,0,0,5,0,5
2002,Iraq,IRQ,Saudi Arabia,SAU,0,0,14,10,24
2002,Somalia,SOM,Saudi Arabia,SAU,50,0,5,72,127
2002,Sudan,SDN,Saudi Arabia,SAU,5,0,48,0,53
2002,Syrian Arab Rep.,SYR,Saudi Arabia,SAU,0,0,19,5,24
2002,Unknown ,,Saudi Arabia,SAU,5,0,19,28,52
2002,Afghanistan,AFG,Serbia and Kosovo: S/RES/1244 (1999),SRB,5,0,30,11,46
2002,Albania,ALB,Serbia and Kosovo: S/RES/1244 (1999),SRB,0,0,5,0,5
2002,Algeria,DZA,Serbia and Kosovo: S/RES/1244 (1999),SRB,0,0,0,5,5
2002,Azerbaijan,AZE,Serbia and Kosovo: S/RES/1244 (1999),SRB,5,0,0,0,5
2002,Iran (Islamic Rep. of),IRN,Serbia and Kosovo: S/RES/1244 (1999),SRB,0,0,5,5,10
2002,Iraq,IRQ,Serbia and Kosovo: S/RES/1244 (1999),SRB,22,0,39,26,87
2002,Russian Federation,RUS,Serbia and Kosovo: S/RES/1244 (1999),SRB,0,0,5,5,10
2002,Sudan,SDN,Serbia and Kosovo: S/RES/1244 (1999),SRB,0,0,5,0,5
2002,Sri Lanka,LKA,Singapore,SGP,0,0,0,5,5
2002,Malaysia,MYS,Singapore,SGP,0,0,0,5,5
2002,Afghanistan,AFG,Sierra Leone,SLE,0,0,0,5,5
2002,Liberia,LBR,Sierra Leone,SLE,5,0,0,0,5
2002,Ethiopia,ETH,Somalia,SOM,36,0,72,147,255
2002,United Rep. of Tanzania,TZA,Somalia,SOM,0,0,26,0,26
2002,Afghanistan,AFG,Turkmenistan,TKM,5,0,17,73,95
2002,Azerbaijan,AZE,Turkmenistan,TKM,51,0,68,44,163
2002,Russian Federation,RUS,Turkmenistan,TKM,5,0,0,0,5
2002,Tajikistan,TJK,Turkmenistan,TKM,0,0,252,41,293
2002,Unknown ,,Turkmenistan,TKM,0,0,5,0,5
2002,Indonesia,IDN,Timor-Leste,TLS,0,0,11,0,11
2002,Sri Lanka,LKA,Timor-Leste,TLS,0,0,0,16,16
2002,Congo,COG,Togo,TGO,0,0,5,0,5
2002,Dem. Rep. of the Congo,COD,Togo,TGO,10,0,0,0,10
2002,Rwanda,RWA,Togo,TGO,21,0,5,0,26
2002,Somalia,SOM,Togo,TGO,5,0,0,0,5
2002,Afghanistan,AFG,Turkey,TUR,54,0,86,134,274
2002,Algeria,DZA,Turkey,TUR,0,0,5,5,10
2002,China,CHN,Turkey,TUR,16,0,20,13,49
2002,Dem. Rep. of the Congo,COD,Turkey,TUR,0,0,12,5,17
2002,Ethiopia,ETH,Turkey,TUR,5,0,0,0,5
2002,Palestinian,PSE,Turkey,TUR,16,0,5,5,26
2002,Iran (Islamic Rep. of),IRN,Turkey,TUR,2380,0,982,126,3488
2002,Iraq,IRQ,Turkey,TUR,356,0,803,171,1330
2002,Kenya,KEN,Turkey,TUR,0,0,16,0,16
2002,Sri Lanka,LKA,Turkey,TUR,0,0,11,22,33
2002,Nigeria,NGA,Turkey,TUR,0,0,0,5,5
2002,Sierra Leone,SLE,Turkey,TUR,0,0,5,0,5
2002,Somalia,SOM,Turkey,TUR,17,0,5,5,27
2002,Sudan,SDN,Turkey,TUR,0,0,0,5,5
2002,Syrian Arab Rep.,SYR,Turkey,TUR,5,0,0,5,10
2002,Tunisia,TUN,Turkey,TUR,0,0,0,10,10
2002,Uzbekistan,UZB,Turkey,TUR,29,0,5,0,34
2002,Stateless,XXA,Turkey,TUR,5,0,0,0,5
2002,Afghanistan,AFG,United Arab Emirates,ARE,0,0,10,0,10
2002,Ethiopia,ETH,United Arab Emirates,ARE,0,0,0,5,5
2002,Iran (Islamic Rep. of),IRN,United Arab Emirates,ARE,0,0,15,0,15
2002,Iraq,IRQ,United Arab Emirates,ARE,0,0,24,0,24
2002,Jordan,JOR,United Arab Emirates,ARE,0,0,0,5,5
2002,Somalia,SOM,United Arab Emirates,ARE,0,0,59,47,106
2002,Sudan,SDN,United Arab Emirates,ARE,0,0,10,0,10
2002,Tajikistan,TJK,United Arab Emirates,ARE,0,0,10,0,10
2002,Yemen,YEM,United Arab Emirates,ARE,0,0,10,14,24
2002,Colombia,COL,Uruguay,URY,5,0,0,5,10
2002,Afghanistan,AFG,Uzbekistan,UZB,544,0,22,206,772
2002,Azerbaijan,AZE,Uzbekistan,UZB,0,0,5,5,10
2002,Egypt,EGY,Yemen,YEM,0,0,5,10,15
2002,Djibouti,DJI,Yemen,YEM,0,0,0,11,11
2002,Eritrea,ERI,Yemen,YEM,0,0,42,97,139
2002,Ethiopia,ETH,Yemen,YEM,24,0,230,767,1021
2002,Palestinian,PSE,Yemen,YEM,26,0,5,35,66
2002,Iraq,IRQ,Yemen,YEM,48,0,288,457,793
2002,Jordan,JOR,Yemen,YEM,0,0,5,0,5
2002,Saudi Arabia,SAU,Yemen,YEM,0,0,0,52,52
2002,Viet Nam,VNM,Yemen,YEM,0,0,5,5,10
2002,Sudan,SDN,Yemen,YEM,0,0,34,429,463
2003,Iran (Islamic Rep. of),IRN,Afghanistan,AFG,5,0,0,10,15
2003,Iraq,IRQ,Afghanistan,AFG,0,0,5,0,5
2003,Pakistan,PAK,Afghanistan,AFG,5,0,0,0,5
2003,Afghanistan,AFG,Egypt,EGY,0,0,5,0,5
2003,Algeria,DZA,Egypt,EGY,0,0,5,0,5
2003,Burundi,BDI,Egypt,EGY,24,0,0,0,24
2003,Chad,TCD,Egypt,EGY,5,0,5,0,10
2003,China,CHN,Egypt,EGY,0,0,5,0,5
2003,Dem. Rep. of the Congo,COD,Egypt,EGY,5,0,10,0,15
2003,Djibouti,DJI,Egypt,EGY,0,0,5,0,5
2003,Eritrea,ERI,Egypt,EGY,65,0,34,0,99
2003,Ethiopia,ETH,Egypt,EGY,229,0,201,0,430
2003,Palestinian,PSE,Egypt,EGY,18,0,0,0,18
2003,Cote d'Ivoire,CIV,Egypt,EGY,67,0,0,0,67
2003,Iraq,IRQ,Egypt,EGY,5,0,10,0,15
2003,Liberia,LBR,Egypt,EGY,16,0,0,0,16
2003,Rwanda,RWA,Egypt,EGY,5,0,5,0,10
2003,Sierra Leone,SLE,Egypt,EGY,10,0,5,0,15
2003,Somalia,SOM,Egypt,EGY,1589,0,233,0,1822
2003,Sudan,SDN,Egypt,EGY,8673,0,2082,0,10755
2003,Syrian Arab Rep.,SYR,Egypt,EGY,5,0,5,0,10
2003,Uganda,UGA,Egypt,EGY,5,0,0,0,5
2003,Yemen,YEM,Egypt,EGY,0,0,10,0,10
2003,Afghanistan,AFG,Azerbaijan,AZE,32,0,15,14,61
2003,Algeria,DZA,Azerbaijan,AZE,0,0,0,5,5
2003,Iran (Islamic Rep. of),IRN,Azerbaijan,AZE,25,0,22,0,47
2003,Iraq,IRQ,Azerbaijan,AZE,5,0,5,0,10
2003,Kuwait,KWT,Azerbaijan,AZE,5,0,0,0,5
2003,Russian Federation,RUS,Azerbaijan,AZE,42,0,0,0,42
2003,Somalia,SOM,Azerbaijan,AZE,5,0,0,0,5
2003,Turkmenistan,TKM,Azerbaijan,AZE,0,0,0,5,5
2003,Turkey,TUR,Azerbaijan,AZE,0,0,0,5,5
2003,Myanmar,MMR,Bangladesh,BGD,28,0,28,5,61
2003,Egypt,EGY,Bosnia and Herzegovina,BIH,0,0,0,5,5
2003,Bangladesh,BGD,Bosnia and Herzegovina,BIH,0,0,0,10,10
2003,Iran (Islamic Rep. of),IRN,Bosnia and Herzegovina,BIH,0,0,0,5,5
2003,Iraq,IRQ,Bosnia and Herzegovina,BIH,0,0,0,5,5
2003,North Macedonia,MKD,Bosnia and Herzegovina,BIH,0,0,39,33,72
2003,Rep. of Moldova,MDA,Bosnia and Herzegovina,BIH,0,0,5,0,5
2003,Romania,ROU,Bosnia and Herzegovina,BIH,0,0,5,0,5
2003,Serbia and Kosovo: S/RES/1244 (1999),SRB,Bosnia and Herzegovina,BIH,16,0,255,101,372
2003,China,CHN,Cambodia,KHM,0,0,5,0,5
2003,Pakistan,PAK,Cambodia,KHM,0,0,5,0,5
2003,Viet Nam,VNM,Cambodia,KHM,37,0,54,16,107
2003,Burundi,BDI,China,CHN,5,0,0,0,5
2003,Iran (Islamic Rep. of),IRN,China,CHN,5,0,0,0,5
2003,Burundi,BDI,Cameroon,CMR,12,0,0,0,12
2003,Central African Rep.,CAF,Cameroon,CMR,105,0,136,0,241
2003,Chad,TCD,Cameroon,CMR,20,0,35,0,55
2003,Congo,COG,Cameroon,CMR,72,0,45,0,117
2003,Dem. Rep. of the Congo,COD,Cameroon,CMR,98,0,175,5,278
2003,Cote d'Ivoire,CIV,Cameroon,CMR,11,0,28,0,39
2003,Liberia,LBR,Cameroon,CMR,54,0,10,0,64
2003,Rwanda,RWA,Cameroon,CMR,105,0,39,5,149
2003,Unknown ,,Cameroon,CMR,14,0,19,0,33
2003,Iran (Islamic Rep. of),IRN,Colombia,COL,5,0,0,0,5
2003,Ethiopia,ETH,Cuba,CUB,10,0,0,0,10
2003,Iran (Islamic Rep. of),IRN,Cuba,CUB,0,0,5,0,5
2003,Russian Federation,RUS,Cuba,CUB,0,0,0,5,5
2003,Algeria,DZA,Cyprus,CYP,5,0,5,0,10
2003,Armenia,ARM,Cyprus,CYP,0,0,10,0,10
2003,Azerbaijan,AZE,Cyprus,CYP,0,0,0,5,5
2003,Bangladesh,BGD,Cyprus,CYP,0,0,5,0,5
2003,Bosnia and Herzegovina,BIH,Cyprus,CYP,10,0,39,0,49
2003,Bulgaria,BGR,Cyprus,CYP,0,0,5,0,5
2003,Cameroon,CMR,Cyprus,CYP,0,0,13,0,13
2003,Palestinian,PSE,Cyprus,CYP,10,0,12,11,33
2003,Georgia,GEO,Cyprus,CYP,0,0,21,11,32
2003,India,IND,Cyprus,CYP,0,0,5,0,5
2003,Iran (Islamic Rep. of),IRN,Cyprus,CYP,100,0,403,127,630
2003,Iraq,IRQ,Cyprus,CYP,0,0,13,0,13
2003,Jordan,JOR,Cyprus,CYP,0,0,5,0,5
2003,Kyrgyzstan,KGZ,Cyprus,CYP,0,0,5,0,5
2003,Lebanon,LBN,Cyprus,CYP,0,0,28,10,38
2003,Sri Lanka,LKA,Cyprus,CYP,0,0,27,0,27
2003,Rep. of Moldova,MDA,Cyprus,CYP,0,0,0,5,5
2003,Nigeria,NGA,Cyprus,CYP,0,0,5,0,5
2003,Pakistan,PAK,Cyprus,CYP,5,0,169,24,198
2003,Russian Federation,RUS,Cyprus,CYP,15,0,123,36,174
2003,Serbia and Kosovo: S/RES/1244 (1999),SRB,Cyprus,CYP,5,0,175,38,218
2003,Syrian Arab Rep.,SYR,Cyprus,CYP,5,0,10,0,15
2003,Turkey,TUR,Cyprus,CYP,18,0,27,5,50
2003,Ukraine,UKR,Cyprus,CYP,0,0,35,0,35
2003,Uzbekistan,UZB,Cyprus,CYP,0,0,10,0,10
2003,Ethiopia,ETH,Eritrea,ERI,5,0,0,0,5
2003,Bangladesh,BGD,"China, Hong Kong SAR",HKG,0,0,5,0,5
2003,Cameroon,CMR,"China, Hong Kong SAR",HKG,0,0,19,5,24
2003,Dem. Rep. of the Congo,COD,"China, Hong Kong SAR",HKG,5,0,0,5,10
2003,Ghana,GHA,"China, Hong Kong SAR",HKG,0,0,0,10,10
2003,Cote d'Ivoire,CIV,"China, Hong Kong SAR",HKG,5,0,5,5,15
2003,India,IND,"China, Hong Kong SAR",HKG,0,0,5,5,10
2003,Indonesia,IDN,"China, Hong Kong SAR",HKG,0,0,5,0,5
2003,Liberia,LBR,"China, Hong Kong SAR",HKG,0,0,5,0,5
2003,Sri Lanka,LKA,"China, Hong Kong SAR",HKG,12,0,28,12,52
2003,Nepal,NPL,"China, Hong Kong SAR",HKG,0,0,5,5,10
2003,Pakistan,PAK,"China, Hong Kong SAR",HKG,77,10,80,31,198
2003,Uganda,UGA,"China, Hong Kong SAR",HKG,0,0,5,0,5
2003,Afghanistan,AFG,Croatia,HRV,0,0,0,5,5
2003,Algeria,DZA,Croatia,HRV,0,0,5,5,10
2003,Bangladesh,BGD,Croatia,HRV,0,0,0,5,5
2003,Palestinian,PSE,Croatia,HRV,0,0,0,5,5
2003,Iran (Islamic Rep. of),IRN,Croatia,HRV,0,0,5,10,15
2003,Iraq,IRQ,Croatia,HRV,0,0,0,15,15
2003,Liberia,LBR,Croatia,HRV,0,0,0,5,5
2003,Pakistan,PAK,Croatia,HRV,0,0,0,5,5
2003,Serbia and Kosovo: S/RES/1244 (1999),SRB,Croatia,HRV,0,0,5,0,5
2003,Afghanistan,AFG,India,IND,74,0,40,35,149
2003,China,CHN,India,IND,5,0,0,0,5
2003,Eritrea,ERI,India,IND,0,0,14,10,24
2003,Ethiopia,ETH,India,IND,5,0,23,15,43
2003,Iran (Islamic Rep. of),IRN,India,IND,12,0,10,0,22
2003,Iraq,IRQ,India,IND,0,0,5,5,10
2003,Liberia,LBR,India,IND,0,0,5,0,5
2003,Myanmar,MMR,India,IND,85,0,233,96,414
2003,Somalia,SOM,India,IND,5,0,26,0,31
2003,Sudan,SDN,India,IND,5,0,47,0,52
2003,Afghanistan,AFG,Indonesia,IDN,14,0,30,10,54
2003,Cameroon,CMR,Indonesia,IDN,0,0,0,5,5
2003,Dem. Rep. of the Congo,COD,Indonesia,IDN,5,0,10,0,15
2003,Cote d'Ivoire,CIV,Indonesia,IDN,0,0,0,5,5
2003,India,IND,Indonesia,IDN,0,0,0,14,14
2003,Iran (Islamic Rep. of),IRN,Indonesia,IDN,0,0,31,0,31
2003,Iraq,IRQ,Indonesia,IDN,22,0,22,38,82
2003,Sri Lanka,LKA,Indonesia,IDN,0,0,5,11,16
2003,Pakistan,PAK,Indonesia,IDN,0,0,5,0,5
2003,Philippines,PHL,Indonesia,IDN,0,0,0,5,5
2003,Somalia,SOM,Indonesia,IDN,5,0,5,0,10
2003,Viet Nam,VNM,Indonesia,IDN,0,0,66,34,100
2003,Timor-Leste,TLS,Indonesia,IDN,0,0,0,26,26
2003,Turkey,TUR,Indonesia,IDN,0,0,0,10,10
2003,Somalia,SOM,Iran (Islamic Rep. of),IRN,0,0,19,0,19
2003,Tunisia,TUN,Iran (Islamic Rep. of),IRN,0,0,5,0,5
2003,Turkey,TUR,Iran (Islamic Rep. of),IRN,0,0,0,11,11
2003,Afghanistan,AFG,Jordan,JOR,0,0,0,5,5
2003,Algeria,DZA,Jordan,JOR,0,0,0,10,10
2003,Egypt,EGY,Jordan,JOR,5,0,12,22,39
2003,Eritrea,ERI,Jordan,JOR,0,0,5,0,5
2003,Ethiopia,ETH,Jordan,JOR,5,0,0,0,5
2003,Iran (Islamic Rep. of),IRN,Jordan,JOR,5,0,0,0,5
2003,Iraq,IRQ,Jordan,JOR,247,0,117,75,439
2003,Jamaica,JAM,Jordan,JOR,0,0,0,5,5
2003,Russian Federation,RUS,Jordan,JOR,0,0,0,5,5
2003,Saudi Arabia,SAU,Jordan,JOR,0,0,0,5,5
2003,Somalia,SOM,Jordan,JOR,44,0,0,0,44
2003,Sudan,SDN,Jordan,JOR,37,0,22,39,98
2003,Syrian Arab Rep.,SYR,Jordan,JOR,21,0,15,33,69
2003,Tunisia,TUN,Jordan,JOR,0,0,5,5,10
2003,Yemen,YEM,Jordan,JOR,0,0,5,0,5
2003,China,CHN,Kazakhstan,KAZ,10,0,0,0,10
2003,Burundi,BDI,Kenya,KEN,53,0,36,0,89
2003,Dem. Rep. of the Congo,COD,Kenya,KEN,268,0,180,0,448
2003,Eritrea,ERI,Kenya,KEN,56,0,55,0,111
2003,Ethiopia,ETH,Kenya,KEN,307,0,706,0,1013
2003,Rwanda,RWA,Kenya,KEN,74,0,122,0,196
2003,Somalia,SOM,Kenya,KEN,108,0,191,0,299
2003,Sudan,SDN,Kenya,KEN,175,0,17,5,197
2003,Uganda,UGA,Kenya,KEN,27,0,202,0,229
2003,Iraq,IRQ,Kuwait,KWT,0,0,0,5,5
2003,Chad,TCD,Libya,LBY,10,0,5,0,15
2003,Dem. Rep. of the Congo,COD,Libya,LBY,5,0,5,5,15
2003,Ethiopia,ETH,Libya,LBY,0,0,0,5,5
2003,Palestinian,PSE,Libya,LBY,186,0,11,49,246
2003,Cote d'Ivoire,CIV,Libya,LBY,0,0,5,0,5
2003,Iraq,IRQ,Libya,LBY,0,0,5,0,5
2003,Liberia,LBR,Libya,LBY,24,0,5,10,39
2003,Sierra Leone,SLE,Libya,LBY,0,0,5,5,10
2003,Somalia,SOM,Libya,LBY,5,0,0,0,5
2003,Sudan,SDN,Libya,LBY,0,0,5,0,5
2003,Algeria,DZA,Lebanon,LBN,0,0,5,0,5
2003,Egypt,EGY,Lebanon,LBN,0,0,5,0,5
2003,Iran (Islamic Rep. of),IRN,Lebanon,LBN,0,0,5,0,5
2003,Iraq,IRQ,Lebanon,LBN,5,0,27,40,72
2003,Nigeria,NGA,Lebanon,LBN,0,0,0,5,5
2003,Rwanda,RWA,Lebanon,LBN,0,0,5,0,5
2003,Somalia,SOM,Lebanon,LBN,0,0,12,0,12
2003,Sudan,SDN,Lebanon,LBN,0,0,140,45,185
2003,Afghanistan,AFG,Sri Lanka,LKA,11,0,5,0,16
2003,Iraq,IRQ,Sri Lanka,LKA,5,0,0,0,5
2003,Afghanistan,AFG,Malaysia,MYS,10,0,0,5,15
2003,Burundi,BDI,Malaysia,MYS,0,0,0,5,5
2003,Bangladesh,BGD,Malaysia,MYS,0,0,5,71,76
2003,China,CHN,Malaysia,MYS,0,0,5,0,5
2003,India,IND,Malaysia,MYS,0,0,0,10,10
2003,Indonesia,IDN,Malaysia,MYS,121,3109,316,1484,5030
2003,Iran (Islamic Rep. of),IRN,Malaysia,MYS,5,0,5,5,15
2003,Iraq,IRQ,Malaysia,MYS,10,0,0,5,15
2003,Liberia,LBR,Malaysia,MYS,0,0,5,50,55
2003,Sri Lanka,LKA,Malaysia,MYS,0,0,5,25,30
2003,Myanmar,MMR,Malaysia,MYS,279,3979,239,1193,5690
2003,Nepal,NPL,Malaysia,MYS,0,0,0,5,5
2003,Pakistan,PAK,Malaysia,MYS,0,0,5,5,10
2003,Russian Federation,RUS,Malaysia,MYS,0,0,0,5,5
2003,Somalia,SOM,Malaysia,MYS,5,0,0,0,5
2003,Uzbekistan,UZB,Malaysia,MYS,5,0,0,0,5
2003,Chad,TCD,Niger,NER,10,0,0,0,10
2003,Dem. Rep. of the Congo,COD,Niger,NER,5,0,11,26,42
2003,Palestinian,PSE,Niger,NER,5,0,0,0,5
2003,Cote d'Ivoire,CIV,Niger,NER,5,0,0,0,5
2003,Iraq,IRQ,Niger,NER,5,0,0,0,5
2003,Afghanistan,AFG,Pakistan,PAK,352,0,1408,5820,7580
2003,Angola,AGO,Pakistan,PAK,0,0,5,0,5
2003,Egypt,EGY,Pakistan,PAK,0,0,0,10,10
2003,Burundi,BDI,Pakistan,PAK,0,0,10,0,10
2003,China,CHN,Pakistan,PAK,5,0,22,20,47
2003,Congo,COG,Pakistan,PAK,0,0,5,5,10
2003,Cote d'Ivoire,CIV,Pakistan,PAK,0,0,0,12,12
2003,Iran (Islamic Rep. of),IRN,Pakistan,PAK,26,0,297,128,451
2003,Iraq,IRQ,Pakistan,PAK,0,0,23,82,105
2003,Jordan,JOR,Pakistan,PAK,0,0,0,5,5
2003,Liberia,LBR,Pakistan,PAK,0,0,24,15,39
2003,Sri Lanka,LKA,Pakistan,PAK,0,0,0,5,5
2003,Niger,NER,Pakistan,PAK,0,0,5,0,5
2003,Nigeria,NGA,Pakistan,PAK,0,0,185,135,320
2003,Rwanda,RWA,Pakistan,PAK,0,0,5,0,5
2003,Sierra Leone,SLE,Pakistan,PAK,0,0,36,18,54
2003,Somalia,SOM,Pakistan,PAK,5,0,130,57,192
2003,Syrian Arab Rep.,SYR,Pakistan,PAK,5,0,0,0,5
2003,United Rep. of Tanzania,TZA,Pakistan,PAK,0,0,113,31,144
2003,Cuba,CUB,Paraguay,PRY,5,0,0,0,5
2003,Burundi,BDI,Rwanda,RWA,75,0,0,0,75
2003,Chad,TCD,Rwanda,RWA,10,0,0,0,10
2003,Dem. Rep. of the Congo,COD,Rwanda,RWA,150,0,0,0,150
2003,Ethiopia,ETH,Rwanda,RWA,12,0,0,0,12
2003,Uganda,UGA,Rwanda,RWA,10,0,0,0,10
2003,Bangladesh,BGD,Saudi Arabia,SAU,0,0,0,5,5
2003,Palestinian,PSE,Saudi Arabia,SAU,0,0,0,5,5
2003,Iraq,IRQ,Saudi Arabia,SAU,0,0,0,10,10
2003,Myanmar,MMR,Saudi Arabia,SAU,0,0,0,10,10
2003,Nigeria,NGA,Saudi Arabia,SAU,0,0,5,0,5
2003,Pakistan,PAK,Saudi Arabia,SAU,0,0,5,0,5
2003,Somalia,SOM,Saudi Arabia,SAU,16,0,27,0,43
2003,Sudan,SDN,Saudi Arabia,SAU,0,0,10,5,15
2003,Syrian Arab Rep.,SYR,Saudi Arabia,SAU,0,0,0,5,5
2003,Afghanistan,AFG,Serbia and Kosovo: S/RES/1244 (1999),SRB,0,0,30,0,30
2003,Egypt,EGY,Serbia and Kosovo: S/RES/1244 (1999),SRB,0,0,0,5,5
2003,Azerbaijan,AZE,Serbia and Kosovo: S/RES/1244 (1999),SRB,0,0,5,0,5
2003,Bangladesh,BGD,Serbia and Kosovo: S/RES/1244 (1999),SRB,0,0,5,0,5
2003,Iran (Islamic Rep. of),IRN,Serbia and Kosovo: S/RES/1244 (1999),SRB,0,0,0,5,5
2003,Iraq,IRQ,Serbia and Kosovo: S/RES/1244 (1999),SRB,0,0,0,65,65
2003,Rep. of Moldova,MDA,Serbia and Kosovo: S/RES/1244 (1999),SRB,5,0,0,0,5
2003,Russian Federation,RUS,Serbia and Kosovo: S/RES/1244 (1999),SRB,10,0,0,0,10
2003,Liberia,LBR,Sierra Leone,SLE,0,0,0,142,142
2003,Afghanistan,AFG,Turkmenistan,TKM,5,0,5,10,20
2003,Azerbaijan,AZE,Turkmenistan,TKM,12,0,5,0,17
2003,Viet Nam,VNM,Timor-Leste,TLS,0,0,5,0,5
2003,Central African Rep.,CAF,Togo,TGO,5,0,0,0,5
2003,Congo,COG,Togo,TGO,5,0,0,0,5
2003,Dem. Rep. of the Congo,COD,Togo,TGO,17,0,5,0,22
2003,Cote d'Ivoire,CIV,Togo,TGO,55,0,0,0,55
2003,Liberia,LBR,Togo,TGO,5,0,0,0,5
2003,Rwanda,RWA,Togo,TGO,29,0,0,0,29
2003,Sierra Leone,SLE,Togo,TGO,0,0,5,0,5
2003,Afghanistan,AFG,Turkey,TUR,53,0,37,23,113
2003,China,CHN,Turkey,TUR,21,0,10,0,31
2003,Dem. Rep. of the Congo,COD,Turkey,TUR,0,0,5,5,10
2003,Eritrea,ERI,Turkey,TUR,0,0,10,5,15
2003,Ethiopia,ETH,Turkey,TUR,5,0,5,5,15
2003,Palestinian,PSE,Turkey,TUR,0,0,5,0,5
2003,Iran (Islamic Rep. of),IRN,Turkey,TUR,2009,0,380,0,2389
2003,Iraq,IRQ,Turkey,TUR,198,0,20,146,364
2003,Jordan,JOR,Turkey,TUR,0,0,0,5,5
2003,Kenya,KEN,Turkey,TUR,0,0,0,5,5
2003,Libya,LBY,Turkey,TUR,0,0,0,5,5
2003,Lebanon,LBN,Turkey,TUR,0,0,0,5,5
2003,Sri Lanka,LKA,Turkey,TUR,0,0,0,5,5
2003,Pakistan,PAK,Turkey,TUR,0,0,10,0,10
2003,Somalia,SOM,Turkey,TUR,21,0,5,26,52
2003,Sudan,SDN,Turkey,TUR,5,0,5,0,10
2003,Syrian Arab Rep.,SYR,Turkey,TUR,5,0,0,0,5
2003,Tunisia,TUN,Turkey,TUR,0,0,5,0,5
2003,Uzbekistan,UZB,Turkey,TUR,15,0,5,0,20
2003,Afghanistan,AFG,United Arab Emirates,ARE,0,0,0,16,16
2003,Palestinian,PSE,United Arab Emirates,ARE,0,0,0,33,33
2003,Iran (Islamic Rep. of),IRN,United Arab Emirates,ARE,0,0,5,0,5
2003,Iraq,IRQ,United Arab Emirates,ARE,0,0,0,68,68
2003,Libya,LBY,United Arab Emirates,ARE,0,0,0,10,10
2003,Mauritania,MRT,United Arab Emirates,ARE,0,0,5,0,5
2003,Qatar,QAT,United Arab Emirates,ARE,0,0,0,16,16
2003,Somalia,SOM,United Arab Emirates,ARE,0,0,11,16,27
2003,Sudan,SDN,United Arab Emirates,ARE,0,0,0,23,23
2003,Syrian Arab Rep.,SYR,United Arab Emirates,ARE,12,0,0,51,63
2003,Tajikistan,TJK,United Arab Emirates,ARE,0,0,10,0,10
2003,Uganda,UGA,United Arab Emirates,ARE,0,0,0,10,10
2003,Uzbekistan,UZB,United Arab Emirates,ARE,5,0,0,0,5
2003,Cameroon,CMR,Uruguay,URY,5,0,0,0,5
2003,Afghanistan,AFG,Uzbekistan,UZB,150,0,218,142,510
2003,Azerbaijan,AZE,Uzbekistan,UZB,5,0,5,5,15
2003,Stateless,XXA,Uzbekistan,UZB,0,0,0,5,5
2003,Eritrea,ERI,Yemen,YEM,15,0,34,16,65
2003,Ethiopia,ETH,Yemen,YEM,100,0,214,2022,2336
2003,Palestinian,PSE,Yemen,YEM,0,205,0,0,205
2003,Iraq,IRQ,Yemen,YEM,0,0,60,0,60
2003,Kenya,KEN,Yemen,YEM,0,0,5,0,5
2003,Viet Nam,VNM,Yemen,YEM,27,0,0,0,27
2003,Sudan,SDN,Yemen,YEM,0,0,23,5,28
2004,China,CHN,Afghanistan,AFG,0,0,0,5,5
2004,Indonesia,IDN,Afghanistan,AFG,0,0,5,0,5
2004,Iran (Islamic Rep. of),IRN,Afghanistan,AFG,11,0,25,36,72
2004,Iraq,IRQ,Afghanistan,AFG,0,0,10,28,38
2004,Pakistan,PAK,Afghanistan,AFG,5,0,5,0,10
2004,Cote d'Ivoire,CIV,Algeria,DZA,0,0,5,0,5
2004,Liberia,LBR,Algeria,DZA,0,0,0,18,18
2004,Algeria,DZA,Egypt,EGY,0,0,0,5,5
2004,Burundi,BDI,Egypt,EGY,19,0,0,0,19
2004,Chad,TCD,Egypt,EGY,0,0,0,14,14
2004,Cameroon,CMR,Egypt,EGY,0,0,5,5,10
2004,Congo,COG,Egypt,EGY,0,0,0,12,12
2004,Dem. Rep. of the Congo,COD,Egypt,EGY,5,0,17,14,36
2004,Djibouti,DJI,Egypt,EGY,0,0,0,10,10
2004,Eritrea,ERI,Egypt,EGY,80,0,47,169,296
2004,Ethiopia,ETH,Egypt,EGY,146,0,174,369,689
2004,Palestinian,PSE,Egypt,EGY,30,0,0,0,30
2004,Georgia,GEO,Egypt,EGY,0,0,0,5,5
2004,Cote d'Ivoire,CIV,Egypt,EGY,0,0,0,34,34
2004,Iraq,IRQ,Egypt,EGY,0,0,0,80,80
2004,Jordan,JOR,Egypt,EGY,0,0,5,5,10
2004,Myanmar,MMR,Egypt,EGY,0,0,0,5,5
2004,Nigeria,NGA,Egypt,EGY,5,0,5,5,15
2004,Russian Federation,RUS,Egypt,EGY,0,0,0,5,5
2004,Rwanda,RWA,Egypt,EGY,0,0,0,10,10
2004,Saudi Arabia,SAU,Egypt,EGY,0,0,0,5,5
2004,Sierra Leone,SLE,Egypt,EGY,5,0,10,0,15
2004,Somalia,SOM,Egypt,EGY,941,0,5,1052,1998
2004,Sudan,SDN,Egypt,EGY,2436,0,603,932,3971
2004,Syrian Arab Rep.,SYR,Egypt,EGY,0,0,5,11,16
2004,Tajikistan,TJK,Egypt,EGY,0,0,0,5,5
2004,Uganda,UGA,Egypt,EGY,0,0,0,10,10
2004,Ukraine,UKR,Egypt,EGY,0,0,0,5,5
2004,Zimbabwe,ZWE,Egypt,EGY,0,0,0,10,10
2004,Afghanistan,AFG,Azerbaijan,AZE,36,0,260,11,307
2004,Iran (Islamic Rep. of),IRN,Azerbaijan,AZE,14,0,22,0,36
2004,Iraq,IRQ,Azerbaijan,AZE,0,0,31,0,31
2004,Russian Federation,RUS,Azerbaijan,AZE,263,0,0,8088,8351
2004,Dem. Rep. of the Congo,COD,Burundi,BDI,17,0,0,0,17
2004,Rwanda,RWA,Burundi,BDI,19,0,0,0,19
2004,Bangladesh,BGD,Bosnia and Herzegovina,BIH,0,0,5,0,5
2004,Palestinian,PSE,Bosnia and Herzegovina,BIH,0,0,0,5,5
2004,Sri Lanka,LKA,Bosnia and Herzegovina,BIH,0,0,0,12,12
2004,North Macedonia,MKD,Bosnia and Herzegovina,BIH,0,0,73,0,73
2004,Rep. of Moldova,MDA,Bosnia and Herzegovina,BIH,5,0,0,5,10
2004,Romania,ROU,Bosnia and Herzegovina,BIH,0,0,5,0,5
2004,Serbia and Kosovo: S/RES/1244 (1999),SRB,Bosnia and Herzegovina,BIH,34,0,212,63,309
2004,Tunisia,TUN,Bosnia and Herzegovina,BIH,0,0,0,5,5
2004,China,CHN,Cambodia,KHM,5,0,0,0,5
2004,Dem. Rep. of the Congo,COD,Cambodia,KHM,5,0,0,0,5
2004,Liberia,LBR,Cambodia,KHM,0,0,0,5,5
2004,Viet Nam,VNM,Cambodia,KHM,407,0,184,19,610
2004,Burundi,BDI,China,CHN,0,5,5,0,10
2004,Dem. Rep. of the Congo,COD,China,CHN,0,0,0,5,5
2004,Cote d'Ivoire,CIV,China,CHN,5,0,0,0,5
2004,Iraq,IRQ,China,CHN,0,0,0,5,5
2004,Liberia,LBR,China,CHN,0,0,12,17,29
2004,Nigeria,NGA,China,CHN,0,0,10,0,10
2004,Pakistan,PAK,China,CHN,51,0,15,26,92
2004,Ethiopia,ETH,Cuba,CUB,10,0,0,0,10
2004,Ethiopia,ETH,Eritrea,ERI,5,0,0,0,5
2004,Algeria,DZA,Croatia,HRV,0,0,0,14,14
2004,Egypt,EGY,Croatia,HRV,0,0,0,5,5
2004,Cuba,CUB,Croatia,HRV,0,0,5,0,5
2004,India,IND,Croatia,HRV,0,0,0,10,10
2004,Iraq,IRQ,Croatia,HRV,0,0,0,5,5
2004,Liberia,LBR,Croatia,HRV,0,0,0,10,10
2004,Nigeria,NGA,Croatia,HRV,0,0,0,5,5
2004,Pakistan,PAK,Croatia,HRV,0,0,0,10,10
2004,Serbia and Kosovo: S/RES/1244 (1999),SRB,Croatia,HRV,5,0,0,5,10
2004,Turkey,TUR,Croatia,HRV,0,0,0,5,5
2004,Afghanistan,AFG,India,IND,93,0,44,12,149
2004,Congo,COG,India,IND,0,0,0,5,5
2004,Eritrea,ERI,India,IND,0,0,5,0,5
2004,Ethiopia,ETH,India,IND,5,0,16,13,34
2004,Iran (Islamic Rep. of),IRN,India,IND,0,0,10,5,15
2004,Iraq,IRQ,India,IND,0,0,0,5,5
2004,Israel,ISR,India,IND,0,0,0,5,5
2004,Myanmar,MMR,India,IND,277,0,201,97,575
2004,Somalia,SOM,India,IND,5,0,24,13,42
2004,Sudan,SDN,India,IND,0,0,16,12,28
2004,Afghanistan,AFG,Iran (Islamic Rep. of),IRN,0,0,22,0,22
2004,Pakistan,PAK,Iran (Islamic Rep. of),IRN,0,0,0,10,10
2004,Algeria,DZA,Jordan,JOR,0,0,0,5,5
2004,Egypt,EGY,Jordan,JOR,0,0,5,5,10
2004,Iraq,IRQ,Jordan,JOR,36,0,5,468,509
2004,Lebanon,LBN,Jordan,JOR,5,0,0,0,5
2004,Sri Lanka,LKA,Jordan,JOR,0,0,5,0,5
2004,Russian Federation,RUS,Jordan,JOR,0,0,0,5,5
2004,Saudi Arabia,SAU,Jordan,JOR,5,0,5,5,15
2004,Somalia,SOM,Jordan,JOR,14,0,0,12,26
2004,Sudan,SDN,Jordan,JOR,0,0,15,5,20
2004,Syrian Arab Rep.,SYR,Jordan,JOR,11,0,10,5,26
2004,Yemen,YEM,Jordan,JOR,0,0,0,5,5
2004,Stateless,XXA,Jordan,JOR,5,0,0,0,5
2004,Burundi,BDI,Kenya,KEN,171,0,47,0,218
2004,Dem. Rep. of the Congo,COD,Kenya,KEN,93,0,26,0,119
2004,Eritrea,ERI,Kenya,KEN,35,0,5,0,40
2004,Ethiopia,ETH,Kenya,KEN,293,0,213,0,506
2004,Cote d'Ivoire,CIV,Kenya,KEN,19,0,15,0,34
2004,Rwanda,RWA,Kenya,KEN,17,0,43,0,60
2004,Somalia,SOM,Kenya,KEN,2415,0,120,0,2535
2004,Sudan,SDN,Kenya,KEN,17,0,0,0,17
2004,Uganda,UGA,Kenya,KEN,35,0,28,0,63
2004,China,CHN,Kyrgyzstan,KGZ,0,0,0,10,10
2004,Afghanistan,AFG,Kuwait,KWT,0,0,0,5,5
2004,Chad,TCD,Libya,LBY,0,0,5,5,10
2004,Dem. Rep. of the Congo,COD,Libya,LBY,0,0,5,16,21
2004,Eritrea,ERI,Libya,LBY,10,0,0,47,57
2004,Ethiopia,ETH,Libya,LBY,0,0,5,35,40
2004,Cote d'Ivoire,CIV,Libya,LBY,0,21,0,10,31
2004,Liberia,LBR,Libya,LBY,0,0,0,5,5
2004,Sierra Leone,SLE,Libya,LBY,0,0,10,0,10
2004,Somalia,SOM,Libya,LBY,34,0,34,96,164
2004,Sudan,SDN,Libya,LBY,0,0,10,22,32
2004,United Rep. of Tanzania,TZA,Libya,LBY,0,0,5,0,5
2004,Cote d'Ivoire,CIV,Mauritania,MRT,13,0,5,0,18
2004,Liberia,LBR,Mauritania,MRT,37,0,0,0,37
2004,Dem. Rep. of the Congo,COD,Niger,NER,10,0,5,13,28
2004,Cote d'Ivoire,CIV,Niger,NER,5,0,0,5,10
2004,Cuba,CUB,Paraguay,PRY,10,0,0,0,10
2004,Burundi,BDI,Rwanda,RWA,10,0,0,0,10
2004,Dem. Rep. of the Congo,COD,Rwanda,RWA,25,0,0,0,25
2004,Afghanistan,AFG,Serbia and Kosovo: S/RES/1244 (1999),SRB,0,0,5,0,5
2004,Palestinian,PSE,Serbia and Kosovo: S/RES/1244 (1999),SRB,0,0,0,5,5
2004,India,IND,Serbia and Kosovo: S/RES/1244 (1999),SRB,0,0,0,5,5
2004,Iran (Islamic Rep. of),IRN,Serbia and Kosovo: S/RES/1244 (1999),SRB,0,0,0,5,5
2004,Iraq,IRQ,Serbia and Kosovo: S/RES/1244 (1999),SRB,5,0,0,0,5
2004,Mongolia,MNG,Serbia and Kosovo: S/RES/1244 (1999),SRB,0,0,5,0,5
2004,Niger,NER,Serbia and Kosovo: S/RES/1244 (1999),SRB,0,0,5,0,5
2004,Sierra Leone,SLE,Serbia and Kosovo: S/RES/1244 (1999),SRB,0,0,5,0,5
2004,China,CHN,Singapore,SGP,5,0,0,0,5
2004,Sri Lanka,LKA,Singapore,SGP,0,0,5,0,5
2004,Afghanistan,AFG,Turkmenistan,TKM,0,0,10,0,10
2004,Azerbaijan,AZE,Turkmenistan,TKM,17,0,0,0,17
2004,Unknown ,,Turkmenistan,TKM,0,0,5,0,5
2004,Dem. Rep. of the Congo,COD,Togo,TGO,33,0,25,5,63
2004,Cote d'Ivoire,CIV,Togo,TGO,25,0,0,0,25
2004,Liberia,LBR,Togo,TGO,5,0,0,0,5
2004,Rwanda,RWA,Togo,TGO,21,0,17,19,57
2004,Afghanistan,AFG,Turkey,TUR,27,0,28,0,55
2004,Algeria,DZA,Turkey,TUR,0,0,5,0,5
2004,Azerbaijan,AZE,Turkey,TUR,5,0,0,0,5
2004,China,CHN,Turkey,TUR,5,0,0,0,5
2004,Eritrea,ERI,Turkey,TUR,0,0,14,0,14
2004,Ethiopia,ETH,Turkey,TUR,5,0,27,0,32
2004,Palestinian,PSE,Turkey,TUR,0,0,10,0,10
2004,Iran (Islamic Rep. of),IRN,Turkey,TUR,1530,0,1340,0,2870
2004,Iraq,IRQ,Turkey,TUR,11,0,92,0,103
2004,Sri Lanka,LKA,Turkey,TUR,0,0,10,0,10
2004,Mauritania,MRT,Turkey,TUR,0,0,5,0,5
2004,Morocco,MAR,Turkey,TUR,5,0,5,0,10
2004,Pakistan,PAK,Turkey,TUR,0,0,5,0,5
2004,Sierra Leone,SLE,Turkey,TUR,0,0,5,0,5
2004,Somalia,SOM,Turkey,TUR,78,0,150,0,228
2004,Sudan,SDN,Turkey,TUR,5,0,37,0,42
2004,Syrian Arab Rep.,SYR,Turkey,TUR,5,0,0,0,5
2004,Uzbekistan,UZB,Turkey,TUR,12,0,0,0,12
2004,Iran (Islamic Rep. of),IRN,United Arab Emirates,ARE,0,0,0,10,10
2004,Somalia,SOM,United Arab Emirates,ARE,0,0,0,10,10
2004,Sudan,SDN,United Arab Emirates,ARE,0,0,0,5,5
2004,Syrian Arab Rep.,SYR,United Arab Emirates,ARE,20,0,5,10,35
2004,Afghanistan,AFG,Ukraine,UKR,10,0,30,0,40
2004,Armenia,ARM,Ukraine,UKR,0,0,5,0,5
2004,Bangladesh,BGD,Ukraine,UKR,0,0,10,0,10
2004,Ethiopia,ETH,Ukraine,UKR,5,0,5,0,10
2004,Guinea-Bissau,GNB,Ukraine,UKR,0,0,5,0,5
2004,Iran (Islamic Rep. of),IRN,Ukraine,UKR,10,0,10,0,20
2004,Iraq,IRQ,Ukraine,UKR,5,0,0,0,5
2004,Sri Lanka,LKA,Ukraine,UKR,0,0,5,0,5
2004,Nigeria,NGA,Ukraine,UKR,0,0,5,0,5
2004,Pakistan,PAK,Ukraine,UKR,0,0,15,0,15
2004,Russian Federation,RUS,Ukraine,UKR,5,0,10,0,15
2004,Somalia,SOM,Ukraine,UKR,5,0,0,0,5
2004,Syrian Arab Rep.,SYR,Ukraine,UKR,0,0,5,0,5
2004,Colombia,COL,Uruguay,URY,5,0,0,0,5
2004,Egypt,EGY,Yemen,YEM,0,0,0,21,21
2004,Djibouti,DJI,Yemen,YEM,0,0,0,10,10
2004,Eritrea,ERI,Yemen,YEM,16,0,10,46,72
2004,Ethiopia,ETH,Yemen,YEM,199,0,205,590,994
2004,Palestinian,PSE,Yemen,YEM,30,0,0,12,42
2004,Iraq,IRQ,Yemen,YEM,0,0,0,5,5
2004,Sudan,SDN,Yemen,YEM,0,0,47,130,177
2004,Syrian Arab Rep.,SYR,Yemen,YEM,11,0,0,20,31
2005,China,CHN,Afghanistan,AFG,0,0,0,5,5
2005,Iran (Islamic Rep. of),IRN,Afghanistan,AFG,5,0,0,24,29
2005,Iraq,IRQ,Afghanistan,AFG,0,0,0,5,5
2005,Pakistan,PAK,Afghanistan,AFG,0,0,5,0,5
2005,Afghanistan,AFG,Azerbaijan,AZE,0,0,0,752,752
2005,Algeria,DZA,Azerbaijan,AZE,0,0,0,5,5
2005,Palestinian,PSE,Azerbaijan,AZE,0,0,0,11,11
2005,Georgia,GEO,Azerbaijan,AZE,0,0,0,5,5
2005,Iran (Islamic Rep. of),IRN,Azerbaijan,AZE,0,0,0,230,230
2005,Iraq,IRQ,Azerbaijan,AZE,0,0,0,30,30
2005,Pakistan,PAK,Azerbaijan,AZE,0,0,0,53,53
2005,Russian Federation,RUS,Azerbaijan,AZE,123,513,0,0,636
2005,Tajikistan,TJK,Azerbaijan,AZE,0,0,0,5,5
2005,Turkmenistan,TKM,Azerbaijan,AZE,0,0,0,5,5
2005,Turkey,TUR,Azerbaijan,AZE,0,0,0,5,5
2005,Dem. Rep. of the Congo,COD,Burundi,BDI,21,0,0,0,21
2005,Rwanda,RWA,Burundi,BDI,5,0,0,0,5
2005,China,CHN,Cambodia,KHM,5,0,0,0,5
2005,Viet Nam,VNM,Cambodia,KHM,314,0,187,116,617
2005,Ecuador,ECU,Colombia,COL,10,0,0,0,10
2005,Venezuela (Bolivarian Republic of),VEN,Colombia,COL,5,0,0,0,5
2005,Colombia,COL,Cuba,CUB,5,0,0,0,5
2005,Algeria,DZA,"China, Hong Kong SAR",HKG,0,0,0,5,5
2005,Bangladesh,BGD,"China, Hong Kong SAR",HKG,0,0,0,5,5
2005,Cameroon,CMR,"China, Hong Kong SAR",HKG,0,0,0,24,24
2005,Congo,COG,"China, Hong Kong SAR",HKG,0,0,0,5,5
2005,Dem. Rep. of the Congo,COD,"China, Hong Kong SAR",HKG,0,0,0,5,5
2005,Ethiopia,ETH,"China, Hong Kong SAR",HKG,5,0,0,0,5
2005,Ghana,GHA,"China, Hong Kong SAR",HKG,0,0,10,15,25
2005,India,IND,"China, Hong Kong SAR",HKG,0,0,5,14,19
2005,Liberia,LBR,"China, Hong Kong SAR",HKG,5,0,5,5,15
2005,Sri Lanka,LKA,"China, Hong Kong SAR",HKG,5,0,32,84,121
2005,Nepal,NPL,"China, Hong Kong SAR",HKG,10,0,16,67,93
2005,Nigeria,NGA,"China, Hong Kong SAR",HKG,0,0,0,14,14
2005,Pakistan,PAK,"China, Hong Kong SAR",HKG,14,0,10,15,39
2005,Somalia,SOM,"China, Hong Kong SAR",HKG,26,0,0,0,26
2005,Viet Nam,VNM,"China, Hong Kong SAR",HKG,5,0,0,0,5
2005,Togo,TGO,"China, Hong Kong SAR",HKG,0,5,0,5,10
2005,Cote d'Ivoire,CIV,Croatia,HRV,0,0,0,5,5
2005,Serbia and Kosovo: S/RES/1244 (1999),SRB,Croatia,HRV,5,0,5,0,10
2005,Uzbekistan,UZB,Croatia,HRV,0,0,5,0,5
2005,Afghanistan,AFG,India,IND,232,0,23,10,265
2005,Congo,COG,India,IND,0,0,13,0,13
2005,Eritrea,ERI,India,IND,0,0,0,5,5
2005,Ethiopia,ETH,India,IND,0,0,10,5,15
2005,Iran (Islamic Rep. of),IRN,India,IND,5,0,11,0,16
2005,Myanmar,MMR,India,IND,338,0,44,10,392
2005,Rwanda,RWA,India,IND,0,0,5,0,5
2005,Somalia,SOM,India,IND,79,0,33,27,139
2005,Sudan,SDN,India,IND,0,0,15,12,27
2005,Afghanistan,AFG,Iran (Islamic Rep. of),IRN,0,0,34,43,77
2005,Iraq,IRQ,Iran (Islamic Rep. of),IRN,5,0,5,5,15
2005,Pakistan,PAK,Iran (Islamic Rep. of),IRN,0,0,0,10,10
2005,Uzbekistan,UZB,Iran (Islamic Rep. of),IRN,47,0,5,44,96
2005,Egypt,EGY,Jordan,JOR,0,0,15,0,15
2005,Dem. Rep. of the Congo,COD,Jordan,JOR,5,0,0,0,5
2005,Iraq,IRQ,Jordan,JOR,13,0,0,138,151
2005,Russian Federation,RUS,Jordan,JOR,10,0,0,0,10
2005,Somalia,SOM,Jordan,JOR,5,0,0,0,5
2005,Sudan,SDN,Jordan,JOR,0,0,12,5,17
2005,Syrian Arab Rep.,SYR,Jordan,JOR,10,0,0,10,20
2005,Stateless,XXA,Jordan,JOR,5,0,10,0,15
2005,China,CHN,Kazakhstan,KAZ,13,0,10,0,23
2005,Uzbekistan,UZB,Kazakhstan,KAZ,41,0,5,12,58
2005,Burundi,BDI,Kenya,KEN,573,0,11,5,589
2005,Dem. Rep. of the Congo,COD,Kenya,KEN,196,0,36,57,289
2005,Eritrea,ERI,Kenya,KEN,309,0,28,0,337
2005,Ethiopia,ETH,Kenya,KEN,1698,0,971,10,2679
2005,Liberia,LBR,Kenya,KEN,5,0,0,0,5
2005,Rwanda,RWA,Kenya,KEN,1254,0,120,0,1374
2005,Somalia,SOM,Kenya,KEN,13786,0,50,601,14437
2005,Sudan,SDN,Kenya,KEN,9890,0,5,0,9895
2005,Uganda,UGA,Kenya,KEN,2083,0,22,0,2105
2005,Afghanistan,AFG,Kyrgyzstan,KGZ,5,0,0,0,5
2005,China,CHN,Kyrgyzstan,KGZ,5,0,5,5,15
2005,Russian Federation,RUS,Kyrgyzstan,KGZ,5,0,0,0,5
2005,Uzbekistan,UZB,Kyrgyzstan,KGZ,472,0,0,50,522
2005,Congo,COG,Mauritania,MRT,12,0,5,10,27
2005,Dem. Rep. of the Congo,COD,Mauritania,MRT,21,0,5,0,26
2005,Cote d'Ivoire,CIV,Mauritania,MRT,75,0,15,23,113
2005,Liberia,LBR,Mauritania,MRT,20,0,10,16,46
2005,Sierra Leone,SLE,Mauritania,MRT,0,0,20,32,52
2005,Togo,TGO,Mauritania,MRT,24,0,5,5,34
2005,Unknown ,,Mauritania,MRT,0,0,5,10,15
2005,Dem. Rep. of the Congo,COD,Morocco,MAR,14,0,10,10,34
2005,Ghana,GHA,Morocco,MAR,0,0,14,16,30
2005,Guinea,GIN,Morocco,MAR,0,0,5,5,10
2005,Cote d'Ivoire,CIV,Morocco,MAR,10,0,0,0,10
2005,Liberia,LBR,Morocco,MAR,0,0,16,0,16
2005,Nigeria,NGA,Morocco,MAR,0,0,23,29,52
2005,Sierra Leone,SLE,Morocco,MAR,0,0,11,10,21
2005,Iraq,IRQ,Nepal,NPL,0,0,5,0,5
2005,Myanmar,MMR,Nepal,NPL,5,0,0,0,5
2005,Pakistan,PAK,Nepal,NPL,12,0,110,0,122
2005,Angola,AGO,Rwanda,RWA,0,0,0,5,5
2005,Burundi,BDI,Rwanda,RWA,257,0,75,534,866
2005,Dem. Rep. of the Congo,COD,Rwanda,RWA,754,0,287,818,1859
2005,Ethiopia,ETH,Rwanda,RWA,0,0,0,10,10
2005,Somalia,SOM,Rwanda,RWA,0,0,0,26,26
2005,Sudan,SDN,Rwanda,RWA,10,0,0,0,10
2005,Uganda,UGA,Rwanda,RWA,0,0,0,25,25
2005,Bangladesh,BGD,Serbia and Kosovo: S/RES/1244 (1999),SRB,0,0,16,10,26
2005,Georgia,GEO,Serbia and Kosovo: S/RES/1244 (1999),SRB,0,0,0,5,5
2005,India,IND,Serbia and Kosovo: S/RES/1244 (1999),SRB,0,0,10,0,10
2005,Iraq,IRQ,Serbia and Kosovo: S/RES/1244 (1999),SRB,0,0,0,5,5
2005,Sri Lanka,LKA,Serbia and Kosovo: S/RES/1244 (1999),SRB,0,0,0,5,5
2005,Pakistan,PAK,Serbia and Kosovo: S/RES/1244 (1999),SRB,0,0,5,0,5
2005,Russian Federation,RUS,Serbia and Kosovo: S/RES/1244 (1999),SRB,0,0,5,0,5
2005,Turkey,TUR,Serbia and Kosovo: S/RES/1244 (1999),SRB,10,0,0,5,15
2005,China,CHN,Singapore,SGP,5,0,5,0,10
2005,Egypt,EGY,Thailand,THA,0,0,5,0,5
2005,Cambodia,KHM,Thailand,THA,63,0,199,12,274
2005,China,CHN,Thailand,THA,28,0,28,11,67
2005,Cameroon,CMR,Thailand,THA,0,0,5,0,5
2005,Congo,COG,Thailand,THA,0,0,0,5,5
2005,Dem. Rep. of the Congo,COD,Thailand,THA,14,0,14,5,33
2005,Ethiopia,ETH,Thailand,THA,0,0,5,0,5
2005,Palestinian,PSE,Thailand,THA,5,0,0,5,10
2005,Guinea,GIN,Thailand,THA,0,0,0,5,5
2005,"China, Hong Kong SAR",HKG,Thailand,THA,0,0,5,0,5
2005,Cote d'Ivoire,CIV,Thailand,THA,5,0,5,0,10
2005,India,IND,Thailand,THA,5,0,5,10,20
2005,Indonesia,IDN,Thailand,THA,5,0,0,5,10
2005,Iran (Islamic Rep. of),IRN,Thailand,THA,10,0,17,10,37
2005,Iraq,IRQ,Thailand,THA,0,0,0,115,115
2005,Kenya,KEN,Thailand,THA,0,0,5,0,5
2005,Dem. People's Rep. of Korea,PRK,Thailand,THA,0,0,0,15,15
2005,Lao People's Dem. Rep.,LAO,Thailand,THA,136,0,23,60,219
2005,Liberia,LBR,Thailand,THA,0,0,0,28,28
2005,Sri Lanka,LKA,Thailand,THA,14,0,16,17,47
2005,Myanmar,MMR,Thailand,THA,309,0,38,109,456
2005,Nepal,NPL,Thailand,THA,37,0,22,18,77
2005,Nigeria,NGA,Thailand,THA,0,0,14,15,29
2005,Pakistan,PAK,Thailand,THA,0,0,0,5,5
2005,Sierra Leone,SLE,Thailand,THA,0,0,5,13,18
2005,Somalia,SOM,Thailand,THA,10,0,5,5,20
2005,Viet Nam,VNM,Thailand,THA,13,0,44,25,82
2005,Sudan,SDN,Thailand,THA,0,0,5,0,5
2005,Zimbabwe,ZWE,Thailand,THA,0,0,0,5,5
2005,Algeria,DZA,Tunisia,TUN,0,0,5,48,53
2005,Burkina Faso,BFA,Tunisia,TUN,0,0,0,5,5
2005,Dem. Rep. of the Congo,COD,Tunisia,TUN,0,0,0,5,5
2005,Cote d'Ivoire,CIV,Tunisia,TUN,0,0,0,11,11
2005,Iraq,IRQ,Tunisia,TUN,0,0,0,5,5
2005,Liberia,LBR,Tunisia,TUN,0,0,0,19,19
2005,Sierra Leone,SLE,Tunisia,TUN,0,0,0,5,5
2005,Afghanistan,AFG,Turkey,TUR,58,0,29,351,438
2005,Algeria,DZA,Turkey,TUR,0,0,0,10,10
2005,Burundi,BDI,Turkey,TUR,5,0,0,0,5
2005,China,CHN,Turkey,TUR,14,0,0,21,35
2005,Dem. Rep. of the Congo,COD,Turkey,TUR,0,0,0,5,5
2005,Eritrea,ERI,Turkey,TUR,5,0,0,12,17
2005,Ethiopia,ETH,Turkey,TUR,0,0,5,19,24
2005,Palestinian,PSE,Turkey,TUR,0,0,0,21,21
2005,Iran (Islamic Rep. of),IRN,Turkey,TUR,1106,0,307,288,1701
2005,Iraq,IRQ,Turkey,TUR,33,0,0,276,309
2005,Kyrgyzstan,KGZ,Turkey,TUR,5,0,0,5,10
2005,Sri Lanka,LKA,Turkey,TUR,0,0,0,5,5
2005,Morocco,MAR,Turkey,TUR,5,0,0,0,5
2005,Myanmar,MMR,Turkey,TUR,0,0,0,5,5
2005,Nigeria,NGA,Turkey,TUR,0,0,0,10,10
2005,Somalia,SOM,Turkey,TUR,82,0,16,152,250
2005,Sudan,SDN,Turkey,TUR,5,0,5,35,45
2005,Syrian Arab Rep.,SYR,Turkey,TUR,12,0,5,0,17
2005,Turkmenistan,TKM,Turkey,TUR,5,0,0,0,5
2005,Tunisia,TUN,Turkey,TUR,0,0,0,5,5
2005,Uzbekistan,UZB,Turkey,TUR,27,0,5,0,32
2005,Western Sahara,ESH,Turkey,TUR,0,0,0,5,5
2005,China,CHN,United Arab Emirates,ARE,0,0,0,5,5
2005,Iran (Islamic Rep. of),IRN,United Arab Emirates,ARE,0,0,0,5,5
2005,Iraq,IRQ,United Arab Emirates,ARE,0,0,0,10,10
2005,Somalia,SOM,United Arab Emirates,ARE,0,5,0,0,5
2005,Eritrea,ERI,Yemen,YEM,21,0,0,12,33
2005,Ethiopia,ETH,Yemen,YEM,251,70,189,938,1448
2005,Iraq,IRQ,Yemen,YEM,0,827,0,0,827
2005,Sudan,SDN,Yemen,YEM,0,10,13,65,88
2005,Syrian Arab Rep.,SYR,Yemen,YEM,0,0,0,19,19
2006,Iran (Islamic Rep. of),IRN,Afghanistan,AFG,0,0,0,5,5
2006,Pakistan,PAK,Afghanistan,AFG,0,0,5,5,10
2006,Dem. Rep. of the Congo,COD,Algeria,DZA,58,0,29,0,87
2006,Cote d'Ivoire,CIV,Algeria,DZA,10,0,0,0,10
2006,Libya,LBY,Algeria,DZA,0,0,0,5,5
2006,Eritrea,ERI,Egypt,EGY,88,0,96,0,184
2006,Ethiopia,ETH,Egypt,EGY,39,0,136,0,175
2006,Palestinian,PSE,Egypt,EGY,5,0,0,0,5
2006,Iraq,IRQ,Egypt,EGY,10,0,0,57,67
2006,Liberia,LBR,Egypt,EGY,0,0,5,0,5
2006,Somalia,SOM,Egypt,EGY,1082,0,11,0,1093
2006,Sudan,SDN,Egypt,EGY,40,0,49,114,203
2006,Afghanistan,AFG,Azerbaijan,AZE,10,0,0,0,10
2006,Russian Federation,RUS,Azerbaijan,AZE,366,0,0,0,366
2006,Dem. Rep. of the Congo,COD,Burundi,BDI,68,0,0,0,68
2006,Ethiopia,ETH,Burundi,BDI,0,0,0,5,5
2006,Rwanda,RWA,Burundi,BDI,0,0,0,51,51
2006,Uganda,UGA,Burundi,BDI,0,0,0,10,10
2006,Liberia,LBR,Bangladesh,BGD,0,0,0,5,5
2006,Myanmar,MMR,Bangladesh,BGD,0,0,0,14,14
2006,Dem. Rep. of the Congo,COD,Cambodia,KHM,5,0,0,0,5
2006,Myanmar,MMR,Cambodia,KHM,5,0,0,0,5
2006,Somalia,SOM,Cambodia,KHM,10,0,0,0,10
2006,Viet Nam,VNM,Cambodia,KHM,43,0,187,18,248
2006,Iran (Islamic Rep. of),IRN,Cyprus,CYP,0,0,5,0,5
2006,Iraq,IRQ,Cyprus,CYP,5,0,0,5,10
2006,Eritrea,ERI,Djibouti,DJI,10,0,0,0,10
2006,Ethiopia,ETH,Djibouti,DJI,5,0,0,0,5
2006,Somalia,SOM,Djibouti,DJI,10,0,0,0,10
2006,Bangladesh,BGD,"China, Hong Kong SAR",HKG,0,0,21,140,161
2006,Cameroon,CMR,"China, Hong Kong SAR",HKG,0,0,0,5,5
2006,Congo,COG,"China, Hong Kong SAR",HKG,0,0,10,0,10
2006,Dem. Rep. of the Congo,COD,"China, Hong Kong SAR",HKG,0,0,5,0,5
2006,Ethiopia,ETH,"China, Hong Kong SAR",HKG,5,0,0,0,5
2006,Ghana,GHA,"China, Hong Kong SAR",HKG,0,0,51,28,79
2006,Guinea,GIN,"China, Hong Kong SAR",HKG,0,0,5,0,5
2006,India,IND,"China, Hong Kong SAR",HKG,0,0,96,200,296
2006,Indonesia,IDN,"China, Hong Kong SAR",HKG,0,0,5,5,10
2006,Liberia,LBR,"China, Hong Kong SAR",HKG,0,0,10,0,10
2006,Sri Lanka,LKA,"China, Hong Kong SAR",HKG,17,0,133,114,264
2006,Nepal,NPL,"China, Hong Kong SAR",HKG,5,0,28,12,45
2006,Nigeria,NGA,"China, Hong Kong SAR",HKG,0,0,29,15,44
2006,Pakistan,PAK,"China, Hong Kong SAR",HKG,5,0,95,117,217
2006,Philippines,PHL,"China, Hong Kong SAR",HKG,0,0,5,5,10
2006,Somalia,SOM,"China, Hong Kong SAR",HKG,13,0,5,0,18
2006,Togo,TGO,"China, Hong Kong SAR",HKG,0,0,21,5,26
2006,Afghanistan,AFG,India,IND,75,0,91,43,209
2006,Dem. Rep. of the Congo,COD,India,IND,0,0,5,5,10
2006,Eritrea,ERI,India,IND,0,0,5,5,10
2006,Ethiopia,ETH,India,IND,0,0,0,5,5
2006,Palestinian,PSE,India,IND,55,0,0,28,83
2006,Iran (Islamic Rep. of),IRN,India,IND,5,0,14,12,31
2006,Iraq,IRQ,India,IND,5,0,0,10,15
2006,Liberia,LBR,India,IND,0,0,0,5,5
2006,Myanmar,MMR,India,IND,311,0,68,83,462
2006,Somalia,SOM,India,IND,43,0,16,5,64
2006,Sudan,SDN,India,IND,5,0,5,5,15
2006,Afghanistan,AFG,Iran (Islamic Rep. of),IRN,11,10,36,81,138
2006,Iraq,IRQ,Iran (Islamic Rep. of),IRN,33,0,10,21,64
2006,Pakistan,PAK,Iran (Islamic Rep. of),IRN,0,0,0,11,11
2006,Tajikistan,TJK,Iran (Islamic Rep. of),IRN,0,0,0,13,13
2006,Uzbekistan,UZB,Iran (Islamic Rep. of),IRN,37,0,5,11,53
2006,Iran (Islamic Rep. of),IRN,Iraq,IRQ,0,0,0,45,45
2006,Syrian Arab Rep.,SYR,Iraq,IRQ,0,0,0,83,83
2006,Turkey,TUR,Iraq,IRQ,0,0,0,120,120
2006,Egypt,EGY,Jordan,JOR,5,0,10,10,25
2006,Ethiopia,ETH,Jordan,JOR,0,0,0,5,5
2006,Iran (Islamic Rep. of),IRN,Jordan,JOR,0,0,0,5,5
2006,Iraq,IRQ,Jordan,JOR,121,0,314,1514,1949
2006,Russian Federation,RUS,Jordan,JOR,5,0,0,5,10
2006,Saudi Arabia,SAU,Jordan,JOR,0,0,5,0,5
2006,Somalia,SOM,Jordan,JOR,5,0,5,5,15
2006,Sudan,SDN,Jordan,JOR,5,0,56,18,79
2006,Syrian Arab Rep.,SYR,Jordan,JOR,15,0,10,20,45
2006,Tunisia,TUN,Jordan,JOR,0,0,0,5,5
2006,Stateless,XXA,Jordan,JOR,26,0,0,0,26
2006,Burundi,BDI,Kenya,KEN,23,0,18,10,51
2006,Dem. Rep. of the Congo,COD,Kenya,KEN,129,0,45,22,196
2006,Eritrea,ERI,Kenya,KEN,132,0,38,20,190
2006,Ethiopia,ETH,Kenya,KEN,589,0,1376,871,2836
2006,Rwanda,RWA,Kenya,KEN,60,0,113,23,196
2006,Somalia,SOM,Kenya,KEN,17718,0,32,9821,27571
2006,Sudan,SDN,Kenya,KEN,4092,0,5,56,4153
2006,United Rep. of Tanzania,TZA,Kenya,KEN,0,0,5,0,5
2006,Uganda,UGA,Kenya,KEN,29,0,89,17,135
2006,Afghanistan,AFG,Kuwait,KWT,0,0,5,0,5
2006,Egypt,EGY,Kuwait,KWT,0,0,0,5,5
2006,China,CHN,Kuwait,KWT,0,0,0,5,5
2006,Iraq,IRQ,Kuwait,KWT,13,0,0,0,13
2006,Libya,LBY,Kuwait,KWT,0,0,0,5,5
2006,Sierra Leone,SLE,Kuwait,KWT,0,0,0,5,5
2006,Somalia,SOM,Kuwait,KWT,0,0,0,32,32
2006,Sudan,SDN,Kuwait,KWT,0,0,0,10,10
2006,Syrian Arab Rep.,SYR,Kuwait,KWT,0,0,0,5,5
2006,Egypt,EGY,Lebanon,LBN,0,0,10,0,10
2006,Ethiopia,ETH,Lebanon,LBN,0,0,5,0,5
2006,Iran (Islamic Rep. of),IRN,Lebanon,LBN,0,0,5,0,5
2006,Iraq,IRQ,Lebanon,LBN,93,48,332,22,495
2006,Somalia,SOM,Lebanon,LBN,5,10,14,0,29
2006,Sudan,SDN,Lebanon,LBN,0,5,89,16,110
2006,Syrian Arab Rep.,SYR,Lebanon,LBN,10,0,5,0,15
2006,Serbia and Kosovo: S/RES/1244 (1999),SRB,Montenegro,MNE,0,0,0,5,5
2006,Iraq,IRQ,Nepal,NPL,5,0,0,0,5
2006,Liberia,LBR,Nepal,NPL,0,0,5,11,16
2006,Pakistan,PAK,Nepal,NPL,55,10,45,0,110
2006,Somalia,SOM,Nepal,NPL,49,0,0,0,49
2006,Uganda,UGA,Rwanda,RWA,14,0,0,0,14
2006,China,CHN,Saudi Arabia,SAU,5,0,0,0,5
2006,Eritrea,ERI,Saudi Arabia,SAU,0,0,10,0,10
2006,Somalia,SOM,Saudi Arabia,SAU,0,0,5,0,5
2006,Sudan,SDN,Saudi Arabia,SAU,5,0,0,0,5
2006,Tunisia,TUN,Saudi Arabia,SAU,5,0,0,0,5
2006,Yemen,YEM,Saudi Arabia,SAU,0,0,5,0,5
2006,Egypt,EGY,Serbia and Kosovo: S/RES/1244 (1999),SRB,0,0,5,0,5
2006,India,IND,Serbia and Kosovo: S/RES/1244 (1999),SRB,0,0,5,0,5
2006,Iraq,IRQ,Serbia and Kosovo: S/RES/1244 (1999),SRB,0,0,0,20,20
2006,Rep. of Moldova,MDA,Serbia and Kosovo: S/RES/1244 (1999),SRB,0,0,5,0,5
2006,Mongolia,MNG,Serbia and Kosovo: S/RES/1244 (1999),SRB,0,0,5,0,5
2006,Dem. Rep. of the Congo,COD,Sierra Leone,SLE,0,0,0,5,5
2006,Cote d'Ivoire,CIV,Sierra Leone,SLE,41,0,10,0,51
2006,Liberia,LBR,Sierra Leone,SLE,26,0,55,50,131
2006,Afghanistan,AFG,Syrian Arab Rep.,SYR,25,0,0,0,25
2006,Chad,TCD,Syrian Arab Rep.,SYR,0,0,5,0,5
2006,Eritrea,ERI,Syrian Arab Rep.,SYR,5,0,0,0,5
2006,Ethiopia,ETH,Syrian Arab Rep.,SYR,5,0,0,0,5
2006,Iran (Islamic Rep. of),IRN,Syrian Arab Rep.,SYR,143,0,13,0,156
2006,Kenya,KEN,Syrian Arab Rep.,SYR,5,0,0,0,5
2006,Somalia,SOM,Syrian Arab Rep.,SYR,744,0,20,0,764
2006,Sudan,SDN,Syrian Arab Rep.,SYR,42,0,16,0,58
2006,Stateless,XXA,Syrian Arab Rep.,SYR,10,0,0,0,10
2006,Bangladesh,BGD,Thailand,THA,5,0,0,0,5
2006,Cambodia,KHM,Thailand,THA,36,0,83,5,124
2006,China,CHN,Thailand,THA,54,0,10,12,76
2006,Dem. Rep. of the Congo,COD,Thailand,THA,12,0,22,5,39
2006,Cote d'Ivoire,CIV,Thailand,THA,5,0,5,0,10
2006,India,IND,Thailand,THA,0,0,5,5,10
2006,Iran (Islamic Rep. of),IRN,Thailand,THA,0,0,10,0,10
2006,Iraq,IRQ,Thailand,THA,5,0,0,0,5
2006,Lao People's Dem. Rep.,LAO,Thailand,THA,214,0,0,5,219
2006,Liberia,LBR,Thailand,THA,0,0,0,5,5
2006,Sri Lanka,LKA,Thailand,THA,40,0,24,11,75
2006,Myanmar,MMR,Thailand,THA,14,0,0,0,14
2006,Nepal,NPL,Thailand,THA,34,0,29,15,78
2006,Nigeria,NGA,Thailand,THA,0,0,18,5,23
2006,Pakistan,PAK,Thailand,THA,0,0,5,0,5
2006,Sierra Leone,SLE,Thailand,THA,0,0,5,0,5
2006,Viet Nam,VNM,Thailand,THA,71,0,24,10,105
2006,Uganda,UGA,Thailand,THA,0,0,5,0,5
2006,Afghanistan,AFG,Turkmenistan,TKM,0,0,10,0,10
2006,Azerbaijan,AZE,Turkmenistan,TKM,5,0,0,0,5
2006,Afghanistan,AFG,Turkey,TUR,23,0,56,130,209
2006,Azerbaijan,AZE,Turkey,TUR,5,0,0,0,5
2006,China,CHN,Turkey,TUR,0,0,0,21,21
2006,Dem. Rep. of the Congo,COD,Turkey,TUR,0,0,0,5,5
2006,Eritrea,ERI,Turkey,TUR,5,0,5,0,10
2006,Ethiopia,ETH,Turkey,TUR,0,0,5,19,24
2006,Palestinian,PSE,Turkey,TUR,10,0,5,11,26
2006,Cote d'Ivoire,CIV,Turkey,TUR,0,0,0,5,5
2006,Iran (Islamic Rep. of),IRN,Turkey,TUR,1373,0,293,213,1879
2006,Iraq,IRQ,Turkey,TUR,36,0,0,318,354
2006,Kazakhstan,KAZ,Turkey,TUR,0,0,5,0,5
2006,Liberia,LBR,Turkey,TUR,0,0,0,5,5
2006,Libya,LBY,Turkey,TUR,0,0,0,5,5
2006,Lebanon,LBN,Turkey,TUR,0,0,0,5,5
2006,Sri Lanka,LKA,Turkey,TUR,0,0,0,10,10
2006,Mauritania,MRT,Turkey,TUR,0,0,5,21,26
2006,Nigeria,NGA,Turkey,TUR,0,0,5,0,5
2006,Sierra Leone,SLE,Turkey,TUR,0,0,0,5,5
2006,Somalia,SOM,Turkey,TUR,108,0,110,303,521
2006,Sudan,SDN,Turkey,TUR,10,0,13,54,77
2006,Syrian Arab Rep.,SYR,Turkey,TUR,0,0,0,5,5
2006,Turkmenistan,TKM,Turkey,TUR,0,0,5,0,5
2006,Uzbekistan,UZB,Turkey,TUR,5,0,0,0,5
2006,Afghanistan,AFG,Uzbekistan,UZB,0,0,0,534,534
2006,Armenia,ARM,Uzbekistan,UZB,0,0,0,5,5
2006,Palestinian,PSE,Uzbekistan,UZB,0,0,0,5,5
2006,Iraq,IRQ,Uzbekistan,UZB,0,0,0,5,5
2006,Syrian Arab Rep.,SYR,Uzbekistan,UZB,0,0,0,10,10
2006,Tajikistan,TJK,Uzbekistan,UZB,0,0,0,5,5
2006,Turkmenistan,TKM,Uzbekistan,UZB,0,0,0,5,5
2006,Stateless,XXA,Uzbekistan,UZB,0,0,0,12,12
2007,Iran (Islamic Rep. of),IRN,Afghanistan,AFG,5,0,0,5,10
2007,Iraq,IRQ,Afghanistan,AFG,5,0,0,0,5
2007,Russian Federation,RUS,Afghanistan,AFG,0,0,0,5,5
2007,Chad,TCD,Algeria,DZA,0,0,10,0,10
2007,Cameroon,CMR,Algeria,DZA,0,0,32,0,32
2007,Congo,COG,Algeria,DZA,0,0,10,0,10
2007,Dem. Rep. of the Congo,COD,Algeria,DZA,0,0,43,0,43
2007,Cote d'Ivoire,CIV,Algeria,DZA,0,0,13,0,13
2007,Niger,NER,Algeria,DZA,0,0,5,0,5
2007,Burundi,BDI,Egypt,EGY,5,0,0,0,5
2007,Chad,TCD,Egypt,EGY,5,0,5,0,10
2007,Dem. Rep. of the Congo,COD,Egypt,EGY,5,0,0,0,5
2007,Eritrea,ERI,Egypt,EGY,123,0,145,5,273
2007,Ethiopia,ETH,Egypt,EGY,13,0,126,5,144
2007,Palestinian,PSE,Egypt,EGY,13,0,0,5,18
2007,Cote d'Ivoire,CIV,Egypt,EGY,45,0,5,12,62
2007,Iraq,IRQ,Egypt,EGY,19,0,0,0,19
2007,Liberia,LBR,Egypt,EGY,0,0,5,0,5
2007,Somalia,SOM,Egypt,EGY,912,0,11,0,923
2007,Sudan,SDN,Egypt,EGY,92,0,20,708,820
2007,Tunisia,TUN,Egypt,EGY,5,0,0,0,5
2007,Uzbekistan,UZB,Egypt,EGY,0,0,5,0,5
2007,Afghanistan,AFG,Azerbaijan,AZE,10,0,0,0,10
2007,Iran (Islamic Rep. of),IRN,Azerbaijan,AZE,5,0,0,0,5
2007,Iraq,IRQ,Azerbaijan,AZE,22,0,0,0,22
2007,Russian Federation,RUS,Azerbaijan,AZE,254,0,0,0,254
2007,Dem. Rep. of the Congo,COD,Burundi,BDI,0,0,10,0,10
2007,Rwanda,RWA,Burundi,BDI,0,0,0,28,28
2007,Afghanistan,AFG,Belarus,BLR,5,0,0,10,15
2007,Dem. People's Rep. of Korea,PRK,Cambodia,KHM,0,0,0,5,5
2007,Myanmar,MMR,Cambodia,KHM,5,0,0,0,5
2007,Nepal,NPL,Cambodia,KHM,0,0,5,0,5
2007,Somalia,SOM,Cambodia,KHM,5,0,0,0,5
2007,Viet Nam,VNM,Cambodia,KHM,100,0,148,24,272
2007,Palestinian,PSE,Cyprus,CYP,5,0,0,0,5
2007,Iran (Islamic Rep. of),IRN,Cyprus,CYP,0,0,5,5,10
2007,Iraq,IRQ,Cyprus,CYP,0,0,0,20,20
2007,Bangladesh,BGD,"China, Hong Kong SAR",HKG,0,0,148,234,382
2007,Congo,COG,"China, Hong Kong SAR",HKG,0,0,5,0,5
2007,Dem. Rep. of the Congo,COD,"China, Hong Kong SAR",HKG,0,0,5,0,5
2007,Ghana,GHA,"China, Hong Kong SAR",HKG,0,0,15,17,32
2007,India,IND,"China, Hong Kong SAR",HKG,0,0,179,250,429
2007,Indonesia,IDN,"China, Hong Kong SAR",HKG,0,0,5,18,23
2007,Sri Lanka,LKA,"China, Hong Kong SAR",HKG,5,0,32,164,201
2007,Nepal,NPL,"China, Hong Kong SAR",HKG,0,0,76,43,119
2007,Nigeria,NGA,"China, Hong Kong SAR",HKG,0,0,13,15,28
2007,Pakistan,PAK,"China, Hong Kong SAR",HKG,0,0,345,371,716
2007,Philippines,PHL,"China, Hong Kong SAR",HKG,0,0,50,18,68
2007,Somalia,SOM,"China, Hong Kong SAR",HKG,10,0,0,0,10
2007,Togo,TGO,"China, Hong Kong SAR",HKG,0,0,13,5,18
2007,Afghanistan,AFG,India,IND,73,0,215,33,321
2007,Dem. Rep. of the Congo,COD,India,IND,0,0,10,0,10
2007,Eritrea,ERI,India,IND,0,0,10,0,10
2007,Ethiopia,ETH,India,IND,0,0,5,0,5
2007,Palestinian,PSE,India,IND,165,0,0,0,165
2007,Iran (Islamic Rep. of),IRN,India,IND,5,0,5,0,10
2007,Iraq,IRQ,India,IND,41,0,0,0,41
2007,Myanmar,MMR,India,IND,343,0,33,19,395
2007,Somalia,SOM,India,IND,95,0,10,5,110
2007,Sudan,SDN,India,IND,5,0,0,0,5
2007,Syrian Arab Rep.,SYR,India,IND,5,0,0,0,5
2007,Afghanistan,AFG,Iran (Islamic Rep. of),IRN,5,5,164,155,329
2007,Iraq,IRQ,Iran (Islamic Rep. of),IRN,0,0,0,149,149
2007,Kyrgyzstan,KGZ,Iran (Islamic Rep. of),IRN,0,0,0,5,5
2007,Pakistan,PAK,Iran (Islamic Rep. of),IRN,5,0,5,31,41
2007,Tajikistan,TJK,Iran (Islamic Rep. of),IRN,0,0,0,5,5
2007,Burundi,BDI,Kenya,KEN,58,0,28,40,126
2007,Dem. Rep. of the Congo,COD,Kenya,KEN,246,0,24,311,581
2007,Eritrea,ERI,Kenya,KEN,67,0,5,26,98
2007,Ethiopia,ETH,Kenya,KEN,1197,0,542,2513,4252
2007,Sri Lanka,LKA,Kenya,KEN,0,0,0,5,5
2007,Namibia,NAM,Kenya,KEN,0,0,0,5,5
2007,Pakistan,PAK,Kenya,KEN,0,0,0,5,5
2007,Rwanda,RWA,Kenya,KEN,95,0,72,92,259
2007,Somalia,SOM,Kenya,KEN,1102,0,109,24037,25248
2007,Sudan,SDN,Kenya,KEN,173,0,329,66,568
2007,United Rep. of Tanzania,TZA,Kenya,KEN,0,0,0,10,10
2007,Uganda,UGA,Kenya,KEN,19,0,96,316,431
2007,Afghanistan,AFG,Kuwait,KWT,5,0,0,27,32
2007,Dominican Rep.,DOM,Kuwait,KWT,0,0,0,5,5
2007,Iran (Islamic Rep. of),IRN,Kuwait,KWT,23,0,0,0,23
2007,Iraq,IRQ,Kuwait,KWT,94,0,0,80,174
2007,Somalia,SOM,Kuwait,KWT,0,0,0,5,5
2007,Sudan,SDN,Kuwait,KWT,0,0,0,5,5
2007,Afghanistan,AFG,Lebanon,LBN,0,5,0,0,5
2007,Egypt,EGY,Lebanon,LBN,0,0,5,0,5
2007,Bangladesh,BGD,Lebanon,LBN,0,0,5,0,5
2007,Ethiopia,ETH,Lebanon,LBN,0,0,5,0,5
2007,Iran (Islamic Rep. of),IRN,Lebanon,LBN,5,0,0,0,5
2007,Iraq,IRQ,Lebanon,LBN,23,2268,10,55,2356
2007,Somalia,SOM,Lebanon,LBN,5,5,10,0,20
2007,Sudan,SDN,Lebanon,LBN,25,10,216,10,261
2007,Syrian Arab Rep.,SYR,Lebanon,LBN,18,5,34,5,62
2007,Stateless,XXA,Lebanon,LBN,5,0,0,0,5
2007,Afghanistan,AFG,Malaysia,MYS,23,0,0,0,23
2007,Bangladesh,BGD,Malaysia,MYS,0,0,48,27,75
2007,Cambodia,KHM,Malaysia,MYS,5,0,121,0,126
2007,China,CHN,Malaysia,MYS,19,0,5,5,29
2007,Cameroon,CMR,Malaysia,MYS,0,0,21,0,21
2007,Dem. Rep. of the Congo,COD,Malaysia,MYS,5,0,0,0,5
2007,Eritrea,ERI,Malaysia,MYS,5,0,0,0,5
2007,Palestinian,PSE,Malaysia,MYS,48,0,0,0,48
2007,Ghana,GHA,Malaysia,MYS,0,0,5,0,5
2007,Guinea,GIN,Malaysia,MYS,0,0,10,0,10
2007,Cote d'Ivoire,CIV,Malaysia,MYS,5,0,13,0,18
2007,India,IND,Malaysia,MYS,0,0,10,5,15
2007,Indonesia,IDN,Malaysia,MYS,41,0,26,376,443
2007,Iran (Islamic Rep. of),IRN,Malaysia,MYS,11,0,0,5,16
2007,Iraq,IRQ,Malaysia,MYS,149,0,0,0,149
2007,Liberia,LBR,Malaysia,MYS,5,0,111,0,116
2007,Sri Lanka,LKA,Malaysia,MYS,271,0,45,93,409
2007,Myanmar,MMR,Malaysia,MYS,13470,0,205,607,14282
2007,Nepal,NPL,Malaysia,MYS,0,0,49,58,107
2007,Nigeria,NGA,Malaysia,MYS,0,0,26,0,26
2007,Pakistan,PAK,Malaysia,MYS,10,0,16,0,26
2007,Somalia,SOM,Malaysia,MYS,61,0,0,5,66
2007,Viet Nam,VNM,Malaysia,MYS,0,0,31,0,31
2007,Sudan,SDN,Malaysia,MYS,11,0,10,0,21
2007,Syrian Arab Rep.,SYR,Malaysia,MYS,5,0,0,0,5
2007,Thailand,THA,Malaysia,MYS,0,0,0,26,26
2007,Tunisia,TUN,Malaysia,MYS,0,0,0,5,5
2007,China,CHN,Mongolia,MNG,0,0,0,5,5
2007,Angola,AGO,Morocco,MAR,0,0,5,0,5
2007,Benin,BEN,Morocco,MAR,0,0,5,5,10
2007,Chad,TCD,Morocco,MAR,0,0,5,5,10
2007,Cameroon,CMR,Morocco,MAR,0,0,15,18,33
2007,Congo,COG,Morocco,MAR,5,0,33,5,43
2007,Dem. Rep. of the Congo,COD,Morocco,MAR,88,0,267,114,469
2007,Gambia,GMB,Morocco,MAR,0,0,11,22,33
2007,Palestinian,PSE,Morocco,MAR,0,0,0,5,5
2007,Ghana,GHA,Morocco,MAR,0,0,25,70,95
2007,Guinea,GIN,Morocco,MAR,0,0,12,10,22
2007,Cote d'Ivoire,CIV,Morocco,MAR,86,0,23,71,180
2007,Iraq,IRQ,Morocco,MAR,99,0,0,11,110
2007,Liberia,LBR,Morocco,MAR,0,0,30,5,35
2007,Mauritania,MRT,Morocco,MAR,5,0,0,0,5
2007,Mali,MLI,Morocco,MAR,0,0,0,12,12
2007,Niger,NER,Morocco,MAR,0,0,10,0,10
2007,Nigeria,NGA,Morocco,MAR,0,0,309,173,482
2007,Rwanda,RWA,Morocco,MAR,0,0,5,5,10
2007,Sierra Leone,SLE,Morocco,MAR,0,0,15,73,88
2007,Somalia,SOM,Morocco,MAR,0,0,0,10,10
2007,Sudan,SDN,Morocco,MAR,0,0,5,5,10
2007,Uganda,UGA,Morocco,MAR,0,0,5,12,17
2007,Zimbabwe,ZWE,Morocco,MAR,0,0,0,5,5
2007,Bosnia and Herzegovina,BIH,Montenegro,MNE,0,0,0,5,5
2007,Serbia and Kosovo: S/RES/1244 (1999),SRB,Montenegro,MNE,0,0,0,5,5
2007,Liberia,LBR,Nepal,NPL,0,0,0,5,5
2007,Nigeria,NGA,Nepal,NPL,0,0,5,5,10
2007,Pakistan,PAK,Nepal,NPL,5,0,20,10,35
2007,Somalia,SOM,Nepal,NPL,10,0,5,26,41
2007,Ethiopia,ETH,Saudi Arabia,SAU,0,0,15,0,15
2007,Somalia,SOM,Saudi Arabia,SAU,0,0,15,0,15
2007,Sudan,SDN,Saudi Arabia,SAU,0,0,12,0,12
2007,Cameroon,CMR,Serbia and Kosovo: S/RES/1244 (1999),SRB,5,0,0,0,5
2007,Georgia,GEO,Serbia and Kosovo: S/RES/1244 (1999),SRB,0,0,0,10,10
2007,Iraq,IRQ,Serbia and Kosovo: S/RES/1244 (1999),SRB,5,0,0,0,5
2007,Pakistan,PAK,Serbia and Kosovo: S/RES/1244 (1999),SRB,0,0,0,5,5
2007,Cambodia,KHM,Singapore,SGP,5,0,5,0,10
2007,Cote d'Ivoire,CIV,Singapore,SGP,0,0,0,5,5
2007,Iraq,IRQ,Singapore,SGP,5,0,0,0,5
2007,Sri Lanka,LKA,Singapore,SGP,0,0,0,5,5
2007,Myanmar,MMR,Singapore,SGP,5,0,0,0,5
2007,Cote d'Ivoire,CIV,Sierra Leone,SLE,0,5,0,0,5
2007,Afghanistan,AFG,Syrian Arab Rep.,SYR,27,0,0,0,27
2007,Ethiopia,ETH,Syrian Arab Rep.,SYR,0,0,5,0,5
2007,Iran (Islamic Rep. of),IRN,Syrian Arab Rep.,SYR,106,0,24,0,130
2007,Jordan,JOR,Syrian Arab Rep.,SYR,0,0,5,0,5
2007,Liberia,LBR,Syrian Arab Rep.,SYR,0,0,0,5,5
2007,Somalia,SOM,Syrian Arab Rep.,SYR,1047,0,51,0,1098
2007,Sudan,SDN,Syrian Arab Rep.,SYR,24,0,24,0,48
2007,Syrian Arab Rep.,SYR,Syrian Arab Rep.,SYR,0,0,0,5,5
2007,Stateless,XXA,Syrian Arab Rep.,SYR,5,0,0,0,5
2007,Cambodia,KHM,Thailand,THA,25,0,37,17,79
2007,China,CHN,Thailand,THA,91,0,15,5,111
2007,Cameroon,CMR,Thailand,THA,0,0,5,0,5
2007,Dem. Rep. of the Congo,COD,Thailand,THA,15,0,10,5,30
2007,Ethiopia,ETH,Thailand,THA,0,0,5,0,5
2007,Palestinian,PSE,Thailand,THA,39,0,0,13,52
2007,Cote d'Ivoire,CIV,Thailand,THA,5,0,0,0,5
2007,India,IND,Thailand,THA,0,0,5,0,5
2007,Iran (Islamic Rep. of),IRN,Thailand,THA,5,0,0,13,18
2007,Iraq,IRQ,Thailand,THA,31,0,0,5,36
2007,Lao People's Dem. Rep.,LAO,Thailand,THA,66,0,0,5,71
2007,Sri Lanka,LKA,Thailand,THA,146,0,5,27,178
2007,Myanmar,MMR,Thailand,THA,5,0,0,0,5
2007,Nepal,NPL,Thailand,THA,14,0,18,11,43
2007,Nigeria,NGA,Thailand,THA,0,0,5,5,10
2007,Pakistan,PAK,Thailand,THA,0,0,0,5,5
2007,Somalia,SOM,Thailand,THA,24,0,0,0,24
2007,Viet Nam,VNM,Thailand,THA,10,0,22,5,37
2007,Zimbabwe,ZWE,Thailand,THA,5,0,0,0,5
2007,Senegal,SEN,Trinidad and Tobago,TTO,0,0,5,0,5
2007,Afghanistan,AFG,Turkey,TUR,149,0,19,187,355
2007,China,CHN,Turkey,TUR,5,0,0,22,27
2007,Dem. Rep. of the Congo,COD,Turkey,TUR,5,0,16,17,38
2007,Eritrea,ERI,Turkey,TUR,12,0,5,42,59
2007,Ethiopia,ETH,Turkey,TUR,5,0,18,34,57
2007,Palestinian,PSE,Turkey,TUR,13,0,5,30,48
2007,Guinea,GIN,Turkey,TUR,0,0,0,5,5
2007,Cote d'Ivoire,CIV,Turkey,TUR,0,0,5,12,17
2007,Iran (Islamic Rep. of),IRN,Turkey,TUR,1452,0,138,309,1899
2007,Iraq,IRQ,Turkey,TUR,4442,0,0,499,4941
2007,Liberia,LBR,Turkey,TUR,5,0,5,5,15
2007,Sri Lanka,LKA,Turkey,TUR,5,0,0,47,52
2007,Mauritania,MRT,Turkey,TUR,0,0,5,11,16
2007,Morocco,MAR,Turkey,TUR,5,0,5,5,15
2007,Pakistan,PAK,Turkey,TUR,0,0,0,5,5
2007,Somalia,SOM,Turkey,TUR,594,0,119,268,981
2007,Sudan,SDN,Turkey,TUR,19,0,30,51,100
2007,Syrian Arab Rep.,SYR,Turkey,TUR,0,0,5,5,10
2007,Tunisia,TUN,Turkey,TUR,5,0,0,0,5
2007,Uzbekistan,UZB,Turkey,TUR,51,0,0,5,56
2008,Egypt,EGY,Afghanistan,AFG,0,0,0,5,5
2008,Iran (Islamic Rep. of),IRN,Afghanistan,AFG,0,0,0,5,5
2008,China,CHN,Egypt,EGY,5,0,0,0,5
2008,Dem. Rep. of the Congo,COD,Egypt,EGY,0,0,5,0,5
2008,Eritrea,ERI,Egypt,EGY,374,0,250,5,629
2008,Ethiopia,ETH,Egypt,EGY,14,0,189,45,248
2008,Palestinian,PSE,Egypt,EGY,5,0,0,0,5
2008,Cote d'Ivoire,CIV,Egypt,EGY,15,0,41,0,56
2008,Iraq,IRQ,Egypt,EGY,100,0,0,50,150
2008,Russian Federation,RUS,Egypt,EGY,5,0,0,0,5
2008,Rwanda,RWA,Egypt,EGY,5,0,0,0,5
2008,Somalia,SOM,Egypt,EGY,389,0,15,100,504
2008,Sudan,SDN,Egypt,EGY,152,0,97,562,811
2008,Syrian Arab Rep.,SYR,Egypt,EGY,5,0,0,0,5
2008,Afghanistan,AFG,Azerbaijan,AZE,28,0,0,0,28
2008,Iran (Islamic Rep. of),IRN,Azerbaijan,AZE,5,0,0,0,5
2008,Iraq,IRQ,Azerbaijan,AZE,22,0,0,0,22
2008,Russian Federation,RUS,Azerbaijan,AZE,138,0,0,0,138
2008,Iraq,IRQ,Bahrain,BHR,48,0,0,0,48
2008,Rwanda,RWA,Burundi,BDI,5,0,0,16,21
2008,Uganda,UGA,Burundi,BDI,18,0,0,0,18
2008,Afghanistan,AFG,Belarus,BLR,10,0,0,0,10
2008,Iraq,IRQ,Cambodia,KHM,0,0,0,5,5
2008,Dem. People's Rep. of Korea,PRK,Cambodia,KHM,0,0,0,5,5
2008,Myanmar,MMR,Cambodia,KHM,5,0,0,0,5
2008,Somalia,SOM,Cambodia,KHM,5,0,0,0,5
2008,Viet Nam,VNM,Cambodia,KHM,41,0,272,64,377
2008,Eritrea,ERI,China,CHN,0,0,0,5,5
2008,Palestinian,PSE,China,CHN,0,0,5,0,5
2008,Cote d'Ivoire,CIV,China,CHN,0,0,5,0,5
2008,Iraq,IRQ,China,CHN,13,0,0,13,26
2008,Liberia,LBR,China,CHN,0,0,5,0,5
2008,Nigeria,NGA,China,CHN,0,0,5,5,10
2008,Pakistan,PAK,China,CHN,13,0,0,5,18
2008,Sierra Leone,SLE,China,CHN,0,0,0,5,5
2008,Eritrea,ERI,Djibouti,DJI,73,0,0,0,73
2008,Ethiopia,ETH,Djibouti,DJI,0,0,0,156,156
2008,Somalia,SOM,Djibouti,DJI,0,20,0,0,20
2008,Bangladesh,BGD,"China, Hong Kong SAR",HKG,0,0,249,60,309
2008,Congo,COG,"China, Hong Kong SAR",HKG,0,0,5,0,5
2008,Dem. Rep. of the Congo,COD,"China, Hong Kong SAR",HKG,5,0,5,0,10
2008,Eritrea,ERI,"China, Hong Kong SAR",HKG,5,0,0,0,5
2008,Ghana,GHA,"China, Hong Kong SAR",HKG,0,0,5,0,5
2008,Guinea,GIN,"China, Hong Kong SAR",HKG,0,0,0,5,5
2008,India,IND,"China, Hong Kong SAR",HKG,0,0,144,58,202
2008,Indonesia,IDN,"China, Hong Kong SAR",HKG,0,0,25,21,46
2008,Sri Lanka,LKA,"China, Hong Kong SAR",HKG,10,0,27,37,74
2008,Nepal,NPL,"China, Hong Kong SAR",HKG,0,0,102,19,121
2008,Nigeria,NGA,"China, Hong Kong SAR",HKG,0,0,12,5,17
2008,Pakistan,PAK,"China, Hong Kong SAR",HKG,11,0,252,153,416
2008,Philippines,PHL,"China, Hong Kong SAR",HKG,0,0,86,15,101
2008,Somalia,SOM,"China, Hong Kong SAR",HKG,5,0,5,0,10
2008,Thailand,THA,"China, Hong Kong SAR",HKG,0,0,0,5,5
2008,Afghanistan,AFG,India,IND,140,0,177,84,401
2008,Bangladesh,BGD,India,IND,0,0,0,5,5
2008,Dem. Rep. of the Congo,COD,India,IND,0,0,5,0,5
2008,Eritrea,ERI,India,IND,11,0,0,0,11
2008,Ethiopia,ETH,India,IND,0,0,5,0,5
2008,Palestinian,PSE,India,IND,34,0,10,10,54
2008,Iran (Islamic Rep. of),IRN,India,IND,14,0,22,0,36
2008,Iraq,IRQ,India,IND,57,0,14,12,83
2008,Myanmar,MMR,India,IND,726,0,130,76,932
2008,Somalia,SOM,India,IND,275,0,27,29,331
2008,Sudan,SDN,India,IND,0,0,10,5,15
2008,Afghanistan,AFG,Indonesia,IDN,5,0,10,10,25
2008,Iran (Islamic Rep. of),IRN,Indonesia,IDN,0,0,0,5,5
2008,Iraq,IRQ,Indonesia,IDN,125,0,0,15,140
2008,Sri Lanka,LKA,Indonesia,IDN,14,0,0,5,19
2008,Myanmar,MMR,Indonesia,IDN,16,0,0,0,16
2008,Somalia,SOM,Indonesia,IDN,14,0,0,0,14
2008,Viet Nam,VNM,Indonesia,IDN,0,0,0,10,10
2008,Afghanistan,AFG,Iran (Islamic Rep. of),IRN,73,0,55,135,263
2008,Iraq,IRQ,Iran (Islamic Rep. of),IRN,11,0,10,17,38
2008,Kyrgyzstan,KGZ,Iran (Islamic Rep. of),IRN,0,0,0,5,5
2008,Kuwait,KWT,Iran (Islamic Rep. of),IRN,11,0,0,0,11
2008,Pakistan,PAK,Iran (Islamic Rep. of),IRN,13,0,0,0,13
2008,Uzbekistan,UZB,Iran (Islamic Rep. of),IRN,10,0,0,29,39
2008,Iran (Islamic Rep. of),IRN,Iraq,IRQ,0,0,0,491,491
2008,Syrian Arab Rep.,SYR,Iraq,IRQ,0,0,0,54,54
2008,Turkey,TUR,Iraq,IRQ,0,0,0,96,96
2008,Algeria,DZA,Jordan,JOR,0,0,0,5,5
2008,Egypt,EGY,Jordan,JOR,5,0,5,0,10
2008,Lebanon,LBN,Jordan,JOR,0,0,0,5,5
2008,Sri Lanka,LKA,Jordan,JOR,0,0,0,5,5
2008,Russian Federation,RUS,Jordan,JOR,5,0,0,21,26
2008,Saudi Arabia,SAU,Jordan,JOR,0,0,0,5,5
2008,Somalia,SOM,Jordan,JOR,87,49,0,13,149
2008,Sudan,SDN,Jordan,JOR,20,0,30,5,55
2008,Syrian Arab Rep.,SYR,Jordan,JOR,21,0,5,62,88
2008,Tunisia,TUN,Jordan,JOR,0,0,0,10,10
2008,Turkey,TUR,Jordan,JOR,0,0,0,5,5
2008,Yemen,YEM,Jordan,JOR,0,0,5,0,5
2008,Burundi,BDI,Kenya,KEN,70,0,5,0,75
2008,Dem. Rep. of the Congo,COD,Kenya,KEN,246,0,17,10,273
2008,Eritrea,ERI,Kenya,KEN,96,0,0,53,149
2008,Ethiopia,ETH,Kenya,KEN,1513,0,95,792,2400
2008,India,IND,Kenya,KEN,0,0,0,5,5
2008,Rwanda,RWA,Kenya,KEN,25,0,61,82,168
2008,Sierra Leone,SLE,Kenya,KEN,0,0,0,5,5
2008,Somalia,SOM,Kenya,KEN,553,0,0,240,793
2008,Sudan,SDN,Kenya,KEN,98,0,269,879,1246
2008,United Rep. of Tanzania,TZA,Kenya,KEN,0,0,0,63,63
2008,Uganda,UGA,Kenya,KEN,5,0,10,54,69
2008,Bangladesh,BGD,Kuwait,KWT,0,0,5,0,5
2008,Dem. Rep. of the Congo,COD,Kuwait,KWT,0,0,0,5,5
2008,Palestinian,PSE,Kuwait,KWT,0,0,0,5,5
2008,Iran (Islamic Rep. of),IRN,Kuwait,KWT,22,0,0,5,27
2008,Iraq,IRQ,Kuwait,KWT,82,0,0,0,82
2008,Jordan,JOR,Kuwait,KWT,0,0,5,0,5
2008,Egypt,EGY,Libya,LBY,5,0,0,0,5
2008,Chad,TCD,Libya,LBY,0,0,14,0,14
2008,Dem. Rep. of the Congo,COD,Libya,LBY,20,0,64,5,89
2008,Eritrea,ERI,Libya,LBY,312,0,12,5,329
2008,Ethiopia,ETH,Libya,LBY,30,0,11,5,46
2008,Palestinian,PSE,Libya,LBY,544,344,5,0,893
2008,Iraq,IRQ,Libya,LBY,1161,0,5,27,1193
2008,Liberia,LBR,Libya,LBY,0,0,0,5,5
2008,Sierra Leone,SLE,Libya,LBY,0,0,0,19,19
2008,Somalia,SOM,Libya,LBY,55,0,0,10,65
2008,Sudan,SDN,Libya,LBY,195,0,64,13,272
2008,Egypt,EGY,Lebanon,LBN,0,0,5,0,5
2008,Eritrea,ERI,Lebanon,LBN,0,0,0,5,5
2008,Ethiopia,ETH,Lebanon,LBN,5,0,0,0,5
2008,Palestinian,PSE,Lebanon,LBN,5,0,0,0,5
2008,Iraq,IRQ,Lebanon,LBN,0,0,5,73,78
2008,Kuwait,KWT,Lebanon,LBN,0,0,0,5,5
2008,Somalia,SOM,Lebanon,LBN,5,5,10,0,20
2008,Sudan,SDN,Lebanon,LBN,12,0,128,12,152
2008,Syrian Arab Rep.,SYR,Lebanon,LBN,34,0,19,0,53
2008,Afghanistan,AFG,Malaysia,MYS,10,0,0,27,37
2008,Bangladesh,BGD,Malaysia,MYS,0,0,20,20,40
2008,Cambodia,KHM,Malaysia,MYS,5,0,35,123,163
2008,China,CHN,Malaysia,MYS,5,0,0,0,5
2008,Cameroon,CMR,Malaysia,MYS,0,0,0,26,26
2008,Congo,COG,Malaysia,MYS,0,0,0,5,5
2008,Dem. Rep. of the Congo,COD,Malaysia,MYS,0,0,0,5,5
2008,Palestinian,PSE,Malaysia,MYS,55,0,0,0,55
2008,Guinea,GIN,Malaysia,MYS,0,0,5,5,10
2008,Cote d'Ivoire,CIV,Malaysia,MYS,0,0,5,14,19
2008,India,IND,Malaysia,MYS,0,0,0,10,10
2008,Indonesia,IDN,Malaysia,MYS,27,0,0,275,302
2008,Iran (Islamic Rep. of),IRN,Malaysia,MYS,5,0,5,10,20
2008,Iraq,IRQ,Malaysia,MYS,191,0,0,260,451
2008,Liberia,LBR,Malaysia,MYS,0,0,30,44,74
2008,Sri Lanka,LKA,Malaysia,MYS,957,0,22,283,1262
2008,Myanmar,MMR,Malaysia,MYS,9819,0,84,1508,11411
2008,Nepal,NPL,Malaysia,MYS,0,0,57,83,140
2008,Niger,NER,Malaysia,MYS,0,0,0,5,5
2008,Nigeria,NGA,Malaysia,MYS,0,0,5,11,16
2008,Pakistan,PAK,Malaysia,MYS,0,0,26,24,50
2008,Somalia,SOM,Malaysia,MYS,278,0,0,83,361
2008,Viet Nam,VNM,Malaysia,MYS,0,0,16,16,32
2008,Sudan,SDN,Malaysia,MYS,5,0,0,13,18
2008,Thailand,THA,Malaysia,MYS,0,0,0,15,15
2008,China,CHN,Mongolia,MNG,5,0,0,0,5
2008,Algeria,DZA,Morocco,MAR,0,0,5,0,5
2008,Angola,AGO,Morocco,MAR,0,0,5,0,5
2008,Central African Rep.,CAF,Morocco,MAR,0,0,5,0,5
2008,Cameroon,CMR,Morocco,MAR,0,0,30,11,41
2008,Congo,COG,Morocco,MAR,0,0,12,10,22
2008,Dem. Rep. of the Congo,COD,Morocco,MAR,36,0,218,92,346
2008,Palestinian,PSE,Morocco,MAR,5,0,0,0,5
2008,Ghana,GHA,Morocco,MAR,0,0,0,5,5
2008,Guinea,GIN,Morocco,MAR,0,0,10,0,10
2008,Cote d'Ivoire,CIV,Morocco,MAR,30,0,49,15,94
2008,Iraq,IRQ,Morocco,MAR,27,0,0,29,56
2008,Kenya,KEN,Morocco,MAR,0,0,5,0,5
2008,Liberia,LBR,Morocco,MAR,5,0,16,20,41
2008,Mauritania,MRT,Morocco,MAR,0,0,5,0,5
2008,Niger,NER,Morocco,MAR,0,0,5,5,10
2008,Nigeria,NGA,Morocco,MAR,0,0,157,81,238
2008,Rwanda,RWA,Morocco,MAR,0,0,5,0,5
2008,Sierra Leone,SLE,Morocco,MAR,0,0,5,10,15
2008,Somalia,SOM,Morocco,MAR,5,0,0,5,10
2008,Sudan,SDN,Morocco,MAR,0,0,0,5,5
2008,Togo,TGO,Morocco,MAR,0,0,5,0,5
2008,Uganda,UGA,Morocco,MAR,0,0,5,0,5
2008,Iran (Islamic Rep. of),IRN,Nepal,NPL,0,0,0,5,5
2008,Liberia,LBR,Nepal,NPL,0,0,5,0,5
2008,Pakistan,PAK,Nepal,NPL,21,0,0,0,21
2008,Somalia,SOM,Nepal,NPL,21,0,0,26,47
2008,Palestinian,PSE,Qatar,QAT,0,0,0,5,5
2008,Somalia,SOM,Qatar,QAT,0,0,0,11,11
2008,Syrian Arab Rep.,SYR,Qatar,QAT,5,0,0,0,5
2008,Afghanistan,AFG,Saudi Arabia,SAU,0,0,0,5,5
2008,Chad,TCD,Saudi Arabia,SAU,0,0,5,0,5
2008,Eritrea,ERI,Saudi Arabia,SAU,5,0,0,10,15
2008,Ethiopia,ETH,Saudi Arabia,SAU,10,0,5,0,15
2008,Palestinian,PSE,Saudi Arabia,SAU,0,10,0,0,10
2008,Cote d'Ivoire,CIV,Saudi Arabia,SAU,0,0,0,5,5
2008,Iraq,IRQ,Saudi Arabia,SAU,10,0,0,0,10
2008,Liberia,LBR,Saudi Arabia,SAU,5,0,0,25,30
2008,Myanmar,MMR,Saudi Arabia,SAU,0,0,0,10,10
2008,Somalia,SOM,Saudi Arabia,SAU,0,0,0,31,31
2008,Sudan,SDN,Saudi Arabia,SAU,10,0,12,15,37
2008,Syrian Arab Rep.,SYR,Saudi Arabia,SAU,10,0,0,0,10
2008,Uzbekistan,UZB,Saudi Arabia,SAU,5,0,0,0,5
2008,Yemen,YEM,Saudi Arabia,SAU,0,0,5,0,5
2008,China,CHN,Singapore,SGP,0,0,0,5,5
2008,Sri Lanka,LKA,Singapore,SGP,5,0,0,5,10
2008,Myanmar,MMR,Singapore,SGP,10,0,0,10,20
2008,Pakistan,PAK,Singapore,SGP,0,0,0,5,5
2008,Cote d'Ivoire,CIV,Sierra Leone,SLE,0,0,0,21,21
2008,Liberia,LBR,Sierra Leone,SLE,0,0,0,255,255
2008,Nigeria,NGA,Sierra Leone,SLE,0,0,53,0,53
2008,Bangladesh,BGD,Somalia,SOM,5,0,0,0,5
2008,Eritrea,ERI,Somalia,SOM,5,0,0,0,5
2008,Ethiopia,ETH,Somalia,SOM,705,0,610,222,1537
2008,Somalia,SOM,Somalia,SOM,0,0,5,0,5
2008,Sudan,SDN,Somalia,SOM,0,0,10,0,10
2008,Afghanistan,AFG,Syrian Arab Rep.,SYR,222,0,0,101,323
2008,Albania,ALB,Syrian Arab Rep.,SYR,0,0,0,5,5
2008,Algeria,DZA,Syrian Arab Rep.,SYR,0,0,0,82,82
2008,Egypt,EGY,Syrian Arab Rep.,SYR,0,0,0,12,12
2008,Armenia,ARM,Syrian Arab Rep.,SYR,0,0,0,5,5
2008,Chad,TCD,Syrian Arab Rep.,SYR,0,0,0,14,14
2008,Congo,COG,Syrian Arab Rep.,SYR,0,0,0,5,5
2008,Dem. Rep. of the Congo,COD,Syrian Arab Rep.,SYR,11,0,0,0,11
2008,Comoros,COM,Syrian Arab Rep.,SYR,0,0,0,5,5
2008,Eritrea,ERI,Syrian Arab Rep.,SYR,10,0,0,33,43
2008,Ethiopia,ETH,Syrian Arab Rep.,SYR,0,0,5,36,41
2008,Palestinian,PSE,Syrian Arab Rep.,SYR,0,0,0,119,119
2008,India,IND,Syrian Arab Rep.,SYR,0,0,0,5,5
2008,Iran (Islamic Rep. of),IRN,Syrian Arab Rep.,SYR,33,0,19,302,354
2008,Jordan,JOR,Syrian Arab Rep.,SYR,0,0,0,40,40
2008,Kuwait,KWT,Syrian Arab Rep.,SYR,0,0,0,5,5
2008,Liberia,LBR,Syrian Arab Rep.,SYR,0,0,0,5,5
2008,Libya,LBY,Syrian Arab Rep.,SYR,0,0,0,10,10
2008,Lebanon,LBN,Syrian Arab Rep.,SYR,0,0,10,11,21
2008,Sri Lanka,LKA,Syrian Arab Rep.,SYR,0,0,0,5,5
2008,Morocco,MAR,Syrian Arab Rep.,SYR,0,0,0,17,17
2008,Serbia and Kosovo: S/RES/1244 (1999),SRB,Syrian Arab Rep.,SYR,0,0,0,5,5
2008,Sierra Leone,SLE,Syrian Arab Rep.,SYR,0,0,0,14,14
2008,Somalia,SOM,Syrian Arab Rep.,SYR,964,0,24,1349,2337
2008,Sudan,SDN,Syrian Arab Rep.,SYR,121,0,48,479,648
2008,Tunisia,TUN,Syrian Arab Rep.,SYR,0,0,0,17,17
2008,Turkey,TUR,Syrian Arab Rep.,SYR,0,0,0,56,56
2008,Yemen,YEM,Syrian Arab Rep.,SYR,0,0,5,5,10
2008,Stateless,XXA,Syrian Arab Rep.,SYR,5,0,0,49,54
2008,Burundi,BDI,Thailand,THA,5,0,0,0,5
2008,Bangladesh,BGD,Thailand,THA,0,0,5,0,5
2008,Cambodia,KHM,Thailand,THA,26,0,24,24,74
2008,China,CHN,Thailand,THA,35,0,46,5,86
2008,Dem. Rep. of the Congo,COD,Thailand,THA,5,0,11,10,26
2008,Ethiopia,ETH,Thailand,THA,0,0,0,5,5
2008,Guinea,GIN,Thailand,THA,0,0,0,5,5
2008,Cote d'Ivoire,CIV,Thailand,THA,0,0,11,5,16
2008,India,IND,Thailand,THA,0,0,5,0,5
2008,Iran (Islamic Rep. of),IRN,Thailand,THA,0,0,10,5,15
2008,Iraq,IRQ,Thailand,THA,46,0,0,39,85
2008,Kuwait,KWT,Thailand,THA,0,0,0,5,5
2008,Lao People's Dem. Rep.,LAO,Thailand,THA,15,0,0,0,15
2008,Sri Lanka,LKA,Thailand,THA,215,0,91,29,335
2008,Myanmar,MMR,Thailand,THA,5,0,0,0,5
2008,Nepal,NPL,Thailand,THA,0,0,5,12,17
2008,Nigeria,NGA,Thailand,THA,0,0,0,5,5
2008,Pakistan,PAK,Thailand,THA,10,0,5,5,20
2008,Sierra Leone,SLE,Thailand,THA,0,0,5,0,5
2008,Somalia,SOM,Thailand,THA,112,0,0,18,130
2008,Viet Nam,VNM,Thailand,THA,0,0,17,11,28
2008,Azerbaijan,AZE,Turkmenistan,TKM,0,0,16,0,16
2008,Afghanistan,AFG,Turkey,TUR,144,0,113,309,566
2008,Bangladesh,BGD,Turkey,TUR,0,0,0,5,5
2008,China,CHN,Turkey,TUR,5,0,0,29,34
2008,Cameroon,CMR,Turkey,TUR,0,0,0,5,5
2008,Congo,COG,Turkey,TUR,0,0,0,5,5
2008,Dem. Rep. of the Congo,COD,Turkey,TUR,5,0,12,61,78
2008,Eritrea,ERI,Turkey,TUR,12,0,5,40,57
2008,Ethiopia,ETH,Turkey,TUR,0,0,5,44,49
2008,Palestinian,PSE,Turkey,TUR,58,0,14,112,184
2008,Guinea,GIN,Turkey,TUR,5,0,0,19,24
2008,Cote d'Ivoire,CIV,Turkey,TUR,5,0,5,10,20
2008,Iran (Islamic Rep. of),IRN,Turkey,TUR,1112,0,213,192,1517
2008,Iraq,IRQ,Turkey,TUR,6573,0,21,465,7059
2008,Sri Lanka,LKA,Turkey,TUR,5,0,10,42,57
2008,Mauritania,MRT,Turkey,TUR,0,0,0,18,18
2008,Morocco,MAR,Turkey,TUR,0,0,0,5,5
2008,Nigeria,NGA,Turkey,TUR,0,0,0,10,10
2008,Pakistan,PAK,Turkey,TUR,0,0,0,10,10
2008,Somalia,SOM,Turkey,TUR,323,0,30,573,926
2008,Sudan,SDN,Turkey,TUR,38,0,24,35,97
2008,Syrian Arab Rep.,SYR,Turkey,TUR,5,0,11,0,16
2008,Turkmenistan,TKM,Turkey,TUR,0,0,0,5,5
2008,Tunisia,TUN,Turkey,TUR,0,0,0,5,5
2008,Uzbekistan,UZB,Turkey,TUR,10,0,0,12,22
2008,Stateless,XXA,Turkey,TUR,5,0,0,0,5
2008,Afghanistan,AFG,Ukraine,UKR,16,0,0,0,16
2008,Ethiopia,ETH,Ukraine,UKR,5,0,0,0,5
2008,Iran (Islamic Rep. of),IRN,Ukraine,UKR,5,0,0,0,5
2008,Iraq,IRQ,Ukraine,UKR,5,0,0,0,5
2008,Russian Federation,RUS,Ukraine,UKR,25,0,0,0,25
2008,Uzbekistan,UZB,Ukraine,UKR,14,0,0,0,14
2008,Sri Lanka,LKA,Vanuatu,VUT,5,0,0,0,5
2009,Iran (Islamic Rep. of),IRN,Afghanistan,AFG,0,0,5,5,10
2009,Pakistan,PAK,Afghanistan,AFG,0,0,5,0,5
2009,Central African Rep.,CAF,Algeria,DZA,0,0,5,11,16
2009,Chad,TCD,Algeria,DZA,0,0,25,55,80
2009,Cameroon,CMR,Algeria,DZA,0,0,107,172,279
2009,Congo,COG,Algeria,DZA,0,0,5,0,5
2009,Dem. Rep. of the Congo,COD,Algeria,DZA,5,0,63,109,177
2009,Palestinian,PSE,Algeria,DZA,0,0,0,5,5
2009,Guinea,GIN,Algeria,DZA,0,0,0,5,5
2009,Cote d'Ivoire,CIV,Algeria,DZA,10,0,62,182,254
2009,Iraq,IRQ,Algeria,DZA,0,0,0,11,11
2009,Liberia,LBR,Algeria,DZA,0,0,132,133,265
2009,Mali,MLI,Algeria,DZA,0,0,0,5,5
2009,Morocco,MAR,Algeria,DZA,0,0,0,5,5
2009,Nigeria,NGA,Algeria,DZA,0,0,110,84,194
2009,South Africa,ZAF,Algeria,DZA,0,0,0,5,5
2009,Sierra Leone,SLE,Algeria,DZA,0,0,0,10,10
2009,Togo,TGO,Algeria,DZA,0,0,0,5,5
2009,Chad,TCD,Egypt,EGY,0,0,0,5,5
2009,Dem. Rep. of the Congo,COD,Egypt,EGY,5,0,0,0,5
2009,Eritrea,ERI,Egypt,EGY,215,0,82,59,356
2009,Ethiopia,ETH,Egypt,EGY,40,0,98,26,164
2009,Palestinian,PSE,Egypt,EGY,10,0,0,5,15
2009,Guinea-Bissau,GNB,Egypt,EGY,0,0,5,0,5
2009,Cote d'Ivoire,CIV,Egypt,EGY,0,0,13,5,18
2009,Iraq,IRQ,Egypt,EGY,68,0,0,23,91
2009,Russian Federation,RUS,Egypt,EGY,5,0,0,0,5
2009,Rwanda,RWA,Egypt,EGY,0,0,5,0,5
2009,Somalia,SOM,Egypt,EGY,603,0,5,5,613
2009,Sudan,SDN,Egypt,EGY,341,0,182,1850,2373
2009,Syrian Arab Rep.,SYR,Egypt,EGY,0,0,0,10,10
2009,Yemen,YEM,Egypt,EGY,0,0,10,0,10
2009,Zimbabwe,ZWE,Egypt,EGY,5,0,0,0,5
2009,Afghanistan,AFG,Azerbaijan,AZE,10,0,0,0,10
2009,Armenia,ARM,Azerbaijan,AZE,5,0,0,0,5
2009,Iran (Islamic Rep. of),IRN,Azerbaijan,AZE,5,0,0,0,5
2009,Russian Federation,RUS,Azerbaijan,AZE,11,0,5,11,27
2009,Iraq,IRQ,Bahrain,BHR,91,0,0,22,113
2009,Afghanistan,AFG,Belarus,BLR,11,0,0,0,11
2009,China,CHN,Cambodia,KHM,0,0,0,20,20
2009,Myanmar,MMR,Cambodia,KHM,5,0,5,0,10
2009,Viet Nam,VNM,Cambodia,KHM,10,0,24,16,50
2009,Palestinian,PSE,Cyprus,CYP,5,0,0,5,10
2009,Eritrea,ERI,Djibouti,DJI,151,0,0,5,156
2009,Ethiopia,ETH,Djibouti,DJI,41,0,5,47,93
2009,Somalia,SOM,Djibouti,DJI,0,0,26,5,31
2009,Afghanistan,AFG,"China, Hong Kong SAR",HKG,0,0,0,5,5
2009,Algeria,DZA,"China, Hong Kong SAR",HKG,0,0,0,5,5
2009,Bangladesh,BGD,"China, Hong Kong SAR",HKG,0,0,63,31,94
2009,Eritrea,ERI,"China, Hong Kong SAR",HKG,5,0,0,0,5
2009,Ghana,GHA,"China, Hong Kong SAR",HKG,0,0,5,5,10
2009,India,IND,"China, Hong Kong SAR",HKG,0,0,61,35,96
2009,Indonesia,IDN,"China, Hong Kong SAR",HKG,0,0,167,85,252
2009,Iran (Islamic Rep. of),IRN,"China, Hong Kong SAR",HKG,5,0,0,0,5
2009,Kenya,KEN,"China, Hong Kong SAR",HKG,0,0,5,0,5
2009,Sri Lanka,LKA,"China, Hong Kong SAR",HKG,0,0,10,46,56
2009,Nepal,NPL,"China, Hong Kong SAR",HKG,0,0,72,22,94
2009,Niger,NER,"China, Hong Kong SAR",HKG,0,0,5,0,5
2009,Nigeria,NGA,"China, Hong Kong SAR",HKG,0,0,10,5,15
2009,Pakistan,PAK,"China, Hong Kong SAR",HKG,0,0,81,63,144
2009,Philippines,PHL,"China, Hong Kong SAR",HKG,0,0,160,27,187
2009,Somalia,SOM,"China, Hong Kong SAR",HKG,11,0,0,0,11
2009,United Rep. of Tanzania,TZA,"China, Hong Kong SAR",HKG,0,0,0,5,5
2009,Togo,TGO,"China, Hong Kong SAR",HKG,0,0,10,0,10
2009,Afghanistan,AFG,India,IND,400,0,986,947,2333
2009,Egypt,EGY,India,IND,0,0,5,0,5
2009,Dem. Rep. of the Congo,COD,India,IND,0,0,5,10,15
2009,Ethiopia,ETH,India,IND,0,0,5,0,5
2009,Palestinian,PSE,India,IND,18,0,0,13,31
2009,Iran (Islamic Rep. of),IRN,India,IND,0,0,5,21,26
2009,Iraq,IRQ,India,IND,37,0,0,44,81
2009,Myanmar,MMR,India,IND,1253,0,22,652,1927
2009,Somalia,SOM,India,IND,169,0,5,61,235
2009,Sudan,SDN,India,IND,5,0,0,13,18
2009,Afghanistan,AFG,Indonesia,IDN,256,0,34,753,1043
2009,Algeria,DZA,Indonesia,IDN,0,0,5,0,5
2009,Bangladesh,BGD,Indonesia,IDN,0,0,0,121,121
2009,China,CHN,Indonesia,IDN,0,0,5,0,5
2009,Dem. Rep. of the Congo,COD,Indonesia,IDN,5,0,0,0,5
2009,Iran (Islamic Rep. of),IRN,Indonesia,IDN,18,0,5,12,35
2009,Iraq,IRQ,Indonesia,IDN,61,0,5,72,138
2009,Kuwait,KWT,Indonesia,IDN,5,0,0,0,5
2009,Sri Lanka,LKA,Indonesia,IDN,104,0,5,17,126
2009,Myanmar,MMR,Indonesia,IDN,282,0,0,10,292
2009,Pakistan,PAK,Indonesia,IDN,5,0,5,0,10
2009,Sierra Leone,SLE,Indonesia,IDN,0,0,0,5,5
2009,Somalia,SOM,Indonesia,IDN,14,0,13,0,27
2009,Afghanistan,AFG,Iran (Islamic Rep. of),IRN,86,0,84,36,206
2009,Iraq,IRQ,Iran (Islamic Rep. of),IRN,0,0,10,5,15
2009,Iran (Islamic Rep. of),IRN,Iraq,IRQ,5,0,0,24,29
2009,Syrian Arab Rep.,SYR,Iraq,IRQ,0,0,0,962,962
2009,Egypt,EGY,Israel,ISR,0,0,0,10,10
2009,Burundi,BDI,Israel,ISR,0,0,0,5,5
2009,Benin,BEN,Israel,ISR,0,0,0,5,5
2009,Bangladesh,BGD,Israel,ISR,0,0,0,5,5
2009,Burkina Faso,BFA,Israel,ISR,0,0,0,20,20
2009,Central African Rep.,CAF,Israel,ISR,0,0,0,12,12
2009,Chad,TCD,Israel,ISR,0,0,0,22,22
2009,China,CHN,Israel,ISR,0,0,0,22,22
2009,Chile,CHL,Israel,ISR,0,0,0,5,5
2009,Cameroon,CMR,Israel,ISR,0,0,0,23,23
2009,Congo,COG,Israel,ISR,0,0,0,5,5
2009,Dem. Rep. of the Congo,COD,Israel,ISR,0,0,0,135,135
2009,Colombia,COL,Israel,ISR,0,0,0,182,182
2009,Cuba,CUB,Israel,ISR,0,0,0,5,5
2009,Ecuador,ECU,Israel,ISR,0,0,0,11,11
2009,Eritrea,ERI,Israel,ISR,0,0,0,5,5
2009,Ethiopia,ETH,Israel,ISR,0,0,0,739,739
2009,Georgia,GEO,Israel,ISR,0,0,0,263,263
2009,Ghana,GHA,Israel,ISR,0,0,0,292,292
2009,Guinea,GIN,Israel,ISR,0,0,0,40,40
2009,Cote d'Ivoire,CIV,Israel,ISR,0,0,0,681,681
2009,India,IND,Israel,ISR,0,0,0,5,5
2009,Iran (Islamic Rep. of),IRN,Israel,ISR,0,0,0,11,11
2009,Iraq,IRQ,Israel,ISR,0,0,0,15,15
2009,Kazakhstan,KAZ,Israel,ISR,0,0,0,5,5
2009,Kenya,KEN,Israel,ISR,0,0,0,23,23
2009,Liberia,LBR,Israel,ISR,0,0,0,34,34
2009,Lebanon,LBN,Israel,ISR,0,0,0,10,10
2009,Sri Lanka,LKA,Israel,ISR,0,0,0,14,14
2009,Lithuania,LTU,Israel,ISR,0,0,0,5,5
2009,Mauritania,MRT,Israel,ISR,0,0,0,5,5
2009,Rep. of Moldova,MDA,Israel,ISR,0,0,0,16,16
2009,Mali,MLI,Israel,ISR,0,0,0,10,10
2009,Mongolia,MNG,Israel,ISR,0,0,0,5,5
2009,Myanmar,MMR,Israel,ISR,0,0,0,85,85
2009,Nepal,NPL,Israel,ISR,0,0,0,10,10
2009,Niger,NER,Israel,ISR,0,0,0,19,19
2009,Nigeria,NGA,Israel,ISR,0,0,0,610,610
2009,Philippines,PHL,Israel,ISR,0,0,0,46,46
2009,South Africa,ZAF,Israel,ISR,0,0,0,11,11
2009,Russian Federation,RUS,Israel,ISR,0,0,0,12,12
2009,Rwanda,RWA,Israel,ISR,0,0,0,10,10
2009,Serbia and Kosovo: S/RES/1244 (1999),SRB,Israel,ISR,0,0,0,5,5
2009,Sierra Leone,SLE,Israel,ISR,0,0,0,11,11
2009,Somalia,SOM,Israel,ISR,0,0,0,24,24
2009,United Rep. of Tanzania,TZA,Israel,ISR,0,0,0,5,5
2009,Togo,TGO,Israel,ISR,0,0,0,18,18
2009,Turkey,TUR,Israel,ISR,0,0,0,233,233
2009,Uzbekistan,UZB,Israel,ISR,0,0,0,5,5
2009,Zimbabwe,ZWE,Israel,ISR,0,0,0,12,12
2009,Unknown ,,Israel,ISR,0,0,0,56,56
2009,Afghanistan,AFG,Jordan,JOR,5,0,5,0,10
2009,Egypt,EGY,Jordan,JOR,5,0,49,22,76
2009,Bosnia and Herzegovina,BIH,Jordan,JOR,0,0,5,0,5
2009,Dem. Rep. of the Congo,COD,Jordan,JOR,0,0,0,5,5
2009,Eritrea,ERI,Jordan,JOR,12,0,0,0,12
2009,Georgia,GEO,Jordan,JOR,0,0,0,5,5
2009,Ghana,GHA,Jordan,JOR,0,0,10,0,10
2009,Iran (Islamic Rep. of),IRN,Jordan,JOR,0,0,0,5,5
2009,Israel,ISR,Jordan,JOR,5,0,0,0,5
2009,Lebanon,LBN,Jordan,JOR,0,0,0,10,10
2009,Sri Lanka,LKA,Jordan,JOR,0,0,10,0,10
2009,Pakistan,PAK,Jordan,JOR,0,0,10,0,10
2009,Russian Federation,RUS,Jordan,JOR,0,0,0,5,5
2009,Somalia,SOM,Jordan,JOR,72,0,5,139,216
2009,Sudan,SDN,Jordan,JOR,92,0,53,35,180
2009,Syrian Arab Rep.,SYR,Jordan,JOR,97,0,17,37,151
2009,Tunisia,TUN,Jordan,JOR,0,0,5,0,5
2009,Yemen,YEM,Jordan,JOR,5,0,0,0,5
2009,Stateless,XXA,Jordan,JOR,20,0,0,12,32
2009,Burundi,BDI,Kenya,KEN,23,0,23,5,51
2009,Dem. Rep. of the Congo,COD,Kenya,KEN,986,0,74,5,1065
2009,Eritrea,ERI,Kenya,KEN,303,0,0,5,308
2009,Ethiopia,ETH,Kenya,KEN,1025,0,211,319,1555
2009,Rwanda,RWA,Kenya,KEN,42,0,86,10,138
2009,Somalia,SOM,Kenya,KEN,674,0,11,1049,1734
2009,Sudan,SDN,Kenya,KEN,123,0,163,0,286
2009,Uganda,UGA,Kenya,KEN,25,0,27,11,63
2009,Zimbabwe,ZWE,Kenya,KEN,5,0,0,0,5
2009,Iraq,IRQ,Kuwait,KWT,0,0,0,25,25
2009,Somalia,SOM,Kuwait,KWT,5,0,0,0,5
2009,Algeria,DZA,Libya,LBY,0,0,0,5,5
2009,Egypt,EGY,Libya,LBY,0,0,0,26,26
2009,Bangladesh,BGD,Libya,LBY,0,0,0,5,5
2009,Chad,TCD,Libya,LBY,25,0,43,256,324
2009,Cameroon,CMR,Libya,LBY,0,0,0,10,10
2009,Congo,COG,Libya,LBY,0,0,0,5,5
2009,Dem. Rep. of the Congo,COD,Libya,LBY,0,0,0,48,48
2009,Eritrea,ERI,Libya,LBY,383,0,10,515,908
2009,Ethiopia,ETH,Libya,LBY,10,0,5,192,207
2009,Ghana,GHA,Libya,LBY,0,0,0,5,5
2009,Cote d'Ivoire,CIV,Libya,LBY,0,0,0,10,10
2009,Iraq,IRQ,Libya,LBY,640,0,5,309,954
2009,Jordan,JOR,Libya,LBY,0,0,0,5,5
2009,Liberia,LBR,Libya,LBY,5,0,5,43,53
2009,Morocco,MAR,Libya,LBY,0,0,0,10,10
2009,Niger,NER,Libya,LBY,0,0,0,13,13
2009,Nigeria,NGA,Libya,LBY,0,0,0,10,10
2009,Rwanda,RWA,Libya,LBY,0,0,0,10,10
2009,Sierra Leone,SLE,Libya,LBY,0,0,0,24,24
2009,Somalia,SOM,Libya,LBY,91,0,0,167,258
2009,Sudan,SDN,Libya,LBY,541,0,58,950,1549
2009,Syrian Arab Rep.,SYR,Libya,LBY,0,0,0,15,15
2009,Egypt,EGY,Lebanon,LBN,10,0,5,0,15
2009,Ethiopia,ETH,Lebanon,LBN,0,0,5,0,5
2009,Palestinian,PSE,Lebanon,LBN,5,0,0,0,5
2009,Iran (Islamic Rep. of),IRN,Lebanon,LBN,5,0,0,0,5
2009,Iraq,IRQ,Lebanon,LBN,5,0,14,0,19
2009,Sudan,SDN,Lebanon,LBN,36,0,158,90,284
2009,Syrian Arab Rep.,SYR,Lebanon,LBN,22,0,41,5,68
2009,Turkey,TUR,Lebanon,LBN,0,0,5,0,5
2009,Stateless,XXA,Lebanon,LBN,0,0,0,5,5
2009,Angola,AGO,Morocco,MAR,0,0,0,5,5
2009,Benin,BEN,Morocco,MAR,0,0,5,0,5
2009,Bangladesh,BGD,Morocco,MAR,0,0,5,0,5
2009,Central African Rep.,CAF,Morocco,MAR,0,0,5,0,5
2009,Chad,TCD,Morocco,MAR,0,0,10,0,10
2009,Cameroon,CMR,Morocco,MAR,0,0,32,0,32
2009,Congo,COG,Morocco,MAR,5,0,12,0,17
2009,Dem. Rep. of the Congo,COD,Morocco,MAR,26,0,258,24,308
2009,Eritrea,ERI,Morocco,MAR,0,0,10,5,15
2009,Palestinian,PSE,Morocco,MAR,11,0,0,0,11
2009,Guinea-Bissau,GNB,Morocco,MAR,0,0,5,0,5
2009,Guinea,GIN,Morocco,MAR,5,0,5,0,10
2009,Cote d'Ivoire,CIV,Morocco,MAR,20,0,56,10,86
2009,Iraq,IRQ,Morocco,MAR,50,0,0,0,50
2009,Kenya,KEN,Morocco,MAR,0,0,12,0,12
2009,Liberia,LBR,Morocco,MAR,0,0,21,0,21
2009,Nigeria,NGA,Morocco,MAR,0,0,62,16,78
2009,Pakistan,PAK,Morocco,MAR,0,0,5,0,5
2009,Rwanda,RWA,Morocco,MAR,0,0,5,0,5
2009,Senegal,SEN,Morocco,MAR,5,0,0,0,5
2009,Sierra Leone,SLE,Morocco,MAR,0,0,12,0,12
2009,Somalia,SOM,Morocco,MAR,0,0,10,0,10
2009,Sudan,SDN,Morocco,MAR,0,0,12,5,17
2009,Uganda,UGA,Morocco,MAR,0,0,5,0,5
2009,Yemen,YEM,Morocco,MAR,5,0,0,0,5
2009,Zimbabwe,ZWE,Morocco,MAR,0,0,10,0,10
2009,Egypt,EGY,Nepal,NPL,0,0,0,5,5
2009,Iran (Islamic Rep. of),IRN,Nepal,NPL,0,0,0,5,5
2009,Sri Lanka,LKA,Nepal,NPL,0,0,0,5,5
2009,Myanmar,MMR,Nepal,NPL,5,0,0,0,5
2009,Pakistan,PAK,Nepal,NPL,0,0,0,5,5
2009,Somalia,SOM,Nepal,NPL,5,0,0,0,5
2009,Iraq,IRQ,Oman,OMN,19,0,0,35,54
2009,Sudan,SDN,Oman,OMN,0,0,5,0,5
2009,Myanmar,MMR,Palau,PLW,11,0,0,0,11
2009,Iraq,IRQ,Qatar,QAT,16,0,0,12,28
2009,Sudan,SDN,Qatar,QAT,0,0,0,5,5
2009,Chad,TCD,Saudi Arabia,SAU,0,0,0,5,5
2009,China,CHN,Saudi Arabia,SAU,10,0,0,0,10
2009,Eritrea,ERI,Saudi Arabia,SAU,0,0,0,5,5
2009,Ethiopia,ETH,Saudi Arabia,SAU,0,0,0,5,5
2009,Cote d'Ivoire,CIV,Saudi Arabia,SAU,0,0,0,5,5
2009,Iraq,IRQ,Saudi Arabia,SAU,0,0,0,21,21
2009,Myanmar,MMR,Saudi Arabia,SAU,0,0,0,10,10
2009,Somalia,SOM,Saudi Arabia,SAU,0,0,0,5,5
2009,Sudan,SDN,Saudi Arabia,SAU,0,0,0,77,77
2009,Uzbekistan,UZB,Saudi Arabia,SAU,0,0,0,5,5
2009,Yemen,YEM,Saudi Arabia,SAU,0,0,0,5,5
2009,Dem. Rep. of the Congo,COD,Somalia,SOM,0,0,5,0,5
2009,Eritrea,ERI,Somalia,SOM,10,0,0,5,15
2009,Ethiopia,ETH,Somalia,SOM,91,0,25,0,116
2009,United Rep. of Tanzania,TZA,Somalia,SOM,0,0,0,18,18
2009,Eritrea,ERI,Sudan,SDN,45,0,5,0,50
2009,Ethiopia,ETH,Sudan,SDN,49,0,14,0,63
2009,Somalia,SOM,Sudan,SDN,0,0,0,5,5
2009,Unknown ,,Sudan,SDN,0,0,5,0,5
2009,Afghanistan,AFG,Syrian Arab Rep.,SYR,576,0,10,0,586
2009,Algeria,DZA,Syrian Arab Rep.,SYR,0,0,5,0,5
2009,Egypt,EGY,Syrian Arab Rep.,SYR,0,0,5,0,5
2009,Chad,TCD,Syrian Arab Rep.,SYR,0,0,5,0,5
2009,China,CHN,Syrian Arab Rep.,SYR,0,0,0,5,5
2009,Dem. Rep. of the Congo,COD,Syrian Arab Rep.,SYR,5,0,0,0,5
2009,Colombia,COL,Syrian Arab Rep.,SYR,0,0,5,0,5
2009,Eritrea,ERI,Syrian Arab Rep.,SYR,15,0,0,0,15
2009,Ethiopia,ETH,Syrian Arab Rep.,SYR,0,0,5,0,5
2009,Palestinian,PSE,Syrian Arab Rep.,SYR,0,0,0,52,52
2009,Iran (Islamic Rep. of),IRN,Syrian Arab Rep.,SYR,45,0,41,0,86
2009,Kuwait,KWT,Syrian Arab Rep.,SYR,5,0,0,0,5
2009,Lebanon,LBN,Syrian Arab Rep.,SYR,0,0,5,0,5
2009,Pakistan,PAK,Syrian Arab Rep.,SYR,5,0,0,0,5
2009,Somalia,SOM,Syrian Arab Rep.,SYR,342,0,5,0,347
2009,Sudan,SDN,Syrian Arab Rep.,SYR,118,0,150,0,268
2009,Tunisia,TUN,Syrian Arab Rep.,SYR,5,0,0,0,5
2009,Yemen,YEM,Syrian Arab Rep.,SYR,5,0,5,0,10
2009,Stateless,XXA,Syrian Arab Rep.,SYR,18,0,0,5,23
2009,Afghanistan,AFG,Thailand,THA,0,0,0,5,5
2009,Bangladesh,BGD,Thailand,THA,0,0,0,5,5
2009,Cambodia,KHM,Thailand,THA,20,0,5,17,42
2009,China,CHN,Thailand,THA,19,0,19,25,63
2009,Cameroon,CMR,Thailand,THA,0,0,0,5,5
2009,Dem. Rep. of the Congo,COD,Thailand,THA,5,0,15,20,40
2009,Palestinian,PSE,Thailand,THA,12,0,0,0,12
2009,Guinea,GIN,Thailand,THA,0,0,5,0,5
2009,Cote d'Ivoire,CIV,Thailand,THA,0,0,5,5,10
2009,India,IND,Thailand,THA,0,0,0,5,5
2009,Iran (Islamic Rep. of),IRN,Thailand,THA,0,0,5,13,18
2009,Iraq,IRQ,Thailand,THA,42,0,5,16,63
2009,Lao People's Dem. Rep.,LAO,Thailand,THA,13,0,0,5,18
2009,Sri Lanka,LKA,Thailand,THA,149,0,29,109,287
2009,Nepal,NPL,Thailand,THA,0,0,0,10,10
2009,Pakistan,PAK,Thailand,THA,17,0,31,38,86
2009,Sierra Leone,SLE,Thailand,THA,0,0,5,5,10
2009,Somalia,SOM,Thailand,THA,34,0,0,5,39
2009,Viet Nam,VNM,Thailand,THA,18,0,129,75,222
2009,Syrian Arab Rep.,SYR,Thailand,THA,0,0,0,5,5
2009,Afghanistan,AFG,Tajikistan,TJK,16,0,0,0,16
2009,Afghanistan,AFG,Turkey,TUR,771,0,644,948,2363
2009,Algeria,DZA,Turkey,TUR,0,0,0,5,5
2009,Egypt,EGY,Turkey,TUR,0,0,5,0,5
2009,Bangladesh,BGD,Turkey,TUR,0,0,0,5,5
2009,Bhutan,BTN,Turkey,TUR,0,0,0,5,5
2009,China,CHN,Turkey,TUR,0,0,0,5,5
2009,Cameroon,CMR,Turkey,TUR,0,0,0,27,27
2009,Dem. Rep. of the Congo,COD,Turkey,TUR,0,0,5,70,75
2009,Eritrea,ERI,Turkey,TUR,21,0,5,49,75
2009,Ethiopia,ETH,Turkey,TUR,10,0,5,5,20
2009,Palestinian,PSE,Turkey,TUR,5,0,0,38,43
2009,Guinea,GIN,Turkey,TUR,0,0,11,10,21
2009,Cote d'Ivoire,CIV,Turkey,TUR,0,0,5,5,10
2009,Iran (Islamic Rep. of),IRN,Turkey,TUR,1345,0,263,311,1919
2009,Iraq,IRQ,Turkey,TUR,3432,0,36,471,3939
2009,Kenya,KEN,Turkey,TUR,0,0,0,5,5
2009,Liberia,LBR,Turkey,TUR,0,0,0,5,5
2009,Sri Lanka,LKA,Turkey,TUR,13,0,5,30,48
2009,Mauritania,MRT,Turkey,TUR,0,0,0,22,22
2009,Morocco,MAR,Turkey,TUR,5,0,0,5,10
2009,Myanmar,MMR,Turkey,TUR,0,0,0,87,87
2009,Nigeria,NGA,Turkey,TUR,5,0,5,10,20
2009,Pakistan,PAK,Turkey,TUR,5,0,0,15,20
2009,Sierra Leone,SLE,Turkey,TUR,0,0,0,5,5
2009,Somalia,SOM,Turkey,TUR,237,0,17,214,468
2009,Sudan,SDN,Turkey,TUR,46,0,14,77,137
2009,Syrian Arab Rep.,SYR,Turkey,TUR,5,0,0,5,10
2009,Turkmenistan,TKM,Turkey,TUR,0,0,0,5,5
2009,Uzbekistan,UZB,Turkey,TUR,12,0,0,5,17
2009,Stateless,XXA,Turkey,TUR,0,0,0,5,5
2009,Afghanistan,AFG,Ukraine,UKR,40,0,11,0,51
2009,Armenia,ARM,Ukraine,UKR,0,0,0,5,5
2009,Azerbaijan,AZE,Ukraine,UKR,12,0,0,0,12
2009,Belarus,BLR,Ukraine,UKR,0,0,5,0,5
2009,Dem. Rep. of the Congo,COD,Ukraine,UKR,10,0,10,0,20
2009,Ethiopia,ETH,Ukraine,UKR,5,0,0,0,5
2009,Palestinian,PSE,Ukraine,UKR,5,0,0,0,5
2009,Georgia,GEO,Ukraine,UKR,5,0,5,0,10
2009,Iran (Islamic Rep. of),IRN,Ukraine,UKR,15,0,5,0,20
2009,Iraq,IRQ,Ukraine,UKR,13,0,5,0,18
2009,Kazakhstan,KAZ,Ukraine,UKR,10,0,0,0,10
2009,Sri Lanka,LKA,Ukraine,UKR,5,0,5,0,10
2009,Russian Federation,RUS,Ukraine,UKR,10,0,5,5,20
2009,Somalia,SOM,Ukraine,UKR,5,0,0,5,10
2009,Sudan,SDN,Ukraine,UKR,5,0,0,0,5
2009,Syrian Arab Rep.,SYR,Ukraine,UKR,5,0,5,0,10
2009,Uzbekistan,UZB,Ukraine,UKR,18,0,10,0,28
2010,Iran (Islamic Rep. of),IRN,Afghanistan,AFG,0,0,0,5,5
2010,Pakistan,PAK,Afghanistan,AFG,10,0,0,5,15
2010,Chad,TCD,Algeria,DZA,0,0,5,0,5
2010,Cameroon,CMR,Algeria,DZA,0,0,41,12,53
2010,Congo,COG,Algeria,DZA,0,0,5,0,5
2010,Dem. Rep. of the Congo,COD,Algeria,DZA,0,0,16,5,21
2010,Guinea,GIN,Algeria,DZA,0,0,5,5,10
2010,Cote d'Ivoire,CIV,Algeria,DZA,5,0,20,0,25
2010,Iraq,IRQ,Algeria,DZA,11,0,0,0,11
2010,Liberia,LBR,Algeria,DZA,0,0,37,23,60
2010,Niger,NER,Algeria,DZA,0,0,5,0,5
2010,Nigeria,NGA,Algeria,DZA,0,0,30,29,59
2010,Sierra Leone,SLE,Algeria,DZA,0,0,5,5,10
2010,Chad,TCD,Egypt,EGY,10,0,0,0,10
2010,Eritrea,ERI,Egypt,EGY,170,0,100,17,287
2010,Ethiopia,ETH,Egypt,EGY,66,0,136,5,207
2010,Guinea,GIN,Egypt,EGY,0,0,5,0,5
2010,Cote d'Ivoire,CIV,Egypt,EGY,5,0,5,0,10
2010,Iraq,IRQ,Egypt,EGY,62,0,5,0,67
2010,Israel,ISR,Egypt,EGY,0,0,0,5,5
2010,Sri Lanka,LKA,Egypt,EGY,0,0,0,5,5
2010,Somalia,SOM,Egypt,EGY,217,0,57,10,284
2010,Sudan,SDN,Egypt,EGY,384,0,378,320,1082
2010,Turkmenistan,TKM,Egypt,EGY,5,0,0,0,5
2010,Georgia,GEO,Armenia,ARM,5,0,0,0,5
2010,Afghanistan,AFG,Azerbaijan,AZE,144,0,0,0,144
2010,Palestinian,PSE,Azerbaijan,AZE,10,0,0,0,10
2010,Iran (Islamic Rep. of),IRN,Azerbaijan,AZE,5,0,0,0,5
2010,Russian Federation,RUS,Azerbaijan,AZE,5,0,5,16,26
2010,Uzbekistan,UZB,Azerbaijan,AZE,5,0,0,0,5
2010,Iraq,IRQ,Bahrain,BHR,63,0,5,0,68
2010,Sudan,SDN,Bahrain,BHR,0,0,10,0,10
2010,Stateless,XXA,Bahrain,BHR,0,0,0,5,5
2010,Myanmar,MMR,Bangladesh,BGD,10,0,5,0,15
2010,Afghanistan,AFG,Belarus,BLR,15,0,0,0,15
2010,China,CHN,Cambodia,KHM,0,0,0,5,5
2010,Myanmar,MMR,Cambodia,KHM,0,0,5,5,10
2010,Viet Nam,VNM,Cambodia,KHM,0,0,13,0,13
2010,Burundi,BDI,Cameroon,CMR,5,0,0,0,5
2010,Central African Rep.,CAF,Cameroon,CMR,984,0,85,128,1197
2010,Chad,TCD,Cameroon,CMR,102,0,159,84,345
2010,Congo,COG,Cameroon,CMR,0,0,5,0,5
2010,Dem. Rep. of the Congo,COD,Cameroon,CMR,52,0,91,15,158
2010,Equatorial Guinea,GNQ,Cameroon,CMR,5,0,0,0,5
2010,Gabon,GAB,Cameroon,CMR,5,0,0,5,10
2010,Guinea-Bissau,GNB,Cameroon,CMR,0,0,10,18,28
2010,Guinea,GIN,Cameroon,CMR,0,0,91,337,428
2010,Cote d'Ivoire,CIV,Cameroon,CMR,5,0,12,66,83
2010,Liberia,LBR,Cameroon,CMR,5,0,0,0,5
2010,Mauritania,MRT,Cameroon,CMR,0,0,0,5,5
2010,Rwanda,RWA,Cameroon,CMR,82,0,59,5,146
2010,Sudan,SDN,Cameroon,CMR,5,0,0,0,5
2010,Togo,TGO,Cameroon,CMR,0,0,0,5,5
2010,Palestinian,PSE,Cyprus,CYP,0,0,0,5,5
2010,Iraq,IRQ,Cyprus,CYP,0,0,0,10,10
2010,Syrian Arab Rep.,SYR,Cyprus,CYP,0,0,0,5,5
2010,Cuba,CUB,Haiti,HTI,0,0,0,5,5
2010,Sri Lanka,LKA,Haiti,HTI,0,0,0,5,5
2010,Afghanistan,AFG,"China, Hong Kong SAR",HKG,10,0,5,0,15
2010,Egypt,EGY,"China, Hong Kong SAR",HKG,5,0,0,0,5
2010,Bangladesh,BGD,"China, Hong Kong SAR",HKG,0,0,5,10,15
2010,Cameroon,CMR,"China, Hong Kong SAR",HKG,0,0,5,0,5
2010,Eritrea,ERI,"China, Hong Kong SAR",HKG,5,0,0,0,5
2010,Ethiopia,ETH,"China, Hong Kong SAR",HKG,5,0,0,0,5
2010,Palestinian,PSE,"China, Hong Kong SAR",HKG,0,5,0,0,5
2010,Ghana,GHA,"China, Hong Kong SAR",HKG,0,0,0,5,5
2010,Guinea,GIN,"China, Hong Kong SAR",HKG,0,0,5,0,5
2010,India,IND,"China, Hong Kong SAR",HKG,0,0,21,25,46
2010,Indonesia,IDN,"China, Hong Kong SAR",HKG,0,0,66,100,166
2010,Liberia,LBR,"China, Hong Kong SAR",HKG,0,0,5,0,5
2010,Sri Lanka,LKA,"China, Hong Kong SAR",HKG,11,0,61,20,92
2010,Nepal,NPL,"China, Hong Kong SAR",HKG,0,0,33,10,43
2010,Nigeria,NGA,"China, Hong Kong SAR",HKG,0,0,10,0,10
2010,Pakistan,PAK,"China, Hong Kong SAR",HKG,5,0,49,52,106
2010,Philippines,PHL,"China, Hong Kong SAR",HKG,0,0,49,55,104
2010,Somalia,SOM,"China, Hong Kong SAR",HKG,37,0,0,0,37
2010,Togo,TGO,"China, Hong Kong SAR",HKG,0,0,5,0,5
2010,Uganda,UGA,"China, Hong Kong SAR",HKG,0,0,5,17,22
2010,Afghanistan,AFG,India,IND,727,0,986,265,1978
2010,Bangladesh,BGD,India,IND,0,0,0,11,11
2010,Dem. Rep. of the Congo,COD,India,IND,10,0,10,5,25
2010,Eritrea,ERI,India,IND,20,0,5,5,30
2010,Ethiopia,ETH,India,IND,5,0,0,0,5
2010,Palestinian,PSE,India,IND,10,0,0,0,10
2010,Iran (Islamic Rep. of),IRN,India,IND,25,0,20,15,60
2010,Iraq,IRQ,India,IND,21,0,5,21,47
2010,Myanmar,MMR,India,IND,2212,0,26,707,2945
2010,Somalia,SOM,India,IND,154,0,0,35,189
2010,Sudan,SDN,India,IND,5,0,5,0,10
2010,Tajikistan,TJK,India,IND,0,0,0,5,5
2010,Uzbekistan,UZB,India,IND,0,0,0,5,5
2010,Afghanistan,AFG,Iran (Islamic Rep. of),IRN,89,0,16,32,137
2010,Uzbekistan,UZB,Iran (Islamic Rep. of),IRN,0,0,0,12,12
2010,Indonesia,IDN,Iraq,IRQ,0,0,0,5,5
2010,Iran (Islamic Rep. of),IRN,Iraq,IRQ,48,0,5,67,120
2010,Turkey,TUR,Iraq,IRQ,0,0,0,1426,1426
2010,Yemen,YEM,Iraq,IRQ,0,0,0,13,13
2010,Afghanistan,AFG,Jordan,JOR,10,0,5,0,15
2010,Algeria,DZA,Jordan,JOR,0,0,5,0,5
2010,Egypt,EGY,Jordan,JOR,0,0,41,27,68
2010,Eritrea,ERI,Jordan,JOR,5,0,0,0,5
2010,Iraq,IRQ,Jordan,JOR,379,0,225,247,851
2010,Lebanon,LBN,Jordan,JOR,0,0,5,0,5
2010,Sri Lanka,LKA,Jordan,JOR,0,0,14,0,14
2010,Pakistan,PAK,Jordan,JOR,0,0,10,0,10
2010,Russian Federation,RUS,Jordan,JOR,5,0,0,0,5
2010,Somalia,SOM,Jordan,JOR,78,0,29,33,140
2010,Sudan,SDN,Jordan,JOR,96,0,89,45,230
2010,Syrian Arab Rep.,SYR,Jordan,JOR,68,0,38,22,128
2010,Tunisia,TUN,Jordan,JOR,0,0,5,0,5
2010,Turkey,TUR,Jordan,JOR,0,0,5,5,10
2010,Yemen,YEM,Jordan,JOR,0,0,15,14,29
2010,Stateless,XXA,Jordan,JOR,19,0,0,12,31
2010,Burundi,BDI,Kenya,KEN,57,0,44,5,106
2010,Congo,COG,Kenya,KEN,0,0,0,5,5
2010,Dem. Rep. of the Congo,COD,Kenya,KEN,1623,0,170,32,1825
2010,Eritrea,ERI,Kenya,KEN,303,0,20,28,351
2010,Ethiopia,ETH,Kenya,KEN,4967,0,408,2119,7494
2010,Iran (Islamic Rep. of),IRN,Kenya,KEN,5,0,0,5,10
2010,Pakistan,PAK,Kenya,KEN,0,0,5,0,5
2010,Rwanda,RWA,Kenya,KEN,28,0,90,27,145
2010,Somalia,SOM,Kenya,KEN,256,0,16,78,350
2010,Sudan,SDN,Kenya,KEN,113,0,122,10,245
2010,United Rep. of Tanzania,TZA,Kenya,KEN,0,0,0,15,15
2010,Uganda,UGA,Kenya,KEN,37,0,19,36,92
2010,Zimbabwe,ZWE,Kenya,KEN,0,0,0,5,5
2010,Afghanistan,AFG,Kuwait,KWT,0,0,5,0,5
2010,Iran (Islamic Rep. of),IRN,Kuwait,KWT,0,0,14,0,14
2010,Iraq,IRQ,Kuwait,KWT,0,0,0,29,29
2010,Somalia,SOM,Kuwait,KWT,10,0,0,0,10
2010,Syrian Arab Rep.,SYR,Kuwait,KWT,5,0,5,0,10
2010,Chad,TCD,Libya,LBY,0,0,0,212,212
2010,Dem. Rep. of the Congo,COD,Libya,LBY,0,0,0,10,10
2010,Eritrea,ERI,Libya,LBY,441,0,0,231,672
2010,Ethiopia,ETH,Libya,LBY,14,0,0,23,37
2010,Iraq,IRQ,Libya,LBY,171,0,5,110,286
2010,Liberia,LBR,Libya,LBY,0,0,0,5,5
2010,Niger,NER,Libya,LBY,0,0,0,5,5
2010,Sierra Leone,SLE,Libya,LBY,0,0,0,5,5
2010,Somalia,SOM,Libya,LBY,74,0,0,114,188
2010,Sudan,SDN,Libya,LBY,90,0,12,205,307
2010,Egypt,EGY,Lebanon,LBN,0,0,0,11,11
2010,Eritrea,ERI,Lebanon,LBN,0,0,0,5,5
2010,Ethiopia,ETH,Lebanon,LBN,0,0,5,5,10
2010,Palestinian,PSE,Lebanon,LBN,0,0,0,5,5
2010,Iran (Islamic Rep. of),IRN,Lebanon,LBN,10,0,10,91,111
2010,Iraq,IRQ,Lebanon,LBN,49,10,80,180,319
2010,Jordan,JOR,Lebanon,LBN,5,0,5,13,23
2010,Sri Lanka,LKA,Lebanon,LBN,0,0,0,5,5
2010,Philippines,PHL,Lebanon,LBN,0,0,0,5,5
2010,Somalia,SOM,Lebanon,LBN,5,0,0,12,17
2010,Sudan,SDN,Lebanon,LBN,45,0,203,89,337
2010,Syrian Arab Rep.,SYR,Lebanon,LBN,19,0,50,88,157
2010,Turkey,TUR,Lebanon,LBN,0,0,0,5,5
2010,Stateless,XXA,Lebanon,LBN,0,0,0,5,5
2010,Afghanistan,AFG,Malaysia,MYS,116,0,0,90,206
2010,Bangladesh,BGD,Malaysia,MYS,5,0,0,0,5
2010,Cambodia,KHM,Malaysia,MYS,14,0,0,0,14
2010,China,CHN,Malaysia,MYS,16,0,0,0,16
2010,Palestinian,PSE,Malaysia,MYS,46,0,0,0,46
2010,Guinea,GIN,Malaysia,MYS,0,0,5,0,5
2010,Indonesia,IDN,Malaysia,MYS,51,0,0,28,79
2010,Iran (Islamic Rep. of),IRN,Malaysia,MYS,35,0,5,0,40
2010,Iraq,IRQ,Malaysia,MYS,63,0,0,15,78
2010,Kenya,KEN,Malaysia,MYS,5,0,0,0,5
2010,Sri Lanka,LKA,Malaysia,MYS,265,0,128,0,393
2010,Myanmar,MMR,Malaysia,MYS,21036,0,210,2129,23375
2010,Nigeria,NGA,Malaysia,MYS,0,0,5,0,5
2010,Pakistan,PAK,Malaysia,MYS,32,0,0,0,32
2010,Somalia,SOM,Malaysia,MYS,193,0,10,0,203
2010,Viet Nam,VNM,Malaysia,MYS,0,0,10,0,10
2010,Sudan,SDN,Malaysia,MYS,19,0,5,0,24
2010,Thailand,THA,Malaysia,MYS,0,0,0,48,48
2010,Yemen,YEM,Malaysia,MYS,10,0,0,0,10
2010,Zimbabwe,ZWE,Malaysia,MYS,0,0,0,5,5
2010,Afghanistan,AFG,Morocco,MAR,10,0,0,0,10
2010,Algeria,DZA,Morocco,MAR,0,0,5,0,5
2010,Angola,AGO,Morocco,MAR,0,0,10,0,10
2010,Benin,BEN,Morocco,MAR,0,0,5,0,5
2010,Bangladesh,BGD,Morocco,MAR,0,0,5,0,5
2010,Central African Rep.,CAF,Morocco,MAR,0,0,5,0,5
2010,Cameroon,CMR,Morocco,MAR,5,0,24,5,34
2010,Congo,COG,Morocco,MAR,5,0,18,5,28
2010,Dem. Rep. of the Congo,COD,Morocco,MAR,39,0,209,17,265
2010,Eritrea,ERI,Morocco,MAR,5,0,5,0,10
2010,Gambia,GMB,Morocco,MAR,0,0,5,0,5
2010,Palestinian,PSE,Morocco,MAR,5,0,0,0,5
2010,Ghana,GHA,Morocco,MAR,0,0,12,0,12
2010,Guinea,GIN,Morocco,MAR,0,0,61,5,66
2010,Cote d'Ivoire,CIV,Morocco,MAR,29,0,51,10,90
2010,Iraq,IRQ,Morocco,MAR,31,0,0,0,31
2010,Liberia,LBR,Morocco,MAR,0,0,26,5,31
2010,Niger,NER,Morocco,MAR,0,0,12,5,17
2010,Nigeria,NGA,Morocco,MAR,0,0,141,10,151
2010,Pakistan,PAK,Morocco,MAR,0,0,0,5,5
2010,Rwanda,RWA,Morocco,MAR,0,0,10,0,10
2010,Sierra Leone,SLE,Morocco,MAR,0,0,25,0,25
2010,Somalia,SOM,Morocco,MAR,0,0,10,0,10
2010,Sudan,SDN,Morocco,MAR,0,0,10,0,10
2010,Uganda,UGA,Morocco,MAR,0,0,19,0,19
2010,Zimbabwe,ZWE,Morocco,MAR,0,0,10,0,10
2010,Sri Lanka,LKA,Nepal,NPL,0,0,0,5,5
2010,Myanmar,MMR,Nepal,NPL,18,0,10,13,41
2010,Pakistan,PAK,Nepal,NPL,12,0,0,5,17
2010,Iraq,IRQ,Oman,OMN,52,0,0,0,52
2010,Iraq,IRQ,Qatar,QAT,16,0,0,0,16
2010,Pakistan,PAK,Qatar,QAT,0,0,0,5,5
2010,Somalia,SOM,Qatar,QAT,5,0,0,0,5
2010,Sudan,SDN,Qatar,QAT,0,0,0,5,5
2010,Ethiopia,ETH,Saudi Arabia,SAU,0,0,0,5,5
2010,Iraq,IRQ,Saudi Arabia,SAU,0,0,0,10,10
2010,Somalia,SOM,Saudi Arabia,SAU,10,0,0,10,20
2010,Sudan,SDN,Saudi Arabia,SAU,0,0,0,5,5
2010,Uzbekistan,UZB,Saudi Arabia,SAU,0,0,0,5,5
2010,Dem. Rep. of the Congo,COD,Senegal,SEN,0,0,5,0,5
2010,Gambia,GMB,Senegal,SEN,0,0,5,0,5
2010,Guinea,GIN,Senegal,SEN,0,0,48,0,48
2010,Cote d'Ivoire,CIV,Senegal,SEN,0,0,5,0,5
2010,Mauritania,MRT,Senegal,SEN,0,0,5,0,5
2010,Nigeria,NGA,Senegal,SEN,0,0,5,0,5
2010,Sierra Leone,SLE,Senegal,SEN,0,0,5,707,712
2010,Dem. Rep. of the Congo,COD,Somalia,SOM,0,0,5,5,10
2010,Eritrea,ERI,Somalia,SOM,5,0,0,0,5
2010,Ethiopia,ETH,Somalia,SOM,158,0,206,405,769
2010,United Rep. of Tanzania,TZA,Somalia,SOM,0,0,5,0,5
2010,Unknown ,,Somalia,SOM,0,0,5,5,10
2010,Dem. Rep. of the Congo,COD,Sudan,SDN,5,0,5,0,10
2010,Eritrea,ERI,Sudan,SDN,42,0,0,0,42
2010,Ethiopia,ETH,Sudan,SDN,80,0,14,0,94
2010,Somalia,SOM,Sudan,SDN,0,0,0,13,13
2010,Afghanistan,AFG,Syrian Arab Rep.,SYR,463,0,5,246,714
2010,Algeria,DZA,Syrian Arab Rep.,SYR,0,0,0,15,15
2010,Egypt,EGY,Syrian Arab Rep.,SYR,0,0,0,32,32
2010,Burundi,BDI,Syrian Arab Rep.,SYR,5,0,0,0,5
2010,Chad,TCD,Syrian Arab Rep.,SYR,0,0,0,5,5
2010,Dem. Rep. of the Congo,COD,Syrian Arab Rep.,SYR,0,0,0,5,5
2010,Eritrea,ERI,Syrian Arab Rep.,SYR,17,0,0,13,30
2010,Ethiopia,ETH,Syrian Arab Rep.,SYR,0,0,12,5,17
2010,Palestinian,PSE,Syrian Arab Rep.,SYR,5,0,0,317,322
2010,Cote d'Ivoire,CIV,Syrian Arab Rep.,SYR,0,0,0,5,5
2010,India,IND,Syrian Arab Rep.,SYR,0,0,0,5,5
2010,Iran (Islamic Rep. of),IRN,Syrian Arab Rep.,SYR,22,0,17,90,129
2010,Iraq,IRQ,Syrian Arab Rep.,SYR,97,148,154,0,399
2010,Jordan,JOR,Syrian Arab Rep.,SYR,0,0,5,58,63
2010,Libya,LBY,Syrian Arab Rep.,SYR,0,0,0,5,5
2010,Lebanon,LBN,Syrian Arab Rep.,SYR,0,0,0,65,65
2010,Morocco,MAR,Syrian Arab Rep.,SYR,0,0,0,12,12
2010,Nigeria,NGA,Syrian Arab Rep.,SYR,0,0,0,5,5
2010,Pakistan,PAK,Syrian Arab Rep.,SYR,0,0,5,10,15
2010,Russian Federation,RUS,Syrian Arab Rep.,SYR,0,0,0,5,5
2010,Saudi Arabia,SAU,Syrian Arab Rep.,SYR,0,0,0,10,10
2010,Sierra Leone,SLE,Syrian Arab Rep.,SYR,0,0,5,0,5
2010,Somalia,SOM,Syrian Arab Rep.,SYR,389,0,16,735,1140
2010,Sudan,SDN,Syrian Arab Rep.,SYR,76,5,84,292,457
2010,Tajikistan,TJK,Syrian Arab Rep.,SYR,0,0,0,5,5
2010,Tunisia,TUN,Syrian Arab Rep.,SYR,0,0,5,0,5
2010,Turkey,TUR,Syrian Arab Rep.,SYR,0,0,0,5,5
2010,Yemen,YEM,Syrian Arab Rep.,SYR,22,0,17,29,68
2010,Stateless,XXA,Syrian Arab Rep.,SYR,16,0,0,35,51
2010,Afghanistan,AFG,Thailand,THA,0,0,0,5,5
2010,Cambodia,KHM,Thailand,THA,5,0,5,28,38
2010,China,CHN,Thailand,THA,10,0,5,22,37
2010,Cameroon,CMR,Thailand,THA,0,0,5,5,10
2010,Dem. Rep. of the Congo,COD,Thailand,THA,0,0,19,18,37
2010,Ethiopia,ETH,Thailand,THA,0,0,0,5,5
2010,Palestinian,PSE,Thailand,THA,0,0,0,5,5
2010,Guinea,GIN,Thailand,THA,0,0,16,11,27
2010,Cote d'Ivoire,CIV,Thailand,THA,0,0,0,5,5
2010,Iran (Islamic Rep. of),IRN,Thailand,THA,5,0,5,24,34
2010,Iraq,IRQ,Thailand,THA,13,0,0,10,23
2010,Kuwait,KWT,Thailand,THA,0,0,5,5,10
2010,Lao People's Dem. Rep.,LAO,Thailand,THA,115,0,0,5,120
2010,Liberia,LBR,Thailand,THA,0,0,0,5,5
2010,Sri Lanka,LKA,Thailand,THA,58,0,134,384,576
2010,Nepal,NPL,Thailand,THA,0,0,5,5,10
2010,Nigeria,NGA,Thailand,THA,0,0,5,0,5
2010,Pakistan,PAK,Thailand,THA,34,0,42,126,202
2010,Sierra Leone,SLE,Thailand,THA,0,0,5,11,16
2010,Somalia,SOM,Thailand,THA,15,0,0,0,15
2010,Viet Nam,VNM,Thailand,THA,5,0,28,82,115
2010,Afghanistan,AFG,Tajikistan,TJK,32,0,0,0,32
2010,Bangladesh,BGD,Trinidad and Tobago,TTO,0,0,0,5,5
2010,Ghana,GHA,Trinidad and Tobago,TTO,0,0,0,63,63
2010,Haiti,HTI,Trinidad and Tobago,TTO,0,5,0,0,5
2010,Liberia,LBR,Trinidad and Tobago,TTO,0,0,0,10,10
2010,Nigeria,NGA,Trinidad and Tobago,TTO,0,0,0,10,10
2010,Sudan,SDN,Trinidad and Tobago,TTO,0,0,0,5,5
2010,Zimbabwe,ZWE,Trinidad and Tobago,TTO,0,0,0,5,5
2010,Afghanistan,AFG,Turkey,TUR,528,0,374,438,1340
2010,Egypt,EGY,Turkey,TUR,5,0,0,0,5
2010,Bangladesh,BGD,Turkey,TUR,0,0,0,16,16
2010,Chad,TCD,Turkey,TUR,0,0,0,5,5
2010,China,CHN,Turkey,TUR,0,0,0,14,14
2010,Cameroon,CMR,Turkey,TUR,0,0,0,18,18
2010,Dem. Rep. of the Congo,COD,Turkey,TUR,5,0,5,34,44
2010,Eritrea,ERI,Turkey,TUR,23,0,5,28,56
2010,Ethiopia,ETH,Turkey,TUR,10,0,12,16,38
2010,Gabon,GAB,Turkey,TUR,0,0,0,5,5
2010,Palestinian,PSE,Turkey,TUR,35,0,10,32,77
2010,Guinea,GIN,Turkey,TUR,0,0,13,10,23
2010,Cote d'Ivoire,CIV,Turkey,TUR,0,0,0,11,11
2010,India,IND,Turkey,TUR,0,0,0,5,5
2010,Indonesia,IDN,Turkey,TUR,0,0,0,5,5
2010,Iran (Islamic Rep. of),IRN,Turkey,TUR,1880,0,979,340,3199
2010,Iraq,IRQ,Turkey,TUR,3323,0,175,248,3746
2010,Jordan,JOR,Turkey,TUR,5,0,0,5,10
2010,Kyrgyzstan,KGZ,Turkey,TUR,0,0,0,10,10
2010,Sri Lanka,LKA,Turkey,TUR,10,0,5,15,30
2010,Mauritania,MRT,Turkey,TUR,0,0,0,16,16
2010,Morocco,MAR,Turkey,TUR,0,0,5,0,5
2010,Myanmar,MMR,Turkey,TUR,0,0,5,60,65
2010,Nigeria,NGA,Turkey,TUR,0,0,5,5,10
2010,Pakistan,PAK,Turkey,TUR,0,0,5,21,26
2010,Russian Federation,RUS,Turkey,TUR,5,0,0,0,5
2010,Saudi Arabia,SAU,Turkey,TUR,0,0,0,5,5
2010,Senegal,SEN,Turkey,TUR,0,0,0,5,5
2010,Sierra Leone,SLE,Turkey,TUR,0,0,5,5,10
2010,Somalia,SOM,Turkey,TUR,282,0,32,93,407
2010,Sudan,SDN,Turkey,TUR,43,0,20,24,87
2010,Syrian Arab Rep.,SYR,Turkey,TUR,5,0,26,10,41
2010,Tajikistan,TJK,Turkey,TUR,0,0,0,13,13
2010,Turkmenistan,TKM,Turkey,TUR,0,0,0,5,5
2010,Uzbekistan,UZB,Turkey,TUR,10,0,0,10,20
2010,Stateless,XXA,Turkey,TUR,0,0,0,5,5
2010,Afghanistan,AFG,Ukraine,UKR,30,0,5,0,35
2010,Dem. Rep. of the Congo,COD,Ukraine,UKR,5,0,0,0,5
2010,Iran (Islamic Rep. of),IRN,Ukraine,UKR,5,0,0,0,5
2010,Iraq,IRQ,Ukraine,UKR,5,0,0,0,5
2010,Kazakhstan,KAZ,Ukraine,UKR,5,0,0,0,5
2010,Russian Federation,RUS,Ukraine,UKR,29,0,0,0,29
2010,Somalia,SOM,Ukraine,UKR,11,0,0,0,11
2010,Uzbekistan,UZB,Ukraine,UKR,15,0,5,0,20
2010,Jamaica,JAM,Curacao ,CUW,5,0,0,0,5
2011,Benin,BEN,Algeria,DZA,0,0,5,0,5
2011,Chad,TCD,Algeria,DZA,0,0,5,5,10
2011,Cameroon,CMR,Algeria,DZA,0,0,83,105,188
2011,Dem. Rep. of the Congo,COD,Algeria,DZA,0,0,10,12,22
2011,Palestinian,PSE,Algeria,DZA,10,0,0,0,10
2011,Guinea,GIN,Algeria,DZA,0,0,5,11,16
2011,Cote d'Ivoire,CIV,Algeria,DZA,0,0,0,35,35
2011,Jordan,JOR,Algeria,DZA,0,0,0,16,16
2011,Liberia,LBR,Algeria,DZA,0,0,5,15,20
2011,Niger,NER,Algeria,DZA,0,0,10,5,15
2011,Nigeria,NGA,Algeria,DZA,0,0,30,55,85
2011,Sierra Leone,SLE,Algeria,DZA,0,0,0,5,5
2011,Sudan,SDN,Algeria,DZA,0,0,5,18,23
2011,China,CHN,Egypt,EGY,5,0,0,0,5
2011,Congo,COG,Egypt,EGY,0,0,5,0,5
2011,Eritrea,ERI,Egypt,EGY,161,0,23,30,214
2011,Ethiopia,ETH,Egypt,EGY,64,0,108,46,218
2011,Palestinian,PSE,Egypt,EGY,10,0,0,0,10
2011,Guinea,GIN,Egypt,EGY,5,0,0,0,5
2011,Cote d'Ivoire,CIV,Egypt,EGY,10,0,0,10,20
2011,Iraq,IRQ,Egypt,EGY,26,0,10,193,229
2011,Kazakhstan,KAZ,Egypt,EGY,0,0,5,0,5
2011,Libya,LBY,Egypt,EGY,5,0,0,0,5
2011,Mali,MLI,Egypt,EGY,0,0,0,5,5
2011,Nigeria,NGA,Egypt,EGY,0,0,5,0,5
2011,Russian Federation,RUS,Egypt,EGY,0,0,5,0,5
2011,Somalia,SOM,Egypt,EGY,164,0,94,28,286
2011,Sudan,SDN,Egypt,EGY,265,0,259,384,908
2011,Syrian Arab Rep.,SYR,Egypt,EGY,0,0,0,5,5
2011,Tajikistan,TJK,Egypt,EGY,10,0,5,0,15
2011,Uzbekistan,UZB,Egypt,EGY,0,0,13,0,13
2011,Afghanistan,AFG,Azerbaijan,AZE,11,5,0,0,16
2011,Armenia,ARM,Azerbaijan,AZE,10,0,0,0,10
2011,Iran (Islamic Rep. of),IRN,Azerbaijan,AZE,0,0,5,0,5
2011,Iraq,IRQ,Azerbaijan,AZE,5,0,0,0,5
2011,Pakistan,PAK,Azerbaijan,AZE,0,0,12,0,12
2011,Russian Federation,RUS,Azerbaijan,AZE,0,0,0,5,5
2011,Iraq,IRQ,Bahrain,BHR,0,47,0,0,47
2011,Myanmar,MMR,Bangladesh,BGD,0,0,5,0,5
2011,Central African Rep.,CAF,Dem. Rep. of the Congo,COD,0,0,0,10,10
2011,Mozambique,MOZ,Dem. Rep. of the Congo,COD,0,0,0,5,5
2011,Eritrea,ERI,Djibouti,DJI,49,0,0,53,102
2011,Ethiopia,ETH,Djibouti,DJI,0,5,0,85,90
2011,Iraq,IRQ,Djibouti,DJI,0,0,0,5,5
2011,Yemen,YEM,Djibouti,DJI,0,0,0,10,10
2011,Somalia,SOM,Eritrea,ERI,0,0,0,135,135
2011,Iran (Islamic Rep. of),IRN,Grenada,GRD,5,0,0,0,5
2011,Afghanistan,AFG,"China, Hong Kong SAR",HKG,0,0,5,0,5
2011,Egypt,EGY,"China, Hong Kong SAR",HKG,0,0,5,5,10
2011,Benin,BEN,"China, Hong Kong SAR",HKG,0,0,5,0,5
2011,Bangladesh,BGD,"China, Hong Kong SAR",HKG,0,0,10,5,15
2011,Dem. Rep. of the Congo,COD,"China, Hong Kong SAR",HKG,0,0,5,0,5
2011,Colombia,COL,"China, Hong Kong SAR",HKG,0,0,0,5,5
2011,India,IND,"China, Hong Kong SAR",HKG,0,0,35,39,74
2011,Indonesia,IDN,"China, Hong Kong SAR",HKG,0,0,63,142,205
2011,Sri Lanka,LKA,"China, Hong Kong SAR",HKG,10,0,45,5,60
2011,Mongolia,MNG,"China, Hong Kong SAR",HKG,0,0,0,5,5
2011,Nepal,NPL,"China, Hong Kong SAR",HKG,0,0,15,18,33
2011,Nigeria,NGA,"China, Hong Kong SAR",HKG,0,0,5,5,10
2011,Pakistan,PAK,"China, Hong Kong SAR",HKG,5,0,42,33,80
2011,Philippines,PHL,"China, Hong Kong SAR",HKG,0,0,58,46,104
2011,South Africa,ZAF,"China, Hong Kong SAR",HKG,0,0,0,5,5
2011,Somalia,SOM,"China, Hong Kong SAR",HKG,16,0,5,0,21
2011,Togo,TGO,"China, Hong Kong SAR",HKG,0,0,5,0,5
2011,Uganda,UGA,"China, Hong Kong SAR",HKG,0,0,0,5,5
2011,Bangladesh,BGD,Honduras,HND,0,0,0,5,5
2011,Colombia,COL,Honduras,HND,5,0,0,0,5
2011,Afghanistan,AFG,India,IND,438,0,418,0,856
2011,Dem. Rep. of the Congo,COD,India,IND,5,0,10,0,15
2011,Eritrea,ERI,India,IND,13,0,0,0,13
2011,Ethiopia,ETH,India,IND,0,0,5,0,5
2011,Palestinian,PSE,India,IND,5,0,0,0,5
2011,Iran (Islamic Rep. of),IRN,India,IND,25,0,5,0,30
2011,Iraq,IRQ,India,IND,25,0,0,0,25
2011,Myanmar,MMR,India,IND,2471,0,59,512,3042
2011,Pakistan,PAK,India,IND,65,0,0,0,65
2011,Rwanda,RWA,India,IND,5,0,0,0,5
2011,Somalia,SOM,India,IND,128,0,0,33,161
2011,Sudan,SDN,India,IND,5,0,5,0,10
2011,Uzbekistan,UZB,India,IND,5,0,0,0,5
2011,Afghanistan,AFG,Iran (Islamic Rep. of),IRN,105,0,175,1055,1335
2011,Iraq,IRQ,Iran (Islamic Rep. of),IRN,0,0,5,88,93
2011,Pakistan,PAK,Iran (Islamic Rep. of),IRN,0,0,0,19,19
2011,Iran (Islamic Rep. of),IRN,Iraq,IRQ,25,0,0,11,36
2011,Egypt,EGY,Israel,ISR,5,0,0,0,5
2011,Chad,TCD,Israel,ISR,5,0,5,0,10
2011,Dem. Rep. of the Congo,COD,Israel,ISR,0,0,5,0,5
2011,Colombia,COL,Israel,ISR,5,0,0,0,5
2011,Eritrea,ERI,Israel,ISR,47,0,10,0,57
2011,Ethiopia,ETH,Israel,ISR,10,0,14,0,24
2011,Ghana,GHA,Israel,ISR,0,0,5,0,5
2011,Guinea,GIN,Israel,ISR,5,0,0,0,5
2011,Cote d'Ivoire,CIV,Israel,ISR,5,14,5,0,24
2011,Nigeria,NGA,Israel,ISR,0,0,5,0,5
2011,Somalia,SOM,Israel,ISR,5,0,0,0,5
2011,Sudan,SDN,Israel,ISR,20,0,11,0,31
2011,Unknown ,,Israel,ISR,0,0,0,949,949
2011,Afghanistan,AFG,Kazakhstan,KAZ,5,0,10,18,33
2011,China,CHN,Kazakhstan,KAZ,0,0,0,39,39
2011,Palestinian,PSE,Kazakhstan,KAZ,5,0,0,0,5
2011,Kyrgyzstan,KGZ,Kazakhstan,KAZ,0,0,0,12,12
2011,Uzbekistan,UZB,Kazakhstan,KAZ,5,0,5,215,225
2011,Eritrea,ERI,Kenya,KEN,5,0,0,0,5
2011,Ethiopia,ETH,Kenya,KEN,2906,0,10,571,3487
2011,Somalia,SOM,Kenya,KEN,274,0,0,140,414
2011,Sudan,SDN,Kenya,KEN,5,0,0,5,10
2011,United Rep. of Tanzania,TZA,Kenya,KEN,0,0,0,5,5
2011,Afghanistan,AFG,Kuwait,KWT,0,0,0,1794,1794
2011,Eritrea,ERI,Kuwait,KWT,0,0,0,5,5
2011,Palestinian,PSE,Kuwait,KWT,0,0,0,124,124
2011,Iran (Islamic Rep. of),IRN,Kuwait,KWT,0,0,0,22,22
2011,Iraq,IRQ,Kuwait,KWT,0,0,0,166,166
2011,Nepal,NPL,Kuwait,KWT,0,0,0,5,5
2011,Somalia,SOM,Kuwait,KWT,0,0,0,41,41
2011,Syrian Arab Rep.,SYR,Kuwait,KWT,5,0,0,5,10
2011,Stateless,XXA,Kuwait,KWT,0,0,0,230,230
2011,Eritrea,ERI,Libya,LBY,0,0,0,285,285
2011,Ethiopia,ETH,Libya,LBY,0,0,0,39,39
2011,Iraq,IRQ,Libya,LBY,0,0,0,15,15
2011,Somalia,SOM,Libya,LBY,0,0,0,45,45
2011,Sudan,SDN,Libya,LBY,0,0,0,5,5
2011,Egypt,EGY,Lebanon,LBN,0,0,5,5,10
2011,Chad,TCD,Lebanon,LBN,0,0,0,5,5
2011,Ethiopia,ETH,Lebanon,LBN,0,0,5,14,19
2011,Palestinian,PSE,Lebanon,LBN,0,0,0,10,10
2011,Iran (Islamic Rep. of),IRN,Lebanon,LBN,0,0,0,11,11
2011,Iraq,IRQ,Lebanon,LBN,419,0,98,135,652
2011,Jordan,JOR,Lebanon,LBN,0,0,0,5,5
2011,Philippines,PHL,Lebanon,LBN,0,0,0,5,5
2011,Somalia,SOM,Lebanon,LBN,5,0,0,0,5
2011,Sudan,SDN,Lebanon,LBN,40,0,79,178,297
2011,Syrian Arab Rep.,SYR,Lebanon,LBN,60,0,44,51,155
2011,Stateless,XXA,Lebanon,LBN,0,0,0,10,10
2011,Afghanistan,AFG,Malaysia,MYS,5,0,0,29,34
2011,Bangladesh,BGD,Malaysia,MYS,0,0,0,5,5
2011,Cambodia,KHM,Malaysia,MYS,0,0,0,5,5
2011,China,CHN,Malaysia,MYS,11,0,10,17,38
2011,Palestinian,PSE,Malaysia,MYS,52,0,0,22,74
2011,Cote d'Ivoire,CIV,Malaysia,MYS,0,0,0,5,5
2011,Indonesia,IDN,Malaysia,MYS,28,0,5,42,75
2011,Iran (Islamic Rep. of),IRN,Malaysia,MYS,38,0,13,41,92
2011,Iraq,IRQ,Malaysia,MYS,127,0,0,33,160
2011,Sri Lanka,LKA,Malaysia,MYS,100,0,322,131,553
2011,Myanmar,MMR,Malaysia,MYS,10855,0,974,3548,15377
2011,Nigeria,NGA,Malaysia,MYS,0,0,5,0,5
2011,Pakistan,PAK,Malaysia,MYS,10,0,5,0,15
2011,Somalia,SOM,Malaysia,MYS,132,0,5,61,198
2011,Sudan,SDN,Malaysia,MYS,10,0,0,11,21
2011,Syrian Arab Rep.,SYR,Malaysia,MYS,5,0,0,5,10
2011,Yemen,YEM,Malaysia,MYS,10,0,0,0,10
2011,Benin,BEN,Morocco,MAR,0,0,10,0,10
2011,Bangladesh,BGD,Morocco,MAR,0,0,0,5,5
2011,Burkina Faso,BFA,Morocco,MAR,0,0,5,0,5
2011,Central African Rep.,CAF,Morocco,MAR,0,0,5,0,5
2011,Chad,TCD,Morocco,MAR,0,0,0,5,5
2011,Cameroon,CMR,Morocco,MAR,0,0,19,5,24
2011,Congo,COG,Morocco,MAR,0,0,5,5,10
2011,Dem. Rep. of the Congo,COD,Morocco,MAR,10,0,144,33,187
2011,Eritrea,ERI,Morocco,MAR,0,0,5,5,10
2011,Gambia,GMB,Morocco,MAR,0,0,5,0,5
2011,Palestinian,PSE,Morocco,MAR,5,0,0,5,10
2011,Ghana,GHA,Morocco,MAR,0,0,12,0,12
2011,Guinea,GIN,Morocco,MAR,0,0,32,14,46
2011,Cote d'Ivoire,CIV,Morocco,MAR,10,0,10,27,47
2011,Iraq,IRQ,Morocco,MAR,5,0,0,0,5
2011,Liberia,LBR,Morocco,MAR,0,0,20,10,30
2011,Libya,LBY,Morocco,MAR,0,0,0,13,13
2011,Mali,MLI,Morocco,MAR,0,0,5,0,5
2011,Niger,NER,Morocco,MAR,0,0,10,5,15
2011,Nigeria,NGA,Morocco,MAR,0,0,99,14,113
2011,Rwanda,RWA,Morocco,MAR,0,0,5,0,5
2011,Sierra Leone,SLE,Morocco,MAR,0,0,10,0,10
2011,Somalia,SOM,Morocco,MAR,10,0,0,10,20
2011,Sudan,SDN,Morocco,MAR,0,0,5,0,5
2011,Togo,TGO,Morocco,MAR,0,0,5,0,5
2011,Uganda,UGA,Morocco,MAR,0,0,5,0,5
2011,Sri Lanka,LKA,Nepal,NPL,16,0,0,0,16
2011,Pakistan,PAK,Nepal,NPL,5,0,0,17,22
2011,Somalia,SOM,Nepal,NPL,5,0,0,0,5
2011,Iraq,IRQ,Oman,OMN,5,0,0,0,5
2011,Iraq,IRQ,Qatar,QAT,26,0,0,0,26
2011,Somalia,SOM,Qatar,QAT,0,5,0,0,5
2011,Egypt,EGY,Saudi Arabia,SAU,0,0,5,0,5
2011,Iraq,IRQ,Saudi Arabia,SAU,17,0,0,0,17
2011,Somalia,SOM,Saudi Arabia,SAU,0,0,0,5,5
2011,Ethiopia,ETH,Somalia,SOM,126,0,0,17991,18117
2011,Chad,TCD,Sudan,SDN,10,0,0,0,10
2011,Eritrea,ERI,Sudan,SDN,51,0,0,0,51
2011,Ethiopia,ETH,Sudan,SDN,27,0,5,43,75
2011,Iraq,IRQ,Sudan,SDN,10,0,0,0,10
2011,Burundi,BDI,South Sudan,SSD,0,0,5,0,5
2011,Dem. Rep. of the Congo,COD,South Sudan,SSD,0,0,5,0,5
2011,Eritrea,ERI,South Sudan,SSD,0,0,5,0,5
2011,Ethiopia,ETH,South Sudan,SSD,5,0,113,5,123
2011,Somalia,SOM,South Sudan,SSD,0,0,5,0,5
2011,Sudan,SDN,South Sudan,SSD,5,0,0,0,5
2011,Uganda,UGA,South Sudan,SSD,0,0,5,0,5
2011,Afghanistan,AFG,Syrian Arab Rep.,SYR,358,0,80,167,605
2011,Algeria,DZA,Syrian Arab Rep.,SYR,10,0,16,10,36
2011,Egypt,EGY,Syrian Arab Rep.,SYR,14,0,5,16,35
2011,Burkina Faso,BFA,Syrian Arab Rep.,SYR,0,0,0,5,5
2011,Chad,TCD,Syrian Arab Rep.,SYR,0,0,5,5,10
2011,Congo,COG,Syrian Arab Rep.,SYR,0,0,5,0,5
2011,Colombia,COL,Syrian Arab Rep.,SYR,0,0,0,5,5
2011,Eritrea,ERI,Syrian Arab Rep.,SYR,12,0,5,5,22
2011,Ethiopia,ETH,Syrian Arab Rep.,SYR,5,0,14,34,53
2011,Palestinian,PSE,Syrian Arab Rep.,SYR,0,0,0,61,61
2011,Cote d'Ivoire,CIV,Syrian Arab Rep.,SYR,0,0,5,0,5
2011,Iran (Islamic Rep. of),IRN,Syrian Arab Rep.,SYR,14,0,14,96,124
2011,Iraq,IRQ,Syrian Arab Rep.,SYR,136,0,293,801,1230
2011,Jordan,JOR,Syrian Arab Rep.,SYR,0,0,5,29,34
2011,Kuwait,KWT,Syrian Arab Rep.,SYR,5,0,0,0,5
2011,Libya,LBY,Syrian Arab Rep.,SYR,0,0,0,10,10
2011,Lebanon,LBN,Syrian Arab Rep.,SYR,0,0,0,5,5
2011,Morocco,MAR,Syrian Arab Rep.,SYR,0,0,5,0,5
2011,Pakistan,PAK,Syrian Arab Rep.,SYR,15,0,22,10,47
2011,Russian Federation,RUS,Syrian Arab Rep.,SYR,0,0,0,5,5
2011,Somalia,SOM,Syrian Arab Rep.,SYR,405,0,0,266,671
2011,Sudan,SDN,Syrian Arab Rep.,SYR,47,0,87,254,388
2011,Tunisia,TUN,Syrian Arab Rep.,SYR,0,0,0,14,14
2011,Uzbekistan,UZB,Syrian Arab Rep.,SYR,0,0,0,10,10
2011,Yemen,YEM,Syrian Arab Rep.,SYR,5,0,5,54,64
2011,Stateless,XXA,Syrian Arab Rep.,SYR,0,0,0,19,19
2011,Bangladesh,BGD,Thailand,THA,0,0,5,0,5
2011,Cambodia,KHM,Thailand,THA,18,0,0,0,18
2011,China,CHN,Thailand,THA,25,0,5,16,46
2011,Cameroon,CMR,Thailand,THA,0,0,0,5,5
2011,Dem. Rep. of the Congo,COD,Thailand,THA,0,0,31,24,55
2011,Guinea,GIN,Thailand,THA,0,0,5,14,19
2011,Cote d'Ivoire,CIV,Thailand,THA,0,0,0,5,5
2011,India,IND,Thailand,THA,0,0,0,5,5
2011,Iran (Islamic Rep. of),IRN,Thailand,THA,0,0,5,20,25
2011,Iraq,IRQ,Thailand,THA,13,0,5,10,28
2011,Lao People's Dem. Rep.,LAO,Thailand,THA,5,0,0,0,5
2011,Liberia,LBR,Thailand,THA,0,0,10,12,22
2011,Sri Lanka,LKA,Thailand,THA,39,0,100,230,369
2011,Nepal,NPL,Thailand,THA,5,0,0,0,5
2011,Nigeria,NGA,Thailand,THA,0,0,0,5,5
2011,Pakistan,PAK,Thailand,THA,282,0,21,90,393
2011,Somalia,SOM,Thailand,THA,37,0,5,10,52
2011,Viet Nam,VNM,Thailand,THA,67,0,12,5,84
2011,Uganda,UGA,Thailand,THA,0,0,0,5,5
2011,Afghanistan,AFG,Tajikistan,TJK,26,0,0,0,26
2011,Cameroon,CMR,Trinidad and Tobago,TTO,0,0,0,5,5
2011,Cuba,CUB,Trinidad and Tobago,TTO,5,0,0,0,5
2011,Ethiopia,ETH,Trinidad and Tobago,TTO,0,0,0,5,5
2011,Ghana,GHA,Trinidad and Tobago,TTO,0,0,0,5,5
2011,Guinea,GIN,Trinidad and Tobago,TTO,0,0,0,5,5
2011,Cote d'Ivoire,CIV,Trinidad and Tobago,TTO,0,0,5,5,10
2011,Liberia,LBR,Trinidad and Tobago,TTO,0,0,5,5,10
2011,Nigeria,NGA,Trinidad and Tobago,TTO,0,0,0,19,19
2011,Senegal,SEN,Trinidad and Tobago,TTO,0,0,0,10,10
2011,Sierra Leone,SLE,Trinidad and Tobago,TTO,0,0,0,10,10
2011,Togo,TGO,Trinidad and Tobago,TTO,0,0,0,5,5
2011,Afghanistan,AFG,Turkey,TUR,870,0,76,595,1541
2011,Algeria,DZA,Turkey,TUR,0,0,0,5,5
2011,Bangladesh,BGD,Turkey,TUR,0,0,5,10,15
2011,China,CHN,Turkey,TUR,0,0,5,17,22
2011,Cameroon,CMR,Turkey,TUR,5,0,0,37,42
2011,Congo,COG,Turkey,TUR,0,0,0,5,5
2011,Dem. Rep. of the Congo,COD,Turkey,TUR,22,0,0,59,81
2011,Eritrea,ERI,Turkey,TUR,15,0,10,21,46
2011,Ethiopia,ETH,Turkey,TUR,25,0,5,5,35
2011,Palestinian,PSE,Turkey,TUR,36,0,5,53,94
2011,Guinea,GIN,Turkey,TUR,5,0,0,24,29
2011,Cote d'Ivoire,CIV,Turkey,TUR,5,0,0,23,28
2011,India,IND,Turkey,TUR,0,0,0,5,5
2011,Iran (Islamic Rep. of),IRN,Turkey,TUR,2268,0,127,397,2792
2011,Iraq,IRQ,Turkey,TUR,4484,0,25,261,4770
2011,Kyrgyzstan,KGZ,Turkey,TUR,0,0,0,108,108
2011,Liberia,LBR,Turkey,TUR,0,0,0,5,5
2011,Libya,LBY,Turkey,TUR,0,0,0,5,5
2011,Sri Lanka,LKA,Turkey,TUR,0,0,0,5,5
2011,Mauritania,MRT,Turkey,TUR,5,0,0,0,5
2011,Morocco,MAR,Turkey,TUR,5,0,0,15,20
2011,Myanmar,MMR,Turkey,TUR,0,0,0,10,10
2011,Nepal,NPL,Turkey,TUR,0,0,0,5,5
2011,Nigeria,NGA,Turkey,TUR,0,0,5,10,15
2011,Pakistan,PAK,Turkey,TUR,14,0,10,33,57
2011,Rwanda,RWA,Turkey,TUR,0,0,0,12,12
2011,Senegal,SEN,Turkey,TUR,0,0,0,5,5
2011,Sierra Leone,SLE,Turkey,TUR,0,0,0,5,5
2011,Somalia,SOM,Turkey,TUR,255,0,17,148,420
2011,Sudan,SDN,Turkey,TUR,32,0,10,19,61
2011,Syrian Arab Rep.,SYR,Turkey,TUR,13,0,5,30,48
2011,United Rep. of Tanzania,TZA,Turkey,TUR,0,0,0,5,5
2011,Tajikistan,TJK,Turkey,TUR,0,0,0,20,20
2011,Turkmenistan,TKM,Turkey,TUR,0,0,0,5,5
2011,Tunisia,TUN,Turkey,TUR,5,0,0,10,15
2011,Uganda,UGA,Turkey,TUR,5,0,0,0,5
2011,Uzbekistan,UZB,Turkey,TUR,5,0,0,45,50
2011,Yemen,YEM,Turkey,TUR,5,0,0,5,10
2011,Stateless,XXA,Turkey,TUR,14,0,0,0,14
2011,Afghanistan,AFG,Ukraine,UKR,23,0,5,10,38
2011,Dem. Rep. of the Congo,COD,Ukraine,UKR,5,0,10,0,15
2011,Ethiopia,ETH,Ukraine,UKR,0,0,0,5,5
2011,Guinea,GIN,Ukraine,UKR,0,0,5,5,10
2011,Iran (Islamic Rep. of),IRN,Ukraine,UKR,5,0,5,10,20
2011,Iraq,IRQ,Ukraine,UKR,5,0,0,0,5
2011,Russian Federation,RUS,Ukraine,UKR,5,0,0,11,16
2011,Somalia,SOM,Ukraine,UKR,5,0,0,14,19
2011,Syrian Arab Rep.,SYR,Ukraine,UKR,0,0,10,0,10
2011,Uzbekistan,UZB,Ukraine,UKR,46,0,0,0,46
2011,Sri Lanka,LKA,Montserrat,MSR,0,0,0,10,10
2011,Colombia,COL,Curacao ,CUW,0,0,0,5,5
2012,Afghanistan,AFG,Algeria,DZA,0,0,0,5,5
2012,Benin,BEN,Algeria,DZA,0,0,10,5,15
2012,Chad,TCD,Algeria,DZA,0,0,13,10,23
2012,Cameroon,CMR,Algeria,DZA,0,0,108,137,245
2012,Congo,COG,Algeria,DZA,0,0,0,5,5
2012,Dem. Rep. of the Congo,COD,Algeria,DZA,5,0,10,11,26
2012,Palestinian,PSE,Algeria,DZA,5,0,0,0,5
2012,Guinea,GIN,Algeria,DZA,0,0,10,5,15
2012,Cote d'Ivoire,CIV,Algeria,DZA,5,0,5,72,82
2012,Liberia,LBR,Algeria,DZA,0,0,5,5,10
2012,Libya,LBY,Algeria,DZA,0,0,0,12,12
2012,Niger,NER,Algeria,DZA,0,0,5,5,10
2012,Nigeria,NGA,Algeria,DZA,0,0,15,57,72
2012,Sierra Leone,SLE,Algeria,DZA,0,0,0,5,5
2012,Sudan,SDN,Algeria,DZA,0,0,0,25,25
2012,Syrian Arab Rep.,SYR,Algeria,DZA,0,0,0,5,5
2012,Chad,TCD,Egypt,EGY,12,0,0,0,12
2012,Cameroon,CMR,Egypt,EGY,0,0,5,0,5
2012,Dem. Rep. of the Congo,COD,Egypt,EGY,11,0,5,0,16
2012,Eritrea,ERI,Egypt,EGY,320,0,10,0,330
2012,Ethiopia,ETH,Egypt,EGY,300,0,118,5,423
2012,Palestinian,PSE,Egypt,EGY,5,0,0,0,5
2012,Guinea,GIN,Egypt,EGY,0,0,5,0,5
2012,Cote d'Ivoire,CIV,Egypt,EGY,14,0,5,20,39
2012,Iraq,IRQ,Egypt,EGY,277,0,5,550,832
2012,Liberia,LBR,Egypt,EGY,0,0,5,0,5
2012,Libya,LBY,Egypt,EGY,0,0,5,0,5
2012,Nigeria,NGA,Egypt,EGY,0,0,12,0,12
2012,Somalia,SOM,Egypt,EGY,444,0,26,0,470
2012,Sudan,SDN,Egypt,EGY,1753,0,110,4168,6031
2012,South Sudan,SSD,Egypt,EGY,5,0,0,0,5
2012,Syrian Arab Rep.,SYR,Egypt,EGY,85,0,0,0,85
2012,Tunisia,TUN,Egypt,EGY,0,0,5,0,5
2012,Yemen,YEM,Egypt,EGY,0,0,5,0,5
2012,Zimbabwe,ZWE,Egypt,EGY,5,0,0,0,5
2012,Afghanistan,AFG,Azerbaijan,AZE,10,11,5,11,37
2012,Iran (Islamic Rep. of),IRN,Azerbaijan,AZE,13,0,5,0,18
2012,Pakistan,PAK,Azerbaijan,AZE,5,0,14,0,19
2012,Russian Federation,RUS,Azerbaijan,AZE,5,0,5,10,20
2012,Iraq,IRQ,Bahrain,BHR,89,5,0,51,145
2012,Myanmar,MMR,Bangladesh,BGD,5,0,0,0,5
2012,Afghanistan,AFG,Belarus,BLR,0,0,0,10,10
2012,Russian Federation,RUS,Belarus,BLR,0,0,0,5,5
2012,Angola,AGO,Dem. Rep. of the Congo,COD,0,0,0,5,5
2012,Burundi,BDI,Dem. Rep. of the Congo,COD,15,0,29,42,86
2012,Central African Rep.,CAF,Dem. Rep. of the Congo,COD,5,0,5,0,10
2012,Cameroon,CMR,Dem. Rep. of the Congo,COD,5,0,0,0,5
2012,Congo,COG,Dem. Rep. of the Congo,COD,10,0,5,27,42
2012,Cote d'Ivoire,CIV,Dem. Rep. of the Congo,COD,0,0,0,5,5
2012,Rwanda,RWA,Dem. Rep. of the Congo,COD,22,0,5,0,27
2012,Somalia,SOM,Dem. Rep. of the Congo,COD,0,0,0,25,25
2012,Uganda,UGA,Dem. Rep. of the Congo,COD,5,0,0,0,5
2012,Afghanistan,AFG,"China, Hong Kong SAR",HKG,0,0,0,5,5
2012,Egypt,EGY,"China, Hong Kong SAR",HKG,0,0,0,5,5
2012,Bangladesh,BGD,"China, Hong Kong SAR",HKG,0,0,11,10,21
2012,Colombia,COL,"China, Hong Kong SAR",HKG,0,0,0,5,5
2012,Ghana,GHA,"China, Hong Kong SAR",HKG,0,0,0,5,5
2012,India,IND,"China, Hong Kong SAR",HKG,0,0,36,30,66
2012,Indonesia,IDN,"China, Hong Kong SAR",HKG,0,0,172,144,316
2012,Sri Lanka,LKA,"China, Hong Kong SAR",HKG,0,0,17,11,28
2012,Nepal,NPL,"China, Hong Kong SAR",HKG,0,0,5,5,10
2012,Nigeria,NGA,"China, Hong Kong SAR",HKG,0,0,5,0,5
2012,Pakistan,PAK,"China, Hong Kong SAR",HKG,5,0,37,52,94
2012,Peru,PER,"China, Hong Kong SAR",HKG,0,0,0,5,5
2012,Philippines,PHL,"China, Hong Kong SAR",HKG,0,0,47,41,88
2012,Somalia,SOM,"China, Hong Kong SAR",HKG,5,0,0,0,5
2012,Thailand,THA,"China, Hong Kong SAR",HKG,0,0,0,5,5
2012,Togo,TGO,"China, Hong Kong SAR",HKG,0,0,5,0,5
2012,Uganda,UGA,"China, Hong Kong SAR",HKG,0,0,5,10,15
2012,Yemen,YEM,"China, Hong Kong SAR",HKG,0,0,0,10,10
2012,Afghanistan,AFG,India,IND,663,0,320,0,983
2012,Cameroon,CMR,India,IND,0,0,5,0,5
2012,Dem. Rep. of the Congo,COD,India,IND,11,0,15,0,26
2012,Eritrea,ERI,India,IND,5,0,0,0,5
2012,Palestinian,PSE,India,IND,24,0,0,0,24
2012,Cote d'Ivoire,CIV,India,IND,5,0,0,5,10
2012,Iran (Islamic Rep. of),IRN,India,IND,24,0,0,0,24
2012,Iraq,IRQ,India,IND,10,0,5,0,15
2012,Myanmar,MMR,India,IND,1145,0,42,421,1608
2012,Somalia,SOM,India,IND,71,0,0,0,71
2012,Sudan,SDN,India,IND,11,0,0,0,11
2012,Syrian Arab Rep.,SYR,India,IND,5,0,0,5,10
2012,Afghanistan,AFG,Iran (Islamic Rep. of),IRN,69,0,216,123,408
2012,Pakistan,PAK,Iran (Islamic Rep. of),IRN,0,0,5,10,15
2012,Uzbekistan,UZB,Iran (Islamic Rep. of),IRN,0,0,0,5,5
2012,Iran (Islamic Rep. of),IRN,Iraq,IRQ,15,0,0,0,15
2012,Syrian Arab Rep.,SYR,Iraq,IRQ,5,0,0,202,207
2012,Turkey,TUR,Iraq,IRQ,43,0,0,17,60
2012,Chad,TCD,Israel,ISR,0,0,0,5,5
2012,China,CHN,Israel,ISR,0,0,0,5,5
2012,Colombia,COL,Israel,ISR,0,0,0,19,19
2012,Eritrea,ERI,Israel,ISR,19,0,10,0,29
2012,Ethiopia,ETH,Israel,ISR,0,0,10,27,37
2012,Ghana,GHA,Israel,ISR,0,0,0,35,35
2012,Guinea,GIN,Israel,ISR,0,0,10,60,70
2012,Cote d'Ivoire,CIV,Israel,ISR,0,0,10,229,239
2012,Nepal,NPL,Israel,ISR,0,0,0,14,14
2012,Nigeria,NGA,Israel,ISR,0,0,5,57,62
2012,Sudan,SDN,Israel,ISR,5,0,5,0,10
2012,South Sudan,SSD,Israel,ISR,0,0,0,118,118
2012,Togo,TGO,Israel,ISR,0,0,0,5,5
2012,Unknown ,,Israel,ISR,0,0,0,59,59
2012,Afghanistan,AFG,Kazakhstan,KAZ,0,0,0,5,5
2012,Egypt,EGY,Kenya,KEN,5,0,0,5,10
2012,Burundi,BDI,Kenya,KEN,51,0,70,103,224
2012,Dem. Rep. of the Congo,COD,Kenya,KEN,827,0,279,868,1974
2012,Eritrea,ERI,Kenya,KEN,279,0,29,182,490
2012,Ethiopia,ETH,Kenya,KEN,2486,32,1611,3916,8045
2012,Cote d'Ivoire,CIV,Kenya,KEN,0,0,0,5,5
2012,Liberia,LBR,Kenya,KEN,0,0,5,0,5
2012,Sri Lanka,LKA,Kenya,KEN,5,0,0,5,10
2012,Rwanda,RWA,Kenya,KEN,41,0,91,244,376
2012,Somalia,SOM,Kenya,KEN,242,0,165,620,1027
2012,Sudan,SDN,Kenya,KEN,28,0,25,1301,1354
2012,South Sudan,SSD,Kenya,KEN,217,5,14,322,558
2012,United Rep. of Tanzania,TZA,Kenya,KEN,0,0,0,39,39
2012,Uganda,UGA,Kenya,KEN,18,0,23,62,103
2012,Chad,TCD,Libya,LBY,0,0,0,10,10
2012,Dem. Rep. of the Congo,COD,Libya,LBY,0,0,0,5,5
2012,Eritrea,ERI,Libya,LBY,0,0,0,207,207
2012,Ethiopia,ETH,Libya,LBY,0,0,0,18,18
2012,Palestinian,PSE,Libya,LBY,431,0,0,0,431
2012,Cote d'Ivoire,CIV,Libya,LBY,0,0,0,5,5
2012,Iraq,IRQ,Libya,LBY,0,0,0,10,10
2012,Somalia,SOM,Libya,LBY,0,0,0,77,77
2012,Sudan,SDN,Libya,LBY,0,0,0,33,33
2012,Syrian Arab Rep.,SYR,Libya,LBY,0,0,0,5,5
2012,Afghanistan,AFG,Lebanon,LBN,0,0,0,12,12
2012,Egypt,EGY,Lebanon,LBN,11,0,39,10,60
2012,Eritrea,ERI,Lebanon,LBN,5,0,0,0,5
2012,Ethiopia,ETH,Lebanon,LBN,0,0,10,0,10
2012,Iran (Islamic Rep. of),IRN,Lebanon,LBN,0,0,0,5,5
2012,Iraq,IRQ,Lebanon,LBN,319,16,90,311,736
2012,Jordan,JOR,Lebanon,LBN,5,0,0,5,10
2012,Libya,LBY,Lebanon,LBN,5,0,0,0,5
2012,Madagascar,MDG,Lebanon,LBN,0,0,5,0,5
2012,Somalia,SOM,Lebanon,LBN,5,0,0,0,5
2012,Sudan,SDN,Lebanon,LBN,73,0,286,97,456
2012,Syrian Arab Rep.,SYR,Lebanon,LBN,33,0,5,230,268
2012,Turkey,TUR,Lebanon,LBN,0,0,5,0,5
2012,Yemen,YEM,Lebanon,LBN,0,0,0,10,10
2012,Afghanistan,AFG,Malaysia,MYS,31,0,0,32,63
2012,Egypt,EGY,Malaysia,MYS,0,0,0,5,5
2012,Bangladesh,BGD,Malaysia,MYS,5,0,0,0,5
2012,Cambodia,KHM,Malaysia,MYS,5,0,0,13,18
2012,China,CHN,Malaysia,MYS,21,0,5,0,26
2012,Ethiopia,ETH,Malaysia,MYS,5,0,0,0,5
2012,Palestinian,PSE,Malaysia,MYS,19,0,5,31,55
2012,Indonesia,IDN,Malaysia,MYS,33,0,0,36,69
2012,Iran (Islamic Rep. of),IRN,Malaysia,MYS,73,0,24,0,97
2012,Iraq,IRQ,Malaysia,MYS,84,0,0,72,156
2012,Liberia,LBR,Malaysia,MYS,5,0,0,0,5
2012,Lebanon,LBN,Malaysia,MYS,0,0,0,5,5
2012,Sri Lanka,LKA,Malaysia,MYS,153,0,292,331,776
2012,Myanmar,MMR,Malaysia,MYS,12164,0,545,4433,17142
2012,Pakistan,PAK,Malaysia,MYS,34,0,12,10,56
2012,Philippines,PHL,Malaysia,MYS,0,0,0,5,5
2012,Somalia,SOM,Malaysia,MYS,119,0,10,61,190
2012,Viet Nam,VNM,Malaysia,MYS,5,0,0,0,5
2012,Sudan,SDN,Malaysia,MYS,20,0,5,0,25
2012,Thailand,THA,Malaysia,MYS,5,0,0,5,10
2012,Yemen,YEM,Malaysia,MYS,5,0,23,0,28
2012,China,CHN,Mongolia,MNG,5,0,0,0,5
2012,Central African Rep.,CAF,Morocco,MAR,0,0,5,0,5
2012,Chad,TCD,Morocco,MAR,0,0,5,0,5
2012,Cameroon,CMR,Morocco,MAR,0,0,25,10,35
2012,Dem. Rep. of the Congo,COD,Morocco,MAR,12,10,49,46,117
2012,Palestinian,PSE,Morocco,MAR,0,0,0,10,10
2012,Guinea,GIN,Morocco,MAR,0,0,22,5,27
2012,Cote d'Ivoire,CIV,Morocco,MAR,81,5,26,153,265
2012,Iraq,IRQ,Morocco,MAR,5,5,0,0,10
2012,Liberia,LBR,Morocco,MAR,0,0,10,5,15
2012,Libya,LBY,Morocco,MAR,0,0,0,13,13
2012,Mali,MLI,Morocco,MAR,0,0,0,5,5
2012,Nigeria,NGA,Morocco,MAR,0,0,76,10,86
2012,Pakistan,PAK,Morocco,MAR,0,0,0,5,5
2012,Sierra Leone,SLE,Morocco,MAR,0,0,0,5,5
2012,Sudan,SDN,Morocco,MAR,0,0,5,5,10
2012,Iran (Islamic Rep. of),IRN,Nepal,NPL,5,0,0,0,5
2012,Sri Lanka,LKA,Nepal,NPL,10,0,0,0,10
2012,Myanmar,MMR,Nepal,NPL,17,0,0,0,17
2012,Pakistan,PAK,Nepal,NPL,19,0,5,0,24
2012,Somalia,SOM,Nepal,NPL,5,0,0,0,5
2012,Iraq,IRQ,Oman,OMN,54,0,0,0,54
2012,Somalia,SOM,Papua New Guinea,PNG,5,0,0,0,5
2012,Iraq,IRQ,Qatar,QAT,0,0,5,10,15
2012,Eritrea,ERI,Somalia,SOM,5,0,0,0,5
2012,Ethiopia,ETH,Somalia,SOM,119,0,76,764,959
2012,Yemen,YEM,Somalia,SOM,0,0,0,5,5
2012,Unknown ,,Somalia,SOM,0,0,0,15,15
2012,Egypt,EGY,Sudan,SDN,10,0,0,0,10
2012,Eritrea,ERI,Sudan,SDN,47,0,0,0,47
2012,Ethiopia,ETH,Sudan,SDN,35,0,0,5,40
2012,Iraq,IRQ,Sudan,SDN,5,0,0,0,5
2012,Ethiopia,ETH,South Sudan,SSD,0,0,0,82,82
2012,Afghanistan,AFG,Syrian Arab Rep.,SYR,73,0,30,32,135
2012,Algeria,DZA,Syrian Arab Rep.,SYR,5,0,5,5,15
2012,Egypt,EGY,Syrian Arab Rep.,SYR,5,0,10,0,15
2012,Bosnia and Herzegovina,BIH,Syrian Arab Rep.,SYR,0,0,0,5,5
2012,Chad,TCD,Syrian Arab Rep.,SYR,0,0,5,0,5
2012,Eritrea,ERI,Syrian Arab Rep.,SYR,0,0,5,11,16
2012,Ethiopia,ETH,Syrian Arab Rep.,SYR,0,0,10,5,15
2012,Palestinian,PSE,Syrian Arab Rep.,SYR,0,0,0,5,5
2012,Iran (Islamic Rep. of),IRN,Syrian Arab Rep.,SYR,14,0,25,28,67
2012,Iraq,IRQ,Syrian Arab Rep.,SYR,81,5,333,223,642
2012,Jordan,JOR,Syrian Arab Rep.,SYR,0,0,5,0,5
2012,Kuwait,KWT,Syrian Arab Rep.,SYR,0,0,0,27,27
2012,Libya,LBY,Syrian Arab Rep.,SYR,5,0,0,5,10
2012,Morocco,MAR,Syrian Arab Rep.,SYR,0,0,5,0,5
2012,Pakistan,PAK,Syrian Arab Rep.,SYR,0,0,5,10,15
2012,Somalia,SOM,Syrian Arab Rep.,SYR,116,5,5,58,184
2012,Sudan,SDN,Syrian Arab Rep.,SYR,43,5,115,39,202
2012,South Sudan,SSD,Syrian Arab Rep.,SYR,5,0,0,0,5
2012,Yemen,YEM,Syrian Arab Rep.,SYR,13,0,41,13,67
2012,Egypt,EGY,Thailand,THA,10,0,0,0,10
2012,Bangladesh,BGD,Thailand,THA,0,0,5,5,10
2012,Cambodia,KHM,Thailand,THA,32,0,16,5,53
2012,China,CHN,Thailand,THA,46,0,38,15,99
2012,Cameroon,CMR,Thailand,THA,0,0,10,10,20
2012,Dem. Rep. of the Congo,COD,Thailand,THA,0,0,26,25,51
2012,Ethiopia,ETH,Thailand,THA,0,0,0,5,5
2012,Palestinian,PSE,Thailand,THA,38,0,0,5,43
2012,Ghana,GHA,Thailand,THA,0,0,5,0,5
2012,Guinea,GIN,Thailand,THA,0,0,10,5,15
2012,Cote d'Ivoire,CIV,Thailand,THA,0,0,5,5,10
2012,India,IND,Thailand,THA,0,0,5,0,5
2012,Iran (Islamic Rep. of),IRN,Thailand,THA,11,0,36,15,62
2012,Iraq,IRQ,Thailand,THA,17,0,0,10,27
2012,Lao People's Dem. Rep.,LAO,Thailand,THA,0,0,5,0,5
2012,Liberia,LBR,Thailand,THA,0,0,10,0,10
2012,Sri Lanka,LKA,Thailand,THA,21,0,28,16,65
2012,Nepal,NPL,Thailand,THA,0,0,10,5,15
2012,Pakistan,PAK,Thailand,THA,112,0,10,24,146
2012,Somalia,SOM,Thailand,THA,48,0,5,10,63
2012,Viet Nam,VNM,Thailand,THA,40,0,251,33,324
2012,Sudan,SDN,Thailand,THA,5,0,0,0,5
2012,Syrian Arab Rep.,SYR,Thailand,THA,11,0,0,26,37
2012,Yemen,YEM,Thailand,THA,5,0,0,0,5
2012,Afghanistan,AFG,Tajikistan,TJK,16,0,5,0,21
2012,Kyrgyzstan,KGZ,Tajikistan,TJK,0,0,0,10,10
2012,Colombia,COL,Trinidad and Tobago,TTO,5,0,0,0,5
2012,Chad,TCD,Tunisia,TUN,5,0,5,5,15
2012,Dem. Rep. of the Congo,COD,Tunisia,TUN,0,0,0,5,5
2012,Eritrea,ERI,Tunisia,TUN,43,0,0,0,43
2012,Ethiopia,ETH,Tunisia,TUN,10,0,0,0,10
2012,Guinea,GIN,Tunisia,TUN,0,0,0,5,5
2012,Cote d'Ivoire,CIV,Tunisia,TUN,5,0,0,12,17
2012,Iraq,IRQ,Tunisia,TUN,10,0,0,0,10
2012,Mali,MLI,Tunisia,TUN,5,0,0,5,10
2012,Somalia,SOM,Tunisia,TUN,95,0,5,32,132
2012,Sudan,SDN,Tunisia,TUN,131,0,24,20,175
2012,Afghanistan,AFG,Turkey,TUR,1144,0,185,548,1877
2012,Algeria,DZA,Turkey,TUR,0,0,0,10,10
2012,Egypt,EGY,Turkey,TUR,0,0,0,5,5
2012,Azerbaijan,AZE,Turkey,TUR,5,0,0,0,5
2012,Bangladesh,BGD,Turkey,TUR,0,0,0,5,5
2012,China,CHN,Turkey,TUR,0,0,0,14,14
2012,Cameroon,CMR,Turkey,TUR,0,0,0,18,18
2012,Dem. Rep. of the Congo,COD,Turkey,TUR,12,0,5,29,46
2012,Eritrea,ERI,Turkey,TUR,5,0,0,5,10
2012,Ethiopia,ETH,Turkey,TUR,24,0,0,5,29
2012,Palestinian,PSE,Turkey,TUR,65,0,0,26,91
2012,Ghana,GHA,Turkey,TUR,0,0,0,5,5
2012,Cote d'Ivoire,CIV,Turkey,TUR,5,0,0,19,24
2012,India,IND,Turkey,TUR,0,0,0,5,5
2012,Iran (Islamic Rep. of),IRN,Turkey,TUR,1942,0,179,369,2490
2012,Iraq,IRQ,Turkey,TUR,6381,0,44,721,7146
2012,Jordan,JOR,Turkey,TUR,5,0,0,0,5
2012,Kazakhstan,KAZ,Turkey,TUR,0,0,5,0,5
2012,Kenya,KEN,Turkey,TUR,0,0,0,5,5
2012,Kyrgyzstan,KGZ,Turkey,TUR,173,0,5,34,212
2012,Kuwait,KWT,Turkey,TUR,0,0,0,5,5
2012,Libya,LBY,Turkey,TUR,0,0,0,10,10
2012,Lebanon,LBN,Turkey,TUR,5,0,0,0,5
2012,Sri Lanka,LKA,Turkey,TUR,0,0,0,5,5
2012,Morocco,MAR,Turkey,TUR,0,0,10,5,15
2012,Myanmar,MMR,Turkey,TUR,0,0,0,5,5
2012,Nigeria,NGA,Turkey,TUR,0,0,5,5,10
2012,Pakistan,PAK,Turkey,TUR,5,0,5,5,15
2012,Rwanda,RWA,Turkey,TUR,0,0,0,10,10
2012,Senegal,SEN,Turkey,TUR,0,0,0,20,20
2012,Sierra Leone,SLE,Turkey,TUR,0,0,0,5,5
2012,Somalia,SOM,Turkey,TUR,840,0,31,160,1031
2012,Sudan,SDN,Turkey,TUR,26,0,0,10,36
2012,Syrian Arab Rep.,SYR,Turkey,TUR,10,0,0,20,30
2012,Tajikistan,TJK,Turkey,TUR,0,0,0,19,19
2012,Turkmenistan,TKM,Turkey,TUR,5,0,5,11,21
2012,Tunisia,TUN,Turkey,TUR,0,0,5,0,5
2012,Uganda,UGA,Turkey,TUR,5,0,0,31,36
2012,Uzbekistan,UZB,Turkey,TUR,14,0,10,85,109
2012,Yemen,YEM,Turkey,TUR,10,0,0,0,10
2012,Stateless,XXA,Turkey,TUR,5,0,0,0,5
2012,Cuba,CUB,Sint Maarten (Dutch part),SXM,0,0,5,0,5
2013,Pakistan,PAK,Afghanistan,AFG,0,0,15,0,15
2013,Benin,BEN,Algeria,DZA,0,0,30,5,35
2013,Chad,TCD,Algeria,DZA,0,0,5,19,24
2013,Cameroon,CMR,Algeria,DZA,5,0,633,260,898
2013,Congo,COG,Algeria,DZA,0,0,10,0,10
2013,Dem. Rep. of the Congo,COD,Algeria,DZA,5,0,45,27,77
2013,Gabon,GAB,Algeria,DZA,0,0,5,0,5
2013,Palestinian,PSE,Algeria,DZA,0,0,0,16,16
2013,Guinea,GIN,Algeria,DZA,0,0,68,26,94
2013,Cote d'Ivoire,CIV,Algeria,DZA,5,0,213,95,313
2013,Liberia,LBR,Algeria,DZA,0,0,17,5,22
2013,Libya,LBY,Algeria,DZA,0,0,0,32,32
2013,Mali,MLI,Algeria,DZA,0,0,14,10,24
2013,Niger,NER,Algeria,DZA,0,0,43,27,70
2013,Nigeria,NGA,Algeria,DZA,0,0,79,59,138
2013,Sierra Leone,SLE,Algeria,DZA,0,0,5,0,5
2013,Sudan,SDN,Algeria,DZA,0,0,0,14,14
2013,Syrian Arab Rep.,SYR,Algeria,DZA,0,0,0,48,48
2013,Yemen,YEM,Algeria,DZA,5,0,0,0,5
2013,Afghanistan,AFG,Azerbaijan,AZE,58,0,19,26,103
2013,Algeria,DZA,Azerbaijan,AZE,0,0,5,0,5
2013,Palestinian,PSE,Azerbaijan,AZE,5,0,0,0,5
2013,Iran (Islamic Rep. of),IRN,Azerbaijan,AZE,5,0,10,0,15
2013,Pakistan,PAK,Azerbaijan,AZE,5,0,10,5,20
2013,Russian Federation,RUS,Azerbaijan,AZE,0,0,0,5,5
2013,Syrian Arab Rep.,SYR,Azerbaijan,AZE,5,0,0,0,5
2013,Iraq,IRQ,Bahrain,BHR,17,0,5,12,34
2013,Syrian Arab Rep.,SYR,Bahrain,BHR,0,0,0,5,5
2013,Myanmar,MMR,Bangladesh,BGD,14,0,0,0,14
2013,Mexico,MEX,Cayman Islands,CYM,5,0,0,0,5
2013,Central African Rep.,CAF,Cameroon,CMR,62,0,110,196,368
2013,Chad,TCD,Cameroon,CMR,10,0,24,47,81
2013,Dem. Rep. of the Congo,COD,Cameroon,CMR,0,0,5,0,5
2013,Guinea-Bissau,GNB,Cameroon,CMR,0,0,5,0,5
2013,Guinea,GIN,Cameroon,CMR,5,0,84,0,89
2013,Cote d'Ivoire,CIV,Cameroon,CMR,5,0,14,0,19
2013,Libya,LBY,Cameroon,CMR,0,0,0,5,5
2013,Mali,MLI,Cameroon,CMR,0,0,10,5,15
2013,Rwanda,RWA,Cameroon,CMR,0,0,28,10,38
2013,Senegal,SEN,Cameroon,CMR,0,0,42,5,47
2013,Sierra Leone,SLE,Cameroon,CMR,0,0,5,0,5
2013,Palestinian,PSE,Cyprus,CYP,0,0,0,17,17
2013,Jordan,JOR,Cyprus,CYP,0,0,0,5,5
2013,Pakistan,PAK,Cyprus,CYP,0,0,0,5,5
2013,Syrian Arab Rep.,SYR,Cyprus,CYP,0,0,0,22,22
2013,Cuba,CUB,Haiti,HTI,0,0,0,10,10
2013,Egypt,EGY,"China, Hong Kong SAR",HKG,0,0,0,5,5
2013,Bangladesh,BGD,"China, Hong Kong SAR",HKG,0,0,0,19,19
2013,Colombia,COL,"China, Hong Kong SAR",HKG,0,0,0,14,14
2013,Fiji,FJI,"China, Hong Kong SAR",HKG,0,0,0,5,5
2013,India,IND,"China, Hong Kong SAR",HKG,0,0,5,63,68
2013,Indonesia,IDN,"China, Hong Kong SAR",HKG,0,0,43,163,206
2013,Sri Lanka,LKA,"China, Hong Kong SAR",HKG,0,0,0,5,5
2013,Namibia,NAM,"China, Hong Kong SAR",HKG,0,0,5,0,5
2013,Nepal,NPL,"China, Hong Kong SAR",HKG,0,0,0,5,5
2013,Nigeria,NGA,"China, Hong Kong SAR",HKG,0,0,0,5,5
2013,Pakistan,PAK,"China, Hong Kong SAR",HKG,0,0,16,56,72
2013,Philippines,PHL,"China, Hong Kong SAR",HKG,0,0,11,39,50
2013,Rwanda,RWA,"China, Hong Kong SAR",HKG,5,0,0,0,5
2013,Somalia,SOM,"China, Hong Kong SAR",HKG,18,0,0,0,18
2013,Viet Nam,VNM,"China, Hong Kong SAR",HKG,0,0,0,28,28
2013,Syrian Arab Rep.,SYR,"China, Hong Kong SAR",HKG,0,0,0,5,5
2013,United Rep. of Tanzania,TZA,"China, Hong Kong SAR",HKG,0,0,0,5,5
2013,Thailand,THA,"China, Hong Kong SAR",HKG,0,0,0,10,10
2013,Togo,TGO,"China, Hong Kong SAR",HKG,0,0,0,5,5
2013,Uganda,UGA,"China, Hong Kong SAR",HKG,0,0,5,5,10
2013,Yemen,YEM,"China, Hong Kong SAR",HKG,5,0,0,5,10
2013,Afghanistan,AFG,India,IND,894,0,330,217,1441
2013,Cameroon,CMR,India,IND,0,0,5,0,5
2013,Dem. Rep. of the Congo,COD,India,IND,13,0,22,5,40
2013,Eritrea,ERI,India,IND,12,0,0,0,12
2013,Palestinian,PSE,India,IND,24,0,0,0,24
2013,Cote d'Ivoire,CIV,India,IND,5,0,0,0,5
2013,Iran (Islamic Rep. of),IRN,India,IND,11,0,0,0,11
2013,Iraq,IRQ,India,IND,24,0,5,12,41
2013,Maldives,MDV,India,IND,5,0,0,0,5
2013,Myanmar,MMR,India,IND,3712,0,75,38,3825
2013,Nigeria,NGA,India,IND,0,0,5,0,5
2013,Romania,ROU,India,IND,5,0,0,0,5
2013,Somalia,SOM,India,IND,38,0,0,26,64
2013,Sudan,SDN,India,IND,18,0,14,0,32
2013,Syrian Arab Rep.,SYR,India,IND,17,0,0,0,17
2013,Afghanistan,AFG,Indonesia,IDN,960,0,81,2542,3583
2013,Egypt,EGY,Indonesia,IDN,0,0,0,5,5
2013,Bangladesh,BGD,Indonesia,IDN,0,0,5,51,56
2013,China,CHN,Indonesia,IDN,13,0,5,0,18
2013,Dem. Rep. of the Congo,COD,Indonesia,IDN,5,0,5,0,10
2013,Ethiopia,ETH,Indonesia,IDN,11,0,0,0,11
2013,Palestinian,PSE,Indonesia,IDN,150,0,0,128,278
2013,Iran (Islamic Rep. of),IRN,Indonesia,IDN,164,0,106,518,788
2013,Iraq,IRQ,Indonesia,IDN,60,0,14,412,486
2013,Kuwait,KWT,Indonesia,IDN,0,0,0,5,5
2013,Lebanon,LBN,Indonesia,IDN,0,0,0,10,10
2013,Sri Lanka,LKA,Indonesia,IDN,137,0,44,192,373
2013,Myanmar,MMR,Indonesia,IDN,559,0,5,262,826
2013,Nepal,NPL,Indonesia,IDN,0,0,0,5,5
2013,Pakistan,PAK,Indonesia,IDN,108,0,10,460,578
2013,Somalia,SOM,Indonesia,IDN,155,0,5,31,191
2013,Viet Nam,VNM,Indonesia,IDN,0,0,0,5,5
2013,Sudan,SDN,Indonesia,IDN,12,0,0,39,51
2013,Syrian Arab Rep.,SYR,Indonesia,IDN,32,0,0,10,42
2013,Yemen,YEM,Indonesia,IDN,0,0,5,0,5
2013,Afghanistan,AFG,Iran (Islamic Rep. of),IRN,13,0,10,0,23
2013,Pakistan,PAK,Iran (Islamic Rep. of),IRN,5,0,0,0,5
2013,Iran (Islamic Rep. of),IRN,Iraq,IRQ,47,0,0,31,78
2013,Syrian Arab Rep.,SYR,Iraq,IRQ,20,0,0,0,20
2013,Turkey,TUR,Iraq,IRQ,23,0,0,0,23
2013,Afghanistan,AFG,Kazakhstan,KAZ,18,0,0,0,18
2013,Uzbekistan,UZB,Kazakhstan,KAZ,0,0,5,0,5
2013,Afghanistan,AFG,Kenya,KEN,5,0,0,0,5
2013,Burundi,BDI,Kenya,KEN,42,0,43,49,134
2013,Dem. Rep. of the Congo,COD,Kenya,KEN,1849,0,143,96,2088
2013,Eritrea,ERI,Kenya,KEN,154,0,10,46,210
2013,Ethiopia,ETH,Kenya,KEN,2625,0,1686,1510,5821
2013,Sri Lanka,LKA,Kenya,KEN,5,0,0,5,10
2013,Nigeria,NGA,Kenya,KEN,0,0,15,0,15
2013,Rwanda,RWA,Kenya,KEN,27,0,63,0,90
2013,Somalia,SOM,Kenya,KEN,371,0,107,636,1114
2013,Sudan,SDN,Kenya,KEN,116,0,11,67,194
2013,South Sudan,SSD,Kenya,KEN,195,0,86,79,360
2013,United Rep. of Tanzania,TZA,Kenya,KEN,0,0,14,0,14
2013,Uganda,UGA,Kenya,KEN,5,0,29,45,79
2013,Egypt,EGY,Kuwait,KWT,5,0,0,5,10
2013,Iran (Islamic Rep. of),IRN,Kuwait,KWT,0,0,10,14,24
2013,Iraq,IRQ,Kuwait,KWT,101,0,0,147,248
2013,Jordan,JOR,Kuwait,KWT,0,0,0,5,5
2013,Lebanon,LBN,Kuwait,KWT,0,0,0,5,5
2013,Somalia,SOM,Kuwait,KWT,38,0,0,30,68
2013,Dem. Rep. of the Congo,COD,Libya,LBY,5,0,0,0,5
2013,Eritrea,ERI,Libya,LBY,5,0,0,5,10
2013,Palestinian,PSE,Libya,LBY,1677,0,0,0,1677
2013,Iraq,IRQ,Libya,LBY,12,0,0,38,50
2013,Somalia,SOM,Libya,LBY,0,0,0,5,5
2013,Sudan,SDN,Libya,LBY,16,0,0,5,21
2013,Afghanistan,AFG,Lebanon,LBN,0,0,5,12,17
2013,Egypt,EGY,Lebanon,LBN,20,0,50,46,116
2013,Bahrain,BHR,Lebanon,LBN,0,0,0,11,11
2013,Eritrea,ERI,Lebanon,LBN,0,0,5,0,5
2013,Ethiopia,ETH,Lebanon,LBN,0,0,10,5,15
2013,Cote d'Ivoire,CIV,Lebanon,LBN,0,0,5,0,5
2013,India,IND,Lebanon,LBN,0,0,5,0,5
2013,Iran (Islamic Rep. of),IRN,Lebanon,LBN,0,0,17,0,17
2013,Iraq,IRQ,Lebanon,LBN,759,0,200,249,1208
2013,Jordan,JOR,Lebanon,LBN,0,0,0,5,5
2013,Madagascar,MDG,Lebanon,LBN,0,0,5,0,5
2013,Saudi Arabia,SAU,Lebanon,LBN,5,0,0,5,10
2013,Somalia,SOM,Lebanon,LBN,16,0,0,5,21
2013,Sudan,SDN,Lebanon,LBN,66,0,151,49,266
2013,Suriname,SUR,Lebanon,LBN,0,0,0,13,13
2013,Syrian Arab Rep.,SYR,Lebanon,LBN,408,0,0,0,408
2013,Yemen,YEM,Lebanon,LBN,0,0,0,5,5
2013,Stateless,XXA,Lebanon,LBN,358,0,0,0,358
2013,Maldives,MDV,Sri Lanka,LKA,0,0,25,20,45
2013,Pakistan,PAK,Sri Lanka,LKA,59,0,75,63,197
2013,Syrian Arab Rep.,SYR,Sri Lanka,LKA,0,0,0,5,5
2013,Pakistan,PAK,Madagascar,MDG,5,0,0,0,5
2013,Burundi,BDI,Mauritania,MRT,0,0,0,5,5
2013,Benin,BEN,Mauritania,MRT,0,0,0,5,5
2013,Chad,TCD,Mauritania,MRT,0,0,0,5,5
2013,Cameroon,CMR,Mauritania,MRT,0,0,0,15,15
2013,Congo,COG,Mauritania,MRT,0,0,5,5,10
2013,Dem. Rep. of the Congo,COD,Mauritania,MRT,0,0,15,122,137
2013,Palestinian,PSE,Mauritania,MRT,5,0,0,5,10
2013,Guinea,GIN,Mauritania,MRT,0,0,0,5,5
2013,Cote d'Ivoire,CIV,Mauritania,MRT,13,0,104,288,405
2013,Iraq,IRQ,Mauritania,MRT,0,0,0,5,5
2013,Liberia,LBR,Mauritania,MRT,0,0,0,5,5
2013,Nigeria,NGA,Mauritania,MRT,0,0,0,5,5
2013,Senegal,SEN,Mauritania,MRT,0,0,0,5,5
2013,Syrian Arab Rep.,SYR,Mauritania,MRT,5,0,0,0,5
2013,Togo,TGO,Mauritania,MRT,0,0,0,5,5
2013,Afghanistan,AFG,Malaysia,MYS,21,0,0,27,48
2013,Egypt,EGY,Malaysia,MYS,0,0,10,5,15
2013,Cambodia,KHM,Malaysia,MYS,14,0,0,0,14
2013,Congo,COG,Malaysia,MYS,0,0,0,5,5
2013,Dem. Rep. of the Congo,COD,Malaysia,MYS,5,0,0,0,5
2013,Palestinian,PSE,Malaysia,MYS,81,0,10,27,118
2013,Indonesia,IDN,Malaysia,MYS,69,0,10,23,102
2013,Iran (Islamic Rep. of),IRN,Malaysia,MYS,82,0,45,47,174
2013,Iraq,IRQ,Malaysia,MYS,131,0,5,55,191
2013,Liberia,LBR,Malaysia,MYS,5,0,5,0,10
2013,Sri Lanka,LKA,Malaysia,MYS,109,0,307,598,1014
2013,Myanmar,MMR,Malaysia,MYS,13465,0,649,5711,19825
2013,Nepal,NPL,Malaysia,MYS,0,0,0,5,5
2013,Nigeria,NGA,Malaysia,MYS,0,0,0,10,10
2013,Pakistan,PAK,Malaysia,MYS,82,0,56,46,184
2013,Philippines,PHL,Malaysia,MYS,0,0,0,5,5
2013,Somalia,SOM,Malaysia,MYS,139,0,20,82,241
2013,Sudan,SDN,Malaysia,MYS,29,0,12,5,46
2013,Syrian Arab Rep.,SYR,Malaysia,MYS,100,0,0,17,117
2013,Thailand,THA,Malaysia,MYS,0,0,0,24,24
2013,Yemen,YEM,Malaysia,MYS,13,0,0,41,54
2013,China,CHN,Mongolia,MNG,5,0,0,0,5
2013,Benin,BEN,Morocco,MAR,0,0,5,0,5
2013,Burkina Faso,BFA,Morocco,MAR,0,0,0,5,5
2013,Chad,TCD,Morocco,MAR,0,0,5,0,5
2013,Cameroon,CMR,Morocco,MAR,11,0,62,10,83
2013,Congo,COG,Morocco,MAR,5,0,34,0,39
2013,Dem. Rep. of the Congo,COD,Morocco,MAR,12,0,140,22,174
2013,Eritrea,ERI,Morocco,MAR,0,0,5,0,5
2013,Gambia,GMB,Morocco,MAR,0,0,10,0,10
2013,Palestinian,PSE,Morocco,MAR,13,0,0,5,18
2013,Ghana,GHA,Morocco,MAR,5,0,11,0,16
2013,Guinea-Bissau,GNB,Morocco,MAR,0,0,0,5,5
2013,Guinea,GIN,Morocco,MAR,0,0,24,10,34
2013,Cote d'Ivoire,CIV,Morocco,MAR,141,0,90,0,231
2013,Iraq,IRQ,Morocco,MAR,0,0,0,5,5
2013,Kenya,KEN,Morocco,MAR,0,0,5,0,5
2013,Liberia,LBR,Morocco,MAR,0,0,10,5,15
2013,Mali,MLI,Morocco,MAR,0,0,0,10,10
2013,Niger,NER,Morocco,MAR,0,0,13,0,13
2013,Nigeria,NGA,Morocco,MAR,0,0,210,5,215
2013,Rwanda,RWA,Morocco,MAR,0,0,5,0,5
2013,Saudi Arabia,SAU,Morocco,MAR,0,0,0,5,5
2013,Senegal,SEN,Morocco,MAR,5,0,5,5,15
2013,Sierra Leone,SLE,Morocco,MAR,0,0,5,5,10
2013,Somalia,SOM,Morocco,MAR,0,0,5,5,10
2013,Sudan,SDN,Morocco,MAR,0,0,18,5,23
2013,Syrian Arab Rep.,SYR,Morocco,MAR,0,0,0,858,858
2013,Togo,TGO,Morocco,MAR,0,0,0,5,5
2013,Uganda,UGA,Morocco,MAR,0,0,5,5,10
2013,Zimbabwe,ZWE,Morocco,MAR,0,0,5,5,10
2013,Myanmar,MMR,Nepal,NPL,44,0,0,0,44
2013,Pakistan,PAK,Nepal,NPL,32,0,28,10,70
2013,Iraq,IRQ,Oman,OMN,5,0,0,0,5
2013,India,IND,Qatar,QAT,0,0,0,5,5
2013,Iraq,IRQ,Qatar,QAT,39,0,0,12,51
2013,Yemen,YEM,Qatar,QAT,0,0,0,5,5
2013,Eritrea,ERI,Saudi Arabia,SAU,10,0,0,0,10
2013,Iraq,IRQ,Saudi Arabia,SAU,10,0,0,0,10
2013,Syrian Arab Rep.,SYR,Saudi Arabia,SAU,5,0,0,0,5
2013,Eritrea,ERI,Somalia,SOM,0,0,0,5,5
2013,Ethiopia,ETH,Somalia,SOM,55,0,83,1322,1460
2013,United Rep. of Tanzania,TZA,Somalia,SOM,0,0,0,5,5
2013,Eritrea,ERI,Sudan,SDN,59,0,0,0,59
2013,Ethiopia,ETH,Sudan,SDN,14,0,0,0,14
2013,Afghanistan,AFG,Syrian Arab Rep.,SYR,123,0,0,38,161
2013,Algeria,DZA,Syrian Arab Rep.,SYR,0,0,5,0,5
2013,Egypt,EGY,Syrian Arab Rep.,SYR,0,0,55,10,65
2013,Bangladesh,BGD,Syrian Arab Rep.,SYR,0,0,5,0,5
2013,Burkina Faso,BFA,Syrian Arab Rep.,SYR,0,0,5,0,5
2013,Eritrea,ERI,Syrian Arab Rep.,SYR,5,0,0,0,5
2013,Ethiopia,ETH,Syrian Arab Rep.,SYR,10,0,26,0,36
2013,Guinea,GIN,Syrian Arab Rep.,SYR,5,0,11,0,16
2013,Cote d'Ivoire,CIV,Syrian Arab Rep.,SYR,0,0,0,5,5
2013,Iran (Islamic Rep. of),IRN,Syrian Arab Rep.,SYR,0,0,26,22,48
2013,Iraq,IRQ,Syrian Arab Rep.,SYR,113,0,79,100,292
2013,Jordan,JOR,Syrian Arab Rep.,SYR,0,0,47,5,52
2013,Kenya,KEN,Syrian Arab Rep.,SYR,0,0,10,0,10
2013,Kuwait,KWT,Syrian Arab Rep.,SYR,5,0,0,5,10
2013,Libya,LBY,Syrian Arab Rep.,SYR,0,0,5,5,10
2013,Lebanon,LBN,Syrian Arab Rep.,SYR,0,0,54,0,54
2013,Morocco,MAR,Syrian Arab Rep.,SYR,0,0,10,0,10
2013,Nigeria,NGA,Syrian Arab Rep.,SYR,0,0,5,0,5
2013,Pakistan,PAK,Syrian Arab Rep.,SYR,15,0,45,15,75
2013,Philippines,PHL,Syrian Arab Rep.,SYR,0,0,18,0,18
2013,Somalia,SOM,Syrian Arab Rep.,SYR,11,0,5,39,55
2013,Sudan,SDN,Syrian Arab Rep.,SYR,97,0,113,169,379
2013,South Sudan,SSD,Syrian Arab Rep.,SYR,0,0,10,0,10
2013,Tunisia,TUN,Syrian Arab Rep.,SYR,0,0,11,0,11
2013,Yemen,YEM,Syrian Arab Rep.,SYR,28,0,26,65,119
2013,Afghanistan,AFG,Thailand,THA,5,0,0,0,5
2013,Egypt,EGY,Thailand,THA,0,0,0,5,5
2013,Cambodia,KHM,Thailand,THA,26,0,0,10,36
2013,China,CHN,Thailand,THA,30,0,0,5,35
2013,Cameroon,CMR,Thailand,THA,0,0,0,5,5
2013,Dem. Rep. of the Congo,COD,Thailand,THA,5,0,0,5,10
2013,Palestinian,PSE,Thailand,THA,97,0,0,21,118
2013,Cote d'Ivoire,CIV,Thailand,THA,5,0,0,5,10
2013,India,IND,Thailand,THA,0,0,0,5,5
2013,Iran (Islamic Rep. of),IRN,Thailand,THA,5,0,0,27,32
2013,Iraq,IRQ,Thailand,THA,5,0,0,0,5
2013,Sri Lanka,LKA,Thailand,THA,17,0,0,20,37
2013,Nepal,NPL,Thailand,THA,0,0,0,5,5
2013,Pakistan,PAK,Thailand,THA,115,0,15,30,160
2013,Somalia,SOM,Thailand,THA,15,0,0,0,15
2013,Viet Nam,VNM,Thailand,THA,29,0,5,38,72
2013,Syrian Arab Rep.,SYR,Thailand,THA,35,0,0,36,71
2013,Uganda,UGA,Thailand,THA,0,0,0,5,5
2013,Egypt,EGY,Tunisia,TUN,0,0,0,21,21
2013,Dem. Rep. of the Congo,COD,Tunisia,TUN,0,0,0,5,5
2013,Eritrea,ERI,Tunisia,TUN,17,0,0,23,40
2013,Gambia,GMB,Tunisia,TUN,0,0,0,5,5
2013,Cote d'Ivoire,CIV,Tunisia,TUN,0,0,0,137,137
2013,Iraq,IRQ,Tunisia,TUN,5,0,0,0,5
2013,Libya,LBY,Tunisia,TUN,0,0,0,5,5
2013,Mali,MLI,Tunisia,TUN,0,0,0,17,17
2013,Somalia,SOM,Tunisia,TUN,5,0,0,10,15
2013,Sudan,SDN,Tunisia,TUN,10,0,0,16,26
2013,Afghanistan,AFG,Turkey,TUR,797,0,259,204,1260
2013,Angola,AGO,Turkey,TUR,0,0,0,5,5
2013,Egypt,EGY,Turkey,TUR,5,0,5,5,15
2013,Bangladesh,BGD,Turkey,TUR,0,0,5,0,5
2013,China,CHN,Turkey,TUR,11,0,0,21,32
2013,Cameroon,CMR,Turkey,TUR,0,0,5,17,22
2013,Dem. Rep. of the Congo,COD,Turkey,TUR,13,0,0,28,41
2013,Eritrea,ERI,Turkey,TUR,5,0,5,12,22
2013,Ethiopia,ETH,Turkey,TUR,27,0,0,5,32
2013,Palestinian,PSE,Turkey,TUR,457,0,0,39,496
2013,Ghana,GHA,Turkey,TUR,0,0,0,5,5
2013,Guinea,GIN,Turkey,TUR,0,0,0,5,5
2013,Cote d'Ivoire,CIV,Turkey,TUR,5,0,0,19,24
2013,Iran (Islamic Rep. of),IRN,Turkey,TUR,2635,0,790,461,3886
2013,Iraq,IRQ,Turkey,TUR,9069,0,100,541,9710
2013,Jordan,JOR,Turkey,TUR,12,0,0,0,12
2013,Kazakhstan,KAZ,Turkey,TUR,0,0,5,5,10
2013,Kenya,KEN,Turkey,TUR,0,0,0,5,5
2013,Kyrgyzstan,KGZ,Turkey,TUR,51,0,34,31,116
2013,Libya,LBY,Turkey,TUR,0,0,5,0,5
2013,Lebanon,LBN,Turkey,TUR,0,0,0,5,5
2013,Morocco,MAR,Turkey,TUR,5,0,5,0,10
2013,Myanmar,MMR,Turkey,TUR,0,0,0,5,5
2013,Nigeria,NGA,Turkey,TUR,0,0,10,12,22
2013,Pakistan,PAK,Turkey,TUR,5,0,5,13,23
2013,Russian Federation,RUS,Turkey,TUR,0,0,0,5,5
2013,Saudi Arabia,SAU,Turkey,TUR,5,0,0,0,5
2013,Senegal,SEN,Turkey,TUR,0,0,12,20,32
2013,Sierra Leone,SLE,Turkey,TUR,0,0,0,5,5
2013,Somalia,SOM,Turkey,TUR,726,0,11,53,790
2013,Sudan,SDN,Turkey,TUR,31,0,5,5,41
2013,Syrian Arab Rep.,SYR,Turkey,TUR,100,0,0,92,192
2013,Tajikistan,TJK,Turkey,TUR,12,0,19,15,46
2013,Turkmenistan,TKM,Turkey,TUR,0,0,20,24,44
2013,Tunisia,TUN,Turkey,TUR,5,0,0,0,5
2013,Uganda,UGA,Turkey,TUR,5,0,5,12,22
2013,Uzbekistan,UZB,Turkey,TUR,0,0,44,40,84
2013,Yemen,YEM,Turkey,TUR,17,0,22,10,49
2013,Stateless,XXA,Turkey,TUR,5,0,0,12,17
2013,Eritrea,ERI,Yemen,YEM,74,0,5,214,293
2013,Ethiopia,ETH,Yemen,YEM,271,0,425,3201,3897
2013,Palestinian,PSE,Yemen,YEM,18,0,0,61,79
2013,Iraq,IRQ,Yemen,YEM,11,0,0,47,58
2013,Jordan,JOR,Yemen,YEM,5,0,0,5,10
2013,Russian Federation,RUS,Yemen,YEM,0,0,0,5,5
2013,Sudan,SDN,Yemen,YEM,5,0,0,10,15
2013,Syrian Arab Rep.,SYR,Yemen,YEM,12,0,0,84,96
2013,Tajikistan,TJK,Yemen,YEM,0,0,0,10,10
2013,Sri Lanka,LKA,Montserrat,MSR,0,0,0,5,5
2013,Cuba,CUB,Sint Maarten (Dutch part),SXM,0,0,0,5,5
2014,Iran (Islamic Rep. of),IRN,Afghanistan,AFG,5,0,5,0,10
2014,Pakistan,PAK,Afghanistan,AFG,25,0,5,0,30
2014,Burundi,BDI,Algeria,DZA,0,0,5,0,5
2014,Benin,BEN,Algeria,DZA,0,0,32,0,32
2014,Burkina Faso,BFA,Algeria,DZA,0,0,5,0,5
2014,Central African Rep.,CAF,Algeria,DZA,0,0,5,10,15
2014,Chad,TCD,Algeria,DZA,0,0,10,5,15
2014,Cameroon,CMR,Algeria,DZA,0,0,102,41,143
2014,Congo,COG,Algeria,DZA,0,0,5,0,5
2014,Dem. Rep. of the Congo,COD,Algeria,DZA,0,0,40,17,57
2014,Palestinian,PSE,Algeria,DZA,0,0,0,30,30
2014,Guinea,GIN,Algeria,DZA,0,0,26,10,36
2014,Cote d'Ivoire,CIV,Algeria,DZA,0,0,152,36,188
2014,Libya,LBY,Algeria,DZA,0,0,0,12,12
2014,Mali,MLI,Algeria,DZA,0,0,264,150,414
2014,Niger,NER,Algeria,DZA,0,0,5,0,5
2014,Nigeria,NGA,Algeria,DZA,0,0,24,10,34
2014,Senegal,SEN,Algeria,DZA,0,0,5,0,5
2014,Sierra Leone,SLE,Algeria,DZA,0,0,5,0,5
2014,Sudan,SDN,Algeria,DZA,0,0,5,5,10
2014,Syrian Arab Rep.,SYR,Algeria,DZA,0,0,0,166,166
2014,Togo,TGO,Algeria,DZA,0,0,10,0,10
2014,Afghanistan,AFG,Egypt,EGY,0,0,0,5,5
2014,Chad,TCD,Egypt,EGY,5,0,0,15,20
2014,Cameroon,CMR,Egypt,EGY,0,0,0,27,27
2014,Congo,COG,Egypt,EGY,0,0,0,10,10
2014,Dem. Rep. of the Congo,COD,Egypt,EGY,0,0,0,17,17
2014,Eritrea,ERI,Egypt,EGY,361,0,45,284,690
2014,Ethiopia,ETH,Egypt,EGY,262,0,207,221,690
2014,Palestinian,PSE,Egypt,EGY,0,0,0,13,13
2014,Guinea-Bissau,GNB,Egypt,EGY,0,0,0,5,5
2014,Guinea,GIN,Egypt,EGY,0,0,0,27,27
2014,Cote d'Ivoire,CIV,Egypt,EGY,0,0,5,68,73
2014,Iran (Islamic Rep. of),IRN,Egypt,EGY,5,0,0,0,5
2014,Iraq,IRQ,Egypt,EGY,524,0,72,0,596
2014,Jordan,JOR,Egypt,EGY,0,0,0,5,5
2014,Liberia,LBR,Egypt,EGY,0,0,0,5,5
2014,Libya,LBY,Egypt,EGY,0,0,0,5,5
2014,Lebanon,LBN,Egypt,EGY,0,0,0,5,5
2014,Nigeria,NGA,Egypt,EGY,5,0,10,56,71
2014,Russian Federation,RUS,Egypt,EGY,5,0,5,0,10
2014,Rwanda,RWA,Egypt,EGY,0,0,5,0,5
2014,Saudi Arabia,SAU,Egypt,EGY,0,0,0,5,5
2014,Somalia,SOM,Egypt,EGY,440,0,10,209,659
2014,Sudan,SDN,Egypt,EGY,2035,0,564,1886,4485
2014,South Sudan,SSD,Egypt,EGY,151,0,10,0,161
2014,Tajikistan,TJK,Egypt,EGY,0,0,0,5,5
2014,Turkmenistan,TKM,Egypt,EGY,0,0,0,5,5
2014,Tunisia,TUN,Egypt,EGY,0,0,0,5,5
2014,Uganda,UGA,Egypt,EGY,5,0,0,10,15
2014,Uzbekistan,UZB,Egypt,EGY,0,0,0,11,11
2014,Yemen,YEM,Egypt,EGY,10,0,10,23,43
2014,Zimbabwe,ZWE,Egypt,EGY,5,0,0,0,5
2014,Azerbaijan,AZE,Armenia,ARM,5,0,0,0,5
2014,Afghanistan,AFG,Azerbaijan,AZE,53,0,80,24,157
2014,Iraq,IRQ,Azerbaijan,AZE,0,0,0,5,5
2014,Pakistan,PAK,Azerbaijan,AZE,5,0,19,24,48
2014,Russian Federation,RUS,Azerbaijan,AZE,10,0,10,20,40
2014,Syrian Arab Rep.,SYR,Azerbaijan,AZE,0,0,0,5,5
2014,Egypt,EGY,Bahrain,BHR,0,0,5,0,5
2014,Iraq,IRQ,Bahrain,BHR,52,0,0,0,52
2014,Yemen,YEM,Bahrain,BHR,5,0,0,0,5
2014,Burkina Faso,BFA,China,CHN,0,0,0,5,5
2014,Central African Rep.,CAF,China,CHN,0,0,0,5,5
2014,Cameroon,CMR,China,CHN,0,0,0,5,5
2014,Eritrea,ERI,China,CHN,5,0,0,0,5
2014,Palestinian,PSE,China,CHN,0,0,0,5,5
2014,Ghana,GHA,China,CHN,0,0,5,5,10
2014,Kenya,KEN,China,CHN,0,0,0,5,5
2014,Liberia,LBR,China,CHN,0,0,0,15,15
2014,Nigeria,NGA,China,CHN,0,0,35,35,70
2014,Pakistan,PAK,China,CHN,0,0,5,0,5
2014,Sierra Leone,SLE,China,CHN,0,0,0,5,5
2014,Somalia,SOM,China,CHN,54,0,68,35,157
2014,Syrian Arab Rep.,SYR,China,CHN,5,0,0,5,10
2014,Burundi,BDI,Cameroon,CMR,0,0,5,0,5
2014,Burkina Faso,BFA,Cameroon,CMR,0,0,0,5,5
2014,Central African Rep.,CAF,Cameroon,CMR,3808,0,162,891,4861
2014,Chad,TCD,Cameroon,CMR,17,0,108,111,236
2014,Congo,COG,Cameroon,CMR,0,0,5,10,15
2014,Dem. Rep. of the Congo,COD,Cameroon,CMR,12,0,117,46,175
2014,Gambia,GMB,Cameroon,CMR,0,0,0,17,17
2014,Guinea-Bissau,GNB,Cameroon,CMR,0,0,10,18,28
2014,Guinea,GIN,Cameroon,CMR,0,0,113,239,352
2014,Cote d'Ivoire,CIV,Cameroon,CMR,0,0,37,93,130
2014,Liberia,LBR,Cameroon,CMR,0,0,0,11,11
2014,Mali,MLI,Cameroon,CMR,0,0,16,21,37
2014,Niger,NER,Cameroon,CMR,0,0,5,0,5
2014,Rwanda,RWA,Cameroon,CMR,5,0,104,0,109
2014,Senegal,SEN,Cameroon,CMR,0,0,25,81,106
2014,Sierra Leone,SLE,Cameroon,CMR,0,0,5,10,15
2014,Sudan,SDN,Cameroon,CMR,24,0,5,5,34
2014,South Sudan,SSD,Cameroon,CMR,5,0,0,0,5
2014,Angola,AGO,Dem. Rep. of the Congo,COD,0,0,5,0,5
2014,Burundi,BDI,Dem. Rep. of the Congo,COD,0,0,5,303,308
2014,Rwanda,RWA,Dem. Rep. of the Congo,COD,0,0,10,69,79
2014,Afghanistan,AFG,Cyprus,CYP,0,0,0,5,5
2014,Cameroon,CMR,Cyprus,CYP,0,0,5,0,5
2014,Palestinian,PSE,Cyprus,CYP,11,0,0,38,49
2014,Nigeria,NGA,Cyprus,CYP,5,0,0,0,5
2014,Syrian Arab Rep.,SYR,Cyprus,CYP,10,0,0,5,15
2014,Egypt,EGY,"China, Hong Kong SAR",HKG,5,0,5,0,10
2014,Bangladesh,BGD,"China, Hong Kong SAR",HKG,0,0,0,5,5
2014,Central African Rep.,CAF,"China, Hong Kong SAR",HKG,0,0,0,5,5
2014,Gambia,GMB,"China, Hong Kong SAR",HKG,5,0,0,0,5
2014,India,IND,"China, Hong Kong SAR",HKG,5,0,5,15,25
2014,Indonesia,IDN,"China, Hong Kong SAR",HKG,0,0,5,46,51
2014,Sri Lanka,LKA,"China, Hong Kong SAR",HKG,0,0,0,5,5
2014,Nigeria,NGA,"China, Hong Kong SAR",HKG,0,0,0,5,5
2014,Pakistan,PAK,"China, Hong Kong SAR",HKG,5,0,10,11,26
2014,Philippines,PHL,"China, Hong Kong SAR",HKG,5,0,0,14,19
2014,Rwanda,RWA,"China, Hong Kong SAR",HKG,13,0,0,5,18
2014,Somalia,SOM,"China, Hong Kong SAR",HKG,30,0,5,5,40
2014,Viet Nam,VNM,"China, Hong Kong SAR",HKG,0,0,0,24,24
2014,Togo,TGO,"China, Hong Kong SAR",HKG,0,0,5,0,5
2014,Uganda,UGA,"China, Hong Kong SAR",HKG,5,0,5,5,15
2014,Afghanistan,AFG,India,IND,543,0,338,415,1296
2014,Cameroon,CMR,India,IND,0,0,5,0,5
2014,Dem. Rep. of the Congo,COD,India,IND,5,0,10,5,20
2014,Ethiopia,ETH,India,IND,5,0,0,0,5
2014,Palestinian,PSE,India,IND,18,0,0,0,18
2014,Iran (Islamic Rep. of),IRN,India,IND,0,0,5,0,5
2014,Iraq,IRQ,India,IND,24,0,5,12,41
2014,Myanmar,MMR,India,IND,3660,0,201,142,4003
2014,Nigeria,NGA,India,IND,0,0,82,0,82
2014,Somalia,SOM,India,IND,39,0,5,5,49
2014,Sudan,SDN,India,IND,5,0,22,0,27
2014,Syrian Arab Rep.,SYR,India,IND,10,0,0,13,23
2014,Tunisia,TUN,India,IND,0,0,0,5,5
2014,Ukraine,UKR,India,IND,0,0,5,0,5
2014,Afghanistan,AFG,Indonesia,IDN,1023,0,174,1138,2335
2014,Egypt,EGY,Indonesia,IDN,11,0,0,5,16
2014,Bangladesh,BGD,Indonesia,IDN,0,0,5,92,97
2014,China,CHN,Indonesia,IDN,10,0,5,0,15
2014,Dem. Rep. of the Congo,COD,Indonesia,IDN,5,0,0,5,10
2014,Eritrea,ERI,Indonesia,IDN,13,0,0,10,23
2014,Ethiopia,ETH,Indonesia,IDN,16,0,0,5,21
2014,Palestinian,PSE,Indonesia,IDN,129,0,0,40,169
2014,India,IND,Indonesia,IDN,0,0,0,5,5
2014,Iran (Islamic Rep. of),IRN,Indonesia,IDN,192,0,198,371,761
2014,Iraq,IRQ,Indonesia,IDN,118,0,13,163,294
2014,Kuwait,KWT,Indonesia,IDN,0,0,0,5,5
2014,Sri Lanka,LKA,Indonesia,IDN,140,0,64,296,500
2014,Myanmar,MMR,Indonesia,IDN,330,0,5,451,786
2014,Nepal,NPL,Indonesia,IDN,0,0,0,17,17
2014,Pakistan,PAK,Indonesia,IDN,125,0,10,352,487
2014,Somalia,SOM,Indonesia,IDN,196,0,0,115,311
2014,Sudan,SDN,Indonesia,IDN,103,0,10,87,200
2014,Syrian Arab Rep.,SYR,Indonesia,IDN,10,0,0,16,26
2014,Yemen,YEM,Indonesia,IDN,0,0,10,0,10
2014,Afghanistan,AFG,Iran (Islamic Rep. of),IRN,5,0,0,0,5
2014,Iran (Islamic Rep. of),IRN,Iraq,IRQ,97,0,5,56,158
2014,Syrian Arab Rep.,SYR,Iraq,IRQ,36,0,0,0,36
2014,Turkey,TUR,Iraq,IRQ,41,0,14,0,55
2014,Burundi,BDI,Israel,ISR,5,0,0,0,5
2014,Eritrea,ERI,Israel,ISR,141,0,0,0,141
2014,Iraq,IRQ,Israel,ISR,10,0,0,0,10
2014,Sudan,SDN,Israel,ISR,30,0,0,0,30
2014,South Sudan,SSD,Israel,ISR,41,0,0,0,41
2014,Afghanistan,AFG,Jordan,JOR,0,0,0,5,5
2014,Egypt,EGY,Jordan,JOR,10,0,0,18,28
2014,Eritrea,ERI,Jordan,JOR,5,0,0,0,5
2014,Iraq,IRQ,Jordan,JOR,7440,0,44,61,7545
2014,Kuwait,KWT,Jordan,JOR,0,0,0,12,12
2014,Lebanon,LBN,Jordan,JOR,0,0,0,5,5
2014,Morocco,MAR,Jordan,JOR,0,0,0,5,5
2014,Pakistan,PAK,Jordan,JOR,5,0,0,0,5
2014,Saudi Arabia,SAU,Jordan,JOR,0,0,0,5,5
2014,Somalia,SOM,Jordan,JOR,164,0,5,5,174
2014,Sudan,SDN,Jordan,JOR,632,0,24,0,656
2014,Syrian Arab Rep.,SYR,Jordan,JOR,5400,0,5,659,6064
2014,Turkey,TUR,Jordan,JOR,0,0,0,10,10
2014,Yemen,YEM,Jordan,JOR,14,0,10,5,29
2014,Stateless,XXA,Jordan,JOR,0,0,0,38,38
2014,Afghanistan,AFG,Kazakhstan,KAZ,0,0,13,0,13
2014,Kyrgyzstan,KGZ,Kazakhstan,KAZ,0,0,5,0,5
2014,Uzbekistan,UZB,Kazakhstan,KAZ,0,0,0,5,5
2014,Burundi,BDI,Kenya,KEN,31,0,15,5206,5252
2014,Chad,TCD,Kenya,KEN,0,0,0,5,5
2014,Cameroon,CMR,Kenya,KEN,0,0,0,19,19
2014,Congo,COG,Kenya,KEN,0,0,0,32,32
2014,Dem. Rep. of the Congo,COD,Kenya,KEN,525,0,40,8193,8758
2014,Eritrea,ERI,Kenya,KEN,38,0,5,298,341
2014,Ethiopia,ETH,Kenya,KEN,372,0,316,7295,7983
2014,Cote d'Ivoire,CIV,Kenya,KEN,0,0,0,10,10
2014,Sri Lanka,LKA,Kenya,KEN,0,0,0,5,5
2014,Mozambique,MOZ,Kenya,KEN,0,0,0,5,5
2014,Nigeria,NGA,Kenya,KEN,0,0,0,12,12
2014,Pakistan,PAK,Kenya,KEN,0,0,0,5,5
2014,Rwanda,RWA,Kenya,KEN,5,0,12,464,481
2014,Somalia,SOM,Kenya,KEN,27,0,10,5173,5210
2014,Sudan,SDN,Kenya,KEN,14,0,0,5679,5693
2014,South Sudan,SSD,Kenya,KEN,5,0,0,26802,26807
2014,Syrian Arab Rep.,SYR,Kenya,KEN,0,0,0,12,12
2014,United Rep. of Tanzania,TZA,Kenya,KEN,5,0,0,16,21
2014,Uganda,UGA,Kenya,KEN,39,0,10,655,704
2014,Zimbabwe,ZWE,Kenya,KEN,0,0,0,5,5
2014,Afghanistan,AFG,Kyrgyzstan,KGZ,5,5,21,0,31
2014,Iran (Islamic Rep. of),IRN,Kyrgyzstan,KGZ,0,0,5,0,5
2014,Syrian Arab Rep.,SYR,Kyrgyzstan,KGZ,0,0,0,5,5
2014,Uzbekistan,UZB,Kyrgyzstan,KGZ,5,0,0,39,44
2014,Iran (Islamic Rep. of),IRN,Kuwait,KWT,0,0,0,5,5
2014,Iraq,IRQ,Kuwait,KWT,74,0,0,5,79
2014,Dem. Rep. of the Congo,COD,Libya,LBY,5,0,0,0,5
2014,Eritrea,ERI,Libya,LBY,10,0,0,0,10
2014,Palestinian,PSE,Libya,LBY,598,0,0,0,598
2014,Iraq,IRQ,Libya,LBY,5,0,0,0,5
2014,Jordan,JOR,Libya,LBY,0,0,0,5,5
2014,Sudan,SDN,Libya,LBY,5,0,0,0,5
2014,Afghanistan,AFG,Lebanon,LBN,0,0,10,5,15
2014,Egypt,EGY,Lebanon,LBN,19,0,46,21,86
2014,Bahrain,BHR,Lebanon,LBN,12,0,0,0,12
2014,Bangladesh,BGD,Lebanon,LBN,0,0,5,0,5
2014,Eritrea,ERI,Lebanon,LBN,10,0,15,5,30
2014,Ethiopia,ETH,Lebanon,LBN,0,0,33,11,44
2014,Iran (Islamic Rep. of),IRN,Lebanon,LBN,5,0,33,5,43
2014,Iraq,IRQ,Lebanon,LBN,1608,0,83,187,1878
2014,Jordan,JOR,Lebanon,LBN,5,0,23,10,38
2014,Kuwait,KWT,Lebanon,LBN,0,0,0,5,5
2014,Madagascar,MDG,Lebanon,LBN,0,0,14,5,19
2014,Mali,MLI,Lebanon,LBN,0,0,5,0,5
2014,Somalia,SOM,Lebanon,LBN,5,0,5,5,15
2014,Sudan,SDN,Lebanon,LBN,195,0,330,60,585
2014,South Sudan,SSD,Lebanon,LBN,26,0,0,0,26
2014,Syrian Arab Rep.,SYR,Lebanon,LBN,6733,0,0,0,6733
2014,Turkey,TUR,Lebanon,LBN,5,0,0,0,5
2014,Yemen,YEM,Lebanon,LBN,0,0,5,5,10
2014,Afghanistan,AFG,Sri Lanka,LKA,33,0,0,88,121
2014,Palestinian,PSE,Sri Lanka,LKA,17,0,0,0,17
2014,Iran (Islamic Rep. of),IRN,Sri Lanka,LKA,5,0,5,0,10
2014,Maldives,MDV,Sri Lanka,LKA,0,0,0,5,5
2014,Myanmar,MMR,Sri Lanka,LKA,96,0,0,0,96
2014,Pakistan,PAK,Sri Lanka,LKA,301,0,142,467,910
2014,Syrian Arab Rep.,SYR,Sri Lanka,LKA,5,0,0,0,5
2014,Afghanistan,AFG,Malaysia,MYS,57,0,18,45,120
2014,Egypt,EGY,Malaysia,MYS,0,0,11,5,16
2014,Bangladesh,BGD,Malaysia,MYS,5,0,5,0,10
2014,Cambodia,KHM,Malaysia,MYS,13,0,0,0,13
2014,China,CHN,Malaysia,MYS,5,0,0,5,10
2014,Palestinian,PSE,Malaysia,MYS,58,0,10,19,87
2014,Guinea,GIN,Malaysia,MYS,0,0,0,5,5
2014,Indonesia,IDN,Malaysia,MYS,91,0,5,5,101
2014,Iran (Islamic Rep. of),IRN,Malaysia,MYS,97,0,59,54,210
2014,Iraq,IRQ,Malaysia,MYS,114,0,5,91,210
2014,Lebanon,LBN,Malaysia,MYS,5,0,0,5,10
2014,Sri Lanka,LKA,Malaysia,MYS,124,0,475,468,1067
2014,Mali,MLI,Malaysia,MYS,0,0,5,0,5
2014,Myanmar,MMR,Malaysia,MYS,11072,0,395,2837,14304
2014,Nigeria,NGA,Malaysia,MYS,0,0,0,5,5
2014,Pakistan,PAK,Malaysia,MYS,99,0,221,118,438
2014,Sierra Leone,SLE,Malaysia,MYS,0,0,5,0,5
2014,Somalia,SOM,Malaysia,MYS,121,0,49,71,241
2014,Sudan,SDN,Malaysia,MYS,17,0,5,16,38
2014,Syrian Arab Rep.,SYR,Malaysia,MYS,376,0,5,62,443
2014,Thailand,THA,Malaysia,MYS,5,0,0,66,71
2014,Tunisia,TUN,Malaysia,MYS,0,0,5,0,5
2014,Yemen,YEM,Malaysia,MYS,10,0,0,56,66
2014,Syrian Arab Rep.,SYR,Mongolia,MNG,5,0,0,0,5
2014,Algeria,DZA,Morocco,MAR,0,0,0,5,5
2014,Benin,BEN,Morocco,MAR,0,0,5,15,20
2014,Bangladesh,BGD,Morocco,MAR,0,0,0,5,5
2014,Burkina Faso,BFA,Morocco,MAR,0,0,0,5,5
2014,Central African Rep.,CAF,Morocco,MAR,0,0,5,52,57
2014,Chad,TCD,Morocco,MAR,0,0,0,10,10
2014,Cameroon,CMR,Morocco,MAR,10,0,64,243,317
2014,Congo,COG,Morocco,MAR,5,0,27,35,67
2014,Dem. Rep. of the Congo,COD,Morocco,MAR,15,0,189,76,280
2014,Eritrea,ERI,Morocco,MAR,0,0,0,5,5
2014,Gabon,GAB,Morocco,MAR,0,0,5,0,5
2014,Gambia,GMB,Morocco,MAR,0,0,5,16,21
2014,Palestinian,PSE,Morocco,MAR,0,0,0,15,15
2014,Ghana,GHA,Morocco,MAR,0,0,10,36,46
2014,Guinea-Bissau,GNB,Morocco,MAR,0,0,0,5,5
2014,Guinea,GIN,Morocco,MAR,5,0,26,72,103
2014,Cote d'Ivoire,CIV,Morocco,MAR,10,0,150,247,407
2014,Iraq,IRQ,Morocco,MAR,10,0,0,11,21
2014,Kenya,KEN,Morocco,MAR,0,0,5,13,18
2014,Liberia,LBR,Morocco,MAR,0,0,12,37,49
2014,Libya,LBY,Morocco,MAR,0,0,0,5,5
2014,Mali,MLI,Morocco,MAR,0,0,10,374,384
2014,Niger,NER,Morocco,MAR,0,0,5,24,29
2014,Nigeria,NGA,Morocco,MAR,5,0,118,508,631
2014,Rwanda,RWA,Morocco,MAR,0,0,5,5,10
2014,Senegal,SEN,Morocco,MAR,5,0,0,16,21
2014,Sierra Leone,SLE,Morocco,MAR,0,0,5,38,43
2014,Somalia,SOM,Morocco,MAR,0,0,5,29,34
2014,Sudan,SDN,Morocco,MAR,0,0,10,59,69
2014,Togo,TGO,Morocco,MAR,0,0,5,5,10
2014,Uganda,UGA,Morocco,MAR,0,0,5,21,26
2014,Zambia,ZMB,Morocco,MAR,0,0,0,5,5
2014,Zimbabwe,ZWE,Morocco,MAR,0,0,0,5,5
2014,Afghanistan,AFG,Nepal,NPL,14,0,0,0,14
2014,Sri Lanka,LKA,Nepal,NPL,5,0,0,0,5
2014,Myanmar,MMR,Nepal,NPL,23,0,0,5,28
2014,Pakistan,PAK,Nepal,NPL,85,0,91,26,202
2014,Somalia,SOM,Nepal,NPL,5,0,0,0,5
2014,Iraq,IRQ,Oman,OMN,10,0,0,0,10
2014,Afghanistan,AFG,Pakistan,PAK,1833,0,3202,248,5283
2014,Palestinian,PSE,Pakistan,PAK,12,0,0,0,12
2014,Iran (Islamic Rep. of),IRN,Pakistan,PAK,0,0,5,5,10
2014,Myanmar,MMR,Pakistan,PAK,10,0,0,0,10
2014,Nigeria,NGA,Pakistan,PAK,0,0,10,0,10
2014,Somalia,SOM,Pakistan,PAK,32,0,10,0,42
2014,Syrian Arab Rep.,SYR,Pakistan,PAK,5,0,0,0,5
2014,Uzbekistan,UZB,Pakistan,PAK,0,0,0,5,5
2014,Syrian Arab Rep.,SYR,Qatar,QAT,5,0,0,0,5
2014,Pakistan,PAK,Saudi Arabia,SAU,5,0,0,0,5
2014,Syrian Arab Rep.,SYR,Saudi Arabia,SAU,5,0,0,0,5
2014,Fiji,FJI,Solomon Islands,SLB,5,0,0,0,5
2014,Eritrea,ERI,Somalia,SOM,0,0,0,11,11
2014,Ethiopia,ETH,Somalia,SOM,208,0,172,809,1189
2014,Yemen,YEM,Somalia,SOM,0,0,0,5,5
2014,Unknown ,,Somalia,SOM,0,0,0,5,5
2014,Egypt,EGY,Sudan,SDN,5,0,0,5,10
2014,Armenia,ARM,Sudan,SDN,5,0,0,0,5
2014,Dem. Rep. of the Congo,COD,Sudan,SDN,5,0,0,0,5
2014,Eritrea,ERI,Sudan,SDN,149,0,0,0,149
2014,Ethiopia,ETH,Sudan,SDN,181,0,0,0,181
2014,Palestinian,PSE,Sudan,SDN,0,0,0,10,10
2014,Somalia,SOM,Sudan,SDN,5,0,0,0,5
2014,Afghanistan,AFG,Syrian Arab Rep.,SYR,120,0,0,0,120
2014,Albania,ALB,Syrian Arab Rep.,SYR,0,0,0,5,5
2014,Algeria,DZA,Syrian Arab Rep.,SYR,0,0,48,0,48
2014,Egypt,EGY,Syrian Arab Rep.,SYR,0,0,58,0,58
2014,Burkina Faso,BFA,Syrian Arab Rep.,SYR,5,0,5,0,10
2014,Ethiopia,ETH,Syrian Arab Rep.,SYR,0,0,0,5,5
2014,Palestinian,PSE,Syrian Arab Rep.,SYR,0,0,0,17,17
2014,Guinea,GIN,Syrian Arab Rep.,SYR,5,0,13,0,18
2014,Cote d'Ivoire,CIV,Syrian Arab Rep.,SYR,0,0,0,5,5
2014,Iran (Islamic Rep. of),IRN,Syrian Arab Rep.,SYR,0,0,131,13,144
2014,Iraq,IRQ,Syrian Arab Rep.,SYR,312,0,15,112,439
2014,Jordan,JOR,Syrian Arab Rep.,SYR,0,0,15,5,20
2014,Lebanon,LBN,Syrian Arab Rep.,SYR,0,0,118,5,123
2014,Sri Lanka,LKA,Syrian Arab Rep.,SYR,0,0,5,0,5
2014,Morocco,MAR,Syrian Arab Rep.,SYR,0,0,5,0,5
2014,Pakistan,PAK,Syrian Arab Rep.,SYR,18,0,10,0,28
2014,Philippines,PHL,Syrian Arab Rep.,SYR,0,0,28,0,28
2014,Sierra Leone,SLE,Syrian Arab Rep.,SYR,0,0,5,0,5
2014,Somalia,SOM,Syrian Arab Rep.,SYR,5,0,0,17,22
2014,Sudan,SDN,Syrian Arab Rep.,SYR,57,0,46,159,262
2014,South Sudan,SSD,Syrian Arab Rep.,SYR,0,0,0,14,14
2014,United Rep. of Tanzania,TZA,Syrian Arab Rep.,SYR,0,0,5,0,5
2014,Tunisia,TUN,Syrian Arab Rep.,SYR,0,0,12,5,17
2014,Turkey,TUR,Syrian Arab Rep.,SYR,0,0,5,0,5
2014,Yemen,YEM,Syrian Arab Rep.,SYR,0,0,13,21,34
2014,Afghanistan,AFG,Thailand,THA,5,0,5,5,15
2014,Egypt,EGY,Thailand,THA,0,0,0,10,10
2014,Cambodia,KHM,Thailand,THA,38,0,0,5,43
2014,China,CHN,Thailand,THA,42,0,11,15,68
2014,Cameroon,CMR,Thailand,THA,0,0,5,5,10
2014,Dem. Rep. of the Congo,COD,Thailand,THA,5,0,0,0,5
2014,Palestinian,PSE,Thailand,THA,231,0,5,42,278
2014,Iran (Islamic Rep. of),IRN,Thailand,THA,14,0,19,25,58
2014,Iraq,IRQ,Thailand,THA,5,0,0,10,15
2014,Jordan,JOR,Thailand,THA,5,0,0,0,5
2014,Libya,LBY,Thailand,THA,0,0,0,5,5
2014,Sri Lanka,LKA,Thailand,THA,20,0,5,5,30
2014,Pakistan,PAK,Thailand,THA,291,0,334,195,820
2014,Somalia,SOM,Thailand,THA,30,0,0,16,46
2014,Viet Nam,VNM,Thailand,THA,10,0,5,24,39
2014,Sudan,SDN,Thailand,THA,0,0,0,5,5
2014,Syrian Arab Rep.,SYR,Thailand,THA,72,0,0,61,133
2014,Afghanistan,AFG,Tajikistan,TJK,214,0,104,0,318
2014,Iran (Islamic Rep. of),IRN,Tajikistan,TJK,5,0,0,0,5
2014,Bangladesh,BGD,Trinidad and Tobago,TTO,5,0,5,0,10
2014,Colombia,COL,Trinidad and Tobago,TTO,10,0,0,0,10
2014,Cuba,CUB,Trinidad and Tobago,TTO,38,0,17,35,90
2014,Sri Lanka,LKA,Trinidad and Tobago,TTO,5,0,0,0,5
2014,Mexico,MEX,Trinidad and Tobago,TTO,5,0,0,0,5
2014,Pakistan,PAK,Trinidad and Tobago,TTO,5,0,0,0,5
2014,Syrian Arab Rep.,SYR,Trinidad and Tobago,TTO,10,0,0,0,10
2014,Dem. Rep. of the Congo,COD,Tunisia,TUN,5,0,0,5,10
2014,Eritrea,ERI,Tunisia,TUN,42,0,5,46,93
2014,Ethiopia,ETH,Tunisia,TUN,11,0,0,19,30
2014,Palestinian,PSE,Tunisia,TUN,10,0,0,10,20
2014,Cote d'Ivoire,CIV,Tunisia,TUN,0,0,71,132,203
2014,Iraq,IRQ,Tunisia,TUN,10,0,0,0,10
2014,Somalia,SOM,Tunisia,TUN,14,0,14,10,38
2014,Sudan,SDN,Tunisia,TUN,5,0,23,19,47
2014,Afghanistan,AFG,Turkey,TUR,545,0,0,4344,4889
2014,Algeria,DZA,Turkey,TUR,0,0,5,5,10
2014,Egypt,EGY,Turkey,TUR,5,0,5,53,63
2014,Azerbaijan,AZE,Turkey,TUR,5,0,0,0,5
2014,Burundi,BDI,Turkey,TUR,5,0,0,0,5
2014,Bangladesh,BGD,Turkey,TUR,0,0,0,62,62
2014,Central African Rep.,CAF,Turkey,TUR,0,0,0,13,13
2014,China,CHN,Turkey,TUR,0,0,0,10,10
2014,Cameroon,CMR,Turkey,TUR,0,0,5,109,114
2014,Congo,COG,Turkey,TUR,10,0,10,18,38
2014,Dem. Rep. of the Congo,COD,Turkey,TUR,20,0,12,77,109
2014,Eritrea,ERI,Turkey,TUR,18,0,0,34,52
2014,Ethiopia,ETH,Turkey,TUR,14,0,0,49,63
2014,Gabon,GAB,Turkey,TUR,0,0,0,5,5
2014,Palestinian,PSE,Turkey,TUR,322,0,0,64,386
2014,Ghana,GHA,Turkey,TUR,0,0,0,27,27
2014,Guinea,GIN,Turkey,TUR,0,0,0,10,10
2014,Cote d'Ivoire,CIV,Turkey,TUR,5,0,5,40,50
2014,India,IND,Turkey,TUR,0,0,0,5,5
2014,Iran (Islamic Rep. of),IRN,Turkey,TUR,2361,0,658,441,3460
2014,Iraq,IRQ,Turkey,TUR,10174,0,30,4836,15040
2014,Jordan,JOR,Turkey,TUR,13,0,0,0,13
2014,Kazakhstan,KAZ,Turkey,TUR,0,0,0,13,13
2014,Kenya,KEN,Turkey,TUR,0,0,5,0,5
2014,Kyrgyzstan,KGZ,Turkey,TUR,0,0,5,10,15
2014,Libya,LBY,Turkey,TUR,10,0,0,5,15
2014,Lebanon,LBN,Turkey,TUR,5,0,0,11,16
2014,Mali,MLI,Turkey,TUR,5,0,0,66,71
2014,Mongolia,MNG,Turkey,TUR,0,0,0,23,23
2014,Morocco,MAR,Turkey,TUR,14,0,0,10,24
2014,Myanmar,MMR,Turkey,TUR,0,0,0,10,10
2014,Niger,NER,Turkey,TUR,0,0,0,10,10
2014,Nigeria,NGA,Turkey,TUR,5,0,10,47,62
2014,Pakistan,PAK,Turkey,TUR,5,0,5,305,315
2014,Senegal,SEN,Turkey,TUR,0,0,0,21,21
2014,Somalia,SOM,Turkey,TUR,370,0,5,130,505
2014,Sudan,SDN,Turkey,TUR,43,0,10,46,99
2014,Syrian Arab Rep.,SYR,Turkey,TUR,8229,0,0,0,8229
2014,Tajikistan,TJK,Turkey,TUR,5,0,0,31,36
2014,Turkmenistan,TKM,Turkey,TUR,0,0,10,39,49
2014,Togo,TGO,Turkey,TUR,0,0,0,5,5
2014,Tunisia,TUN,Turkey,TUR,5,0,0,5,10
2014,Uganda,UGA,Turkey,TUR,16,0,14,135,165
2014,Uzbekistan,UZB,Turkey,TUR,10,0,10,76,96
2014,Yemen,YEM,Turkey,TUR,10,0,14,84,108
2014,Stateless,XXA,Turkey,TUR,50,0,0,0,50
2014,Afghanistan,AFG,Ukraine,UKR,18,0,12,5,35
2014,Dem. Rep. of the Congo,COD,Ukraine,UKR,0,0,0,5,5
2014,Iran (Islamic Rep. of),IRN,Ukraine,UKR,0,0,0,5,5
2014,Iraq,IRQ,Ukraine,UKR,0,0,0,5,5
2014,Russian Federation,RUS,Ukraine,UKR,0,0,0,12,12
2014,Somalia,SOM,Ukraine,UKR,5,0,0,5,10
2014,Syrian Arab Rep.,SYR,Ukraine,UKR,0,0,0,5,5
2014,Turkey,TUR,Ukraine,UKR,0,0,0,5,5
2014,Uzbekistan,UZB,Ukraine,UKR,0,0,0,5,5
2014,Eritrea,ERI,Yemen,YEM,267,0,5,43,315
2014,Ethiopia,ETH,Yemen,YEM,116,0,455,1380,1951
2014,Palestinian,PSE,Yemen,YEM,5,0,0,11,16
2014,Iraq,IRQ,Yemen,YEM,5,0,0,10,15
2014,Nigeria,NGA,Yemen,YEM,0,0,0,5,5
2014,Sudan,SDN,Yemen,YEM,5,0,0,0,5
2014,Syrian Arab Rep.,SYR,Yemen,YEM,0,0,0,1065,1065
2014,Cuba,CUB,British Virgin Islands,VGB,0,0,0,10,10
2014,Haiti,HTI,British Virgin Islands,VGB,0,0,0,5,5
2014,Colombia,COL,Curacao ,CUW,18,0,0,5,23
2014,Cuba,CUB,Curacao ,CUW,0,0,14,5,19
2015,Iran (Islamic Rep. of),IRN,Afghanistan,AFG,0,0,5,5,10
2015,Pakistan,PAK,Afghanistan,AFG,88,0,0,0,88
2015,Burkina Faso,BFA,Algeria,DZA,0,0,5,5,10
2015,Central African Rep.,CAF,Algeria,DZA,17,0,5,27,49
2015,Chad,TCD,Algeria,DZA,0,0,10,0,10
2015,Cameroon,CMR,Algeria,DZA,0,0,26,10,36
2015,Dem. Rep. of the Congo,COD,Algeria,DZA,10,0,23,10,43
2015,Palestinian,PSE,Algeria,DZA,0,0,0,307,307
2015,Guinea,GIN,Algeria,DZA,0,0,57,25,82
2015,Cote d'Ivoire,CIV,Algeria,DZA,5,0,50,25,80
2015,Iraq,IRQ,Algeria,DZA,5,0,0,0,5
2015,Liberia,LBR,Algeria,DZA,0,0,10,0,10
2015,Libya,LBY,Algeria,DZA,13,0,0,5,18
2015,Mali,MLI,Algeria,DZA,14,0,135,63,212
2015,Nigeria,NGA,Algeria,DZA,0,0,5,11,16
2015,Sudan,SDN,Algeria,DZA,5,0,0,5,10
2015,Syrian Arab Rep.,SYR,Algeria,DZA,0,0,0,16,16
2015,Togo,TGO,Algeria,DZA,0,0,5,0,5
2015,Angola,AGO,Egypt,EGY,0,0,0,5,5
2015,Bangladesh,BGD,Egypt,EGY,0,0,0,5,5
2015,Belarus,BLR,Egypt,EGY,0,0,0,5,5
2015,Chad,TCD,Egypt,EGY,5,0,0,5,10
2015,Congo,COG,Egypt,EGY,0,0,5,0,5
2015,Dem. Rep. of the Congo,COD,Egypt,EGY,0,0,0,5,5
2015,Djibouti,DJI,Egypt,EGY,0,0,5,0,5
2015,Eritrea,ERI,Egypt,EGY,188,23,11,89,311
2015,Ethiopia,ETH,Egypt,EGY,168,35,107,0,310
2015,Palestinian,PSE,Egypt,EGY,0,0,0,13,13
2015,Guinea,GIN,Egypt,EGY,0,0,0,11,11
2015,Cote d'Ivoire,CIV,Egypt,EGY,0,0,0,10,10
2015,Iraq,IRQ,Egypt,EGY,196,87,5,79,367
2015,Myanmar,MMR,Egypt,EGY,0,0,0,5,5
2015,Nigeria,NGA,Egypt,EGY,0,0,39,0,39
2015,Russian Federation,RUS,Egypt,EGY,0,0,50,0,50
2015,Somalia,SOM,Egypt,EGY,200,80,5,0,285
2015,Sudan,SDN,Egypt,EGY,2189,357,617,1752,4915
2015,South Sudan,SSD,Egypt,EGY,1159,49,0,0,1208
2015,Syrian Arab Rep.,SYR,Egypt,EGY,2415,0,0,0,2415
2015,Tajikistan,TJK,Egypt,EGY,0,0,16,0,16
2015,Turkmenistan,TKM,Egypt,EGY,0,0,12,0,12
2015,Uganda,UGA,Egypt,EGY,0,0,0,5,5
2015,Uzbekistan,UZB,Egypt,EGY,0,0,62,0,62
2015,Yemen,YEM,Egypt,EGY,11,5,0,17,33
2015,Afghanistan,AFG,Azerbaijan,AZE,76,0,60,30,166
2015,Bangladesh,BGD,Azerbaijan,AZE,0,0,0,5,5
2015,India,IND,Azerbaijan,AZE,0,0,5,0,5
2015,Iran (Islamic Rep. of),IRN,Azerbaijan,AZE,0,0,11,0,11
2015,Iraq,IRQ,Azerbaijan,AZE,11,0,0,0,11
2015,Nepal,NPL,Azerbaijan,AZE,0,0,5,0,5
2015,Pakistan,PAK,Azerbaijan,AZE,0,0,159,41,200
2015,Russian Federation,RUS,Azerbaijan,AZE,15,0,5,16,36
2015,Syrian Arab Rep.,SYR,Azerbaijan,AZE,5,0,0,0,5
2015,Ukraine,UKR,Azerbaijan,AZE,16,0,5,0,21
2015,Yemen,YEM,Azerbaijan,AZE,5,0,0,0,5
2015,Myanmar,MMR,Bangladesh,BGD,0,0,5,5,10
2015,Cameroon,CMR,China,CHN,0,0,0,5,5
2015,Dem. Rep. of the Congo,COD,China,CHN,5,0,0,5,10
2015,Gambia,GMB,China,CHN,0,0,0,5,5
2015,Ghana,GHA,China,CHN,0,0,0,5,5
2015,Guinea,GIN,China,CHN,0,0,5,11,16
2015,Cote d'Ivoire,CIV,China,CHN,0,0,0,5,5
2015,Iraq,IRQ,China,CHN,0,0,0,5,5
2015,Liberia,LBR,China,CHN,0,0,5,11,16
2015,Mali,MLI,China,CHN,0,0,5,0,5
2015,Niger,NER,China,CHN,0,0,5,5,10
2015,Nigeria,NGA,China,CHN,0,0,28,38,66
2015,Pakistan,PAK,China,CHN,0,0,5,0,5
2015,Philippines,PHL,China,CHN,0,0,10,0,10
2015,Sierra Leone,SLE,China,CHN,0,0,5,10,15
2015,Somalia,SOM,China,CHN,25,0,5,5,35
2015,Syrian Arab Rep.,SYR,China,CHN,10,0,0,0,10
2015,Uganda,UGA,China,CHN,0,0,5,5,10
2015,Zimbabwe,ZWE,China,CHN,0,0,5,0,5
2015,Burkina Faso,BFA,Cameroon,CMR,0,0,5,5,10
2015,Central African Rep.,CAF,Cameroon,CMR,5342,0,127,4202,9671
2015,Chad,TCD,Cameroon,CMR,10,0,151,151,312
2015,Congo,COG,Cameroon,CMR,0,0,0,5,5
2015,Dem. Rep. of the Congo,COD,Cameroon,CMR,35,0,154,89,278
2015,Gambia,GMB,Cameroon,CMR,0,0,5,10,15
2015,Guinea-Bissau,GNB,Cameroon,CMR,0,0,20,37,57
2015,Guinea,GIN,Cameroon,CMR,0,0,102,290,392
2015,Cote d'Ivoire,CIV,Cameroon,CMR,10,0,49,111,170
2015,Liberia,LBR,Cameroon,CMR,5,0,0,0,5
2015,Mauritania,MRT,Cameroon,CMR,0,0,0,5,5
2015,Mali,MLI,Cameroon,CMR,0,0,5,35,40
2015,Nigeria,NGA,Cameroon,CMR,14,0,0,15,29
2015,Rwanda,RWA,Cameroon,CMR,16,0,67,40,123
2015,Senegal,SEN,Cameroon,CMR,0,0,36,79,115
2015,Sierra Leone,SLE,Cameroon,CMR,0,0,5,10,15
2015,Sudan,SDN,Cameroon,CMR,82,0,5,59,146
2015,South Sudan,SSD,Cameroon,CMR,5,0,0,0,5
2015,Syrian Arab Rep.,SYR,Cameroon,CMR,13,0,0,0,13
2015,India,IND,Micronesia (Federated States of),FSM,0,0,14,0,14
2015,Nepal,NPL,Micronesia (Federated States of),FSM,5,0,12,0,17
2015,Somalia,SOM,"China, Hong Kong SAR",HKG,5,0,0,0,5
2015,Afghanistan,AFG,India,IND,187,0,655,619,1461
2015,Cameroon,CMR,India,IND,0,0,17,5,22
2015,Dem. Rep. of the Congo,COD,India,IND,0,0,10,11,21
2015,Eritrea,ERI,India,IND,11,0,0,0,11
2015,Palestinian,PSE,India,IND,13,0,0,5,18
2015,Cote d'Ivoire,CIV,India,IND,0,0,0,5,5
2015,Iran (Islamic Rep. of),IRN,India,IND,0,0,0,5,5
2015,Iraq,IRQ,India,IND,198,0,5,55,258
2015,Mexico,MEX,India,IND,0,0,5,0,5
2015,Myanmar,MMR,India,IND,2141,0,126,681,2948
2015,Nigeria,NGA,India,IND,0,0,222,156,378
2015,Somalia,SOM,India,IND,39,0,60,0,99
2015,Sudan,SDN,India,IND,17,0,17,13,47
2015,Syrian Arab Rep.,SYR,India,IND,17,0,0,0,17
2015,Uganda,UGA,India,IND,0,0,10,0,10
2015,Ukraine,UKR,India,IND,0,0,5,0,5
2015,Uzbekistan,UZB,India,IND,0,0,0,5,5
2015,Yemen,YEM,India,IND,0,0,0,5,5
2015,Afghanistan,AFG,Indonesia,IDN,1462,0,59,171,1692
2015,Egypt,EGY,Indonesia,IDN,0,0,0,5,5
2015,Bangladesh,BGD,Indonesia,IDN,0,0,5,58,63
2015,China,CHN,Indonesia,IDN,0,0,5,5,10
2015,Eritrea,ERI,Indonesia,IDN,5,0,0,0,5
2015,Ethiopia,ETH,Indonesia,IDN,20,0,5,0,25
2015,Palestinian,PSE,Indonesia,IDN,95,0,0,0,95
2015,Cote d'Ivoire,CIV,Indonesia,IDN,0,0,0,5,5
2015,India,IND,Indonesia,IDN,0,0,0,5,5
2015,Iran (Islamic Rep. of),IRN,Indonesia,IDN,133,0,107,68,308
2015,Iraq,IRQ,Indonesia,IDN,108,0,0,133,241
2015,Kuwait,KWT,Indonesia,IDN,5,0,0,0,5
2015,Sri Lanka,LKA,Indonesia,IDN,60,0,33,53,146
2015,Myanmar,MMR,Indonesia,IDN,58,0,0,608,666
2015,Nepal,NPL,Indonesia,IDN,0,0,0,5,5
2015,Nigeria,NGA,Indonesia,IDN,0,0,0,10,10
2015,Pakistan,PAK,Indonesia,IDN,138,0,10,15,163
2015,Somalia,SOM,Indonesia,IDN,159,0,5,29,193
2015,Sudan,SDN,Indonesia,IDN,53,0,10,21,84
2015,Syrian Arab Rep.,SYR,Indonesia,IDN,19,0,0,11,30
2015,Yemen,YEM,Indonesia,IDN,0,0,0,5,5
2015,Myanmar,MMR,Iran (Islamic Rep. of),IRN,5,0,0,0,5
2015,Algeria,DZA,Iraq,IRQ,0,0,0,5,5
2015,Palestinian,PSE,Iraq,IRQ,0,21,0,0,21
2015,Iran (Islamic Rep. of),IRN,Iraq,IRQ,0,5,0,78,83
2015,Jordan,JOR,Iraq,IRQ,0,5,0,0,5
2015,Kuwait,KWT,Iraq,IRQ,0,0,0,5,5
2015,Monaco,MCO,Iraq,IRQ,0,0,0,5,5
2015,Syrian Arab Rep.,SYR,Iraq,IRQ,5,394,0,828,1227
2015,Eritrea,ERI,Israel,ISR,100,0,0,0,100
2015,Ethiopia,ETH,Israel,ISR,5,0,0,0,5
2015,Sudan,SDN,Israel,ISR,32,0,0,0,32
2015,South Sudan,SSD,Israel,ISR,28,0,0,0,28
2015,Egypt,EGY,Jordan,JOR,10,0,5,0,15
2015,Eritrea,ERI,Jordan,JOR,10,0,0,0,10
2015,Iran (Islamic Rep. of),IRN,Jordan,JOR,5,0,0,0,5
2015,Iraq,IRQ,Jordan,JOR,4449,0,15,10,4474
2015,Lebanon,LBN,Jordan,JOR,0,0,5,0,5
2015,Somalia,SOM,Jordan,JOR,38,0,5,0,43
2015,Sudan,SDN,Jordan,JOR,1184,0,32,0,1216
2015,Syrian Arab Rep.,SYR,Jordan,JOR,7367,0,0,46,7413
2015,Yemen,YEM,Jordan,JOR,32,0,0,0,32
2015,Stateless,XXA,Jordan,JOR,0,0,0,13,13
2015,Afghanistan,AFG,Kazakhstan,KAZ,0,0,0,18,18
2015,Kyrgyzstan,KGZ,Kazakhstan,KAZ,0,0,5,0,5
2015,Syrian Arab Rep.,SYR,Kazakhstan,KAZ,5,0,0,0,5
2015,Afghanistan,AFG,Kyrgyzstan,KGZ,5,0,0,0,5
2015,Uzbekistan,UZB,Kyrgyzstan,KGZ,10,0,0,14,24
2015,Iraq,IRQ,Kuwait,KWT,49,0,0,10,59
2015,Somalia,SOM,Kuwait,KWT,290,0,0,10,300
2015,Eritrea,ERI,Libya,LBY,5,0,0,32,37
2015,Ethiopia,ETH,Libya,LBY,0,0,0,5,5
2015,Iraq,IRQ,Libya,LBY,0,0,0,10,10
2015,Sudan,SDN,Libya,LBY,0,0,0,24,24
2015,Egypt,EGY,Lebanon,LBN,22,0,21,0,43
2015,Bahrain,BHR,Lebanon,LBN,10,0,0,0,10
2015,Bangladesh,BGD,Lebanon,LBN,0,0,5,0,5
2015,Dem. Rep. of the Congo,COD,Lebanon,LBN,5,0,0,0,5
2015,Eritrea,ERI,Lebanon,LBN,10,0,5,0,15
2015,Ethiopia,ETH,Lebanon,LBN,10,0,28,32,70
2015,Palestinian,PSE,Lebanon,LBN,5,0,0,18,23
2015,Cote d'Ivoire,CIV,Lebanon,LBN,0,0,5,0,5
2015,Iran (Islamic Rep. of),IRN,Lebanon,LBN,5,0,5,13,23
2015,Iraq,IRQ,Lebanon,LBN,1465,0,17,1165,2647
2015,Jordan,JOR,Lebanon,LBN,5,0,12,16,33
2015,Kenya,KEN,Lebanon,LBN,0,0,0,5,5
2015,Kuwait,KWT,Lebanon,LBN,0,0,0,10,10
2015,Libya,LBY,Lebanon,LBN,0,0,0,5,5
2015,Sri Lanka,LKA,Lebanon,LBN,0,0,0,5,5
2015,Madagascar,MDG,Lebanon,LBN,0,0,5,0,5
2015,Morocco,MAR,Lebanon,LBN,0,0,0,5,5
2015,Nigeria,NGA,Lebanon,LBN,0,0,10,0,10
2015,Pakistan,PAK,Lebanon,LBN,0,0,0,10,10
2015,Philippines,PHL,Lebanon,LBN,0,0,5,16,21
2015,Somalia,SOM,Lebanon,LBN,5,0,0,5,10
2015,Sudan,SDN,Lebanon,LBN,305,0,310,78,693
2015,South Sudan,SSD,Lebanon,LBN,28,0,0,0,28
2015,Syrian Arab Rep.,SYR,Lebanon,LBN,9062,0,0,399,9461
2015,Ukraine,UKR,Lebanon,LBN,0,0,0,5,5
2015,Yemen,YEM,Lebanon,LBN,10,0,0,0,10
2015,Afghanistan,AFG,Sri Lanka,LKA,90,0,5,5,100
2015,Iran (Islamic Rep. of),IRN,Sri Lanka,LKA,5,0,0,0,5
2015,Myanmar,MMR,Sri Lanka,LKA,12,0,0,0,12
2015,Pakistan,PAK,Sri Lanka,LKA,404,0,166,234,804
2015,Afghanistan,AFG,Malaysia,MYS,50,0,5,63,118
2015,Egypt,EGY,Malaysia,MYS,0,0,5,5,10
2015,Bangladesh,BGD,Malaysia,MYS,0,0,10,0,10
2015,Central African Rep.,CAF,Malaysia,MYS,5,0,0,0,5
2015,China,CHN,Malaysia,MYS,5,0,0,5,10
2015,Congo,COG,Malaysia,MYS,0,0,0,5,5
2015,Palestinian,PSE,Malaysia,MYS,28,0,0,36,64
2015,Indonesia,IDN,Malaysia,MYS,62,0,0,0,62
2015,Iran (Islamic Rep. of),IRN,Malaysia,MYS,33,0,54,74,161
2015,Iraq,IRQ,Malaysia,MYS,41,0,0,78,119
2015,Liberia,LBR,Malaysia,MYS,0,0,0,12,12
2015,Lebanon,LBN,Malaysia,MYS,0,0,0,10,10
2015,Sri Lanka,LKA,Malaysia,MYS,62,0,175,766,1003
2015,Mali,MLI,Malaysia,MYS,0,0,0,5,5
2015,Myanmar,MMR,Malaysia,MYS,7983,0,225,2034,10242
2015,Nigeria,NGA,Malaysia,MYS,0,0,0,5,5
2015,Pakistan,PAK,Malaysia,MYS,51,0,121,311,483
2015,Saudi Arabia,SAU,Malaysia,MYS,0,0,0,5,5
2015,Sierra Leone,SLE,Malaysia,MYS,0,0,0,10,10
2015,Somalia,SOM,Malaysia,MYS,51,0,0,115,166
2015,Sudan,SDN,Malaysia,MYS,5,0,0,20,25
2015,South Sudan,SSD,Malaysia,MYS,13,0,0,0,13
2015,Syrian Arab Rep.,SYR,Malaysia,MYS,54,0,0,151,205
2015,Thailand,THA,Malaysia,MYS,5,0,0,0,5
2015,Yemen,YEM,Malaysia,MYS,18,0,0,11,29
2015,China,CHN,Mongolia,MNG,5,0,0,0,5
2015,Angola,AGO,Morocco,MAR,0,0,0,5,5
2015,Benin,BEN,Morocco,MAR,0,0,0,5,5
2015,Burkina Faso,BFA,Morocco,MAR,0,0,0,5,5
2015,Central African Rep.,CAF,Morocco,MAR,65,0,0,29,94
2015,Chad,TCD,Morocco,MAR,0,0,0,5,5
2015,Cameroon,CMR,Morocco,MAR,37,0,71,74,182
2015,Congo,COG,Morocco,MAR,5,0,20,39,64
2015,Dem. Rep. of the Congo,COD,Morocco,MAR,26,0,209,241,476
2015,Gambia,GMB,Morocco,MAR,0,0,5,0,5
2015,Palestinian,PSE,Morocco,MAR,10,0,0,5,15
2015,Guinea,GIN,Morocco,MAR,10,0,42,24,76
2015,Cote d'Ivoire,CIV,Morocco,MAR,32,0,163,127,322
2015,Iraq,IRQ,Morocco,MAR,30,0,0,5,35
2015,Liberia,LBR,Morocco,MAR,5,0,13,11,29
2015,Libya,LBY,Morocco,MAR,10,0,0,0,10
2015,Mali,MLI,Morocco,MAR,5,0,62,64,131
2015,Nigeria,NGA,Morocco,MAR,5,0,65,60,130
2015,Rwanda,RWA,Morocco,MAR,0,0,5,0,5
2015,Senegal,SEN,Morocco,MAR,35,0,11,0,46
2015,Sierra Leone,SLE,Morocco,MAR,0,0,10,0,10
2015,Somalia,SOM,Morocco,MAR,0,0,0,10,10
2015,Sudan,SDN,Morocco,MAR,0,0,0,5,5
2015,Togo,TGO,Morocco,MAR,0,0,5,0,5
2015,Yemen,YEM,Morocco,MAR,10,0,0,0,10
2015,Afghanistan,AFG,Nepal,NPL,62,0,10,27,99
2015,China,CHN,Nepal,NPL,0,0,5,0,5
2015,Sri Lanka,LKA,Nepal,NPL,10,0,0,5,15
2015,Myanmar,MMR,Nepal,NPL,65,0,0,0,65
2015,Pakistan,PAK,Nepal,NPL,25,0,12,0,37
2015,Somalia,SOM,Nepal,NPL,5,0,0,0,5
2015,Iraq,IRQ,Oman,OMN,133,0,0,11,144
2015,Afghanistan,AFG,Pakistan,PAK,2322,0,2729,1168,6219
2015,Palestinian,PSE,Pakistan,PAK,12,0,0,0,12
2015,Iran (Islamic Rep. of),IRN,Pakistan,PAK,0,0,5,0,5
2015,Libya,LBY,Pakistan,PAK,5,0,0,0,5
2015,Myanmar,MMR,Pakistan,PAK,5,0,0,0,5
2015,Somalia,SOM,Pakistan,PAK,27,0,15,0,42
2015,Syrian Arab Rep.,SYR,Pakistan,PAK,5,0,0,0,5
2015,Afghanistan,AFG,Saudi Arabia,SAU,0,0,0,5,5
2015,Ethiopia,ETH,Saudi Arabia,SAU,0,0,0,5,5
2015,Iraq,IRQ,Saudi Arabia,SAU,0,0,0,17,17
2015,Somalia,SOM,Saudi Arabia,SAU,0,0,0,19,19
2015,Sudan,SDN,Saudi Arabia,SAU,0,0,0,10,10
2015,Syrian Arab Rep.,SYR,Saudi Arabia,SAU,0,0,0,12,12
2015,Yemen,YEM,Saudi Arabia,SAU,5,0,0,0,5
2015,Eritrea,ERI,Somalia,SOM,0,0,5,0,5
2015,Ethiopia,ETH,Somalia,SOM,144,0,226,0,370
2015,Yemen,YEM,Somalia,SOM,29,0,0,0,29
2015,Unknown ,,Somalia,SOM,0,0,0,12,12
2015,Afghanistan,AFG,Sudan,SDN,5,0,0,0,5
2015,Egypt,EGY,Sudan,SDN,5,0,13,0,18
2015,Eritrea,ERI,Sudan,SDN,260,0,0,0,260
2015,Ethiopia,ETH,Sudan,SDN,12,0,17,5,34
2015,Somalia,SOM,Sudan,SDN,5,0,0,0,5
2015,Syrian Arab Rep.,SYR,Sudan,SDN,11,0,0,0,11
2015,Afghanistan,AFG,Syrian Arab Rep.,SYR,46,0,143,0,189
2015,Algeria,DZA,Syrian Arab Rep.,SYR,0,0,10,5,15
2015,Egypt,EGY,Syrian Arab Rep.,SYR,5,0,41,5,51
2015,Argentina,ARG,Syrian Arab Rep.,SYR,0,0,5,0,5
2015,Bangladesh,BGD,Syrian Arab Rep.,SYR,0,0,5,0,5
2015,Comoros,COM,Syrian Arab Rep.,SYR,0,0,5,0,5
2015,Ethiopia,ETH,Syrian Arab Rep.,SYR,0,0,0,10,10
2015,Guinea,GIN,Syrian Arab Rep.,SYR,5,0,5,0,10
2015,India,IND,Syrian Arab Rep.,SYR,0,0,0,5,5
2015,Indonesia,IDN,Syrian Arab Rep.,SYR,0,0,5,0,5
2015,Iran (Islamic Rep. of),IRN,Syrian Arab Rep.,SYR,5,0,205,10,220
2015,Iraq,IRQ,Syrian Arab Rep.,SYR,987,0,10,193,1190
2015,Jordan,JOR,Syrian Arab Rep.,SYR,5,0,43,0,48
2015,Lebanon,LBN,Syrian Arab Rep.,SYR,5,0,126,27,158
2015,Sri Lanka,LKA,Syrian Arab Rep.,SYR,0,0,5,0,5
2015,Morocco,MAR,Syrian Arab Rep.,SYR,0,0,5,0,5
2015,Pakistan,PAK,Syrian Arab Rep.,SYR,23,0,31,0,54
2015,Philippines,PHL,Syrian Arab Rep.,SYR,0,0,0,5,5
2015,Sierra Leone,SLE,Syrian Arab Rep.,SYR,0,0,5,0,5
2015,Sudan,SDN,Syrian Arab Rep.,SYR,22,0,15,19,56
2015,Tunisia,TUN,Syrian Arab Rep.,SYR,0,0,20,5,25
2015,Uzbekistan,UZB,Syrian Arab Rep.,SYR,0,0,5,0,5
2015,Afghanistan,AFG,Thailand,THA,11,0,0,0,11
2015,Egypt,EGY,Thailand,THA,5,0,0,10,15
2015,Bahrain,BHR,Thailand,THA,0,0,0,5,5
2015,Cambodia,KHM,Thailand,THA,16,0,0,13,29
2015,China,CHN,Thailand,THA,62,0,0,18,80
2015,Cameroon,CMR,Thailand,THA,0,0,5,5,10
2015,Dem. Rep. of the Congo,COD,Thailand,THA,5,0,0,10,15
2015,Ethiopia,ETH,Thailand,THA,5,0,0,0,5
2015,Palestinian,PSE,Thailand,THA,234,0,5,10,249
2015,Guinea,GIN,Thailand,THA,0,0,0,5,5
2015,India,IND,Thailand,THA,0,0,0,5,5
2015,Iran (Islamic Rep. of),IRN,Thailand,THA,10,0,21,39,70
2015,Iraq,IRQ,Thailand,THA,22,0,0,65,87
2015,Liberia,LBR,Thailand,THA,0,0,5,66,71
2015,Sri Lanka,LKA,Thailand,THA,22,0,10,54,86
2015,Nigeria,NGA,Thailand,THA,0,0,5,5,10
2015,Pakistan,PAK,Thailand,THA,306,0,163,472,941
2015,Sierra Leone,SLE,Thailand,THA,0,0,0,13,13
2015,Somalia,SOM,Thailand,THA,34,0,28,50,112
2015,Viet Nam,VNM,Thailand,THA,77,0,17,78,172
2015,Sudan,SDN,Thailand,THA,5,0,0,5,10
2015,Syrian Arab Rep.,SYR,Thailand,THA,36,0,0,66,102
2015,United Rep. of Tanzania,TZA,Thailand,THA,5,0,0,0,5
2015,Uzbekistan,UZB,Thailand,THA,0,0,0,5,5
2015,Yemen,YEM,Thailand,THA,0,0,0,5,5
2015,Afghanistan,AFG,Tajikistan,TJK,22,0,40,0,62
2015,Colombia,COL,Trinidad and Tobago,TTO,5,0,0,0,5
2015,Cuba,CUB,Trinidad and Tobago,TTO,22,0,5,11,38
2015,Jamaica,JAM,Trinidad and Tobago,TTO,5,0,0,0,5
2015,Nigeria,NGA,Trinidad and Tobago,TTO,5,0,12,0,17
2015,Pakistan,PAK,Trinidad and Tobago,TTO,5,0,0,0,5
2015,Syrian Arab Rep.,SYR,Trinidad and Tobago,TTO,19,0,0,0,19
2015,Central African Rep.,CAF,Tunisia,TUN,5,0,0,0,5
2015,Dem. Rep. of the Congo,COD,Tunisia,TUN,0,0,0,5,5
2015,Eritrea,ERI,Tunisia,TUN,5,0,0,5,10
2015,Palestinian,PSE,Tunisia,TUN,10,0,0,0,10
2015,Cote d'Ivoire,CIV,Tunisia,TUN,0,0,44,83,127
2015,Somalia,SOM,Tunisia,TUN,5,0,5,40,50
2015,Sudan,SDN,Tunisia,TUN,5,0,5,5,15
2015,Afghanistan,AFG,Turkey,TUR,317,0,0,5890,6207
2015,Algeria,DZA,Turkey,TUR,0,0,5,11,16
2015,Angola,AGO,Turkey,TUR,0,0,0,5,5
2015,Egypt,EGY,Turkey,TUR,10,0,5,5,20
2015,Central African Rep.,CAF,Turkey,TUR,0,0,0,5,5
2015,China,CHN,Turkey,TUR,0,0,0,10,10
2015,Cameroon,CMR,Turkey,TUR,0,0,5,15,20
2015,Congo,COG,Turkey,TUR,0,0,5,65,70
2015,Dem. Rep. of the Congo,COD,Turkey,TUR,5,0,10,23,38
2015,Eritrea,ERI,Turkey,TUR,17,0,0,38,55
2015,Ethiopia,ETH,Turkey,TUR,0,0,0,53,53
2015,Palestinian,PSE,Turkey,TUR,138,0,0,90,228
2015,Ghana,GHA,Turkey,TUR,0,0,0,10,10
2015,Cote d'Ivoire,CIV,Turkey,TUR,0,0,5,27,32
2015,Iran (Islamic Rep. of),IRN,Turkey,TUR,3161,0,661,1896,5718
2015,Iraq,IRQ,Turkey,TUR,10628,0,18,10188,20834
2015,Jordan,JOR,Turkey,TUR,5,0,0,10,15
2015,Kazakhstan,KAZ,Turkey,TUR,0,0,0,5,5
2015,Kenya,KEN,Turkey,TUR,0,0,0,11,11
2015,Kyrgyzstan,KGZ,Turkey,TUR,0,0,5,12,17
2015,Kuwait,KWT,Turkey,TUR,0,0,0,5,5
2015,Libya,LBY,Turkey,TUR,10,0,5,0,15
2015,Lebanon,LBN,Turkey,TUR,5,0,5,5,15
2015,Sri Lanka,LKA,Turkey,TUR,0,0,0,5,5
2015,Mali,MLI,Turkey,TUR,0,0,0,10,10
2015,Mongolia,MNG,Turkey,TUR,0,0,0,23,23
2015,Morocco,MAR,Turkey,TUR,0,0,5,28,33
2015,Myanmar,MMR,Turkey,TUR,0,0,0,5,5
2015,Nepal,NPL,Turkey,TUR,0,0,0,5,5
2015,Nigeria,NGA,Turkey,TUR,0,0,10,62,72
2015,Pakistan,PAK,Turkey,TUR,13,0,19,424,456
2015,Philippines,PHL,Turkey,TUR,0,0,0,5,5
2015,Russian Federation,RUS,Turkey,TUR,0,0,0,5,5
2015,Rwanda,RWA,Turkey,TUR,0,0,0,5,5
2015,Senegal,SEN,Turkey,TUR,0,0,0,12,12
2015,Sierra Leone,SLE,Turkey,TUR,0,0,0,10,10
2015,Somalia,SOM,Turkey,TUR,118,0,5,399,522
2015,Sudan,SDN,Turkey,TUR,30,0,0,106,136
2015,South Sudan,SSD,Turkey,TUR,5,0,0,0,5
2015,United Rep. of Tanzania,TZA,Turkey,TUR,0,0,0,5,5
2015,Tajikistan,TJK,Turkey,TUR,5,0,0,28,33
2015,Turkmenistan,TKM,Turkey,TUR,0,0,0,68,68
2015,Uganda,UGA,Turkey,TUR,0,0,15,216,231
2015,Uzbekistan,UZB,Turkey,TUR,5,0,10,88,103
2015,Yemen,YEM,Turkey,TUR,39,0,0,94,133
2015,Stateless,XXA,Turkey,TUR,5,0,0,25,30
2015,Afghanistan,AFG,Ukraine,UKR,30,0,0,19,49
2015,Chad,TCD,Ukraine,UKR,0,0,0,5,5
2015,Nigeria,NGA,Ukraine,UKR,0,0,0,5,5
2015,Russian Federation,RUS,Ukraine,UKR,0,0,0,10,10
2015,Somalia,SOM,Ukraine,UKR,5,0,0,11,16
2015,Syrian Arab Rep.,SYR,Ukraine,UKR,10,0,0,5,15
2015,Turkey,TUR,Ukraine,UKR,0,0,0,5,5
2015,Uzbekistan,UZB,Ukraine,UKR,0,0,0,5,5
2015,Eritrea,ERI,Yemen,YEM,26,0,0,20,46
2015,Ethiopia,ETH,Yemen,YEM,82,0,5,817,904
2015,Palestinian,PSE,Yemen,YEM,17,0,0,22,39
2015,Iraq,IRQ,Yemen,YEM,5,0,0,35,40
2015,Saudi Arabia,SAU,Yemen,YEM,5,0,0,0,5
2015,Sudan,SDN,Yemen,YEM,5,0,0,0,5
2015,Syrian Arab Rep.,SYR,Yemen,YEM,5,0,0,421,426
2015,Colombia,COL,Aruba,ABW,0,0,5,0,5
2015,Colombia,COL,Curacao ,CUW,5,0,0,0,5
2015,Cuba,CUB,Curacao ,CUW,5,0,0,0,5
2016,Iran (Islamic Rep. of),IRN,Afghanistan,AFG,5,0,0,5,10
2016,Benin,BEN,Algeria,DZA,0,0,5,0,5
2016,Burkina Faso,BFA,Algeria,DZA,0,0,0,5,5
2016,Central African Rep.,CAF,Algeria,DZA,26,0,0,5,31
2016,Cameroon,CMR,Algeria,DZA,5,0,13,5,23
2016,Congo,COG,Algeria,DZA,0,0,0,5,5
2016,Dem. Rep. of the Congo,COD,Algeria,DZA,5,0,10,10,25
2016,Palestinian,PSE,Algeria,DZA,0,0,0,60,60
2016,Guinea,GIN,Algeria,DZA,0,0,36,5,41
2016,Cote d'Ivoire,CIV,Algeria,DZA,12,0,21,5,38
2016,Libya,LBY,Algeria,DZA,0,0,0,12,12
2016,Lebanon,LBN,Algeria,DZA,0,0,0,5,5
2016,Mali,MLI,Algeria,DZA,16,0,26,19,61
2016,Nigeria,NGA,Algeria,DZA,0,0,0,5,5
2016,Syrian Arab Rep.,SYR,Algeria,DZA,0,0,0,2398,2398
2016,Yemen,YEM,Algeria,DZA,0,0,0,32,32
2016,Afghanistan,AFG,Egypt,EGY,13,0,5,5,23
2016,Algeria,DZA,Egypt,EGY,0,0,0,5,5
2016,Azerbaijan,AZE,Egypt,EGY,0,0,5,0,5
2016,Burundi,BDI,Egypt,EGY,0,0,5,0,5
2016,Benin,BEN,Egypt,EGY,0,0,5,0,5
2016,Bangladesh,BGD,Egypt,EGY,0,0,5,12,17
2016,Central African Rep.,CAF,Egypt,EGY,5,0,0,0,5
2016,Chad,TCD,Egypt,EGY,0,0,22,16,38
2016,China,CHN,Egypt,EGY,0,0,0,5,5
2016,Cameroon,CMR,Egypt,EGY,5,0,20,29,54
2016,Congo,COG,Egypt,EGY,0,0,5,10,15
2016,Dem. Rep. of the Congo,COD,Egypt,EGY,5,0,5,12,22
2016,Djibouti,DJI,Egypt,EGY,0,0,5,0,5
2016,Eritrea,ERI,Egypt,EGY,516,0,10,917,1443
2016,Ethiopia,ETH,Egypt,EGY,529,0,1234,364,2127
2016,Gambia,GMB,Egypt,EGY,0,0,5,0,5
2016,Palestinian,PSE,Egypt,EGY,10,0,0,14,24
2016,Ghana,GHA,Egypt,EGY,0,0,39,5,44
2016,Guinea,GIN,Egypt,EGY,0,0,28,35,63
2016,Cote d'Ivoire,CIV,Egypt,EGY,0,0,5,18,23
2016,Iraq,IRQ,Egypt,EGY,370,0,0,566,936
2016,Jordan,JOR,Egypt,EGY,0,0,0,5,5
2016,Liberia,LBR,Egypt,EGY,0,0,10,0,10
2016,Sri Lanka,LKA,Egypt,EGY,0,0,0,5,5
2016,Mali,MLI,Egypt,EGY,0,0,0,5,5
2016,Morocco,MAR,Egypt,EGY,0,0,0,10,10
2016,Niger,NER,Egypt,EGY,0,0,0,5,5
2016,Nigeria,NGA,Egypt,EGY,5,0,392,461,858
2016,Russian Federation,RUS,Egypt,EGY,5,0,41,5,51
2016,Senegal,SEN,Egypt,EGY,0,0,0,5,5
2016,Sierra Leone,SLE,Egypt,EGY,0,0,5,5,10
2016,Somalia,SOM,Egypt,EGY,492,0,59,1403,1954
2016,Sudan,SDN,Egypt,EGY,3736,0,1769,3050,8555
2016,South Sudan,SSD,Egypt,EGY,979,0,5,270,1254
2016,Tajikistan,TJK,Egypt,EGY,0,0,10,0,10
2016,Togo,TGO,Egypt,EGY,0,0,5,0,5
2016,Uganda,UGA,Egypt,EGY,0,0,20,14,34
2016,Uzbekistan,UZB,Egypt,EGY,0,0,38,11,49
2016,Yemen,YEM,Egypt,EGY,17,0,0,182,199
2016,Zimbabwe,ZWE,Egypt,EGY,5,0,0,0,5
2016,Afghanistan,AFG,Azerbaijan,AZE,60,0,10,33,103
2016,Georgia,GEO,Azerbaijan,AZE,0,0,5,0,5
2016,Iran (Islamic Rep. of),IRN,Azerbaijan,AZE,5,0,5,0,10
2016,Iraq,IRQ,Azerbaijan,AZE,0,0,0,10,10
2016,Pakistan,PAK,Azerbaijan,AZE,5,0,17,10,32
2016,Russian Federation,RUS,Azerbaijan,AZE,10,0,0,11,21
2016,Syrian Arab Rep.,SYR,Azerbaijan,AZE,5,0,0,0,5
2016,Iraq,IRQ,Bahrain,BHR,29,0,0,10,39
2016,Turkey,TUR,Bahrain,BHR,5,0,0,0,5
2016,Central African Rep.,CAF,China,CHN,0,0,0,5,5
2016,Cameroon,CMR,China,CHN,0,0,10,10,20
2016,Congo,COG,China,CHN,0,0,0,5,5
2016,Dem. Rep. of the Congo,COD,China,CHN,0,0,0,5,5
2016,Gambia,GMB,China,CHN,0,0,5,5,10
2016,Palestinian,PSE,China,CHN,5,0,0,0,5
2016,Ghana,GHA,China,CHN,0,0,29,37,66
2016,Guinea,GIN,China,CHN,0,0,10,12,22
2016,Cote d'Ivoire,CIV,China,CHN,0,0,10,5,15
2016,Iran (Islamic Rep. of),IRN,China,CHN,5,0,0,0,5
2016,Iraq,IRQ,China,CHN,5,0,0,37,42
2016,Kenya,KEN,China,CHN,0,0,0,5,5
2016,Liberia,LBR,China,CHN,0,0,10,25,35
2016,Mali,MLI,China,CHN,0,0,5,10,15
2016,Mozambique,MOZ,China,CHN,0,0,0,5,5
2016,Nigeria,NGA,China,CHN,0,0,34,21,55
2016,Pakistan,PAK,China,CHN,5,0,0,0,5
2016,Philippines,PHL,China,CHN,0,0,5,5,10
2016,Sierra Leone,SLE,China,CHN,0,0,5,16,21
2016,Somalia,SOM,China,CHN,12,0,5,5,22
2016,Syrian Arab Rep.,SYR,China,CHN,10,0,0,0,10
2016,Uganda,UGA,China,CHN,0,0,5,21,26
2016,Yemen,YEM,China,CHN,0,0,0,5,5
2016,Zimbabwe,ZWE,China,CHN,0,0,5,0,5
2016,Burundi,BDI,Cameroon,CMR,5,0,0,0,5
2016,Central African Rep.,CAF,Cameroon,CMR,2146,0,67,1351,3564
2016,Chad,TCD,Cameroon,CMR,5,0,85,144,234
2016,Congo,COG,Cameroon,CMR,0,0,5,0,5
2016,Dem. Rep. of the Congo,COD,Cameroon,CMR,29,0,46,45,120
2016,Equatorial Guinea,GNQ,Cameroon,CMR,0,0,0,5,5
2016,Gambia,GMB,Cameroon,CMR,0,0,0,5,5
2016,Ghana,GHA,Cameroon,CMR,0,0,5,0,5
2016,Guinea-Bissau,GNB,Cameroon,CMR,0,0,5,5,10
2016,Guinea,GIN,Cameroon,CMR,0,0,10,0,10
2016,Cote d'Ivoire,CIV,Cameroon,CMR,0,0,17,99,116
2016,Mali,MLI,Cameroon,CMR,0,0,5,0,5
2016,Nigeria,NGA,Cameroon,CMR,10,0,5,26,41
2016,Rwanda,RWA,Cameroon,CMR,5,0,31,0,36
2016,Sudan,SDN,Cameroon,CMR,10,0,0,10,20
2016,Syrian Arab Rep.,SYR,Cameroon,CMR,10,0,0,0,10
2016,Togo,TGO,Cameroon,CMR,0,0,5,0,5
2016,Cuba,CUB,Dominican Rep.,DOM,0,0,0,5,5
2016,Ukraine,UKR,Dominican Rep.,DOM,5,0,0,0,5
2016,India,IND,Micronesia (Federated States of),FSM,0,0,5,0,5
2016,Iran (Islamic Rep. of),IRN,"China, Hong Kong SAR",HKG,5,0,0,0,5
2016,Rwanda,RWA,"China, Hong Kong SAR",HKG,5,0,0,0,5
2016,Afghanistan,AFG,India,IND,1221,0,287,998,2506
2016,Cameroon,CMR,India,IND,0,0,10,5,15
2016,Dem. Rep. of the Congo,COD,India,IND,12,0,5,0,17
2016,Eritrea,ERI,India,IND,5,0,0,0,5
2016,Ethiopia,ETH,India,IND,10,0,0,0,10
2016,Palestinian,PSE,India,IND,12,0,0,5,17
2016,Iran (Islamic Rep. of),IRN,India,IND,10,0,0,5,15
2016,Iraq,IRQ,India,IND,113,0,0,34,147
2016,Myanmar,MMR,India,IND,1438,0,36,768,2242
2016,Nigeria,NGA,India,IND,0,0,10,41,51
2016,Rwanda,RWA,India,IND,0,0,5,0,5
2016,Somalia,SOM,India,IND,134,0,0,41,175
2016,Sudan,SDN,India,IND,25,0,5,5,35
2016,South Sudan,SSD,India,IND,5,0,0,0,5
2016,Syrian Arab Rep.,SYR,India,IND,29,0,0,13,42
2016,Tajikistan,TJK,India,IND,0,0,0,5,5
2016,Ukraine,UKR,India,IND,0,0,5,5,10
2016,Yemen,YEM,India,IND,0,0,0,23,23
2016,Afghanistan,AFG,Indonesia,IDN,1980,0,61,108,2149
2016,Egypt,EGY,Indonesia,IDN,0,0,0,5,5
2016,Bangladesh,BGD,Indonesia,IDN,0,0,0,55,55
2016,Dem. Rep. of the Congo,COD,Indonesia,IDN,0,0,0,5,5
2016,Eritrea,ERI,Indonesia,IDN,5,0,0,0,5
2016,Ethiopia,ETH,Indonesia,IDN,17,0,42,27,86
2016,Palestinian,PSE,Indonesia,IDN,83,0,0,10,93
2016,Guinea,GIN,Indonesia,IDN,0,0,5,0,5
2016,Cote d'Ivoire,CIV,Indonesia,IDN,0,0,0,5,5
2016,India,IND,Indonesia,IDN,0,0,5,0,5
2016,Iran (Islamic Rep. of),IRN,Indonesia,IDN,49,0,38,30,117
2016,Iraq,IRQ,Indonesia,IDN,195,0,0,173,368
2016,Liberia,LBR,Indonesia,IDN,0,0,0,5,5
2016,Sri Lanka,LKA,Indonesia,IDN,54,0,52,45,151
2016,Myanmar,MMR,Indonesia,IDN,330,0,5,105,440
2016,Nigeria,NGA,Indonesia,IDN,0,0,16,34,50
2016,Pakistan,PAK,Indonesia,IDN,63,0,10,10,83
2016,Sierra Leone,SLE,Indonesia,IDN,0,0,0,5,5
2016,Somalia,SOM,Indonesia,IDN,242,0,5,62,309
2016,Sudan,SDN,Indonesia,IDN,71,0,0,17,88
2016,Syrian Arab Rep.,SYR,Indonesia,IDN,12,0,0,0,12
2016,Yemen,YEM,Indonesia,IDN,5,0,0,25,30
2016,Afghanistan,AFG,Iran (Islamic Rep. of),IRN,0,0,0,26,26
2016,Pakistan,PAK,Iran (Islamic Rep. of),IRN,0,0,0,10,10
2016,Afghanistan,AFG,Iraq,IRQ,0,0,0,29,29
2016,Egypt,EGY,Iraq,IRQ,0,0,0,16,16
2016,Palestinian,PSE,Iraq,IRQ,66,0,0,0,66
2016,India,IND,Iraq,IRQ,0,0,0,5,5
2016,Iran (Islamic Rep. of),IRN,Iraq,IRQ,18,0,0,0,18
2016,Kuwait,KWT,Iraq,IRQ,0,0,0,10,10
2016,Pakistan,PAK,Iraq,IRQ,0,0,0,64,64
2016,Turkey,TUR,Iraq,IRQ,11,0,0,0,11
2016,Eritrea,ERI,Israel,ISR,151,0,0,0,151
2016,Ethiopia,ETH,Israel,ISR,5,0,0,0,5
2016,Sudan,SDN,Israel,ISR,25,0,0,0,25
2016,South Sudan,SSD,Israel,ISR,20,0,0,0,20
2016,Turkey,TUR,Israel,ISR,5,0,0,0,5
2016,Cuba,CUB,Jamaica,JAM,0,0,0,10,10
2016,Egypt,EGY,Jordan,JOR,14,0,22,0,36
2016,Eritrea,ERI,Jordan,JOR,0,0,0,5,5
2016,Ethiopia,ETH,Jordan,JOR,5,0,0,0,5
2016,Iraq,IRQ,Jordan,JOR,695,0,0,5,700
2016,Libya,LBY,Jordan,JOR,16,0,0,0,16
2016,Pakistan,PAK,Jordan,JOR,0,0,0,5,5
2016,Somalia,SOM,Jordan,JOR,67,0,0,0,67
2016,Sudan,SDN,Jordan,JOR,397,0,35,0,432
2016,South Sudan,SSD,Jordan,JOR,5,0,0,0,5
2016,Turkey,TUR,Jordan,JOR,0,0,0,5,5
2016,Yemen,YEM,Jordan,JOR,135,0,0,0,135
2016,Afghanistan,AFG,Kyrgyzstan,KGZ,5,0,23,0,28
2016,Syrian Arab Rep.,SYR,Kyrgyzstan,KGZ,5,0,0,0,5
2016,Egypt,EGY,Kuwait,KWT,0,0,5,0,5
2016,Iran (Islamic Rep. of),IRN,Kuwait,KWT,0,0,5,0,5
2016,Iraq,IRQ,Kuwait,KWT,74,0,0,0,74
2016,Somalia,SOM,Kuwait,KWT,165,0,0,0,165
2016,Syrian Arab Rep.,SYR,Kuwait,KWT,36,0,0,0,36
2016,Chad,TCD,Libya,LBY,0,0,0,5,5
2016,Eritrea,ERI,Libya,LBY,0,0,0,18,18
2016,Ethiopia,ETH,Libya,LBY,0,0,0,5,5
2016,Iraq,IRQ,Libya,LBY,0,0,0,26,26
2016,Somalia,SOM,Libya,LBY,0,0,0,5,5
2016,Sudan,SDN,Libya,LBY,0,0,0,38,38
2016,Syrian Arab Rep.,SYR,Libya,LBY,25,0,0,25,50
2016,Afghanistan,AFG,Lebanon,LBN,5,0,0,0,5
2016,Egypt,EGY,Lebanon,LBN,5,0,30,42,77
2016,Bahrain,BHR,Lebanon,LBN,10,0,0,5,15
2016,Bangladesh,BGD,Lebanon,LBN,0,0,0,17,17
2016,Cameroon,CMR,Lebanon,LBN,0,0,0,5,5
2016,Dem. Rep. of the Congo,COD,Lebanon,LBN,0,0,0,5,5
2016,Eritrea,ERI,Lebanon,LBN,5,0,12,13,30
2016,Ethiopia,ETH,Lebanon,LBN,11,0,93,142,246
2016,Palestinian,PSE,Lebanon,LBN,0,0,0,5,5
2016,India,IND,Lebanon,LBN,0,0,0,5,5
2016,Iran (Islamic Rep. of),IRN,Lebanon,LBN,5,0,5,14,24
2016,Iraq,IRQ,Lebanon,LBN,32,0,19,764,815
2016,Jordan,JOR,Lebanon,LBN,5,0,0,5,10
2016,Kenya,KEN,Lebanon,LBN,0,0,5,11,16
2016,Libya,LBY,Lebanon,LBN,5,0,0,0,5
2016,Sri Lanka,LKA,Lebanon,LBN,0,0,0,5,5
2016,Nigeria,NGA,Lebanon,LBN,0,0,5,0,5
2016,Philippines,PHL,Lebanon,LBN,0,0,0,13,13
2016,Sudan,SDN,Lebanon,LBN,176,0,519,335,1030
2016,South Sudan,SSD,Lebanon,LBN,5,0,0,0,5
2016,Yemen,YEM,Lebanon,LBN,5,0,0,5,10
2016,Afghanistan,AFG,Sri Lanka,LKA,48,0,0,5,53
2016,Bangladesh,BGD,Sri Lanka,LKA,10,0,0,0,10
2016,Palestinian,PSE,Sri Lanka,LKA,0,0,0,5,5
2016,Iran (Islamic Rep. of),IRN,Sri Lanka,LKA,5,0,0,0,5
2016,Maldives,MDV,Sri Lanka,LKA,5,0,0,0,5
2016,Pakistan,PAK,Sri Lanka,LKA,130,0,35,5,170
2016,Syrian Arab Rep.,SYR,Sri Lanka,LKA,5,0,0,0,5
2016,Ukraine,UKR,Sri Lanka,LKA,0,0,0,5,5
2016,Pakistan,PAK,Madagascar,MDG,10,0,0,0,10
2016,Syrian Arab Rep.,SYR,Madagascar,MDG,0,0,0,5,5
2016,Yemen,YEM,Madagascar,MDG,10,0,0,0,10
2016,Burundi,BDI,Mauritania,MRT,5,0,0,0,5
2016,Central African Rep.,CAF,Mauritania,MRT,88,0,0,0,88
2016,Cameroon,CMR,Mauritania,MRT,0,0,10,16,26
2016,Dem. Rep. of the Congo,COD,Mauritania,MRT,0,0,12,0,12
2016,Palestinian,PSE,Mauritania,MRT,11,0,0,0,11
2016,Guinea,GIN,Mauritania,MRT,0,0,0,10,10
2016,Cote d'Ivoire,CIV,Mauritania,MRT,0,0,5,62,67
2016,Iraq,IRQ,Mauritania,MRT,10,0,0,0,10
2016,Nigeria,NGA,Mauritania,MRT,5,0,20,28,53
2016,Senegal,SEN,Mauritania,MRT,19,0,10,10,39
2016,Sudan,SDN,Mauritania,MRT,5,0,0,0,5
2016,Syrian Arab Rep.,SYR,Mauritania,MRT,178,0,0,23,201
2016,Togo,TGO,Mauritania,MRT,0,0,0,5,5
2016,Yemen,YEM,Mauritania,MRT,5,0,0,0,5
2016,Afghanistan,AFG,Malaysia,MYS,107,0,89,50,246
2016,Egypt,EGY,Malaysia,MYS,5,0,13,0,18
2016,Bangladesh,BGD,Malaysia,MYS,0,0,5,5,10
2016,Central African Rep.,CAF,Malaysia,MYS,0,0,0,5,5
2016,China,CHN,Malaysia,MYS,0,0,5,0,5
2016,Cameroon,CMR,Malaysia,MYS,0,0,0,5,5
2016,Dem. Rep. of the Congo,COD,Malaysia,MYS,0,0,0,5,5
2016,Eritrea,ERI,Malaysia,MYS,0,0,0,5,5
2016,Palestinian,PSE,Malaysia,MYS,33,0,5,76,114
2016,Guinea,GIN,Malaysia,MYS,0,0,5,5,10
2016,India,IND,Malaysia,MYS,0,0,0,5,5
2016,Indonesia,IDN,Malaysia,MYS,51,0,5,0,56
2016,Iran (Islamic Rep. of),IRN,Malaysia,MYS,11,0,52,0,63
2016,Iraq,IRQ,Malaysia,MYS,36,0,0,245,281
2016,Liberia,LBR,Malaysia,MYS,0,0,12,0,12
2016,Libya,LBY,Malaysia,MYS,5,0,12,0,17
2016,Sri Lanka,LKA,Malaysia,MYS,36,0,451,296,783
2016,Mali,MLI,Malaysia,MYS,0,0,5,0,5
2016,Myanmar,MMR,Malaysia,MYS,18917,0,1196,0,20113
2016,Nigeria,NGA,Malaysia,MYS,0,0,5,10,15
2016,Pakistan,PAK,Malaysia,MYS,419,0,368,93,880
2016,Philippines,PHL,Malaysia,MYS,0,0,0,10,10
2016,Russian Federation,RUS,Malaysia,MYS,0,0,0,5,5
2016,Saudi Arabia,SAU,Malaysia,MYS,5,0,0,0,5
2016,Sierra Leone,SLE,Malaysia,MYS,0,0,10,5,15
2016,Somalia,SOM,Malaysia,MYS,137,0,74,13,224
2016,Sudan,SDN,Malaysia,MYS,10,0,17,39,66
2016,Syrian Arab Rep.,SYR,Malaysia,MYS,63,0,0,191,254
2016,Togo,TGO,Malaysia,MYS,0,0,0,5,5
2016,Uzbekistan,UZB,Malaysia,MYS,0,0,0,14,14
2016,Yemen,YEM,Malaysia,MYS,12,0,0,643,655
2016,Afghanistan,AFG,Mongolia,MNG,5,0,0,0,5
2016,Nigeria,NGA,Mongolia,MNG,0,0,5,0,5
2016,Algeria,DZA,Morocco,MAR,5,0,0,0,5
2016,Benin,BEN,Morocco,MAR,0,0,5,0,5
2016,Bangladesh,BGD,Morocco,MAR,0,0,0,5,5
2016,Burkina Faso,BFA,Morocco,MAR,0,0,5,10,15
2016,Central African Rep.,CAF,Morocco,MAR,104,0,11,28,143
2016,Chad,TCD,Morocco,MAR,0,0,5,0,5
2016,Cameroon,CMR,Morocco,MAR,24,0,82,219,325
2016,Congo,COG,Morocco,MAR,0,0,23,0,23
2016,Dem. Rep. of the Congo,COD,Morocco,MAR,26,0,92,95,213
2016,Gambia,GMB,Morocco,MAR,0,0,5,5,10
2016,Palestinian,PSE,Morocco,MAR,10,0,0,10,20
2016,Ghana,GHA,Morocco,MAR,0,0,0,5,5
2016,Guinea,GIN,Morocco,MAR,13,0,83,97,193
2016,Cote d'Ivoire,CIV,Morocco,MAR,19,0,109,130,258
2016,Iraq,IRQ,Morocco,MAR,5,0,0,10,15
2016,Liberia,LBR,Morocco,MAR,0,0,10,19,29
2016,Libya,LBY,Morocco,MAR,10,0,0,5,15
2016,Mali,MLI,Morocco,MAR,10,0,57,53,120
2016,Niger,NER,Morocco,MAR,0,0,0,5,5
2016,Nigeria,NGA,Morocco,MAR,0,0,31,70,101
2016,Pakistan,PAK,Morocco,MAR,5,0,0,0,5
2016,Rwanda,RWA,Morocco,MAR,0,0,5,0,5
2016,Senegal,SEN,Morocco,MAR,12,0,10,24,46
2016,Sierra Leone,SLE,Morocco,MAR,0,0,0,10,10
2016,Somalia,SOM,Morocco,MAR,0,0,0,5,5
2016,Sudan,SDN,Morocco,MAR,0,0,5,0,5
2016,Syrian Arab Rep.,SYR,Morocco,MAR,5,0,0,0,5
2016,Togo,TGO,Morocco,MAR,0,0,5,5,10
2016,Turkey,TUR,Morocco,MAR,0,0,0,5,5
2016,Bangladesh,BGD,Nepal,NPL,23,0,0,0,23
2016,Myanmar,MMR,Nepal,NPL,14,0,5,0,19
2016,Pakistan,PAK,Nepal,NPL,20,0,0,0,20
2016,Somalia,SOM,Nepal,NPL,5,0,0,0,5
2016,Iraq,IRQ,Oman,OMN,85,0,0,5,90
2016,Afghanistan,AFG,Pakistan,PAK,1210,0,1721,1990,4921
2016,Iran (Islamic Rep. of),IRN,Pakistan,PAK,17,0,5,0,22
2016,Iraq,IRQ,Pakistan,PAK,0,0,0,10,10
2016,Somalia,SOM,Pakistan,PAK,15,0,5,11,31
2016,Syrian Arab Rep.,SYR,Pakistan,PAK,5,0,0,0,5
2016,Turkey,TUR,Pakistan,PAK,0,0,0,10,10
2016,Yemen,YEM,Pakistan,PAK,24,0,0,5,29
2016,Iraq,IRQ,Qatar,QAT,44,0,0,0,44
2016,Syrian Arab Rep.,SYR,Qatar,QAT,18,0,0,0,18
2016,Syrian Arab Rep.,SYR,Saudi Arabia,SAU,10,0,0,0,10
2016,Yemen,YEM,Saudi Arabia,SAU,5,0,0,0,5
2016,Eritrea,ERI,Somalia,SOM,5,0,0,0,5
2016,Ethiopia,ETH,Somalia,SOM,271,0,52,37,360
2016,Palestinian,PSE,Somalia,SOM,0,0,0,14,14
2016,Syrian Arab Rep.,SYR,Somalia,SOM,0,0,0,100,100
2016,Yemen,YEM,Somalia,SOM,0,0,0,10,10
2016,Burundi,BDI,Sudan,SDN,0,5,0,0,5
2016,Eritrea,ERI,Sudan,SDN,148,45,5,16,214
2016,Ethiopia,ETH,Sudan,SDN,12,5,0,0,17
2016,Syrian Arab Rep.,SYR,Sudan,SDN,0,0,0,17,17
2016,Eritrea,ERI,South Sudan,SSD,5,0,0,5,10
2016,Ethiopia,ETH,South Sudan,SSD,13,0,5,44,62
2016,Somalia,SOM,South Sudan,SSD,0,0,0,16,16
2016,Sudan,SDN,South Sudan,SSD,5,0,0,11,16
2016,Afghanistan,AFG,Syrian Arab Rep.,SYR,39,0,13,0,52
2016,Algeria,DZA,Syrian Arab Rep.,SYR,0,0,47,0,47
2016,Egypt,EGY,Syrian Arab Rep.,SYR,0,0,75,5,80
2016,Bangladesh,BGD,Syrian Arab Rep.,SYR,0,0,5,0,5
2016,Burkina Faso,BFA,Syrian Arab Rep.,SYR,0,0,10,0,10
2016,Chad,TCD,Syrian Arab Rep.,SYR,0,0,5,0,5
2016,Chile,CHL,Syrian Arab Rep.,SYR,0,0,5,0,5
2016,Guinea,GIN,Syrian Arab Rep.,SYR,19,0,24,0,43
2016,Cote d'Ivoire,CIV,Syrian Arab Rep.,SYR,0,0,5,0,5
2016,Iran (Islamic Rep. of),IRN,Syrian Arab Rep.,SYR,5,0,644,56,705
2016,Iraq,IRQ,Syrian Arab Rep.,SYR,535,0,24,240,799
2016,Jordan,JOR,Syrian Arab Rep.,SYR,0,0,131,11,142
2016,Lebanon,LBN,Syrian Arab Rep.,SYR,0,0,294,20,314
2016,Mali,MLI,Syrian Arab Rep.,SYR,0,0,0,5,5
2016,Morocco,MAR,Syrian Arab Rep.,SYR,0,0,5,5,10
2016,Pakistan,PAK,Syrian Arab Rep.,SYR,57,0,24,13,94
2016,Philippines,PHL,Syrian Arab Rep.,SYR,0,0,5,0,5
2016,Sierra Leone,SLE,Syrian Arab Rep.,SYR,16,0,5,0,21
2016,Somalia,SOM,Syrian Arab Rep.,SYR,5,0,0,10,15
2016,Sudan,SDN,Syrian Arab Rep.,SYR,27,0,31,0,58
2016,Tunisia,TUN,Syrian Arab Rep.,SYR,0,0,13,0,13
2016,Yemen,YEM,Syrian Arab Rep.,SYR,0,0,0,14,14
2016,Stateless,XXA,Syrian Arab Rep.,SYR,0,0,0,5,5
2016,Afghanistan,AFG,Thailand,THA,44,0,5,11,60
2016,Egypt,EGY,Thailand,THA,5,0,5,5,15
2016,Bangladesh,BGD,Thailand,THA,0,0,0,5,5
2016,Cambodia,KHM,Thailand,THA,36,0,13,10,59
2016,China,CHN,Thailand,THA,97,0,16,24,137
2016,Cameroon,CMR,Thailand,THA,0,0,5,5,10
2016,Dem. Rep. of the Congo,COD,Thailand,THA,13,0,5,5,23
2016,Eritrea,ERI,Thailand,THA,5,0,0,0,5
2016,Ethiopia,ETH,Thailand,THA,5,0,10,10,25
2016,Palestinian,PSE,Thailand,THA,103,0,10,18,131
2016,Guinea,GIN,Thailand,THA,0,0,5,5,10
2016,India,IND,Thailand,THA,0,0,15,11,26
2016,Iran (Islamic Rep. of),IRN,Thailand,THA,10,0,26,42,78
2016,Iraq,IRQ,Thailand,THA,170,0,0,73,243
2016,Liberia,LBR,Thailand,THA,0,0,0,5,5
2016,Sri Lanka,LKA,Thailand,THA,16,0,36,37,89
2016,Nepal,NPL,Thailand,THA,0,0,5,0,5
2016,Nigeria,NGA,Thailand,THA,0,0,5,10,15
2016,Pakistan,PAK,Thailand,THA,1396,0,960,636,2992
2016,Russian Federation,RUS,Thailand,THA,0,0,5,0,5
2016,Sierra Leone,SLE,Thailand,THA,0,0,5,5,10
2016,Somalia,SOM,Thailand,THA,108,0,34,95,237
2016,Viet Nam,VNM,Thailand,THA,121,0,55,98,274
2016,Sudan,SDN,Thailand,THA,5,0,5,10,20
2016,Syrian Arab Rep.,SYR,Thailand,THA,229,0,0,41,270
2016,Uzbekistan,UZB,Thailand,THA,0,0,0,5,5
2016,Yemen,YEM,Thailand,THA,14,0,0,15,29
2016,Afghanistan,AFG,Tajikistan,TJK,11,0,0,20,31
2016,Cuba,CUB,Trinidad and Tobago,TTO,5,0,0,13,18
2016,Syrian Arab Rep.,SYR,Trinidad and Tobago,TTO,14,0,0,0,14
2016,Cote d'Ivoire,CIV,Tunisia,TUN,0,0,0,38,38
2016,Iraq,IRQ,Tunisia,TUN,5,0,0,5,10
2016,Somalia,SOM,Tunisia,TUN,0,0,0,5,5
2016,Sudan,SDN,Tunisia,TUN,0,0,0,5,5
2016,Turkey,TUR,Tunisia,TUN,5,0,0,0,5
2016,Afghanistan,AFG,Turkey,TUR,1251,0,0,8872,10123
2016,Algeria,DZA,Turkey,TUR,0,0,0,5,5
2016,Egypt,EGY,Turkey,TUR,25,0,29,44,98
2016,Burundi,BDI,Turkey,TUR,0,0,0,5,5
2016,Bangladesh,BGD,Turkey,TUR,0,0,0,232,232
2016,Central African Rep.,CAF,Turkey,TUR,0,0,0,5,5
2016,China,CHN,Turkey,TUR,0,0,0,27,27
2016,Cameroon,CMR,Turkey,TUR,5,0,0,40,45
2016,Congo,COG,Turkey,TUR,0,0,0,147,147
2016,Dem. Rep. of the Congo,COD,Turkey,TUR,15,0,5,124,144
2016,Eritrea,ERI,Turkey,TUR,10,0,0,125,135
2016,Ethiopia,ETH,Turkey,TUR,15,0,0,45,60
2016,Gabon,GAB,Turkey,TUR,0,0,0,5,5
2016,Gambia,GMB,Turkey,TUR,0,0,0,5,5
2016,Palestinian,PSE,Turkey,TUR,104,0,0,158,262
2016,Ghana,GHA,Turkey,TUR,0,0,0,11,11
2016,Guinea,GIN,Turkey,TUR,0,0,0,5,5
2016,Cote d'Ivoire,CIV,Turkey,TUR,0,0,0,19,19
2016,India,IND,Turkey,TUR,0,0,0,10,10
2016,Iran (Islamic Rep. of),IRN,Turkey,TUR,3764,0,753,2088,6605
2016,Iraq,IRQ,Turkey,TUR,12615,0,36,10887,23538
2016,Jordan,JOR,Turkey,TUR,5,0,0,14,19
2016,Kazakhstan,KAZ,Turkey,TUR,0,0,0,22,22
2016,Kyrgyzstan,KGZ,Turkey,TUR,0,0,0,15,15
2016,Libya,LBY,Turkey,TUR,13,0,0,10,23
2016,Lebanon,LBN,Turkey,TUR,5,0,0,17,22
2016,Sri Lanka,LKA,Turkey,TUR,0,0,0,5,5
2016,Mali,MLI,Turkey,TUR,0,0,5,5,10
2016,Mongolia,MNG,Turkey,TUR,0,0,0,33,33
2016,Morocco,MAR,Turkey,TUR,5,0,0,14,19
2016,Myanmar,MMR,Turkey,TUR,0,0,0,5,5
2016,Nepal,NPL,Turkey,TUR,0,0,0,5,5
2016,Nigeria,NGA,Turkey,TUR,0,0,0,51,51
2016,Pakistan,PAK,Turkey,TUR,13,0,0,1827,1840
2016,Philippines,PHL,Turkey,TUR,0,0,0,5,5
2016,Saudi Arabia,SAU,Turkey,TUR,5,0,0,0,5
2016,Senegal,SEN,Turkey,TUR,0,0,0,12,12
2016,Sierra Leone,SLE,Turkey,TUR,0,0,0,5,5
2016,Somalia,SOM,Turkey,TUR,189,0,0,661,850
2016,Sudan,SDN,Turkey,TUR,29,0,5,37,71
2016,Syrian Arab Rep.,SYR,Turkey,TUR,10,0,0,129,139
2016,Tajikistan,TJK,Turkey,TUR,0,0,10,44,54
2016,Turkmenistan,TKM,Turkey,TUR,0,0,5,108,113
2016,Tunisia,TUN,Turkey,TUR,0,0,0,10,10
2016,United Arab Emirates,ARE,Turkey,TUR,0,0,0,5,5
2016,Uganda,UGA,Turkey,TUR,5,0,28,156,189
2016,Uzbekistan,UZB,Turkey,TUR,5,0,0,109,114
2016,Yemen,YEM,Turkey,TUR,74,0,0,91,165
2016,Stateless,XXA,Turkey,TUR,10,0,0,5,15
2016,Afghanistan,AFG,Ukraine,UKR,17,0,0,5,22
2016,Iran (Islamic Rep. of),IRN,Ukraine,UKR,5,0,0,0,5
2016,Kyrgyzstan,KGZ,Ukraine,UKR,0,0,10,0,10
2016,Russian Federation,RUS,Ukraine,UKR,0,0,0,10,10
2016,Somalia,SOM,Ukraine,UKR,24,0,0,5,29
2016,Syrian Arab Rep.,SYR,Ukraine,UKR,10,0,0,15,25
2016,Uzbekistan,UZB,Ukraine,UKR,0,0,0,5,5
2016,Sri Lanka,LKA,Samoa,WSM,5,0,0,0,5
2016,Egypt,EGY,Yemen,YEM,0,0,0,10,10
2016,Eritrea,ERI,Yemen,YEM,118,0,0,220,338
2016,Ethiopia,ETH,Yemen,YEM,165,0,121,3966,4252
2016,Palestinian,PSE,Yemen,YEM,64,0,0,75,139
2016,Iran (Islamic Rep. of),IRN,Yemen,YEM,0,0,0,5,5
2016,Iraq,IRQ,Yemen,YEM,10,0,0,101,111
2016,Jordan,JOR,Yemen,YEM,0,0,0,5,5
2016,Viet Nam,VNM,Yemen,YEM,0,0,0,5,5
2016,Sudan,SDN,Yemen,YEM,37,0,10,50,97
2016,Syrian Arab Rep.,SYR,Yemen,YEM,14,0,0,99,113
2016,Uzbekistan,UZB,Yemen,YEM,0,0,0,5,5
2016,Cuba,CUB,British Virgin Islands,VGB,0,0,0,17,17
2016,Colombia,COL,Curacao ,CUW,5,0,0,5,10
2016,Syrian Arab Rep.,SYR,Curacao ,CUW,0,0,0,5,5
2016,Venezuela (Bolivarian Republic of),VEN,Curacao ,CUW,5,0,0,0,5
2016,Syrian Arab Rep.,SYR,Sint Maarten (Dutch part),SXM,0,0,0,5,5
2017,Iran (Islamic Rep. of),IRN,Afghanistan,AFG,5,0,0,5,10
2017,Pakistan,PAK,Afghanistan,AFG,5,0,5,11,21
2017,Turkey,TUR,Afghanistan,AFG,0,0,0,10,10
2017,Burkina Faso,BFA,Algeria,DZA,0,0,5,0,5
2017,Central African Rep.,CAF,Algeria,DZA,15,0,5,0,20
2017,Chad,TCD,Algeria,DZA,5,0,0,0,5
2017,Cameroon,CMR,Algeria,DZA,10,0,13,0,23
2017,Dem. Rep. of the Congo,COD,Algeria,DZA,10,0,10,0,20
2017,Guinea,GIN,Algeria,DZA,5,0,15,5,25
2017,Cote d'Ivoire,CIV,Algeria,DZA,10,0,10,0,20
2017,Libya,LBY,Algeria,DZA,0,0,0,12,12
2017,Lebanon,LBN,Algeria,DZA,0,0,0,10,10
2017,Mali,MLI,Algeria,DZA,11,0,14,5,30
2017,Syrian Arab Rep.,SYR,Algeria,DZA,10,0,0,1472,1482
2017,Yemen,YEM,Algeria,DZA,0,0,0,51,51
2017,Afghanistan,AFG,Egypt,EGY,0,0,5,10,15
2017,Burundi,BDI,Egypt,EGY,10,0,5,10,25
2017,Bangladesh,BGD,Egypt,EGY,0,0,12,0,12
2017,Central African Rep.,CAF,Egypt,EGY,13,0,0,5,18
2017,Chad,TCD,Egypt,EGY,0,0,10,0,10
2017,Cameroon,CMR,Egypt,EGY,0,0,24,0,24
2017,Congo,COG,Egypt,EGY,5,0,10,5,20
2017,Dem. Rep. of the Congo,COD,Egypt,EGY,0,0,18,0,18
2017,Eritrea,ERI,Egypt,EGY,1401,0,16,609,2026
2017,Ethiopia,ETH,Egypt,EGY,1319,0,1750,650,3719
2017,Gambia,GMB,Egypt,EGY,0,0,0,5,5
2017,Palestinian,PSE,Egypt,EGY,0,0,0,12,12
2017,Ghana,GHA,Egypt,EGY,0,0,5,17,22
2017,Guinea,GIN,Egypt,EGY,0,0,11,10,21
2017,Cote d'Ivoire,CIV,Egypt,EGY,5,0,5,5,15
2017,Iraq,IRQ,Egypt,EGY,576,0,10,836,1422
2017,Kenya,KEN,Egypt,EGY,0,0,5,0,5
2017,Kyrgyzstan,KGZ,Egypt,EGY,0,0,0,5,5
2017,Liberia,LBR,Egypt,EGY,0,0,5,0,5
2017,Libya,LBY,Egypt,EGY,0,0,0,5,5
2017,Mali,MLI,Egypt,EGY,0,0,5,0,5
2017,Morocco,MAR,Egypt,EGY,0,0,5,5,10
2017,Nigeria,NGA,Egypt,EGY,5,0,83,930,1018
2017,Russian Federation,RUS,Egypt,EGY,0,0,0,26,26
2017,Saudi Arabia,SAU,Egypt,EGY,0,0,0,5,5
2017,Sierra Leone,SLE,Egypt,EGY,0,0,21,5,26
2017,Somalia,SOM,Egypt,EGY,766,0,133,857,1756
2017,Sudan,SDN,Egypt,EGY,3974,0,2471,2247,8692
2017,South Sudan,SSD,Egypt,EGY,2524,0,5,372,2901
2017,Tajikistan,TJK,Egypt,EGY,0,0,10,11,21
2017,Togo,TGO,Egypt,EGY,0,0,0,5,5
2017,Tunisia,TUN,Egypt,EGY,0,0,5,0,5
2017,Uganda,UGA,Egypt,EGY,0,0,10,10,20
2017,Uzbekistan,UZB,Egypt,EGY,0,0,0,5,5
2017,Yemen,YEM,Egypt,EGY,28,0,0,528,556
2017,Zimbabwe,ZWE,Egypt,EGY,5,0,11,0,16
2017,Unknown ,,Egypt,EGY,0,0,0,5,5
2017,Afghanistan,AFG,Azerbaijan,AZE,46,0,10,0,56
2017,Iran (Islamic Rep. of),IRN,Azerbaijan,AZE,0,0,5,0,5
2017,Iraq,IRQ,Azerbaijan,AZE,5,0,0,0,5
2017,Russian Federation,RUS,Azerbaijan,AZE,10,0,5,39,54
2017,Turkey,TUR,Azerbaijan,AZE,5,0,0,0,5
2017,Yemen,YEM,Azerbaijan,AZE,5,0,0,0,5
2017,Afghanistan,AFG,China,CHN,5,0,0,0,5
2017,Burundi,BDI,China,CHN,5,0,0,5,10
2017,Benin,BEN,China,CHN,0,0,5,0,5
2017,Cameroon,CMR,China,CHN,0,0,15,11,26
2017,Dem. Rep. of the Congo,COD,China,CHN,0,0,5,5,10
2017,Gambia,GMB,China,CHN,0,0,5,5,10
2017,Ghana,GHA,China,CHN,0,0,20,12,32
2017,Guinea,GIN,China,CHN,0,0,5,5,10
2017,Cote d'Ivoire,CIV,China,CHN,0,0,5,5,10
2017,Iraq,IRQ,China,CHN,5,0,0,13,18
2017,Kenya,KEN,China,CHN,0,0,0,5,5
2017,Liberia,LBR,China,CHN,0,0,78,29,107
2017,Mali,MLI,China,CHN,0,0,5,0,5
2017,Mozambique,MOZ,China,CHN,0,0,5,5,10
2017,Nigeria,NGA,China,CHN,0,0,51,15,66
2017,Pakistan,PAK,China,CHN,10,0,0,0,10
2017,Sierra Leone,SLE,China,CHN,0,0,5,5,10
2017,Somalia,SOM,China,CHN,11,0,5,0,16
2017,Syrian Arab Rep.,SYR,China,CHN,22,0,0,0,22
2017,Uganda,UGA,China,CHN,5,0,27,5,37
2017,Yemen,YEM,China,CHN,5,0,0,5,10
2017,Zimbabwe,ZWE,China,CHN,5,0,20,5,30
2017,Central African Rep.,CAF,Cameroon,CMR,1150,0,254,0,1404
2017,Chad,TCD,Cameroon,CMR,25,0,71,0,96
2017,Dem. Rep. of the Congo,COD,Cameroon,CMR,5,0,45,0,50
2017,Guinea-Bissau,GNB,Cameroon,CMR,0,0,5,0,5
2017,Guinea,GIN,Cameroon,CMR,0,0,13,0,13
2017,Cote d'Ivoire,CIV,Cameroon,CMR,0,0,15,0,15
2017,Nigeria,NGA,Cameroon,CMR,5,0,0,0,5
2017,Rwanda,RWA,Cameroon,CMR,5,0,15,0,20
2017,Sudan,SDN,Cameroon,CMR,11,0,0,0,11
2017,Angola,AGO,Cuba,CUB,0,0,5,0,5
2017,Palestinian,PSE,Cuba,CUB,0,0,0,5,5
2017,Iran (Islamic Rep. of),IRN,Cuba,CUB,0,0,5,0,5
2017,Iraq,IRQ,Cuba,CUB,0,0,0,5,5
2017,Syrian Arab Rep.,SYR,Cuba,CUB,10,0,0,0,10
2017,Yemen,YEM,Cuba,CUB,5,0,0,0,5
2017,Pakistan,PAK,Guyana,GUY,5,0,0,0,5
2017,Yemen,YEM,"China, Hong Kong SAR",HKG,5,0,0,0,5
2017,Afghanistan,AFG,India,IND,1477,0,962,826,3265
2017,Cameroon,CMR,India,IND,0,0,10,5,15
2017,Congo,COG,India,IND,0,0,5,0,5
2017,Dem. Rep. of the Congo,COD,India,IND,10,0,13,0,23
2017,Palestinian,PSE,India,IND,18,0,0,5,23
2017,Cote d'Ivoire,CIV,India,IND,0,0,5,0,5
2017,Iran (Islamic Rep. of),IRN,India,IND,0,0,5,0,5
2017,Iraq,IRQ,India,IND,103,0,0,57,160
2017,Mali,MLI,India,IND,0,0,0,5,5
2017,Myanmar,MMR,India,IND,2512,0,37,1455,4004
2017,Nigeria,NGA,India,IND,0,0,0,68,68
2017,Philippines,PHL,India,IND,0,0,0,5,5
2017,Russian Federation,RUS,India,IND,0,0,5,5,10
2017,Rwanda,RWA,India,IND,0,0,5,0,5
2017,Somalia,SOM,India,IND,132,0,38,5,175
2017,Sudan,SDN,India,IND,12,0,5,11,28
2017,South Sudan,SSD,India,IND,5,0,0,0,5
2017,Syrian Arab Rep.,SYR,India,IND,39,0,0,5,44
2017,Uganda,UGA,India,IND,0,0,0,5,5
2017,Ukraine,UKR,India,IND,0,0,5,5,10
2017,Yemen,YEM,India,IND,0,0,0,25,25
2017,Afghanistan,AFG,Indonesia,IDN,1467,0,0,47,1514
2017,Egypt,EGY,Indonesia,IDN,0,0,10,5,15
2017,Bangladesh,BGD,Indonesia,IDN,0,0,10,46,56
2017,Belarus,BLR,Indonesia,IDN,0,0,0,5,5
2017,China,CHN,Indonesia,IDN,0,0,0,5,5
2017,Cameroon,CMR,Indonesia,IDN,0,0,34,10,44
2017,Dem. Rep. of the Congo,COD,Indonesia,IDN,5,0,5,5,15
2017,Eritrea,ERI,Indonesia,IDN,10,0,0,5,15
2017,Ethiopia,ETH,Indonesia,IDN,80,0,64,13,157
2017,Gabon,GAB,Indonesia,IDN,0,0,0,10,10
2017,Palestinian,PSE,Indonesia,IDN,15,0,0,76,91
2017,Ghana,GHA,Indonesia,IDN,0,0,5,0,5
2017,Guinea,GIN,Indonesia,IDN,0,0,5,5,10
2017,Cote d'Ivoire,CIV,Indonesia,IDN,0,0,5,0,5
2017,India,IND,Indonesia,IDN,0,0,0,10,10
2017,Iran (Islamic Rep. of),IRN,Indonesia,IDN,37,0,19,14,70
2017,Iraq,IRQ,Indonesia,IDN,211,0,5,161,377
2017,Kuwait,KWT,Indonesia,IDN,0,0,0,5,5
2017,Liberia,LBR,Indonesia,IDN,0,0,5,5,10
2017,Libya,LBY,Indonesia,IDN,5,0,0,5,10
2017,Sri Lanka,LKA,Indonesia,IDN,36,0,36,54,126
2017,Mali,MLI,Indonesia,IDN,0,0,5,0,5
2017,Myanmar,MMR,Indonesia,IDN,18,0,0,49,67
2017,Nigeria,NGA,Indonesia,IDN,0,0,149,696,845
2017,Pakistan,PAK,Indonesia,IDN,48,0,0,10,58
2017,Sierra Leone,SLE,Indonesia,IDN,0,0,5,12,17
2017,Somalia,SOM,Indonesia,IDN,452,0,10,117,579
2017,Viet Nam,VNM,Indonesia,IDN,18,0,0,0,18
2017,Sudan,SDN,Indonesia,IDN,103,0,0,19,122
2017,Syrian Arab Rep.,SYR,Indonesia,IDN,0,0,0,14,14
2017,Turkey,TUR,Indonesia,IDN,0,0,0,5,5
2017,Yemen,YEM,Indonesia,IDN,66,0,0,78,144
2017,Afghanistan,AFG,Iran (Islamic Rep. of),IRN,0,0,0,5,5
2017,Eritrea,ERI,Iraq,IRQ,5,0,0,0,5
2017,Palestinian,PSE,Iraq,IRQ,0,0,0,130,130
2017,Iran (Islamic Rep. of),IRN,Iraq,IRQ,0,0,0,459,459
2017,Kuwait,KWT,Iraq,IRQ,0,0,0,10,10
2017,Saudi Arabia,SAU,Iraq,IRQ,0,0,0,13,13
2017,South Sudan,SSD,Iraq,IRQ,5,0,10,157,172
2017,Turkey,TUR,Iraq,IRQ,0,0,0,191,191
2017,Eritrea,ERI,Israel,ISR,177,0,0,0,177
2017,Ethiopia,ETH,Israel,ISR,5,0,0,0,5
2017,Palestinian,PSE,Israel,ISR,5,0,0,0,5
2017,Sudan,SDN,Israel,ISR,26,0,0,0,26
2017,South Sudan,SSD,Israel,ISR,22,0,0,0,22
2017,Burkina Faso,BFA,Jordan,JOR,0,0,0,5,5
2017,Eritrea,ERI,Jordan,JOR,5,0,0,0,5
2017,Iraq,IRQ,Jordan,JOR,1604,0,0,0,1604
2017,Libya,LBY,Jordan,JOR,11,0,0,0,11
2017,Somalia,SOM,Jordan,JOR,25,0,0,0,25
2017,Sudan,SDN,Jordan,JOR,270,0,10,0,280
2017,Tunisia,TUN,Jordan,JOR,0,0,0,5,5
2017,Ukraine,UKR,Jordan,JOR,0,0,0,10,10
2017,Yemen,YEM,Jordan,JOR,304,0,0,0,304
2017,Stateless,XXA,Jordan,JOR,0,0,0,168,168
2017,Iran (Islamic Rep. of),IRN,Kuwait,KWT,0,0,5,14,19
2017,Iraq,IRQ,Kuwait,KWT,5,0,0,0,5
2017,Dem. People's Rep. of Korea,PRK,Kuwait,KWT,5,0,0,0,5
2017,Turkey,TUR,Kuwait,KWT,5,0,0,0,5
2017,Stateless,XXA,Kuwait,KWT,0,0,0,16,16
2017,Eritrea,ERI,Libya,LBY,34,0,0,0,34
2017,Palestinian,PSE,Libya,LBY,5,0,0,0,5
2017,Iraq,IRQ,Libya,LBY,5,0,0,0,5
2017,Sudan,SDN,Libya,LBY,5,0,0,0,5
2017,Syrian Arab Rep.,SYR,Libya,LBY,115,0,0,0,115
2017,Egypt,EGY,Lebanon,LBN,22,0,27,22,71
2017,Bangladesh,BGD,Lebanon,LBN,0,0,5,5,10
2017,Cameroon,CMR,Lebanon,LBN,0,0,0,5,5
2017,Eritrea,ERI,Lebanon,LBN,5,0,19,15,39
2017,Ethiopia,ETH,Lebanon,LBN,12,0,152,126,290
2017,Iran (Islamic Rep. of),IRN,Lebanon,LBN,0,0,10,10,20
2017,Iraq,IRQ,Lebanon,LBN,149,0,10,16,175
2017,Jordan,JOR,Lebanon,LBN,5,0,0,5,10
2017,Kenya,KEN,Lebanon,LBN,0,0,5,5,10
2017,Sri Lanka,LKA,Lebanon,LBN,0,0,0,5,5
2017,Saudi Arabia,SAU,Lebanon,LBN,5,0,0,0,5
2017,Somalia,SOM,Lebanon,LBN,0,0,5,0,5
2017,Sudan,SDN,Lebanon,LBN,65,0,299,226,590
2017,South Sudan,SSD,Lebanon,LBN,5,0,0,0,5
2017,Syrian Arab Rep.,SYR,Lebanon,LBN,0,0,0,5,5
2017,Turkey,TUR,Lebanon,LBN,0,0,0,5,5
2017,Yemen,YEM,Lebanon,LBN,5,0,0,5,10
2017,Afghanistan,AFG,Sri Lanka,LKA,57,0,0,13,70
2017,Pakistan,PAK,Sri Lanka,LKA,188,0,0,22,210
2017,Syrian Arab Rep.,SYR,Sri Lanka,LKA,5,0,0,0,5
2017,Yemen,YEM,Sri Lanka,LKA,11,0,0,0,11
2017,Afghanistan,AFG,Madagascar,MDG,5,0,0,0,5
2017,Kyrgyzstan,KGZ,Madagascar,MDG,0,0,0,5,5
2017,Turkey,TUR,Madagascar,MDG,0,0,0,23,23
2017,Yemen,YEM,Madagascar,MDG,12,0,0,0,12
2017,Central African Rep.,CAF,Mauritania,MRT,44,0,0,33,77
2017,Chad,TCD,Mauritania,MRT,0,0,0,5,5
2017,Cameroon,CMR,Mauritania,MRT,0,0,10,0,10
2017,Congo,COG,Mauritania,MRT,5,0,0,0,5
2017,Palestinian,PSE,Mauritania,MRT,5,0,0,5,10
2017,Ghana,GHA,Mauritania,MRT,0,0,0,5,5
2017,Guinea,GIN,Mauritania,MRT,0,0,10,5,15
2017,Cote d'Ivoire,CIV,Mauritania,MRT,10,0,12,0,22
2017,Liberia,LBR,Mauritania,MRT,0,0,0,5,5
2017,Mali,MLI,Mauritania,MRT,0,0,5,0,5
2017,Nigeria,NGA,Mauritania,MRT,5,0,29,24,58
2017,Senegal,SEN,Mauritania,MRT,17,0,12,5,34
2017,Syrian Arab Rep.,SYR,Mauritania,MRT,96,0,0,14,110
2017,Togo,TGO,Mauritania,MRT,0,0,5,0,5
2017,Turkey,TUR,Mauritania,MRT,0,0,0,11,11
2017,Afghanistan,AFG,Malaysia,MYS,164,0,37,0,201
2017,Egypt,EGY,Malaysia,MYS,0,0,5,0,5
2017,Bangladesh,BGD,Malaysia,MYS,0,0,5,5,10
2017,Cambodia,KHM,Malaysia,MYS,5,0,0,26,31
2017,China,CHN,Malaysia,MYS,5,0,0,5,10
2017,Ethiopia,ETH,Malaysia,MYS,5,0,0,0,5
2017,Palestinian,PSE,Malaysia,MYS,15,0,5,0,20
2017,United Kingdom of Great Britain and Northern Ireland,GBR,Malaysia,MYS,0,0,0,5,5
2017,Guinea,GIN,Malaysia,MYS,0,0,5,0,5
2017,Indonesia,IDN,Malaysia,MYS,15,0,5,268,288
2017,Iran (Islamic Rep. of),IRN,Malaysia,MYS,11,0,22,17,50
2017,Iraq,IRQ,Malaysia,MYS,32,0,0,0,32
2017,Jordan,JOR,Malaysia,MYS,0,0,0,5,5
2017,Liberia,LBR,Malaysia,MYS,0,0,10,0,10
2017,Lebanon,LBN,Malaysia,MYS,0,0,0,5,5
2017,Sri Lanka,LKA,Malaysia,MYS,35,0,200,28,263
2017,Myanmar,MMR,Malaysia,MYS,17566,0,2135,11843,31544
2017,Nepal,NPL,Malaysia,MYS,0,0,0,5,5
2017,Nigeria,NGA,Malaysia,MYS,0,0,5,0,5
2017,Pakistan,PAK,Malaysia,MYS,508,0,230,0,738
2017,Russian Federation,RUS,Malaysia,MYS,0,0,5,0,5
2017,Somalia,SOM,Malaysia,MYS,169,0,48,59,276
2017,Sudan,SDN,Malaysia,MYS,30,0,11,0,41
2017,South Sudan,SSD,Malaysia,MYS,5,0,0,10,15
2017,Syrian Arab Rep.,SYR,Malaysia,MYS,29,0,0,35,64
2017,Thailand,THA,Malaysia,MYS,0,0,0,20,20
2017,Turkey,TUR,Malaysia,MYS,0,0,0,13,13
2017,United States of America,USA,Malaysia,MYS,0,0,0,5,5
2017,Uzbekistan,UZB,Malaysia,MYS,0,0,5,0,5
2017,Yemen,YEM,Malaysia,MYS,34,0,0,0,34
2017,Afghanistan,AFG,Mongolia,MNG,5,0,0,0,5
2017,Algeria,DZA,Morocco,MAR,0,0,0,10,10
2017,Burundi,BDI,Morocco,MAR,0,0,0,5,5
2017,Benin,BEN,Morocco,MAR,0,0,5,0,5
2017,Bangladesh,BGD,Morocco,MAR,0,0,0,5,5
2017,Burkina Faso,BFA,Morocco,MAR,0,0,5,5,10
2017,Central African Rep.,CAF,Morocco,MAR,82,0,5,14,101
2017,Chad,TCD,Morocco,MAR,0,0,5,0,5
2017,Cameroon,CMR,Morocco,MAR,25,0,122,313,460
2017,Congo,COG,Morocco,MAR,0,0,40,35,75
2017,Dem. Rep. of the Congo,COD,Morocco,MAR,10,0,123,91,224
2017,Gambia,GMB,Morocco,MAR,0,0,5,20,25
2017,Palestinian,PSE,Morocco,MAR,21,0,0,5,26
2017,Ghana,GHA,Morocco,MAR,0,0,0,5,5
2017,Guinea-Bissau,GNB,Morocco,MAR,0,0,0,5,5
2017,Guinea,GIN,Morocco,MAR,5,0,155,157,317
2017,Cote d'Ivoire,CIV,Morocco,MAR,29,0,135,142,306
2017,Iraq,IRQ,Morocco,MAR,24,0,0,10,34
2017,Liberia,LBR,Morocco,MAR,0,0,18,5,23
2017,Libya,LBY,Morocco,MAR,15,0,0,16,31
2017,Lebanon,LBN,Morocco,MAR,0,0,5,36,41
2017,Mali,MLI,Morocco,MAR,0,0,47,86,133
2017,Nigeria,NGA,Morocco,MAR,5,0,28,70,103
2017,Senegal,SEN,Morocco,MAR,30,0,47,49,126
2017,Sierra Leone,SLE,Morocco,MAR,0,0,10,5,15
2017,Somalia,SOM,Morocco,MAR,0,0,0,5,5
2017,Sudan,SDN,Morocco,MAR,0,0,0,5,5
2017,Syrian Arab Rep.,SYR,Morocco,MAR,23,0,0,795,818
2017,Turkey,TUR,Morocco,MAR,0,0,0,126,126
2017,Yemen,YEM,Morocco,MAR,5,0,0,92,97
2017,Syrian Arab Rep.,SYR,Mauritius,MUS,5,0,0,0,5
2017,Myanmar,MMR,Nepal,NPL,41,0,0,5,46
2017,Pakistan,PAK,Nepal,NPL,5,0,0,0,5
2017,Somalia,SOM,Nepal,NPL,5,0,0,0,5
2017,Afghanistan,AFG,Pakistan,PAK,0,0,0,1986,1986
2017,Egypt,EGY,Pakistan,PAK,0,0,0,5,5
2017,Palestinian,PSE,Pakistan,PAK,5,0,0,5,10
2017,Iran (Islamic Rep. of),IRN,Pakistan,PAK,5,0,0,0,5
2017,Iraq,IRQ,Pakistan,PAK,0,0,5,0,5
2017,Somalia,SOM,Pakistan,PAK,33,0,0,0,33
2017,Syrian Arab Rep.,SYR,Pakistan,PAK,12,0,0,0,12
2017,Tajikistan,TJK,Pakistan,PAK,5,0,0,0,5
2017,Turkey,TUR,Pakistan,PAK,0,0,0,150,150
2017,Yemen,YEM,Pakistan,PAK,89,0,0,11,100
2017,Syrian Arab Rep.,SYR,Palau,PLW,5,0,0,0,5
2017,Egypt,EGY,Qatar,QAT,10,0,0,0,10
2017,Iraq,IRQ,Qatar,QAT,5,0,0,0,5
2017,Chad,TCD,Saudi Arabia,SAU,10,0,0,0,10
2017,Yemen,YEM,Saudi Arabia,SAU,5,0,0,0,5
2017,Eritrea,ERI,Somalia,SOM,10,0,0,0,10
2017,Ethiopia,ETH,Somalia,SOM,590,0,51,27,668
2017,Yemen,YEM,Somalia,SOM,272,0,0,0,272
2017,Egypt,EGY,Sudan,SDN,0,0,0,20,20
2017,Burundi,BDI,Sudan,SDN,0,0,0,5,5
2017,Central African Rep.,CAF,Sudan,SDN,0,0,0,5,5
2017,Chad,TCD,Sudan,SDN,0,0,0,5,5
2017,Congo,COG,Sudan,SDN,0,0,0,5,5
2017,Dem. Rep. of the Congo,COD,Sudan,SDN,0,0,0,181,181
2017,Eritrea,ERI,Sudan,SDN,4172,0,71,0,4243
2017,Ethiopia,ETH,Sudan,SDN,307,0,75,0,382
2017,Somalia,SOM,Sudan,SDN,27,0,0,0,27
2017,Syrian Arab Rep.,SYR,Sudan,SDN,0,0,0,55,55
2017,Cuba,CUB,Suriname,SUR,29,0,14,21,64
2017,Burundi,BDI,South Sudan,SSD,0,0,0,226,226
2017,Eritrea,ERI,South Sudan,SSD,68,0,0,344,412
2017,Ethiopia,ETH,South Sudan,SSD,17,0,0,105,122
2017,Kenya,KEN,South Sudan,SSD,0,0,0,5,5
2017,Somalia,SOM,South Sudan,SSD,0,0,0,135,135
2017,Sudan,SDN,South Sudan,SSD,0,0,0,10,10
2017,Afghanistan,AFG,Syrian Arab Rep.,SYR,34,0,86,20,140
2017,Algeria,DZA,Syrian Arab Rep.,SYR,0,0,22,12,34
2017,Egypt,EGY,Syrian Arab Rep.,SYR,0,0,54,5,59
2017,Burkina Faso,BFA,Syrian Arab Rep.,SYR,0,0,5,0,5
2017,Bosnia and Herzegovina,BIH,Syrian Arab Rep.,SYR,0,0,5,0,5
2017,Chad,TCD,Syrian Arab Rep.,SYR,0,0,11,5,16
2017,Palestinian,PSE,Syrian Arab Rep.,SYR,0,0,0,5,5
2017,Iran (Islamic Rep. of),IRN,Syrian Arab Rep.,SYR,17,0,150,5,172
2017,Iraq,IRQ,Syrian Arab Rep.,SYR,424,0,76,2314,2814
2017,Jordan,JOR,Syrian Arab Rep.,SYR,0,0,20,5,25
2017,Lebanon,LBN,Syrian Arab Rep.,SYR,0,0,31,5,36
2017,Pakistan,PAK,Syrian Arab Rep.,SYR,14,0,29,0,43
2017,Romania,ROU,Syrian Arab Rep.,SYR,0,0,5,0,5
2017,Saudi Arabia,SAU,Syrian Arab Rep.,SYR,5,0,10,0,15
2017,Sierra Leone,SLE,Syrian Arab Rep.,SYR,0,0,5,5,10
2017,Somalia,SOM,Syrian Arab Rep.,SYR,14,0,0,0,14
2017,Sudan,SDN,Syrian Arab Rep.,SYR,28,0,38,18,84
2017,Tajikistan,TJK,Syrian Arab Rep.,SYR,0,0,0,5,5
2017,Tunisia,TUN,Syrian Arab Rep.,SYR,0,0,10,0,10
2017,Turkey,TUR,Syrian Arab Rep.,SYR,0,0,10,5,15
2017,Yemen,YEM,Syrian Arab Rep.,SYR,69,0,0,18,87
2017,Stateless,XXA,Syrian Arab Rep.,SYR,0,0,5,0,5
2017,Afghanistan,AFG,Thailand,THA,43,0,0,11,54
2017,Egypt,EGY,Thailand,THA,11,0,13,5,29
2017,Bangladesh,BGD,Thailand,THA,0,0,5,0,5
2017,Cambodia,KHM,Thailand,THA,63,0,20,30,113
2017,China,CHN,Thailand,THA,52,0,10,20,82
2017,Cameroon,CMR,Thailand,THA,0,0,0,5,5
2017,Dem. Rep. of the Congo,COD,Thailand,THA,10,0,5,5,20
2017,Eritrea,ERI,Thailand,THA,5,0,0,0,5
2017,Ethiopia,ETH,Thailand,THA,5,0,5,10,20
2017,Palestinian,PSE,Thailand,THA,30,0,0,11,41
2017,Guinea,GIN,Thailand,THA,0,0,5,5,10
2017,India,IND,Thailand,THA,0,0,5,13,18
2017,Iran (Islamic Rep. of),IRN,Thailand,THA,25,0,34,42,101
2017,Iraq,IRQ,Thailand,THA,94,0,5,12,111
2017,Sri Lanka,LKA,Thailand,THA,27,0,32,26,85
2017,Nepal,NPL,Thailand,THA,0,0,0,5,5
2017,Nigeria,NGA,Thailand,THA,0,0,5,11,16
2017,Pakistan,PAK,Thailand,THA,372,0,1262,833,2467
2017,Philippines,PHL,Thailand,THA,0,0,5,0,5
2017,Russian Federation,RUS,Thailand,THA,0,0,0,5,5
2017,Somalia,SOM,Thailand,THA,80,0,34,36,150
2017,Viet Nam,VNM,Thailand,THA,194,0,191,25,410
2017,Syrian Arab Rep.,SYR,Thailand,THA,72,0,0,16,88
2017,Uzbekistan,UZB,Thailand,THA,0,0,0,5,5
2017,Yemen,YEM,Thailand,THA,22,0,0,0,22
2017,Zimbabwe,ZWE,Thailand,THA,10,0,0,0,10
2017,Afghanistan,AFG,Tajikistan,TJK,0,0,0,17,17
2017,Bangladesh,BGD,Trinidad and Tobago,TTO,0,0,5,0,5
2017,Cuba,CUB,Trinidad and Tobago,TTO,84,0,5,10,99
2017,Guyana,GUY,Trinidad and Tobago,TTO,5,0,0,0,5
2017,Jamaica,JAM,Trinidad and Tobago,TTO,17,0,0,0,17
2017,Pakistan,PAK,Trinidad and Tobago,TTO,5,0,0,0,5
2017,Syrian Arab Rep.,SYR,Trinidad and Tobago,TTO,25,0,0,0,25
2017,Saint Vincent and the Grenadines,VCT,Trinidad and Tobago,TTO,5,0,0,0,5
2017,Venezuela (Bolivarian Republic of),VEN,Trinidad and Tobago,TTO,46,0,0,5,51
2017,Congo,COG,Tunisia,TUN,0,0,5,0,5
2017,Palestinian,PSE,Tunisia,TUN,5,0,0,0,5
2017,Cote d'Ivoire,CIV,Tunisia,TUN,0,0,5,0,5
2017,Iraq,IRQ,Tunisia,TUN,0,0,0,18,18
2017,Yemen,YEM,Tunisia,TUN,0,0,0,5,5
2017,Afghanistan,AFG,Turkey,TUR,2669,0,0,21532,24201
2017,Algeria,DZA,Turkey,TUR,0,0,0,10,10
2017,Angola,AGO,Turkey,TUR,0,0,0,5,5
2017,Egypt,EGY,Turkey,TUR,5,0,0,24,29
2017,Burundi,BDI,Turkey,TUR,5,0,0,5,10
2017,Bangladesh,BGD,Turkey,TUR,0,0,0,20,20
2017,China,CHN,Turkey,TUR,0,0,0,5,5
2017,Cameroon,CMR,Turkey,TUR,0,0,0,29,29
2017,Congo,COG,Turkey,TUR,0,0,0,61,61
2017,Dem. Rep. of the Congo,COD,Turkey,TUR,5,0,5,70,80
2017,Djibouti,DJI,Turkey,TUR,0,0,0,5,5
2017,Dominican Rep.,DOM,Turkey,TUR,0,0,0,5,5
2017,Eritrea,ERI,Turkey,TUR,0,0,0,23,23
2017,Ethiopia,ETH,Turkey,TUR,5,0,0,64,69
2017,Palestinian,PSE,Turkey,TUR,160,0,0,213,373
2017,Ghana,GHA,Turkey,TUR,0,0,0,5,5
2017,Guinea,GIN,Turkey,TUR,5,0,0,5,10
2017,Cote d'Ivoire,CIV,Turkey,TUR,0,0,0,5,5
2017,Iran (Islamic Rep. of),IRN,Turkey,TUR,2143,0,785,5848,8776
2017,Iraq,IRQ,Turkey,TUR,10199,0,5,18317,28521
2017,Jordan,JOR,Turkey,TUR,5,0,0,5,10
2017,Kazakhstan,KAZ,Turkey,TUR,0,0,0,17,17
2017,Kyrgyzstan,KGZ,Turkey,TUR,0,0,0,31,31
2017,Kuwait,KWT,Turkey,TUR,0,0,0,5,5
2017,Libya,LBY,Turkey,TUR,0,0,0,10,10
2017,Lebanon,LBN,Turkey,TUR,0,0,0,5,5
2017,Sri Lanka,LKA,Turkey,TUR,5,0,0,0,5
2017,Mali,MLI,Turkey,TUR,0,0,0,5,5
2017,Mongolia,MNG,Turkey,TUR,0,0,0,20,20
2017,Morocco,MAR,Turkey,TUR,0,0,0,16,16
2017,Myanmar,MMR,Turkey,TUR,0,0,0,10,10
2017,Nigeria,NGA,Turkey,TUR,0,0,0,27,27
2017,Pakistan,PAK,Turkey,TUR,10,0,5,98,113
2017,Romania,ROU,Turkey,TUR,0,0,0,5,5
2017,Russian Federation,RUS,Turkey,TUR,0,0,0,5,5
2017,Senegal,SEN,Turkey,TUR,0,0,0,5,5
2017,Sierra Leone,SLE,Turkey,TUR,0,0,0,10,10
2017,Somalia,SOM,Turkey,TUR,83,0,5,433,521
2017,Sudan,SDN,Turkey,TUR,10,0,0,22,32
2017,Syrian Arab Rep.,SYR,Turkey,TUR,5,0,0,31,36
2017,Tajikistan,TJK,Turkey,TUR,0,0,0,37,37
2017,Turkmenistan,TKM,Turkey,TUR,0,0,0,122,122
2017,Tunisia,TUN,Turkey,TUR,5,0,0,12,17
2017,United Arab Emirates,ARE,Turkey,TUR,5,0,0,0,5
2017,Uganda,UGA,Turkey,TUR,0,0,10,151,161
2017,Uzbekistan,UZB,Turkey,TUR,5,0,0,145,150
2017,Yemen,YEM,Turkey,TUR,13,0,0,16,29
2017,Unknown ,,Turkey,TUR,0,0,0,13,13
2017,Afghanistan,AFG,United Arab Emirates,ARE,5,0,0,0,5
2017,Palestinian,PSE,United Arab Emirates,ARE,5,0,0,21,26
2017,Iran (Islamic Rep. of),IRN,United Arab Emirates,ARE,5,0,0,0,5
2017,Iraq,IRQ,United Arab Emirates,ARE,49,0,5,0,54
2017,Lebanon,LBN,United Arab Emirates,ARE,5,0,0,0,5
2017,Saudi Arabia,SAU,United Arab Emirates,ARE,5,0,0,0,5
2017,Sudan,SDN,United Arab Emirates,ARE,5,0,0,0,5
2017,Syrian Arab Rep.,SYR,United Arab Emirates,ARE,44,0,0,247,291
2017,Afghanistan,AFG,Ukraine,UKR,21,0,0,0,21
2017,Somalia,SOM,Ukraine,UKR,5,0,0,0,5
2017,Sudan,SDN,Ukraine,UKR,5,0,0,0,5
2017,Uzbekistan,UZB,Ukraine,UKR,5,0,0,0,5
2017,Colombia,COL,Curacao ,CUW,11,0,5,0,16
2017,Venezuela (Bolivarian Republic of),VEN,Curacao ,CUW,20,0,0,0,20
2018,Turkey,TUR,Afghanistan,AFG,0,0,0,89,89
2018,Benin,BEN,Algeria,DZA,5,0,0,0,5
2018,Burkina Faso,BFA,Algeria,DZA,0,0,5,5,10
2018,Central African Rep.,CAF,Algeria,DZA,17,0,0,14,31
2018,Chad,TCD,Algeria,DZA,10,0,5,5,20
2018,Cameroon,CMR,Algeria,DZA,16,0,21,27,64
2018,Congo,COG,Algeria,DZA,0,0,5,0,5
2018,Dem. Rep. of the Congo,COD,Algeria,DZA,24,0,23,24,71
2018,Palestinian,PSE,Algeria,DZA,0,0,0,5,5
2018,Guinea,GIN,Algeria,DZA,10,0,104,74,188
2018,Cote d'Ivoire,CIV,Algeria,DZA,15,0,63,40,118
2018,Liberia,LBR,Algeria,DZA,0,0,0,10,10
2018,Libya,LBY,Algeria,DZA,0,0,0,5,5
2018,Mali,MLI,Algeria,DZA,24,0,48,36,108
2018,Niger,NER,Algeria,DZA,0,0,0,5,5
2018,Senegal,SEN,Algeria,DZA,0,0,5,0,5
2018,Sierra Leone,SLE,Algeria,DZA,0,0,0,5,5
2018,Sudan,SDN,Algeria,DZA,5,0,0,5,10
2018,Syrian Arab Rep.,SYR,Algeria,DZA,13,0,0,69,82
2018,Tunisia,TUN,Algeria,DZA,0,0,0,5,5
2018,Yemen,YEM,Algeria,DZA,5,0,0,30,35
2018,Afghanistan,AFG,Egypt,EGY,5,0,0,0,5
2018,Burundi,BDI,Egypt,EGY,5,0,0,0,5
2018,Central African Rep.,CAF,Egypt,EGY,5,0,0,0,5
2018,Chad,TCD,Egypt,EGY,5,0,10,11,26
2018,Cameroon,CMR,Egypt,EGY,0,0,10,0,10
2018,Dem. Rep. of the Congo,COD,Egypt,EGY,5,0,0,0,5
2018,Eritrea,ERI,Egypt,EGY,1941,60,10,187,2198
2018,Ethiopia,ETH,Egypt,EGY,1215,33,941,253,2442
2018,Guinea,GIN,Egypt,EGY,0,0,17,18,35
2018,Iraq,IRQ,Egypt,EGY,328,26,5,83,442
2018,Jordan,JOR,Egypt,EGY,5,0,0,0,5
2018,Liberia,LBR,Egypt,EGY,0,0,5,0,5
2018,Libya,LBY,Egypt,EGY,5,0,0,0,5
2018,Niger,NER,Egypt,EGY,0,0,5,0,5
2018,Nigeria,NGA,Egypt,EGY,0,5,57,0,62
2018,Russian Federation,RUS,Egypt,EGY,0,0,5,0,5
2018,Sierra Leone,SLE,Egypt,EGY,0,0,5,0,5
2018,Somalia,SOM,Egypt,EGY,521,17,53,146,737
2018,Sudan,SDN,Egypt,EGY,2013,99,865,980,3957
2018,South Sudan,SSD,Egypt,EGY,2212,54,5,143,2414
2018,Turkey,TUR,Egypt,EGY,0,0,0,26,26
2018,Uganda,UGA,Egypt,EGY,0,0,10,5,15
2018,Uzbekistan,UZB,Egypt,EGY,0,0,0,10,10
2018,Yemen,YEM,Egypt,EGY,19,0,0,319,338
2018,Zimbabwe,ZWE,Egypt,EGY,5,0,0,5,10
2018,Afghanistan,AFG,Azerbaijan,AZE,34,0,0,0,34
2018,Iraq,IRQ,Bahrain,BHR,10,0,0,40,50
2018,Jordan,JOR,Bahrain,BHR,0,0,0,5,5
2018,Turkey,TUR,Bahrain,BHR,0,0,0,5,5
2018,Turkey,TUR,Bangladesh,BGD,0,0,0,101,101
2018,Afghanistan,AFG,China,CHN,0,0,0,5,5
2018,Burundi,BDI,China,CHN,0,0,0,5,5
2018,Cameroon,CMR,China,CHN,0,0,24,27,51
2018,Dem. Rep. of the Congo,COD,China,CHN,0,0,0,5,5
2018,Palestinian,PSE,China,CHN,5,0,0,10,15
2018,Ghana,GHA,China,CHN,0,0,5,5,10
2018,Guinea,GIN,China,CHN,0,0,0,5,5
2018,Cote d'Ivoire,CIV,China,CHN,0,0,0,5,5
2018,Iraq,IRQ,China,CHN,5,0,0,5,10
2018,Kenya,KEN,China,CHN,0,0,19,5,24
2018,Liberia,LBR,China,CHN,0,0,10,56,66
2018,Mozambique,MOZ,China,CHN,0,0,0,12,12
2018,Nigeria,NGA,China,CHN,0,0,5,17,22
2018,Sierra Leone,SLE,China,CHN,0,0,5,10,15
2018,Somalia,SOM,China,CHN,10,0,0,0,10
2018,Syrian Arab Rep.,SYR,China,CHN,10,0,0,12,22
2018,Turkey,TUR,China,CHN,0,0,0,5,5
2018,Uganda,UGA,China,CHN,0,0,5,10,15
2018,Yemen,YEM,China,CHN,5,0,0,10,15
2018,Zimbabwe,ZWE,China,CHN,0,0,11,36,47
2018,Burundi,BDI,Cameroon,CMR,5,0,0,0,5
2018,Central African Rep.,CAF,Cameroon,CMR,2322,0,74,15,2411
2018,Chad,TCD,Cameroon,CMR,29,0,41,0,70
2018,Congo,COG,Cameroon,CMR,0,0,5,0,5
2018,Dem. Rep. of the Congo,COD,Cameroon,CMR,10,0,16,0,26
2018,Guinea,GIN,Cameroon,CMR,0,0,17,0,17
2018,Cote d'Ivoire,CIV,Cameroon,CMR,0,0,10,0,10
2018,Mali,MLI,Cameroon,CMR,0,0,5,0,5
2018,Nigeria,NGA,Cameroon,CMR,5,0,0,0,5
2018,Rwanda,RWA,Cameroon,CMR,10,0,14,0,24
2018,Senegal,SEN,Cameroon,CMR,0,0,5,0,5
2018,Sudan,SDN,Cameroon,CMR,15,0,0,0,15
2018,Syrian Arab Rep.,SYR,Cameroon,CMR,5,0,0,0,5
2018,Ethiopia,ETH,Cuba,CUB,0,0,5,0,5
2018,Iran (Islamic Rep. of),IRN,Cuba,CUB,0,0,5,0,5
2018,Colombia,COL,Dominican Rep.,DOM,0,0,0,10,10
2018,Cuba,CUB,Dominican Rep.,DOM,0,0,0,13,13
2018,Haiti,HTI,Dominican Rep.,DOM,0,0,0,509,509
2018,Syrian Arab Rep.,SYR,Dominican Rep.,DOM,0,0,0,5,5
2018,Turkey,TUR,Dominican Rep.,DOM,0,0,0,5,5
2018,Cuba,CUB,Guyana,GUY,5,0,0,0,5
2018,Afghanistan,AFG,India,IND,425,0,900,1742,3067
2018,Cameroon,CMR,India,IND,0,0,5,5,10
2018,Congo,COG,India,IND,5,0,0,5,10
2018,Dem. Rep. of the Congo,COD,India,IND,0,0,10,10,20
2018,Eritrea,ERI,India,IND,0,0,0,5,5
2018,Ethiopia,ETH,India,IND,0,0,5,5,10
2018,Palestinian,PSE,India,IND,0,0,0,5,5
2018,Cote d'Ivoire,CIV,India,IND,0,0,0,5,5
2018,Iran (Islamic Rep. of),IRN,India,IND,0,0,0,5,5
2018,Iraq,IRQ,India,IND,11,0,0,49,60
2018,Myanmar,MMR,India,IND,1217,0,46,1768,3031
2018,Nigeria,NGA,India,IND,0,0,0,5,5
2018,Somalia,SOM,India,IND,15,0,69,83,167
2018,Sudan,SDN,India,IND,5,0,0,16,21
2018,Syrian Arab Rep.,SYR,India,IND,5,0,0,10,15
2018,Ukraine,UKR,India,IND,0,0,0,5,5
2018,Yemen,YEM,India,IND,0,0,0,36,36
2018,Afghanistan,AFG,Indonesia,IDN,873,0,0,59,932
2018,Algeria,DZA,Indonesia,IDN,0,0,5,5,10
2018,Egypt,EGY,Indonesia,IDN,0,0,5,5,10
2018,Bangladesh,BGD,Indonesia,IDN,0,0,10,5,15
2018,China,CHN,Indonesia,IDN,5,0,0,0,5
2018,Cameroon,CMR,Indonesia,IDN,0,0,29,22,51
2018,Dem. Rep. of the Congo,COD,Indonesia,IDN,0,0,10,5,15
2018,Eritrea,ERI,Indonesia,IDN,5,0,0,0,5
2018,Ethiopia,ETH,Indonesia,IDN,17,0,17,0,34
2018,Palestinian,PSE,Indonesia,IDN,10,0,0,11,21
2018,Ghana,GHA,Indonesia,IDN,0,0,5,0,5
2018,Cote d'Ivoire,CIV,Indonesia,IDN,0,0,10,5,15
2018,India,IND,Indonesia,IDN,0,0,5,5,10
2018,Iran (Islamic Rep. of),IRN,Indonesia,IDN,45,0,38,0,83
2018,Iraq,IRQ,Indonesia,IDN,74,0,0,70,144
2018,Libya,LBY,Indonesia,IDN,5,0,0,0,5
2018,Sri Lanka,LKA,Indonesia,IDN,43,0,43,35,121
2018,Myanmar,MMR,Indonesia,IDN,29,0,0,34,63
2018,Nigeria,NGA,Indonesia,IDN,0,0,5,0,5
2018,Pakistan,PAK,Indonesia,IDN,19,0,5,0,24
2018,Russian Federation,RUS,Indonesia,IDN,5,0,0,0,5
2018,Senegal,SEN,Indonesia,IDN,0,0,5,0,5
2018,Sierra Leone,SLE,Indonesia,IDN,0,0,0,5,5
2018,Somalia,SOM,Indonesia,IDN,171,0,5,57,233
2018,Sudan,SDN,Indonesia,IDN,112,0,5,11,128
2018,Syrian Arab Rep.,SYR,Indonesia,IDN,0,0,0,14,14
2018,Turkey,TUR,Indonesia,IDN,0,0,0,25,25
2018,Yemen,YEM,Indonesia,IDN,34,0,0,18,52
2018,Myanmar,MMR,Iran (Islamic Rep. of),IRN,0,0,0,49,49
2018,Afghanistan,AFG,Iraq,IRQ,0,0,0,40,40
2018,Bahrain,BHR,Iraq,IRQ,0,0,0,19,19
2018,Palestinian,PSE,Iraq,IRQ,0,0,0,5,5
2018,Iran (Islamic Rep. of),IRN,Iraq,IRQ,5,0,0,160,165
2018,Morocco,MAR,Iraq,IRQ,0,0,0,5,5
2018,Pakistan,PAK,Iraq,IRQ,0,0,0,19,19
2018,Saudi Arabia,SAU,Iraq,IRQ,0,0,0,5,5
2018,Somalia,SOM,Iraq,IRQ,5,0,0,0,5
2018,Sudan,SDN,Iraq,IRQ,22,0,15,68,105
2018,Turkey,TUR,Iraq,IRQ,0,0,0,173,173
2018,Yemen,YEM,Iraq,IRQ,0,0,0,5,5
2018,Egypt,EGY,Jordan,JOR,14,0,10,0,24
2018,Eritrea,ERI,Jordan,JOR,5,0,0,0,5
2018,Iraq,IRQ,Jordan,JOR,1198,0,0,13,1211
2018,Kenya,KEN,Jordan,JOR,0,0,5,0,5
2018,Libya,LBY,Jordan,JOR,5,0,0,5,10
2018,Lebanon,LBN,Jordan,JOR,5,0,5,0,10
2018,Somalia,SOM,Jordan,JOR,55,0,0,0,55
2018,Sudan,SDN,Jordan,JOR,182,0,63,0,245
2018,Yemen,YEM,Jordan,JOR,141,0,0,5,146
2018,Uzbekistan,UZB,Kyrgyzstan,KGZ,0,0,0,5,5
2018,Iraq,IRQ,Kuwait,KWT,23,0,0,0,23
2018,Somalia,SOM,Kuwait,KWT,0,0,0,5,5
2018,Syrian Arab Rep.,SYR,Kuwait,KWT,29,0,0,0,29
2018,Egypt,EGY,Libya,LBY,0,0,0,21,21
2018,Chad,TCD,Libya,LBY,0,0,0,18,18
2018,Cameroon,CMR,Libya,LBY,0,0,0,5,5
2018,Dem. Rep. of the Congo,COD,Libya,LBY,5,0,0,10,15
2018,Eritrea,ERI,Libya,LBY,110,0,0,2009,2119
2018,Ethiopia,ETH,Libya,LBY,14,0,5,221,240
2018,Palestinian,PSE,Libya,LBY,5,0,0,0,5
2018,Iraq,IRQ,Libya,LBY,15,0,0,517,532
2018,Liberia,LBR,Libya,LBY,0,0,0,10,10
2018,Nigeria,NGA,Libya,LBY,0,0,0,5,5
2018,Somalia,SOM,Libya,LBY,18,0,0,490,508
2018,Sudan,SDN,Libya,LBY,373,0,10,146,529
2018,South Sudan,SSD,Libya,LBY,0,0,0,5,5
2018,Syrian Arab Rep.,SYR,Libya,LBY,412,0,0,55,467
2018,Yemen,YEM,Libya,LBY,0,0,0,24,24
2018,Algeria,DZA,Lebanon,LBN,0,0,0,5,5
2018,Egypt,EGY,Lebanon,LBN,13,0,5,18,36
2018,Bangladesh,BGD,Lebanon,LBN,0,0,10,5,15
2018,Cameroon,CMR,Lebanon,LBN,0,0,10,0,10
2018,Eritrea,ERI,Lebanon,LBN,0,0,0,5,5
2018,Ethiopia,ETH,Lebanon,LBN,21,0,147,68,236
2018,Ghana,GHA,Lebanon,LBN,0,0,5,0,5
2018,Iraq,IRQ,Lebanon,LBN,396,0,41,12,449
2018,Jordan,JOR,Lebanon,LBN,5,0,0,0,5
2018,Kenya,KEN,Lebanon,LBN,0,0,5,5,10
2018,Nigeria,NGA,Lebanon,LBN,0,0,5,5,10
2018,Pakistan,PAK,Lebanon,LBN,5,0,0,0,5
2018,Philippines,PHL,Lebanon,LBN,0,0,20,10,30
2018,Saudi Arabia,SAU,Lebanon,LBN,5,0,0,5,10
2018,Sudan,SDN,Lebanon,LBN,50,0,131,92,273
2018,Syrian Arab Rep.,SYR,Lebanon,LBN,0,0,0,5,5
2018,Yemen,YEM,Lebanon,LBN,10,0,0,0,10
2018,Afghanistan,AFG,Sri Lanka,LKA,44,0,0,5,49
2018,Iran (Islamic Rep. of),IRN,Sri Lanka,LKA,11,0,5,0,16
2018,Maldives,MDV,Sri Lanka,LKA,0,0,0,5,5
2018,Nepal,NPL,Sri Lanka,LKA,0,0,0,5,5
2018,Nigeria,NGA,Sri Lanka,LKA,0,0,0,5,5
2018,Pakistan,PAK,Sri Lanka,LKA,204,0,10,12,226
2018,Yemen,YEM,Sri Lanka,LKA,0,0,0,5,5
2018,Algeria,DZA,Mauritania,MRT,0,0,0,10,10
2018,Egypt,EGY,Mauritania,MRT,0,0,0,5,5
2018,Benin,BEN,Mauritania,MRT,0,0,5,0,5
2018,Central African Rep.,CAF,Mauritania,MRT,68,0,0,10,78
2018,Cameroon,CMR,Mauritania,MRT,0,0,5,31,36
2018,Dem. Rep. of the Congo,COD,Mauritania,MRT,5,0,0,11,16
2018,Gambia,GMB,Mauritania,MRT,0,0,5,0,5
2018,Palestinian,PSE,Mauritania,MRT,0,0,0,11,11
2018,Guinea-Bissau,GNB,Mauritania,MRT,0,0,5,0,5
2018,Guinea,GIN,Mauritania,MRT,0,0,18,0,18
2018,Cote d'Ivoire,CIV,Mauritania,MRT,16,0,18,10,44
2018,Libya,LBY,Mauritania,MRT,0,0,0,5,5
2018,Lebanon,LBN,Mauritania,MRT,5,0,0,0,5
2018,Mali,MLI,Mauritania,MRT,0,0,10,14,24
2018,Morocco,MAR,Mauritania,MRT,0,0,0,5,5
2018,Nigeria,NGA,Mauritania,MRT,0,0,10,34,44
2018,Senegal,SEN,Mauritania,MRT,10,0,5,20,35
2018,Sierra Leone,SLE,Mauritania,MRT,0,0,27,10,37
2018,Somalia,SOM,Mauritania,MRT,0,0,0,5,5
2018,Sudan,SDN,Mauritania,MRT,0,0,0,11,11
2018,South Sudan,SSD,Mauritania,MRT,5,0,0,0,5
2018,Syrian Arab Rep.,SYR,Mauritania,MRT,30,0,0,73,103
2018,Togo,TGO,Mauritania,MRT,5,0,0,0,5
2018,Turkey,TUR,Mauritania,MRT,0,0,0,47,47
2018,Afghanistan,AFG,Malaysia,MYS,267,0,85,67,419
2018,Egypt,EGY,Malaysia,MYS,5,0,0,0,5
2018,Austria,AUT,Malaysia,MYS,0,0,0,5,5
2018,Bangladesh,BGD,Malaysia,MYS,0,0,5,10,15
2018,Cambodia,KHM,Malaysia,MYS,0,0,0,5,5
2018,Central African Rep.,CAF,Malaysia,MYS,0,0,5,0,5
2018,China,CHN,Malaysia,MYS,5,0,0,0,5
2018,Dem. Rep. of the Congo,COD,Malaysia,MYS,0,0,5,0,5
2018,Palestinian,PSE,Malaysia,MYS,21,0,0,22,43
2018,Indonesia,IDN,Malaysia,MYS,5,0,5,65,75
2018,Iran (Islamic Rep. of),IRN,Malaysia,MYS,30,0,23,5,58
2018,Iraq,IRQ,Malaysia,MYS,31,0,0,44,75
2018,Liberia,LBR,Malaysia,MYS,0,0,5,5,10
2018,Lebanon,LBN,Malaysia,MYS,0,0,5,0,5
2018,Sri Lanka,LKA,Malaysia,MYS,14,0,146,115,275
2018,Mali,MLI,Malaysia,MYS,0,0,5,0,5
2018,Myanmar,MMR,Malaysia,MYS,19592,0,5429,3129,28150
2018,Pakistan,PAK,Malaysia,MYS,624,0,232,128,984
2018,Sierra Leone,SLE,Malaysia,MYS,0,0,5,0,5
2018,Somalia,SOM,Malaysia,MYS,275,0,109,144,528
2018,Sudan,SDN,Malaysia,MYS,16,0,40,0,56
2018,Syrian Arab Rep.,SYR,Malaysia,MYS,56,0,0,95,151
2018,Thailand,THA,Malaysia,MYS,0,0,0,5,5
2018,Togo,TGO,Malaysia,MYS,0,0,5,0,5
2018,Uganda,UGA,Malaysia,MYS,0,0,5,0,5
2018,Yemen,YEM,Malaysia,MYS,93,0,0,100,193
2018,Algeria,DZA,Morocco,MAR,5,0,0,0,5
2018,Benin,BEN,Morocco,MAR,0,0,0,5,5
2018,Burkina Faso,BFA,Morocco,MAR,0,0,5,12,17
2018,Central African Rep.,CAF,Morocco,MAR,173,0,13,24,210
2018,Chad,TCD,Morocco,MAR,0,0,0,5,5
2018,China,CHN,Morocco,MAR,0,0,0,5,5
2018,Cameroon,CMR,Morocco,MAR,33,0,117,592,742
2018,Congo,COG,Morocco,MAR,0,0,28,20,48
2018,Dem. Rep. of the Congo,COD,Morocco,MAR,12,0,74,55,141
2018,Eritrea,ERI,Morocco,MAR,10,0,0,0,10
2018,Gambia,GMB,Morocco,MAR,0,0,5,5,10
2018,Palestinian,PSE,Morocco,MAR,14,0,0,23,37
2018,Guinea-Bissau,GNB,Morocco,MAR,0,0,0,10,10
2018,Guinea,GIN,Morocco,MAR,15,0,216,484,715
2018,Cote d'Ivoire,CIV,Morocco,MAR,20,0,116,177,313
2018,Iraq,IRQ,Morocco,MAR,10,0,0,5,15
2018,Liberia,LBR,Morocco,MAR,0,0,10,24,34
2018,Libya,LBY,Morocco,MAR,5,0,0,5,10
2018,Lebanon,LBN,Morocco,MAR,0,0,0,10,10
2018,Mauritania,MRT,Morocco,MAR,5,0,0,5,10
2018,Mali,MLI,Morocco,MAR,5,0,35,68,108
2018,Niger,NER,Morocco,MAR,0,0,0,5,5
2018,Nigeria,NGA,Morocco,MAR,0,0,43,39,82
2018,Pakistan,PAK,Morocco,MAR,5,0,0,0,5
2018,Senegal,SEN,Morocco,MAR,29,0,28,63,120
2018,Sierra Leone,SLE,Morocco,MAR,0,0,10,37,47
2018,Somalia,SOM,Morocco,MAR,5,0,0,0,5
2018,Sudan,SDN,Morocco,MAR,5,0,0,0,5
2018,South Sudan,SSD,Morocco,MAR,24,0,0,134,158
2018,Syrian Arab Rep.,SYR,Morocco,MAR,5,0,0,791,796
2018,Togo,TGO,Morocco,MAR,0,0,10,0,10
2018,Turkey,TUR,Morocco,MAR,0,0,0,32,32
2018,Yemen,YEM,Morocco,MAR,11,0,0,251,262
2018,Dem. Rep. of the Congo,COD,Mauritius,MUS,11,0,0,0,11
2018,Sri Lanka,LKA,Nepal,NPL,0,0,0,5,5
2018,Myanmar,MMR,Nepal,NPL,143,0,5,5,153
2018,Pakistan,PAK,Nepal,NPL,5,0,10,0,15
2018,Somalia,SOM,Nepal,NPL,5,0,0,0,5
2018,Iraq,IRQ,Oman,OMN,0,0,0,156,156
2018,Sudan,SDN,Oman,OMN,0,0,0,5,5
2018,Syrian Arab Rep.,SYR,Oman,OMN,0,0,0,5,5
2018,Afghanistan,AFG,Pakistan,PAK,0,0,0,64,64
2018,Turkey,TUR,Pakistan,PAK,0,0,0,173,173
2018,Yemen,YEM,Pakistan,PAK,16,0,0,0,16
2018,Cuba,CUB,Paraguay,PRY,5,0,5,0,10
2018,El Salvador,SLV,Paraguay,PRY,5,0,0,0,5
2018,Syrian Arab Rep.,SYR,Paraguay,PRY,10,0,0,0,10
2018,Venezuela (Bolivarian Republic of),VEN,Paraguay,PRY,29,0,0,5,34
2018,Iraq,IRQ,Qatar,QAT,0,0,0,41,41
2018,Iraq,IRQ,Saudi Arabia,SAU,5,0,0,0,5
2018,Syrian Arab Rep.,SYR,Saudi Arabia,SAU,89,0,0,78,167
2018,Yemen,YEM,Saudi Arabia,SAU,19,0,0,0,19
2018,Dem. Rep. of the Congo,COD,Somalia,SOM,0,0,0,5,5
2018,Ethiopia,ETH,Somalia,SOM,442,0,0,13,455
2018,Yemen,YEM,Somalia,SOM,17,0,0,0,17
2018,Dem. Rep. of the Congo,COD,Sudan,SDN,0,0,0,403,403
2018,Eritrea,ERI,Sudan,SDN,0,0,0,386,386
2018,Ethiopia,ETH,Sudan,SDN,0,0,0,8544,8544
2018,Somalia,SOM,Sudan,SDN,0,0,0,55,55
2018,Syrian Arab Rep.,SYR,Sudan,SDN,0,0,0,251,251
2018,Yemen,YEM,Sudan,SDN,0,0,0,325,325
2018,Unknown ,,Sudan,SDN,0,0,0,13,13
2018,Cuba,CUB,Suriname,SUR,5,0,12,31,48
2018,Venezuela (Bolivarian Republic of),VEN,Suriname,SUR,5,0,0,0,5
2018,Afghanistan,AFG,Syrian Arab Rep.,SYR,13,0,0,5,18
2018,Egypt,EGY,Syrian Arab Rep.,SYR,0,0,10,10,20
2018,Burkina Faso,BFA,Syrian Arab Rep.,SYR,0,0,5,0,5
2018,Iran (Islamic Rep. of),IRN,Syrian Arab Rep.,SYR,0,0,10,13,23
2018,Iraq,IRQ,Syrian Arab Rep.,SYR,210,0,30,3611,3851
2018,Jordan,JOR,Syrian Arab Rep.,SYR,0,0,0,13,13
2018,Pakistan,PAK,Syrian Arab Rep.,SYR,5,0,5,0,10
2018,Sudan,SDN,Syrian Arab Rep.,SYR,0,0,12,5,17
2018,Tunisia,TUN,Syrian Arab Rep.,SYR,0,0,5,0,5
2018,Yemen,YEM,Syrian Arab Rep.,SYR,26,0,0,24,50
2018,Afghanistan,AFG,Thailand,THA,49,0,0,0,49
2018,Egypt,EGY,Thailand,THA,0,0,10,5,15
2018,Bangladesh,BGD,Thailand,THA,0,0,0,5,5
2018,Cambodia,KHM,Thailand,THA,47,0,124,103,274
2018,China,CHN,Thailand,THA,21,0,10,10,41
2018,Cameroon,CMR,Thailand,THA,0,0,5,0,5
2018,Dem. Rep. of the Congo,COD,Thailand,THA,0,0,0,5,5
2018,Ethiopia,ETH,Thailand,THA,5,0,5,5,15
2018,Palestinian,PSE,Thailand,THA,10,0,0,5,15
2018,Iran (Islamic Rep. of),IRN,Thailand,THA,13,0,13,29,55
2018,Iraq,IRQ,Thailand,THA,5,0,0,42,47
2018,Lao People's Dem. Rep.,LAO,Thailand,THA,0,0,5,5,10
2018,Sri Lanka,LKA,Thailand,THA,0,0,5,18,23
2018,Malaysia,MYS,Thailand,THA,0,0,0,5,5
2018,Myanmar,MMR,Thailand,THA,0,0,0,254,254
2018,Nigeria,NGA,Thailand,THA,0,0,0,5,5
2018,Pakistan,PAK,Thailand,THA,96,0,40,140,276
2018,Russian Federation,RUS,Thailand,THA,0,0,5,5,10
2018,Somalia,SOM,Thailand,THA,30,0,46,41,117
2018,Viet Nam,VNM,Thailand,THA,220,0,137,78,435
2018,Syrian Arab Rep.,SYR,Thailand,THA,10,0,0,5,15
2018,Yemen,YEM,Thailand,THA,5,0,0,0,5
2018,Bangladesh,BGD,Trinidad and Tobago,TTO,0,0,0,5,5
2018,Cuba,CUB,Trinidad and Tobago,TTO,56,0,11,35,102
2018,Jamaica,JAM,Trinidad and Tobago,TTO,10,0,0,13,23
2018,Syrian Arab Rep.,SYR,Trinidad and Tobago,TTO,10,0,0,5,15
2018,Venezuela (Bolivarian Republic of),VEN,Trinidad and Tobago,TTO,464,0,0,58,522
2018,Central African Rep.,CAF,Tunisia,TUN,5,0,0,0,5
2018,Cameroon,CMR,Tunisia,TUN,5,0,0,5,10
2018,Dem. Rep. of the Congo,COD,Tunisia,TUN,0,0,0,5,5
2018,Palestinian,PSE,Tunisia,TUN,5,0,0,0,5
2018,Guinea,GIN,Tunisia,TUN,0,0,0,5,5
2018,Cote d'Ivoire,CIV,Tunisia,TUN,0,0,0,5,5
2018,Iraq,IRQ,Tunisia,TUN,5,0,0,0,5
2018,Lebanon,LBN,Tunisia,TUN,5,0,0,0,5
2018,Nigeria,NGA,Tunisia,TUN,0,0,0,5,5
2018,Senegal,SEN,Tunisia,TUN,0,0,0,5,5
2018,Yemen,YEM,Tunisia,TUN,0,0,0,5,5
2018,Afghanistan,AFG,Turkey,TUR,1155,0,0,44773,45928
2018,Algeria,DZA,Turkey,TUR,0,0,0,5,5
2018,Egypt,EGY,Turkey,TUR,10,0,0,21,31
2018,Burundi,BDI,Turkey,TUR,0,0,0,5,5
2018,Bangladesh,BGD,Turkey,TUR,0,0,0,43,43
2018,Central African Rep.,CAF,Turkey,TUR,0,0,0,5,5
2018,China,CHN,Turkey,TUR,0,0,0,5,5
2018,Cameroon,CMR,Turkey,TUR,0,0,0,25,25
2018,Congo,COG,Turkey,TUR,0,0,0,30,30
2018,Dem. Rep. of the Congo,COD,Turkey,TUR,0,0,0,44,44
2018,Eritrea,ERI,Turkey,TUR,0,0,0,10,10
2018,Ethiopia,ETH,Turkey,TUR,0,0,0,54,54
2018,Palestinian,PSE,Turkey,TUR,103,0,0,138,241
2018,Ghana,GHA,Turkey,TUR,0,0,0,5,5
2018,Cote d'Ivoire,CIV,Turkey,TUR,0,0,0,5,5
2018,Iran (Islamic Rep. of),IRN,Turkey,TUR,640,0,359,819,1818
2018,Iraq,IRQ,Turkey,TUR,2918,0,0,29056,31974
2018,Jordan,JOR,Turkey,TUR,5,0,0,13,18
2018,Kazakhstan,KAZ,Turkey,TUR,0,0,0,21,21
2018,Kyrgyzstan,KGZ,Turkey,TUR,0,0,0,21,21
2018,Libya,LBY,Turkey,TUR,5,0,0,15,20
2018,Lebanon,LBN,Turkey,TUR,0,0,0,5,5
2018,Mali,MLI,Turkey,TUR,0,0,0,5,5
2018,Mongolia,MNG,Turkey,TUR,0,0,0,10,10
2018,Morocco,MAR,Turkey,TUR,0,0,0,19,19
2018,Nigeria,NGA,Turkey,TUR,0,0,0,21,21
2018,Pakistan,PAK,Turkey,TUR,5,0,5,41,51
2018,Rwanda,RWA,Turkey,TUR,0,0,0,5,5
2018,Senegal,SEN,Turkey,TUR,0,0,0,5,5
2018,Sierra Leone,SLE,Turkey,TUR,0,0,0,10,10
2018,Somalia,SOM,Turkey,TUR,32,0,0,345,377
2018,Sudan,SDN,Turkey,TUR,5,0,5,28,38
2018,Syrian Arab Rep.,SYR,Turkey,TUR,0,0,0,54,54
2018,Tajikistan,TJK,Turkey,TUR,0,0,0,51,51
2018,Turkmenistan,TKM,Turkey,TUR,0,0,0,62,62
2018,Tunisia,TUN,Turkey,TUR,0,0,0,5,5
2018,Uganda,UGA,Turkey,TUR,0,0,0,97,97
2018,Uzbekistan,UZB,Turkey,TUR,0,0,0,50,50
2018,Yemen,YEM,Turkey,TUR,15,0,0,50,65
2018,Zimbabwe,ZWE,Turkey,TUR,5,0,0,0,5
2018,Stateless,XXA,Turkey,TUR,0,0,0,11,11
2018,Eritrea,ERI,United Arab Emirates,ARE,5,0,0,0,5
2018,Ethiopia,ETH,United Arab Emirates,ARE,5,0,0,0,5
2018,Palestinian,PSE,United Arab Emirates,ARE,5,0,0,131,136
2018,Iran (Islamic Rep. of),IRN,United Arab Emirates,ARE,5,0,0,0,5
2018,Iraq,IRQ,United Arab Emirates,ARE,85,0,0,0,85
2018,Jordan,JOR,United Arab Emirates,ARE,5,0,0,0,5
2018,Kuwait,KWT,United Arab Emirates,ARE,5,0,0,0,5
2018,Liberia,LBR,United Arab Emirates,ARE,0,0,0,5,5
2018,Lebanon,LBN,United Arab Emirates,ARE,11,0,0,0,11
2018,Pakistan,PAK,United Arab Emirates,ARE,5,0,0,0,5
2018,Somalia,SOM,United Arab Emirates,ARE,5,0,0,0,5
2018,Syrian Arab Rep.,SYR,United Arab Emirates,ARE,170,0,0,2418,2588
2018,Yemen,YEM,United Arab Emirates,ARE,5,0,0,0,5
2018,Somalia,SOM,Ukraine,UKR,5,0,0,0,5
2018,Tajikistan,TJK,Ukraine,UKR,5,0,0,0,5
2018,Colombia,COL,Curacao ,CUW,5,0,0,0,5
2018,Venezuela (Bolivarian Republic of),VEN,Curacao ,CUW,5,0,0,0,5
2019,Tajikistan,TJK,Afghanistan,AFG,0,0,0,5,5
2019,Turkey,TUR,Afghanistan,AFG,0,0,0,60,60
2019,Benin,BEN,Algeria,DZA,0,0,5,5,10
2019,Central African Rep.,CAF,Algeria,DZA,25,0,0,5,30
2019,Chad,TCD,Algeria,DZA,0,0,5,5,10
2019,Cameroon,CMR,Algeria,DZA,47,0,56,40,143
2019,Dem. Rep. of the Congo,COD,Algeria,DZA,24,0,35,20,79
2019,Palestinian,PSE,Algeria,DZA,0,0,0,169,169
2019,Guinea,GIN,Algeria,DZA,21,0,67,91,179
2019,Cote d'Ivoire,CIV,Algeria,DZA,17,0,62,52,131
2019,Liberia,LBR,Algeria,DZA,0,0,5,10,15
2019,Mali,MLI,Algeria,DZA,32,0,51,79,162
2019,Niger,NER,Algeria,DZA,5,0,5,10,20
2019,Nigeria,NGA,Algeria,DZA,0,0,20,59,79
2019,Somalia,SOM,Algeria,DZA,0,0,0,5,5
2019,Sudan,SDN,Algeria,DZA,5,0,0,5,10
2019,Syrian Arab Rep.,SYR,Algeria,DZA,15,0,0,8388,8403
2019,Togo,TGO,Algeria,DZA,0,0,5,0,5
2019,Yemen,YEM,Algeria,DZA,0,0,0,271,271
2019,Afghanistan,AFG,Egypt,EGY,5,0,0,5,10
2019,Burundi,BDI,Egypt,EGY,24,0,0,5,29
2019,Benin,BEN,Egypt,EGY,0,0,0,5,5
2019,Bangladesh,BGD,Egypt,EGY,0,0,0,5,5
2019,Central African Rep.,CAF,Egypt,EGY,15,0,0,5,20
2019,Chad,TCD,Egypt,EGY,0,0,0,5,5
2019,China,CHN,Egypt,EGY,0,0,0,5,5
2019,Cameroon,CMR,Egypt,EGY,10,0,5,0,15
2019,Congo,COG,Egypt,EGY,10,0,0,5,15
2019,Dem. Rep. of the Congo,COD,Egypt,EGY,10,0,5,5,20
2019,Djibouti,DJI,Egypt,EGY,10,0,5,0,15
2019,Eritrea,ERI,Egypt,EGY,4777,0,10,412,5199
2019,Ethiopia,ETH,Egypt,EGY,844,0,644,1838,3326
2019,Ghana,GHA,Egypt,EGY,0,0,0,5,5
2019,Guinea,GIN,Egypt,EGY,5,0,14,0,19
2019,Iraq,IRQ,Egypt,EGY,363,0,10,459,832
2019,Jordan,JOR,Egypt,EGY,5,0,0,0,5
2019,Liberia,LBR,Egypt,EGY,0,0,5,5,10
2019,Niger,NER,Egypt,EGY,0,0,0,5,5
2019,Nigeria,NGA,Egypt,EGY,5,0,86,216,307
2019,Russian Federation,RUS,Egypt,EGY,0,0,0,20,20
2019,Rwanda,RWA,Egypt,EGY,5,0,0,0,5
2019,Saudi Arabia,SAU,Egypt,EGY,5,0,0,0,5
2019,Sierra Leone,SLE,Egypt,EGY,0,0,5,5,10
2019,Somalia,SOM,Egypt,EGY,643,0,75,847,1565
2019,Sudan,SDN,Egypt,EGY,2576,0,688,2444,5708
2019,South Sudan,SSD,Egypt,EGY,6961,0,0,291,7252
2019,Tajikistan,TJK,Egypt,EGY,0,0,16,0,16
2019,Turkey,TUR,Egypt,EGY,0,0,0,33,33
2019,Uganda,UGA,Egypt,EGY,0,0,5,0,5
2019,Uzbekistan,UZB,Egypt,EGY,0,0,0,17,17
2019,Yemen,YEM,Egypt,EGY,26,0,0,1111,1137
2019,Zimbabwe,ZWE,Egypt,EGY,10,0,21,0,31
2019,Afghanistan,AFG,Azerbaijan,AZE,12,0,0,0,12
2019,Russian Federation,RUS,Azerbaijan,AZE,0,0,0,5,5
2019,Syrian Arab Rep.,SYR,Azerbaijan,AZE,5,0,0,0,5
2019,Turkey,TUR,Azerbaijan,AZE,5,0,0,0,5
2019,Yemen,YEM,Azerbaijan,AZE,5,0,0,0,5
2019,Somalia,SOM,Bangladesh,BGD,5,0,0,0,5
2019,Turkey,TUR,Bangladesh,BGD,0,0,0,5,5
2019,Yemen,YEM,Bangladesh,BGD,5,0,0,0,5
2019,Cuba,CUB,Bahamas,BHS,0,0,0,5,5
2019,Haiti,HTI,Bahamas,BHS,0,0,0,5,5
2019,Dem. Rep. of the Congo,COD,Botswana,BWA,21,0,0,0,21
2019,Afghanistan,AFG,China,CHN,12,0,0,0,12
2019,Burundi,BDI,China,CHN,5,0,0,0,5
2019,Cameroon,CMR,China,CHN,0,0,5,30,35
2019,Dem. Rep. of the Congo,COD,China,CHN,5,0,0,10,15
2019,Ghana,GHA,China,CHN,0,0,5,0,5
2019,Iraq,IRQ,China,CHN,5,0,0,5,10
2019,Kenya,KEN,China,CHN,0,0,25,40,65
2019,Liberia,LBR,China,CHN,0,0,0,5,5
2019,Mozambique,MOZ,China,CHN,0,0,0,5,5
2019,Nigeria,NGA,China,CHN,0,0,0,10,10
2019,Pakistan,PAK,China,CHN,5,0,0,0,5
2019,Somalia,SOM,China,CHN,10,0,0,0,10
2019,Syrian Arab Rep.,SYR,China,CHN,0,0,0,10,10
2019,Uganda,UGA,China,CHN,0,0,20,21,41
2019,Yemen,YEM,China,CHN,5,0,0,5,10
2019,Zimbabwe,ZWE,China,CHN,0,0,21,35,56
2019,Burkina Faso,BFA,Cameroon,CMR,0,0,5,0,5
2019,Central African Rep.,CAF,Cameroon,CMR,1522,0,56,170,1748
2019,Chad,TCD,Cameroon,CMR,16,0,43,5,64
2019,Dem. Rep. of the Congo,COD,Cameroon,CMR,0,0,15,0,15
2019,Guinea,GIN,Cameroon,CMR,0,0,17,0,17
2019,Mali,MLI,Cameroon,CMR,11,0,16,5,32
2019,Niger,NER,Cameroon,CMR,0,0,5,0,5
2019,Nigeria,NGA,Cameroon,CMR,5,0,0,0,5
2019,Rwanda,RWA,Cameroon,CMR,0,0,5,5,10
2019,Sudan,SDN,Cameroon,CMR,5,0,0,0,5
2019,Turkey,TUR,Cameroon,CMR,0,0,0,23,23
2019,Haiti,HTI,Cuba,CUB,5,0,0,0,5
2019,Iran (Islamic Rep. of),IRN,Cuba,CUB,0,0,21,0,21
2019,Syrian Arab Rep.,SYR,Cuba,CUB,5,0,0,0,5
2019,Venezuela (Bolivarian Republic of),VEN,Dominican Rep.,DOM,0,0,5,0,5
2019,Cuba,CUB,Guyana,GUY,0,0,5,0,5
2019,Afghanistan,AFG,India,IND,1265,0,808,1220,3293
2019,Cameroon,CMR,India,IND,0,0,5,17,22
2019,Dem. Rep. of the Congo,COD,India,IND,5,0,5,5,15
2019,Ethiopia,ETH,India,IND,0,0,0,10,10
2019,Cote d'Ivoire,CIV,India,IND,0,0,5,5,10
2019,Iran (Islamic Rep. of),IRN,India,IND,0,0,0,11,11
2019,Iraq,IRQ,India,IND,17,0,10,36,63
2019,Libya,LBY,India,IND,5,0,0,0,5
2019,Myanmar,MMR,India,IND,39,0,11,1851,1901
2019,Nigeria,NGA,India,IND,0,0,5,0,5
2019,Somalia,SOM,India,IND,21,0,36,90,147
2019,Sudan,SDN,India,IND,0,0,0,12,12
2019,Syrian Arab Rep.,SYR,India,IND,5,0,0,5,10
2019,Thailand,THA,India,IND,0,0,0,5,5
2019,Tajikistan,TJK,India,IND,0,0,0,5,5
2019,Turkey,TUR,India,IND,29,0,0,0,29
2019,Yemen,YEM,India,IND,0,0,0,468,468
2019,Stateless,XXA,India,IND,1705,0,0,0,1705
2019,Afghanistan,AFG,Indonesia,IDN,79,0,0,102,181
2019,Algeria,DZA,Indonesia,IDN,0,0,0,5,5
2019,Angola,AGO,Indonesia,IDN,5,0,0,0,5
2019,Egypt,EGY,Indonesia,IDN,5,0,5,0,10
2019,Bangladesh,BGD,Indonesia,IDN,0,0,5,0,5
2019,Cameroon,CMR,Indonesia,IDN,0,0,5,0,5
2019,Dem. Rep. of the Congo,COD,Indonesia,IDN,5,0,0,0,5
2019,Eritrea,ERI,Indonesia,IDN,22,0,0,15,37
2019,Ethiopia,ETH,Indonesia,IDN,5,0,10,0,15
2019,Palestinian,PSE,Indonesia,IDN,5,0,0,11,16
2019,Cote d'Ivoire,CIV,Indonesia,IDN,0,0,5,0,5
2019,Iran (Islamic Rep. of),IRN,Indonesia,IDN,10,0,10,5,25
2019,Iraq,IRQ,Indonesia,IDN,0,0,0,40,40
2019,Sri Lanka,LKA,Indonesia,IDN,5,0,24,95,124
2019,Myanmar,MMR,Indonesia,IDN,0,0,0,104,104
2019,Pakistan,PAK,Indonesia,IDN,5,0,0,5,10
2019,Somalia,SOM,Indonesia,IDN,35,0,0,65,100
2019,Sudan,SDN,Indonesia,IDN,5,0,10,21,36
2019,Turkey,TUR,Indonesia,IDN,0,0,0,31,31
2019,Yemen,YEM,Indonesia,IDN,5,0,0,48,53
2019,Afghanistan,AFG,Iraq,IRQ,0,0,0,10,10
2019,Palestinian,PSE,Iraq,IRQ,0,0,0,41,41
2019,Iran (Islamic Rep. of),IRN,Iraq,IRQ,5,0,0,1148,1153
2019,Kuwait,KWT,Iraq,IRQ,0,0,0,26,26
2019,Pakistan,PAK,Iraq,IRQ,0,0,0,5,5
2019,Sudan,SDN,Iraq,IRQ,0,0,0,147,147
2019,Turkey,TUR,Iraq,IRQ,5,0,0,731,736
2019,Yemen,YEM,Iraq,IRQ,0,0,0,5,5
2019,Egypt,EGY,Jordan,JOR,14,0,21,26,61
2019,Central African Rep.,CAF,Jordan,JOR,5,0,0,0,5
2019,Chad,TCD,Jordan,JOR,5,0,0,0,5
2019,Eritrea,ERI,Jordan,JOR,5,0,0,5,10
2019,Ethiopia,ETH,Jordan,JOR,5,0,5,5,15
2019,Iraq,IRQ,Jordan,JOR,315,0,5,169,489
2019,Libya,LBY,Jordan,JOR,0,0,0,18,18
2019,Lebanon,LBN,Jordan,JOR,0,0,0,5,5
2019,Morocco,MAR,Jordan,JOR,0,0,0,5,5
2019,Nigeria,NGA,Jordan,JOR,0,0,0,5,5
2019,Russian Federation,RUS,Jordan,JOR,0,0,0,5,5
2019,Somalia,SOM,Jordan,JOR,12,0,0,20,32
2019,Sudan,SDN,Jordan,JOR,335,0,65,94,494
2019,Suriname,SUR,Jordan,JOR,0,0,0,5,5
2019,Yemen,YEM,Jordan,JOR,62,0,0,30,92
2019,Stateless,XXA,Jordan,JOR,0,0,0,56,56
2019,Iraq,IRQ,Kuwait,KWT,12,0,0,0,12
2019,Dem. People's Rep. of Korea,PRK,Kuwait,KWT,0,0,0,5,5
2019,Syrian Arab Rep.,SYR,Kuwait,KWT,24,0,0,0,24
2019,Thailand,THA,Lao People's Dem. Rep.,LAO,10,0,0,0,10
2019,Algeria,DZA,Libya,LBY,0,0,0,5,5
2019,Egypt,EGY,Libya,LBY,0,0,0,18,18
2019,Chad,TCD,Libya,LBY,0,0,0,23,23
2019,Dem. Rep. of the Congo,COD,Libya,LBY,0,0,0,5,5
2019,Eritrea,ERI,Libya,LBY,282,0,0,4566,4848
2019,Ethiopia,ETH,Libya,LBY,5,0,5,453,463
2019,Palestinian,PSE,Libya,LBY,10,0,0,41,51
2019,Iraq,IRQ,Libya,LBY,0,0,0,334,334
2019,Jordan,JOR,Libya,LBY,0,0,0,11,11
2019,Liberia,LBR,Libya,LBY,0,0,0,5,5
2019,Morocco,MAR,Libya,LBY,0,0,0,11,11
2019,Somalia,SOM,Libya,LBY,5,0,0,1681,1686
2019,Sudan,SDN,Libya,LBY,237,0,23,1063,1323
2019,South Sudan,SSD,Libya,LBY,5,0,0,0,5
2019,Syrian Arab Rep.,SYR,Libya,LBY,525,0,0,9515,10040
2019,Yemen,YEM,Libya,LBY,0,0,0,5,5
2019,Egypt,EGY,Lebanon,LBN,22,0,49,30,101
2019,Benin,BEN,Lebanon,LBN,0,0,5,0,5
2019,Bangladesh,BGD,Lebanon,LBN,0,0,12,15,27
2019,Cameroon,CMR,Lebanon,LBN,0,0,10,5,15
2019,Congo,COG,Lebanon,LBN,0,0,5,0,5
2019,Eritrea,ERI,Lebanon,LBN,0,0,5,14,19
2019,Ethiopia,ETH,Lebanon,LBN,12,0,129,123,264
2019,Gambia,GMB,Lebanon,LBN,0,0,5,5,10
2019,Palestinian,PSE,Lebanon,LBN,0,0,0,18,18
2019,Ghana,GHA,Lebanon,LBN,0,0,5,5,10
2019,Cote d'Ivoire,CIV,Lebanon,LBN,0,0,0,5,5
2019,Iran (Islamic Rep. of),IRN,Lebanon,LBN,13,0,0,0,13
2019,Iraq,IRQ,Lebanon,LBN,35,0,15,5742,5792
2019,Jordan,JOR,Lebanon,LBN,5,0,0,5,10
2019,Kenya,KEN,Lebanon,LBN,0,0,10,10,20
2019,Kuwait,KWT,Lebanon,LBN,10,0,0,0,10
2019,Libya,LBY,Lebanon,LBN,0,0,0,5,5
2019,Sri Lanka,LKA,Lebanon,LBN,0,0,0,5,5
2019,Nigeria,NGA,Lebanon,LBN,0,0,68,26,94
2019,Philippines,PHL,Lebanon,LBN,0,0,28,23,51
2019,Somalia,SOM,Lebanon,LBN,0,0,0,5,5
2019,Sudan,SDN,Lebanon,LBN,41,0,97,180,318
2019,Turkey,TUR,Lebanon,LBN,0,0,0,5,5
2019,Yemen,YEM,Lebanon,LBN,5,0,0,31,36
2019,Unknown ,,Lebanon,LBN,0,0,0,10,10
2019,Afghanistan,AFG,Sri Lanka,LKA,30,0,0,0,30
2019,Nigeria,NGA,Sri Lanka,LKA,0,0,0,5,5
2019,Pakistan,PAK,Sri Lanka,LKA,549,0,10,66,625
2019,Afghanistan,AFG,Madagascar,MDG,5,0,0,0,5
2019,Dem. Rep. of the Congo,COD,Madagascar,MDG,11,0,0,0,11
2019,Pakistan,PAK,Madagascar,MDG,39,0,0,0,39
2019,Somalia,SOM,Madagascar,MDG,0,0,0,5,5
2019,Syrian Arab Rep.,SYR,Madagascar,MDG,5,0,0,5,10
2019,Turkey,TUR,Madagascar,MDG,5,0,0,43,48
2019,Yemen,YEM,Madagascar,MDG,0,0,0,25,25
2019,Afghanistan,AFG,Mauritania,MRT,0,0,0,14,14
2019,Central African Rep.,CAF,Mauritania,MRT,71,0,0,28,99
2019,China,CHN,Mauritania,MRT,5,0,0,0,5
2019,Cameroon,CMR,Mauritania,MRT,0,0,5,13,18
2019,Congo,COG,Mauritania,MRT,0,0,5,17,22
2019,Gabon,GAB,Mauritania,MRT,0,0,0,5,5
2019,Gambia,GMB,Mauritania,MRT,0,0,5,5,10
2019,Palestinian,PSE,Mauritania,MRT,31,0,0,0,31
2019,Ghana,GHA,Mauritania,MRT,0,0,5,5,10
2019,Guinea-Bissau,GNB,Mauritania,MRT,0,0,0,11,11
2019,Guinea,GIN,Mauritania,MRT,0,0,27,18,45
2019,Cote d'Ivoire,CIV,Mauritania,MRT,13,0,14,33,60
2019,Liberia,LBR,Mauritania,MRT,0,0,5,5,10
2019,Mali,MLI,Mauritania,MRT,728,0,5,0,733
2019,Niger,NER,Mauritania,MRT,0,0,0,5,5
2019,Nigeria,NGA,Mauritania,MRT,0,0,12,0,12
2019,Senegal,SEN,Mauritania,MRT,11,0,16,0,27
2019,Sierra Leone,SLE,Mauritania,MRT,0,0,48,136,184
2019,Sudan,SDN,Mauritania,MRT,0,0,0,5,5
2019,Syrian Arab Rep.,SYR,Mauritania,MRT,59,0,0,0,59
2019,Togo,TGO,Mauritania,MRT,0,0,17,10,27
2019,Yemen,YEM,Mauritania,MRT,10,0,0,0,10
2019,Afghanistan,AFG,Malaysia,MYS,694,0,12,0,706
2019,Egypt,EGY,Malaysia,MYS,5,0,0,0,5
2019,Bangladesh,BGD,Malaysia,MYS,5,0,0,5,10
2019,Cambodia,KHM,Malaysia,MYS,15,0,0,5,20
2019,China,CHN,Malaysia,MYS,17,0,0,0,17
2019,Cameroon,CMR,Malaysia,MYS,5,0,0,0,5
2019,Eritrea,ERI,Malaysia,MYS,5,0,0,0,5
2019,Palestinian,PSE,Malaysia,MYS,29,0,0,24,53
2019,India,IND,Malaysia,MYS,0,0,0,10,10
2019,Indonesia,IDN,Malaysia,MYS,29,0,0,66,95
2019,Iran (Islamic Rep. of),IRN,Malaysia,MYS,56,0,12,0,68
2019,Iraq,IRQ,Malaysia,MYS,38,0,0,100,138
2019,Liberia,LBR,Malaysia,MYS,10,0,0,0,10
2019,Libya,LBY,Malaysia,MYS,5,0,0,0,5
2019,Sri Lanka,LKA,Malaysia,MYS,33,0,64,84,181
2019,Morocco,MAR,Malaysia,MYS,0,0,0,5,5
2019,Myanmar,MMR,Malaysia,MYS,12904,0,241,860,14005
2019,Nigeria,NGA,Malaysia,MYS,0,0,10,0,10
2019,Pakistan,PAK,Malaysia,MYS,1606,0,68,133,1807
2019,Philippines,PHL,Malaysia,MYS,0,0,0,5,5
2019,Sierra Leone,SLE,Malaysia,MYS,5,0,5,0,10
2019,Somalia,SOM,Malaysia,MYS,605,0,28,66,699
2019,Sudan,SDN,Malaysia,MYS,59,0,5,5,69
2019,South Sudan,SSD,Malaysia,MYS,5,0,0,5,10
2019,Syrian Arab Rep.,SYR,Malaysia,MYS,47,0,0,0,47
2019,Turkey,TUR,Malaysia,MYS,5,0,0,0,5
2019,Uganda,UGA,Malaysia,MYS,5,0,0,0,5
2019,Yemen,YEM,Malaysia,MYS,59,0,0,152,211
2019,Turkey,TUR,Mongolia,MNG,21,0,0,0,21
2019,Afghanistan,AFG,Morocco,MAR,0,0,0,5,5
2019,Algeria,DZA,Morocco,MAR,5,0,0,0,5
2019,Egypt,EGY,Morocco,MAR,0,0,0,10,10
2019,Benin,BEN,Morocco,MAR,0,0,5,0,5
2019,Bangladesh,BGD,Morocco,MAR,0,0,5,111,116
2019,Burkina Faso,BFA,Morocco,MAR,0,0,5,0,5
2019,Central African Rep.,CAF,Morocco,MAR,188,0,5,30,223
2019,Chad,TCD,Morocco,MAR,0,0,0,5,5
2019,Cameroon,CMR,Morocco,MAR,32,0,167,463,662
2019,Congo,COG,Morocco,MAR,0,0,13,30,43
2019,Dem. Rep. of the Congo,COD,Morocco,MAR,5,0,36,81,122
2019,Eritrea,ERI,Morocco,MAR,5,0,0,5,10
2019,Gabon,GAB,Morocco,MAR,0,0,0,5,5
2019,Gambia,GMB,Morocco,MAR,0,0,0,5,5
2019,Palestinian,PSE,Morocco,MAR,13,0,0,196,209
2019,Ghana,GHA,Morocco,MAR,0,0,0,10,10
2019,Guinea-Bissau,GNB,Morocco,MAR,0,0,0,5,5
2019,Guinea,GIN,Morocco,MAR,35,0,165,408,608
2019,Cote d'Ivoire,CIV,Morocco,MAR,39,0,110,165,314
2019,Iraq,IRQ,Morocco,MAR,5,0,0,0,5
2019,Liberia,LBR,Morocco,MAR,0,0,5,31,36
2019,Libya,LBY,Morocco,MAR,0,0,0,5,5
2019,Lebanon,LBN,Morocco,MAR,5,0,0,0,5
2019,Sri Lanka,LKA,Morocco,MAR,0,0,0,5,5
2019,Mali,MLI,Morocco,MAR,14,0,18,55,87
2019,Nigeria,NGA,Morocco,MAR,10,0,61,151,222
2019,Pakistan,PAK,Morocco,MAR,0,0,0,5,5
2019,Senegal,SEN,Morocco,MAR,15,0,40,131,186
2019,Sierra Leone,SLE,Morocco,MAR,0,0,10,25,35
2019,Somalia,SOM,Morocco,MAR,0,0,0,5,5
2019,Sudan,SDN,Morocco,MAR,5,0,5,5,15
2019,South Sudan,SSD,Morocco,MAR,0,0,0,134,134
2019,Syrian Arab Rep.,SYR,Morocco,MAR,0,0,0,727,727
2019,Togo,TGO,Morocco,MAR,0,0,5,5,10
2019,Turkey,TUR,Morocco,MAR,0,0,0,10,10
2019,Yemen,YEM,Morocco,MAR,0,0,0,270,270
2019,Pakistan,PAK,Mauritius,MUS,5,0,0,0,5
2019,South Africa,ZAF,Mauritius,MUS,5,0,0,0,5
2019,Myanmar,MMR,Nepal,NPL,33,0,0,5,38
2019,Pakistan,PAK,Nepal,NPL,5,0,5,0,10
2019,Afghanistan,AFG,Pakistan,PAK,21,0,0,128,149
2019,China,CHN,Pakistan,PAK,5,0,0,0,5
2019,Somalia,SOM,Pakistan,PAK,0,0,0,5,5
2019,Syrian Arab Rep.,SYR,Pakistan,PAK,14,0,0,0,14
2019,Turkey,TUR,Pakistan,PAK,0,0,0,49,49
2019,Yemen,YEM,Pakistan,PAK,10,0,0,5,15
2019,Egypt,EGY,Qatar,QAT,5,0,0,0,5
2019,Iraq,IRQ,Qatar,QAT,5,0,0,0,5
2019,Yemen,YEM,Qatar,QAT,5,0,0,0,5
2019,Eritrea,ERI,Saudi Arabia,SAU,11,0,0,0,11
2019,Syrian Arab Rep.,SYR,Saudi Arabia,SAU,101,0,0,39,140
2019,Yemen,YEM,Saudi Arabia,SAU,10,0,0,5,15
2019,Cameroon,CMR,Somalia,SOM,5,0,0,0,5
2019,Eritrea,ERI,Somalia,SOM,10,0,5,0,15
2019,Ethiopia,ETH,Somalia,SOM,238,0,135,177,550
2019,Mozambique,MOZ,Somalia,SOM,0,0,5,0,5
2019,Yemen,YEM,Somalia,SOM,0,0,5,0,5
2019,Afghanistan,AFG,Viet Nam,VNM,5,0,0,0,5
2019,Central African Rep.,CAF,Sudan,SDN,0,0,0,5,5
2019,Chad,TCD,Sudan,SDN,0,0,0,5,5
2019,Eritrea,ERI,Sudan,SDN,0,0,0,2268,2268
2019,Ethiopia,ETH,Sudan,SDN,0,0,0,332,332
2019,Somalia,SOM,Sudan,SDN,0,0,0,45,45
2019,Yemen,YEM,Sudan,SDN,0,0,0,2523,2523
2019,Unknown ,,Sudan,SDN,0,0,0,288,288
2019,Cuba,CUB,Suriname,SUR,5,0,29,16,50
2019,Egypt,EGY,Syrian Arab Rep.,SYR,0,0,0,5,5
2019,Eritrea,ERI,Syrian Arab Rep.,SYR,5,0,0,0,5
2019,Palestinian,PSE,Syrian Arab Rep.,SYR,0,0,0,5,5
2019,Iran (Islamic Rep. of),IRN,Syrian Arab Rep.,SYR,0,0,0,5,5
2019,Iraq,IRQ,Syrian Arab Rep.,SYR,53,0,15,7925,7993
2019,Lebanon,LBN,Syrian Arab Rep.,SYR,0,0,0,5,5
2019,Pakistan,PAK,Syrian Arab Rep.,SYR,5,0,0,5,10
2019,Somalia,SOM,Syrian Arab Rep.,SYR,12,0,0,0,12
2019,Sudan,SDN,Syrian Arab Rep.,SYR,5,0,0,0,5
2019,Turkey,TUR,Syrian Arab Rep.,SYR,0,0,0,5,5
2019,Yemen,YEM,Syrian Arab Rep.,SYR,11,0,0,45,56
2019,Afghanistan,AFG,Thailand,THA,19,0,0,5,24
2019,Egypt,EGY,Thailand,THA,0,0,0,5,5
2019,Cambodia,KHM,Thailand,THA,43,0,48,70,161
2019,China,CHN,Thailand,THA,10,0,5,10,25
2019,Cameroon,CMR,Thailand,THA,25,0,0,0,25
2019,Ethiopia,ETH,Thailand,THA,10,0,5,5,20
2019,Palestinian,PSE,Thailand,THA,5,0,5,0,10
2019,Iran (Islamic Rep. of),IRN,Thailand,THA,5,0,5,26,36
2019,Iraq,IRQ,Thailand,THA,5,0,5,21,31
2019,Kuwait,KWT,Thailand,THA,0,0,5,0,5
2019,Lao People's Dem. Rep.,LAO,Thailand,THA,5,0,0,0,5
2019,Sri Lanka,LKA,Thailand,THA,0,0,0,10,10
2019,Pakistan,PAK,Thailand,THA,88,0,22,20,130
2019,Somalia,SOM,Thailand,THA,12,0,5,16,33
2019,Viet Nam,VNM,Thailand,THA,82,0,89,93,264
2019,Sudan,SDN,Thailand,THA,0,0,0,5,5
2019,Syrian Arab Rep.,SYR,Thailand,THA,10,0,0,0,10
2019,Uzbekistan,UZB,Thailand,THA,0,0,0,5,5
2019,Yemen,YEM,Thailand,THA,5,0,0,0,5
2019,Afghanistan,AFG,Tajikistan,TJK,5,0,0,0,5
2019,Cuba,CUB,Trinidad and Tobago,TTO,18,0,13,40,71
2019,Jamaica,JAM,Trinidad and Tobago,TTO,13,0,5,0,18
2019,Syrian Arab Rep.,SYR,Trinidad and Tobago,TTO,5,0,0,0,5
2019,Venezuela (Bolivarian Republic of),VEN,Trinidad and Tobago,TTO,1573,0,0,105,1678
2019,Eritrea,ERI,Tunisia,TUN,128,0,0,0,128
2019,Ethiopia,ETH,Tunisia,TUN,0,0,0,5,5
2019,Palestinian,PSE,Tunisia,TUN,5,0,0,0,5
2019,Cote d'Ivoire,CIV,Tunisia,TUN,5,0,0,0,5
2019,Libya,LBY,Tunisia,TUN,10,0,0,0,10
2019,Somalia,SOM,Tunisia,TUN,14,0,5,0,19
2019,Sudan,SDN,Tunisia,TUN,21,0,0,0,21
2019,Egypt,EGY,United Arab Emirates,ARE,5,0,0,0,5
2019,Chad,TCD,United Arab Emirates,ARE,5,0,0,0,5
2019,Palestinian,PSE,United Arab Emirates,ARE,5,0,0,41,46
2019,Iran (Islamic Rep. of),IRN,United Arab Emirates,ARE,5,0,0,0,5
2019,Iraq,IRQ,United Arab Emirates,ARE,33,0,0,0,33
2019,Sudan,SDN,United Arab Emirates,ARE,0,0,0,10,10
2019,Syrian Arab Rep.,SYR,United Arab Emirates,ARE,112,0,0,650,762
2019,Russian Federation,RUS,Ukraine,UKR,5,0,0,0,5
2019,Tajikistan,TJK,Ukraine,UKR,5,0,0,0,5
2019,Colombia,COL,Curacao ,CUW,0,0,5,11,16
2019,Cuba,CUB,Curacao ,CUW,0,0,0,5,5
2019,Venezuela (Bolivarian Republic of),VEN,Curacao ,CUW,13,0,0,10,23
2020,Pakistan,PAK,Afghanistan,AFG,0,0,0,5,5
2020,Turkey,TUR,Afghanistan,AFG,61,0,0,18,79
2020,Benin,BEN,Algeria,DZA,0,0,0,5,5
2020,Burkina Faso,BFA,Algeria,DZA,5,0,0,0,5
2020,Central African Rep.,CAF,Algeria,DZA,14,0,0,5,19
2020,Chad,TCD,Algeria,DZA,0,0,5,0,5
2020,Cameroon,CMR,Algeria,DZA,54,0,38,10,102
2020,Dem. Rep. of the Congo,COD,Algeria,DZA,13,0,24,0,37
2020,Palestinian,PSE,Algeria,DZA,0,0,0,13,13
2020,Guinea,GIN,Algeria,DZA,5,0,34,5,44
2020,Cote d'Ivoire,CIV,Algeria,DZA,11,0,23,10,44
2020,Liberia,LBR,Algeria,DZA,0,0,0,5,5
2020,Mali,MLI,Algeria,DZA,54,0,38,0,92
2020,Niger,NER,Algeria,DZA,0,0,5,5,10
2020,Nigeria,NGA,Algeria,DZA,0,0,5,28,33
2020,Senegal,SEN,Algeria,DZA,0,0,0,5,5
2020,Sierra Leone,SLE,Algeria,DZA,0,0,0,5,5
2020,Sudan,SDN,Algeria,DZA,5,0,0,0,5
2020,Syrian Arab Rep.,SYR,Algeria,DZA,11,0,0,325,336
2020,Togo,TGO,Algeria,DZA,0,0,5,0,5
2020,Yemen,YEM,Algeria,DZA,0,0,0,11,11
2020,Afghanistan,AFG,Egypt,EGY,5,0,0,0,5
2020,Burundi,BDI,Egypt,EGY,5,0,0,0,5
2020,Central African Rep.,CAF,Egypt,EGY,5,0,0,0,5
2020,Chad,TCD,Egypt,EGY,10,0,0,0,10
2020,China,CHN,Egypt,EGY,0,0,0,5,5
2020,Cameroon,CMR,Egypt,EGY,5,0,0,0,5
2020,Dem. Rep. of the Congo,COD,Egypt,EGY,0,0,0,5,5
2020,Eritrea,ERI,Egypt,EGY,4862,0,85,772,5719
2020,Ethiopia,ETH,Egypt,EGY,815,0,1385,399,2599
2020,Guinea,GIN,Egypt,EGY,0,0,5,5,10
2020,Iraq,IRQ,Egypt,EGY,274,0,85,5,364
2020,Nigeria,NGA,Egypt,EGY,5,0,33,5,43
2020,Russian Federation,RUS,Egypt,EGY,0,0,0,5,5
2020,Saudi Arabia,SAU,Egypt,EGY,11,0,0,0,11
2020,Somalia,SOM,Egypt,EGY,677,0,130,190,997
2020,Sudan,SDN,Egypt,EGY,3726,0,1991,344,6061
2020,South Sudan,SSD,Egypt,EGY,3390,0,5,91,3486
2020,Tajikistan,TJK,Egypt,EGY,0,0,0,14,14
2020,Turkey,TUR,Egypt,EGY,0,0,0,21,21
2020,Uganda,UGA,Egypt,EGY,0,0,5,0,5
2020,Uzbekistan,UZB,Egypt,EGY,0,0,5,0,5
2020,Yemen,YEM,Egypt,EGY,27,0,0,173,200
2020,Zimbabwe,ZWE,Egypt,EGY,14,0,5,0,19
2020,Afghanistan,AFG,Azerbaijan,AZE,470,0,0,0,470
2020,Iraq,IRQ,Azerbaijan,AZE,5,0,0,0,5
2020,Syrian Arab Rep.,SYR,Azerbaijan,AZE,13,0,0,0,13
2020,Uzbekistan,UZB,Azerbaijan,AZE,5,0,0,0,5
2020,Trinidad and Tobago,TTO,Barbados,BRB,0,0,0,5,5
2020,Myanmar,MMR,Bangladesh,BGD,5,0,0,0,5
2020,Somalia,SOM,Bangladesh,BGD,0,0,12,0,12
2020,Turkey,TUR,Bangladesh,BGD,14,0,0,0,14
2020,Cambodia,KHM,Bahamas,BHS,5,0,0,0,5
2020,Afghanistan,AFG,Belarus,BLR,10,0,0,0,10
2020,Rwanda,RWA,Botswana,BWA,0,0,0,5,5
2020,Somalia,SOM,Botswana,BWA,5,0,0,0,5
2020,Zimbabwe,ZWE,Botswana,BWA,0,0,0,21,21
2020,Afghanistan,AFG,China,CHN,5,0,0,5,10
2020,Cameroon,CMR,China,CHN,0,0,12,5,17
2020,Dem. Rep. of the Congo,COD,China,CHN,0,0,0,5,5
2020,Eritrea,ERI,China,CHN,5,0,0,0,5
2020,Palestinian,PSE,China,CHN,0,0,0,5,5
2020,Ghana,GHA,China,CHN,0,0,14,0,14
2020,Cote d'Ivoire,CIV,China,CHN,0,0,0,5,5
2020,Iran (Islamic Rep. of),IRN,China,CHN,5,0,0,0,5
2020,Kenya,KEN,China,CHN,0,0,11,0,11
2020,Liberia,LBR,China,CHN,0,0,0,5,5
2020,Mozambique,MOZ,China,CHN,0,0,0,5,5
2020,Nigeria,NGA,China,CHN,0,0,0,12,12
2020,Pakistan,PAK,China,CHN,10,0,0,5,15
2020,Sierra Leone,SLE,China,CHN,0,0,0,5,5
2020,Somalia,SOM,China,CHN,18,0,5,0,23
2020,Turkey,TUR,China,CHN,0,0,0,10,10
2020,Uganda,UGA,China,CHN,0,0,41,5,46
2020,Yemen,YEM,China,CHN,10,0,0,0,10
2020,Zimbabwe,ZWE,China,CHN,0,0,38,12,50
2020,Burundi,BDI,Cameroon,CMR,0,0,0,5,5
2020,Central African Rep.,CAF,Cameroon,CMR,1393,0,17,2319,3729
2020,Chad,TCD,Cameroon,CMR,11,0,46,163,220
2020,Congo,COG,Cameroon,CMR,0,0,0,12,12
2020,Dem. Rep. of the Congo,COD,Cameroon,CMR,0,0,15,45,60
2020,Gabon,GAB,Cameroon,CMR,0,0,0,5,5
2020,Guinea,GIN,Cameroon,CMR,0,0,10,0,10
2020,Cote d'Ivoire,CIV,Cameroon,CMR,0,0,5,0,5
2020,Mali,MLI,Cameroon,CMR,10,0,5,20,35
2020,Niger,NER,Cameroon,CMR,0,0,23,5,28
2020,Nigeria,NGA,Cameroon,CMR,0,0,0,20,20
2020,Rwanda,RWA,Cameroon,CMR,0,0,11,55,66
2020,Sudan,SDN,Cameroon,CMR,5,0,0,19,24
2020,Togo,TGO,Cameroon,CMR,0,0,0,5,5
2020,Turkey,TUR,Cameroon,CMR,0,0,0,33,33
2020,Yemen,YEM,Cameroon,CMR,5,0,0,0,5
2020,Burundi,BDI,Comoros,COM,0,0,0,14,14
2020,Iraq,IRQ,Cuba,CUB,0,0,5,0,5
2020,Sudan,SDN,Cuba,CUB,10,0,0,0,10
2020,Cuba,CUB,Guyana,GUY,11,0,0,0,11
2020,Afghanistan,AFG,India,IND,981,0,427,921,2329
2020,Cameroon,CMR,India,IND,5,0,0,21,26
2020,Congo,COG,India,IND,5,0,0,0,5
2020,Dem. Rep. of the Congo,COD,India,IND,5,0,11,5,21
2020,Eritrea,ERI,India,IND,5,0,0,0,5
2020,Ethiopia,ETH,India,IND,0,0,10,0,10
2020,Cote d'Ivoire,CIV,India,IND,0,0,5,0,5
2020,Iran (Islamic Rep. of),IRN,India,IND,0,0,0,5,5
2020,Iraq,IRQ,India,IND,0,0,10,5,15
2020,Myanmar,MMR,India,IND,349,0,57,290,696
2020,Nigeria,NGA,India,IND,0,0,64,0,64
2020,Somalia,SOM,India,IND,5,0,21,41,67
2020,Sudan,SDN,India,IND,0,0,5,16,21
2020,South Sudan,SSD,India,IND,0,0,0,10,10
2020,Syrian Arab Rep.,SYR,India,IND,0,0,0,5,5
2020,Ukraine,UKR,India,IND,0,0,5,0,5
2020,Uzbekistan,UZB,India,IND,0,0,5,0,5
2020,Venezuela (Bolivarian Republic of),VEN,India,IND,5,0,0,0,5
2020,Yemen,YEM,India,IND,0,0,0,65,65
2020,Afghanistan,AFG,Indonesia,IDN,89,0,0,39,128
2020,Bangladesh,BGD,Indonesia,IDN,0,0,5,0,5
2020,Cameroon,CMR,Indonesia,IDN,0,0,5,0,5
2020,Eritrea,ERI,Indonesia,IDN,48,0,0,0,48
2020,Ethiopia,ETH,Indonesia,IDN,0,0,5,0,5
2020,Palestinian,PSE,Indonesia,IDN,0,0,0,15,15
2020,Iran (Islamic Rep. of),IRN,Indonesia,IDN,5,0,5,0,10
2020,Iraq,IRQ,Indonesia,IDN,14,0,0,0,14
2020,Libya,LBY,Indonesia,IDN,0,0,0,5,5
2020,Sri Lanka,LKA,Indonesia,IDN,0,0,5,0,5
2020,Myanmar,MMR,Indonesia,IDN,0,0,0,20,20
2020,Somalia,SOM,Indonesia,IDN,75,0,0,5,80
2020,Sudan,SDN,Indonesia,IDN,5,0,0,0,5
2020,Yemen,YEM,Indonesia,IDN,15,0,0,13,28
2020,Egypt,EGY,Iraq,IRQ,0,0,0,14,14
2020,Eritrea,ERI,Iraq,IRQ,0,0,0,5,5
2020,Palestinian,PSE,Iraq,IRQ,0,0,0,97,97
2020,Iran (Islamic Rep. of),IRN,Iraq,IRQ,5,0,0,455,460
2020,Kuwait,KWT,Iraq,IRQ,0,0,0,5,5
2020,Sudan,SDN,Iraq,IRQ,0,0,0,36,36
2020,Turkey,TUR,Iraq,IRQ,0,0,0,153,153
2020,Yemen,YEM,Iraq,IRQ,0,0,0,5,5
2020,Egypt,EGY,Jordan,JOR,21,0,61,131,213
2020,Chad,TCD,Jordan,JOR,0,0,0,5,5
2020,Eritrea,ERI,Jordan,JOR,0,0,0,5,5
2020,Ethiopia,ETH,Jordan,JOR,5,0,0,0,5
2020,Ghana,GHA,Jordan,JOR,0,0,0,5,5
2020,India,IND,Jordan,JOR,0,0,5,0,5
2020,Iraq,IRQ,Jordan,JOR,228,0,5,31996,32229
2020,Kenya,KEN,Jordan,JOR,5,0,0,0,5
2020,Libya,LBY,Jordan,JOR,16,0,0,32,48
2020,Lebanon,LBN,Jordan,JOR,0,0,0,5,5
2020,Sri Lanka,LKA,Jordan,JOR,0,0,0,5,5
2020,Niger,NER,Jordan,JOR,0,0,0,5,5
2020,Nigeria,NGA,Jordan,JOR,0,0,11,38,49
2020,Russian Federation,RUS,Jordan,JOR,0,0,0,5,5
2020,Saudi Arabia,SAU,Jordan,JOR,0,0,0,13,13
2020,Somalia,SOM,Jordan,JOR,10,0,5,10,25
2020,Sudan,SDN,Jordan,JOR,493,0,185,245,923
2020,Tunisia,TUN,Jordan,JOR,5,0,0,0,5
2020,United Arab Emirates,ARE,Jordan,JOR,0,0,0,5,5
2020,Ukraine,UKR,Jordan,JOR,0,0,0,10,10
2020,Yemen,YEM,Jordan,JOR,115,0,0,12716,12831
2020,Stateless,XXA,Jordan,JOR,0,0,0,49,49
2020,Iraq,IRQ,Kuwait,KWT,0,0,0,5,5
2020,Sudan,SDN,Kuwait,KWT,0,0,0,5,5
2020,Syrian Arab Rep.,SYR,Kuwait,KWT,40,0,0,5,45
2020,Afghanistan,AFG,Libya,LBY,0,0,0,11,11
2020,Central African Rep.,CAF,Libya,LBY,0,0,0,5,5
2020,Chad,TCD,Libya,LBY,0,0,0,30,30
2020,Congo,COG,Libya,LBY,0,0,0,5,5
2020,Dem. Rep. of the Congo,COD,Libya,LBY,0,0,0,10,10
2020,Eritrea,ERI,Libya,LBY,240,0,33,523,796
2020,Ethiopia,ETH,Libya,LBY,11,0,26,156,193
2020,Palestinian,PSE,Libya,LBY,0,0,0,531,531
2020,Iraq,IRQ,Libya,LBY,0,0,5,46,51
2020,Niger,NER,Libya,LBY,0,0,0,5,5
2020,Somalia,SOM,Libya,LBY,12,0,0,285,297
2020,Sudan,SDN,Libya,LBY,431,0,194,1026,1651
2020,South Sudan,SSD,Libya,LBY,0,0,0,11,11
2020,Syrian Arab Rep.,SYR,Libya,LBY,126,0,0,5038,5164
2020,Algeria,DZA,Lebanon,LBN,5,0,0,0,5
2020,Egypt,EGY,Lebanon,LBN,26,0,34,68,128
2020,Bangladesh,BGD,Lebanon,LBN,0,0,10,14,24
2020,Cameroon,CMR,Lebanon,LBN,0,0,5,5,10
2020,Congo,COG,Lebanon,LBN,0,0,0,5,5
2020,Eritrea,ERI,Lebanon,LBN,5,0,0,5,10
2020,Ethiopia,ETH,Lebanon,LBN,5,0,182,126,313
2020,Gambia,GMB,Lebanon,LBN,0,0,5,0,5
2020,Palestinian,PSE,Lebanon,LBN,0,0,0,17,17
2020,Cote d'Ivoire,CIV,Lebanon,LBN,0,0,5,0,5
2020,India,IND,Lebanon,LBN,0,0,5,0,5
2020,Iran (Islamic Rep. of),IRN,Lebanon,LBN,5,0,5,0,10
2020,Iraq,IRQ,Lebanon,LBN,5,0,5,1997,2007
2020,Jordan,JOR,Lebanon,LBN,5,0,5,10,20
2020,Kenya,KEN,Lebanon,LBN,0,0,5,5,10
2020,Sri Lanka,LKA,Lebanon,LBN,0,0,5,5,10
2020,Madagascar,MDG,Lebanon,LBN,0,0,10,0,10
2020,Morocco,MAR,Lebanon,LBN,5,0,0,0,5
2020,Nigeria,NGA,Lebanon,LBN,0,0,21,30,51
2020,Philippines,PHL,Lebanon,LBN,0,0,12,10,22
2020,Sudan,SDN,Lebanon,LBN,56,0,320,289,665
2020,Togo,TGO,Lebanon,LBN,0,0,5,0,5
2020,Yemen,YEM,Lebanon,LBN,5,0,0,35,40
2020,Unknown ,,Lebanon,LBN,0,0,0,11,11
2020,Afghanistan,AFG,Sri Lanka,LKA,39,0,0,0,39
2020,Iran (Islamic Rep. of),IRN,Sri Lanka,LKA,5,0,0,0,5
2020,Nigeria,NGA,Sri Lanka,LKA,0,0,0,5,5
2020,Pakistan,PAK,Sri Lanka,LKA,123,0,34,10,167
2020,Sudan,SDN,Sri Lanka,LKA,5,0,0,0,5
2020,Turkey,TUR,Madagascar,MDG,10,0,0,0,10
2020,Benin,BEN,Mauritania,MRT,0,0,0,5,5
2020,Burkina Faso,BFA,Mauritania,MRT,15,0,0,10,25
2020,Central African Rep.,CAF,Mauritania,MRT,21,0,5,29,55
2020,Cameroon,CMR,Mauritania,MRT,15,0,27,0,42
2020,Dem. Rep. of the Congo,COD,Mauritania,MRT,0,0,5,0,5
2020,Gambia,GMB,Mauritania,MRT,0,0,0,5,5
2020,Palestinian,PSE,Mauritania,MRT,21,0,0,0,21
2020,Ghana,GHA,Mauritania,MRT,0,0,0,5,5
2020,Guinea-Bissau,GNB,Mauritania,MRT,0,0,14,0,14
2020,Guinea,GIN,Mauritania,MRT,0,0,70,60,130
2020,Cote d'Ivoire,CIV,Mauritania,MRT,12,0,26,50,88
2020,Liberia,LBR,Mauritania,MRT,0,0,0,19,19
2020,Mali,MLI,Mauritania,MRT,1158,0,5,16,1179
2020,Morocco,MAR,Mauritania,MRT,0,0,0,5,5
2020,Nigeria,NGA,Mauritania,MRT,0,0,32,26,58
2020,Senegal,SEN,Mauritania,MRT,36,0,14,0,50
2020,Sierra Leone,SLE,Mauritania,MRT,0,0,42,102,144
2020,Sudan,SDN,Mauritania,MRT,0,0,0,11,11
2020,Syrian Arab Rep.,SYR,Mauritania,MRT,21,0,0,10,31
2020,Togo,TGO,Mauritania,MRT,0,0,10,23,33
2020,Turkey,TUR,Mauritania,MRT,5,0,0,0,5
2020,Yemen,YEM,Mauritania,MRT,28,0,0,0,28
2020,Afghanistan,AFG,Malaysia,MYS,213,0,0,0,213
2020,Egypt,EGY,Malaysia,MYS,0,0,0,5,5
2020,China,CHN,Malaysia,MYS,5,0,0,0,5
2020,Cameroon,CMR,Malaysia,MYS,5,0,0,0,5
2020,Eritrea,ERI,Malaysia,MYS,5,0,0,0,5
2020,Palestinian,PSE,Malaysia,MYS,18,0,0,40,58
2020,Indonesia,IDN,Malaysia,MYS,11,0,0,24,35
2020,Iran (Islamic Rep. of),IRN,Malaysia,MYS,13,0,0,0,13
2020,Iraq,IRQ,Malaysia,MYS,5,0,0,77,82
2020,Jordan,JOR,Malaysia,MYS,0,0,0,5,5
2020,Lao People's Dem. Rep.,LAO,Malaysia,MYS,0,0,0,5,5
2020,Libya,LBY,Malaysia,MYS,0,0,0,5,5
2020,Sri Lanka,LKA,Malaysia,MYS,15,0,10,56,81
2020,Myanmar,MMR,Malaysia,MYS,2840,0,23,1990,4853
2020,Pakistan,PAK,Malaysia,MYS,244,0,12,134,390
2020,Sierra Leone,SLE,Malaysia,MYS,0,0,5,0,5
2020,Somalia,SOM,Malaysia,MYS,320,0,5,65,390
2020,Sudan,SDN,Malaysia,MYS,5,0,0,5,10
2020,South Sudan,SSD,Malaysia,MYS,5,0,0,5,10
2020,Syrian Arab Rep.,SYR,Malaysia,MYS,12,0,0,101,113
2020,Uganda,UGA,Malaysia,MYS,0,0,0,5,5
2020,Yemen,YEM,Malaysia,MYS,36,0,0,155,191
2020,Burundi,BDI,Morocco,MAR,5,0,0,0,5
2020,Benin,BEN,Morocco,MAR,0,0,0,5,5
2020,Bangladesh,BGD,Morocco,MAR,0,0,0,30,30
2020,Burkina Faso,BFA,Morocco,MAR,0,0,5,0,5
2020,Central African Rep.,CAF,Morocco,MAR,21,0,0,199,220
2020,Cameroon,CMR,Morocco,MAR,28,0,81,0,109
2020,Congo,COG,Morocco,MAR,5,0,11,0,16
2020,Dem. Rep. of the Congo,COD,Morocco,MAR,5,0,29,0,34
2020,Eritrea,ERI,Morocco,MAR,5,0,0,0,5
2020,Palestinian,PSE,Morocco,MAR,0,0,0,53,53
2020,Ghana,GHA,Morocco,MAR,0,0,0,5,5
2020,Guinea,GIN,Morocco,MAR,38,0,136,0,174
2020,Cote d'Ivoire,CIV,Morocco,MAR,22,0,81,10,113
2020,Iraq,IRQ,Morocco,MAR,5,0,0,0,5
2020,Liberia,LBR,Morocco,MAR,0,0,5,0,5
2020,Libya,LBY,Morocco,MAR,21,0,0,0,21
2020,Mali,MLI,Morocco,MAR,11,0,41,0,52
2020,Nigeria,NGA,Morocco,MAR,5,0,22,5,32
2020,Pakistan,PAK,Morocco,MAR,5,0,0,0,5
2020,Senegal,SEN,Morocco,MAR,16,0,13,5,34
2020,Sierra Leone,SLE,Morocco,MAR,0,0,10,0,10
2020,Somalia,SOM,Morocco,MAR,13,0,0,0,13
2020,Sudan,SDN,Morocco,MAR,5,0,0,0,5
2020,South Sudan,SSD,Morocco,MAR,0,0,0,56,56
2020,Syrian Arab Rep.,SYR,Morocco,MAR,0,0,0,605,605
2020,Turkey,TUR,Morocco,MAR,5,0,0,0,5
2020,Yemen,YEM,Morocco,MAR,0,0,0,164,164
2020,Philippines,PHL,Mauritius,MUS,0,0,0,5,5
2020,Iran (Islamic Rep. of),IRN,Nepal,NPL,5,0,0,0,5
2020,Myanmar,MMR,Nepal,NPL,0,0,0,5,5
2020,Pakistan,PAK,Nepal,NPL,15,0,0,0,15
2020,Yemen,YEM,Nepal,NPL,0,0,0,5,5
2020,Afghanistan,AFG,Pakistan,PAK,5,0,0,17,22
2020,Iran (Islamic Rep. of),IRN,Pakistan,PAK,0,0,0,5,5
2020,Syrian Arab Rep.,SYR,Saudi Arabia,SAU,32,0,0,0,32
2020,Egypt,EGY,Somalia,SOM,0,0,0,24,24
2020,Djibouti,DJI,Somalia,SOM,0,0,0,10,10
2020,Eritrea,ERI,Somalia,SOM,0,0,0,20,20
2020,Ethiopia,ETH,Somalia,SOM,156,0,429,5743,6328
2020,Nigeria,NGA,Somalia,SOM,0,0,0,5,5
2020,Pakistan,PAK,Somalia,SOM,0,0,0,5,5
2020,Sudan,SDN,Somalia,SOM,0,0,0,10,10
2020,Syrian Arab Rep.,SYR,Somalia,SOM,0,0,0,18,18
2020,United Rep. of Tanzania,TZA,Somalia,SOM,0,0,0,5,5
2020,Yemen,YEM,Somalia,SOM,0,0,0,31,31
2020,Cuba,CUB,Suriname,SUR,10,0,10,147,167
2020,Dominican Rep.,DOM,Suriname,SUR,0,0,0,5,5
2020,Venezuela (Bolivarian Republic of),VEN,Suriname,SUR,5,0,0,19,24
2020,Iraq,IRQ,Syrian Arab Rep.,SYR,10,0,0,3435,3445
2020,Somalia,SOM,Syrian Arab Rep.,SYR,5,0,0,0,5
2020,Sudan,SDN,Syrian Arab Rep.,SYR,0,0,0,5,5
2020,Yemen,YEM,Syrian Arab Rep.,SYR,0,0,0,10,10
2020,Sri Lanka,LKA,Turks and Caicos Islands,TCA,10,0,5,0,15
2020,Afghanistan,AFG,Thailand,THA,36,0,0,0,36
2020,Egypt,EGY,Thailand,THA,5,0,0,0,5
2020,Cambodia,KHM,Thailand,THA,29,0,5,15,49
2020,China,CHN,Thailand,THA,10,0,0,5,15
2020,Cameroon,CMR,Thailand,THA,20,0,0,5,25
2020,Ethiopia,ETH,Thailand,THA,5,0,0,0,5
2020,Palestinian,PSE,Thailand,THA,5,0,0,0,5
2020,Iran (Islamic Rep. of),IRN,Thailand,THA,15,0,0,0,15
2020,Lao People's Dem. Rep.,LAO,Thailand,THA,5,0,0,0,5
2020,Sri Lanka,LKA,Thailand,THA,0,0,5,0,5
2020,Pakistan,PAK,Thailand,THA,63,0,0,11,74
2020,Somalia,SOM,Thailand,THA,11,0,0,0,11
2020,Viet Nam,VNM,Thailand,THA,93,0,28,34,155
2020,Syrian Arab Rep.,SYR,Thailand,THA,13,0,0,0,13
2020,Zimbabwe,ZWE,Thailand,THA,10,0,0,0,10
2020,Afghanistan,AFG,Tajikistan,TJK,15,0,0,0,15
2020,Cuba,CUB,Trinidad and Tobago,TTO,16,0,13,28,57
2020,Guyana,GUY,Trinidad and Tobago,TTO,18,0,0,0,18
2020,Jamaica,JAM,Trinidad and Tobago,TTO,25,0,0,0,25
2020,Syrian Arab Rep.,SYR,Trinidad and Tobago,TTO,10,0,0,0,10
2020,Venezuela (Bolivarian Republic of),VEN,Trinidad and Tobago,TTO,801,0,0,75,876
2020,Chad,TCD,Tunisia,TUN,0,0,0,5,5
2020,Cameroon,CMR,Tunisia,TUN,10,0,0,0,10
2020,Eritrea,ERI,Tunisia,TUN,90,0,0,5,95
2020,Ethiopia,ETH,Tunisia,TUN,0,0,0,5,5
2020,Palestinian,PSE,Tunisia,TUN,0,0,0,5,5
2020,Guinea,GIN,Tunisia,TUN,0,0,0,5,5
2020,Cote d'Ivoire,CIV,Tunisia,TUN,20,0,0,17,37
2020,Iran (Islamic Rep. of),IRN,Tunisia,TUN,5,0,0,0,5
2020,Iraq,IRQ,Tunisia,TUN,5,0,0,0,5
2020,Libya,LBY,Tunisia,TUN,26,0,0,0,26
2020,Mali,MLI,Tunisia,TUN,5,0,0,0,5
2020,Nigeria,NGA,Tunisia,TUN,5,0,0,0,5
2020,Somalia,SOM,Tunisia,TUN,18,0,0,32,50
2020,Sudan,SDN,Tunisia,TUN,96,0,0,28,124
2020,South Sudan,SSD,Tunisia,TUN,5,0,0,5,10
2020,Turkey,TUR,Tunisia,TUN,10,0,0,0,10
2020,Yemen,YEM,Tunisia,TUN,10,0,0,0,10
2020,Iran (Islamic Rep. of),IRN,United Arab Emirates,ARE,5,0,0,0,5
2020,Iraq,IRQ,United Arab Emirates,ARE,25,0,0,5,30
2020,Lebanon,LBN,United Arab Emirates,ARE,5,0,0,0,5
2020,Sudan,SDN,United Arab Emirates,ARE,0,0,0,5,5
2020,Syrian Arab Rep.,SYR,United Arab Emirates,ARE,86,0,0,12,98
2020,Eritrea,ERI,Yemen,YEM,5,0,0,0,5
2020,Ethiopia,ETH,Yemen,YEM,5,0,0,699,704
2020,Lebanon,LBN,Yemen,YEM,0,0,0,5,5
2020,Sudan,SDN,Yemen,YEM,0,0,0,5,5
2020,Colombia,COL,Curacao ,CUW,19,0,0,0,19
2020,Venezuela (Bolivarian Republic of),VEN,Curacao ,CUW,11,0,0,0,11
2020,Cuba,CUB,Sint Maarten (Dutch part),SXM,5,0,0,0,5
2003,Afghanistan,AFG,Jordan,JOR,0,0,0,5,5
2009,Cote d'Ivoire,CIV,Israel,ISR,0,0,0,5,5
2009,Turkey,TUR,Israel,ISR,0,0,0,10,10
2016,Afghanistan,AFG,Syrian Arab Rep.,SYR,11,0,5,0,16
2016,Algeria,DZA,Syrian Arab Rep.,SYR,0,0,10,0,10
2016,Egypt,EGY,Syrian Arab Rep.,SYR,0,0,40,5,45
2016,Argentina,ARG,Syrian Arab Rep.,SYR,0,0,5,0,5
2016,Burkina Faso,BFA,Syrian Arab Rep.,SYR,0,0,5,0,5
2016,Comoros,COM,Syrian Arab Rep.,SYR,0,0,5,0,5
2016,Ethiopia,ETH,Syrian Arab Rep.,SYR,0,0,10,5,15
2016,Guinea,GIN,Syrian Arab Rep.,SYR,0,0,10,0,10
2016,Cote d'Ivoire,CIV,Syrian Arab Rep.,SYR,0,0,5,0,5
2016,Iran (Islamic Rep. of),IRN,Syrian Arab Rep.,SYR,0,0,375,0,375
2016,Iraq,IRQ,Syrian Arab Rep.,SYR,15,0,10,12,37
2016,Jordan,JOR,Syrian Arab Rep.,SYR,0,0,63,27,90
2016,Liberia,LBR,Syrian Arab Rep.,SYR,5,0,0,0,5
2016,Lebanon,LBN,Syrian Arab Rep.,SYR,0,0,97,20,117
2016,Morocco,MAR,Syrian Arab Rep.,SYR,0,0,5,0,5
2016,Pakistan,PAK,Syrian Arab Rep.,SYR,10,0,20,5,35
2016,Sierra Leone,SLE,Syrian Arab Rep.,SYR,0,0,5,5,10
2016,Sudan,SDN,Syrian Arab Rep.,SYR,15,0,46,45,106
2016,Tunisia,TUN,Syrian Arab Rep.,SYR,0,0,10,10,20
2017,Afghanistan,AFG,Syrian Arab Rep.,SYR,15,0,174,5,194
2017,Algeria,DZA,Syrian Arab Rep.,SYR,0,0,10,0,10
2017,Egypt,EGY,Syrian Arab Rep.,SYR,5,0,45,0,50
2017,Bangladesh,BGD,Syrian Arab Rep.,SYR,0,0,5,0,5
2017,Burkina Faso,BFA,Syrian Arab Rep.,SYR,0,0,5,5,10
2017,Chad,TCD,Syrian Arab Rep.,SYR,0,0,5,0,5
2017,Eritrea,ERI,Syrian Arab Rep.,SYR,5,0,0,0,5
2017,Ethiopia,ETH,Syrian Arab Rep.,SYR,0,0,5,0,5
2017,Guinea,GIN,Syrian Arab Rep.,SYR,0,0,0,5,5
2017,Iran (Islamic Rep. of),IRN,Syrian Arab Rep.,SYR,0,0,261,108,369
2017,Iraq,IRQ,Syrian Arab Rep.,SYR,5,0,45,15,65
2017,Lebanon,LBN,Syrian Arab Rep.,SYR,0,0,37,21,58
2017,Pakistan,PAK,Syrian Arab Rep.,SYR,5,0,5,5,15
2017,Romania,ROU,Syrian Arab Rep.,SYR,0,0,5,0,5
2017,Saudi Arabia,SAU,Syrian Arab Rep.,SYR,0,0,5,0,5
2017,Sierra Leone,SLE,Syrian Arab Rep.,SYR,0,0,5,0,5
2017,Sudan,SDN,Syrian Arab Rep.,SYR,5,0,54,0,59
2017,United Rep. of Tanzania,TZA,Syrian Arab Rep.,SYR,0,0,5,0,5
2017,Tunisia,TUN,Syrian Arab Rep.,SYR,0,0,10,0,10
2017,Turkey,TUR,Syrian Arab Rep.,SYR,0,0,5,0,5
2017,Ukraine,UKR,Syrian Arab Rep.,SYR,0,0,0,5,5
2017,Uzbekistan,UZB,Syrian Arab Rep.,SYR,0,0,5,0,5
2017,Yemen,YEM,Syrian Arab Rep.,SYR,10,0,0,5,15
2018,Afghanistan,AFG,Syrian Arab Rep.,SYR,5,0,10,5,20
2018,Guinea,GIN,Syrian Arab Rep.,SYR,0,0,5,0,5
2018,Iran (Islamic Rep. of),IRN,Syrian Arab Rep.,SYR,0,0,5,5,10
2018,Iraq,IRQ,Syrian Arab Rep.,SYR,5,0,21,5,31
2018,Jordan,JOR,Syrian Arab Rep.,SYR,0,0,5,0,5
2018,Pakistan,PAK,Syrian Arab Rep.,SYR,0,0,15,0,15
2018,Sudan,SDN,Syrian Arab Rep.,SYR,0,0,44,0,44
2018,Yemen,YEM,Syrian Arab Rep.,SYR,10,0,0,0,10
2018,Stateless,XXA,Syrian Arab Rep.,SYR,0,0,0,5,5
2019,Iraq,IRQ,Syrian Arab Rep.,SYR,0,0,0,10,10
2019,Sudan,SDN,Syrian Arab Rep.,SYR,18,0,0,0,18
2019,Yemen,YEM,Syrian Arab Rep.,SYR,0,0,0,10,10
2016,Iraq,IRQ,United Arab Emirates,ARE,224,0,0,0,224
2016,Syrian Arab Rep.,SYR,United Arab Emirates,ARE,101,0,0,0,101
2005,Cameroon,CMR,"China, Hong Kong SAR",HKG,0,0,5,0,5
2005,Sri Lanka,LKA,"China, Hong Kong SAR",HKG,0,0,5,0,5
2005,Pakistan,PAK,"China, Hong Kong SAR",HKG,0,0,5,0,5
2005,Cambodia,KHM,Thailand,THA,0,0,10,0,10
2005,China,CHN,Thailand,THA,5,0,0,0,5
2005,Iran (Islamic Rep. of),IRN,Thailand,THA,0,0,5,0,5
2005,Lao People's Dem. Rep.,LAO,Thailand,THA,0,0,0,5,5
2005,Myanmar,MMR,Thailand,THA,33,0,31,0,64
2005,Viet Nam,VNM,Thailand,THA,0,0,0,5,5
2006,Sri Lanka,LKA,"China, Hong Kong SAR",HKG,0,0,13,0,13
2006,Pakistan,PAK,"China, Hong Kong SAR",HKG,0,0,5,0,5
2006,Afghanistan,AFG,Syrian Arab Rep.,SYR,5,0,0,0,5
2006,Eritrea,ERI,Syrian Arab Rep.,SYR,0,0,0,5,5
2006,Iran (Islamic Rep. of),IRN,Syrian Arab Rep.,SYR,5,0,10,0,15
2006,Somalia,SOM,Syrian Arab Rep.,SYR,168,0,15,0,183
2006,Sudan,SDN,Syrian Arab Rep.,SYR,15,0,11,0,26
2006,Cambodia,KHM,Thailand,THA,0,0,0,5,5
2006,China,CHN,Thailand,THA,0,0,5,0,5
2006,Sri Lanka,LKA,Thailand,THA,0,0,5,0,5
2006,Afghanistan,AFG,Turkey,TUR,0,0,5,0,5
2006,Iran (Islamic Rep. of),IRN,Turkey,TUR,76,0,26,0,102
2006,Iraq,IRQ,Turkey,TUR,10,0,0,0,10
2007,Rwanda,RWA,Cameroon,CMR,5,0,36,0,41
2007,Congo,COG,"China, Hong Kong SAR",HKG,0,5,0,0,5
2007,Dem. Rep. of the Congo,COD,"China, Hong Kong SAR",HKG,0,0,5,0,5
2007,Sri Lanka,LKA,"China, Hong Kong SAR",HKG,0,0,5,0,5
2007,Nepal,NPL,"China, Hong Kong SAR",HKG,0,0,10,0,10
2007,Afghanistan,AFG,Syrian Arab Rep.,SYR,10,0,10,0,20
2007,Somalia,SOM,Syrian Arab Rep.,SYR,28,0,0,0,28
2007,Sudan,SDN,Syrian Arab Rep.,SYR,0,0,5,0,5
2007,Cambodia,KHM,Thailand,THA,0,0,5,43,48
2007,China,CHN,Thailand,THA,5,0,0,21,26
2007,Dem. Rep. of the Congo,COD,Thailand,THA,0,0,0,5,5
2007,Iraq,IRQ,Thailand,THA,5,0,0,0,5
2007,Sri Lanka,LKA,Thailand,THA,0,0,0,10,10
2007,Viet Nam,VNM,Thailand,THA,0,0,10,57,67
2007,Eritrea,ERI,Turkey,TUR,0,0,0,5,5
2007,Iran (Islamic Rep. of),IRN,Turkey,TUR,61,0,16,0,77
2007,Iraq,IRQ,Turkey,TUR,80,0,0,22,102
2007,Kazakhstan,KAZ,Turkey,TUR,0,0,0,5,5
2007,Somalia,SOM,Turkey,TUR,0,0,0,5,5
2007,Uzbekistan,UZB,Turkey,TUR,5,0,0,0,5
2008,Sudan,SDN,Jordan,JOR,0,0,5,0,5
2008,Afghanistan,AFG,Syrian Arab Rep.,SYR,0,0,0,5,5
2008,Iran (Islamic Rep. of),IRN,Syrian Arab Rep.,SYR,0,0,0,11,11
2008,Kuwait,KWT,Syrian Arab Rep.,SYR,5,0,0,0,5
2008,Somalia,SOM,Syrian Arab Rep.,SYR,5,0,0,0,5
2008,Sudan,SDN,Syrian Arab Rep.,SYR,0,0,0,22,22
2008,Stateless,XXA,Syrian Arab Rep.,SYR,13,0,0,0,13
2008,Cambodia,KHM,Thailand,THA,0,0,0,22,22
2008,China,CHN,Thailand,THA,10,0,5,11,26
2008,Iran (Islamic Rep. of),IRN,Thailand,THA,0,0,5,0,5
2008,Iraq,IRQ,Thailand,THA,5,0,0,0,5
2008,Sri Lanka,LKA,Thailand,THA,5,0,10,21,36
2008,Viet Nam,VNM,Thailand,THA,0,0,5,0,5
2008,Iran (Islamic Rep. of),IRN,Turkey,TUR,47,0,19,5,71
2008,Iraq,IRQ,Turkey,TUR,31,0,5,0,36
2009,Sri Lanka,LKA,"China, Hong Kong SAR",HKG,0,0,0,10,10
2009,Pakistan,PAK,"China, Hong Kong SAR",HKG,0,0,0,5,5
2009,Egypt,EGY,Jordan,JOR,0,0,5,0,5
2009,Sudan,SDN,Jordan,JOR,32,0,10,0,42
2009,Afghanistan,AFG,Syrian Arab Rep.,SYR,5,0,0,0,5
2009,Iran (Islamic Rep. of),IRN,Syrian Arab Rep.,SYR,0,0,0,5,5
2009,Somalia,SOM,Syrian Arab Rep.,SYR,10,0,0,0,10
2009,Sudan,SDN,Syrian Arab Rep.,SYR,5,0,0,0,5
2009,Cambodia,KHM,Thailand,THA,5,0,0,10,15
2009,China,CHN,Thailand,THA,0,0,13,5,18
2009,Iraq,IRQ,Thailand,THA,0,0,5,0,5
2009,Kuwait,KWT,Thailand,THA,0,0,0,5,5
2009,Sri Lanka,LKA,Thailand,THA,11,0,0,10,21
2009,Viet Nam,VNM,Thailand,THA,0,0,5,5,10
2009,Afghanistan,AFG,Turkey,TUR,0,0,5,0,5
2009,China,CHN,Turkey,TUR,0,0,0,5,5
2009,Ethiopia,ETH,Turkey,TUR,0,0,5,0,5
2009,Iran (Islamic Rep. of),IRN,Turkey,TUR,11,0,5,14,30
2009,Iraq,IRQ,Turkey,TUR,16,0,5,14,35
2009,Syrian Arab Rep.,SYR,Turkey,TUR,0,0,5,0,5
2009,Uzbekistan,UZB,Turkey,TUR,14,0,0,0,14
2010,Central African Rep.,CAF,Cameroon,CMR,0,0,5,11,16
2010,Chad,TCD,Cameroon,CMR,0,0,29,5,34
2010,Dem. Rep. of the Congo,COD,Cameroon,CMR,0,0,10,0,10
2010,Guinea,GIN,Cameroon,CMR,0,0,0,5,5
2010,Rwanda,RWA,Cameroon,CMR,0,0,5,0,5
2010,Sudan,SDN,Cameroon,CMR,0,0,5,0,5
2010,Bangladesh,BGD,"China, Hong Kong SAR",HKG,0,0,5,5,10
2010,India,IND,"China, Hong Kong SAR",HKG,0,0,0,5,5
2010,Indonesia,IDN,"China, Hong Kong SAR",HKG,0,0,5,5,10
2010,Sri Lanka,LKA,"China, Hong Kong SAR",HKG,0,0,5,12,17
2010,Nepal,NPL,"China, Hong Kong SAR",HKG,0,0,5,0,5
2010,Pakistan,PAK,"China, Hong Kong SAR",HKG,0,0,10,10,20
2010,Egypt,EGY,Jordan,JOR,0,0,0,15,15
2010,Iraq,IRQ,Jordan,JOR,0,0,0,40,40
2010,Pakistan,PAK,Jordan,JOR,0,0,0,10,10
2010,Sudan,SDN,Jordan,JOR,0,0,0,20,20
2010,Syrian Arab Rep.,SYR,Jordan,JOR,0,0,0,11,11
2010,Stateless,XXA,Jordan,JOR,0,0,0,10,10
2010,Iraq,IRQ,Lebanon,LBN,0,0,5,0,5
2010,Somalia,SOM,Lebanon,LBN,0,0,0,5,5
2010,Sudan,SDN,Lebanon,LBN,0,0,0,5,5
2010,Afghanistan,AFG,Syrian Arab Rep.,SYR,11,0,0,23,34
2010,Somalia,SOM,Syrian Arab Rep.,SYR,0,0,0,50,50
2010,Sudan,SDN,Syrian Arab Rep.,SYR,0,0,0,34,34
2010,Stateless,XXA,Syrian Arab Rep.,SYR,10,0,0,0,10
2010,Cambodia,KHM,Thailand,THA,0,0,18,22,40
2010,China,CHN,Thailand,THA,5,0,5,17,27
2010,Dem. Rep. of the Congo,COD,Thailand,THA,0,0,0,5,5
2010,India,IND,Thailand,THA,0,0,0,5,5
2010,Iran (Islamic Rep. of),IRN,Thailand,THA,0,0,0,5,5
2010,Iraq,IRQ,Thailand,THA,0,0,0,5,5
2010,Sri Lanka,LKA,Thailand,THA,0,0,13,17,30
2010,Pakistan,PAK,Thailand,THA,0,0,0,10,10
2010,Viet Nam,VNM,Thailand,THA,0,0,12,23,35
2010,Afghanistan,AFG,Turkey,TUR,5,0,0,0,5
2010,Iran (Islamic Rep. of),IRN,Turkey,TUR,33,0,5,0,38
2010,Iraq,IRQ,Turkey,TUR,5,0,0,0,5
2010,Uzbekistan,UZB,Turkey,TUR,5,0,0,0,5
2010,Stateless,XXA,Turkey,TUR,5,0,0,0,5
2011,Burundi,BDI,Cameroon,CMR,0,0,5,0,5
2011,Central African Rep.,CAF,Cameroon,CMR,5,0,51,143,199
2011,Chad,TCD,Cameroon,CMR,0,0,60,5,65
2011,Dem. Rep. of the Congo,COD,Cameroon,CMR,0,0,20,0,20
2011,Ghana,GHA,Cameroon,CMR,0,0,5,0,5
2011,Guinea,GIN,Cameroon,CMR,0,0,5,0,5
2011,Cote d'Ivoire,CIV,Cameroon,CMR,10,0,0,0,10
2011,Liberia,LBR,Cameroon,CMR,0,0,0,5,5
2011,Rwanda,RWA,Cameroon,CMR,5,0,57,49,111
2011,Bangladesh,BGD,"China, Hong Kong SAR",HKG,0,0,0,5,5
2011,Indonesia,IDN,"China, Hong Kong SAR",HKG,0,0,0,5,5
2011,Nepal,NPL,"China, Hong Kong SAR",HKG,0,0,0,5,5
2011,Pakistan,PAK,"China, Hong Kong SAR",HKG,0,0,0,5,5
2011,Philippines,PHL,"China, Hong Kong SAR",HKG,0,0,5,0,5
2011,Iraq,IRQ,Lebanon,LBN,0,0,0,18,18
2011,Sudan,SDN,Lebanon,LBN,0,0,5,5,10
2011,Afghanistan,AFG,Syrian Arab Rep.,SYR,5,0,0,0,5
2011,China,CHN,Thailand,THA,12,0,5,5,22
2011,Iraq,IRQ,Thailand,THA,0,0,0,5,5
2011,Sri Lanka,LKA,Thailand,THA,0,0,5,20,25
2011,Pakistan,PAK,Thailand,THA,5,0,0,5,10
2011,Viet Nam,VNM,Thailand,THA,0,0,0,26,26
2011,Afghanistan,AFG,Turkey,TUR,15,0,0,0,15
2011,Egypt,EGY,Turkey,TUR,5,0,0,0,5
2011,Iran (Islamic Rep. of),IRN,Turkey,TUR,71,0,10,0,81
2011,Iraq,IRQ,Turkey,TUR,0,0,0,5,5
2011,Morocco,MAR,Turkey,TUR,0,0,0,10,10
2011,Syrian Arab Rep.,SYR,Turkey,TUR,0,0,0,5,5
2012,Central African Rep.,CAF,Cameroon,CMR,0,0,0,26,26
2012,Chad,TCD,Cameroon,CMR,0,0,5,5,10
2012,Guinea,GIN,Cameroon,CMR,0,0,0,5,5
2012,Rwanda,RWA,Cameroon,CMR,0,0,13,0,13
2012,India,IND,"China, Hong Kong SAR",HKG,0,0,0,5,5
2012,Indonesia,IDN,"China, Hong Kong SAR",HKG,0,0,0,11,11
2012,Sri Lanka,LKA,"China, Hong Kong SAR",HKG,0,0,0,5,5
2012,Nepal,NPL,"China, Hong Kong SAR",HKG,0,0,5,0,5
2012,Egypt,EGY,Lebanon,LBN,0,0,0,5,5
2012,Iraq,IRQ,Lebanon,LBN,0,0,0,52,52
2012,Sudan,SDN,Lebanon,LBN,0,0,0,15,15
2012,Chad,TCD,Syrian Arab Rep.,SYR,0,0,0,5,5
2012,Iraq,IRQ,Syrian Arab Rep.,SYR,0,0,5,0,5
2012,Somalia,SOM,Syrian Arab Rep.,SYR,5,0,0,0,5
2012,Sudan,SDN,Syrian Arab Rep.,SYR,10,0,0,0,10
2012,Cambodia,KHM,Thailand,THA,10,0,18,0,28
2012,China,CHN,Thailand,THA,10,0,5,0,15
2012,Dem. Rep. of the Congo,COD,Thailand,THA,0,0,11,5,16
2012,Iran (Islamic Rep. of),IRN,Thailand,THA,5,0,0,5,10
2012,Sri Lanka,LKA,Thailand,THA,0,0,22,5,27
2012,Pakistan,PAK,Thailand,THA,0,0,5,0,5
2012,Viet Nam,VNM,Thailand,THA,0,0,30,23,53
2012,Iran (Islamic Rep. of),IRN,Turkey,TUR,10,0,0,5,15
2012,Iraq,IRQ,Turkey,TUR,0,0,0,5,5
2012,Kazakhstan,KAZ,Turkey,TUR,0,0,0,5,5
2012,Somalia,SOM,Turkey,TUR,5,0,0,5,10
2012,Yemen,YEM,Turkey,TUR,0,0,0,5,5
2012,Stateless,XXA,Turkey,TUR,5,0,0,10,15
2013,Cameroon,CMR,Algeria,DZA,0,0,14,20,34
2013,Dem. Rep. of the Congo,COD,Algeria,DZA,0,0,0,5,5
2013,Cote d'Ivoire,CIV,Algeria,DZA,0,0,10,15,25
2013,Liberia,LBR,Algeria,DZA,0,0,5,0,5
2013,Central African Rep.,CAF,Cameroon,CMR,0,0,0,12,12
2013,Chad,TCD,Cameroon,CMR,0,0,0,5,5
2013,Cote d'Ivoire,CIV,Cameroon,CMR,0,0,5,0,5
2013,Indonesia,IDN,"China, Hong Kong SAR",HKG,0,0,0,10,10
2013,Sri Lanka,LKA,"China, Hong Kong SAR",HKG,0,0,0,10,10
2013,Philippines,PHL,"China, Hong Kong SAR",HKG,0,0,5,0,5
2013,Iraq,IRQ,Lebanon,LBN,0,0,71,0,71
2013,Syrian Arab Rep.,SYR,Lebanon,LBN,5,0,0,0,5
2013,Afghanistan,AFG,Syrian Arab Rep.,SYR,11,0,0,0,11
2013,Algeria,DZA,Syrian Arab Rep.,SYR,0,0,5,0,5
2013,Chad,TCD,Syrian Arab Rep.,SYR,0,0,5,0,5
2013,Iraq,IRQ,Syrian Arab Rep.,SYR,0,0,5,0,5
2013,Sudan,SDN,Syrian Arab Rep.,SYR,43,0,5,0,48
2013,Cambodia,KHM,Thailand,THA,5,0,0,0,5
2013,China,CHN,Thailand,THA,5,0,0,0,5
2013,Sri Lanka,LKA,Thailand,THA,0,0,0,5,5
2013,Viet Nam,VNM,Thailand,THA,5,0,5,0,10
2013,Afghanistan,AFG,Turkey,TUR,5,0,0,5,10
2013,Bangladesh,BGD,Turkey,TUR,0,0,0,5,5
2013,Iran (Islamic Rep. of),IRN,Turkey,TUR,42,0,11,0,53
2013,Iraq,IRQ,Turkey,TUR,0,0,5,12,17
2013,Morocco,MAR,Turkey,TUR,0,0,0,5,5
2013,Pakistan,PAK,Turkey,TUR,5,0,0,0,5
2013,Somalia,SOM,Turkey,TUR,0,0,0,18,18
2013,Syrian Arab Rep.,SYR,Turkey,TUR,16,0,0,0,16
2013,Uzbekistan,UZB,Turkey,TUR,0,0,0,14,14
2014,Dem. Rep. of the Congo,COD,Algeria,DZA,0,0,5,0,5
2014,Eritrea,ERI,Egypt,EGY,16,0,31,0,47
2014,Ethiopia,ETH,Egypt,EGY,5,0,23,0,28
2014,Iraq,IRQ,Egypt,EGY,66,0,0,0,66
2014,Somalia,SOM,Egypt,EGY,5,0,5,0,10
2014,Sudan,SDN,Egypt,EGY,291,0,50,0,341
2014,South Sudan,SSD,Egypt,EGY,32,0,0,0,32
2014,Central African Rep.,CAF,Cameroon,CMR,66,0,0,0,66
2014,Egypt,EGY,Jordan,JOR,0,0,5,0,5
2014,Iraq,IRQ,Jordan,JOR,10,0,0,0,10
2014,Sudan,SDN,Jordan,JOR,10,0,0,0,10
2014,Afghanistan,AFG,Syrian Arab Rep.,SYR,16,0,0,0,16
2014,Chad,TCD,Syrian Arab Rep.,SYR,5,0,0,0,5
2014,Ethiopia,ETH,Syrian Arab Rep.,SYR,5,0,0,0,5
2014,Iran (Islamic Rep. of),IRN,Syrian Arab Rep.,SYR,0,0,5,0,5
2014,Iraq,IRQ,Syrian Arab Rep.,SYR,22,0,0,5,27
2014,Jordan,JOR,Syrian Arab Rep.,SYR,0,0,0,5,5
2014,Lebanon,LBN,Syrian Arab Rep.,SYR,0,0,0,10,10
2014,Somalia,SOM,Syrian Arab Rep.,SYR,0,0,0,11,11
2014,Sudan,SDN,Syrian Arab Rep.,SYR,59,0,0,0,59
2014,South Sudan,SSD,Syrian Arab Rep.,SYR,41,0,0,0,41
2014,Tunisia,TUN,Syrian Arab Rep.,SYR,0,0,5,0,5
2014,Yemen,YEM,Syrian Arab Rep.,SYR,0,0,0,5,5
2014,Stateless,XXA,Syrian Arab Rep.,SYR,0,0,5,0,5
2014,Cambodia,KHM,Thailand,THA,5,0,0,10,15
2014,China,CHN,Thailand,THA,5,0,0,0,5
2014,Iraq,IRQ,Thailand,THA,0,0,0,5,5
2014,Sri Lanka,LKA,Thailand,THA,18,0,0,5,23
2014,Viet Nam,VNM,Thailand,THA,38,0,5,0,43
2014,Iran (Islamic Rep. of),IRN,Turkey,TUR,11,0,10,0,21
2014,Morocco,MAR,Turkey,TUR,0,0,0,5,5
2015,Cote d'Ivoire,CIV,Algeria,DZA,0,0,0,5,5
2015,Libya,LBY,Algeria,DZA,0,0,0,10,10
2015,Mali,MLI,Algeria,DZA,0,0,0,5,5
2015,Syrian Arab Rep.,SYR,Algeria,DZA,0,0,0,5,5
2015,Eritrea,ERI,Egypt,EGY,5,0,0,0,5
2015,Ethiopia,ETH,Egypt,EGY,5,0,0,0,5
2015,Iraq,IRQ,Egypt,EGY,34,0,0,0,34
2015,Somalia,SOM,Egypt,EGY,18,0,0,0,18
2015,Sudan,SDN,Egypt,EGY,199,0,5,0,204
2015,South Sudan,SSD,Egypt,EGY,16,0,0,0,16
2015,Central African Rep.,CAF,Cameroon,CMR,397,0,0,25,422
2015,Sudan,SDN,Cameroon,CMR,5,0,0,0,5
2015,Iraq,IRQ,Jordan,JOR,57,0,0,0,57
2015,Sudan,SDN,Jordan,JOR,11,0,0,0,11
2015,Afghanistan,AFG,Syrian Arab Rep.,SYR,11,0,5,0,16
2015,Egypt,EGY,Syrian Arab Rep.,SYR,5,0,10,0,15
2015,Iran (Islamic Rep. of),IRN,Syrian Arab Rep.,SYR,0,0,17,0,17
2015,Iraq,IRQ,Syrian Arab Rep.,SYR,20,0,0,0,20
2015,Lebanon,LBN,Syrian Arab Rep.,SYR,0,0,5,0,5
2015,Pakistan,PAK,Syrian Arab Rep.,SYR,0,0,5,0,5
2015,Philippines,PHL,Syrian Arab Rep.,SYR,0,0,0,5,5
2015,Sudan,SDN,Syrian Arab Rep.,SYR,35,0,26,5,66
2015,Turkey,TUR,Syrian Arab Rep.,SYR,0,0,5,0,5
2015,Cambodia,KHM,Thailand,THA,5,0,0,0,5
2015,China,CHN,Thailand,THA,5,0,0,0,5
2015,Sri Lanka,LKA,Thailand,THA,13,0,10,0,23
2015,Pakistan,PAK,Thailand,THA,0,0,5,0,5
2015,Viet Nam,VNM,Thailand,THA,38,0,5,0,43
2015,Afghanistan,AFG,Turkey,TUR,15,0,0,17,32
2015,Iran (Islamic Rep. of),IRN,Turkey,TUR,50,0,19,91,160
2015,Iraq,IRQ,Turkey,TUR,10,0,0,359,369
2015,Somalia,SOM,Turkey,TUR,5,0,0,5,10
2015,Sudan,SDN,Turkey,TUR,5,0,0,0,5
2016,Mali,MLI,Algeria,DZA,0,0,5,5,10
2016,Syrian Arab Rep.,SYR,Algeria,DZA,0,0,0,5,5
2016,Eritrea,ERI,Egypt,EGY,5,0,10,0,15
2016,Guinea-Bissau,GNB,Egypt,EGY,0,0,0,5,5
2016,Somalia,SOM,Egypt,EGY,10,0,0,0,10
2016,Sudan,SDN,Egypt,EGY,90,0,29,0,119
2016,South Sudan,SSD,Egypt,EGY,25,0,0,0,25
2016,Central African Rep.,CAF,Cameroon,CMR,661,0,0,148,809
2016,Chad,TCD,Cameroon,CMR,0,0,5,14,19
2016,Guinea,GIN,Cameroon,CMR,0,0,5,5,10
2016,Cote d'Ivoire,CIV,Cameroon,CMR,0,0,0,5,5
2016,Iraq,IRQ,Jordan,JOR,5,0,0,0,5
2016,Sudan,SDN,Jordan,JOR,11,0,0,0,11
2016,Cambodia,KHM,Thailand,THA,14,0,0,5,19
2016,Sri Lanka,LKA,Thailand,THA,0,0,5,0,5
2016,Pakistan,PAK,Thailand,THA,0,0,5,0,5
2016,Viet Nam,VNM,Thailand,THA,5,0,18,5,28
2016,Syrian Arab Rep.,SYR,Thailand,THA,0,0,0,5,5
2016,Afghanistan,AFG,Turkey,TUR,10,0,0,16,26
2016,Iran (Islamic Rep. of),IRN,Turkey,TUR,39,0,16,21,76
2016,Iraq,IRQ,Turkey,TUR,5,0,0,92,97
2017,Cote d'Ivoire,CIV,Algeria,DZA,0,0,5,5,10
2017,Mali,MLI,Algeria,DZA,0,0,5,0,5
2017,Syrian Arab Rep.,SYR,Algeria,DZA,5,0,0,0,5
2017,Eritrea,ERI,Egypt,EGY,5,0,0,0,5
2017,Somalia,SOM,Egypt,EGY,5,0,0,0,5
2017,Sudan,SDN,Egypt,EGY,70,0,5,5,80
2017,South Sudan,SSD,Egypt,EGY,38,0,0,0,38
2017,Central African Rep.,CAF,Cameroon,CMR,86,0,0,66,152
2017,Dem. Rep. of the Congo,COD,Cameroon,CMR,0,0,0,5,5
2017,Pakistan,PAK,Thailand,THA,5,0,5,0,10
2017,Viet Nam,VNM,Thailand,THA,15,0,11,0,26
2017,Afghanistan,AFG,Turkey,TUR,0,0,0,10,10
2017,Iran (Islamic Rep. of),IRN,Turkey,TUR,5,0,10,51,66
2017,Iraq,IRQ,Turkey,TUR,5,0,0,12,17
2018,Cameroon,CMR,Algeria,DZA,0,0,0,5,5
2018,Guinea,GIN,Algeria,DZA,0,0,5,5,10
2018,Cote d'Ivoire,CIV,Algeria,DZA,0,0,0,10,10
2018,Mali,MLI,Algeria,DZA,0,0,0,5,5
2018,Syrian Arab Rep.,SYR,Algeria,DZA,0,0,0,5,5
2018,Eritrea,ERI,Egypt,EGY,0,0,13,0,13
2018,Ethiopia,ETH,Egypt,EGY,0,0,16,0,16
2018,Iraq,IRQ,Egypt,EGY,0,0,5,0,5
2018,Nigeria,NGA,Egypt,EGY,0,0,0,10,10
2018,Somalia,SOM,Egypt,EGY,5,0,17,0,22
2018,Sudan,SDN,Egypt,EGY,71,0,291,12,374
2018,South Sudan,SSD,Egypt,EGY,65,0,0,0,65
2018,Central African Rep.,CAF,Cameroon,CMR,104,0,5,49,158
2018,Chad,TCD,Cameroon,CMR,0,0,12,0,12
2018,Dem. Rep. of the Congo,COD,Cameroon,CMR,5,0,0,0,5
2018,Pakistan,PAK,Thailand,THA,5,0,5,0,10
2018,Viet Nam,VNM,Thailand,THA,10,0,10,5,25
2018,Afghanistan,AFG,Turkey,TUR,0,0,0,5,5
2018,Iran (Islamic Rep. of),IRN,Turkey,TUR,5,0,0,0,5
2019,Cameroon,CMR,Algeria,DZA,0,0,5,5,10
2019,Guinea,GIN,Algeria,DZA,0,0,0,5,5
2019,Cote d'Ivoire,CIV,Algeria,DZA,0,0,0,11,11
2019,Libya,LBY,Algeria,DZA,0,0,0,5,5
2019,Mali,MLI,Algeria,DZA,0,0,5,0,5
2019,Syrian Arab Rep.,SYR,Algeria,DZA,0,0,0,42,42
2019,Yemen,YEM,Algeria,DZA,0,0,0,5,5
2019,Eritrea,ERI,Egypt,EGY,0,0,5,0,5
2019,Ethiopia,ETH,Egypt,EGY,0,0,5,5,10
2019,Sudan,SDN,Egypt,EGY,34,0,12,10,56
2019,South Sudan,SSD,Egypt,EGY,37,0,0,0,37
2019,Central African Rep.,CAF,Cameroon,CMR,38,0,0,30,68
2019,Chad,TCD,Cameroon,CMR,0,0,0,29,29
2019,Dem. Rep. of the Congo,COD,Cameroon,CMR,0,0,0,12,12
2019,Guinea,GIN,Cameroon,CMR,0,0,0,11,11
2019,Iran (Islamic Rep. of),IRN,Thailand,THA,5,0,0,0,5
2019,Pakistan,PAK,Thailand,THA,0,0,10,5,15
2019,Viet Nam,VNM,Thailand,THA,0,0,0,5,5
2020,Cameroon,CMR,Algeria,DZA,0,0,0,5,5
2020,Guinea,GIN,Algeria,DZA,0,0,0,5,5
2020,Cote d'Ivoire,CIV,Algeria,DZA,0,0,0,5,5
2020,Mali,MLI,Algeria,DZA,5,0,0,5,10
2020,Sudan,SDN,Egypt,EGY,14,0,0,0,14
2020,South Sudan,SSD,Egypt,EGY,10,0,0,0,10
2020,Central African Rep.,CAF,Cameroon,CMR,26,0,0,127,153
2020,Chad,TCD,Cameroon,CMR,0,0,0,5,5
2020,Rwanda,RWA,Cameroon,CMR,0,0,0,10,10
2020,Egypt,EGY,Jordan,JOR,0,0,0,5,5
2020,Sudan,SDN,Jordan,JOR,0,0,0,10,10
2020,Yemen,YEM,Jordan,JOR,0,0,0,14,14
2020,Pakistan,PAK,Thailand,THA,0,0,5,0,5
2020,Somalia,SOM,Thailand,THA,5,0,0,0,5
2020,Viet Nam,VNM,Thailand,THA,5,0,0,0,5
